A,B,C,D,E,F,G,s
1,2,1,3,21,19,0,47
1,2,2,5,25,0,0,35
1,2,4,15,13,5,14,54
1,2,9,12,9,20,25,78
1,2,18,15,1,4,0,41
1,2,21,19,5,0,0,48
1,3,3,5,19,19,0,50
1,3,3,15,21,14,20,77
1,3,9,4,0,0,0,17
1,3,18,25,12,9,3,71
1,3,20,0,0,0,0,24
1,3,20,9,15,14,0,62
1,3,20,15,18,0,0,57
1,3,20,18,5,19,19,85
1,4,0,0,0,0,0,5
1,4,1,16,20,5,18,65
1,4,4,18,5,19,19,70
1,4,21,12,20,0,0,58
1,4,22,1,14,3,5,50
1,4,22,9,3,5,0,44
1,6,6,1,9,18,0,41
1,6,6,5,3,20,0,41
1,7,5,0,0,0,0,13
1,7,5,14,3,25,0,55
1,7,5,14,4,1,0,32
1,7,5,14,20,0,0,47
1,7,12,5,20,0,0,45
1,9,4,0,0,0,0,14
1,9,18,0,0,0,0,28
1,9,18,2,1,7,0,38
1,9,18,2,21,19,0,70
1,9,18,6,1,18,5,58
1,9,18,12,9,14,5,68
1,9,18,13,1,9,12,63
1,9,18,16,15,18,20,97
1,9,18,19,8,9,16,80
1,12,1,18,13,0,0,45
1,12,2,0,0,0,0,15
1,12,3,15,8,15,12,66
1,12,3,15,22,5,0,58
1,12,4,5,18,0,0,40
1,12,7,5,2,18,1,46
1,12,9,2,9,0,0,33
1,12,12,5,25,0,0,55
1,12,12,15,25,0,0,65
1,12,13,1,14,1,3,45
1,12,13,15,14,4,0,59
1,12,16,1,3,1,0,34
1,12,16,8,1,0,0,38
1,12,20,15,0,0,0,48
1,13,15,21,14,20,0,84
1,14,1,7,18,1,13,55
1,14,1,12,15,7,0,50
1,14,1,12,15,7,25,75
1,14,1,12,25,19,20,92
1,14,1,20,15,13,25,89
1,14,7,5,18,0,0,45
1,14,7,12,5,0,0,39
1,14,7,15,18,1,0,56
1,14,7,21,9,19,8,79
1,14,9,13,1,12,0,50
1,14,9,13,5,0,0,42
1,14,11,12,5,0,0,43
1,14,11,12,5,20,0,63
1,14,14,21,1,12,0,63
1,14,15,18,1,11,0,60
1,14,19,23,5,18,0,80
1,14,20,0,0,0,0,35
1,14,20,8,15,14,25,97
1,14,20,12,5,18,0,70
1,14,24,9,5,20,25,98
1,14,25,2,15,4,25,86
1,16,5,0,0,0,0,22
1,16,15,12,15,7,25,91
1,16,16,1,18,5,12,69
1,16,16,5,1,12,0,51
1,16,16,12,5,0,0,50
1,16,18,15,14,0,0,64
1,16,19,5,0,0,0,41
1,17,21,9,6,5,18,77
1,18,3,8,0,0,0,30
1,18,3,8,5,18,0,53
1,18,5,1,0,0,0,25
1,18,13,0,0,0,0,32
1,18,13,15,9,18,5,79
1,18,13,15,18,0,0,65
1,18,13,25,0,0,0,57
1,18,18,9,22,1,12,81
1,18,18,15,23,0,0,75
1,18,20,0,0,0,0,39
1,18,20,9,3,12,5,68
1,19,3,15,20,0,0,58
1,19,8,0,0,0,0,28
1,19,8,18,1,13,0,60
1,19,8,20,18,1,25,92
1,19,9,4,5,0,0,38
1,19,11,0,0,0,0,31
1,19,16,5,3,20,0,64
1,19,16,8,1,12,20,77
1,19,19,9,19,20,0,87
1,20,5,12,9,5,18,70
1,20,8,12,5,20,5,71
1,20,15,13,0,0,0,49
1,20,18,9,21,13,0,82
1,20,20,1,3,11,0,56
1,20,20,5,13,16,20,95
1,20,20,9,3,0,0,53
1,21,14,20,0,0,0,56
1,21,20,8,15,18,0,83
1,22,5,14,21,5,0,68
1,22,5,18,1,7,5,59
1,23,1,18,4,0,0,47
1,26,9,13,21,20,8,98
2,1,2,5,0,0,0,10
2,1,2,15,15,14,0,49
2,1,2,25,0,0,0,30
2,1,3,11,0,0,0,17
2,1,3,15,14,0,0,35
2,1,4,0,0,0,0,7
2,1,4,7,5,0,0,19
2,1,4,7,5,18,0,37
2,1,7,0,0,0,0,10
2,1,7,5,12,0,0,27
2,1,7,7,1,7,5,30
2,1,7,16,9,16,5,56
2,1,9,12,0,0,0,24
2,1,9,20,0,0,0,32
2,1,11,5,0,0,0,19
2,1,11,5,18,0,0,37
2,1,11,5,18,25,0,62
2,1,12,1,14,3,5,38
2,1,12,3,15,14,25,72
2,1,12,12,0,0,0,27
2,1,12,12,5,20,0,52
2,1,12,12,15,15,14,71
2,1,13,2,15,15,0,48
2,1,14,1,14,1,0,33
2,1,14,4,0,0,0,21
2,1,14,4,1,14,1,37
2,1,14,7,12,5,0,41
2,1,14,10,15,0,0,42
2,1,14,11,0,0,0,28
2,1,14,11,5,18,0,51
2,1,15,2,1,2,0,23
2,1,18,0,0,0,0,21
2,1,18,2,5,18,0,46
2,1,18,7,5,0,0,33
2,1,18,9,21,13,0,64
2,1,18,14,0,0,0,35
2,1,19,5,0,0,0,27
2,1,19,9,14,0,0,45
2,1,19,9,19,0,0,50
2,1,19,11,5,20,0,58
2,1,19,19,0,0,0,41
2,1,19,19,15,15,14,85
2,1,20,0,0,0,0,23
2,1,20,8,0,0,0,31
2,1,20,8,5,18,0,54
2,1,20,8,20,21,2,74
2,1,20,20,5,18,0,66
2,1,20,20,5,18,25,91
2,1,20,20,9,14,7,73
2,1,20,20,12,5,0,60
2,1,25,0,0,0,0,28
2,1,25,15,21,0,0,64
2,5,1,3,8,0,0,19
2,5,1,4,0,0,0,12
2,5,1,11,0,0,0,19
2,5,1,13,0,0,0,21
2,5,1,14,0,0,0,22
2,5,1,14,9,5,0,36
2,5,1,18,0,0,0,26
2,5,1,18,4,0,0,30
2,5,1,19,20,0,0,47
2,5,1,20,0,0,0,28
2,5,1,21,20,25,0,74
2,5,1,22,5,18,0,53
2,5,4,0,0,0,0,11
2,5,4,18,15,15,13,72
2,5,5,0,0,0,0,12
2,5,5,3,8,0,0,23
2,5,5,6,0,0,0,18
2,5,5,18,0,0,0,30
2,5,5,20,0,0,0,32
2,5,5,20,12,5,0,49
2,5,7,7,1,18,0,40
2,5,7,15,14,9,1,53
2,5,8,5,19,20,0,59
2,5,9,14,7,0,0,37
2,5,12,6,18,25,0,68
2,5,12,9,5,6,0,39
2,5,12,9,5,22,5,60
2,5,12,12,0,0,0,31
2,5,12,12,15,23,19,88
2,5,12,12,25,0,0,56
2,5,12,20,0,0,0,39
2,5,14,3,8,0,0,32
2,5,14,4,0,0,0,25
2,5,14,5,6,9,20,61
2,5,14,7,1,12,0,41
2,5,18,5,20,0,0,50
2,5,18,18,25,0,0,68
2,5,20,0,0,0,0,27
2,5,25,15,14,4,0,65
2,9,3,25,3,12,5,59
2,9,4,0,0,0,0,15
2,9,4,5,20,0,0,40
2,9,7,0,0,0,0,18
2,9,10,15,21,0,0,57
2,9,11,5,0,0,0,27
2,9,11,9,14,9,0,54
2,9,12,12,0,0,0,35
2,9,14,0,0,0,0,25
2,9,15,12,15,7,25,85
2,9,16,12,1,14,5,59
2,9,18,3,8,0,0,40
2,9,18,4,0,0,0,33
2,9,18,20,8,0,0,57
2,9,20,0,0,0,0,31
2,9,20,5,0,0,0,36
2,9,20,20,5,18,0,74
2,12,1,3,11,0,0,29
2,12,1,4,4,5,18,46
2,12,1,4,5,0,0,24
2,12,1,13,5,0,0,33
2,12,1,14,11,0,0,40
2,12,1,14,11,5,20,65
2,12,1,26,5,18,0,64
2,12,9,7,8,20,0,58
2,12,9,14,4,0,0,41
2,12,9,14,11,5,18,71
2,12,9,19,20,5,18,85
2,12,15,3,11,0,0,43
2,12,15,3,11,5,18,66
2,12,15,15,4,0,0,48
2,12,15,15,13,0,0,57
2,12,15,19,19,15,13,95
2,12,15,21,19,5,0,74
2,12,15,23,0,0,0,52
2,12,15,23,7,21,14,94
2,12,21,5,0,0,0,40
2,15,1,18,0,0,0,36
2,15,1,18,4,0,0,40
2,15,1,20,0,0,0,38
2,15,2,3,1,20,0,43
2,15,4,25,0,0,0,46
2,15,7,0,0,0,0,24
2,15,12,5,18,15,0,67
2,15,12,20,0,0,0,49
2,15,13,2,0,0,0,32
2,15,13,2,5,18,0,55
2,15,14,5,0,0,0,36
2,15,14,7,15,0,0,53
2,15,14,14,5,20,0,70
2,15,14,19,1,9,0,60
2,15,14,21,19,0,0,71
2,15,15,11,0,0,0,43
2,15,15,11,5,14,4,66
2,15,15,11,12,5,20,80
2,15,15,19,20,5,18,94
2,15,15,20,0,0,0,52
2,15,15,20,5,5,0,62
2,15,15,20,9,5,0,66
2,15,15,20,19,0,0,71
2,15,15,20,25,0,0,77
2,15,18,4,5,18,0,62
2,15,18,5,0,0,0,40
2,15,19,15,13,0,0,64
2,15,19,19,0,0,0,55
2,15,20,1,14,25,0,77
2,15,20,8,5,18,0,68
2,15,20,20,12,5,0,74
2,15,20,20,15,13,0,85
2,15,21,4,15,9,18,84
2,15,21,7,8,0,0,53
2,15,23,0,0,0,0,40
2,15,23,5,18,0,0,63
2,15,23,12,0,0,0,52
2,15,23,12,5,18,0,75
2,15,23,12,9,14,7,82
2,15,23,20,9,5,0,74
2,15,24,0,0,0,0,41
2,15,24,5,18,0,0,64
2,15,25,0,0,0,0,42
2,18,1,0,0,0,0,21
2,18,1,3,5,0,0,29
2,18,1,3,11,5,20,60
2,18,1,9,14,0,0,44
2,18,1,11,5,0,0,37
2,18,1,14,3,8,0,46
2,18,1,14,4,0,0,39
2,18,1,14,4,25,0,64
2,18,1,19,19,0,0,59
2,18,1,22,5,0,0,48
2,18,5,1,4,0,0,30
2,18,5,1,11,0,0,37
2,18,5,1,19,20,0,65
2,18,5,1,20,8,0,54
2,18,5,5,26,5,0,61
2,18,9,2,5,18,25,79
2,18,9,3,11,0,0,43
2,18,9,4,7,5,0,45
2,18,9,5,6,0,0,40
2,18,9,5,6,19,0,59
2,18,9,20,9,19,8,85
2,18,15,1,4,0,0,40
2,18,15,9,12,5,18,79
2,18,15,11,5,18,0,69
2,18,15,13,5,0,0,53
2,18,15,14,3,15,0,67
2,18,15,14,26,5,0,80
2,18,15,15,3,8,0,61
2,18,15,15,4,0,0,54
2,18,15,15,11,0,0,61
2,18,15,15,13,0,0,63
2,18,15,20,8,5,18,86
2,18,15,23,0,0,0,58
2,18,15,23,14,0,0,72
2,18,21,19,8,0,0,68
2,21,2,2,12,5,0,44
2,21,3,11,5,20,0,62
2,21,3,11,12,5,0,54
2,21,4,0,0,0,0,27
2,21,4,4,25,0,0,56
2,21,4,7,5,20,0,59
2,21,6,6,5,18,0,58
2,21,6,6,5,20,0,60
2,21,7,0,0,0,0,30
2,21,7,7,25,0,0,62
2,21,7,12,5,0,0,47
2,21,12,2,0,0,0,37
2,21,12,12,0,0,0,47
2,21,12,12,5,20,0,72
2,21,13,16,5,18,0,75
2,21,14,0,0,0,0,37
2,21,14,3,8,0,0,48
2,21,18,7,12,1,18,79
2,21,18,14,0,0,0,55
2,21,18,19,20,0,0,80
2,21,19,0,0,0,0,42
2,21,19,8,0,0,0,50
2,21,19,20,0,0,0,62
2,21,19,20,12,5,0,79
2,21,20,1,14,5,0,63
2,21,20,3,8,5,18,77
2,21,20,20,5,18,0,86
2,21,20,20,15,14,0,92
2,21,25,0,0,0,0,48
2,21,25,5,18,0,0,71
2,21,26,26,1,18,4,98
3,1,2,1,14,1,0,22
3,1,2,2,1,7,5,21
3,1,2,9,14,0,0,29
3,1,2,9,14,5,20,54
3,1,2,12,5,0,0,23
3,1,2,15,15,19,5,60
3,1,3,1,15,0,0,23
3,1,3,20,21,19,0,67
3,1,4,4,25,0,0,37
3,1,4,5,20,0,0,33
3,1,6,5,0,0,0,15
3,1,6,20,1,14,0,45
3,1,11,5,0,0,0,20
3,1,12,6,0,0,0,22
3,1,12,9,3,15,0,43
3,1,12,12,0,0,0,28
3,1,12,13,0,0,0,29
3,1,13,5,12,0,0,34
3,1,13,5,15,0,0,37
3,1,13,5,18,1,0,41
3,1,13,16,0,0,0,33
3,1,14,0,0,0,0,18
3,1,14,1,12,0,0,31
3,1,14,3,5,12,0,38
3,1,14,3,5,18,0,44
3,1,14,4,12,5,0,39
3,1,14,4,25,0,0,47
3,1,14,5,0,0,0,23
3,1,14,14,15,14,0,61
3,1,14,15,5,0,0,38
3,1,14,15,14,0,0,47
3,1,14,15,16,25,0,74
3,1,14,20,5,5,14,62
3,1,14,22,1,19,0,60
3,1,16,0,0,0,0,20
3,1,16,5,0,0,0,25
3,1,16,9,20,1,12,62
3,1,16,15,14,0,0,49
3,1,16,20,1,9,14,64
3,1,16,20,9,15,14,78
3,1,18,0,0,0,0,22
3,1,18,1,22,1,14,60
3,1,18,2,15,14,0,53
3,1,18,4,0,0,0,26
3,1,18,5,0,0,0,27
3,1,18,5,5,18,0,50
3,1,18,7,15,0,0,44
3,1,18,12,15,1,4,54
3,1,18,15,12,0,0,49
3,1,18,16,0,0,0,38
3,1,18,16,5,20,0,63
3,1,18,16,15,18,20,91
3,1,18,18,9,5,18,72
3,1,18,18,15,20,0,75
3,1,18,18,25,0,0,65
3,1,18,20,0,0,0,42
3,1,18,20,15,15,14,86
3,1,19,3,1,4,5,36
3,1,19,5,0,0,0,28
3,1,19,8,0,0,0,31
3,1,19,8,9,5,18,63
3,1,19,9,14,15,0,61
3,1,19,19,15,3,11,71
3,1,19,20,0,0,0,43
3,1,19,20,12,5,0,60
3,1,20,0,0,0,0,24
3,1,20,3,8,0,0,35
3,1,20,19,21,16,0,80
3,1,20,20,12,5,0,61
3,1,21,19,5,0,0,49
3,1,21,20,9,15,14,83
3,1,22,5,0,0,0,31
3,4,0,0,0,0,0,7
3,5,9,12,9,14,7,59
3,5,12,5,18,25,0,68
3,5,12,5,19,20,5,69
3,5,12,12,0,0,0,32
3,5,12,12,1,18,0,51
3,5,12,12,15,0,0,47
3,5,12,19,9,21,19,88
3,5,13,5,14,20,0,60
3,5,14,19,21,19,0,81
3,5,14,20,0,0,0,42
3,5,14,20,5,18,0,65
3,5,14,20,21,18,25,106
3,5,18,1,13,9,3,52
3,5,18,5,1,12,0,44
3,8,1,6,5,0,0,23
3,8,1,9,14,0,0,35
3,8,1,9,18,0,0,39
3,8,1,9,19,5,0,45
3,8,1,12,5,20,0,49
3,8,1,12,9,3,5,41
3,8,1,12,11,0,0,35
3,8,1,14,3,5,0,34
3,8,1,14,7,5,0,38
3,8,1,14,14,5,12,57
3,8,1,15,19,0,0,46
3,8,1,16,0,0,0,28
3,8,1,16,5,12,0,45
3,8,1,16,20,5,18,71
3,8,1,18,4,0,0,34
3,8,1,18,7,5,0,42
3,8,1,18,9,20,25,84
3,8,1,18,12,5,19,66
3,8,1,18,13,0,0,43
3,8,1,18,20,0,0,50
3,8,1,20,5,1,21,59
3,8,5,3,11,0,0,30
3,8,5,5,11,0,0,32
3,8,5,5,20,1,8,50
3,8,5,6,0,0,0,22
3,8,5,17,21,5,0,59
3,8,5,18,18,25,0,77
3,8,5,19,19,0,0,54
3,8,5,19,20,0,0,55
3,8,9,3,11,0,0,34
3,8,9,3,11,5,14,53
3,8,9,3,15,18,25,81
3,8,9,5,6,0,0,31
3,8,9,12,4,0,0,36
3,8,9,12,12,0,0,44
3,8,9,13,5,0,0,38
3,8,9,14,0,0,0,34
3,8,9,14,15,0,0,49
3,8,9,16,0,0,0,36
3,8,9,22,5,0,0,47
3,8,15,9,3,5,0,43
3,8,15,11,5,18,0,60
3,8,15,16,0,0,0,42
3,8,15,18,4,0,0,48
3,8,15,23,4,5,18,76
3,8,18,15,13,5,0,62
3,8,21,2,0,0,0,34
3,8,21,7,0,0,0,39
3,8,21,18,3,8,0,61
3,8,21,18,14,0,0,64
3,9,3,1,4,1,0,21
3,9,14,5,13,1,0,45
3,9,18,3,12,5,0,50
3,9,18,18,21,19,0,88
3,9,20,25,0,0,0,57
3,12,1,9,13,0,0,38
3,12,1,13,0,0,0,29
3,12,1,14,11,0,0,41
3,12,1,19,16,0,0,51
3,12,1,19,19,0,0,54
3,12,1,19,19,9,3,66
3,12,1,21,19,5,0,61
3,12,1,22,5,0,0,43
3,12,1,22,9,5,18,70
3,12,5,1,14,5,18,58
3,12,5,1,20,0,0,41
3,12,5,6,0,0,0,26
3,12,5,18,9,3,0,50
3,12,5,18,11,0,0,49
3,12,9,3,11,0,0,38
3,12,9,5,14,20,0,63
3,12,9,6,6,0,0,36
3,12,9,13,1,20,5,63
3,12,9,13,2,0,0,39
3,12,9,16,0,0,0,40
3,12,9,16,16,5,18,79
3,12,15,1,11,0,0,42
3,12,15,3,11,0,0,44
3,12,15,7,19,0,0,56
3,12,15,19,5,0,0,54
3,12,15,19,5,20,0,74
3,12,15,20,8,0,0,58
3,12,15,20,8,5,19,82
3,12,15,21,4,0,0,55
3,12,15,21,4,25,0,80
3,12,15,22,5,0,0,57
3,12,15,22,5,18,0,75
3,12,21,2,0,0,0,38
3,12,21,5,0,0,0,41
3,12,21,20,3,8,0,67
3,15,1,3,8,0,0,30
3,15,1,12,0,0,0,31
3,15,1,19,20,0,0,58
3,15,1,20,0,0,0,39
3,15,2,0,0,0,0,20
3,15,2,23,5,2,0,50
3,15,3,11,16,9,20,77
3,15,3,15,1,0,0,37
3,15,4,0,0,0,0,22
3,15,4,5,0,0,0,27
3,15,4,15,14,0,0,51
3,15,6,6,5,5,0,40
3,15,6,6,9,14,0,53
3,15,9,12,0,0,0,39
3,15,9,14,0,0,0,41
3,15,11,5,0,0,0,34
3,15,12,4,0,0,0,34
3,15,12,12,1,18,0,61
3,15,12,12,5,7,5,59
3,15,12,15,14,0,0,59
3,15,12,15,14,25,0,84
3,15,12,15,18,0,0,63
3,15,12,20,0,0,0,50
3,15,12,21,13,14,0,78
3,15,13,2,0,0,0,33
3,15,13,2,1,20,0,54
3,15,13,2,9,14,5,61
3,15,13,6,15,18,20,90
3,15,13,9,3,0,0,43
3,15,13,13,1,0,0,45
3,15,13,13,1,14,4,63
3,15,13,13,5,14,20,83
3,15,13,13,15,14,0,73
3,15,13,16,1,14,25,87
3,15,13,16,12,5,24,88
3,15,13,16,15,19,20,101
3,15,14,3,5,16,20,76
3,15,14,3,5,18,14,72
3,15,14,3,5,18,20,78
3,15,14,4,15,18,0,69
3,15,14,5,0,0,0,37
3,15,14,7,1,0,0,40
3,15,14,7,15,0,0,54
3,15,14,9,6,5,18,70
3,15,14,19,5,14,20,90
3,15,14,19,9,19,20,99
3,15,14,19,15,12,5,83
3,15,14,19,21,12,0,84
3,15,14,20,1,3,20,76
3,15,14,20,5,14,20,91
3,15,14,20,5,19,20,96
3,15,14,20,5,24,20,101
3,15,14,20,18,15,12,97
3,15,14,22,5,18,20,97
3,15,15,11,0,0,0,44
3,15,15,11,9,5,0,58
3,15,15,11,9,14,7,74
3,15,16,5,0,0,0,39
3,15,16,16,5,18,0,73
3,15,16,25,0,0,0,59
3,15,18,4,0,0,0,40
3,15,18,11,0,0,0,47
3,15,18,14,0,0,0,50
3,15,18,14,5,18,0,73
3,15,18,14,5,20,0,75
3,15,18,18,1,12,0,67
3,15,18,19,1,7,5,68
3,15,19,20,0,0,0,57
3,15,19,20,21,13,5,96
3,15,20,0,0,0,0,38
3,15,20,20,1,7,5,71
3,15,20,20,15,14,0,87
3,15,21,3,8,0,0,50
3,15,21,7,1,18,0,65
3,15,21,7,8,0,0,54
3,15,21,14,3,9,12,77
3,15,21,14,20,0,0,73
3,15,21,14,20,5,18,96
3,15,21,14,20,18,25,116
3,15,21,14,20,25,0,98
3,15,21,16,12,5,0,72
3,15,21,18,1,7,5,70
3,15,21,18,19,5,0,81
3,15,21,18,20,0,0,77
3,15,21,19,9,14,0,81
3,15,22,5,18,0,0,63
3,15,23,0,0,0,0,41
3,15,23,2,5,12,12,72
3,15,23,2,15,25,0,83
3,18,1,2,0,0,0,24
3,18,1,3,11,0,0,36
3,18,1,3,11,5,18,59
3,18,1,4,12,5,0,43
3,18,1,6,20,0,0,48
3,18,1,19,8,0,0,49
3,18,1,20,5,0,0,47
3,18,1,22,1,20,0,65
3,18,1,23,0,0,0,45
3,18,1,23,4,1,4,54
3,18,1,25,15,14,0,76
3,18,1,26,25,0,0,73
3,18,5,1,13,0,0,40
3,18,5,1,20,15,18,80
3,18,5,3,8,5,0,42
3,18,5,4,9,20,0,59
3,18,5,5,11,0,0,42
3,18,5,19,20,0,0,65
3,18,5,23,0,0,0,49
3,18,9,2,0,0,0,32
3,18,9,3,11,5,20,69
3,18,9,13,5,0,0,48
3,18,15,3,21,19,0,79
3,18,15,15,11,0,0,62
3,18,15,16,0,0,0,52
3,18,15,19,19,0,0,74
3,18,15,20,3,8,0,67
3,18,15,21,16,0,0,73
3,18,15,23,0,0,0,59
3,18,15,23,4,0,0,63
3,18,15,23,14,0,0,73
3,18,21,4,5,0,0,51
3,18,21,19,8,0,0,69
3,18,25,0,0,0,0,46
3,21,2,0,0,0,0,26
3,21,3,11,15,15,0,68
3,21,12,20,21,18,5,100
3,21,12,22,5,18,20,101
3,21,16,0,0,0,0,40
3,21,16,3,1,11,5,60
3,21,16,15,12,1,0,68
3,21,18,9,15,0,0,66
3,21,18,12,0,0,0,54
3,21,18,12,5,18,0,77
3,21,18,18,5,14,20,99
3,21,18,19,15,18,0,94
3,21,18,20,1,9,14,86
3,21,18,22,5,0,0,69
3,21,19,8,9,15,14,89
3,21,19,20,1,18,4,86
3,21,20,0,0,0,0,44
3,21,20,9,3,12,5,73
3,21,20,12,5,20,0,81
3,21,20,15,22,5,18,104
3,21,20,20,9,14,7,94
3,25,3,12,5,0,0,48
3,25,3,12,15,14,5,77
3,25,13,2,1,12,0,56
3,25,13,2,1,12,19,75
3,25,14,9,3,0,0,54
3,25,19,20,0,0,0,67
4,1,4,0,0,0,0,9
4,1,7,7,5,18,0,42
4,1,8,12,9,1,0,35
4,1,9,19,25,0,0,58
4,1,13,1,7,5,0,31
4,1,13,5,0,0,0,23
4,1,14,3,5,0,0,27
4,1,14,3,5,18,0,45
4,1,14,3,9,14,7,52
4,1,14,7,5,18,0,49
4,1,14,9,5,12,0,45
4,1,18,5,0,0,0,28
4,1,18,11,0,0,0,34
4,1,18,20,0,0,0,43
4,1,19,8,0,0,0,32
4,1,20,1,0,0,0,26
4,1,20,5,0,0,0,30
4,1,22,9,4,0,0,40
4,1,25,0,0,0,0,30
4,1,25,2,5,4,0,41
4,5,1,4,0,0,0,14
4,5,1,12,0,0,0,22
4,5,1,12,5,18,0,45
4,5,1,18,0,0,0,28
4,5,1,20,8,0,0,38
4,5,2,1,20,5,0,37
4,5,2,20,0,0,0,31
4,5,2,20,15,18,0,64
4,5,3,1,4,5,0,22
4,5,3,9,13,1,12,47
4,5,3,11,0,0,0,23
4,5,5,16,0,0,0,30
4,5,5,18,0,0,0,32
4,5,6,5,14,19,5,58
4,5,6,9,3,9,20,56
4,5,7,18,5,5,0,44
4,5,12,1,25,0,0,47
4,5,12,5,20,5,0,51
4,5,12,9,7,8,20,65
4,5,13,1,14,4,0,41
4,5,13,21,18,0,0,61
4,5,14,0,0,0,0,23
4,5,14,9,13,0,0,45
4,5,14,20,9,19,20,91
4,5,16,15,19,9,20,88
4,5,16,20,8,0,0,53
4,5,16,21,20,25,0,91
4,5,18,2,25,0,0,54
4,5,18,18,9,3,11,68
4,5,19,5,18,20,0,71
4,5,19,9,7,14,0,58
4,5,19,9,18,5,0,60
4,5,19,11,0,0,0,39
4,5,19,19,5,18,20,90
4,5,19,20,9,14,25,96
4,5,20,1,9,12,0,51
4,5,22,9,3,5,0,48
4,5,22,9,12,0,0,52
4,5,23,0,0,0,0,32
4,8,15,23,0,0,0,50
4,9,1,4,5,13,0,36
4,9,1,13,15,14,4,60
4,9,1,18,9,19,20,80
4,9,2,2,12,5,0,34
4,9,3,11,5,25,0,57
4,9,3,20,9,15,14,74
4,9,5,20,0,0,0,38
4,9,7,0,0,0,0,20
4,9,7,7,5,18,0,50
4,9,7,9,20,1,12,62
4,9,7,14,9,20,25,88
4,9,12,12,0,0,0,37
4,9,13,5,0,0,0,31
4,9,13,16,12,5,0,59
4,9,14,5,18,0,0,50
4,9,14,7,8,25,0,67
4,9,14,14,5,18,0,64
4,9,16,12,15,13,1,70
4,9,18,14,4,12,0,61
4,9,18,20,0,0,0,51
4,9,19,3,15,0,0,50
4,9,19,5,1,19,5,62
4,9,19,7,21,19,20,99
4,9,19,8,0,0,0,40
4,9,19,8,5,19,0,64
4,9,19,11,0,0,0,43
4,9,19,16,12,1,25,86
4,9,22,1,14,0,0,50
4,9,22,5,18,0,0,58
4,9,22,9,4,5,0,53
4,9,22,9,4,5,18,71
4,9,22,9,14,7,0,65
4,15,3,11,0,0,0,33
4,15,3,20,15,18,0,75
4,15,5,0,0,0,0,24
4,15,7,0,0,0,0,26
4,15,7,19,12,5,4,66
4,15,7,23,15,15,4,83
4,15,12,12,0,0,0,43
4,15,12,12,1,18,0,62
4,15,12,13,1,14,0,59
4,15,12,16,8,9,14,78
4,15,13,1,9,14,0,56
4,15,14,11,5,25,0,74
4,15,15,18,0,0,0,52
4,15,18,25,0,0,0,62
4,15,20,0,0,0,0,39
4,15,21,2,12,5,0,59
4,15,21,2,20,0,0,62
4,15,21,2,20,5,18,85
4,18,1,6,20,0,0,49
4,18,1,7,0,0,0,30
4,18,1,7,15,14,0,59
4,18,1,9,14,0,0,46
4,18,1,11,5,0,0,39
4,18,1,13,1,0,0,37
4,18,1,23,0,0,0,46
4,18,1,23,5,18,0,69
4,18,1,23,9,14,7,76
4,18,5,1,13,0,0,41
4,18,5,4,7,5,18,61
4,18,5,19,19,0,0,65
4,18,5,19,19,5,18,88
4,18,9,12,12,0,0,55
4,18,9,14,11,0,0,56
4,18,9,22,5,0,0,58
4,18,9,22,5,18,0,76
4,18,9,22,9,14,7,83
4,18,9,26,26,12,5,100
4,18,15,16,0,0,0,53
4,18,21,7,0,0,0,50
4,18,21,13,0,0,0,56
4,18,21,13,13,5,18,92
4,18,21,14,11,0,0,68
4,18,25,0,0,0,0,47
4,18,25,5,18,0,0,70
4,21,3,11,0,0,0,39
4,21,4,0,0,0,0,29
4,21,5,0,0,0,0,30
4,21,6,6,5,12,0,54
4,21,7,15,21,20,0,88
4,21,13,16,0,0,0,54
4,21,14,7,5,15,14,80
4,21,19,20,0,0,0,64
4,21,19,20,5,18,0,87
4,21,20,25,0,0,0,70
4,23,1,18,6,0,0,52
4,25,14,1,13,15,0,72
5,1,7,12,5,0,0,30
5,1,18,0,0,0,0,24
5,1,18,4,18,21,13,80
5,1,18,16,12,21,7,80
5,1,18,20,8,0,0,52
5,1,19,5,0,0,0,30
5,1,19,5,12,0,0,42
5,1,19,20,0,0,0,45
5,1,20,0,0,0,0,26
5,1,22,5,0,0,0,33
5,3,12,9,16,19,5,69
5,3,15,14,15,13,25,90
5,4,4,25,0,0,0,38
5,4,7,5,0,0,0,21
5,4,7,5,18,0,0,39
5,4,9,20,15,18,0,71
5,4,23,1,18,4,0,55
5,5,12,0,0,0,0,22
5,6,6,5,3,20,0,45
5,6,6,15,18,20,0,70
5,7,7,0,0,0,0,19
5,7,7,8,5,1,4,37
5,7,7,14,15,7,0,55
5,9,7,8,20,0,0,49
5,10,5,3,20,15,18,76
5,12,2,15,23,0,0,57
5,12,5,13,5,14,20,74
5,12,9,24,9,18,0,77
5,12,11,0,0,0,0,28
5,12,12,9,16,19,5,78
5,12,13,0,0,0,0,30
5,13,5,18,25,0,0,66
5,13,15,20,9,15,14,91
5,13,16,12,15,25,0,86
5,13,21,0,0,0,0,39
5,14,4,0,0,0,0,23
5,14,5,13,25,0,0,62
5,14,5,18,7,25,0,74
5,14,7,9,14,5,0,54
5,14,9,7,13,1,0,49
5,14,17,21,9,18,25,109
5,14,20,18,25,0,0,82
5,14,22,25,0,0,0,66
5,16,5,5,0,0,0,31
5,16,15,3,8,0,0,47
5,16,15,14,25,13,0,88
5,16,15,24,25,0,0,85
5,17,21,1,12,0,0,56
5,17,21,9,14,15,24,105
5,18,1,0,0,0,0,24
5,18,18,15,18,0,0,74
5,19,3,1,16,5,0,49
5,19,5,0,0,0,0,29
5,19,19,1,25,0,0,69
5,19,20,1,20,5,0,70
5,19,20,21,1,18,25,109
5,20,8,9,3,19,0,64
5,21,18,15,16,5,0,80
5,22,5,14,9,14,7,76
5,22,5,14,20,0,0,66
5,24,1,13,0,0,0,43
5,24,1,13,16,12,5,76
5,24,3,21,19,5,0,77
5,24,8,1,21,19,20,98
5,24,9,12,5,0,0,55
5,24,9,20,0,0,0,58
5,24,16,5,18,20,0,88
5,24,20,5,14,20,0,88
5,24,20,18,5,13,5,90
5,25,5,0,0,0,0,35
5,25,5,2,1,12,12,62
5,25,5,2,18,15,23,93
5,25,5,12,1,19,8,75
5,25,5,12,9,4,0,60
5,25,5,12,9,4,19,79
6,1,3,5,0,0,0,15
6,1,3,5,20,0,0,35
6,1,3,20,0,0,0,30
6,1,3,20,15,18,0,63
6,1,3,20,15,18,25,88
6,1,3,21,12,20,25,88
6,1,9,12,0,0,0,28
6,1,9,12,21,18,5,72
6,1,9,18,9,5,19,67
6,1,9,18,25,0,0,59
6,1,9,20,8,0,0,44
6,1,12,12,0,0,0,31
6,1,13,5,0,0,0,25
6,1,13,9,12,25,0,66
6,1,14,0,0,0,0,21
6,1,14,7,0,0,0,28
6,1,14,14,25,0,0,60
6,1,18,13,0,0,0,38
6,1,18,13,5,18,0,61
6,1,19,3,9,1,0,39
6,1,20,0,0,0,0,27
6,1,20,8,5,18,0,58
6,1,21,3,5,20,0,56
6,1,21,12,20,0,0,60
6,1,23,14,0,0,0,44
6,1,24,0,0,0,0,31
6,5,1,18,0,0,0,30
6,5,1,19,20,0,0,51
6,5,1,20,8,5,18,63
6,5,1,20,21,18,5,76
6,5,4,15,18,1,0,49
6,5,5,0,0,0,0,16
6,5,5,4,0,0,0,20
6,5,5,12,0,0,0,28
6,5,5,12,9,14,7,58
6,5,5,20,0,0,0,36
6,5,12,15,14,25,0,77
6,5,13,1,12,5,0,42
6,5,14,0,0,0,0,25
6,5,14,3,5,0,0,33
6,5,14,3,9,14,7,58
6,5,14,4,5,18,0,52
6,5,18,18,25,0,0,72
6,5,23,0,0,0,0,34
6,9,2,5,18,0,0,40
6,9,2,18,5,0,0,40
6,9,3,20,9,15,14,76
6,9,4,4,12,5,0,40
6,9,5,12,4,0,0,36
6,9,6,20,8,0,0,49
6,9,7,8,20,0,0,50
6,9,7,8,20,5,18,73
6,9,7,21,18,5,0,66
6,9,12,5,0,0,0,32
6,9,12,12,0,0,0,39
6,9,12,12,25,0,0,64
6,9,12,13,0,0,0,40
6,9,12,20,8,0,0,55
6,9,14,1,12,0,0,42
6,9,14,1,14,3,5,52
6,9,14,4,0,0,0,33
6,9,14,4,9,14,7,63
6,9,14,5,0,0,0,34
6,9,14,7,5,18,0,59
6,9,14,9,19,8,0,65
6,9,18,0,0,0,0,33
6,9,18,5,0,0,0,38
6,9,18,5,13,1,14,66
6,9,19,8,0,0,0,42
6,9,19,8,5,18,25,90
6,9,19,8,9,14,7,72
6,9,19,8,14,5,20,81
6,9,19,20,9,14,7,84
6,9,24,0,0,0,0,39
6,9,24,20,21,18,5,103
6,12,1,7,0,0,0,26
6,12,1,13,5,0,0,37
6,12,1,14,11,5,18,67
6,12,1,18,5,0,0,42
6,12,1,19,8,0,0,46
6,12,1,20,0,0,0,39
6,12,1,22,15,18,0,74
6,12,1,24,0,0,0,43
6,12,5,3,11,0,0,37
6,12,5,5,3,5,0,36
6,12,5,19,8,0,0,50
6,12,9,7,8,20,0,62
6,12,15,3,11,0,0,47
6,12,15,15,4,0,0,52
6,12,15,15,18,0,0,66
6,12,15,15,26,9,5,88
6,12,15,21,18,0,0,72
6,12,15,23,0,0,0,56
6,12,15,23,5,18,0,79
6,12,21,0,0,0,0,39
6,12,21,11,5,0,0,55
6,12,21,20,5,0,0,64
6,12,25,0,0,0,0,43
6,12,25,20,18,1,16,98
6,15,1,13,0,0,0,35
6,15,2,0,0,0,0,23
6,15,3,21,19,0,0,64
6,15,7,0,0,0,0,28
6,15,12,4,0,0,0,37
6,15,12,4,5,18,0,60
6,15,14,4,21,5,0,65
6,15,14,20,0,0,0,55
6,15,15,4,0,0,0,40
6,15,15,20,0,0,0,56
6,15,18,1,25,0,0,65
6,15,18,3,5,0,0,47
6,15,18,5,1,18,13,76
6,15,18,5,19,20,0,83
6,15,18,5,22,5,18,89
6,15,18,7,5,18,25,94
6,15,18,11,0,0,0,50
6,15,18,13,0,0,0,52
6,15,18,13,1,12,0,65
6,15,18,13,1,20,0,73
6,15,18,13,5,18,0,75
6,15,18,20,0,0,0,59
6,15,18,20,21,14,5,99
6,15,18,21,13,0,0,73
6,15,23,12,0,0,0,56
6,15,24,0,0,0,0,45
6,18,1,13,5,0,0,43
6,18,1,26,26,12,5,94
6,18,5,3,11,12,5,60
6,18,5,5,4,15,13,66
6,18,5,5,26,5,0,65
6,18,5,5,26,5,18,83
6,18,5,9,7,8,20,73
6,18,5,15,14,0,0,58
6,18,5,19,3,15,0,66
6,18,9,4,7,5,0,49
6,18,9,5,14,4,0,56
6,18,9,7,1,20,5,66
6,18,9,14,7,5,0,59
6,18,15,3,11,0,0,53
6,18,15,7,0,0,0,46
6,18,15,14,20,0,0,73
6,18,15,19,20,0,0,78
6,18,15,23,14,0,0,76
6,18,21,9,20,0,0,74
6,21,5,12,0,0,0,44
6,21,12,12,0,0,0,51
6,21,14,0,0,0,0,41
6,21,14,5,18,1,12,77
6,21,14,14,25,0,0,80
6,21,18,0,0,0,0,45
6,21,18,14,1,3,5,68
6,21,20,15,14,0,0,76
6,21,20,21,18,5,0,91
7,1,6,6,5,18,0,43
7,1,9,14,0,0,0,31
7,1,9,20,5,18,19,79
7,1,12,5,0,0,0,25
7,1,12,12,5,18,25,80
7,1,12,12,5,25,0,62
7,1,12,12,15,14,0,61
7,1,12,14,0,0,0,34
7,1,13,5,0,0,0,26
7,1,14,4,5,18,0,49
7,1,16,0,0,0,0,24
7,1,18,1,7,5,0,39
7,1,18,2,0,0,0,28
7,1,18,2,1,7,5,41
7,1,18,4,5,14,0,49
7,1,18,12,9,3,0,50
7,1,18,13,5,14,20,78
7,1,18,20,5,18,0,69
7,1,19,0,0,0,0,27
7,1,20,5,0,0,0,33
7,1,20,5,23,1,25,82
7,1,20,8,5,18,0,59
7,1,21,7,5,0,0,41
7,1,26,5,2,15,0,56
7,1,26,5,12,12,5,68
7,5,1,18,0,0,0,31
7,5,5,19,5,0,0,41
7,5,12,4,9,14,7,58
7,5,13,0,0,0,0,25
7,5,13,19,2,15,11,72
7,5,14,4,5,18,0,53
7,5,14,5,0,0,0,31
7,5,14,5,18,1,12,62
7,5,15,12,15,7,25,86
7,5,15,18,7,5,0,57
7,5,18,2,9,12,0,53
7,5,25,19,5,18,0,79
7,8,5,18,11,9,14,72
7,8,15,19,20,0,0,69
7,9,1,14,20,0,0,51
7,9,6,20,0,0,0,42
7,9,14,19,5,14,7,75
7,9,18,1,6,6,5,52
7,9,18,4,12,5,0,55
7,9,18,12,0,0,0,46
7,9,20,0,0,0,0,36
7,9,22,5,0,0,0,43
7,12,1,4,0,0,0,24
7,12,1,14,4,0,0,38
7,12,1,19,19,0,0,58
7,12,1,19,19,5,19,82
7,12,5,14,0,0,0,38
7,12,9,4,5,18,0,55
7,12,9,4,9,14,7,62
7,12,15,22,5,0,0,61
7,12,15,22,5,19,0,80
7,12,21,5,0,0,0,45
7,12,21,20,0,0,0,60
7,15,0,0,0,0,0,22
7,15,1,12,0,0,0,35
7,15,1,20,0,0,0,43
7,15,2,2,12,5,18,61
7,15,4,0,0,0,0,26
7,15,7,7,12,5,19,72
7,15,12,4,0,0,0,38
7,15,12,6,0,0,0,40
7,15,14,4,15,12,1,68
7,15,14,7,0,0,0,43
7,15,15,4,0,0,0,41
7,15,15,4,2,25,5,73
7,15,15,4,9,5,0,55
7,15,15,19,5,0,0,61
7,15,16,8,5,18,0,69
7,15,18,9,12,12,1,74
7,15,19,12,9,14,7,83
7,15,19,19,9,16,0,85
7,15,23,14,0,0,0,59
7,18,1,2,0,0,0,28
7,18,1,4,5,0,0,35
7,18,1,9,14,0,0,49
7,18,1,13,0,0,0,39
7,18,1,13,13,1,18,71
7,18,1,14,4,0,0,44
7,18,1,14,14,25,0,79
7,18,1,16,5,0,0,47
7,18,1,16,8,0,0,50
7,18,1,16,8,9,3,62
7,18,1,19,19,0,0,64
7,18,1,25,0,0,0,51
7,18,5,1,19,5,0,55
7,18,5,1,20,0,0,51
7,18,5,5,11,0,0,46
7,18,5,5,14,0,0,49
7,18,5,14,1,4,5,54
7,18,5,25,0,0,0,55
7,18,9,5,6,0,0,45
7,18,9,12,12,0,0,58
7,18,9,16,0,0,0,50
7,18,9,20,0,0,0,54
7,18,15,3,5,18,25,91
7,18,15,21,14,4,0,79
7,18,15,21,16,0,0,77
7,18,15,21,16,5,18,100
7,18,15,21,19,5,0,85
7,18,15,23,20,8,0,91
7,21,1,18,4,0,0,51
7,21,5,19,19,0,0,71
7,21,5,19,20,0,0,72
7,21,9,4,5,0,0,46
7,21,9,12,20,0,0,69
7,21,9,12,20,25,0,94
7,21,9,20,1,18,0,76
7,21,13,0,0,0,0,41
7,21,14,0,0,0,0,42
7,21,20,20,5,18,0,91
7,21,25,0,0,0,0,53
7,25,13,0,0,0,0,45
7,25,13,14,1,19,20,99
7,25,18,15,0,0,0,65
8,1,2,9,20,0,0,40
8,1,3,11,19,1,23,66
8,1,9,12,0,0,0,30
8,1,9,18,0,0,0,36
8,1,9,18,3,21,20,80
8,1,12,6,0,0,0,27
8,1,12,9,2,21,20,73
8,1,12,12,0,0,0,33
8,1,12,12,23,1,25,82
8,1,13,1,11,9,0,43
8,1,13,13,5,18,0,58
8,1,13,13,15,3,11,64
8,1,13,19,20,5,18,84
8,1,14,4,0,0,0,27
8,1,14,4,12,5,0,44
8,1,14,4,19,1,23,70
8,1,14,7,0,0,0,30
8,1,18,2,15,18,0,62
8,1,18,2,15,21,18,83
8,1,18,4,8,1,20,60
8,1,18,13,0,0,0,40
8,1,18,13,15,14,25,94
8,1,18,16,0,0,0,43
8,1,19,19,15,3,11,76
8,1,20,0,0,0,0,29
8,1,20,2,15,24,0,70
8,1,20,3,8,5,20,65
8,1,20,5,0,0,0,34
8,1,20,18,5,4,0,56
8,1,21,14,20,0,0,64
8,1,23,11,0,0,0,43
8,1,25,0,0,0,0,34
8,5,1,4,0,0,0,18
8,5,1,12,20,8,0,54
8,5,1,18,9,14,7,62
8,5,1,18,20,0,0,52
8,5,1,18,20,8,0,60
8,5,1,20,0,0,0,34
8,5,1,20,5,18,0,57
8,5,1,22,5,14,0,55
8,5,1,22,25,0,0,61
8,5,4,7,5,0,0,29
8,5,5,12,0,0,0,30
8,5,9,7,8,20,0,57
8,5,12,5,14,0,0,44
8,5,12,9,21,13,0,68
8,5,12,12,0,0,0,37
8,5,12,12,3,1,20,61
8,5,12,12,15,0,0,52
8,5,12,13,5,20,0,63
8,5,12,15,0,0,0,40
8,5,12,16,0,0,0,41
8,5,13,16,0,0,0,42
8,5,14,0,0,0,0,27
8,5,18,2,0,0,0,33
8,5,18,15,14,0,0,60
8,5,18,18,9,14,7,79
8,5,24,1,7,15,14,74
8,5,25,4,1,25,0,68
8,9,4,5,0,0,0,26
8,9,7,8,0,0,0,32
8,9,7,8,23,1,25,81
8,9,12,12,0,0,0,41
8,9,16,0,0,0,0,33
8,9,18,5,0,0,0,40
8,9,19,20,15,18,25,114
8,9,20,0,0,0,0,37
8,9,22,5,0,0,0,44
8,15,2,2,9,5,19,60
8,15,2,2,9,20,0,56
8,15,2,2,25,0,0,52
8,15,3,11,5,25,0,67
8,15,5,0,0,0,0,28
8,15,7,0,0,0,0,30
8,15,12,4,0,0,0,39
8,15,12,5,0,0,0,40
8,15,12,9,4,1,25,74
8,15,13,5,0,0,0,41
8,15,13,15,14,25,13,103
8,15,14,5,19,20,25,106
8,15,14,5,25,0,0,67
8,15,14,15,18,5,5,80
8,15,15,4,0,0,0,42
8,15,15,6,0,0,0,44
8,15,15,11,0,0,0,49
8,15,16,5,0,0,0,44
8,15,16,19,0,0,0,58
8,15,18,14,0,0,0,55
8,15,18,14,5,20,0,80
8,15,18,18,15,18,0,92
8,15,18,19,5,0,0,65
8,15,19,5,0,0,0,47
8,15,19,9,5,18,25,99
8,15,19,16,9,3,5,75
8,15,19,20,0,0,0,62
8,15,19,20,5,12,0,79
8,15,19,20,5,19,19,105
8,15,20,0,0,0,0,43
8,15,20,5,12,0,0,60
8,15,21,18,0,0,0,62
8,15,21,19,5,0,0,68
8,15,21,19,9,14,7,93
8,15,22,5,12,0,0,62
8,21,2,0,0,0,0,31
8,21,2,3,1,16,0,51
8,21,7,7,5,18,0,66
8,21,13,1,14,0,0,57
8,21,13,15,18,0,0,75
8,21,13,15,21,18,0,96
8,21,14,7,5,18,0,73
8,21,14,20,0,0,0,63
8,21,18,4,12,5,18,86
8,21,18,18,25,0,0,90
8,21,18,20,0,0,0,67
8,21,19,2,1,14,4,69
8,21,20,0,0,0,0,49
8,21,20,3,8,0,0,60
8,25,4,18,1,14,20,90
8,25,5,14,1,0,0,53
9,3,5,0,0,0,0,17
9,3,9,3,12,5,0,41
9,3,15,14,0,0,0,41
9,4,5,1,0,0,0,19
9,4,5,1,12,0,0,31
9,6,0,0,0,0,0,15
9,7,12,15,15,0,0,58
9,11,5,2,1,14,1,43
9,12,12,5,7,1,12,58
9,13,1,7,5,0,0,35
9,13,16,1,3,20,0,62
9,13,16,18,5,19,19,99
9,13,16,21,12,19,5,95
9,14,2,15,24,0,0,64
9,14,3,8,0,0,0,34
9,14,3,15,13,5,0,59
9,14,4,5,24,0,0,56
9,14,6,1,14,3,25,72
9,14,7,18,1,20,5,74
9,14,9,20,9,1,12,74
9,14,10,21,18,25,0,97
9,14,11,0,0,0,0,34
9,14,12,1,25,0,0,61
9,14,14,0,0,0,0,37
9,14,16,21,20,0,0,80
9,14,17,21,9,18,25,113
9,14,19,5,3,20,0,70
9,14,19,9,4,5,0,60
9,14,22,9,20,5,0,79
9,14,22,15,9,3,5,77
9,18,9,19,0,0,0,55
9,18,15,14,0,0,0,56
9,18,15,14,25,0,0,81
9,19,12,1,14,4,0,59
9,19,19,21,5,0,0,73
9,20,0,0,0,0,0,29
9,20,5,13,0,0,0,47
10,1,3,11,1,12,0,38
10,1,3,11,5,20,0,50
10,1,7,21,1,18,0,58
10,1,9,12,0,0,0,32
10,1,13,0,0,0,0,24
10,1,13,5,19,0,0,48
10,1,18,0,0,0,0,29
10,1,19,13,9,14,5,71
10,1,23,0,0,0,0,34
10,5,1,14,19,0,0,49
10,5,5,16,0,0,0,36
10,5,6,6,0,0,0,27
10,5,12,12,25,0,0,64
10,5,20,0,0,0,0,35
10,5,23,5,12,0,0,55
10,5,23,5,12,18,25,98
10,9,6,6,25,0,0,56
10,15,2,0,0,0,0,27
10,15,3,11,5,25,0,69
10,15,5,25,0,0,0,55
10,15,7,7,9,14,7,69
10,15,9,14,0,0,0,48
10,15,9,14,20,0,0,68
10,15,11,5,0,0,0,41
10,15,20,0,0,0,0,45
10,15,21,18,14,5,25,108
10,15,25,0,0,0,0,50
10,21,4,7,5,0,0,47
10,21,4,15,0,0,0,50
10,21,9,3,5,0,0,48
10,21,13,2,15,0,0,61
10,21,13,16,0,0,0,60
10,21,13,16,5,18,0,83
10,21,14,9,15,18,0,87
10,21,14,11,0,0,0,56
10,21,14,11,5,18,0,79
10,21,14,11,5,20,0,81
10,21,18,25,0,0,0,74
10,21,19,20,9,3,5,87
10,21,20,5,0,0,0,56
11,1,12,5,0,0,0,29
11,1,18,1,20,5,0,56
11,1,18,5,14,0,0,49
11,1,25,1,11,0,0,49
11,1,26,15,15,0,0,68
11,5,5,16,0,0,0,37
11,5,14,4,15,0,0,49
11,5,20,3,8,0,0,47
11,5,20,3,8,21,16,84
11,5,20,20,12,5,0,73
11,5,25,0,0,0,0,41
11,9,3,11,0,0,0,34
11,9,4,0,0,0,0,24
11,9,4,14,5,25,0,68
11,9,4,14,5,25,19,87
11,9,12,12,0,0,0,44
11,9,12,20,0,0,0,52
11,9,13,15,14,15,0,77
11,9,14,4,0,0,0,38
11,9,14,7,0,0,0,41
11,9,15,19,11,0,0,65
11,9,19,19,0,0,0,58
11,9,20,3,8,5,14,70
11,9,20,5,0,0,0,45
11,9,20,20,5,14,0,79
11,9,20,20,25,0,0,85
11,12,5,5,14,5,24,76
11,12,15,13,16,19,0,86
11,14,5,5,0,0,0,35
11,14,9,6,5,0,0,45
11,14,9,7,8,20,0,69
11,14,15,20,0,0,0,60
11,14,21,3,11,12,5,77
11,15,1,12,1,0,0,40
12,1,2,0,0,0,0,15
12,1,2,15,18,5,18,71
12,1,2,15,21,18,0,69
12,1,3,5,0,0,0,21
12,1,3,11,0,0,0,27
12,1,4,4,5,18,0,44
12,1,4,25,0,0,0,42
12,1,4,25,2,21,7,72
12,1,11,5,0,0,0,29
12,1,13,2,0,0,0,28
12,1,13,16,0,0,0,42
12,1,14,0,0,0,0,27
12,1,14,1,9,0,0,37
12,1,14,4,0,0,0,31
12,1,14,20,5,18,14,84
12,1,16,0,0,0,0,29
12,1,16,4,15,7,0,55
12,1,16,20,15,16,0,80
12,1,18,3,8,0,0,42
12,1,18,4,5,18,0,58
12,1,18,11,0,0,0,42
12,1,19,1,7,14,1,55
12,1,20,5,14,3,25,80
12,1,20,5,24,0,0,62
12,1,20,8,5,0,0,46
12,1,20,20,5,0,0,58
12,1,21,7,8,0,0,49
12,1,21,14,4,18,25,95
12,1,22,1,0,0,0,36
12,1,23,0,0,0,0,36
12,1,23,14,0,0,0,50
12,1,23,19,21,9,20,105
12,1,23,25,5,18,0,84
12,1,25,0,0,0,0,38
12,1,25,5,18,0,0,61
12,5,1,4,0,0,0,22
12,5,1,4,5,18,0,45
12,5,1,4,9,14,7,52
12,5,1,6,0,0,0,24
12,5,1,7,21,5,0,51
12,5,1,11,5,18,0,52
12,5,1,19,8,0,0,45
12,5,1,20,8,5,18,69
12,5,1,22,5,0,0,45
12,5,1,22,5,18,0,63
12,5,3,20,21,18,5,84
12,5,5,11,0,0,0,33
12,5,7,0,0,0,0,24
12,5,7,1,12,0,0,37
12,5,7,7,9,14,7,61
12,5,7,21,13,5,0,63
12,5,9,0,0,0,0,26
12,5,9,19,21,18,5,89
12,5,13,15,14,0,0,59
12,5,13,21,18,0,0,69
12,5,14,7,20,8,0,66
12,5,14,20,9,12,0,72
12,5,16,18,15,19,25,110
12,5,19,19,15,14,0,84
12,5,20,0,0,0,0,37
12,5,20,20,5,18,0,80
12,5,20,20,21,3,5,86
12,5,22,5,12,0,0,56
12,5,22,5,18,0,0,62
12,9,3,5,14,19,5,67
12,9,5,0,0,0,0,26
12,9,5,18,0,0,0,44
12,9,6,5,0,0,0,32
12,9,6,20,0,0,0,47
12,9,7,8,20,0,0,56
12,9,12,1,3,0,0,37
12,9,12,25,0,0,0,58
12,9,13,9,20,0,0,63
12,9,13,15,0,0,0,49
12,9,14,5,0,0,0,40
12,9,14,5,14,0,0,54
12,9,14,5,18,0,0,58
12,9,14,11,0,0,0,46
12,9,14,19,5,5,4,68
12,9,15,14,0,0,0,50
12,9,16,0,0,0,0,37
12,9,17,21,9,4,0,72
12,9,17,21,15,18,0,92
12,9,19,1,0,0,0,41
12,9,19,20,0,0,0,60
12,9,19,20,5,14,0,79
12,9,20,20,5,18,0,84
12,9,22,5,18,0,0,66
12,9,22,9,14,7,0,73
12,9,26,1,18,4,0,70
12,12,1,13,1,0,0,39
12,15,1,4,0,0,0,32
12,15,1,6,0,0,0,34
12,15,1,6,5,18,0,57
12,15,1,14,0,0,0,42
12,15,2,19,20,5,18,91
12,15,3,1,12,0,0,43
12,15,3,11,0,0,0,41
12,15,3,11,5,18,0,64
12,15,3,11,5,20,0,66
12,15,3,21,19,20,0,90
12,15,6,20,0,0,0,53
12,15,7,0,0,0,0,34
12,15,7,7,9,1,0,51
12,15,7,9,3,0,0,46
12,15,14,7,0,0,0,48
12,15,15,11,0,0,0,53
12,15,19,19,0,0,0,65
12,15,20,0,0,0,0,47
12,15,20,9,15,14,0,85
12,15,21,14,7,5,0,74
12,15,21,20,0,0,0,68
12,15,22,5,0,0,0,54
12,15,23,0,0,0,0,50
12,15,25,1,12,20,25,110
12,21,3,11,0,0,0,47
12,21,7,7,1,7,5,60
12,21,13,2,5,18,0,71
12,21,14,3,8,0,0,58
12,21,14,7,0,0,0,54
12,21,14,7,5,0,0,59
12,21,20,5,0,0,0,58
12,21,20,20,21,3,5,102
12,25,3,18,1,0,0,59
12,25,5,0,0,0,0,42
12,25,14,24,0,0,0,75
12,25,15,3,5,12,12,84
12,25,18,5,0,0,0,60
12,25,18,9,3,0,0,67
13,1,3,8,9,14,5,53
13,1,3,18,1,13,5,54
13,1,5,19,20,18,15,91
13,1,7,9,3,0,0,33
13,1,9,4,0,0,0,27
13,1,9,4,5,14,0,46
13,1,9,12,0,0,0,35
13,1,9,12,2,15,24,76
13,1,9,12,13,1,14,63
13,1,9,14,0,0,0,37
13,1,10,15,18,0,0,57
13,1,11,5,0,0,0,30
13,1,11,5,21,16,0,67
13,1,12,5,0,0,0,31
13,1,12,12,0,0,0,38
13,1,12,12,5,20,0,63
13,1,13,2,15,0,0,44
13,1,13,13,15,20,8,83
13,1,14,0,0,0,0,28
13,1,14,1,7,5,18,59
13,1,14,8,21,14,20,91
13,1,14,9,1,3,0,41
13,1,14,11,9,14,4,66
13,1,14,14,5,18,0,65
13,1,14,15,18,0,0,61
13,1,14,19,1,18,4,70
13,1,14,19,9,15,14,85
13,1,14,20,5,12,0,65
13,1,14,20,12,5,0,65
13,1,14,20,21,1,0,70
13,1,14,24,0,0,0,52
13,1,14,25,0,0,0,53
13,1,16,0,0,0,0,30
13,1,16,12,5,0,0,47
13,1,18,1,3,1,0,37
13,1,18,1,3,1,19,56
13,1,18,2,12,5,0,51
13,1,18,5,0,0,0,37
13,1,18,7,9,14,0,62
13,1,18,9,13,2,1,57
13,1,18,11,0,0,0,43
13,1,18,11,5,20,0,68
13,1,18,19,8,0,0,59
13,1,18,24,9,19,13,97
13,1,19,3,1,18,1,56
13,1,19,11,0,0,0,44
13,1,19,19,0,0,0,52
13,1,19,19,1,7,5,65
13,1,19,20,5,18,0,76
13,1,19,20,15,9,4,81
13,1,20,0,0,0,0,34
13,1,20,3,8,0,0,45
13,1,20,5,0,0,0,39
13,1,20,8,0,0,0,42
13,1,20,20,5,18,0,77
13,1,20,20,15,3,11,83
13,1,24,9,13,21,13,94
13,1,25,2,5,0,0,46
13,1,25,15,18,0,0,72
13,5,1,12,0,0,0,31
13,5,1,14,9,14,7,63
13,5,1,19,12,5,19,74
13,5,1,19,21,18,5,82
13,5,1,20,0,0,0,39
13,5,4,9,1,0,0,32
13,5,4,9,21,13,0,65
13,5,5,20,0,0,0,43
13,5,5,20,9,14,7,73
13,5,12,15,4,25,0,74
13,5,13,2,5,18,0,56
13,5,13,15,18,25,0,89
13,5,14,0,0,0,0,32
13,5,14,15,18,1,8,74
13,5,14,20,9,15,14,90
13,5,14,21,0,0,0,53
13,5,18,3,21,18,25,103
13,5,19,19,0,0,0,56
13,5,19,19,1,7,5,69
13,5,20,1,12,0,0,51
13,5,20,5,15,18,0,76
13,5,20,5,18,0,0,61
13,5,20,8,1,14,5,66
13,5,20,8,15,4,0,65
13,5,20,18,15,0,0,71
13,9,3,5,0,0,0,30
13,9,4,4,12,5,0,47
13,9,4,9,0,0,0,35
13,9,4,12,9,14,5,66
13,9,4,23,9,6,5,69
13,9,7,8,20,0,0,57
13,9,7,18,1,14,20,82
13,9,12,5,0,0,0,39
13,9,12,11,0,0,0,45
13,9,13,5,0,0,0,40
13,9,13,15,19,1,0,70
13,9,14,4,0,0,0,40
13,9,14,5,0,0,0,41
13,9,14,9,0,0,0,45
13,9,14,9,2,21,19,87
13,9,14,9,13,21,13,92
13,9,14,9,15,14,0,74
13,9,14,15,18,0,0,69
13,9,14,20,0,0,0,56
13,9,14,21,20,5,0,82
13,9,18,18,15,18,0,91
13,9,19,6,9,20,0,76
13,9,19,19,0,0,0,60
13,9,19,19,9,12,5,86
13,9,19,19,9,15,14,98
13,9,19,20,0,0,0,61
13,9,19,20,1,11,5,78
13,9,19,20,5,18,0,84
13,9,20,5,18,0,0,65
13,9,20,20,5,14,0,81
13,9,24,0,0,0,0,46
13,9,24,5,18,0,0,69
13,9,24,20,21,18,5,110
13,15,1,20,0,0,0,49
13,15,2,9,12,5,0,56
13,15,3,8,1,0,0,40
13,15,4,5,0,0,0,37
13,15,4,5,12,0,0,49
13,15,4,5,13,0,0,50
13,15,12,5,0,0,0,45
13,15,13,0,0,0,0,41
13,15,13,5,14,20,0,80
13,15,14,5,25,0,0,72
13,15,14,7,5,18,0,72
13,15,14,9,20,15,18,104
13,15,14,11,5,25,0,83
13,15,14,15,3,12,5,77
13,15,14,19,15,15,14,105
13,15,14,19,20,5,18,104
13,15,14,20,8,0,0,70
13,15,15,4,0,0,0,47
13,15,15,14,0,0,0,57
13,15,16,0,0,0,0,44
13,15,18,14,9,14,7,90
13,15,18,19,5,12,0,82
13,15,18,20,9,19,5,99
13,15,19,17,21,5,0,90
13,15,19,20,0,0,0,67
13,15,20,5,12,0,0,65
13,15,20,8,0,0,0,56
13,15,20,8,5,18,0,79
13,15,20,9,15,14,0,86
13,15,20,15,18,0,0,81
13,15,21,14,4,0,0,67
13,15,21,19,5,0,0,73
13,15,21,19,5,18,0,91
13,15,21,19,19,5,0,92
13,15,21,20,8,0,0,77
13,15,21,20,15,14,0,98
13,15,22,5,0,0,0,55
13,15,22,5,18,0,0,73
13,15,22,9,5,0,0,64
13,15,23,5,18,0,0,74
13,21,4,0,0,0,0,38
13,21,7,0,0,0,0,41
13,21,11,12,21,11,0,89
13,21,12,5,0,0,0,51
13,21,19,3,12,5,0,73
13,21,19,5,21,13,0,92
13,21,19,9,3,0,0,65
13,21,19,20,1,18,4,96
13,21,20,20,0,0,0,74
14,1,9,12,0,0,0,36
14,1,13,5,0,0,0,33
14,1,13,9,14,7,0,58
14,1,16,11,9,14,0,65
14,1,19,20,25,0,0,79
14,1,20,9,15,14,0,73
14,1,20,9,22,5,0,71
14,1,20,21,18,1,12,87
14,1,20,21,18,5,0,79
14,5,1,20,0,0,0,40
14,5,3,11,0,0,0,33
14,5,3,11,20,9,5,67
14,5,5,4,0,0,0,28
14,5,5,4,12,5,0,45
14,5,15,14,0,0,0,48
14,5,16,8,5,23,0,71
14,5,18,22,5,0,0,64
14,5,19,20,0,0,0,58
14,5,20,0,0,0,0,39
14,5,20,2,1,12,12,66
14,5,20,2,15,15,11,82
14,5,20,19,21,11,5,95
14,5,20,23,15,18,11,106
14,5,23,19,0,0,0,61
14,5,24,21,19,0,0,83
14,9,3,5,20,25,0,76
14,9,3,8,5,0,0,39
14,9,3,11,5,12,0,54
14,9,5,3,5,0,0,36
14,9,7,8,20,0,0,58
14,15,2,15,4,25,0,75
14,15,4,5,0,0,0,38
14,15,9,19,5,0,0,62
14,15,15,4,12,5,0,65
14,15,18,13,1,12,0,73
14,15,18,19,5,0,0,71
14,15,18,20,8,0,0,75
14,15,19,5,0,0,0,53
14,15,20,5,0,0,0,54
14,15,20,8,9,14,7,87
14,15,20,9,3,5,0,66
14,15,20,9,6,25,0,89
14,15,21,7,1,20,0,78
14,15,22,5,12,0,0,68
14,21,4,7,5,0,0,51
14,21,13,2,5,18,0,73
14,21,13,5,18,9,3,83
14,21,18,19,5,0,0,77
14,21,18,19,5,18,25,120
14,21,18,20,21,18,5,117
14,21,20,0,0,0,0,55
14,25,12,15,14,0,0,80
15,1,11,0,0,0,0,27
15,1,18,0,0,0,0,34
15,1,19,9,19,0,0,63
15,1,20,13,5,1,12,67
15,2,5,19,9,20,25,95
15,2,9,0,0,0,0,26
15,2,10,5,3,20,0,55
15,2,15,5,0,0,0,37
15,3,5,1,14,0,0,38
15,3,5,12,15,20,0,70
15,3,20,1,7,15,14,75
15,3,20,1,22,5,0,66
15,3,20,1,22,15,0,76
15,3,20,5,20,0,0,63
15,3,20,15,16,21,19,109
15,5,21,22,18,5,0,86
15,6,6,5,14,3,5,54
15,6,6,5,18,0,0,50
15,6,6,9,3,5,0,44
15,6,6,9,3,5,18,62
15,9,12,0,0,0,0,36
15,11,18,1,0,0,0,45
15,12,4,9,5,0,0,45
15,12,9,22,5,0,0,63
15,13,5,7,1,0,0,41
15,13,5,12,5,20,0,70
15,14,5,0,0,0,0,34
15,14,9,15,14,0,0,67
15,16,5,14,0,0,0,50
15,16,5,14,9,14,7,80
15,16,5,18,1,0,0,55
15,16,9,14,9,15,14,92
15,16,9,21,13,0,0,74
15,16,15,19,19,21,13,118
15,16,20,9,15,14,0,89
15,18,1,14,7,5,0,60
15,18,1,20,15,18,0,87
15,18,3,8,1,18,4,67
15,18,3,8,9,4,0,57
15,18,4,5,18,0,0,60
15,18,7,1,14,0,0,55
15,19,13,15,19,9,19,109
15,19,16,18,5,25,0,98
15,19,20,18,9,3,8,92
15,20,8,5,18,0,0,66
15,20,8,5,18,19,0,85
15,20,20,0,0,0,0,55
15,20,20,5,18,0,0,78
15,21,14,3,5,0,0,58
15,21,20,2,1,3,11,73
15,21,20,3,15,13,5,92
15,21,20,6,9,20,0,91
15,21,20,12,1,25,0,94
15,21,20,16,21,20,0,113
15,21,20,19,5,20,0,100
15,21,20,19,9,4,5,93
15,22,1,12,0,0,0,50
15,22,1,18,25,0,0,81
15,22,5,14,0,0,0,56
15,23,12,0,0,0,0,50
15,23,14,5,18,0,0,75
15,24,0,0,0,0,0,39
15,24,5,14,0,0,0,58
15,24,6,15,18,4,0,82
15,24,25,7,5,14,0,90
15,25,19,20,5,18,0,102
16,1,3,5,0,0,0,25
16,1,3,11,0,0,0,31
16,1,3,11,1,7,5,44
16,1,3,11,5,20,0,56
16,1,4,0,0,0,0,21
16,1,4,4,12,5,0,42
16,1,4,4,15,3,11,54
16,1,7,5,0,0,0,29
16,1,7,15,4,1,0,44
16,1,9,12,0,0,0,38
16,1,9,14,0,0,0,40
16,1,9,14,20,0,0,60
16,1,9,14,20,5,18,83
16,1,9,18,0,0,0,44
16,1,10,1,13,1,0,42
16,1,10,1,13,1,19,61
16,1,12,13,0,0,0,42
16,1,14,0,0,0,0,31
16,1,14,3,1,11,5,51
16,1,14,4,1,0,0,36
16,1,14,9,3,0,0,43
16,1,14,14,9,5,18,77
16,1,14,16,9,16,5,77
16,1,14,19,25,0,0,75
16,1,14,20,8,5,18,82
16,1,14,20,9,5,19,84
16,1,14,20,18,25,0,94
16,1,14,20,19,0,0,70
16,1,14,20,25,0,0,76
16,1,16,5,18,0,0,56
16,1,18,1,2,12,5,55
16,1,18,1,4,5,0,45
16,1,18,3,5,12,0,55
16,1,18,4,0,0,0,39
16,1,18,5,14,20,0,74
16,1,18,11,0,0,0,46
16,1,18,11,1,0,0,47
16,1,18,11,9,14,7,76
16,1,18,18,15,20,0,88
16,1,18,19,14,9,16,93
16,1,18,20,0,0,0,55
16,1,18,20,14,5,18,92
16,1,18,20,25,0,0,80
16,1,19,19,0,0,0,55
16,1,19,19,1,7,5,68
16,1,19,19,9,15,14,93
16,1,19,19,9,22,5,91
16,1,19,20,0,0,0,56
16,1,19,20,1,0,0,57
16,1,19,20,5,0,0,61
16,1,19,20,15,18,0,89
16,1,19,20,18,25,0,99
16,1,20,3,8,0,0,48
16,1,20,8,0,0,0,45
16,1,20,9,5,14,20,85
16,1,20,9,14,1,0,61
16,1,20,9,15,0,0,61
16,1,20,18,9,15,20,99
16,1,20,18,15,12,0,82
16,1,20,20,5,18,14,94
16,1,21,19,5,0,0,62
16,1,23,0,0,0,0,40
16,1,25,0,0,0,0,42
16,1,25,5,5,0,0,52
16,1,25,13,5,14,20,94
16,5,1,0,0,0,0,22
16,5,1,3,5,0,0,30
16,5,1,3,8,0,0,33
16,5,1,3,15,1,20,61
16,5,1,3,15,3,11,54
16,5,1,11,0,0,0,33
16,5,1,14,21,20,0,77
16,5,1,18,0,0,0,40
16,5,1,18,12,0,0,52
16,5,4,1,12,0,0,38
16,5,5,14,0,0,0,40
16,5,5,18,0,0,0,44
16,5,12,9,3,1,14,60
16,5,12,20,0,0,0,53
16,5,14,0,0,0,0,35
16,5,14,1,12,20,25,93
16,5,14,3,9,12,0,59
16,5,14,4,1,14,20,74
16,5,14,19,9,15,14,92
16,5,15,14,25,0,0,75
16,5,15,16,12,5,0,69
16,5,16,16,5,18,0,76
16,5,18,3,8,0,0,50
16,5,18,6,21,13,5,84
16,5,18,9,15,4,0,67
16,5,18,13,9,20,0,81
16,5,18,16,0,0,0,55
16,5,18,19,15,14,0,87
16,5,19,20,0,0,0,60
16,5,20,0,0,0,0,41
16,5,20,1,12,0,0,54
16,5,23,0,0,0,0,44
16,8,1,0,0,0,0,25
16,8,1,19,5,0,0,49
16,8,15,14,5,0,0,58
16,8,15,20,15,0,0,74
16,8,18,1,19,5,0,67
16,8,25,19,9,3,19,99
16,9,1,14,9,19,20,88
16,9,1,14,15,0,0,55
16,9,3,3,15,12,15,73
16,9,3,11,0,0,0,39
16,9,3,11,1,24,0,64
16,9,3,11,5,20,0,64
16,9,3,11,12,5,0,56
16,9,3,20,21,18,5,92
16,9,5,0,0,0,0,30
16,9,5,3,5,0,0,38
16,9,5,18,0,0,0,48
16,9,5,20,25,0,0,75
16,9,7,0,0,0,0,32
16,9,7,5,15,14,0,66
16,9,11,5,0,0,0,41
16,9,12,5,0,0,0,42
16,9,12,12,2,15,24,90
16,9,12,12,15,23,0,87
16,9,12,15,20,0,0,72
16,9,13,16,0,0,0,54
16,9,13,16,12,5,0,71
16,9,14,0,0,0,0,39
16,9,14,5,0,0,0,44
16,9,14,7,0,0,0,46
16,9,14,11,0,0,0,50
16,9,14,11,9,5,0,64
16,9,14,20,0,0,0,59
16,9,14,20,15,0,0,74
16,9,14,23,15,18,13,108
16,9,15,14,5,5,18,82
16,9,16,5,0,0,0,46
16,9,18,1,3,25,0,72
16,9,19,19,0,0,0,63
16,9,20,3,8,0,0,56
16,9,20,8,0,0,0,53
16,9,26,26,1,0,0,78
16,12,1,3,5,0,0,37
16,12,1,9,14,0,0,52
16,12,1,14,0,0,0,43
16,12,1,14,5,0,0,48
16,12,1,14,5,20,0,68
16,12,1,14,20,0,0,63
16,12,1,14,20,5,18,86
16,12,1,19,20,5,18,91
16,12,1,19,20,9,3,80
16,12,1,20,5,0,0,54
16,12,1,25,0,0,0,54
16,12,1,25,5,18,0,77
16,12,5,1,20,5,4,63
16,12,5,14,20,25,0,92
16,12,9,5,18,0,0,60
16,12,15,20,0,0,0,63
16,12,15,21,7,8,0,79
16,12,15,22,5,18,0,88
16,12,15,23,0,0,0,66
16,12,15,23,13,1,14,94
16,12,21,13,5,0,0,67
16,12,21,14,7,5,18,93
16,12,25,23,15,15,4,110
16,15,3,11,5,20,0,70
16,15,5,13,0,0,0,49
16,15,5,20,0,0,0,56
16,15,5,20,18,25,0,99
16,15,9,14,20,0,0,74
16,15,9,19,15,14,0,88
16,15,12,5,0,0,0,48
16,15,12,5,14,20,1,83
16,15,12,9,3,5,0,60
16,15,12,9,3,25,0,80
16,15,12,9,19,8,0,79
16,15,12,15,0,0,0,58
16,15,13,16,15,13,0,88
16,15,14,3,8,15,0,71
16,15,14,4,0,0,0,49
16,15,14,25,0,0,0,70
16,15,15,6,0,0,0,52
16,15,15,12,0,0,0,58
16,15,16,0,0,0,0,47
16,15,16,3,15,18,14,97
16,15,16,16,25,0,0,88
16,15,18,3,8,0,0,60
16,15,18,20,0,0,0,69
16,15,18,20,5,18,0,92
16,15,19,20,0,0,0,70
16,15,19,20,1,7,5,83
16,15,19,20,2,15,24,111
16,15,19,20,5,18,0,93
16,15,20,0,0,0,0,51
16,15,20,1,20,15,0,87
16,15,20,20,25,0,0,96
16,15,21,3,8,0,0,63
16,15,21,12,20,18,25,127
16,15,21,14,4,0,0,70
16,15,22,5,18,20,25,121
16,15,23,4,5,18,0,81
16,15,23,5,18,0,0,77
16,18,5,6,1,3,5,54
16,18,5,12,21,4,5,81
16,18,5,13,9,5,18,84
16,18,5,19,5,14,20,97
16,18,5,19,19,0,0,77
16,18,9,3,5,0,0,51
16,18,9,4,5,0,0,52
16,18,9,5,19,20,0,87
16,18,9,13,1,18,25,100
16,18,9,13,1,20,5,82
16,18,9,14,3,5,0,65
16,18,9,14,20,0,0,77
16,18,9,14,20,5,18,100
16,18,9,15,18,0,0,76
16,18,9,19,15,14,0,91
16,18,9,22,1,20,5,91
16,18,9,26,5,0,0,74
16,18,15,2,12,5,13,81
16,18,15,3,5,19,19,95
16,18,15,4,21,3,5,82
16,18,15,4,21,3,20,97
16,18,15,6,9,12,5,81
16,18,15,6,9,20,0,84
16,18,15,7,18,1,13,88
16,18,15,10,5,3,20,87
16,18,15,13,9,19,5,95
16,18,15,13,16,20,0,98
16,18,15,15,6,0,0,70
16,18,15,16,1,14,5,85
16,18,15,19,5,0,0,73
16,18,15,20,5,19,20,113
16,18,15,23,0,0,0,72
16,18,21,14,5,18,0,92
16,21,2,12,9,3,0,63
16,21,4,4,9,14,7,75
16,21,4,4,12,5,0,62
16,21,6,6,9,14,0,72
16,21,12,12,0,0,0,61
16,21,12,12,5,25,0,91
16,21,13,1,0,0,0,51
16,21,13,16,0,0,0,66
16,21,13,16,11,9,14,100
16,21,14,3,8,0,0,62
16,21,16,1,0,0,0,54
16,21,16,9,12,0,0,74
16,21,16,16,25,0,0,94
16,21,18,9,20,1,14,99
16,21,18,16,12,5,0,88
16,21,18,16,15,19,5,110
16,21,18,19,5,0,0,79
16,21,19,8,0,0,0,64
16,21,19,8,5,18,0,87
16,21,20,0,0,0,0,57
16,22,3,0,0,0,0,41
16,25,10,1,13,1,0,66
16,25,18,1,13,9,4,86
17,21,1,9,12,0,0,60
17,21,1,12,9,20,25,105
17,21,1,18,20,0,0,77
17,21,1,18,20,5,18,100
17,21,1,18,20,26,0,103
17,21,5,5,14,0,0,62
17,21,9,5,20,0,0,72
17,21,9,12,12,0,0,71
17,21,9,12,20,0,0,79
17,21,9,14,3,5,0,69
17,21,9,20,0,0,0,67
17,21,9,22,5,18,0,92
17,21,15,20,5,0,0,78
18,1,2,2,9,0,0,32
18,1,2,2,9,20,0,52
18,1,3,3,15,15,14,69
18,1,3,5,0,0,0,27
18,1,3,5,18,0,0,45
18,1,3,9,14,7,0,52
18,1,3,9,19,13,0,63
18,1,3,9,19,20,0,70
18,1,3,11,0,0,0,33
18,1,4,1,18,0,0,42
18,1,4,9,15,0,0,47
18,1,4,9,19,8,0,59
18,1,6,6,12,5,0,48
18,1,6,20,0,0,0,45
18,1,7,0,0,0,0,26
18,1,7,5,0,0,0,31
18,1,9,12,0,0,0,40
18,1,9,12,23,1,25,89
18,1,9,13,5,14,20,80
18,1,9,14,0,0,0,42
18,1,9,14,2,15,23,82
18,1,9,19,5,0,0,52
18,1,11,5,0,0,0,35
18,1,13,0,0,0,0,32
18,1,13,2,12,5,18,69
18,1,13,9,5,0,0,46
18,1,14,3,8,0,0,44
18,1,14,4,15,13,0,65
18,1,14,7,5,0,0,45
18,1,14,11,0,0,0,44
18,1,20,0,0,0,0,39
18,1,20,5,0,0,0,44
18,1,20,9,15,0,0,63
18,1,22,5,14,0,0,60
18,1,22,9,15,12,9,86
18,1,23,0,0,0,0,42
18,1,23,8,9,4,5,68
18,1,25,0,0,0,0,44
18,1,25,15,14,0,0,73
18,5,1,3,8,0,0,35
18,5,1,4,0,0,0,28
18,5,1,4,9,14,7,58
18,5,1,12,9,20,25,90
18,5,1,13,5,18,0,60
18,5,1,18,0,0,0,42
18,5,1,19,15,14,0,72
18,5,3,5,9,16,20,76
18,5,3,5,19,19,0,69
18,5,3,9,16,5,0,56
18,5,3,15,18,4,0,63
18,5,3,15,22,5,18,86
18,5,3,18,21,9,20,94
18,5,4,0,0,0,0,27
18,5,5,6,0,0,0,34
18,5,6,21,14,4,0,68
18,5,6,21,19,5,0,74
18,5,7,9,15,14,0,68
18,5,7,18,5,20,0,73
18,5,7,21,12,1,18,82
18,5,10,5,3,20,0,61
18,5,12,5,1,19,5,65
18,5,12,9,5,6,0,55
18,5,12,9,19,8,0,71
18,5,13,15,20,5,0,76
18,5,13,15,22,5,0,78
18,5,14,20,0,0,0,57
18,5,16,1,9,18,0,67
18,5,16,5,1,20,0,65
18,5,16,12,1,3,5,60
18,5,16,12,25,0,0,76
18,5,16,15,18,20,0,92
18,5,17,21,5,19,20,105
18,5,19,1,12,5,0,60
18,5,19,5,18,22,5,92
18,5,19,9,19,20,0,90
18,5,19,15,12,22,5,96
18,5,19,15,18,20,0,95
18,5,19,16,5,3,20,86
18,5,19,16,9,20,5,92
18,5,19,16,15,14,4,91
18,5,19,20,0,0,0,62
18,5,19,21,12,20,0,95
18,5,20,9,14,1,0,67
18,5,20,15,21,3,8,90
18,5,20,21,18,14,0,96
18,5,22,5,1,12,0,63
18,5,22,5,14,7,5,76
18,5,22,5,14,21,5,90
18,5,22,9,5,23,0,82
18,5,22,15,12,22,5,99
18,5,23,1,18,4,0,69
18,8,25,13,5,0,0,69
18,8,25,20,8,13,0,92
18,9,3,5,0,0,0,35
18,9,3,8,0,0,0,38
18,9,4,4,12,5,0,52
18,9,4,5,0,0,0,36
18,9,4,5,18,0,0,54
18,9,4,7,5,0,0,43
18,9,6,12,5,0,0,50
18,9,7,8,20,0,0,62
18,9,13,0,0,0,0,40
18,9,14,7,0,0,0,48
18,9,16,0,0,0,0,43
18,9,16,16,12,5,0,76
18,9,19,5,0,0,0,51
18,9,19,5,18,0,0,69
18,9,19,11,0,0,0,57
18,9,22,5,18,0,0,72
18,9,22,21,12,5,20,107
18,15,1,4,0,0,0,38
18,15,1,4,23,1,25,87
18,15,1,19,20,0,0,73
18,15,2,5,0,0,0,40
18,15,2,9,14,0,0,58
18,15,3,11,0,0,0,47
18,15,3,11,5,18,0,70
18,15,3,11,5,20,0,72
18,15,4,0,0,0,0,37
18,15,12,5,0,0,0,50
18,15,12,12,0,0,0,57
18,15,12,12,5,18,0,80
18,15,15,6,0,0,0,54
18,15,15,13,0,0,0,61
18,15,15,19,20,5,18,110
18,15,15,20,0,0,0,68
18,15,16,5,0,0,0,54
18,15,19,5,0,0,0,57
18,15,19,20,18,21,13,124
18,15,20,1,20,5,0,79
18,15,21,7,8,0,0,69
18,15,21,14,4,0,0,72
18,15,21,20,5,0,0,79
18,15,21,20,5,18,0,97
18,15,21,20,9,14,5,102
18,15,23,0,0,0,0,56
18,15,23,2,15,1,20,94
18,15,25,1,12,0,0,71
18,21,2,0,0,0,0,41
18,21,2,2,5,18,0,66
18,21,2,2,9,19,8,79
18,21,2,18,9,3,0,71
18,21,3,11,21,19,0,93
18,21,6,6,12,5,0,68
18,21,7,2,25,0,0,73
18,21,9,14,0,0,0,62
18,21,12,5,0,0,0,56
18,21,13,0,0,0,0,52
18,21,14,0,0,0,0,53
18,21,14,1,23,1,25,103
18,21,14,14,5,18,0,90
18,21,19,8,0,0,0,66
18,21,20,8,0,0,0,67
18,25,0,0,0,0,0,43
19,1,2,18,5,0,0,45
19,1,3,11,0,0,0,34
19,1,4,0,0,0,0,24
19,1,4,4,12,5,0,45
19,1,6,5,0,0,0,31
19,1,6,5,20,25,0,76
19,1,7,5,0,0,0,32
19,1,9,12,0,0,0,41
19,1,9,12,15,18,0,74
19,1,12,1,4,0,0,37
19,1,12,1,18,25,0,76
19,1,12,5,0,0,0,37
19,1,12,13,15,14,0,74
19,1,12,15,14,0,0,61
19,1,12,15,15,14,0,76
19,1,12,20,0,0,0,52
19,1,13,15,22,1,18,89
19,1,13,16,1,14,0,64
19,1,13,16,12,5,0,66
19,1,13,21,18,1,9,82
19,1,14,4,0,0,0,38
19,1,14,4,1,12,19,70
19,1,14,4,2,1,18,59
19,1,18,4,9,14,5,70
19,1,18,9,0,0,0,47
19,1,18,15,14,7,0,74
19,1,19,8,0,0,0,47
19,1,20,9,14,0,0,63
19,1,20,9,18,5,0,72
19,1,21,3,5,0,0,49
19,1,21,19,1,7,5,73
19,1,22,5,0,0,0,47
19,1,22,9,14,7,0,72
19,1,22,9,14,7,19,91
19,1,22,9,15,18,0,84
19,1,22,9,15,21,18,105
19,1,23,0,0,0,0,43
19,3,1,12,5,0,0,40
19,3,1,14,14,5,18,74
19,3,1,18,6,0,0,47
19,3,5,14,5,0,0,46
19,3,5,14,5,18,25,89
19,3,5,14,20,0,0,61
19,3,8,5,13,5,0,53
19,3,8,15,15,12,0,72
19,3,9,5,14,3,5,58
19,3,15,15,20,5,18,95
19,3,15,18,5,0,0,60
19,3,15,18,14,0,0,69
19,3,15,23,0,0,0,60
19,3,18,1,16,5,18,80
19,3,18,1,20,3,8,72
19,3,18,5,5,14,0,64
19,3,18,5,23,0,0,68
19,3,18,9,13,0,0,62
19,3,18,9,16,0,0,65
19,3,18,9,16,20,0,85
19,5,1,0,0,0,0,25
19,5,1,6,15,15,4,65
19,5,1,7,21,12,12,77
19,5,1,12,0,0,0,37
19,5,1,18,3,8,0,54
19,5,1,19,9,4,5,62
19,5,1,19,15,14,0,73
19,5,1,20,0,0,0,45
19,5,3,15,14,4,0,60
19,5,3,18,5,20,0,70
19,5,3,20,9,15,14,85
19,5,3,20,15,18,0,80
19,5,3,21,18,5,0,71
19,5,5,4,0,0,0,33
19,5,5,4,5,18,0,56
19,5,7,13,5,14,20,83
19,5,12,5,3,20,0,64
19,5,12,6,0,0,0,42
19,5,12,12,0,0,0,48
19,5,14,1,20,15,18,92
19,5,14,9,15,18,0,80
19,5,14,19,5,0,0,62
19,5,16,1,12,0,0,53
19,5,18,9,5,19,0,75
19,5,18,22,1,14,20,99
19,5,18,22,5,0,0,69
19,5,18,22,5,18,0,87
19,5,18,22,9,3,5,81
19,5,19,19,9,15,14,100
19,5,20,0,0,0,0,44
19,5,20,20,9,14,7,94
19,5,20,20,12,5,18,99
19,5,23,5,18,0,0,70
19,5,24,0,0,0,0,48
19,8,1,3,11,0,0,42
19,8,1,4,5,0,0,37
19,8,1,4,15,23,0,70
19,8,1,11,5,0,0,44
19,8,1,11,5,18,0,62
19,8,1,12,12,15,20,87
19,8,1,13,5,0,0,46
19,8,1,13,16,15,15,87
19,8,1,14,20,25,0,87
19,8,1,16,5,0,0,49
19,8,1,18,5,0,0,51
19,8,1,18,11,0,0,57
19,8,1,18,15,14,0,75
19,8,1,23,12,0,0,63
19,8,5,0,0,0,0,32
19,8,5,1,18,19,0,70
19,8,5,1,20,8,0,61
19,8,5,4,0,0,0,36
19,8,5,5,16,0,0,53
19,8,5,5,20,0,0,57
19,8,5,12,6,0,0,50
19,8,5,12,12,0,0,56
19,8,5,12,20,5,18,87
19,8,5,18,18,25,0,93
19,8,9,5,12,4,0,57
19,8,9,6,20,0,0,62
19,8,9,14,0,0,0,50
19,8,9,14,5,0,0,55
19,8,9,14,7,12,5,74
19,8,9,16,0,0,0,52
19,8,9,18,20,0,0,74
19,8,15,1,20,0,0,63
19,8,15,3,11,0,0,56
19,8,15,5,0,0,0,47
19,8,15,5,19,0,0,66
19,8,15,6,1,18,0,67
19,8,15,15,20,0,0,77
19,8,15,16,0,0,0,58
19,8,15,16,16,5,18,97
19,8,15,18,5,0,0,65
19,8,15,18,20,19,0,99
19,8,15,20,0,0,0,62
19,8,15,22,5,12,0,81
19,8,15,23,0,0,0,65
19,8,15,23,5,18,0,88
19,8,18,5,4,0,0,54
19,8,18,9,13,16,0,83
19,8,18,9,14,5,0,73
19,9,2,12,9,14,7,72
19,9,3,11,0,0,0,42
19,9,4,5,0,0,0,37
19,9,4,5,3,1,18,59
19,9,4,9,14,7,0,62
19,9,7,14,0,0,0,49
19,9,7,14,1,12,0,62
19,9,7,14,5,20,0,74
19,9,7,14,21,16,0,86
19,9,12,5,14,3,5,67
19,9,12,9,3,1,0,53
19,9,12,11,0,0,0,51
19,9,12,12,0,0,0,52
19,9,12,12,25,0,0,77
19,9,12,15,0,0,0,55
19,9,12,22,5,18,0,85
19,9,13,16,12,5,0,74
19,9,14,7,0,0,0,49
19,9,14,7,5,18,0,72
19,9,14,7,12,5,0,66
19,9,14,11,0,0,0,53
19,9,18,0,0,0,0,46
19,9,19,20,5,18,0,90
19,9,20,1,18,0,0,67
19,9,20,5,0,0,0,53
19,9,26,5,0,0,0,59
19,11,1,20,5,0,0,56
19,11,9,9,14,7,0,69
19,11,9,12,12,0,0,63
19,11,9,14,0,0,0,53
19,11,9,18,20,0,0,77
19,11,21,12,12,0,0,75
19,11,21,14,11,0,0,76
19,11,25,0,0,0,0,55
19,11,25,23,1,12,11,102
19,12,1,19,8,0,0,59
19,12,1,22,5,0,0,59
19,12,5,4,0,0,0,40
19,12,5,4,7,5,0,52
19,12,5,5,16,0,0,57
19,12,5,5,20,0,0,61
19,12,5,21,20,8,0,85
19,12,9,3,5,0,0,48
19,12,9,4,5,0,0,49
19,12,9,4,5,18,0,67
19,12,9,13,5,0,0,58
19,12,9,16,0,0,0,56
19,12,9,16,16,5,18,95
19,12,15,16,5,0,0,67
19,12,15,20,8,0,0,74
19,13,1,19,8,0,0,60
19,13,5,12,12,0,0,61
19,13,9,12,5,0,0,58
19,13,15,3,11,0,0,61
19,13,15,7,0,0,0,54
19,13,15,11,5,0,0,63
19,13,15,11,9,14,7,88
19,14,1,9,12,0,0,55
19,14,1,11,5,0,0,50
19,14,5,5,26,5,0,74
19,14,15,2,0,0,0,50
19,14,15,18,5,18,0,89
19,14,15,23,0,0,0,71
19,14,15,23,13,1,14,99
19,14,21,7,7,12,5,85
19,15,1,16,0,0,0,51
19,15,3,3,5,18,0,63
19,15,3,9,5,20,25,96
19,15,3,11,0,0,0,48
19,15,3,11,19,0,0,67
19,15,4,1,0,0,0,39
19,15,6,1,0,0,0,41
19,15,6,20,0,0,0,60
19,15,9,12,0,0,0,55
19,15,12,4,9,5,18,82
19,15,12,9,4,0,0,59
19,15,14,0,0,0,0,48
19,15,14,7,0,0,0,55
19,15,14,14,5,20,0,87
19,15,15,20,0,0,0,69
19,15,16,18,1,14,15,98
19,15,18,2,5,20,0,79
19,15,18,18,15,23,0,108
19,15,18,20,0,0,0,72
19,15,21,14,4,0,0,73
19,15,21,16,0,0,0,71
19,15,21,18,3,5,0,81
19,15,21,20,8,0,0,83
19,15,23,0,0,0,0,57
19,15,25,0,0,0,0,59
19,15,25,2,5,1,14,81
19,16,1,3,5,0,0,44
19,16,1,3,9,14,7,69
19,16,1,4,5,0,0,45
19,16,1,14,4,5,24,83
19,16,1,14,11,0,0,61
19,16,1,18,5,0,0,59
19,16,1,18,11,0,0,65
19,16,1,18,18,15,23,110
19,16,1,19,13,0,0,68
19,16,5,1,11,5,18,75
19,16,5,1,18,0,0,59
19,16,5,3,9,1,12,65
19,16,5,5,3,8,0,56
19,16,5,5,4,0,0,49
19,16,5,12,12,0,0,64
19,16,5,14,4,0,0,58
19,16,8,5,18,5,0,71
19,16,8,25,14,24,0,106
19,16,9,4,5,18,0,71
19,16,9,11,5,0,0,60
19,16,9,14,1,3,8,70
19,16,9,14,5,0,0,63
19,16,9,18,1,12,0,75
19,16,9,18,9,20,0,91
19,16,9,20,5,0,0,69
19,16,12,5,5,14,0,71
19,16,12,9,20,0,0,76
19,16,15,14,7,5,0,76
19,16,15,15,14,0,0,79
19,16,15,18,20,0,0,88
19,16,15,20,0,0,0,70
19,16,18,1,25,0,0,79
19,16,18,5,1,4,0,63
19,16,18,9,14,7,0,83
19,16,18,15,21,20,0,109
19,16,18,21,3,5,0,82
19,16,21,13,5,0,0,74
19,16,21,18,0,0,0,74
19,16,25,0,0,0,0,60
19,17,21,1,18,5,0,81
19,17,21,1,19,8,0,85
19,17,21,9,4,0,0,70
19,20,1,2,12,5,0,59
19,20,1,3,11,0,0,54
19,20,1,4,9,21,13,87
19,20,1,6,6,0,0,52
19,20,1,7,0,0,0,47
19,20,1,7,5,0,0,52
19,20,1,9,14,0,0,63
19,20,1,9,18,0,0,67
19,20,1,13,5,14,0,72
19,20,1,13,9,14,1,77
19,20,1,13,16,0,0,69
19,20,1,14,3,5,0,62
19,20,1,14,4,0,0,58
19,20,1,18,0,0,0,58
19,20,1,18,20,0,0,78
19,20,1,18,20,5,18,101
19,20,1,20,5,0,0,65
19,20,1,20,9,15,14,98
19,20,1,20,21,19,0,100
19,20,1,25,0,0,0,65
19,20,5,1,11,0,0,56
19,20,5,1,12,0,0,57
19,20,5,1,13,0,0,58
19,20,5,5,12,0,0,61
19,20,5,5,16,12,5,82
19,20,5,13,0,0,0,57
19,20,5,14,3,9,12,82
19,20,5,16,0,0,0,60
19,20,5,16,19,0,0,79
19,20,5,16,19,15,14,108
19,20,5,23,0,0,0,67
19,20,9,3,11,0,0,62
19,20,9,12,12,0,0,72
19,20,9,14,7,5,18,92
19,20,9,20,3,8,0,79
19,20,15,3,11,0,0,68
19,20,15,12,5,0,0,71
19,20,15,13,1,3,8,79
19,20,15,14,5,0,0,73
19,20,15,15,12,0,0,81
19,20,15,16,0,0,0,70
19,20,15,18,1,7,5,85
19,20,15,18,5,0,0,77
19,20,15,18,5,25,0,102
19,20,15,18,13,0,0,85
19,20,15,18,25,0,0,97
19,20,15,22,5,0,0,81
19,20,18,1,9,14,0,81
19,20,18,1,9,20,0,87
19,20,18,1,16,0,0,74
19,20,18,1,23,0,0,81
19,20,18,5,1,13,0,76
19,20,18,5,5,20,0,87
19,20,18,5,19,19,0,100
19,20,18,5,20,3,8,93
19,20,18,9,11,5,0,82
19,20,18,9,14,7,0,87
19,20,18,9,16,0,0,82
19,20,18,15,11,5,0,88
19,20,21,4,0,0,0,64
19,20,21,4,5,14,20,103
19,20,21,4,9,15,0,88
19,20,21,4,25,0,0,89
19,20,21,6,6,0,0,72
19,20,21,16,9,4,0,89
19,20,25,12,5,0,0,81
19,20,25,12,9,14,7,106
19,20,25,12,21,19,0,116
19,21,2,10,5,3,20,80
19,21,2,21,18,2,0,83
19,21,2,23,1,25,0,91
19,21,3,3,5,19,19,89
19,21,3,11,0,0,0,54
19,21,5,4,5,0,0,54
19,21,7,1,18,0,0,66
19,21,9,20,0,0,0,69
19,21,12,20,1,14,0,87
19,21,13,13,5,18,0,89
19,21,14,0,0,0,0,54
19,21,14,2,5,1,13,75
19,21,14,4,1,25,0,84
19,21,14,4,9,1,12,80
19,21,14,12,1,13,16,96
19,21,14,18,15,15,13,115
19,21,16,16,12,25,0,109
19,21,16,16,15,18,20,125
19,21,18,6,1,3,5,73
19,21,18,7,5,15,14,99
19,21,18,7,5,18,25,113
19,21,18,14,1,13,5,91
19,21,18,22,5,25,0,110
19,21,19,8,9,0,0,76
19,21,19,16,5,3,20,103
19,23,1,12,12,15,23,105
19,23,1,13,16,0,0,72
19,23,1,14,0,0,0,57
19,23,1,20,8,0,0,71
19,23,5,1,20,0,0,68
19,23,5,1,20,5,18,91
19,23,5,1,20,19,0,87
19,23,5,4,9,19,8,87
19,23,5,5,20,0,0,72
19,23,5,5,20,19,0,91
19,23,5,12,12,0,0,71
19,23,9,13,0,0,0,64
19,23,9,14,7,0,0,72
19,23,9,19,19,0,0,89
19,23,9,20,3,8,0,82
19,23,9,22,5,12,0,90
19,23,15,18,4,0,0,79
19,25,14,5,18,7,25,113
19,25,14,15,4,0,0,77
19,25,18,21,16,0,0,99
19,25,19,20,5,13,0,101
20,1,2,2,25,0,0,50
20,1,2,12,5,0,0,40
20,1,3,11,12,5,0,52
20,1,4,16,15,12,5,73
20,1,9,12,0,0,0,42
20,1,9,12,15,18,0,75
20,1,12,5,0,0,0,38
20,1,12,11,0,0,0,44
20,1,13,0,0,0,0,34
20,1,13,2,15,21,18,90
20,1,14,4,5,13,0,57
20,1,14,11,0,0,0,46
20,1,14,11,5,18,0,69
20,1,14,11,6,21,12,85
20,1,16,0,0,0,0,37
20,1,18,4,0,0,0,43
20,1,18,7,5,20,0,71
20,1,19,11,0,0,0,51
20,1,19,19,5,12,0,76
20,1,19,20,5,0,0,65
20,1,20,1,13,9,0,64
20,1,20,20,12,5,18,96
20,1,20,20,15,15,0,91
20,1,22,5,18,14,0,80
20,1,24,0,0,0,0,45
20,1,24,9,0,0,0,54
20,1,24,9,3,1,2,60
20,5,1,0,0,0,0,26
20,5,1,3,8,0,0,37
20,5,1,3,8,5,18,60
20,5,1,13,0,0,0,39
20,5,1,18,0,0,0,44
20,5,5,14,0,0,0,44
20,5,5,20,8,0,0,58
20,5,12,12,0,0,0,49
20,5,12,12,5,18,0,72
20,5,13,16,0,0,0,54
20,5,13,16,5,18,0,77
20,5,13,16,12,5,0,71
20,5,13,16,15,0,0,69
20,5,14,14,9,19,0,81
20,5,14,15,18,0,0,72
20,5,14,19,9,15,14,96
20,5,14,20,0,0,0,59
20,5,16,5,5,0,0,51
20,5,18,13,0,0,0,56
20,5,19,20,0,0,0,64
20,5,24,20,0,0,0,69
20,5,24,20,21,18,5,113
20,8,1,14,11,19,0,73
20,8,1,23,0,0,0,52
20,8,5,1,20,5,18,77
20,8,5,9,19,13,0,74
20,8,5,13,5,0,0,51
20,8,5,15,18,25,0,91
20,8,9,7,8,0,0,52
20,8,9,14,7,0,0,58
20,8,9,18,19,20,0,94
20,8,9,19,20,12,5,93
20,8,15,13,1,19,0,76
20,8,15,14,7,0,0,64
20,8,15,14,7,19,0,83
20,8,15,18,14,0,0,75
20,8,15,21,7,8,20,99
20,8,18,5,1,4,0,56
20,8,18,9,12,12,0,79
20,8,18,15,1,20,0,82
20,8,18,15,14,5,0,80
20,8,18,21,19,8,0,94
20,8,21,13,2,0,0,64
20,8,21,14,4,5,18,90
20,9,1,18,1,0,0,49
20,9,3,0,0,0,0,32
20,9,3,11,5,20,0,68
20,9,5,0,0,0,0,34
20,9,7,5,18,0,0,59
20,9,7,8,20,0,0,64
20,9,7,8,20,19,0,83
20,9,12,5,0,0,0,46
20,9,12,12,0,0,0,53
20,9,13,2,1,12,5,62
20,9,13,2,5,18,0,67
20,9,13,5,0,0,0,47
20,9,13,5,15,21,20,103
20,9,13,5,18,0,0,65
20,9,13,16,1,14,9,82
20,9,14,0,0,0,0,43
20,9,14,11,12,5,0,71
20,9,14,20,25,16,5,109
20,9,16,0,0,0,0,45
20,9,18,5,0,0,0,52
20,9,19,19,21,5,0,93
20,9,20,12,5,0,0,66
20,15,1,4,0,0,0,40
20,15,1,19,20,0,0,75
20,15,4,1,25,0,0,65
20,15,5,0,0,0,0,40
20,15,5,14,1,9,12,76
20,15,7,1,0,0,0,43
20,15,7,19,0,0,0,61
20,15,9,12,5,20,0,81
20,15,13,0,0,0,0,48
20,15,13,1,20,15,0,84
20,15,14,0,0,0,0,49
20,15,14,5,0,0,0,54
20,15,14,7,21,5,0,82
20,15,14,9,7,8,20,93
20,15,15,12,0,0,0,62
20,15,15,20,0,0,0,70
20,15,15,20,8,0,0,78
20,15,16,0,0,0,0,51
20,15,16,9,3,0,0,63
20,15,16,19,1,9,12,92
20,15,17,21,5,0,0,78
20,15,18,14,1,4,15,87
20,15,18,19,15,0,0,87
20,15,19,19,5,18,0,96
20,15,20,1,12,0,0,68
20,15,20,5,0,0,0,60
20,15,21,3,8,0,0,67
20,15,21,7,8,0,0,71
20,15,21,18,0,0,0,74
20,15,21,18,9,19,20,122
20,15,23,5,12,0,0,75
20,15,23,5,18,0,0,81
20,15,23,14,0,0,0,72
20,15,25,0,0,0,0,60
20,18,1,3,11,0,0,53
20,18,1,3,20,15,18,95
20,18,1,4,5,0,0,48
20,18,1,6,6,9,3,63
20,18,1,9,12,0,0,60
20,18,1,9,12,5,18,83
20,18,1,9,14,0,0,62
20,18,1,9,14,5,18,85
20,18,1,13,0,0,0,52
20,18,1,13,16,0,0,68
20,18,1,14,19,15,13,100
20,18,1,19,8,0,0,66
20,18,1,22,5,12,0,78
20,18,1,25,0,0,0,64
20,18,5,1,20,0,0,64
20,18,5,5,0,0,0,48
20,18,5,12,12,9,19,95
20,18,5,13,15,18,0,89
20,18,5,14,3,8,0,68
20,18,9,1,12,0,0,60
20,18,9,2,5,0,0,54
20,18,9,3,11,0,0,61
20,18,9,13,0,0,0,60
20,18,9,14,11,5,20,97
20,18,9,16,0,0,0,63
20,18,9,16,15,4,0,82
20,18,15,12,12,5,25,107
20,18,15,15,16,5,18,107
20,18,15,21,2,12,5,93
20,18,15,21,20,0,0,94
20,18,15,22,5,0,0,80
20,18,15,23,5,12,0,93
20,18,21,3,11,0,0,73
20,18,21,3,11,9,20,102
20,18,21,13,16,5,20,113
20,18,21,14,11,0,0,84
20,18,21,19,20,0,0,98
20,18,21,20,8,0,0,87
20,18,25,0,0,0,0,63
20,19,21,14,1,13,9,97
20,21,2,0,0,0,0,43
20,21,2,1,0,0,0,44
20,21,2,5,0,0,0,48
20,21,7,2,15,1,20,86
20,21,12,9,16,0,0,78
20,21,13,13,25,0,0,92
20,21,14,1,0,0,0,56
20,21,14,5,0,0,0,60
20,21,14,9,3,0,0,67
20,21,14,14,5,12,0,86
20,21,18,2,1,14,0,76
20,21,18,11,9,19,8,106
20,21,18,14,0,0,0,73
20,21,18,14,9,16,0,98
20,21,18,18,5,20,0,102
20,21,18,20,12,5,0,96
20,21,19,19,12,5,0,96
20,21,20,21,0,0,0,82
20,21,24,5,4,15,0,89
20,22,0,0,0,0,0,42
20,23,9,7,0,0,0,59
20,23,9,14,5,0,0,71
20,23,9,19,20,0,0,91
20,23,9,19,20,5,18,114
20,23,15,0,0,0,0,58
20,25,16,5,0,0,0,66
20,25,16,8,15,15,14,113
20,25,22,5,11,0,0,83
21,11,21,12,5,12,5,87
21,14,3,12,5,0,0,55
21,14,9,2,15,4,25,90
21,14,9,6,15,18,13,96
21,14,9,15,14,0,0,73
21,14,9,17,21,5,0,87
21,14,9,20,0,0,0,64
21,14,9,20,25,0,0,89
21,16,16,5,18,0,0,76
21,18,14,0,0,0,0,53
21,19,1,7,5,0,0,53
21,19,5,0,0,0,0,45
21,19,5,18,0,0,0,63
21,19,8,5,18,0,0,71
21,19,21,1,12,0,0,74
21,20,5,14,19,9,12,100
22,1,3,21,21,13,0,81
22,1,7,18,1,14,20,83
22,1,12,1,14,3,5,58
22,1,12,12,5,25,0,77
22,1,12,21,5,0,0,61
22,1,14,0,0,0,0,37
22,1,14,5,0,0,0,42
22,1,14,9,20,25,0,91
22,1,18,9,5,20,25,100
22,1,19,5,0,0,0,47
22,1,19,20,0,0,0,62
22,1,21,12,20,0,0,76
22,5,1,12,0,0,0,40
22,5,8,9,3,12,5,64
22,5,9,12,0,0,0,48
22,5,9,14,0,0,0,50
22,5,12,4,20,0,0,63
22,5,12,12,21,13,0,85
22,5,12,22,5,20,0,86
22,5,14,15,13,0,0,69
22,5,18,1,14,4,1,65
22,5,18,4,9,3,20,81
22,5,18,19,5,0,0,69
22,5,18,19,9,15,14,102
22,5,18,20,9,7,15,96
22,5,18,22,5,0,0,72
22,5,19,19,5,12,0,82
22,5,19,20,0,0,0,66
22,9,2,5,0,0,0,38
22,9,4,5,15,0,0,55
22,9,5,23,0,0,0,59
22,9,12,12,1,0,0,56
22,9,12,12,1,7,5,68
22,9,14,25,12,0,0,82
22,9,15,12,1,0,0,59
22,9,15,12,5,20,0,83
22,9,15,12,9,14,0,81
22,9,18,20,21,5,0,95
22,9,18,21,19,0,0,89
22,9,19,3,15,19,5,92
22,9,19,5,0,0,0,55
22,9,19,9,15,14,0,88
22,9,19,9,20,0,0,79
22,9,19,9,20,15,18,112
22,9,19,15,18,0,0,83
22,9,19,21,1,12,0,84
22,9,24,5,14,0,0,74
22,15,9,3,5,0,0,54
22,15,12,3,1,14,15,82
22,15,12,21,13,5,0,88
22,15,25,1,7,5,0,75
22,21,12,20,21,18,5,119
23,1,4,0,0,0,0,28
23,1,6,5,18,0,0,53
23,1,6,6,12,5,0,53
23,1,9,19,20,0,0,72
23,1,9,20,0,0,0,53
23,1,9,20,5,18,0,76
23,1,11,5,0,0,0,40
23,1,12,11,0,0,0,47
23,1,12,11,5,18,0,70
23,1,12,11,23,1,25,96
23,1,12,12,0,0,0,48
23,1,12,12,1,2,25,76
23,1,12,12,5,20,0,73
23,1,12,14,21,20,0,91
23,1,12,18,21,19,0,94
23,1,13,16,21,13,0,87
23,1,14,14,1,2,5,60
23,1,18,0,0,0,0,42
23,1,18,4,5,14,0,65
23,1,18,12,15,3,11,83
23,1,18,13,20,8,0,83
23,1,18,14,9,14,7,86
23,1,19,8,0,0,0,51
23,1,19,8,5,18,0,74
23,1,19,8,20,21,2,94
23,1,19,16,0,0,0,59
23,1,19,20,5,0,0,68
23,1,20,3,8,0,0,55
23,1,20,5,18,0,0,67
23,1,22,5,0,0,0,51
23,1,24,0,0,0,0,48
23,1,25,0,0,0,0,49
23,5,1,12,20,8,0,69
23,5,1,16,15,14,0,74
23,5,1,18,0,0,0,47
23,5,1,19,5,12,0,65
23,5,1,20,8,5,18,80
23,5,2,0,0,0,0,30
23,5,4,4,9,14,7,66
23,5,4,7,5,0,0,44
23,5,5,4,0,0,0,37
23,5,5,4,5,18,0,60
23,5,5,11,0,0,0,44
23,5,5,11,5,14,4,67
23,5,9,7,8,20,0,72
23,5,9,18,4,0,0,59
23,5,12,3,15,13,5,76
23,5,12,6,1,18,5,70
23,5,12,12,0,0,0,52
23,5,19,20,0,0,0,67
23,5,19,20,5,18,14,104
23,5,20,19,21,9,20,117
23,8,1,12,5,0,0,49
23,8,1,18,6,0,0,56
23,8,5,1,20,0,0,57
23,8,5,5,12,0,0,53
23,8,5,18,5,1,19,79
23,8,9,12,5,0,0,57
23,8,9,16,0,0,0,56
23,8,9,19,11,5,18,93
23,8,9,19,11,5,25,100
23,8,9,19,20,12,5,96
23,8,9,20,5,0,0,65
23,8,15,12,5,0,0,63
23,8,15,18,12,0,0,76
23,9,4,20,8,0,0,64
23,9,6,5,0,0,0,43
23,9,12,12,0,0,0,56
23,9,12,12,15,23,0,94
23,9,14,0,0,0,0,46
23,9,14,4,0,0,0,50
23,9,14,4,1,7,5,63
23,9,14,4,15,23,0,88
23,9,14,5,0,0,0,51
23,9,14,7,0,0,0,53
23,9,14,7,13,1,14,81
23,9,14,7,20,9,16,98
23,9,14,14,5,18,0,83
23,9,14,20,5,18,0,89
23,9,18,5,0,0,0,55
23,9,19,4,15,13,0,83
23,9,19,5,7,21,25,109
23,9,19,8,0,0,0,59
23,9,20,3,8,0,0,63
23,9,20,14,5,19,19,109
23,15,12,6,0,0,0,56
23,15,13,2,1,20,0,74
23,15,13,5,14,0,0,70
23,15,14,4,5,18,0,79
23,15,15,4,0,0,0,57
23,15,15,12,0,0,0,65
23,15,15,12,5,14,0,84
23,15,18,4,0,0,0,60
23,15,18,11,0,0,0,67
23,15,18,11,5,18,0,90
23,15,18,11,9,14,7,97
23,15,18,12,4,0,0,72
23,15,18,13,0,0,0,69
23,15,18,18,25,0,0,99
23,15,18,20,8,0,0,84
23,15,18,20,8,25,0,109
23,15,21,14,4,0,0,77
23,18,1,16,0,0,0,58
23,18,5,3,11,5,18,83
23,18,5,14,0,0,0,60
23,18,5,14,3,8,0,71
23,18,9,14,11,12,5,92
23,18,9,19,20,0,0,89
23,18,9,20,5,18,0,93
23,18,9,20,9,14,7,100
23,18,15,14,7,0,0,77
25,1,3,8,20,0,0,57
25,1,11,0,0,0,0,37
25,1,13,0,0,0,0,39
25,1,18,4,0,0,0,48
25,1,18,14,0,0,0,58
25,1,23,12,0,0,0,61
25,5,1,18,0,0,0,49
25,5,1,19,20,0,0,70
25,5,12,12,15,23,0,92
25,5,23,0,0,0,0,53
25,9,14,0,0,0,0,48
25,15,7,1,0,0,0,48
25,15,7,21,18,20,0,106
25,15,11,5,0,0,0,56
25,15,21,0,0,0,0,61
25,15,21,14,7,0,0,82
25,15,21,20,8,0,0,89
25,21,18,20,0,0,0,84
26,1,13,16,15,14,5,90
26,5,2,18,1,0,0,52
26,5,16,8,25,18,0,98
26,9,14,3,0,0,0,52
26,9,16,16,5,18,0,90
26,9,20,8,5,18,0,86
26,15,14,5,0,0,0,60
26,15,15,0,0,0,0,56
26,15,15,12,15,7,25,115
0,0,0,0,0,0,0,0
