A,B,C,D,E,F,G,H,I,s
1,2,2,0,0,0,0,0,0,5
1,2,2,1,3,25,0,0,0,34
1,2,2,1,3,9,5,19,0,42
1,2,2,1,3,15,13,5,19,61
1,2,2,1,25,5,0,0,0,36
1,2,2,1,14,4,15,14,15,68
1,2,2,1,19,0,0,0,0,25
1,2,2,1,19,9,0,0,0,34
1,2,2,1,19,19,9,0,0,53
1,2,2,1,20,9,1,12,0,48
1,2,2,1,20,9,3,1,12,51
1,2,2,1,20,9,5,0,0,40
1,2,2,5,25,19,0,0,0,54
1,2,2,5,19,0,0,0,0,29
1,2,2,5,19,19,0,0,0,48
1,2,2,5,19,19,5,19,0,72
1,2,2,5,19,20,0,0,0,49
1,2,2,15,3,3,1,20,15,62
1,2,2,15,7,1,4,1,0,33
1,2,2,15,20,3,25,0,0,68
1,2,2,15,20,3,9,5,19,76
1,2,2,15,20,18,9,3,0,70
1,2,2,15,20,19,0,0,0,59
1,2,2,15,20,19,8,9,16,92
1,2,2,15,26,26,15,0,0,87
1,2,2,18,5,22,0,0,0,50
1,2,3,5,19,19,0,0,0,49
1,2,3,9,19,19,1,0,0,54
1,2,3,15,21,12,15,13,2,84
1,2,4,0,0,0,0,0,0,7
1,2,4,1,12,0,0,0,0,20
1,2,4,1,12,9,0,0,0,29
1,2,4,1,18,9,1,0,0,36
1,2,4,1,20,0,0,0,0,28
1,2,4,5,19,20,0,0,0,51
1,2,4,9,3,1,2,12,5,39
1,2,4,9,3,1,14,20,0,54
1,2,4,9,3,1,20,5,0,45
1,2,4,9,3,1,20,5,4,49
1,2,4,9,3,1,20,5,19,64
1,2,4,9,3,1,20,15,18,73
1,2,4,9,20,9,22,5,0,72
1,2,4,9,20,15,18,25,0,94
1,2,4,15,13,0,0,0,0,35
1,2,4,15,13,5,14,0,0,54
1,2,4,15,13,5,14,19,0,73
1,2,4,15,13,9,14,1,0,59
1,2,4,15,13,9,14,1,12,71
1,2,4,21,3,5,0,0,0,36
1,2,4,21,3,5,4,0,0,40
1,2,4,21,3,5,14,19,0,69
1,2,4,21,3,5,14,20,0,70
1,2,4,21,3,5,19,0,0,55
1,2,4,21,3,9,14,7,0,61
1,2,4,21,3,20,0,0,0,51
1,2,4,21,3,20,5,4,0,60
1,2,4,21,3,20,9,14,7,81
1,2,4,21,3,20,9,15,14,89
1,2,4,21,3,20,15,18,0,84
1,2,4,21,3,20,15,18,19,103
1,2,4,21,3,20,19,0,0,70
1,2,5,1,13,0,0,0,0,22
1,2,5,1,18,0,0,0,0,27
1,2,5,1,18,1,14,3,5,50
1,2,5,3,5,4,1,18,25,64
1,2,5,4,0,0,0,0,0,12
1,2,5,4,5,0,0,0,0,17
1,2,5,4,7,5,0,0,0,24
1,2,5,7,7,5,0,0,0,27
1,2,5,25,1,14,3,5,0,56
1,2,5,25,1,14,3,5,19,75
1,2,5,25,1,14,3,25,0,76
1,2,5,25,1,14,20,0,0,68
1,2,5,9,7,8,0,0,0,32
1,2,5,12,5,0,0,0,0,25
1,2,5,12,5,19,0,0,0,44
1,2,5,12,13,15,19,11,0,78
1,2,5,12,13,15,19,11,19,97
1,2,5,12,13,21,19,11,0,84
1,2,5,12,20,18,5,5,0,68
1,2,5,14,4,0,0,0,0,26
1,2,5,14,4,19,0,0,0,45
1,2,5,14,20,5,18,9,3,77
1,2,5,18,14,5,20,8,25,98
1,2,5,18,18,0,0,0,0,44
1,2,5,18,18,1,14,3,5,67
1,2,5,18,18,1,14,3,25,87
1,2,5,18,18,1,14,20,0,79
1,2,5,18,18,1,14,20,19,98
1,2,5,18,18,1,20,5,0,70
1,2,5,18,18,1,20,5,4,74
1,2,5,18,18,1,20,15,18,98
1,2,5,19,19,5,0,0,0,51
1,2,5,19,19,9,22,5,0,82
1,2,5,20,0,0,0,0,0,28
1,2,5,20,13,5,14,20,0,80
1,2,5,20,13,5,14,20,19,99
1,2,5,20,19,0,0,0,0,47
1,2,5,20,20,1,12,0,0,61
1,2,5,20,20,1,12,19,0,80
1,2,5,20,20,5,4,0,0,57
1,2,5,20,20,5,18,0,0,71
1,2,5,20,20,5,18,19,0,90
1,2,5,20,20,9,14,7,0,78
1,2,5,20,20,15,18,0,0,81
1,2,5,20,20,15,18,19,0,100
1,2,6,1,18,1,4,0,0,33
1,2,6,1,18,1,4,19,0,52
1,2,8,5,14,18,25,0,0,73
1,2,8,5,14,18,9,5,19,81
1,2,8,5,14,18,25,19,0,92
1,2,8,9,14,1,25,1,0,61
1,2,8,9,19,5,11,1,0,56
1,2,8,15,18,0,0,0,0,44
1,2,8,15,18,18,5,4,0,71
1,2,8,15,18,18,5,14,20,101
1,2,8,15,18,18,5,18,0,85
1,2,8,15,18,18,5,18,19,104
1,2,8,15,18,18,9,14,7,92
1,2,8,15,18,19,0,0,0,63
1,2,25,0,0,0,0,0,0,28
1,2,9,3,8,9,20,5,0,57
1,2,9,4,1,12,0,0,0,29
1,2,9,4,1,14,3,5,0,39
1,2,9,4,1,14,3,5,19,58
1,2,9,4,4,5,14,0,0,39
1,2,9,4,5,0,0,0,0,21
1,2,9,4,5,4,0,0,0,25
1,2,9,4,5,18,0,0,0,39
1,2,9,4,5,18,19,0,0,58
1,2,9,4,5,19,0,0,0,40
1,2,9,4,9,0,0,0,0,25
1,2,9,4,9,14,7,0,0,46
1,2,9,4,9,14,7,12,25,83
1,2,25,5,0,0,0,0,0,33
1,2,9,5,4,0,0,0,0,21
1,2,25,5,4,0,0,0,0,37
1,2,9,5,7,8,0,0,0,32
1,2,9,5,14,3,5,0,0,39
1,2,9,5,14,20,0,0,0,51
1,2,25,5,19,0,0,0,0,52
1,2,9,5,20,1,20,5,0,63
1,2,9,5,20,5,14,5,0,61
1,2,9,5,20,9,3,0,0,49
1,2,9,5,20,9,14,0,0,60
1,2,9,5,20,9,14,9,3,72
1,2,9,5,20,9,20,5,0,71
1,2,9,7,1,9,12,19,0,60
1,2,9,7,5,1,20,0,0,45
1,2,9,7,5,9,0,0,0,33
1,2,9,7,5,21,19,0,0,64
1,2,25,9,14,7,0,0,0,58
1,2,9,12,1,15,0,0,0,40
1,2,9,12,9,13,5,14,20,85
1,2,9,12,9,20,25,0,0,78
1,2,9,12,9,20,9,5,19,86
1,2,9,12,12,1,0,0,0,37
1,2,9,12,15,0,0,0,0,39
1,2,9,13,5,0,0,0,0,30
1,2,9,15,7,5,14,25,0,78
1,2,9,15,12,15,7,25,0,86
1,2,9,15,19,5,19,0,0,70
1,2,9,15,19,9,19,0,0,74
1,2,9,15,20,9,3,0,0,59
1,2,9,15,20,9,3,1,12,72
1,2,9,18,0,0,0,0,0,30
1,2,25,19,0,0,0,0,0,47
1,2,25,19,13,0,0,0,0,60
1,2,25,19,13,1,12,0,0,73
1,2,25,19,13,1,12,12,25,110
1,2,25,19,13,19,0,0,0,79
1,2,25,19,19,1,0,0,0,67
1,2,25,19,19,1,12,0,0,79
1,2,25,19,19,5,19,0,0,90
1,2,25,19,19,21,19,0,0,106
1,2,9,19,20,15,14,0,0,80
1,2,9,20,0,0,0,0,0,32
1,2,9,21,18,5,20,0,0,76
1,2,10,5,3,20,0,0,0,41
1,2,10,5,3,20,9,15,14,79
1,2,10,5,3,20,9,22,5,77
1,2,10,5,3,20,12,25,0,78
1,2,10,15,9,14,20,0,0,71
1,2,10,21,4,7,5,0,0,50
1,2,10,21,4,7,5,4,0,54
1,2,10,21,4,7,9,14,7,75
1,2,10,21,7,1,20,5,0,67
1,2,10,21,14,3,20,0,0,71
1,2,10,21,18,5,0,0,0,57
1,2,10,21,18,5,4,0,0,61
1,2,10,21,18,5,18,0,0,75
1,2,10,21,18,5,18,19,0,94
1,2,10,21,18,5,19,0,0,76
1,2,10,21,18,9,14,7,0,82
1,2,11,1,18,0,0,0,0,33
1,2,11,1,18,9,0,0,0,42
1,2,11,1,18,25,0,0,0,58
1,2,12,0,0,0,0,0,0,15
1,2,12,1,3,8,0,0,0,27
1,2,12,1,3,20,1,20,5,65
1,2,12,1,18,5,0,0,0,39
1,2,12,1,19,20,9,14,0,78
1,2,12,1,19,20,15,21,19,110
1,2,12,1,20,5,0,0,0,41
1,2,12,1,20,5,4,0,0,45
1,2,12,1,20,5,19,0,0,60
1,2,12,1,20,9,14,7,0,66
1,2,12,1,20,9,15,14,0,74
1,2,12,1,20,9,15,14,19,93
1,2,12,1,20,9,22,1,12,80
1,2,12,1,20,9,22,5,0,72
1,2,12,1,20,9,22,5,19,91
1,2,12,1,20,15,18,0,0,69
1,2,12,1,21,20,0,0,0,57
1,2,12,1,21,20,19,0,0,76
1,2,12,1,26,5,0,0,0,47
1,2,12,5,0,0,0,0,0,20
1,2,12,5,5,26,5,0,0,56
1,2,12,5,7,1,20,5,0,53
1,2,12,5,7,1,20,5,19,72
1,2,12,5,14,4,0,0,0,38
1,2,12,5,14,5,19,19,0,77
1,2,12,5,16,19,25,0,0,80
1,2,12,5,16,19,9,1,0,65
1,2,12,5,18,0,0,0,0,38
1,2,12,5,19,0,0,0,0,39
1,2,12,5,19,19,5,0,0,63
1,2,12,5,19,20,0,0,0,59
1,2,12,5,20,0,0,0,0,40
1,2,12,25,0,0,0,0,0,40
1,2,12,9,14,7,19,0,0,64
1,2,12,9,14,19,0,0,0,57
1,2,12,15,3,11,0,0,0,44
1,2,12,15,15,13,0,0,0,58
1,2,12,15,23,0,0,0,0,53
1,2,12,21,4,5,0,0,0,45
1,2,12,21,5,14,20,0,0,75
1,2,12,21,5,14,20,19,0,94
1,2,12,21,19,8,0,0,0,63
1,2,12,21,20,5,0,0,0,61
1,2,12,21,20,5,4,0,0,65
1,2,12,21,20,9,15,14,0,94
1,2,12,21,20,9,15,14,19,113
1,2,12,21,22,9,15,14,0,96
1,2,13,8,15,0,0,0,0,39
1,2,13,8,15,19,0,0,0,58
1,2,14,0,0,0,0,0,0,17
1,2,14,5,7,1,20,5,0,55
1,2,14,5,7,1,20,5,4,59
1,2,14,5,7,1,20,5,19,74
1,2,14,5,7,1,20,15,18,83
1,2,14,5,18,22,1,12,0,75
1,2,14,5,20,0,0,0,0,42
1,2,14,5,21,18,1,12,0,74
1,2,14,15,18,13,1,12,0,76
1,2,14,15,18,13,1,12,19,95
1,2,14,15,18,13,9,20,25,117
1,2,14,15,18,13,15,21,19,118
1,2,15,1,18,4,0,0,0,41
1,2,15,1,18,4,1,7,5,54
1,2,15,3,15,3,11,5,20,75
1,2,15,4,1,8,0,0,0,31
1,2,15,4,5,0,0,0,0,27
1,2,15,4,5,4,0,0,0,31
1,2,15,4,5,13,5,14,20,79
1,2,15,4,5,19,0,0,0,46
1,2,15,4,25,0,0,0,0,47
1,2,15,4,9,14,7,0,0,52
1,2,15,7,1,4,15,0,0,45
1,2,15,7,1,4,15,19,0,64
1,2,15,8,13,0,0,0,0,39
1,2,15,8,13,19,0,0,0,58
1,2,15,9,4,5,1,21,0,58
1,2,15,9,4,5,1,21,19,77
1,2,15,9,4,5,1,21,24,82
1,2,15,9,12,0,0,0,0,39
1,2,15,9,20,5,1,21,0,74
1,2,15,9,20,5,1,21,19,93
1,2,15,9,20,5,1,21,24,98
1,2,15,12,5,20,5,0,0,60
1,2,15,12,9,19,8,0,0,66
1,2,15,12,9,19,8,5,4,75
1,2,15,12,9,19,8,5,18,89
1,2,15,12,9,19,8,5,19,90
1,2,15,12,9,20,9,15,14,97
1,2,15,12,12,1,0,0,0,43
1,2,15,12,12,1,5,0,0,48
1,2,15,13,1,0,0,0,0,32
1,2,15,13,1,19,0,0,0,51
1,2,15,13,1,19,1,0,0,52
1,2,15,13,1,19,1,12,0,64
1,2,15,13,1,19,9,0,0,60
1,2,15,13,1,19,21,13,0,85
1,2,15,13,1,19,21,19,0,91
1,2,15,13,1,19,21,19,9,100
1,2,15,13,9,14,1,20,5,80
1,2,15,13,9,14,5,0,0,59
1,2,15,14,4,1,14,3,5,59
1,2,15,14,14,5,0,0,0,51
1,2,15,15,14,0,0,0,0,47
1,2,15,18,1,4,0,0,0,41
1,2,15,18,1,12,0,0,0,49
1,2,15,18,1,12,12,25,0,86
1,2,15,18,4,0,0,0,0,40
1,2,15,18,14,9,14,7,0,80
1,2,15,18,19,9,22,5,0,91
1,2,15,18,20,0,0,0,0,56
1,2,15,18,20,5,4,0,0,65
1,2,15,18,20,5,18,0,0,79
1,2,15,18,20,5,18,19,0,98
1,2,15,18,20,9,5,14,20,104
1,2,15,18,20,9,14,0,0,79
1,2,15,18,20,9,14,7,0,86
1,2,15,18,20,9,15,14,0,94
1,2,15,18,20,9,15,14,19,113
1,2,15,18,20,9,22,5,0,92
1,2,15,18,20,19,0,0,0,75
1,2,15,18,20,21,19,0,0,96
1,2,15,18,20,21,19,5,19,120
1,2,15,19,0,0,0,0,0,37
1,2,15,20,5,0,0,0,0,43
1,2,15,21,4,9,11,18,15,96
1,2,15,21,7,8,20,0,0,74
1,2,15,21,12,9,1,0,0,61
1,2,15,21,12,9,1,19,0,80
1,2,15,21,12,9,3,0,0,63
1,2,15,21,14,4,0,0,0,57
1,2,15,21,14,4,5,4,0,66
1,2,15,21,14,4,5,18,0,80
1,2,15,21,14,4,9,14,7,87
1,2,15,21,14,4,19,0,0,76
1,2,15,21,20,0,0,0,0,59
1,2,15,21,20,19,0,0,0,78
1,2,15,22,5,0,0,0,0,45
1,2,15,22,5,4,5,3,11,68
1,2,15,22,5,19,0,0,0,64
1,2,15,22,5,19,1,9,4,78
1,2,15,23,0,0,0,0,0,41
1,2,15,24,0,0,0,0,0,42
1,2,18,0,0,0,0,0,0,21
1,2,18,1,3,8,9,1,0,43
1,2,18,1,3,8,9,1,19,62
1,2,18,1,4,1,2,12,5,46
1,2,18,1,4,1,14,20,0,61
1,2,18,1,4,1,14,20,19,80
1,2,18,1,4,5,0,0,0,31
1,2,18,1,4,5,4,0,0,35
1,2,18,1,4,5,18,0,0,49
1,2,18,1,4,5,18,19,0,68
1,2,18,1,4,5,19,0,0,50
1,2,18,1,4,9,14,7,0,56
1,2,18,1,25,0,0,0,0,47
1,2,18,1,9,4,0,0,0,35
1,2,18,1,19,1,24,0,0,66
1,2,18,1,19,5,0,0,0,46
1,2,18,1,19,5,4,0,0,50
1,2,18,1,19,5,18,0,0,64
1,2,18,1,19,8,0,0,0,49
1,2,18,1,19,9,14,7,0,71
1,2,18,1,19,9,15,14,0,79
1,2,18,1,19,9,15,14,19,98
1,2,18,1,19,9,22,5,0,77
1,2,18,1,19,9,22,5,19,96
1,2,18,1,19,20,15,12,0,88
1,2,18,1,21,13,0,0,0,56
1,2,18,1,24,1,19,0,0,66
1,2,18,1,26,9,20,5,0,82
1,2,18,1,26,9,20,9,3,89
1,2,18,1,26,15,0,0,0,63
1,2,18,1,26,15,19,0,0,82
1,2,18,5,1,3,20,0,0,50
1,2,18,5,1,3,20,5,4,59
1,2,18,5,1,3,20,19,0,69
1,2,18,5,1,19,20,0,0,66
1,2,18,5,5,4,0,0,0,35
1,2,18,5,7,5,0,0,0,38
1,2,18,5,9,4,0,0,0,39
1,2,18,5,16,20,9,15,14,100
1,2,18,5,20,0,0,0,0,46
1,2,18,5,21,22,15,9,18,111
1,2,18,9,0,0,0,0,0,30
1,2,18,9,3,15,0,0,0,48
1,2,18,9,3,15,3,11,0,62
1,2,18,9,3,15,20,0,0,68
1,2,18,9,4,7,5,0,0,46
1,2,18,9,4,7,5,4,0,50
1,2,18,9,4,7,5,18,0,64
1,2,18,9,4,7,5,18,19,83
1,2,18,9,4,7,5,19,0,65
1,2,18,9,4,7,9,14,7,71
1,2,18,9,13,0,0,0,0,43
1,2,18,9,14,0,0,0,0,44
1,2,18,9,14,5,0,0,0,49
1,2,18,9,19,0,0,0,0,49
1,2,18,9,19,20,12,5,0,86
1,2,18,15,1,3,8,0,0,48
1,2,18,15,1,4,0,0,0,41
1,2,18,15,3,15,13,5,0,72
1,2,18,15,7,1,2,12,5,63
1,2,18,15,7,1,20,5,0,69
1,2,18,15,7,1,20,5,4,73
1,2,18,15,7,1,20,5,19,88
1,2,18,15,7,1,20,15,18,97
1,2,18,15,15,4,0,0,0,55
1,2,18,15,15,11,0,0,0,62
1,2,18,15,19,9,1,0,0,65
1,2,18,15,19,9,1,19,0,84
1,2,18,15,20,1,14,21,13,105
1,2,18,15,20,9,14,0,0,79
1,2,18,15,20,9,14,5,0,84
1,2,18,21,16,20,0,0,0,78
1,2,18,21,16,20,5,18,0,101
1,2,18,21,16,20,5,19,20,122
1,2,18,21,16,20,9,15,0,102
1,2,18,21,16,20,9,15,14,116
1,2,18,21,16,20,12,25,0,115
1,2,19,1,13,16,5,18,5,80
1,2,19,3,1,13,0,0,0,39
1,2,19,3,5,19,19,0,0,68
1,2,19,3,5,19,19,5,4,77
1,2,19,3,5,19,19,5,19,92
1,2,19,3,9,14,4,0,0,52
1,2,19,3,9,19,5,0,0,58
1,2,19,3,9,19,5,4,0,62
1,2,19,3,9,19,5,19,0,77
1,2,19,3,9,19,9,14,0,76
1,2,19,3,9,19,9,14,7,83
1,2,19,3,9,19,9,14,19,95
1,2,19,3,9,19,9,15,14,91
1,2,19,3,9,19,19,0,0,72
1,2,19,3,9,19,19,1,0,73
1,2,19,3,9,19,19,1,5,78
1,2,19,3,9,19,19,1,19,92
1,2,19,3,9,19,19,5,0,77
1,2,19,3,9,19,19,9,14,95
1,2,19,3,15,14,3,5,0,62
1,2,19,3,15,14,4,0,0,58
1,2,19,3,15,14,4,5,4,67
1,2,19,3,15,14,4,5,18,81
1,2,19,3,15,14,4,19,0,77
1,2,19,3,15,14,19,1,0,74
1,2,19,3,15,21,14,4,0,79
1,2,19,5,5,0,0,0,0,32
1,2,19,5,25,0,0,0,0,52
1,2,19,5,9,12,0,0,0,48
1,2,19,5,9,12,5,4,0,57
1,2,19,5,9,12,9,14,7,78
1,2,19,5,9,12,19,0,0,67
1,2,19,5,14,3,5,0,0,49
1,2,19,5,14,3,5,19,0,68
1,2,19,5,14,20,0,0,0,61
1,2,19,5,14,20,5,4,0,70
1,2,19,5,14,20,5,5,0,71
1,2,19,5,14,20,5,5,19,90
1,2,19,5,14,20,5,18,0,84
1,2,19,5,14,20,5,18,19,103
1,2,19,5,14,20,9,1,0,71
1,2,19,5,14,20,9,14,7,91
1,2,19,5,14,20,12,25,0,98
1,2,19,5,14,20,19,0,0,80
1,2,19,6,1,18,1,4,0,52
1,2,19,8,5,14,18,25,0,92
1,2,19,9,14,20,8,0,0,73
1,2,19,9,14,20,8,5,0,78
1,2,19,9,14,20,8,5,19,97
1,2,19,9,14,20,8,9,3,85
1,2,19,9,14,20,8,9,14,96
1,2,19,9,14,20,8,15,12,100
1,2,19,9,14,20,8,19,0,92
1,2,19,9,19,0,0,0,0,50
1,2,19,9,19,20,0,0,0,70
1,2,19,9,19,20,15,19,0,104
1,2,19,9,20,0,0,0,0,51
1,2,19,13,8,15,0,0,0,58
1,2,19,15,8,13,0,0,0,58
1,2,19,15,9,12,0,0,0,58
1,2,19,15,12,5,14,20,0,88
1,2,19,15,12,21,20,5,18,113
1,2,19,15,12,21,20,5,19,114
1,2,19,15,12,22,5,0,0,76
1,2,19,15,12,22,5,4,0,80
1,2,19,15,12,22,5,14,20,110
1,2,19,15,12,22,5,18,0,94
1,2,19,15,12,22,5,18,19,113
1,2,19,15,12,22,5,19,0,95
1,2,19,15,12,22,9,14,7,101
1,2,19,15,14,1,14,20,0,86
1,2,19,15,14,15,21,19,0,106
1,2,19,15,18,2,0,0,0,57
1,2,19,15,18,2,1,14,20,92
1,2,19,15,18,2,5,4,0,66
1,2,19,15,18,2,5,14,20,96
1,2,19,15,18,2,5,18,0,80
1,2,19,15,18,2,5,18,19,99
1,2,19,15,18,2,9,14,7,87
1,2,19,15,18,2,19,0,0,76
1,2,19,15,18,16,20,0,0,91
1,2,19,20,1,9,14,0,0,66
1,2,19,20,1,9,14,5,4,75
1,2,19,20,1,9,14,5,18,89
1,2,19,20,1,9,14,19,0,85
1,2,19,20,5,18,7,5,0,77
1,2,19,20,5,18,7,5,4,81
1,2,19,20,5,18,7,5,19,96
1,2,19,20,5,18,19,5,0,89
1,2,19,20,9,14,5,14,20,104
1,2,19,20,15,18,20,0,0,95
1,2,19,20,18,0,0,0,0,60
1,2,19,20,18,1,3,20,0,84
1,2,19,20,18,1,3,20,19,103
1,2,19,20,18,9,3,20,0,92
1,2,19,20,18,9,3,20,19,111
1,2,19,20,18,21,4,5,0,90
1,2,19,20,18,21,19,5,0,105
1,2,19,20,18,21,19,5,18,123
1,2,19,21,13,5,0,0,0,61
1,2,19,21,18,4,0,0,0,65
1,2,19,21,18,4,5,18,0,88
1,2,19,21,18,4,5,19,20,109
1,2,19,21,18,4,9,19,13,106
1,2,19,21,18,4,9,19,20,113
1,2,19,21,18,4,9,20,25,119
1,2,19,21,18,4,12,25,0,102
1,2,19,21,18,4,19,0,0,84
1,2,19,21,18,4,21,13,0,99
1,2,19,22,15,12,20,0,0,91
1,2,20,0,0,0,0,0,0,23
1,2,20,8,1,9,14,0,0,55
1,2,20,8,1,9,14,18,25,98
1,2,20,8,1,14,1,7,5,59
1,2,20,18,21,19,5,0,0,86
1,2,21,2,2,12,5,0,0,45
1,2,21,3,3,15,0,0,0,45
1,2,21,9,12,4,9,14,7,79
1,2,21,12,5,9,1,0,0,51
1,2,21,12,9,1,0,0,0,46
1,2,21,12,9,1,19,0,0,65
1,2,21,12,9,3,0,0,0,48
1,2,21,12,25,5,9,20,0,95
1,2,21,13,2,18,1,12,0,70
1,2,21,14,4,1,14,3,5,65
1,2,21,14,4,1,14,3,25,85
1,2,21,14,4,1,14,20,0,77
1,2,21,14,5,0,0,0,0,43
1,2,21,18,1,0,0,0,0,43
1,2,21,18,1,2,15,26,21,107
1,2,21,18,1,7,9,18,9,86
1,2,21,18,2,1,14,0,0,59
1,2,21,18,19,20,0,0,0,81
1,2,21,18,20,15,14,0,0,91
1,2,21,19,1,2,12,5,0,63
1,2,21,19,1,7,5,0,0,56
1,2,21,19,5,0,0,0,0,48
1,2,21,19,5,4,0,0,0,52
1,2,21,19,5,4,12,25,0,89
1,2,21,19,5,5,0,0,0,53
1,2,21,19,5,6,21,12,0,87
1,2,21,19,5,18,0,0,0,66
1,2,21,19,5,18,19,0,0,85
1,2,21,19,5,19,0,0,0,67
1,2,21,19,8,0,0,0,0,51
1,2,21,19,9,14,7,0,0,73
1,2,21,19,9,15,14,0,0,81
1,2,21,19,9,15,21,19,0,107
1,2,21,19,9,22,5,0,0,79
1,2,21,19,9,22,5,12,25,116
1,2,21,20,0,0,0,0,0,44
1,2,21,20,9,12,15,14,19,113
1,2,21,20,13,5,14,20,0,96
1,2,21,20,13,5,14,20,19,115
1,2,21,20,19,0,0,0,0,63
1,2,21,20,20,1,12,0,0,77
1,2,21,20,20,1,12,19,0,96
1,2,21,20,20,5,4,0,0,73
1,2,21,20,20,5,18,0,0,87
1,2,21,20,20,5,18,19,0,106
1,2,21,20,20,9,14,7,0,94
1,2,21,26,26,0,0,0,0,76
1,2,22,0,0,0,0,0,0,25
1,2,22,15,12,20,0,0,0,72
1,2,22,15,12,20,19,0,0,91
1,2,23,1,2,0,0,0,0,29
1,2,23,1,20,20,0,0,0,67
1,2,23,1,20,20,19,0,0,86
1,3,3,1,0,0,0,0,0,8
1,3,3,1,2,12,5,0,0,27
1,3,3,1,4,5,13,9,1,40
1,3,3,5,0,0,0,0,0,12
1,3,3,5,4,5,0,0,0,21
1,3,3,5,4,5,4,0,0,25
1,3,3,5,4,5,14,3,5,43
1,3,3,5,4,5,18,0,0,39
1,3,3,5,4,5,18,19,0,58
1,3,3,5,4,5,19,0,0,40
1,3,3,5,4,9,14,7,0,46
1,3,3,5,12,0,0,0,0,24
1,3,3,5,14,4,0,0,0,30
1,3,3,5,14,19,5,4,0,54
1,3,3,5,14,19,9,15,14,83
1,3,3,5,14,19,15,18,0,78
1,3,3,5,14,20,0,0,0,46
1,3,3,5,14,20,5,4,0,55
1,3,3,5,14,20,9,14,7,76
1,3,3,5,14,20,15,18,0,79
1,3,3,5,14,20,15,18,19,98
1,3,3,5,14,20,19,0,0,65
1,3,3,5,14,20,21,1,12,80
1,3,3,5,14,20,21,19,0,86
1,3,3,5,16,20,0,0,0,48
1,3,3,5,16,20,1,14,20,83
1,3,3,5,16,20,5,4,0,57
1,3,3,5,16,20,5,5,0,58
1,3,3,5,16,20,5,5,19,77
1,3,3,5,16,20,5,18,0,71
1,3,3,5,16,20,5,18,19,90
1,3,3,5,16,20,9,14,7,78
1,3,3,5,16,20,9,15,14,86
1,3,3,5,16,20,9,22,5,84
1,3,3,5,16,20,15,18,0,81
1,3,3,5,16,20,15,18,19,100
1,3,3,5,16,20,19,0,0,67
1,3,3,5,18,19,5,0,0,54
1,3,3,5,19,19,0,0,0,50
1,3,3,5,19,19,1,18,25,94
1,3,3,5,19,19,5,4,0,59
1,3,3,5,19,19,5,19,0,74
1,3,3,5,19,19,9,14,7,80
1,3,3,5,19,19,9,15,14,88
1,3,3,5,19,19,9,20,0,79
1,3,3,5,19,19,9,22,5,86
1,3,3,5,19,19,15,18,0,83
1,3,3,5,19,19,15,18,25,108
1,3,3,5,19,19,15,18,19,102
1,3,3,9,4,5,14,3,5,47
1,3,3,9,4,5,14,3,25,67
1,3,3,9,4,5,14,20,0,59
1,3,3,9,4,5,14,20,19,78
1,3,3,9,4,9,1,0,0,30
1,3,3,9,4,9,1,19,0,49
1,3,3,9,4,9,5,0,0,34
1,3,3,9,4,9,5,19,0,53
1,3,3,9,14,7,5,0,0,42
1,3,3,9,14,7,5,4,0,46
1,3,3,9,14,7,9,14,7,67
1,3,3,9,16,9,5,14,20,80
1,3,3,9,16,20,5,18,0,75
1,3,3,9,19,5,0,0,0,40
1,3,3,9,19,13,21,19,0,88
1,3,3,9,20,5,0,0,0,41
1,3,3,12,1,9,13,0,0,42
1,3,3,12,1,9,13,5,4,51
1,3,3,12,1,9,13,5,18,65
1,3,3,12,1,9,13,19,0,61
1,3,3,12,9,13,1,20,5,67
1,3,3,12,9,14,1,12,0,55
1,3,3,12,9,14,1,20,5,68
1,3,3,12,9,22,9,20,25,104
1,3,3,12,9,22,15,21,19,105
1,3,3,12,15,25,0,0,0,59
1,3,3,15,1,19,20,0,0,62
1,3,3,15,25,0,0,0,0,47
1,3,3,15,25,5,4,0,0,56
1,3,3,15,25,9,14,7,0,77
1,3,3,15,9,12,0,0,0,43
1,3,3,15,12,1,4,5,0,44
1,3,3,15,12,1,4,5,4,48
1,3,3,15,12,1,4,5,19,63
1,3,3,15,12,1,20,5,4,64
1,3,3,15,12,5,14,20,0,73
1,3,3,15,12,12,0,0,0,46
1,3,3,15,12,12,5,0,0,51
1,3,3,15,12,12,5,4,0,55
1,3,3,15,12,12,5,5,0,56
1,3,3,15,13,16,1,14,25,91
1,3,3,15,13,16,12,9,0,72
1,3,3,15,13,16,12,9,19,91
1,3,3,15,13,16,20,0,0,71
1,3,3,15,18,4,0,0,0,44
1,3,3,15,18,4,1,14,20,79
1,3,3,15,18,4,5,4,0,53
1,3,3,15,18,4,5,18,0,67
1,3,3,15,18,4,5,18,19,86
1,3,3,15,18,4,9,14,7,74
1,3,3,15,18,4,9,15,14,82
1,3,3,15,18,4,19,0,0,63
1,3,3,15,19,20,0,0,0,61
1,3,3,15,19,20,5,4,0,70
1,3,3,15,19,20,9,14,7,91
1,3,3,15,19,20,19,0,0,80
1,3,3,15,21,3,8,5,0,59
1,3,3,15,21,14,19,5,12,93
1,3,3,15,21,14,20,0,0,77
1,3,3,15,21,14,20,5,4,86
1,3,3,15,21,14,20,5,18,100
1,3,3,15,21,14,20,19,0,96
1,3,3,15,21,16,12,5,0,76
1,3,3,15,21,18,1,7,5,74
1,3,3,15,21,18,20,0,0,81
1,3,3,15,21,20,5,18,0,86
1,3,3,15,21,20,5,18,19,105
1,3,3,15,21,20,18,5,0,86
1,3,3,15,21,20,18,5,4,90
1,3,3,15,21,20,18,5,19,105
1,3,3,18,5,1,19,5,0,55
1,3,3,18,5,4,9,20,0,63
1,3,3,18,5,4,9,20,19,82
1,3,3,18,5,19,3,5,0,57
1,3,3,18,5,20,1,12,0,63
1,3,3,18,5,20,5,0,0,55
1,3,3,18,5,20,5,4,0,59
1,3,3,18,5,20,5,19,0,74
1,3,3,18,5,20,9,14,7,80
1,3,3,18,5,20,9,15,14,88
1,3,3,18,5,20,9,22,5,86
1,3,3,18,15,1,3,8,0,52
1,3,3,18,15,9,4,5,19,77
1,3,3,18,21,1,2,12,5,66
1,3,3,18,21,1,12,0,0,59
1,3,3,18,21,1,12,19,0,78
1,3,3,18,21,5,0,0,0,51
1,3,3,18,21,5,4,0,0,55
1,3,3,18,21,5,18,0,0,69
1,3,3,18,21,5,19,0,0,70
1,3,3,18,21,9,14,7,0,76
1,3,3,20,19,0,0,0,0,46
1,3,3,21,2,9,20,1,0,60
1,3,3,21,2,9,20,21,13,93
1,3,3,21,2,9,20,21,19,99
1,3,3,21,5,9,12,0,0,54
1,3,3,21,13,0,0,0,0,41
1,3,3,21,13,2,0,0,0,43
1,3,3,21,13,2,5,14,20,82
1,3,3,21,13,2,5,18,0,66
1,3,3,21,16,25,0,0,0,69
1,3,3,21,18,0,0,0,0,46
1,3,3,21,18,1,3,25,0,75
1,3,3,21,18,1,20,5,0,72
1,3,3,21,18,18,5,0,0,69
1,3,3,21,18,19,5,0,0,70
1,3,3,21,18,19,5,4,0,74
1,3,3,21,18,19,9,14,7,95
1,3,3,21,18,19,20,0,0,85
1,3,3,21,19,0,0,0,0,47
1,3,3,21,19,1,2,12,5,67
1,3,3,21,19,1,2,12,25,87
1,3,3,21,19,1,12,0,0,60
1,3,3,21,19,1,12,19,0,79
1,3,3,21,19,1,14,20,0,82
1,3,3,21,19,1,14,20,19,101
1,3,3,21,19,1,20,15,18,101
1,3,3,21,19,5,0,0,0,52
1,3,3,21,19,5,4,0,0,56
1,3,3,21,19,5,18,0,0,70
1,3,3,21,19,5,18,19,0,89
1,3,3,21,19,5,19,0,0,71
1,3,3,21,19,9,14,7,0,77
1,3,3,21,19,9,22,5,0,83
1,3,3,21,19,15,18,0,0,80
1,3,3,21,19,20,15,13,0,95
1,3,3,21,19,20,15,13,19,114
1,3,5,1,0,0,0,0,0,10
1,3,5,1,5,0,0,0,0,15
1,3,5,1,14,0,0,0,0,24
1,3,5,3,1,6,6,9,14,48
1,3,5,4,0,0,0,0,0,13
1,3,5,4,25,0,0,0,0,38
1,3,5,4,9,1,0,0,0,23
1,3,5,4,9,1,13,9,14,59
1,3,5,4,9,1,19,0,0,42
1,3,5,4,9,1,19,20,0,62
1,3,5,9,20,5,0,0,0,43
1,3,5,9,20,21,14,1,0,74
1,3,5,12,4,1,13,1,19,59
1,3,5,12,12,21,12,1,18,85
1,3,5,13,9,12,1,0,0,44
1,3,5,14,19,21,1,4,1,69
1,3,5,14,20,18,9,3,0,73
1,3,5,14,20,18,15,21,19,116
1,3,5,15,12,15,7,25,0,83
1,3,5,15,12,15,7,9,3,70
1,3,5,15,21,19,0,0,0,64
1,3,5,16,8,1,12,0,0,46
1,3,5,16,8,1,12,1,14,61
1,3,5,16,8,1,12,9,1,56
1,3,5,16,8,1,12,21,19,86
1,3,5,16,15,20,19,0,0,79
1,3,5,17,21,9,1,0,0,57
1,3,5,17,21,9,1,19,0,76
1,3,5,18,1,20,5,0,0,53
1,3,5,18,1,20,5,4,0,57
1,3,5,18,2,0,0,0,0,29
1,3,5,18,2,1,20,5,0,55
1,3,5,18,2,1,20,5,4,59
1,3,5,18,2,1,20,5,19,74
1,3,5,18,2,5,18,0,0,52
1,3,5,18,2,5,19,20,0,73
1,3,5,18,2,9,3,0,0,41
1,3,5,18,2,9,20,25,0,83
1,3,5,18,2,12,25,0,0,66
1,3,5,18,4,15,12,0,0,58
1,3,5,18,9,3,0,0,0,39
1,3,5,18,9,14,0,0,0,50
1,3,5,18,12,9,0,0,0,48
1,3,5,18,15,12,1,0,0,55
1,3,5,18,15,12,1,19,0,74
1,3,5,18,15,19,5,0,0,66
1,3,5,18,15,21,19,0,0,82
1,3,5,18,18,1,0,0,0,46
1,3,5,18,19,0,0,0,0,46
1,3,5,18,22,1,12,0,0,62
1,3,5,18,22,1,20,5,0,75
1,3,5,18,22,1,20,9,13,92
1,3,5,18,22,15,19,5,0,88
1,3,5,18,22,21,12,9,0,91
1,3,5,18,22,21,12,21,19,122
1,3,5,19,0,0,0,0,0,28
1,3,5,19,3,5,14,3,5,58
1,3,5,19,3,5,14,3,25,78
1,3,5,19,3,5,14,20,0,70
1,3,5,19,3,5,14,20,19,89
1,3,5,19,8,9,16,0,0,61
1,3,5,19,15,4,25,14,5,91
1,3,5,19,20,15,13,1,0,77
1,3,5,20,1,0,0,0,0,30
1,3,5,20,1,2,12,5,0,49
1,3,5,20,1,2,21,12,1,66
1,3,5,20,1,12,0,0,0,42
1,3,5,20,1,12,4,15,12,73
1,3,5,20,1,12,9,26,5,82
1,3,5,20,1,12,19,0,0,61
1,3,5,20,1,13,9,4,0,56
1,3,5,20,1,13,9,4,5,61
1,3,5,20,1,13,9,4,15,71
1,3,5,20,1,13,9,4,19,75
1,3,5,20,1,14,9,15,14,82
1,3,5,20,1,14,14,9,14,81
1,3,5,20,1,18,25,0,0,73
1,3,5,20,1,18,19,0,0,67
1,3,5,20,1,20,5,0,0,55
1,3,5,20,1,20,5,4,0,59
1,3,5,20,1,20,5,19,0,74
1,3,5,20,1,20,9,15,14,88
1,3,5,20,5,14,25,12,0,85
1,3,5,20,9,1,13,0,0,52
1,3,5,20,9,3,0,0,0,41
1,3,5,20,9,6,25,0,0,69
1,3,5,20,9,6,9,5,4,62
1,3,5,20,9,6,9,5,18,76
1,3,5,20,9,6,9,5,19,77
1,3,5,20,25,12,0,0,0,66
1,3,5,20,25,12,1,20,5,92
1,3,5,20,25,12,5,14,5,90
1,3,5,20,25,12,9,3,0,78
1,3,5,20,25,12,9,4,0,79
1,3,5,20,25,12,9,4,5,84
1,3,5,20,25,12,9,26,5,106
1,3,5,20,25,12,19,0,0,85
1,3,5,20,9,14,0,0,0,52
1,3,5,20,9,14,5,0,0,57
1,3,5,20,9,14,19,0,0,71
1,3,5,20,9,20,5,0,0,63
1,3,5,20,9,26,5,0,0,69
1,3,5,20,12,1,0,0,0,42
1,3,5,20,15,9,14,0,0,67
1,3,5,20,15,12,0,0,0,56
1,3,5,20,15,14,1,20,5,84
1,3,5,20,15,14,5,0,0,63
1,3,5,20,15,14,5,19,0,82
1,3,5,20,15,14,9,3,0,70
1,3,5,20,15,14,25,12,0,95
1,3,5,20,15,14,9,26,5,98
1,3,5,20,15,19,5,0,0,68
1,3,5,20,15,19,9,20,25,117
1,3,5,20,15,21,19,0,0,84
1,3,5,20,15,24,25,12,0,105
1,3,5,20,15,24,25,12,19,124
1,3,5,20,15,24,9,13,0,90
1,3,5,20,15,24,9,13,5,95
1,3,5,20,18,1,3,20,0,71
1,3,5,20,21,13,0,0,0,63
1,3,5,20,21,18,9,3,0,80
1,3,8,1,5,20,15,21,19,93
1,3,8,1,6,5,0,0,0,24
1,3,8,1,7,5,0,0,0,25
1,3,8,1,12,1,19,9,1,55
1,3,8,1,16,5,0,0,0,34
1,3,8,1,17,21,5,0,0,56
1,3,8,1,18,0,0,0,0,31
1,3,8,1,18,25,1,0,0,57
1,3,8,1,18,14,5,0,0,50
1,3,8,1,20,5,0,0,0,38
1,3,8,1,20,15,21,18,0,87
1,3,8,5,0,0,0,0,0,17
1,3,8,5,1,20,0,0,0,38
1,3,8,5,3,8,0,0,0,28
1,3,8,5,3,11,0,0,0,31
1,3,8,5,4,0,0,0,0,21
1,3,8,5,5,18,0,0,0,40
1,3,8,5,9,12,1,18,25,82
1,3,8,5,9,12,9,1,0,48
1,3,8,5,9,12,15,21,19,93
1,3,8,5,9,18,9,1,0,54
1,3,8,5,9,18,15,21,19,99
1,3,8,5,9,18,21,19,0,84
1,3,8,5,14,5,0,0,0,36
1,3,8,5,14,5,19,0,0,55
1,3,8,5,14,9,1,0,0,41
1,3,8,5,14,9,1,12,0,53
1,3,8,5,14,9,21,13,0,74
1,3,8,5,14,15,4,9,1,60
1,3,8,5,18,0,0,0,0,35
1,3,8,5,19,0,0,0,0,36
1,3,8,5,19,15,21,14,0,86
1,3,8,5,20,5,0,0,0,42
1,3,8,5,23,5,5,4,0,54
1,3,8,25,0,0,0,0,0,37
1,3,8,9,5,18,0,0,0,44
1,3,8,9,5,19,20,0,0,65
1,3,8,9,5,22,5,0,0,53
1,3,8,9,5,22,5,4,0,57
1,3,8,9,5,22,5,18,0,71
1,3,8,9,5,22,5,18,19,90
1,3,8,9,5,22,5,19,0,72
1,3,8,9,5,22,9,14,7,78
1,3,8,9,7,1,14,0,0,43
1,3,8,9,12,1,18,25,0,77
1,3,8,25,12,9,1,0,0,59
1,3,8,9,12,12,5,1,19,70
1,3,8,9,12,12,5,9,14,73
1,3,8,9,12,15,21,19,0,88
1,3,8,25,12,15,21,19,0,104
1,3,8,9,13,5,0,0,0,39
1,3,8,25,13,9,1,0,0,60
1,3,8,25,13,15,21,19,0,105
1,3,8,9,14,5,19,19,0,78
1,3,8,9,14,7,0,0,0,42
1,3,8,9,14,7,12,25,0,79
1,3,8,9,15,20,5,0,0,61
1,3,8,9,15,20,5,19,0,80
1,3,8,9,18,1,0,0,0,40
1,3,8,9,18,9,20,5,0,73
1,3,8,11,1,14,0,0,0,38
1,3,8,15,11,5,0,0,0,43
1,3,8,15,12,9,1,0,0,49
1,3,8,15,12,9,1,19,0,68
1,3,8,15,12,9,3,0,0,51
1,3,8,15,12,15,21,19,0,94
1,3,8,15,12,21,18,9,1,88
1,3,8,15,12,21,18,9,3,90
1,3,8,15,15,0,0,0,0,42
1,3,8,15,18,0,0,0,0,45
1,3,8,15,18,4,1,12,0,62
1,3,8,15,18,4,1,20,5,75
1,3,8,18,5,5,0,0,0,40
1,3,8,18,15,9,20,5,0,79
1,3,8,18,15,13,1,0,0,59
1,3,8,18,15,13,1,20,0,79
1,3,8,18,15,13,1,20,5,84
1,3,8,18,15,13,1,20,19,98
1,3,8,18,15,13,9,1,0,68
1,3,8,18,15,13,9,3,0,70
1,3,8,18,15,13,15,21,19,113
1,3,8,18,15,14,9,19,13,100
1,3,8,18,15,15,21,19,0,100
1,3,8,18,15,16,19,9,1,90
1,3,8,20,5,12,0,0,0,49
1,3,8,20,5,18,0,0,0,55
1,3,8,21,5,20,5,0,0,63
1,3,25,0,0,0,0,0,0,29
1,3,25,3,12,9,3,0,0,56
1,3,9,3,21,12,1,0,0,50
1,3,9,3,21,12,1,5,0,55
1,3,9,3,21,12,1,18,0,68
1,3,9,3,21,12,1,19,0,69
1,3,9,3,21,12,1,20,5,75
1,3,9,3,21,12,21,13,0,83
1,3,9,3,21,12,21,13,19,102
1,3,9,4,0,0,0,0,0,17
1,3,9,4,1,5,13,9,1,46
1,3,9,4,5,13,9,1,0,45
1,3,9,4,5,13,9,1,19,64
1,3,9,4,5,18,0,0,0,40
1,3,9,4,8,5,1,4,0,35
1,3,9,4,8,5,1,4,19,54
1,3,9,4,25,0,0,0,0,42
1,3,9,4,9,3,0,0,0,29
1,3,9,4,9,6,25,0,0,57
1,3,9,4,9,6,9,3,0,44
1,3,9,4,9,6,9,5,4,50
1,3,9,4,9,6,9,5,18,64
1,3,9,4,9,6,9,5,19,65
1,3,9,4,25,12,0,0,0,54
1,3,9,4,9,20,5,0,0,51
1,3,9,4,9,20,25,0,0,71
1,3,9,4,9,20,9,5,19,79
1,3,9,4,9,26,5,0,0,57
1,3,9,4,9,26,5,4,0,61
1,3,9,4,9,26,9,14,7,82
1,3,9,4,12,25,0,0,0,54
1,3,9,4,14,5,19,19,0,74
1,3,9,4,15,9,4,0,0,45
1,3,9,4,15,12,15,7,25,91
1,3,9,4,15,16,8,9,12,77
1,3,9,4,15,19,5,19,0,75
1,3,9,4,15,19,9,19,0,79
1,3,9,4,15,20,9,3,0,64
1,3,9,4,16,18,15,15,6,87
1,3,9,4,19,0,0,0,0,36
1,3,9,4,21,12,1,14,20,85
1,3,9,4,21,12,1,20,5,76
1,3,9,4,21,12,5,14,20,89
1,3,9,4,21,12,15,21,19,105
1,3,9,4,21,18,9,1,0,66
1,3,9,4,21,18,9,1,19,85
1,3,9,4,21,18,9,3,0,68
1,3,9,5,18,0,0,0,0,36
1,3,9,5,18,1,7,5,0,49
1,3,9,5,18,1,20,5,0,62
1,3,9,5,18,1,20,5,4,66
1,3,9,5,18,1,20,5,19,81
1,3,9,5,19,0,0,0,0,37
1,3,25,5,19,9,19,0,0,81
1,3,25,5,20,9,3,0,0,66
1,3,9,6,15,18,13,0,0,65
1,3,25,12,0,0,0,0,0,41
1,3,25,12,1,12,0,0,0,54
1,3,25,12,1,13,9,4,15,83
1,3,25,12,1,13,9,14,15,93
1,3,25,12,1,19,5,0,0,66
1,3,25,12,1,20,5,0,0,67
1,3,25,12,1,20,5,4,0,71
1,3,25,12,1,20,5,19,0,86
1,3,25,12,1,20,9,14,7,92
1,3,25,12,1,20,9,15,14,100
1,3,9,12,9,1,20,5,0,60
1,3,9,12,9,1,20,5,4,64
1,3,25,12,15,7,5,14,0,82
1,3,25,12,15,9,14,0,0,79
1,3,25,12,15,9,14,19,0,98
1,3,25,12,15,24,25,0,0,105
1,3,25,12,19,0,0,0,0,60
1,3,9,14,1,3,5,19,0,55
1,3,9,14,1,3,9,20,25,85
1,3,9,14,1,18,0,0,0,46
1,3,9,14,1,18,25,0,0,71
1,3,9,14,5,20,1,14,0,67
1,3,9,14,5,20,9,3,0,64
1,3,9,14,7,0,0,0,0,34
1,3,9,14,9,0,0,0,0,36
1,3,9,14,9,3,0,0,0,39
1,3,9,14,9,6,15,18,13,88
1,3,9,14,15,19,5,0,0,66
1,3,9,14,15,21,19,0,0,82
1,3,9,14,21,14,9,0,0,71
1,3,9,14,21,19,0,0,0,67
1,3,9,15,21,19,0,0,0,68
1,3,25,18,15,12,15,7,25,121
1,3,25,19,20,9,1,0,0,78
1,3,9,20,1,20,5,0,0,59
1,3,9,20,25,0,0,0,0,58
1,3,9,21,18,7,25,0,0,84
1,3,11,5,5,0,0,0,0,25
1,3,11,5,5,19,0,0,0,44
1,3,11,5,25,0,0,0,0,45
1,3,11,5,25,19,0,0,0,64
1,3,11,13,1,14,0,0,0,43
1,3,11,13,5,14,0,0,0,47
1,3,11,14,5,23,0,0,0,57
1,3,11,14,15,23,0,0,0,67
1,3,11,14,15,23,9,14,7,97
1,3,11,14,15,23,14,0,0,81
1,3,11,20,15,14,0,0,0,64
1,3,12,1,19,20,9,3,0,68
1,3,12,5,0,0,0,0,0,21
1,3,12,5,9,4,9,1,14,58
1,3,12,25,4,5,19,0,0,69
1,3,12,9,4,9,1,14,0,53
1,3,12,9,14,1,12,0,0,52
1,3,12,9,14,9,3,0,0,51
1,3,12,25,19,0,0,0,0,60
1,3,12,15,21,4,0,0,0,56
1,3,13,1,20,9,3,0,0,50
1,3,13,5,0,0,0,0,0,22
1,3,13,5,19,0,0,0,0,41
1,3,13,9,3,0,0,0,0,29
1,3,13,9,20,5,0,0,0,51
1,3,14,5,0,0,0,0,0,23
1,3,14,5,4,0,0,0,0,27
1,3,14,5,6,15,18,13,0,75
1,3,14,5,9,6,15,18,13,84
1,3,14,5,13,9,1,0,0,46
1,3,14,5,19,0,0,0,0,42
1,3,14,15,4,1,12,0,0,50
1,3,14,15,4,5,0,0,0,42
1,3,14,15,4,5,19,0,0,61
1,3,15,1,19,13,0,0,0,52
1,3,15,1,19,13,1,0,0,53
1,3,15,3,11,0,0,0,0,33
1,3,15,3,11,2,9,12,12,68
1,3,15,3,15,20,12,0,0,69
1,3,15,5,12,15,21,19,0,91
1,3,15,9,14,0,0,0,0,42
1,3,15,9,14,5,0,0,0,47
1,3,15,12,4,0,0,0,0,35
1,3,15,12,25,20,5,0,0,81
1,3,15,12,25,20,5,19,0,100
1,3,15,12,25,20,8,0,0,84
1,3,15,12,25,20,21,19,0,116
1,3,15,12,15,7,25,0,0,78
1,3,15,12,15,7,9,3,0,65
1,3,15,12,15,21,19,0,0,86
1,3,15,12,21,20,8,9,3,92
1,3,15,13,9,1,0,0,0,42
1,3,15,13,15,21,19,0,0,87
1,3,15,14,1,20,9,22,5,90
1,3,15,14,5,0,0,0,0,38
1,3,15,14,9,3,0,0,0,45
1,3,15,14,9,14,0,0,0,56
1,3,15,14,9,14,5,0,0,61
1,3,15,14,9,20,1,12,0,75
1,3,15,14,9,20,5,0,0,67
1,3,15,14,9,20,5,19,0,86
1,3,15,14,9,20,9,1,0,72
1,3,15,14,9,20,9,3,0,74
1,3,15,14,9,20,9,14,0,85
1,3,15,14,9,20,9,14,5,90
1,3,15,14,9,20,21,13,19,115
1,3,15,14,20,9,1,0,0,63
1,3,15,14,20,9,21,13,0,96
1,3,15,15,12,0,0,0,0,46
1,3,15,16,0,0,0,0,0,35
1,3,15,16,9,3,0,0,0,47
1,3,15,16,25,18,9,14,0,101
1,3,15,16,25,18,9,14,5,106
1,3,15,16,15,14,0,0,0,64
1,3,15,18,0,0,0,0,0,37
1,3,15,18,5,1,0,0,0,43
1,3,15,18,9,1,0,0,0,47
1,3,15,18,14,0,0,0,0,51
1,3,15,18,14,5,4,0,0,60
1,3,15,18,14,19,0,0,0,70
1,3,15,19,13,9,3,0,0,63
1,3,15,19,13,9,19,13,0,92
1,3,15,19,13,9,19,20,0,99
1,3,15,19,20,0,0,0,0,58
1,3,15,21,1,19,13,0,0,73
1,3,15,21,3,8,9,0,0,60
1,3,15,21,3,8,25,0,0,76
1,3,15,21,13,5,20,5,18,101
1,3,15,21,13,5,20,18,25,121
1,3,15,21,14,20,5,18,0,97
1,3,15,21,16,0,0,0,0,56
1,3,15,21,16,1,0,0,0,57
1,3,15,21,16,5,0,0,0,61
1,3,15,21,19,13,1,0,0,73
1,3,15,21,19,13,1,19,0,92
1,3,15,21,19,13,1,20,1,94
1,3,15,21,19,20,9,3,0,91
1,3,15,21,19,20,9,3,19,110
1,3,16,20,0,0,0,0,0,40
1,3,17,21,1,9,14,20,0,86
1,3,17,21,1,9,14,20,19,105
1,3,17,21,5,14,20,0,0,81
1,3,17,21,5,18,5,21,18,109
1,3,17,21,5,19,20,0,0,86
1,3,17,21,5,19,20,19,0,105
1,3,17,21,9,5,19,3,5,83
1,3,17,21,9,5,20,0,0,76
1,3,17,21,9,18,5,0,0,74
1,3,17,21,9,18,5,4,0,78
1,3,17,21,9,18,5,18,0,92
1,3,17,21,9,18,5,18,19,111
1,3,17,21,9,18,5,19,0,93
1,3,17,21,9,18,9,14,7,99
1,3,17,21,9,19,9,20,1,100
1,3,17,21,9,19,9,20,5,104
1,3,17,21,9,19,20,0,0,90
1,3,17,21,9,20,0,0,0,71
1,3,17,21,9,20,1,12,0,84
1,3,17,21,9,20,19,0,0,90
1,3,17,21,9,20,20,1,12,104
1,3,17,21,9,20,20,5,4,100
1,3,17,21,9,20,20,5,18,114
1,3,18,1,3,25,0,0,0,51
1,3,18,1,5,9,14,0,0,51
1,3,18,1,14,9,1,12,0,59
1,3,18,1,14,9,1,20,5,72
1,3,18,1,19,25,0,0,0,67
1,3,18,1,19,9,1,0,0,52
1,3,18,1,19,9,1,19,0,71
1,3,18,1,19,9,14,0,0,65
1,3,18,1,19,9,14,19,0,84
1,3,18,1,20,9,1,0,0,53
1,3,18,1,23,12,0,0,0,58
1,3,18,1,26,5,0,0,0,54
1,3,18,5,1,2,12,5,0,47
1,3,18,5,1,7,5,0,0,40
1,3,18,5,1,7,5,19,0,59
1,3,18,5,1,11,0,0,0,39
1,3,18,5,1,13,0,0,0,41
1,3,18,5,4,0,0,0,0,31
1,3,18,5,13,1,14,0,0,55
1,3,18,5,13,5,14,0,0,59
1,3,18,5,19,20,1,6,6,79
1,3,18,9,4,0,0,0,0,35
1,3,18,9,4,1,14,0,0,50
1,3,18,9,4,1,14,5,0,55
1,3,18,9,4,5,18,0,0,58
1,3,18,9,4,5,19,20,0,79
1,3,18,9,4,9,1,14,0,59
1,3,18,9,4,9,3,0,0,47
1,3,18,9,4,9,4,0,0,48
1,3,18,9,4,25,12,0,0,72
1,3,18,9,4,9,14,0,0,58
1,3,18,9,4,9,14,5,0,63
1,3,18,9,4,9,14,5,19,82
1,3,18,9,4,9,14,9,3,70
1,3,18,9,4,9,20,25,0,89
1,3,18,9,4,12,25,0,0,72
1,3,18,9,4,14,5,19,19,92
1,3,18,9,4,15,14,5,0,69
1,3,18,25,12,0,0,0,0,59
1,3,18,25,12,1,20,5,0,85
1,3,18,25,12,1,20,5,19,104
1,3,18,25,12,9,3,0,0,71
1,3,18,25,12,9,3,19,0,90
1,3,18,25,12,25,12,0,0,96
1,3,18,9,13,15,14,25,0,98
1,3,18,9,14,25,12,0,0,82
1,3,18,9,19,25,0,0,0,75
1,3,18,9,19,9,1,0,0,60
1,3,18,9,20,1,14,0,0,66
1,3,18,9,20,5,0,0,0,56
1,3,18,9,20,25,0,0,0,76
1,3,18,9,20,9,3,1,12,76
1,3,18,9,20,15,12,0,0,78
1,3,18,9,20,21,4,5,0,81
1,3,18,15,1,13,1,0,0,52
1,3,18,15,1,13,1,20,1,73
1,3,18,15,1,19,9,19,0,85
1,3,18,15,1,20,9,3,0,70
1,3,18,15,2,1,3,25,0,68
1,3,18,15,2,1,20,0,0,60
1,3,18,15,2,1,20,9,3,72
1,3,18,15,2,1,20,19,0,79
1,3,18,15,2,12,1,19,20,91
1,3,18,15,3,25,19,20,0,104
1,3,18,15,3,11,0,0,0,51
1,3,18,15,4,25,14,9,1,90
1,3,18,15,4,15,14,20,0,90
1,3,18,15,4,15,14,20,19,109
1,3,18,15,4,18,15,13,5,92
1,3,18,15,7,1,13,25,0,83
1,3,18,15,7,5,14,0,0,63
1,3,18,15,7,5,14,9,3,75
1,3,18,15,7,5,14,19,0,82
1,3,18,15,12,5,9,14,0,77
1,3,18,15,12,5,9,14,19,96
1,3,18,15,12,9,20,8,0,86
1,3,18,15,12,9,20,8,19,105
1,3,18,15,12,15,7,25,0,96
1,3,18,15,12,15,7,9,3,83
1,3,18,15,12,15,7,21,5,97
1,3,18,15,13,1,14,9,1,75
1,3,18,15,13,5,20,5,18,98
1,3,18,15,13,9,1,0,0,60
1,3,18,15,13,9,1,12,0,72
1,3,18,15,13,9,13,9,1,82
1,3,18,15,13,9,15,14,0,88
1,3,18,15,14,0,0,0,0,51
1,3,18,15,14,1,12,0,0,64
1,3,18,15,14,9,3,0,0,63
1,3,18,15,14,25,3,0,0,79
1,3,18,15,14,9,3,1,12,76
1,3,18,15,14,25,3,1,12,92
1,3,18,15,14,25,3,8,0,87
1,3,18,15,14,25,13,0,0,89
1,3,18,15,14,25,13,9,3,101
1,3,18,15,14,25,13,19,0,108
1,3,18,15,14,25,24,0,0,100
1,3,18,15,14,15,13,25,0,104
1,3,18,15,15,11,0,0,0,63
1,3,18,15,16,1,20,8,25,107
1,3,18,15,16,5,20,1,12,91
1,3,18,15,16,8,15,14,25,115
1,3,18,15,16,15,4,9,1,82
1,3,18,15,16,15,18,5,0,91
1,3,18,15,19,1,18,3,0,78
1,3,18,15,19,1,18,3,1,79
1,3,18,15,19,5,0,0,0,61
1,3,18,15,19,15,13,5,0,89
1,3,18,15,19,15,13,5,19,108
1,3,18,15,19,16,9,18,5,104
1,3,18,15,19,16,15,18,5,110
1,3,18,15,19,19,0,0,0,75
1,3,18,15,19,20,9,3,0,88
1,3,18,15,19,20,9,3,19,107
1,3,18,15,20,5,18,0,0,80
1,3,18,15,20,5,18,1,12,93
1,3,18,15,20,5,18,9,1,90
1,3,18,15,20,5,18,9,3,92
1,3,18,15,20,9,3,0,0,69
1,3,18,15,20,9,19,13,0,98
1,3,18,15,20,9,19,13,19,117
1,3,20,1,2,12,5,0,0,44
1,3,20,5,4,0,0,0,0,33
1,3,20,7,0,0,0,0,0,31
1,3,20,9,6,25,0,0,0,64
1,3,20,9,6,9,5,18,0,71
1,3,20,9,14,0,0,0,0,47
1,3,20,9,14,1,12,0,0,60
1,3,20,9,14,1,12,12,25,97
1,3,20,9,14,5,0,0,0,52
1,3,20,9,14,7,0,0,0,54
1,3,20,9,14,7,19,0,0,73
1,3,20,9,14,9,1,5,0,62
1,3,20,9,14,9,1,14,0,71
1,3,20,9,14,9,1,14,19,90
1,3,20,9,14,9,1,19,0,76
1,3,20,9,14,9,3,0,0,59
1,3,20,9,14,9,3,1,12,72
1,3,20,9,14,9,4,5,0,65
1,3,20,9,14,9,4,5,19,84
1,3,20,9,14,9,14,5,0,75
1,3,20,9,14,9,19,13,0,88
1,3,20,9,14,9,19,13,19,107
1,3,20,9,14,9,21,13,0,90
1,3,20,9,14,9,21,13,19,109
1,3,20,9,14,15,9,4,0,75
1,3,20,9,14,15,9,4,19,94
1,3,20,9,14,15,14,0,0,76
1,3,20,9,14,15,14,19,0,95
1,3,20,9,14,15,16,15,4,97
1,3,20,9,14,15,19,20,0,101
1,3,20,9,14,19,0,0,0,66
1,3,20,9,14,21,12,1,0,81
1,3,20,9,14,21,12,1,5,86
1,3,20,9,15,14,0,0,0,62
1,3,20,9,15,14,1,12,0,75
1,3,20,9,15,14,1,18,25,106
1,3,20,9,15,14,5,18,0,85
1,3,20,9,15,14,5,19,0,86
1,3,20,9,15,14,9,19,20,110
1,3,20,9,15,14,9,26,5,102
1,3,20,9,15,14,19,0,0,81
1,3,20,9,15,21,19,0,0,88
1,3,20,9,22,1,2,12,5,75
1,3,20,9,22,1,20,5,0,81
1,3,20,9,22,1,20,5,4,85
1,3,20,9,22,1,20,5,19,100
1,3,20,9,22,1,20,15,18,109
1,3,20,9,22,5,0,0,0,60
1,3,20,9,22,5,12,25,0,97
1,3,20,9,22,5,19,0,0,79
1,3,20,9,22,9,14,0,0,78
1,3,20,9,22,9,19,13,0,96
1,3,20,9,22,9,19,13,19,115
1,3,20,9,22,9,19,20,0,103
1,3,20,9,22,9,19,20,19,122
1,3,20,9,22,9,20,1,12,97
1,3,20,9,22,9,20,25,0,109
1,3,20,9,22,9,26,5,0,95
1,3,20,9,22,9,26,5,4,99
1,3,20,12,5,19,19,0,0,79
1,3,20,15,18,25,0,0,0,82
1,3,20,15,18,9,19,8,0,93
1,3,20,15,18,19,0,0,0,76
1,3,20,15,18,19,8,9,16,109
1,3,20,15,19,0,0,0,0,58
1,3,20,18,5,19,19,0,0,85
1,3,20,18,5,19,19,5,19,109
1,3,20,18,5,19,19,25,0,110
1,3,20,21,1,12,0,0,0,58
1,3,20,21,1,12,9,19,5,91
1,3,20,21,1,12,9,19,13,99
1,3,20,21,1,12,9,19,20,106
1,3,20,21,1,12,9,20,25,112
1,3,20,21,1,12,9,26,5,98
1,3,20,21,1,12,12,25,0,95
1,3,20,21,1,12,19,0,0,77
1,3,20,21,1,18,25,0,0,89
1,3,20,21,1,18,9,1,12,86
1,3,20,21,1,18,9,1,14,88
1,3,20,21,1,18,9,5,19,97
1,3,20,21,1,20,5,0,0,71
1,3,20,21,1,20,5,4,0,75
1,3,20,21,1,20,5,19,0,90
1,3,20,21,1,20,9,14,7,96
1,3,20,21,1,20,9,15,14,104
1,3,20,21,1,20,15,18,0,99
1,3,20,21,1,20,15,18,19,118
1,3,20,21,15,19,5,0,0,84
1,3,20,21,18,5,0,0,0,68
1,3,20,21,19,0,0,0,0,64
1,3,20,21,20,1,20,5,0,91
1,3,21,1,20,5,0,0,0,51
1,3,21,1,20,9,14,7,0,76
1,3,21,1,20,9,15,14,0,84
1,3,21,3,8,9,0,0,0,45
1,3,21,4,21,3,20,15,18,106
1,3,21,5,18,4,15,0,0,67
1,3,21,5,18,4,15,19,0,86
1,3,21,9,20,25,0,0,0,79
1,3,21,9,20,9,5,19,0,87
1,3,21,12,5,1,0,0,0,43
1,3,21,12,5,1,5,0,0,48
1,3,21,12,5,1,20,5,0,68
1,3,21,12,5,1,20,5,4,72
1,3,21,12,5,9,0,0,0,51
1,3,21,12,5,15,12,21,19,109
1,3,21,12,5,21,19,0,0,82
1,3,21,13,2,12,5,0,0,57
1,3,21,13,5,14,0,0,0,57
1,3,21,13,5,14,19,0,0,76
1,3,21,13,9,14,1,20,5,87
1,3,21,13,9,14,15,19,5,100
1,3,21,13,9,14,15,21,19,116
1,3,21,16,18,5,19,19,0,102
1,3,21,18,1,20,9,22,5,100
1,3,21,19,5,3,20,15,18,105
1,3,21,19,8,12,1,0,0,65
1,3,21,19,20,15,13,0,0,92
1,3,21,20,1,14,3,5,0,68
1,3,21,20,1,14,3,5,19,87
1,3,21,20,1,20,5,0,0,71
1,3,21,20,5,0,0,0,0,50
1,3,21,20,5,12,25,0,0,87
1,3,21,20,5,14,5,19,19,107
1,3,21,20,5,18,0,0,0,68
1,3,21,20,5,19,0,0,0,69
1,3,21,20,5,19,20,0,0,89
1,3,21,20,9,1,20,15,18,108
1,3,21,20,9,19,8,0,0,81
1,3,24,15,25,1,20,12,0,101
1,4,3,15,14,0,0,0,0,37
1,4,3,15,14,19,0,0,0,56
1,4,3,18,1,6,20,0,0,53
1,4,4,1,2,12,5,0,0,29
1,4,4,1,24,0,0,0,0,34
1,4,4,1,24,5,19,0,0,58
1,4,4,4,1,0,0,0,0,14
1,4,4,5,2,20,5,4,0,45
1,4,4,5,4,0,0,0,0,18
1,4,4,5,4,12,25,0,0,55
1,4,4,5,5,13,0,0,0,32
1,4,4,5,14,4,0,0,0,32
1,4,4,5,14,4,1,0,0,33
1,4,4,5,14,4,19,0,0,51
1,4,4,5,14,4,21,13,0,66
1,4,4,5,14,4,21,13,19,85
1,4,4,5,18,0,0,0,0,32
1,4,4,5,18,2,15,12,20,81
1,4,4,5,18,6,9,19,8,74
1,4,4,5,18,19,0,0,0,51
1,4,4,5,18,19,16,9,20,96
1,4,4,5,18,23,15,18,20,108
1,4,4,9,2,12,5,0,0,37
1,4,4,9,3,5,0,0,0,26
1,4,4,9,3,5,14,20,0,60
1,4,4,9,3,20,0,0,0,41
1,4,4,9,3,20,5,4,0,50
1,4,4,9,3,20,9,14,7,71
1,4,4,9,3,20,9,15,14,79
1,4,4,9,3,20,9,22,5,77
1,4,4,9,3,20,19,0,0,60
1,4,4,9,13,5,14,20,0,70
1,4,4,9,14,7,0,0,0,39
1,4,4,9,15,0,0,0,0,33
1,4,4,9,20,1,0,0,0,39
1,4,4,9,20,9,15,14,0,76
1,4,4,9,20,9,15,14,19,95
1,4,4,9,20,9,22,5,0,74
1,4,4,9,20,9,22,5,19,93
1,4,4,9,20,15,18,25,0,96
1,4,4,9,20,21,13,0,0,72
1,4,4,9,20,21,18,0,0,77
1,4,4,12,5,0,0,0,0,26
1,4,4,12,5,4,0,0,0,30
1,4,4,12,5,8,5,1,4,44
1,4,4,12,5,13,5,14,20,78
1,4,4,12,5,14,5,19,19,83
1,4,4,12,5,16,1,20,5,68
1,4,4,12,5,16,12,15,20,89
1,4,4,12,5,19,0,0,0,45
1,4,4,12,9,14,7,0,0,51
1,4,4,12,9,14,7,19,0,70
1,4,4,12,9,14,19,0,0,63
1,4,4,14,0,0,0,0,0,23
1,4,4,14,12,0,0,0,0,35
1,4,4,15,15,13,0,0,0,52
1,4,4,15,18,19,5,4,0,70
1,4,4,15,19,19,5,4,0,71
1,4,4,18,0,0,0,0,0,27
1,4,4,18,5,19,19,0,0,70
1,4,4,18,5,19,19,5,4,79
1,4,4,18,5,19,19,5,5,80
1,4,4,18,5,19,19,5,18,93
1,4,4,18,5,19,19,5,19,94
1,4,4,18,5,19,19,15,18,103
1,4,4,18,5,19,20,0,0,71
1,4,4,19,0,0,0,0,0,28
1,4,4,21,3,5,0,0,0,38
1,4,4,21,3,5,4,0,0,42
1,4,4,21,3,5,14,20,0,72
1,4,4,21,3,5,18,0,0,56
1,4,4,21,3,5,18,19,0,75
1,4,4,21,3,5,19,0,0,57
1,4,4,21,3,9,2,12,5,61
1,4,4,21,3,9,14,7,0,63
1,4,4,21,3,20,0,0,0,53
1,4,4,21,3,20,5,4,0,62
1,4,4,21,3,20,9,14,7,83
1,4,4,21,3,20,9,15,14,91
1,4,4,21,3,20,9,22,5,89
1,4,4,21,3,20,15,18,0,86
1,4,4,21,3,20,15,18,19,105
1,4,4,21,3,20,19,0,0,72
1,4,4,21,12,3,5,0,0,50
1,4,5,0,0,0,0,0,0,10
1,4,5,1,4,0,0,0,0,15
1,4,5,5,13,0,0,0,0,28
1,4,5,5,13,5,4,0,0,37
1,4,5,5,13,9,14,7,0,58
1,4,5,5,13,19,0,0,0,47
1,4,5,5,16,0,0,0,0,31
1,4,5,12,1,14,20,5,0,62
1,4,5,12,1,19,20,5,18,85
1,4,5,12,9,14,7,0,0,52
1,4,5,12,9,20,5,0,0,56
1,4,5,12,15,16,15,4,0,72
1,4,5,12,16,8,9,1,0,56
1,4,5,12,16,8,9,3,0,58
1,4,5,12,16,8,15,21,19,101
1,4,5,13,15,14,9,19,20,100
1,4,5,13,16,20,0,0,0,59
1,4,5,13,16,20,5,4,0,68
1,4,5,13,16,20,9,15,14,97
1,4,5,14,1,12,7,25,0,69
1,4,5,14,1,12,7,9,1,54
1,4,5,14,1,19,5,0,0,49
1,4,5,14,4,18,9,3,0,58
1,4,5,14,9,1,0,0,0,34
1,4,5,14,9,6,15,18,13,85
1,4,5,14,25,12,0,0,0,61
1,4,5,14,25,12,9,3,0,73
1,4,5,14,25,12,19,0,0,80
1,4,5,14,9,14,0,0,0,47
1,4,5,14,9,14,5,0,0,52
1,4,5,14,9,14,5,19,0,71
1,4,5,14,9,20,9,19,0,81
1,4,5,14,15,3,5,12,5,64
1,4,5,14,15,3,25,19,20,106
1,4,5,14,15,9,4,0,0,52
1,4,5,14,15,9,4,1,12,65
1,4,5,14,15,9,4,19,0,71
1,4,5,14,15,12,15,7,25,98
1,4,5,14,15,13,1,0,0,53
1,4,5,14,15,13,1,19,0,72
1,4,5,14,15,13,1,20,1,74
1,4,5,14,15,14,3,21,19,96
1,4,5,14,15,19,5,0,0,63
1,4,5,14,15,19,5,19,0,82
1,4,5,14,15,19,9,14,5,86
1,4,5,14,15,19,9,19,0,86
1,4,5,14,15,20,15,13,5,92
1,4,5,14,15,20,15,13,25,112
1,4,5,14,15,21,19,0,0,79
1,4,5,16,8,1,7,1,14,57
1,4,5,16,8,1,7,9,1,52
1,4,5,16,19,0,0,0,0,45
1,4,5,16,20,0,0,0,0,46
1,4,5,16,20,5,18,0,0,69
1,4,5,16,20,5,19,20,0,90
1,4,5,16,20,9,15,14,0,84
1,4,5,16,20,12,25,0,0,83
1,4,5,16,20,14,5,19,19,103
1,4,5,16,20,19,0,0,0,65
1,4,5,16,20,19,8,9,16,98
1,4,5,17,21,1,3,25,0,77
1,4,5,17,21,1,20,5,0,74
1,4,5,18,13,9,1,0,0,51
1,4,5,18,13,9,14,0,0,64
1,4,5,18,13,9,14,5,0,69
1,4,5,19,13,25,0,0,0,67
1,4,5,19,16,15,20,1,0,81
1,4,5,19,16,15,20,15,14,109
1,4,5,19,19,9,22,5,0,84
1,4,5,19,20,5,0,0,0,54
1,4,5,20,0,0,0,0,0,30
1,4,5,21,9,19,13,0,0,72
1,4,5,22,9,19,13,0,0,73
1,4,6,5,3,20,5,4,0,48
1,4,6,6,18,15,26,5,0,81
1,4,6,6,18,15,26,5,14,95
1,4,6,9,12,9,1,20,5,67
1,4,6,9,24,0,0,0,0,44
1,4,6,12,21,24,9,15,14,106
1,4,6,18,5,5,26,5,0,70
1,4,6,18,15,26,5,0,0,75
1,4,6,18,15,26,5,14,0,89
1,4,8,1,11,1,0,0,0,26
1,4,8,1,13,1,14,20,0,62
1,4,8,1,18,13,1,0,0,46
1,4,8,5,18,1,14,20,0,71
1,4,8,5,18,5,0,0,0,41
1,4,8,5,18,5,4,0,0,45
1,4,8,5,18,5,14,3,5,63
1,4,8,5,18,5,14,3,25,83
1,4,8,5,18,5,14,4,0,59
1,4,8,5,18,5,14,4,19,78
1,4,8,5,18,5,14,20,0,75
1,4,8,5,18,5,14,20,19,94
1,4,8,5,18,5,18,0,0,59
1,4,8,5,18,5,18,19,0,78
1,4,8,5,18,5,19,0,0,60
1,4,8,5,18,9,14,7,0,66
1,4,8,5,19,9,15,14,0,75
1,4,8,5,19,9,15,14,19,94
1,4,8,5,19,9,22,5,0,73
1,4,8,5,19,9,22,5,19,92
1,4,8,9,2,9,20,0,0,53
1,4,8,9,2,9,20,5,4,62
1,4,8,9,2,9,20,19,0,72
1,4,8,15,3,18,1,3,25,78
1,4,8,15,18,20,0,0,0,66
1,4,25,0,0,0,0,0,0,30
1,4,9,1,2,1,20,0,0,38
1,4,9,1,2,1,20,9,3,50
1,4,9,1,16,8,15,14,0,68
1,4,9,1,16,8,15,18,1,73
1,4,9,1,16,8,15,18,25,97
1,4,9,1,20,5,0,0,0,40
1,4,9,1,20,5,4,0,0,44
1,4,9,1,20,9,14,7,0,65
1,4,9,1,20,9,15,14,0,73
1,4,9,2,1,19,9,0,0,45
1,4,9,3,9,20,25,0,0,71
1,4,9,5,14,3,5,0,0,41
1,4,9,5,14,20,0,0,0,53
1,4,9,5,21,0,0,0,0,40
1,4,9,5,21,19,0,0,0,59
1,4,9,5,21,24,0,0,0,64
1,4,9,7,8,20,0,0,0,49
1,4,25,14,1,13,25,0,0,83
1,4,25,14,1,13,9,1,0,68
1,4,25,14,1,13,9,1,19,87
1,4,25,14,1,13,9,3,0,70
1,4,9,14,9,4,1,14,0,56
1,4,9,14,15,12,5,0,0,60
1,4,9,15,14,0,0,0,0,43
1,4,9,15,19,0,0,0,0,48
1,4,9,16,1,20,5,0,0,56
1,4,9,16,9,3,0,0,0,42
1,4,9,16,25,12,0,0,0,67
1,4,9,16,9,14,9,3,0,65
1,4,9,16,15,3,5,12,5,70
1,4,9,16,15,3,5,18,5,76
1,4,9,16,15,3,25,20,5,98
1,4,9,16,15,9,4,0,0,58
1,4,9,16,15,13,1,0,0,59
1,4,9,16,15,13,1,20,1,80
1,4,9,16,15,19,5,0,0,69
1,4,9,16,15,19,5,19,0,88
1,4,9,16,15,19,9,19,0,92
1,4,9,16,15,19,9,20,25,118
1,4,9,16,15,21,19,0,0,85
1,4,9,16,19,25,0,0,0,74
1,4,9,16,19,9,1,0,0,59
1,4,9,16,19,9,3,0,0,61
1,4,9,16,19,15,21,19,0,104
1,4,9,20,0,0,0,0,0,34
1,4,25,20,1,0,0,0,0,51
1,4,9,20,1,12,0,0,0,47
1,4,9,20,9,15,0,0,0,58
1,4,25,20,15,14,0,0,0,79
1,4,9,20,19,0,0,0,0,53
1,4,25,20,20,1,0,0,0,71
1,4,25,20,21,13,0,0,0,84
1,4,9,20,21,19,0,0,0,74
1,4,10,0,0,0,0,0,0,15
1,4,10,1,3,5,14,3,5,46
1,4,10,1,3,5,14,3,25,66
1,4,10,1,3,5,14,20,0,58
1,4,10,1,7,0,0,0,0,23
1,4,10,5,3,20,0,0,0,43
1,4,10,5,3,20,9,15,14,81
1,4,10,5,3,20,9,22,5,79
1,4,10,9,7,1,0,0,0,32
1,4,10,9,7,5,18,0,0,54
1,4,10,15,9,14,0,0,0,53
1,4,10,15,9,14,1,14,20,88
1,4,10,15,9,14,5,4,0,62
1,4,10,15,9,14,5,18,0,76
1,4,10,15,9,14,9,14,7,83
1,4,10,15,9,14,19,0,0,72
1,4,10,15,9,14,20,0,0,73
1,4,10,15,9,14,20,19,0,92
1,4,10,15,21,18,14,0,0,83
1,4,10,15,21,18,14,1,12,96
1,4,10,15,21,18,14,5,4,92
1,4,10,15,21,18,14,19,0,102
1,4,10,15,21,19,20,0,0,90
1,4,10,20,0,0,0,0,0,35
1,4,10,21,4,7,5,0,0,52
1,4,10,21,4,7,5,4,0,56
1,4,10,21,4,7,5,18,0,70
1,4,10,21,4,7,5,19,0,71
1,4,10,21,4,7,9,14,7,77
1,4,10,21,7,1,20,5,0,69
1,4,10,21,13,5,14,20,0,88
1,4,10,21,14,3,20,0,0,73
1,4,10,21,14,3,20,12,25,110
1,4,10,21,14,3,20,19,0,92
1,4,10,21,18,5,0,0,0,59
1,4,10,21,18,5,4,0,0,63
1,4,10,21,18,5,18,0,0,77
1,4,10,21,18,5,18,19,0,96
1,4,10,21,18,5,19,0,0,78
1,4,10,21,18,9,14,7,0,84
1,4,10,21,18,15,18,0,0,87
1,4,10,21,18,15,18,19,0,106
1,4,10,21,19,20,0,0,0,75
1,4,10,21,19,20,1,7,5,88
1,4,10,21,19,20,5,4,0,84
1,4,10,21,19,20,5,18,0,98
1,4,10,21,19,20,5,18,19,117
1,4,10,21,19,20,9,14,7,105
1,4,10,21,19,20,9,22,5,111
1,4,10,21,19,20,15,18,0,108
1,4,10,21,19,20,15,18,19,127
1,4,10,21,19,20,19,0,0,94
1,4,10,21,20,1,7,5,0,69
1,4,10,21,20,1,14,3,25,99
1,4,10,21,20,1,14,20,0,91
1,4,10,21,20,1,14,20,19,110
1,4,10,21,20,1,20,15,18,110
1,4,10,21,20,5,0,0,0,61
1,4,10,21,20,15,18,0,0,89
1,4,10,21,20,15,18,25,0,114
1,4,10,21,20,18,9,3,5,91
1,4,10,21,20,18,9,24,0,107
1,4,10,21,22,1,14,20,0,93
1,4,10,21,22,1,14,20,19,112
1,4,10,21,22,1,20,5,0,84
1,4,12,5,7,9,1,18,5,62
1,4,12,5,19,19,0,0,0,60
1,4,12,5,20,0,0,0,0,42
1,4,12,21,13,9,4,9,14,87
1,4,12,21,13,9,14,0,0,74
1,4,12,21,13,9,14,5,0,79
1,4,13,1,14,0,0,0,0,33
1,4,13,1,19,19,0,0,0,57
1,4,13,5,1,19,21,18,5,87
1,4,13,5,4,9,1,12,0,49
1,4,13,5,4,9,1,14,0,51
1,4,13,5,14,0,0,0,0,37
1,4,13,9,0,0,0,0,0,27
1,4,13,9,14,0,0,0,0,41
1,4,13,9,14,9,3,12,5,70
1,4,13,9,18,1,2,12,5,65
1,4,13,9,18,1,2,12,25,85
1,4,13,9,18,1,12,19,0,77
1,4,13,9,18,1,12,20,25,103
1,4,13,9,18,1,14,3,5,68
1,4,13,9,18,1,20,15,18,99
1,4,13,9,18,5,0,0,0,50
1,4,13,9,18,5,4,0,0,54
1,4,13,9,18,5,4,12,25,91
1,4,13,9,18,5,18,0,0,68
1,4,13,9,18,5,18,19,0,87
1,4,13,9,18,5,19,0,0,69
1,4,13,9,18,9,14,7,0,75
1,4,13,9,19,19,9,15,14,103
1,4,13,9,19,19,9,22,5,101
1,4,13,9,19,19,15,18,25,123
1,4,13,9,20,0,0,0,0,47
1,4,13,9,20,19,0,0,0,66
1,4,13,9,20,20,5,4,0,76
1,4,13,9,20,20,5,5,0,77
1,4,13,9,20,20,5,18,0,90
1,4,13,9,20,20,5,18,19,109
1,4,13,9,20,20,25,0,0,92
1,4,13,9,20,20,9,14,7,97
1,4,13,9,24,0,0,0,0,51
1,4,13,9,24,5,4,0,0,60
1,4,13,9,24,5,19,0,0,75
1,4,13,9,24,9,14,7,0,81
1,4,13,9,24,20,0,0,0,71
1,4,13,9,24,20,9,15,14,109
1,4,13,9,24,20,21,18,5,115
1,4,13,15,14,9,19,8,0,83
1,4,13,15,14,9,20,15,18,109
1,4,13,15,22,0,0,0,0,55
1,4,13,15,22,5,0,0,0,60
1,4,13,18,24,0,0,0,0,60
1,4,14,1,19,3,5,14,20,81
1,4,14,1,20,5,0,0,0,45
1,4,14,1,20,9,15,14,0,78
1,4,14,1,20,9,15,14,19,97
1,4,14,5,18,22,1,12,0,77
1,4,14,5,19,3,5,14,20,85
1,4,14,5,21,18,1,12,0,76
1,4,14,5,24,0,0,0,0,48
1,4,14,5,24,1,0,0,0,49
1,4,14,5,24,1,12,0,0,61
1,4,14,5,24,5,4,0,0,57
1,4,14,5,24,9,20,9,19,105
1,4,14,15,13,9,14,1,12,83
1,4,14,15,21,14,0,0,0,69
1,4,14,15,21,14,19,0,0,88
1,4,14,21,13,2,5,18,0,78
1,4,15,0,0,0,0,0,0,20
1,4,15,2,5,0,0,0,0,27
1,4,15,2,5,19,0,0,0,46
1,4,15,2,15,0,0,0,0,37
1,4,15,2,15,19,0,0,0,56
1,4,15,4,0,0,0,0,0,24
1,4,15,12,5,19,3,5,0,64
1,4,15,12,5,19,3,5,4,68
1,4,15,14,9,4,9,14,0,70
1,4,15,14,9,14,0,0,0,57
1,4,15,14,9,19,5,19,0,86
1,4,15,14,9,19,20,0,0,82
1,4,15,14,9,20,5,0,0,68
1,4,15,14,9,20,15,12,0,90
1,4,15,14,9,26,5,0,0,74
1,4,15,14,9,26,5,4,0,78
1,4,15,14,9,26,9,14,7,99
1,4,15,15,18,19,0,0,0,72
1,4,15,16,5,18,1,20,5,85
1,4,15,16,20,0,0,0,0,56
1,4,15,16,20,1,2,12,5,76
1,4,15,16,20,1,14,20,0,91
1,4,15,16,20,5,4,0,0,65
1,4,15,16,20,5,4,12,25,102
1,4,15,16,20,5,5,0,0,66
1,4,15,16,20,5,5,19,0,85
1,4,15,16,20,5,18,0,0,79
1,4,15,16,20,5,18,19,0,98
1,4,15,16,20,9,1,14,0,80
1,4,15,16,20,9,14,7,0,86
1,4,15,16,20,9,15,14,0,94
1,4,15,16,20,9,15,14,19,113
1,4,15,16,20,9,15,21,19,120
1,4,15,16,20,9,22,5,0,92
1,4,15,16,20,19,0,0,0,75
1,4,15,18,0,0,0,0,0,38
1,4,15,18,1,2,12,5,0,58
1,4,15,18,1,2,12,25,0,78
1,4,15,18,1,12,0,0,0,51
1,4,15,18,1,12,12,25,0,88
1,4,15,18,1,14,20,0,0,73
1,4,15,18,1,20,9,15,14,97
1,4,15,18,1,20,15,18,25,117
1,4,15,18,5,4,0,0,0,47
1,4,15,18,5,18,0,0,0,61
1,4,15,18,5,18,19,0,0,80
1,4,15,18,5,19,0,0,0,62
1,4,15,18,9,14,7,0,0,68
1,4,15,18,9,14,7,12,25,105
1,4,15,18,14,0,0,0,0,52
1,4,15,18,14,5,4,0,0,61
1,4,15,18,14,5,18,0,0,75
1,4,15,18,14,5,18,19,0,94
1,4,15,18,14,9,14,7,0,82
1,4,15,18,14,13,5,14,20,104
1,4,15,18,14,15,0,0,0,67
1,4,15,18,14,15,19,0,0,86
1,4,15,18,14,19,0,0,0,71
1,4,15,18,19,5,4,0,0,66
1,4,15,19,0,0,0,0,0,39
1,4,15,19,19,5,4,0,0,67
1,4,15,19,19,5,5,0,0,68
1,4,15,21,12,9,5,0,0,67
1,4,15,23,14,0,0,0,0,57
1,4,15,24,25,0,0,0,0,69
1,4,15,24,9,5,19,0,0,77
1,4,15,26,5,0,0,0,0,51
1,4,16,1,15,0,0,0,0,37
1,4,16,18,5,19,19,0,0,82
1,4,18,1,4,0,0,0,0,28
1,4,18,1,4,9,1,12,0,50
1,4,18,1,4,9,21,19,0,77
1,4,18,5,1,4,0,0,0,33
1,4,18,5,1,13,0,0,0,42
1,4,18,5,1,13,5,4,0,51
1,4,18,5,1,13,20,0,0,62
1,4,18,5,3,20,1,12,0,64
1,4,18,5,14,1,12,0,0,55
1,4,18,5,14,1,12,12,25,92
1,4,18,5,14,1,12,19,0,74
1,4,18,5,14,3,8,0,0,53
1,4,18,5,14,9,14,0,0,65
1,4,18,5,14,9,14,5,0,70
1,4,18,5,14,9,20,9,19,99
1,4,18,5,14,15,0,0,0,57
1,4,18,5,14,20,0,0,0,62
1,4,18,5,20,0,0,0,0,48
1,4,18,25,0,0,0,0,0,48
1,4,18,9,6,20,0,0,0,58
1,4,18,9,16,0,0,0,0,48
1,4,18,15,7,1,20,5,0,71
1,4,18,15,9,20,0,0,0,67
1,4,18,15,9,20,5,18,0,90
1,4,18,15,9,20,5,19,20,111
1,4,18,15,9,20,12,25,0,104
1,4,18,15,15,16,0,0,0,69
1,4,18,15,16,0,0,0,0,54
1,4,18,15,19,20,1,12,0,90
1,4,18,15,19,20,18,1,12,108
1,4,18,15,23,19,5,0,0,85
1,4,18,21,5,0,0,0,0,49
1,4,19,2,21,4,0,0,0,51
1,4,19,3,18,9,16,20,0,90
1,4,19,3,18,9,16,20,19,109
1,4,19,5,19,19,15,18,0,100
1,4,19,8,5,1,18,20,0,76
1,4,19,9,7,14,9,6,25,94
1,4,19,13,9,20,8,0,0,74
1,4,19,15,18,2,0,0,0,59
1,4,19,15,18,2,1,20,5,85
1,4,19,15,18,2,5,4,0,68
1,4,19,15,18,2,5,14,20,98
1,4,19,15,18,2,9,14,7,89
1,4,19,15,18,2,19,0,0,78
1,4,19,20,18,9,3,20,0,94
1,4,19,20,18,9,14,7,5,97
1,4,19,21,13,0,0,0,0,58
1,4,20,5,22,1,3,0,0,56
1,4,21,1,14,1,0,0,0,42
1,4,21,12,1,18,0,0,0,57
1,4,21,12,1,18,9,1,0,67
1,4,21,12,1,18,9,1,19,86
1,4,21,12,1,20,5,0,0,64
1,4,21,12,1,20,5,4,0,68
1,4,21,12,1,20,5,19,0,83
1,4,21,12,1,20,9,14,7,89
1,4,21,12,1,20,9,15,14,97
1,4,21,12,1,20,15,18,0,92
1,4,21,12,1,20,15,18,25,117
1,4,21,12,1,20,15,18,19,111
1,4,21,12,3,5,0,0,0,46
1,4,21,12,20,0,0,0,0,58
1,4,21,12,20,5,18,0,0,81
1,4,21,12,20,5,18,5,18,104
1,4,21,12,20,5,18,25,0,106
1,4,21,12,20,8,15,15,4,100
1,4,21,12,20,12,25,0,0,95
1,4,21,12,20,12,9,11,5,95
1,4,21,12,20,14,5,19,19,115
1,4,21,12,20,15,9,4,0,86
1,4,21,12,20,18,5,19,19,119
1,4,21,12,20,19,0,0,0,77
1,4,21,13,2,18,1,12,0,72
1,4,21,13,2,18,1,14,20,94
1,4,21,13,2,18,1,20,5,85
1,4,21,14,1,20,9,15,14,99
1,4,21,14,3,0,0,0,0,43
1,4,21,14,3,1,20,5,0,69
1,4,21,14,3,1,20,5,4,73
1,4,21,14,3,9,20,25,0,97
1,4,21,14,3,15,21,19,0,98
1,4,21,18,5,0,0,0,0,49
1,4,21,18,5,14,20,0,0,83
1,4,21,19,11,0,0,0,0,56
1,4,21,19,20,0,0,0,0,65
1,4,21,19,20,9,15,14,0,103
1,4,21,19,20,9,22,5,0,101
1,4,22,0,0,0,0,0,0,27
1,4,22,1,14,3,5,0,0,50
1,4,22,1,14,3,5,4,0,54
1,4,22,1,14,3,5,18,0,68
1,4,22,1,14,3,5,18,19,87
1,4,22,1,14,3,5,19,0,69
1,4,22,1,14,3,9,14,7,75
1,4,22,1,14,3,9,22,5,81
1,4,22,1,14,20,1,7,5,75
1,4,22,5,3,20,0,0,0,55
1,4,22,5,3,20,5,4,0,64
1,4,22,5,3,20,9,14,7,85
1,4,22,5,3,20,9,15,14,93
1,4,22,5,3,20,9,22,5,91
1,4,22,5,3,20,19,0,0,74
1,4,22,5,8,5,14,20,0,79
1,4,22,5,14,1,0,0,0,47
1,4,22,5,14,1,5,0,0,52
1,4,22,5,14,5,0,0,0,51
1,4,22,5,14,9,5,14,20,94
1,4,22,5,14,20,9,1,12,88
1,4,22,5,14,20,9,22,5,102
1,4,22,5,14,20,18,25,0,109
1,4,22,5,14,20,19,0,0,85
1,4,22,5,14,20,21,1,12,100
1,4,22,5,14,20,21,18,5,110
1,4,22,5,18,2,0,0,0,52
1,4,22,5,18,2,9,1,12,74
1,4,22,5,18,2,19,0,0,71
1,4,22,5,18,19,1,0,0,70
1,4,22,5,18,19,1,14,20,104
1,4,22,5,18,19,1,18,25,113
1,4,22,5,18,19,5,0,0,74
1,4,22,5,18,19,5,4,0,78
1,4,22,5,18,19,5,12,25,111
1,4,22,5,18,19,9,14,7,99
1,4,22,5,18,19,9,15,14,107
1,4,22,5,18,19,9,20,25,123
1,4,22,5,18,19,9,22,5,105
1,4,22,5,18,19,21,19,0,109
1,4,22,5,18,20,0,0,0,70
1,4,22,5,18,20,5,4,0,79
1,4,22,5,18,20,5,14,20,109
1,4,22,5,18,20,9,14,7,100
1,4,22,5,18,20,9,19,5,103
1,4,22,5,18,20,9,26,5,110
1,4,22,5,18,20,19,0,0,89
1,4,22,9,3,5,0,0,0,44
1,4,22,9,3,5,6,21,12,83
1,4,22,9,3,5,19,0,0,63
1,4,22,9,19,1,2,12,5,75
1,4,22,9,19,1,2,12,25,95
1,4,22,9,19,1,12,0,0,68
1,4,22,9,19,5,0,0,0,60
1,4,22,9,19,5,4,0,0,64
1,4,22,9,19,5,4,12,25,101
1,4,22,9,19,5,5,0,0,65
1,4,22,9,19,5,5,19,0,84
1,4,22,9,19,5,18,0,0,78
1,4,22,9,19,5,18,19,0,97
1,4,22,9,19,5,19,0,0,79
1,4,22,9,19,25,0,0,0,80
1,4,22,9,19,9,14,7,0,85
1,4,22,9,19,9,22,5,0,91
1,4,22,9,19,15,0,0,0,70
1,4,22,9,19,15,18,0,0,88
1,4,22,9,19,15,18,25,0,113
1,4,22,9,19,15,18,19,0,107
1,4,22,9,20,1,14,20,0,91
1,4,22,15,3,1,1,20,0,67
1,4,22,15,3,1,3,25,0,74
1,4,22,15,3,1,20,5,0,71
1,4,22,15,3,1,20,5,4,75
1,4,22,15,3,1,20,5,19,90
1,4,22,15,3,1,20,15,18,99
1,4,22,15,25,5,18,0,0,90
1,4,22,15,11,5,0,0,0,58
1,4,22,15,23,5,5,0,0,75
1,4,22,15,23,18,25,0,0,108
1,4,22,15,23,19,15,14,0,113
1,4,22,15,23,19,15,14,19,132
1,4,22,20,0,0,0,0,0,47
1,4,23,1,18,4,0,0,0,51
1,4,23,5,19,3,8,0,0,63
1,4,26,0,0,0,0,0,0,31
1,4,26,5,0,0,0,0,0,36
1,4,26,5,18,0,0,0,0,54
1,4,26,5,19,0,0,0,0,55
1,4,26,15,15,11,19,0,0,91
1,5,3,9,1,0,0,0,0,19
1,5,3,9,1,12,0,0,0,31
1,5,3,9,4,9,1,0,0,32
1,5,3,9,4,9,1,12,0,44
1,5,3,9,4,9,21,13,0,65
1,5,3,9,21,13,0,0,0,52
1,5,4,5,1,7,1,12,0,36
1,5,4,5,1,7,9,0,0,32
1,5,4,5,1,7,21,19,0,63
1,5,4,5,7,9,0,0,0,31
1,5,4,9,3,21,12,1,0,56
1,5,4,9,3,21,12,1,5,61
1,5,4,9,3,21,12,5,0,60
1,5,4,9,12,5,0,0,0,36
1,5,4,9,12,5,19,0,0,55
1,5,4,9,12,9,1,14,0,55
1,5,4,9,12,9,3,0,0,43
1,5,4,9,12,9,20,25,0,85
1,5,4,9,14,5,0,0,0,38
1,5,4,15,5,1,7,9,0,47
1,5,4,15,5,1,7,21,19,78
1,5,6,1,12,4,0,0,0,29
1,5,6,1,12,4,25,0,0,54
1,5,6,1,21,12,4,0,0,50
1,5,7,1,7,18,9,0,0,48
1,5,7,1,7,18,21,19,0,79
1,5,7,5,13,15,14,25,0,85
1,5,7,5,18,0,0,0,0,36
1,5,7,5,18,9,1,14,0,60
1,5,7,5,18,9,9,4,0,58
1,5,7,9,12,15,16,19,0,84
1,5,7,9,18,9,14,5,0,68
1,5,7,9,18,9,20,5,0,74
1,5,7,25,18,9,20,5,0,90
1,5,7,9,19,5,19,0,0,65
1,5,7,15,16,8,15,14,25,106
1,5,7,18,9,20,21,4,5,90
1,5,7,18,15,20,1,14,20,101
1,5,7,18,15,20,1,20,0,87
1,5,9,16,1,20,8,25,0,85
1,5,12,15,4,9,3,15,14,78
1,5,12,21,18,15,9,4,0,85
1,5,13,9,1,0,0,0,0,29
1,5,14,1,3,8,0,0,0,32
1,5,14,5,1,14,0,0,0,40
1,5,14,5,15,21,19,0,0,80
1,5,14,9,7,13,1,0,0,50
1,5,15,12,9,4,0,0,0,46
1,5,15,12,9,7,8,20,0,77
1,5,15,12,9,14,1,0,0,57
1,5,15,12,9,14,5,0,0,61
1,5,15,12,9,16,9,12,5,84
1,5,15,12,9,16,25,12,5,100
1,5,15,12,9,19,20,9,3,93
1,5,15,12,15,4,9,15,14,90
1,5,15,14,0,0,0,0,0,35
1,5,15,14,9,1,12,0,0,57
1,5,15,14,9,1,14,0,0,59
1,5,15,14,9,3,0,0,0,47
1,5,15,14,9,19,20,0,0,83
1,5,15,14,19,0,0,0,0,54
1,5,17,0,0,0,0,0,0,23
1,5,17,21,15,18,0,0,0,77
1,5,17,21,15,18,5,1,12,95
1,5,17,21,15,18,9,14,0,100
1,5,17,21,15,18,9,14,19,119
1,5,18,0,0,0,0,0,0,24
1,5,18,1,7,5,0,0,0,37
1,5,18,1,18,9,1,0,0,53
1,5,18,1,18,9,1,14,0,67
1,5,18,1,18,9,21,13,0,86
1,5,18,1,20,5,0,0,0,50
1,5,18,1,20,5,4,0,0,54
1,5,18,1,20,5,19,0,0,69
1,5,18,1,20,9,14,7,0,75
1,5,18,1,20,9,15,14,0,83
1,5,18,1,20,9,15,14,19,102
1,5,18,1,20,15,18,0,0,78
1,5,18,1,20,15,18,19,0,97
1,5,18,25,0,0,0,0,0,49
1,5,18,9,1,12,0,0,0,46
1,5,18,9,1,12,9,19,20,94
1,5,18,9,1,12,9,20,25,100
1,5,18,9,1,12,12,25,0,83
1,5,18,9,1,12,19,0,0,65
1,5,18,9,3,0,0,0,0,36
1,5,18,9,3,1,12,0,0,49
1,5,18,9,5,0,0,0,0,38
1,5,18,9,5,4,0,0,0,42
1,5,18,9,5,18,0,0,0,56
1,5,18,9,5,19,0,0,0,57
1,5,18,9,5,19,20,0,0,77
1,5,18,9,6,25,0,0,0,64
1,5,18,9,6,9,5,4,0,57
1,5,18,9,6,9,5,19,0,72
1,5,18,9,6,25,9,14,7,94
1,5,18,9,6,15,18,13,0,85
1,5,18,9,12,25,0,0,0,70
1,5,18,9,14,5,19,19,0,90
1,5,18,15,0,0,0,0,0,39
1,5,18,15,2,1,20,5,0,67
1,5,18,15,2,1,20,5,4,71
1,5,18,15,2,1,20,9,3,74
1,5,18,15,2,5,0,0,0,46
1,5,18,15,2,5,5,0,0,51
1,5,18,15,2,5,19,0,0,65
1,5,18,15,2,9,1,0,0,51
1,5,18,15,2,9,1,14,0,65
1,5,18,15,2,9,3,0,0,53
1,5,18,15,2,9,3,19,0,72
1,5,18,15,2,9,15,14,0,79
1,5,18,15,2,9,15,14,20,99
1,5,18,15,2,9,15,21,19,105
1,5,18,15,2,9,21,13,0,84
1,5,18,15,2,15,1,20,0,77
1,5,18,15,2,21,19,0,0,81
1,5,18,15,3,1,18,0,0,61
1,5,18,15,3,25,19,20,0,106
1,5,18,15,3,18,1,6,20,87
1,5,18,15,3,21,18,22,5,108
1,5,18,15,4,25,14,5,0,87
1,5,18,15,4,25,14,5,19,106
1,5,18,15,4,15,14,5,0,77
1,5,18,15,4,18,15,13,5,94
1,5,18,15,4,21,3,20,0,87
1,5,18,15,4,21,3,20,19,106
1,5,18,15,6,15,9,12,0,81
1,5,18,15,6,15,9,12,19,100
1,5,18,15,7,5,12,0,0,63
1,5,18,15,7,5,12,19,0,82
1,5,18,15,7,5,14,0,0,65
1,5,18,15,7,5,14,5,0,70
1,5,18,15,7,5,14,5,19,89
1,5,18,15,7,5,14,9,3,77
1,5,18,15,7,14,15,19,25,119
1,5,18,15,7,18,1,13,0,78
1,5,18,15,7,18,1,13,19,97
1,5,18,15,7,18,1,16,8,89
1,5,18,15,7,21,14,0,0,81
1,5,18,15,25,1,3,8,20,96
1,5,18,15,9,4,5,19,0,76
1,5,18,15,12,9,20,5,0,85
1,5,18,15,12,9,20,5,19,104
1,5,18,15,12,9,20,8,0,88
1,5,18,15,12,9,20,8,19,107
1,5,18,15,12,9,20,9,3,92
1,5,18,15,12,15,7,25,0,98
1,5,18,15,12,15,7,9,3,85
1,5,18,15,13,1,14,3,25,95
1,5,18,15,13,5,20,5,18,100
1,5,18,15,13,5,20,18,25,120
1,5,18,15,13,15,20,15,18,120
1,5,18,15,14,0,0,0,0,53
1,5,18,15,14,1,20,0,0,74
1,5,18,15,14,1,21,20,0,95
1,5,18,15,14,1,21,20,19,114
1,5,18,15,14,5,6,0,0,64
1,5,18,15,14,15,13,5,18,104
1,5,18,15,14,15,13,25,0,106
1,5,18,15,14,15,13,9,3,93
1,5,18,15,16,1,20,8,25,109
1,5,18,15,16,1,21,19,5,101
1,5,18,15,16,8,1,7,25,96
1,5,18,15,16,8,1,14,5,83
1,5,18,15,16,8,9,12,5,89
1,5,18,15,16,8,25,20,5,113
1,5,18,15,16,8,15,14,5,97
1,5,18,15,16,8,15,18,0,96
1,5,18,15,16,8,15,18,5,101
1,5,18,15,16,8,15,20,15,113
1,5,18,15,16,12,1,14,5,87
1,5,18,15,16,21,12,19,5,112
1,5,18,15,19,1,20,0,0,79
1,5,18,15,19,1,20,19,0,98
1,5,18,15,19,3,15,16,5,97
1,5,18,15,19,3,15,16,25,117
1,5,18,15,19,5,0,0,0,63
1,5,18,15,19,15,12,19,0,104
1,5,18,15,19,16,1,3,5,83
1,5,18,15,19,20,1,20,0,99
1,5,18,15,19,20,1,20,19,118
1,5,18,15,19,20,5,1,13,97
1,5,18,15,20,1,24,9,19,112
1,5,18,15,20,15,23,0,0,97
1,5,18,15,22,9,5,23,0,98
1,5,18,21,7,15,0,0,0,67
1,5,18,21,7,15,19,0,0,86
1,5,19,3,0,0,0,0,0,28
1,5,19,3,21,12,9,14,0,84
1,5,19,20,5,20,8,9,3,90
1,5,19,20,8,5,19,9,1,87
1,5,19,20,8,5,19,9,19,105
1,5,19,20,8,5,20,5,0,83
1,5,19,20,8,5,20,5,19,102
1,5,19,20,8,5,20,9,3,90
1,5,19,20,9,22,1,12,0,89
1,5,19,20,9,22,1,20,5,102
1,5,19,20,9,22,5,0,0,81
1,5,19,20,21,1,18,25,0,110
1,5,19,20,21,1,20,5,0,92
1,5,19,20,21,15,21,19,0,121
1,5,19,20,21,18,5,0,0,89
1,5,19,20,21,19,0,0,0,85
1,5,20,1,20,0,0,0,0,47
1,5,20,8,1,12,9,1,0,57
1,5,20,8,1,12,9,21,13,90
1,5,20,8,5,12,9,14,7,81
1,5,20,8,5,15,7,1,13,75
1,5,20,8,5,18,0,0,0,57
1,5,20,8,5,18,5,1,12,75
1,5,20,8,5,18,5,4,0,66
1,5,20,8,5,18,9,3,0,69
1,5,20,8,5,18,19,0,0,76
1,5,20,8,15,7,5,14,0,75
1,5,20,8,15,14,0,0,0,63
1,5,20,9,15,12,15,7,25,109
1,5,20,9,20,5,19,0,0,79
1,5,20,15,19,1,21,18,0,100
1,5,20,20,5,11,5,5,19,91
1,5,22,9,1,0,0,0,0,38
1,5,22,21,13,0,0,0,0,62
1,6,4,0,0,0,0,0,0,11
1,6,4,5,3,8,15,0,0,42
1,6,5,1,18,0,0,0,0,31
1,6,5,1,18,4,0,0,0,35
1,6,5,1,18,5,4,0,0,40
1,6,5,2,18,9,12,5,0,58
1,6,5,18,0,0,0,0,0,30
1,6,5,18,14,1,14,0,0,59
1,6,5,20,1,12,0,0,0,45
1,6,6,0,0,0,0,0,0,13
1,6,6,1,0,0,0,0,0,14
1,6,6,1,2,12,5,0,0,33
1,6,6,1,2,12,25,0,0,53
1,6,6,1,2,18,15,21,19,89
1,6,6,1,9,18,0,0,0,41
1,6,6,1,9,18,5,0,0,46
1,6,6,1,9,18,5,19,0,65
1,6,6,1,9,18,19,0,0,60
1,6,6,1,9,20,5,0,0,48
1,6,6,1,13,9,19,8,0,63
1,6,6,1,20,21,1,20,5,81
1,6,6,5,3,20,0,0,0,41
1,6,6,5,3,20,1,20,5,67
1,6,6,5,3,20,5,4,0,50
1,6,6,5,3,20,5,18,0,64
1,6,6,5,3,20,5,18,19,83
1,6,6,5,3,20,9,14,7,71
1,6,6,5,3,20,9,15,14,79
1,6,6,5,3,20,9,22,5,77
1,6,6,5,3,20,15,18,0,74
1,6,6,5,3,20,19,0,0,60
1,6,6,5,3,20,21,1,12,75
1,6,6,5,3,20,21,13,0,75
1,6,6,5,3,20,21,19,0,81
1,6,6,5,5,2,12,5,0,42
1,6,6,5,5,18,0,0,0,41
1,6,6,5,5,18,5,18,0,64
1,6,6,5,5,18,15,18,0,74
1,6,6,5,9,18,0,0,0,45
1,6,6,5,18,5,0,0,0,41
1,6,6,5,18,5,14,20,0,75
1,6,6,25,0,0,0,0,0,38
1,6,6,9,1,14,3,5,0,45
1,6,6,9,1,14,3,5,4,49
1,6,6,9,1,14,3,5,18,63
1,6,6,9,1,14,3,5,19,64
1,6,6,9,1,14,20,0,0,57
1,6,6,9,1,14,20,19,0,76
1,6,6,9,3,8,0,0,0,33
1,6,6,9,3,8,5,0,0,38
1,6,6,9,3,8,5,19,0,57
1,6,6,9,4,1,18,5,0,50
1,6,6,9,4,1,22,25,0,74
1,6,6,25,4,1,22,25,0,90
1,6,6,9,4,1,22,9,20,78
1,6,6,9,5,4,0,0,0,31
1,6,6,9,5,19,0,0,0,46
1,6,6,25,9,14,7,0,0,68
1,6,6,9,12,5,0,0,0,39
1,6,6,9,12,9,1,20,5,69
1,6,6,9,14,1,7,5,0,49
1,6,6,9,14,1,12,0,0,49
1,6,6,9,14,5,0,0,0,41
1,6,6,9,14,5,4,0,0,45
1,6,6,9,14,5,12,25,0,78
1,6,6,9,14,5,19,0,0,60
1,6,6,9,14,7,0,0,0,43
1,6,6,9,14,9,20,5,0,70
1,6,6,9,14,9,20,25,0,90
1,6,6,9,18,13,0,0,0,53
1,6,6,9,18,13,1,14,20,88
1,6,6,9,18,13,5,4,0,62
1,6,6,9,18,13,5,18,0,76
1,6,6,9,18,13,5,18,19,95
1,6,6,9,18,13,9,14,7,83
1,6,6,9,18,13,12,25,0,90
1,6,6,9,18,13,19,0,0,72
1,6,6,9,24,0,0,0,0,46
1,6,6,9,24,1,2,12,5,66
1,6,6,9,24,1,12,0,0,59
1,6,6,9,24,5,4,0,0,55
1,6,6,9,24,5,18,0,0,69
1,6,6,9,24,5,18,19,0,88
1,6,6,9,24,5,19,0,0,70
1,6,6,9,24,9,1,12,0,68
1,6,6,9,24,9,14,7,0,76
1,6,6,9,24,9,15,14,0,84
1,6,6,9,24,13,5,14,20,98
1,6,6,9,24,20,0,0,0,66
1,6,6,9,24,20,21,18,5,110
1,6,6,12,1,20,5,0,0,51
1,6,6,12,1,20,5,4,0,55
1,6,6,12,1,20,9,15,14,84
1,6,6,12,1,20,21,19,0,86
1,6,6,12,9,3,20,0,0,57
1,6,6,12,9,3,20,5,4,66
1,6,6,12,9,3,20,5,18,80
1,6,6,12,9,3,20,19,0,76
1,6,6,12,15,15,6,0,0,61
1,6,6,12,21,5,0,0,0,51
1,6,6,12,21,5,14,3,5,73
1,6,6,12,21,5,14,3,25,93
1,6,6,12,21,5,14,20,0,85
1,6,6,12,21,5,14,20,19,104
1,6,6,12,21,24,0,0,0,70
1,6,6,12,21,24,5,19,0,94
1,6,6,12,21,24,9,15,14,108
1,6,6,15,4,9,12,12,0,65
1,6,6,15,18,3,5,0,0,54
1,6,6,15,18,3,5,4,0,58
1,6,6,15,18,3,9,14,7,79
1,6,6,15,18,4,0,0,0,50
1,6,6,15,18,4,5,4,0,59
1,6,6,15,18,4,9,14,7,80
1,6,6,15,18,4,19,0,0,69
1,6,6,15,18,5,19,20,0,90
1,6,6,15,18,5,19,20,19,109
1,6,6,18,1,25,0,0,0,57
1,6,6,18,1,25,5,4,0,66
1,6,6,18,1,25,5,18,0,80
1,6,6,18,1,25,5,18,19,99
1,6,6,18,1,25,9,14,7,87
1,6,6,18,1,25,19,0,0,76
1,6,6,18,1,16,0,0,0,48
1,6,6,18,5,9,7,8,20,80
1,6,6,18,5,20,0,0,0,56
1,6,6,18,5,21,24,0,0,81
1,6,6,18,9,3,1,20,5,69
1,6,6,18,9,7,8,20,0,75
1,6,6,18,9,7,8,20,19,94
1,6,6,18,15,14,20,0,0,80
1,6,6,18,15,14,20,5,0,85
1,6,6,18,15,14,20,5,4,89
1,6,6,18,15,14,20,5,5,90
1,6,6,18,15,14,20,5,18,103
1,6,6,18,15,14,20,25,0,105
1,6,6,18,15,14,20,19,0,99
1,6,6,20,0,0,0,0,0,33
1,6,6,21,19,5,0,0,0,58
1,6,6,21,19,9,15,14,0,91
1,6,6,21,19,9,15,14,19,110
1,6,7,8,1,14,5,20,19,81
1,6,7,8,1,14,9,19,0,65
1,6,7,8,1,14,19,0,0,56
1,6,7,15,4,0,0,0,0,33
1,6,9,5,12,4,0,0,0,37
1,6,9,11,15,13,5,14,0,74
1,6,9,18,5,0,0,0,0,39
1,6,12,1,13,5,0,0,0,38
1,6,12,1,18,5,0,0,0,43
1,6,12,1,20,0,0,0,0,40
1,6,12,1,20,15,24,9,14,102
1,6,12,1,20,21,19,0,0,80
1,6,12,1,21,14,20,0,0,75
1,6,12,5,25,0,0,0,0,49
1,6,12,9,3,11,5,18,0,65
1,6,12,9,7,8,20,0,0,63
1,6,12,15,1,20,0,0,0,55
1,6,12,15,23,0,0,0,0,57
1,6,12,15,23,5,18,0,0,80
1,6,12,21,11,9,14,7,0,81
1,6,12,21,19,8,0,0,0,67
1,6,12,21,20,20,5,18,0,103
1,6,15,1,13,0,0,0,0,36
1,6,15,3,1,12,0,0,0,38
1,6,15,15,20,0,0,0,0,57
1,6,15,18,5,0,0,0,0,45
1,6,15,18,5,8,1,14,4,72
1,6,15,18,5,19,1,9,4,78
1,6,15,18,5,20,9,13,5,92
1,6,15,18,5,23,1,18,4,91
1,6,15,18,20,9,15,18,9,111
1,6,15,21,12,0,0,0,0,55
1,6,15,21,14,4,5,0,0,66
1,6,18,1,25,0,0,0,0,51
1,6,18,1,9,4,0,0,0,39
1,6,18,5,5,20,0,0,0,55
1,6,18,5,5,20,19,0,0,74
1,6,18,5,19,3,1,0,0,53
1,6,18,5,19,8,0,0,0,57
1,6,18,5,20,0,0,0,0,50
1,6,18,5,20,5,0,0,0,55
1,6,18,9,3,1,14,19,0,71
1,6,18,9,7,8,20,0,0,69
1,6,18,9,20,0,0,0,0,54
1,6,18,9,20,5,0,0,0,59
1,6,18,9,20,19,0,0,0,73
1,6,18,15,14,20,0,0,0,74
1,6,18,15,19,0,0,0,0,59
1,6,18,15,23,14,0,0,0,77
1,6,20,1,2,1,0,0,0,31
1,6,20,5,18,0,0,0,0,50
1,6,20,5,18,1,3,20,0,74
1,6,20,5,18,1,7,5,0,63
1,6,20,5,18,2,1,25,0,78
1,6,20,5,18,2,1,14,4,71
1,6,20,5,18,2,5,1,20,78
1,6,20,5,18,2,12,15,23,102
1,6,20,5,18,2,15,4,25,96
1,6,20,5,18,3,1,18,5,77
1,6,20,5,18,3,1,19,20,93
1,6,20,5,18,3,12,1,16,82
1,6,20,5,18,3,15,13,5,86
1,6,20,5,18,3,15,19,20,107
1,6,20,5,18,3,18,15,16,102
1,6,20,5,18,3,21,18,5,97
1,6,20,5,18,4,1,25,19,99
1,6,20,5,18,4,1,13,16,84
1,6,20,5,18,4,1,20,5,80
1,6,20,5,18,4,5,1,12,72
1,6,20,5,18,4,5,3,11,73
1,6,20,5,18,5,25,5,0,85
1,6,20,5,18,5,14,4,0,73
1,6,20,5,18,6,1,12,12,81
1,6,20,5,18,6,1,13,5,75
1,6,20,5,18,6,5,5,4,70
1,6,20,5,18,6,15,18,13,102
1,6,20,5,18,7,1,13,5,76
1,6,20,5,18,7,1,19,0,77
1,6,20,5,18,7,12,15,23,107
1,6,20,5,18,7,15,0,0,72
1,6,20,5,18,7,15,15,4,91
1,6,20,5,18,7,21,14,19,111
1,6,20,5,18,8,1,14,4,77
1,6,20,5,18,8,1,18,13,90
1,6,20,5,18,8,5,1,20,84
1,6,20,5,18,8,5,12,16,91
1,6,20,5,18,8,5,14,4,81
1,6,20,5,18,8,15,12,4,89
1,6,20,5,18,8,15,16,5,94
1,6,20,5,18,9,14,7,19,99
1,6,20,5,18,11,9,14,7,91
1,6,20,5,18,12,9,6,5,82
1,6,20,5,18,12,15,19,19,115
1,6,20,5,18,12,15,22,5,104
1,6,20,5,18,13,1,18,11,93
1,6,20,5,18,13,1,19,19,102
1,6,20,5,18,13,1,19,20,103
1,6,20,5,18,13,1,20,8,92
1,6,20,5,18,13,5,1,12,81
1,6,20,5,18,13,9,12,11,95
1,6,20,5,18,13,15,19,20,117
1,6,20,5,18,14,15,15,14,108
1,6,20,5,18,14,15,19,5,103
1,6,20,5,18,14,15,20,5,104
1,6,20,5,18,15,1,18,0,84
1,6,20,5,18,16,1,9,14,90
1,6,20,5,18,16,1,18,20,105
1,6,20,5,18,16,1,19,20,106
1,6,20,5,18,16,5,1,11,83
1,6,20,5,18,16,12,1,25,104
1,6,20,5,18,18,1,11,5,85
1,6,20,5,18,18,15,12,12,107
1,6,20,5,18,19,0,0,0,69
1,6,20,5,18,19,5,14,4,92
1,6,20,5,18,19,8,9,16,102
1,6,20,5,18,19,15,14,7,105
1,6,20,5,18,20,1,14,0,85
1,6,20,5,18,20,1,19,11,101
1,6,20,5,18,20,1,24,0,95
1,6,20,5,18,20,9,13,5,97
1,6,20,5,18,20,21,18,14,123
1,6,20,5,18,23,1,12,5,91
1,6,20,5,18,23,1,18,0,92
1,6,20,5,18,23,1,18,4,96
1,6,20,5,18,23,1,19,8,101
1,6,20,5,18,23,9,19,5,106
1,6,20,5,18,23,9,20,0,102
1,6,20,5,18,23,15,18,4,110
1,6,20,5,18,23,15,18,11,117
1,6,20,5,18,23,15,18,20,126
1,6,20,13,15,19,20,0,0,94
1,6,20,15,19,1,0,0,0,62
1,6,20,15,19,1,19,0,0,81
1,6,20,23,1,18,4,0,0,73
1,6,20,23,1,18,4,19,0,92
1,6,21,14,3,20,9,15,14,103
1,6,23,9,12,12,9,20,5,97
1,7,2,1,0,0,0,0,0,11
1,7,3,25,0,0,0,0,0,36
1,7,5,0,0,0,0,0,0,13
1,7,5,1,2,12,5,0,0,33
1,7,5,4,0,0,0,0,0,17
1,7,5,4,12,25,0,0,0,54
1,7,5,4,14,5,19,19,0,74
1,7,5,9,14,7,0,0,0,43
1,7,5,9,14,7,19,0,0,62
1,7,5,9,19,13,0,0,0,54
1,7,5,9,19,13,19,0,0,73
1,7,5,9,19,20,0,0,0,61
1,7,5,9,19,20,19,0,0,80
1,7,5,12,1,19,20,0,0,65
1,7,5,12,5,19,19,0,0,68
1,7,5,12,5,19,19,12,25,105
1,7,5,12,15,14,7,0,0,61
1,7,5,14,3,25,0,0,0,55
1,7,5,14,3,9,5,19,0,63
1,7,5,14,4,0,0,0,0,31
1,7,5,14,4,1,0,0,0,32
1,7,5,14,4,1,19,0,0,51
1,7,5,14,4,21,13,0,0,65
1,7,5,14,4,21,13,19,0,84
1,7,5,14,5,0,0,0,0,32
1,7,5,14,5,19,0,0,0,51
1,7,5,14,5,19,5,19,0,75
1,7,5,14,5,19,9,1,0,61
1,7,5,14,5,19,9,1,19,80
1,7,5,14,5,19,9,3,0,63
1,7,5,14,5,19,9,19,0,79
1,7,5,14,5,20,9,3,0,64
1,7,5,14,9,26,5,0,0,67
1,7,5,14,9,26,5,4,0,71
1,7,5,14,9,26,5,19,0,86
1,7,5,14,9,26,9,14,7,92
1,7,5,14,14,5,19,9,19,93
1,7,5,14,14,5,20,9,3,78
1,7,5,14,20,0,0,0,0,47
1,7,5,14,20,5,19,19,0,90
1,7,5,14,20,9,1,12,0,69
1,7,5,14,20,9,14,7,0,77
1,7,5,14,20,9,22,1,12,91
1,7,5,14,20,9,22,5,0,83
1,7,5,14,20,9,22,5,19,102
1,7,5,14,20,18,25,0,0,90
1,7,5,14,20,18,9,5,19,98
1,7,5,14,20,19,0,0,0,66
1,7,5,14,20,19,8,9,16,99
1,7,5,18,0,0,0,0,0,31
1,7,5,18,1,19,9,1,0,61
1,7,5,18,1,20,21,13,19,105
1,7,5,18,19,0,0,0,0,50
1,7,5,19,0,0,0,0,0,32
1,7,5,20,0,0,0,0,0,33
1,7,5,20,5,0,0,0,0,38
1,7,5,21,19,9,1,0,0,63
1,7,5,21,19,9,3,0,0,65
1,7,5,21,19,20,9,1,0,83
1,7,7,5,18,0,0,0,0,38
1,7,7,5,18,1,20,5,0,64
1,7,7,5,18,15,19,5,0,77
1,7,7,5,18,19,0,0,0,57
1,7,7,5,19,20,0,0,0,59
1,7,7,9,5,19,0,0,0,48
1,7,7,18,1,3,5,0,0,42
1,7,7,18,1,4,5,0,0,43
1,7,7,18,1,4,5,4,0,47
1,7,7,18,1,4,5,19,0,62
1,7,7,18,1,4,9,14,7,68
1,7,7,18,1,20,5,0,0,59
1,7,7,18,1,22,1,20,5,82
1,7,7,18,5,7,1,14,20,80
1,7,7,18,5,7,1,20,5,71
1,7,7,18,5,7,5,0,0,50
1,7,7,18,5,19,19,0,0,76
1,7,7,18,5,19,19,5,4,85
1,7,7,18,5,19,19,5,19,100
1,7,7,18,5,19,19,9,14,99
1,7,7,18,5,19,19,15,18,109
1,7,7,18,25,0,0,0,0,58
1,7,7,18,9,5,22,5,0,74
1,7,7,18,9,5,22,5,4,78
1,7,7,18,9,5,22,5,19,93
1,7,7,18,15,0,0,0,0,48
1,7,7,18,15,19,0,0,0,67
1,7,7,18,15,21,16,0,0,85
1,7,7,21,18,0,0,0,0,54
1,7,8,1,0,0,0,0,0,17
1,7,8,1,14,5,5,0,0,41
1,7,8,1,19,0,0,0,0,36
1,7,8,1,19,20,0,0,0,56
1,7,25,0,0,0,0,0,0,33
1,7,9,2,12,5,0,0,0,36
1,7,9,12,1,23,15,15,4,87
1,7,9,12,5,0,0,0,0,34
1,7,9,12,5,12,25,0,0,71
1,7,9,12,5,14,5,19,19,91
1,7,9,12,9,20,25,0,0,83
1,7,9,12,9,20,9,5,19,91
1,7,9,12,13,5,14,20,5,86
1,7,9,14,0,0,0,0,0,31
1,7,25,14,1,18,25,0,0,91
1,7,9,14,7,0,0,0,0,38
1,7,9,14,7,19,0,0,0,57
1,7,25,14,9,3,0,0,0,59
1,7,9,14,14,5,18,0,0,68
1,7,9,14,14,5,18,19,0,87
1,7,25,14,15,21,19,0,0,102
1,7,9,15,0,0,0,0,0,32
1,7,9,15,19,0,0,0,0,51
1,7,9,15,20,1,7,5,0,65
1,7,9,15,20,1,7,5,19,84
1,7,25,18,1,20,5,0,0,77
1,7,25,18,9,1,0,0,0,61
1,7,9,19,13,0,0,0,0,49
1,7,9,19,13,19,0,0,0,68
1,7,9,19,20,0,0,0,0,56
1,7,9,19,20,1,20,15,18,110
1,7,9,19,20,5,4,0,0,65
1,7,9,19,20,5,18,0,0,79
1,7,9,19,20,9,14,7,0,86
1,7,9,19,20,13,5,14,20,108
1,7,9,19,20,15,18,0,0,89
1,7,9,19,20,19,0,0,0,75
1,7,9,20,0,0,0,0,0,37
1,7,9,20,1,2,12,5,0,57
1,7,9,20,1,14,20,0,0,72
1,7,9,20,1,20,5,0,0,63
1,7,9,20,1,20,5,4,0,67
1,7,9,20,1,20,5,19,0,82
1,7,9,20,1,20,9,14,7,88
1,7,9,20,1,20,9,15,14,96
1,7,9,20,1,20,9,22,5,94
1,7,9,20,1,20,15,0,0,73
1,7,9,20,1,20,15,18,0,91
1,7,9,20,1,20,15,18,19,110
1,7,9,20,1,20,18,9,24,109
1,7,9,20,16,18,15,16,0,102
1,7,9,20,16,18,15,16,19,121
1,7,9,20,16,21,14,11,20,119
1,7,12,1,0,0,0,0,0,21
1,7,12,1,14,3,5,0,0,43
1,7,12,1,18,5,0,0,0,44
1,7,12,5,1,6,0,0,0,32
1,7,12,5,1,13,0,0,0,39
1,7,12,5,5,0,0,0,0,30
1,7,12,5,25,0,0,0,0,50
1,7,12,5,20,0,0,0,0,45
1,7,12,5,20,8,5,1,4,63
1,7,12,5,20,19,0,0,0,64
1,7,12,25,0,0,0,0,0,45
1,7,12,25,3,15,14,0,0,77
1,7,12,25,3,15,14,5,0,82
1,7,12,25,3,15,14,5,19,101
1,7,12,25,3,15,14,19,0,96
1,7,12,9,13,13,5,18,0,78
1,7,12,9,14,20,0,0,0,63
1,7,12,25,16,8,15,21,19,124
1,7,12,9,19,20,5,14,0,87
1,7,12,9,20,20,5,18,0,92
1,7,12,15,2,21,12,9,1,80
1,7,12,15,19,19,1,12,0,86
1,7,12,15,19,19,1,20,5,99
1,7,12,15,19,19,9,1,0,83
1,7,12,15,23,0,0,0,0,58
1,7,12,21,3,15,14,0,0,73
1,7,12,21,3,15,14,5,0,78
1,7,13,1,19,0,0,0,0,41
1,7,13,1,20,9,14,5,0,70
1,7,13,9,14,1,20,5,0,70
1,7,13,9,14,1,20,5,4,74
1,7,14,1,9,12,0,0,0,44
1,7,14,1,9,12,19,0,0,63
1,7,14,1,13,5,0,0,0,41
1,7,14,1,13,5,4,0,0,45
1,7,14,1,20,0,0,0,0,43
1,7,14,1,20,5,0,0,0,48
1,7,14,1,20,5,19,0,0,67
1,7,14,1,20,8,9,1,0,61
1,7,14,1,20,8,9,3,0,63
1,7,14,1,20,8,15,21,19,106
1,7,14,1,20,9,3,0,0,55
1,7,14,1,20,9,3,1,12,68
1,7,14,1,20,9,15,14,0,81
1,7,14,1,20,9,15,14,19,100
1,7,14,5,1,14,0,0,0,42
1,7,14,5,1,21,0,0,0,49
1,7,14,5,1,21,24,0,0,73
1,7,14,5,12,0,0,0,0,39
1,7,14,9,20,9,15,14,0,89
1,7,14,9,26,5,0,0,0,62
1,7,14,9,26,5,4,0,0,66
1,7,14,9,26,5,19,0,0,81
1,7,14,9,26,9,14,7,0,87
1,7,14,15,9,20,5,19,0,90
1,7,14,15,13,5,14,0,0,69
1,7,14,15,13,5,14,19,0,88
1,7,14,15,13,9,3,1,12,75
1,7,14,15,13,9,14,1,0,74
1,7,14,15,13,9,14,1,12,86
1,7,14,15,19,25,0,0,0,81
1,7,14,15,19,9,1,0,0,66
1,7,14,15,19,9,1,19,0,85
1,7,14,15,19,9,19,0,0,84
1,7,14,15,19,20,9,3,0,88
1,7,14,15,19,20,9,3,19,107
1,7,14,21,19,0,0,0,0,62
1,7,14,21,19,5,19,0,0,86
1,7,15,0,0,0,0,0,0,23
1,7,15,7,0,0,0,0,0,30
1,7,15,7,5,0,0,0,0,35
1,7,15,7,9,3,0,0,0,42
1,7,15,7,9,3,19,0,0,61
1,7,15,7,21,5,0,0,0,56
1,7,15,8,15,0,0,0,0,46
1,7,15,9,14,7,0,0,0,53
1,7,15,13,5,14,19,9,14,97
1,7,15,14,1,12,0,0,0,50
1,7,15,14,5,0,0,0,0,42
1,7,15,14,5,19,0,0,0,61
1,7,15,14,25,0,0,0,0,62
1,7,15,14,9,1,0,0,0,47
1,7,15,14,9,1,4,1,0,52
1,7,15,14,9,1,4,9,14,74
1,7,15,14,9,3,0,0,0,49
1,7,15,14,9,5,4,0,0,55
1,7,15,14,9,5,19,0,0,70
1,7,15,14,9,19,5,0,0,70
1,7,15,14,9,19,5,4,0,74
1,7,15,14,9,19,5,19,0,89
1,7,15,14,9,19,9,14,7,95
1,7,15,14,9,19,20,0,0,85
1,7,15,14,9,19,20,9,3,97
1,7,15,14,9,19,20,19,0,104
1,7,15,14,9,21,13,0,0,80
1,7,15,14,9,26,5,0,0,77
1,7,15,14,9,26,5,4,0,81
1,7,15,14,9,26,5,18,0,95
1,7,15,14,9,26,5,19,0,96
1,7,15,14,9,26,9,14,7,102
1,7,15,14,15,20,8,5,20,105
1,7,15,14,19,0,0,0,0,56
1,7,15,18,1,0,0,0,0,42
1,7,15,18,1,5,0,0,0,47
1,7,15,18,1,14,15,13,5,89
1,7,15,18,1,19,0,0,0,61
1,7,15,18,15,20,0,0,0,76
1,7,15,18,15,20,8,0,0,84
1,7,15,19,0,0,0,0,0,42
1,7,15,21,1,18,1,0,0,64
1,7,15,21,20,1,0,0,0,65
1,7,15,21,20,9,0,0,0,73
1,7,15,21,20,25,0,0,0,89
1,7,15,21,20,9,5,19,0,97
1,7,15,21,20,9,19,0,0,92
1,7,16,1,9,20,5,0,0,59
1,7,16,1,9,20,9,3,0,66
1,7,18,1,3,5,0,0,0,35
1,7,18,1,6,5,0,0,0,38
1,7,18,1,6,5,19,0,0,57
1,7,18,1,6,6,5,0,0,44
1,7,18,1,6,6,5,5,0,49
1,7,18,1,6,6,5,19,0,63
1,7,18,1,8,0,0,0,0,35
1,7,18,1,12,0,0,0,0,39
1,7,18,1,13,5,4,0,0,49
1,7,18,1,16,8,9,1,0,61
1,7,18,1,16,8,9,1,19,80
1,7,18,1,16,8,9,3,0,63
1,7,18,1,18,9,1,0,0,55
1,7,18,1,18,9,1,14,0,69
1,7,18,1,18,9,1,14,19,88
1,7,18,1,22,9,3,0,0,61
1,7,18,5,0,0,0,0,0,31
1,7,18,5,1,20,0,0,0,52
1,7,18,5,1,20,9,15,14,90
1,7,18,5,5,0,0,0,0,36
1,7,18,5,5,1,2,12,5,56
1,7,18,5,5,1,2,12,25,76
1,7,18,5,5,4,0,0,0,40
1,7,18,5,5,9,14,7,0,66
1,7,18,5,5,13,5,14,20,88
1,7,18,5,5,18,0,0,0,54
1,7,18,5,5,18,19,0,0,73
1,7,18,5,5,19,0,0,0,55
1,7,18,5,7,5,0,0,0,43
1,7,18,5,7,5,19,0,0,62
1,7,18,5,9,14,7,0,0,61
1,7,18,5,13,5,14,19,0,82
1,7,18,5,13,5,14,20,0,83
1,7,18,5,13,5,14,20,19,102
1,7,18,5,19,20,0,0,0,70
1,7,18,5,19,20,1,12,0,83
1,7,18,5,19,20,9,1,12,92
1,7,18,5,19,20,9,1,14,94
1,7,18,5,19,20,9,3,0,82
1,7,18,5,19,20,9,19,0,98
1,7,18,9,1,0,0,0,0,36
1,7,18,9,1,19,0,0,0,55
1,7,18,9,3,0,0,0,0,38
1,7,18,9,3,5,18,5,0,66
1,7,18,9,3,15,12,5,0,70
1,7,18,9,5,6,0,0,0,46
1,7,18,9,13,15,14,25,0,102
1,7,18,9,13,15,20,15,18,116
1,7,18,9,14,0,0,0,0,49
1,7,18,9,15,12,15,7,25,109
1,7,18,9,15,14,9,4,0,77
1,7,18,9,15,20,0,0,0,70
1,7,18,9,15,20,25,16,5,116
1,7,18,25,16,14,9,1,0,91
1,7,18,25,16,14,9,1,9,100
1,7,18,25,16,14,9,1,19,110
1,7,18,25,16,14,15,4,5,105
1,7,18,9,19,5,0,0,0,59
1,7,18,9,19,5,4,0,0,63
1,7,18,9,19,9,14,7,0,84
1,7,18,9,20,15,0,0,0,70
1,7,18,9,20,15,19,0,0,89
1,7,18,15,1,14,0,0,0,56
1,7,18,15,4,15,12,3,5,80
1,7,18,15,12,15,7,25,0,100
1,7,18,15,12,15,7,9,3,87
1,7,18,15,13,0,0,0,0,54
1,7,18,15,13,1,14,9,1,79
1,7,18,15,13,25,26,9,4,118
1,7,18,15,14,0,0,0,0,55
1,7,18,15,14,15,13,5,0,88
1,7,18,15,14,15,13,25,0,108
1,7,18,15,14,15,13,9,3,95
1,7,18,15,15,6,0,0,0,62
1,7,18,15,16,5,0,0,0,62
1,7,18,15,20,5,0,0,0,66
1,7,18,15,20,25,16,5,0,107
1,7,18,15,21,14,4,0,0,80
1,7,18,21,6,5,0,0,0,58
1,7,18,21,9,6,0,0,0,62
1,7,19,1,13,0,0,0,0,41
1,7,19,20,0,0,0,0,0,47
1,7,20,2,1,19,9,3,0,62
1,7,21,1,0,0,0,0,0,30
1,7,21,1,3,1,20,5,0,59
1,7,21,1,4,15,18,0,0,67
1,7,21,1,10,9,0,0,0,49
1,7,21,1,13,1,19,0,0,63
1,7,21,1,13,9,5,12,0,69
1,7,21,1,18,1,0,0,0,49
1,7,21,1,22,9,14,1,0,76
1,7,21,5,0,0,0,0,0,34
1,7,21,5,25,0,0,0,0,59
1,7,21,5,12,9,11,5,0,71
1,7,21,5,16,18,15,15,6,104
1,7,21,5,19,0,0,0,0,53
1,7,21,5,23,5,5,4,0,71
1,7,21,5,23,5,5,4,19,90
1,7,21,7,12,9,1,0,0,58
1,7,21,9,12,20,0,0,0,70
1,7,21,9,18,1,7,5,0,69
1,7,21,9,19,5,0,0,0,62
1,7,21,9,19,8,0,0,0,65
1,7,21,9,19,8,12,25,0,102
1,7,21,10,15,14,0,0,0,68
1,7,21,14,1,8,0,0,0,52
1,7,21,18,1,0,0,0,0,48
1,7,21,18,15,20,8,0,0,90
1,7,21,19,8,0,0,0,0,56
1,7,21,19,20,0,0,0,0,68
1,8,3,8,15,15,0,0,0,50
1,8,5,1,4,0,0,0,0,19
1,8,5,1,16,0,0,0,0,31
1,8,5,25,0,0,0,0,0,39
1,8,5,9,7,8,20,0,0,58
1,8,5,13,0,0,0,0,0,27
1,8,5,13,19,0,0,0,0,46
1,8,9,0,0,0,0,0,0,18
1,8,9,13,19,1,0,0,0,51
1,8,9,13,19,1,19,0,0,70
1,8,9,14,4,0,0,0,0,36
1,8,9,14,20,0,0,0,0,52
1,8,25,16,14,9,1,0,0,74
1,8,9,19,20,15,18,9,3,102
1,8,12,21,23,1,12,9,1,88
1,8,13,5,4,9,0,0,0,40
1,8,13,5,20,0,0,0,0,47
1,8,15,0,0,0,0,0,0,24
1,8,15,25,0,0,0,0,0,49
1,8,15,25,19,0,0,0,0,68
1,8,15,12,4,0,0,0,0,40
1,8,15,12,4,19,0,0,0,59
1,8,15,12,20,0,0,0,0,56
1,8,15,14,7,0,0,0,0,45
1,8,15,18,19,5,0,0,0,66
1,8,19,0,0,0,0,0,0,28
1,8,19,1,14,0,0,0,0,43
1,8,21,0,0,0,0,0,0,30
1,8,21,1,3,1,0,0,0,35
1,8,21,1,20,12,5,0,0,68
1,8,21,5,8,21,5,20,5,94
1,8,21,12,12,0,0,0,0,54
1,8,21,13,0,0,0,0,0,43
1,8,21,14,7,5,18,5,4,83
1,8,21,14,7,18,25,0,0,94
1,8,21,14,20,0,0,0,0,64
1,8,21,18,1,0,0,0,0,49
1,8,21,18,5,23,1,0,0,77
1,8,21,19,8,0,0,0,0,57
1,8,21,21,12,1,0,0,0,64
1,8,23,1,12,0,0,0,0,45
1,9,2,12,9,14,19,0,0,66
1,9,4,1,2,12,5,0,0,34
1,9,4,1,14,3,5,0,0,37
1,9,4,1,14,20,0,0,0,49
1,9,4,5,0,0,0,0,0,19
1,9,4,5,4,0,0,0,0,23
1,9,4,5,18,0,0,0,0,37
1,9,4,5,18,19,0,0,0,56
1,9,4,6,21,12,0,0,0,53
1,9,4,9,14,7,0,0,0,44
1,9,4,12,5,19,19,0,0,69
1,9,4,13,1,14,0,0,0,42
1,9,4,13,1,14,13,5,14,74
1,9,4,13,5,14,0,0,0,46
1,25,5,0,0,0,0,0,0,31
1,25,5,7,18,5,5,14,0,80
1,9,5,12,0,0,0,0,0,27
1,25,5,12,16,0,0,0,0,59
1,25,5,14,0,0,0,0,0,45
1,25,5,14,2,9,20,5,0,81
1,25,5,14,19,0,0,0,0,64
1,25,5,14,19,20,0,0,0,84
1,9,5,18,25,0,0,0,0,58
1,25,5,19,0,0,0,0,0,50
1,9,7,5,18,0,0,0,0,40
1,9,7,12,5,20,0,0,0,54
1,9,7,12,5,20,19,0,0,73
1,9,7,12,5,20,20,5,0,79
1,9,7,18,5,0,0,0,0,40
1,9,7,18,5,13,15,18,5,91
1,9,7,18,5,20,0,0,0,60
1,9,7,18,5,20,19,0,0,79
1,9,7,18,5,20,20,5,0,85
1,9,7,18,5,20,20,5,19,104
1,9,7,21,5,12,12,5,0,72
1,9,7,21,9,5,18,5,0,75
1,9,7,21,9,12,12,5,0,76
1,9,7,21,9,12,12,5,19,95
1,25,9,5,12,4,0,0,0,56
1,25,9,14,0,0,0,0,0,49
1,25,9,14,19,0,0,0,0,68
1,9,11,0,0,0,0,0,0,21
1,9,11,1,14,5,0,0,0,41
1,9,11,9,4,15,0,0,0,49
1,9,11,9,4,15,19,0,0,68
1,9,11,9,14,9,20,5,0,78
1,9,11,15,14,1,0,0,0,51
1,9,11,21,3,8,9,0,0,62
1,9,12,0,0,0,0,0,0,22
1,9,12,1,14,20,5,18,25,105
1,9,12,1,14,20,8,9,3,77
1,9,12,1,14,20,9,14,5,85
1,9,12,1,14,20,15,0,0,72
1,9,12,5,4,0,0,0,0,31
1,9,12,5,18,15,14,0,0,74
1,9,12,5,18,15,14,19,0,93
1,25,12,5,19,19,0,0,0,81
1,25,12,5,20,0,0,0,0,63
1,9,12,5,20,20,5,0,0,72
1,9,12,9,14,7,0,0,0,52
1,9,12,12,20,0,0,0,0,54
1,25,12,12,21,0,0,0,0,71
1,9,12,13,5,14,20,0,0,74
1,9,12,13,5,14,20,19,0,93
1,9,12,19,0,0,0,0,0,41
1,9,12,19,25,20,5,0,0,91
1,9,12,21,18,15,0,0,0,76
1,9,12,21,18,15,9,4,0,89
1,9,12,23,5,5,4,0,0,59
1,9,13,1,2,12,5,0,0,43
1,9,13,1,18,1,0,0,0,43
1,9,13,5,4,0,0,0,0,32
1,9,13,5,18,0,0,0,0,46
1,9,13,5,18,19,0,0,0,65
1,9,13,6,21,12,0,0,0,62
1,9,13,6,21,12,12,25,0,99
1,9,13,9,14,7,0,0,0,53
1,9,13,12,5,19,19,0,0,78
1,9,13,12,5,19,19,12,25,115
1,9,14,1,12,5,8,0,0,50
1,9,14,5,0,0,0,0,0,29
1,25,14,5,0,0,0,0,0,45
1,9,14,5,5,0,0,0,0,34
1,9,14,8,21,13,0,0,0,66
1,9,14,15,9,0,0,0,0,48
1,9,14,19,0,0,0,0,0,43
1,9,14,19,5,12,12,0,0,72
1,9,14,19,5,12,12,19,0,91
1,9,14,20,0,0,0,0,0,44
1,9,15,12,9,0,0,0,0,46
1,9,15,12,9,19,0,0,0,65
1,9,15,14,0,0,0,0,0,39
1,25,15,14,4,0,0,0,0,59
1,9,15,14,9,1,12,0,0,61
1,25,15,14,20,0,0,0,0,75
1,25,15,21,19,0,0,0,0,81
1,9,18,1,2,12,5,0,0,48
1,9,18,1,13,16,15,0,0,73
1,9,18,1,14,0,0,0,0,43
1,9,18,2,1,7,0,0,0,38
1,9,18,2,1,7,19,0,0,57
1,9,18,2,9,12,12,0,0,63
1,9,18,2,9,12,12,19,0,82
1,9,18,2,15,1,20,0,0,66
1,9,18,2,15,1,20,19,0,85
1,9,18,2,15,18,14,0,0,77
1,9,18,2,15,18,14,5,0,82
1,9,18,2,15,21,14,4,0,84
1,9,18,2,18,9,3,11,0,71
1,9,18,2,18,21,19,8,0,96
1,9,18,2,21,18,19,20,0,108
1,9,18,2,21,18,19,20,19,127
1,9,18,2,21,19,0,0,0,70
1,9,18,2,21,19,5,19,0,94
1,9,18,2,21,19,19,5,19,113
1,9,18,3,8,5,3,11,0,58
1,9,18,3,8,5,3,11,19,77
1,9,18,3,15,1,3,8,0,58
1,9,18,3,18,1,6,20,0,76
1,9,18,3,18,1,6,20,19,95
1,9,18,3,18,5,23,0,0,77
1,9,18,3,18,5,23,19,0,96
1,9,18,4,1,20,5,0,0,58
1,9,18,4,1,20,5,19,0,77
1,9,18,4,15,3,11,0,0,61
1,9,18,4,18,15,13,5,0,83
1,9,18,4,18,15,13,5,19,102
1,9,18,4,18,15,16,0,0,81
1,9,18,4,18,15,16,19,0,100
1,25,18,5,0,0,0,0,0,49
1,9,18,5,4,0,0,0,0,37
1,9,18,5,4,1,12,5,19,74
1,9,18,5,18,0,0,0,0,51
1,9,18,5,18,19,0,0,0,70
1,9,18,5,19,20,0,0,0,72
1,9,18,6,1,18,5,0,0,58
1,9,18,6,1,18,5,19,0,77
1,9,18,6,9,5,12,4,0,64
1,9,18,6,9,5,12,4,19,83
1,9,18,6,12,15,23,0,0,84
1,9,18,6,12,15,23,19,0,103
1,9,18,6,15,9,12,0,0,70
1,9,18,6,15,9,12,19,0,89
1,9,18,6,18,1,13,5,0,71
1,9,18,6,18,1,13,5,19,90
1,9,18,7,12,15,23,0,0,85
1,9,18,7,12,15,23,19,0,104
1,9,18,7,18,1,16,8,0,78
1,9,18,8,5,1,4,0,0,46
1,9,18,8,5,1,4,19,0,65
1,9,18,9,5,18,0,0,0,60
1,9,18,9,5,19,20,0,0,81
1,9,18,9,6,25,0,0,0,68
1,9,18,9,6,9,5,4,0,61
1,9,18,9,12,25,0,0,0,74
1,9,18,9,14,5,19,19,0,94
1,9,18,9,14,7,0,0,0,58
1,9,18,9,14,7,19,0,0,77
1,9,18,9,19,8,0,0,0,64
1,9,18,12,5,19,19,0,0,83
1,9,18,12,5,19,19,12,25,120
1,9,18,12,9,6,20,0,0,75
1,9,18,12,9,6,20,5,4,84
1,9,18,12,9,6,20,19,0,94
1,9,18,12,9,7,8,20,0,84
1,9,18,12,9,11,5,0,0,65
1,9,18,12,9,14,5,0,0,68
1,9,18,12,9,14,5,18,0,86
1,9,18,12,9,14,5,18,19,105
1,9,18,12,9,14,5,19,0,87
1,9,18,12,9,14,7,0,0,70
1,9,18,12,15,3,11,0,0,69
1,9,18,12,15,3,11,19,0,88
1,9,18,13,1,9,12,0,0,63
1,9,18,13,1,9,12,5,4,72
1,9,18,13,1,9,12,19,0,82
1,9,18,13,1,14,0,0,0,56
1,9,18,13,1,18,11,0,0,71
1,9,18,13,1,18,11,5,18,94
1,9,18,13,1,19,19,0,0,80
1,9,18,13,5,14,0,0,0,60
1,9,18,13,15,2,9,12,5,84
1,9,18,13,15,14,7,5,18,100
1,9,18,14,0,0,0,0,0,42
1,9,18,14,19,0,0,0,0,61
1,9,18,15,13,5,20,5,18,104
1,9,18,16,1,18,11,0,0,74
1,9,18,16,1,18,11,19,0,93
1,9,18,16,8,15,2,9,1,79
1,9,18,16,12,1,25,0,0,82
1,9,18,16,12,1,25,19,0,101
1,9,18,16,12,1,14,5,0,76
1,9,18,16,12,1,14,5,4,80
1,9,18,16,12,1,14,5,18,94
1,9,18,16,12,1,14,5,19,95
1,9,18,16,12,15,20,0,0,91
1,9,18,16,15,18,20,0,0,97
1,9,18,16,15,18,20,19,0,116
1,9,18,16,15,19,20,0,0,98
1,9,18,16,15,19,20,19,0,117
1,9,18,16,18,15,15,6,0,98
1,9,18,16,18,15,15,6,19,117
1,9,18,19,0,0,0,0,0,47
1,9,18,19,3,1,16,5,0,72
1,9,18,19,3,1,16,5,19,91
1,9,18,19,3,18,5,23,0,96
1,9,18,19,3,18,5,23,19,115
1,9,18,19,8,5,4,0,0,64
1,9,18,19,8,5,4,19,0,83
1,9,18,19,8,5,5,20,0,85
1,9,18,19,8,9,16,0,0,80
1,9,18,19,8,9,16,19,0,99
1,9,18,19,9,3,11,0,0,70
1,9,18,19,15,13,5,0,0,80
1,9,18,19,16,1,3,5,0,72
1,9,18,19,16,1,3,5,19,91
1,9,18,19,16,5,5,4,0,77
1,9,18,19,16,5,5,4,19,96
1,9,18,19,20,18,5,1,13,104
1,9,18,19,20,18,9,16,0,110
1,9,18,19,20,18,9,16,19,129
1,9,18,20,0,0,0,0,0,48
1,9,18,20,5,4,0,0,0,57
1,9,18,20,8,0,0,0,0,56
1,9,18,20,8,5,4,0,0,65
1,9,18,20,8,9,14,7,0,86
1,9,18,20,8,19,0,0,0,75
1,9,18,20,9,7,8,20,0,92
1,9,18,20,9,13,5,0,0,75
1,9,18,20,9,13,5,19,0,94
1,9,18,20,9,14,7,0,0,78
1,9,18,20,19,0,0,0,0,67
1,9,18,22,9,5,23,0,0,87
1,9,18,23,1,25,0,0,0,77
1,9,18,23,1,25,13,1,14,105
1,9,18,23,1,25,19,0,0,96
1,9,18,23,1,18,4,0,0,74
1,9,18,23,1,18,4,19,0,93
1,9,18,23,1,19,8,0,0,79
1,9,18,23,1,22,5,0,0,79
1,9,18,23,1,22,5,19,0,98
1,9,18,23,9,19,5,0,0,84
1,9,18,23,15,13,1,14,0,94
1,9,18,23,15,13,5,14,0,98
1,9,18,23,15,18,20,8,25,137
1,25,19,0,0,0,0,0,0,45
1,9,19,5,23,5,5,4,0,71
1,9,19,12,5,0,0,0,0,46
1,9,19,12,5,4,0,0,0,50
1,9,19,12,5,12,5,19,19,101
1,9,19,12,5,19,0,0,0,65
1,9,19,12,9,14,7,0,0,71
1,9,19,20,5,15,9,18,0,96
1,9,19,20,15,16,15,4,0,99
1,9,20,0,0,0,0,0,0,30
1,9,20,3,8,0,0,0,0,41
1,9,20,3,8,2,15,14,5,77
1,9,20,3,8,5,19,0,0,65
1,9,20,3,8,12,5,19,19,96
1,9,20,5,19,9,19,0,0,82
1,9,20,8,0,0,0,0,0,38
1,9,20,9,15,12,15,7,25,113
1,9,20,9,15,14,0,0,0,68
1,9,20,9,19,0,0,0,0,58
1,9,20,19,0,0,0,0,0,49
1,25,21,0,0,0,0,0,0,47
1,25,21,4,1,14,20,5,0,91
1,25,21,25,21,0,0,0,0,93
1,25,21,18,22,5,4,1,19,116
1,9,22,5,18,0,0,0,0,55
1,9,22,5,18,19,0,0,0,74
1,9,22,18,0,0,0,0,0,50
1,9,23,1,9,14,0,0,0,57
1,9,23,1,14,0,0,0,0,48
1,25,23,8,5,18,5,0,0,85
1,9,26,12,5,0,0,0,0,53
1,10,5,5,0,0,0,0,0,21
1,10,5,14,10,15,0,0,0,55
1,10,8,1,18,0,0,0,0,38
1,10,9,13,5,26,0,0,0,64
1,10,9,20,20,5,18,0,0,83
1,10,9,22,1,0,0,0,0,43
1,10,9,22,1,19,0,0,0,62
1,10,15,7,0,0,0,0,0,33
1,10,15,9,14,20,0,0,0,69
1,10,15,14,10,15,12,9,0,86
1,10,15,21,18,5,0,0,0,70
1,10,15,21,18,9,19,5,0,98
1,10,15,23,1,14,0,0,0,64
1,10,15,23,1,14,19,0,0,83
1,10,21,7,1,19,0,0,0,59
1,10,21,20,13,5,14,20,0,104
1,11,3,8,5,8,0,0,0,36
1,11,5,0,0,0,0,0,0,17
1,11,5,1,11,5,0,0,0,34
1,11,5,2,9,0,0,0,0,28
1,11,5,4,0,0,0,0,0,21
1,11,5,5,0,0,0,0,0,22
1,11,5,5,19,0,0,0,0,41
1,11,5,8,15,18,14,5,0,77
1,11,5,25,0,0,0,0,0,42
1,11,5,11,9,0,0,0,0,37
1,11,5,12,1,19,0,0,0,49
1,11,5,13,2,15,12,12,0,71
1,11,5,14,2,15,12,4,0,64
1,11,5,14,5,0,0,0,0,36
1,11,5,14,5,19,0,0,0,55
1,11,5,16,9,18,15,0,0,75
1,11,5,16,9,18,15,19,0,94
1,11,5,18,9,20,5,0,0,69
1,11,5,20,15,14,0,0,0,66
1,11,8,1,18,1,0,0,0,40
1,11,8,25,1,14,1,0,0,61
1,11,8,15,15,14,4,0,0,68
1,11,8,18,15,20,0,0,0,73
1,11,8,21,14,4,0,0,0,59
1,11,9,1,0,0,0,0,0,22
1,11,9,13,2,15,0,0,0,51
1,11,9,14,4,12,5,0,0,56
1,11,9,14,5,19,9,1,0,69
1,11,9,14,5,19,9,3,0,71
1,11,9,14,5,19,9,19,0,87
1,11,9,14,5,20,5,0,0,65
1,11,9,14,5,20,9,3,0,72
1,11,9,14,7,0,0,0,0,42
1,11,13,9,20,5,0,0,0,59
1,11,13,21,4,1,18,0,0,69
1,11,13,21,4,4,1,18,0,73
1,11,14,5,5,0,0,0,0,36
1,11,14,15,23,0,0,0,0,64
1,11,15,0,0,0,0,0,0,27
1,11,15,1,19,13,0,0,0,60
1,11,15,1,19,13,1,0,0,61
1,11,15,12,21,20,8,9,1,98
1,11,15,14,7,5,0,0,0,53
1,11,15,22,0,0,0,0,0,49
1,11,16,5,11,0,0,0,0,44
1,11,18,5,0,0,0,0,0,35
1,11,18,15,1,19,9,19,0,93
1,11,18,15,20,5,18,0,0,88
1,11,18,15,20,5,18,9,1,98
1,11,18,20,5,18,9,1,0,83
1,11,21,0,0,0,0,0,0,33
1,11,21,1,13,13,9,14,0,83
1,11,21,1,13,13,9,14,5,88
1,11,21,12,5,0,0,0,0,50
1,11,21,14,4,0,0,0,0,51
1,11,22,1,22,9,20,0,0,86
1,11,22,1,22,9,20,19,0,105
1,12,2,1,3,5,1,0,0,25
1,12,2,1,3,15,18,1,0,53
1,12,2,1,3,15,18,5,0,57
1,12,2,1,3,15,18,5,19,76
1,12,2,1,8,1,3,1,0,29
1,12,2,1,14,9,1,14,19,73
1,12,2,1,14,9,20,5,0,64
1,12,2,1,18,3,15,0,0,52
1,12,2,1,18,4,9,14,5,66
1,12,2,1,18,5,12,12,9,72
1,12,2,1,18,5,12,12,15,78
1,12,2,1,18,9,21,13,0,77
1,12,2,1,19,0,0,0,0,35
1,12,2,1,20,1,0,0,0,37
1,12,2,1,20,1,19,0,0,56
1,12,2,1,20,9,15,14,0,74
1,12,2,1,20,18,15,19,19,107
1,12,2,5,0,0,0,0,0,20
1,12,2,5,4,15,0,0,0,39
1,12,2,5,4,15,5,19,0,63
1,12,2,5,4,15,19,0,0,58
1,12,2,5,9,20,0,0,0,49
1,12,2,5,18,3,1,0,0,42
1,12,2,5,18,7,5,0,0,50
1,12,2,5,18,7,8,9,0,62
1,12,2,5,18,7,15,0,0,60
1,12,2,5,18,20,9,14,0,81
1,12,2,5,18,20,25,16,5,104
1,12,2,5,18,20,9,20,5,92
1,12,2,5,19,3,5,14,20,81
1,12,2,5,19,16,9,14,5,83
1,12,2,5,19,16,25,14,5,99
1,12,2,5,19,20,15,14,0,88
1,12,2,5,20,1,4,0,0,45
1,12,2,9,3,1,14,19,0,61
1,12,2,9,3,1,14,20,0,62
1,12,2,9,3,15,18,5,0,65
1,12,2,9,3,15,18,5,19,84
1,12,2,9,3,21,12,9,0,69
1,12,2,9,6,25,0,0,0,55
1,12,2,9,6,9,5,4,0,48
1,12,2,9,6,25,9,14,7,85
1,12,2,9,14,1,12,0,0,51
1,12,2,9,14,5,19,0,0,62
1,12,2,9,14,5,19,19,0,81
1,12,2,9,14,9,3,0,0,50
1,12,2,9,14,9,19,13,0,79
1,12,2,9,14,9,19,13,19,98
1,12,2,9,14,15,0,0,0,53
1,12,2,9,14,15,9,19,13,94
1,12,2,9,14,15,19,0,0,72
1,12,2,9,14,15,20,9,3,85
1,12,2,9,14,21,18,9,1,87
1,12,2,9,20,5,0,0,0,49
1,12,2,9,20,5,19,0,0,68
1,12,2,9,20,9,3,0,0,56
1,12,2,9,20,9,3,1,12,69
1,12,2,9,20,9,20,5,0,78
1,12,2,9,26,9,1,0,0,60
1,12,2,9,26,9,1,19,0,79
1,12,2,9,26,26,9,1,19,105
1,12,2,15,3,18,1,3,25,80
1,12,2,15,12,9,20,5,0,76
1,12,2,15,12,9,20,8,0,79
1,12,2,15,18,1,4,1,0,54
1,12,2,15,18,1,11,0,0,60
1,12,2,18,9,3,9,1,19,74
1,12,2,18,15,14,26,5,0,93
1,12,2,19,0,0,0,0,0,34
1,12,2,21,7,9,14,5,1,72
1,12,2,21,7,9,14,5,19,90
1,12,2,21,7,15,0,0,0,58
1,12,2,21,13,0,0,0,0,49
1,12,2,21,13,5,1,14,0,69
1,12,2,21,13,5,14,0,0,68
1,12,2,21,13,5,14,19,0,87
1,12,2,21,13,9,14,0,0,72
1,12,2,21,13,9,14,19,0,91
1,12,2,21,13,15,9,4,0,77
1,12,2,21,13,15,19,5,0,88
1,12,2,21,13,15,19,5,19,107
1,12,2,21,13,19,0,0,0,68
1,12,2,21,18,14,0,0,0,68
1,12,2,21,18,14,15,21,19,123
1,12,2,21,18,14,21,13,0,102
1,12,2,21,18,14,21,13,19,121
1,12,2,21,19,0,0,0,0,55
1,12,3,1,2,1,12,1,0,33
1,12,3,1,4,5,0,0,0,26
1,12,3,1,4,5,19,0,0,45
1,12,3,1,8,5,19,20,0,69
1,12,3,1,8,5,19,20,19,88
1,12,3,1,9,4,0,0,0,30
1,12,3,1,9,4,5,0,0,35
1,12,3,1,25,4,5,0,0,51
1,12,3,1,9,4,5,19,0,54
1,12,3,1,25,4,5,19,0,70
1,12,3,1,12,4,5,19,0,57
1,12,3,1,12,4,9,1,0,43
1,12,3,1,12,9,0,0,0,38
1,12,3,1,13,9,14,5,0,58
1,12,3,1,14,14,1,0,0,46
1,12,3,1,16,20,15,14,0,82
1,12,3,1,18,7,5,14,0,61
1,12,3,1,18,18,1,26,1,81
1,12,3,1,20,18,1,19,0,75
1,12,3,1,22,1,12,1,0,53
1,12,3,1,26,1,2,1,0,47
1,12,3,1,26,1,18,19,0,81
1,12,3,1,26,1,22,1,0,67
1,12,3,5,0,0,0,0,0,21
1,12,3,8,5,13,0,0,0,42
1,12,3,8,5,13,25,0,0,67
1,12,3,8,5,13,9,3,0,54
1,12,3,8,5,13,9,5,19,75
1,12,3,8,5,13,9,19,5,75
1,12,3,8,5,13,9,19,20,90
1,12,3,8,5,13,9,26,5,82
1,12,3,8,5,18,1,0,0,48
1,12,3,8,9,13,25,0,0,71
1,12,3,8,25,13,25,0,0,87
1,12,3,8,25,13,9,5,19,95
1,12,3,8,9,20,18,1,14,86
1,12,3,9,4,0,0,0,0,29
1,12,3,9,4,9,14,5,0,57
1,12,3,9,4,19,0,0,0,48
1,12,3,25,15,14,0,0,0,70
1,12,3,25,15,14,9,3,0,82
1,12,3,25,15,14,15,9,4,98
1,12,3,12,1,4,0,0,0,33
1,12,3,15,1,20,5,0,0,57
1,12,3,15,7,5,12,0,0,55
1,12,3,15,7,5,14,5,0,62
1,12,3,15,8,1,20,5,0,65
1,12,3,15,8,15,12,0,0,66
1,12,3,15,8,15,12,9,3,78
1,12,3,15,8,15,12,19,0,85
1,12,3,15,14,4,5,0,0,54
1,12,3,15,18,14,15,3,15,96
1,12,3,15,19,15,12,0,0,77
1,12,3,15,22,5,0,0,0,58
1,12,3,15,22,5,4,0,0,62
1,12,3,15,22,5,19,0,0,77
1,12,3,21,13,25,0,0,0,75
1,12,4,1,25,0,0,0,0,43
1,12,4,1,13,9,14,0,0,54
1,12,4,1,13,9,14,5,0,59
1,12,4,1,14,5,0,0,0,37
1,12,4,1,26,9,14,0,0,67
1,12,4,1,26,9,14,5,0,72
1,12,4,5,1,0,0,0,0,23
1,12,4,5,1,13,5,14,20,75
1,12,4,5,8,25,4,5,0,64
1,12,4,5,8,25,4,5,19,83
1,12,4,5,8,25,4,9,3,71
1,12,4,5,8,15,12,0,0,57
1,12,4,5,9,1,0,0,0,32
1,12,4,5,18,6,12,25,0,83
1,12,4,5,18,12,9,14,7,82
1,12,4,5,18,13,5,14,0,72
1,12,4,5,18,14,0,0,0,54
1,12,4,5,18,19,0,0,0,59
1,12,4,9,4,5,0,0,0,35
1,12,4,9,13,0,0,0,0,39
1,12,4,9,13,5,0,0,0,44
1,12,4,9,13,9,14,0,0,62
1,12,4,9,13,9,14,5,0,67
1,12,4,9,20,15,12,0,0,73
1,12,4,15,12,0,0,0,0,44
1,12,4,15,12,1,19,5,0,69
1,12,4,15,12,1,19,5,19,88
1,12,4,15,12,9,26,5,0,84
1,12,4,15,12,9,26,5,4,88
1,12,4,15,12,19,0,0,0,63
1,12,4,15,19,5,0,0,0,56
1,12,4,15,19,5,19,0,0,75
1,12,4,15,19,9,4,5,0,69
1,12,4,15,22,1,14,4,9,82
1,12,4,15,24,9,13,5,0,83
1,12,4,18,9,14,19,0,0,77
1,12,5,0,0,0,0,0,0,18
1,12,5,1,11,0,0,0,0,30
1,12,5,1,20,15,18,25,0,97
1,12,5,1,20,15,18,9,3,84
1,12,5,2,5,14,3,8,0,50
1,12,5,2,5,18,18,25,0,86
1,12,5,2,21,19,8,0,0,68
1,12,5,3,9,20,8,1,12,71
1,12,5,3,9,20,8,9,3,70
1,12,5,3,9,26,5,0,0,61
1,12,5,3,15,14,14,5,18,87
1,12,5,3,15,19,20,0,0,75
1,12,5,3,19,0,0,0,0,40
1,12,5,3,21,16,0,0,0,58
1,12,5,5,0,0,0,0,0,23
1,12,5,6,0,0,0,0,0,24
1,12,5,6,14,21,12,12,0,83
1,12,5,6,19,0,0,0,0,43
1,12,5,6,20,0,0,0,0,44
1,12,5,6,26,5,18,15,0,88
1,12,5,7,1,18,0,0,0,44
1,12,5,7,1,18,19,0,0,63
1,12,5,7,5,18,0,0,0,48
1,12,5,8,15,15,6,0,0,62
1,12,5,8,15,21,19,5,0,86
1,12,5,8,15,21,19,5,19,105
1,12,5,25,1,18,4,0,0,66
1,12,5,9,11,15,21,13,0,87
1,12,5,9,11,21,13,0,0,72
1,12,5,9,16,20,5,19,0,87
1,12,5,9,16,20,9,3,0,75
1,12,5,25,18,15,4,9,4,93
1,12,5,11,14,9,7,8,20,87
1,12,5,13,1,14,1,0,0,47
1,12,5,13,2,9,3,0,0,45
1,12,5,13,2,9,3,19,0,64
1,12,5,13,2,18,15,20,8,94
1,12,5,13,13,1,12,0,0,57
1,12,5,13,15,14,7,5,18,90
1,12,5,14,0,0,0,0,0,32
1,12,5,14,3,15,14,19,0,83
1,12,5,14,7,5,0,0,0,44
1,12,5,14,7,20,8,0,0,67
1,12,5,14,20,15,21,18,19,125
1,12,5,14,21,0,0,0,0,53
1,12,5,16,8,0,0,0,0,42
1,12,5,16,8,19,0,0,0,61
1,12,5,16,8,26,5,18,15,106
1,12,5,16,9,4,15,20,5,87
1,12,5,16,9,14,5,0,0,62
1,12,5,16,15,12,5,0,0,66
1,12,5,16,15,20,0,0,0,69
1,12,5,18,3,5,0,0,0,44
1,12,5,18,9,15,14,0,0,74
1,12,5,18,19,5,0,0,0,60
1,12,5,18,20,0,0,0,0,56
1,12,5,18,20,1,0,0,0,57
1,12,5,18,20,5,4,0,0,65
1,12,5,18,20,5,4,12,25,102
1,12,5,18,20,5,18,0,0,79
1,12,5,18,20,5,18,19,0,98
1,12,5,18,20,5,19,20,0,100
1,12,5,18,20,9,14,7,0,86
1,12,5,18,20,12,25,0,0,93
1,12,5,18,20,14,5,19,19,113
1,12,5,18,20,19,0,0,0,75
1,12,5,19,0,0,0,0,0,37
1,12,5,19,1,14,0,0,0,52
1,12,5,19,8,15,20,0,0,80
1,12,5,19,20,1,11,5,0,74
1,12,5,20,1,16,0,0,0,55
1,12,5,20,1,19,20,5,18,101
1,12,5,20,8,9,3,0,0,58
1,12,5,20,15,3,25,20,5,106
1,12,5,21,3,5,13,9,3,72
1,12,5,21,11,5,13,9,3,80
1,12,5,21,18,9,20,9,3,98
1,12,5,21,18,15,14,0,0,86
1,12,5,21,18,15,14,1,20,107
1,12,5,21,18,15,14,5,0,91
1,12,5,21,18,15,14,5,19,110
1,12,5,21,18,15,14,9,3,98
1,12,5,21,18,15,14,19,0,105
1,12,5,21,20,9,20,5,0,93
1,12,5,22,9,14,0,0,0,63
1,12,5,22,9,14,19,0,0,82
1,12,5,23,0,0,0,0,0,41
1,12,5,23,8,1,16,0,0,66
1,12,5,23,9,6,5,0,0,61
1,12,5,23,9,22,5,19,0,96
1,12,5,24,9,1,19,0,0,71
1,12,5,24,9,3,0,0,0,54
1,12,5,24,9,14,0,0,0,65
1,12,5,24,9,14,5,19,0,89
1,12,5,24,9,14,9,3,0,77
1,12,5,24,9,14,19,0,0,84
1,12,5,26,1,14,0,0,0,59
1,12,6,1,10,5,0,0,0,35
1,12,6,1,11,9,0,0,0,40
1,12,6,1,11,9,19,0,0,59
1,12,6,1,12,6,1,0,0,39
1,12,6,1,12,6,1,19,0,58
1,12,6,1,17,21,9,0,0,67
1,12,6,1,17,21,9,14,0,81
1,12,6,1,17,21,9,14,19,100
1,12,6,1,17,21,9,19,0,86
1,12,6,1,18,7,1,0,0,46
1,12,6,1,19,0,0,0,0,39
1,12,6,5,14,9,4,5,0,56
1,12,6,5,18,5,19,0,0,66
1,12,6,5,18,5,26,0,0,73
1,12,6,5,20,0,0,0,0,44
1,12,6,9,12,1,18,9,1,69
1,12,6,9,12,5,18,9,1,73
1,12,6,9,14,0,0,0,0,42
1,12,6,9,15,14,1,0,0,58
1,12,6,9,15,14,5,0,0,62
1,12,6,15,14,3,9,14,15,89
1,12,6,15,14,19,9,14,0,90
1,12,6,15,18,7,5,0,0,64
1,12,6,15,18,10,1,0,0,63
1,12,6,15,18,10,1,19,0,82
1,12,6,18,5,19,3,15,0,79
1,12,6,18,9,4,1,18,25,94
1,12,7,1,0,0,0,0,0,21
1,12,7,1,5,0,0,0,0,26
1,12,7,1,5,3,9,4,5,47
1,12,7,1,12,0,0,0,0,33
1,12,7,1,12,9,1,0,0,43
1,12,7,1,18,1,4,0,0,44
1,12,7,1,18,4,5,0,0,48
1,12,7,1,18,15,2,1,0,57
1,12,7,1,18,15,2,1,19,76
1,12,7,1,18,15,20,0,0,74
1,12,7,1,18,18,15,2,1,75
1,12,7,1,19,0,0,0,0,40
1,12,7,1,20,5,0,0,0,46
1,12,7,1,20,5,19,0,0,65
1,12,7,1,26,5,12,0,0,64
1,12,7,5,2,18,1,0,0,46
1,12,7,5,2,18,1,9,3,58
1,12,7,5,2,18,1,19,0,65
1,12,7,5,4,15,0,0,0,44
1,12,7,5,4,15,14,9,3,70
1,12,7,5,18,9,1,14,19,86
1,12,7,5,18,9,14,5,19,90
1,12,7,5,18,9,20,1,0,73
1,12,7,5,18,9,20,5,0,77
1,12,7,5,19,9,1,0,0,54
1,12,7,5,19,9,3,0,0,56
1,12,7,5,19,9,19,0,0,72
1,12,7,5,20,9,3,0,0,57
1,12,7,9,1,0,0,0,0,30
1,12,7,9,3,9,4,1,12,58
1,12,7,9,3,9,4,5,0,50
1,12,7,9,3,9,4,5,19,69
1,12,7,9,4,0,0,0,0,33
1,12,7,9,4,9,20,25,0,87
1,12,7,9,4,14,5,19,19,90
1,12,7,9,6,9,3,0,0,47
1,12,7,9,14,0,0,0,0,43
1,12,7,9,14,1,20,5,0,69
1,12,7,9,14,1,20,5,19,88
1,12,7,9,14,5,0,0,0,48
1,12,7,9,14,9,3,0,0,55
1,12,7,9,14,19,0,0,0,62
1,12,7,9,19,20,0,0,0,68
1,12,7,15,3,25,1,14,0,78
1,12,7,15,4,15,14,0,0,68
1,12,7,15,7,5,14,9,3,73
1,12,7,15,9,4,0,0,0,48
1,12,7,15,12,1,7,14,25,94
1,12,7,15,12,15,7,25,0,94
1,12,7,15,13,5,20,5,18,96
1,12,7,15,13,5,20,18,25,116
1,12,7,15,18,0,0,0,0,53
1,12,7,15,18,9,19,13,0,94
1,12,7,15,18,9,19,13,19,113
1,12,7,15,18,9,19,20,0,101
1,12,7,15,18,9,20,8,13,103
1,12,7,15,18,19,0,0,0,72
1,12,7,15,19,9,19,0,0,82
1,12,7,15,21,19,0,0,0,75
1,12,7,15,22,9,20,5,0,91
1,12,7,18,1,16,8,25,0,88
1,12,7,18,1,16,8,9,3,75
1,12,7,21,1,3,9,12,0,66
1,12,7,21,1,26,9,12,0,89
1,12,7,21,9,6,15,21,0,92
1,12,7,21,13,0,0,0,0,54
1,12,7,21,13,19,0,0,0,73
1,12,8,1,3,5,14,1,0,45
1,12,8,1,14,4,1,12,0,53
1,12,8,5,14,14,1,0,0,55
1,12,8,5,20,0,0,0,0,46
1,12,25,0,0,0,0,0,0,38
1,12,9,1,13,5,14,20,1,76
1,12,9,1,19,0,0,0,0,42
1,12,9,1,19,5,4,0,0,51
1,12,9,1,19,5,19,0,0,66
1,12,9,1,19,9,14,7,0,72
1,12,9,2,9,0,0,0,0,33
1,12,9,2,9,5,4,0,0,42
1,12,9,2,9,5,19,0,0,57
1,12,9,2,9,9,14,7,0,63
1,12,9,2,9,12,9,20,25,99
1,12,9,2,9,19,0,0,0,52
1,12,9,2,12,5,0,0,0,41
1,12,9,3,8,5,12,0,0,50
1,12,9,3,25,3,12,9,3,77
1,12,9,3,15,3,8,5,0,56
1,12,9,3,20,9,19,1,12,86
1,12,9,3,21,12,1,0,0,59
1,12,9,3,21,12,1,5,0,64
1,12,9,4,1,4,0,0,0,31
1,12,9,4,1,4,1,0,0,32
1,12,9,4,1,4,5,0,0,36
1,12,9,4,1,4,5,19,0,55
1,12,9,4,1,4,19,0,0,50
1,12,9,5,14,0,0,0,0,41
1,12,9,5,14,1,2,12,5,61
1,12,9,5,14,1,7,5,0,54
1,12,9,5,14,1,7,5,19,73
1,12,9,5,14,1,20,5,0,67
1,12,9,5,14,1,20,5,4,71
1,12,9,5,14,1,20,5,19,86
1,12,9,5,14,1,20,15,18,95
1,12,9,5,14,3,25,0,0,69
1,12,9,5,14,5,0,0,0,46
1,12,9,5,14,5,4,0,0,50
1,12,9,5,14,5,5,0,0,51
1,12,9,5,14,5,5,19,0,70
1,12,9,5,14,5,18,0,0,64
1,12,9,5,14,5,18,19,0,83
1,12,9,5,14,9,14,7,0,71
1,12,9,5,14,9,19,13,0,82
1,12,9,5,14,9,19,13,19,101
1,12,9,5,14,9,19,20,0,89
1,12,9,5,14,9,19,20,19,108
1,12,9,5,14,9,26,5,0,81
1,12,9,5,14,12,25,0,0,78
1,12,9,5,14,14,5,19,19,98
1,12,9,5,14,15,18,0,0,74
1,12,9,5,14,15,18,19,0,93
1,12,9,5,14,19,0,0,0,60
1,12,9,5,14,19,8,9,16,93
1,12,9,5,20,0,0,0,0,47
1,12,9,6,0,0,0,0,0,28
1,12,9,6,5,0,0,0,0,33
1,12,9,6,5,18,15,21,19,106
1,12,9,6,15,18,13,0,0,74
1,12,9,6,19,0,0,0,0,47
1,12,9,7,5,18,15,21,19,107
1,12,9,7,8,20,0,0,0,57
1,12,9,7,8,20,5,4,0,66
1,12,9,7,8,20,5,14,0,76
1,12,9,7,8,20,9,14,7,87
1,12,9,7,8,20,19,0,0,76
1,12,9,7,14,0,0,0,0,43
1,12,9,7,14,5,4,0,0,52
1,12,9,7,14,5,18,0,0,66
1,12,9,7,14,5,18,19,0,85
1,12,9,7,14,9,14,7,0,73
1,12,9,7,14,13,5,14,20,95
1,12,9,7,14,19,0,0,0,62
1,12,9,7,18,5,5,11,0,68
1,12,9,9,0,0,0,0,0,31
1,12,9,25,1,0,0,0,0,48
1,12,9,25,1,8,0,0,0,56
1,12,9,25,1,8,19,0,0,75
1,12,9,25,1,19,0,0,0,67
1,12,9,25,15,19,0,0,0,81
1,12,9,25,15,20,0,0,0,82
1,12,9,25,15,20,8,0,0,90
1,12,9,9,16,15,5,0,0,67
1,12,9,11,5,0,0,0,0,38
1,12,9,11,5,14,5,19,19,95
1,12,9,11,5,23,9,19,5,94
1,12,9,12,15,14,7,8,9,87
1,12,9,13,1,0,0,0,0,36
1,12,9,13,5,14,20,0,0,74
1,12,9,13,5,14,20,1,12,87
1,12,9,13,5,14,20,5,4,83
1,12,9,13,5,14,20,5,18,97
1,12,9,13,5,14,20,9,3,86
1,12,9,13,5,14,20,19,0,93
1,12,9,13,5,14,20,21,13,108
1,12,9,13,15,14,25,0,0,89
1,12,9,13,15,14,9,5,4,82
1,12,9,13,15,14,9,5,19,97
1,12,25,13,16,8,9,1,0,85
1,12,9,14,0,0,0,0,0,36
1,12,9,14,1,19,1,12,0,69
1,12,9,14,5,4,0,0,0,45
1,12,9,14,5,13,5,14,20,93
1,12,9,14,5,18,0,0,0,59
1,12,9,14,5,18,19,0,0,78
1,12,9,14,5,19,0,0,0,60
1,12,9,14,7,21,1,12,0,77
1,12,9,14,9,14,7,0,0,66
1,12,9,14,9,20,0,0,0,65
1,12,9,14,15,20,1,0,0,72
1,12,9,14,15,20,21,13,0,105
1,12,9,14,20,1,20,1,15,93
1,12,9,15,6,1,18,0,0,62
1,12,9,16,1,20,1,0,0,60
1,12,9,16,5,4,0,0,0,47
1,12,9,16,5,4,19,0,0,66
1,12,9,16,8,1,20,9,3,79
1,12,9,16,9,14,0,0,0,61
1,12,25,16,9,14,0,0,0,77
1,12,25,16,9,14,5,0,0,82
1,12,9,16,20,1,5,0,0,64
1,12,9,16,20,5,18,9,1,91
1,12,9,16,20,5,19,0,0,82
1,12,9,16,20,9,3,0,0,70
1,12,25,16,21,13,0,0,0,88
1,12,9,17,21,1,14,20,0,95
1,12,9,17,21,9,4,0,0,73
1,12,9,17,21,15,20,0,0,95
1,12,9,17,21,15,20,19,0,114
1,12,9,19,5,16,20,1,12,95
1,12,9,19,8,0,0,0,0,49
1,12,9,19,9,5,18,0,0,73
1,12,9,19,13,1,4,0,0,59
1,12,9,19,13,1,12,0,0,67
1,12,9,19,13,15,9,4,0,82
1,12,9,19,15,0,0,0,0,56
1,12,9,19,15,14,9,20,5,104
1,12,9,19,15,19,0,0,0,75
1,12,9,19,16,0,0,0,0,57
1,12,9,19,16,8,5,14,15,99
1,12,25,19,19,15,14,0,0,105
1,12,25,19,19,21,13,19,0,129
1,12,9,19,20,0,0,0,0,61
1,12,25,20,1,18,3,8,0,88
1,12,9,20,5,0,0,0,0,47
1,12,9,20,5,18,0,0,0,65
1,12,9,20,25,0,0,0,0,67
1,12,9,20,18,21,14,11,0,106
1,12,9,20,21,18,7,9,3,100
1,12,9,21,14,4,5,0,0,66
1,12,9,22,5,0,0,0,0,49
1,12,9,22,5,14,5,19,19,106
1,12,9,22,5,19,0,0,0,68
1,12,9,26,1,18,1,20,5,93
1,12,9,26,1,18,9,0,0,76
1,12,9,26,1,18,9,14,0,90
1,12,9,26,1,18,9,14,5,95
1,12,9,26,1,18,9,14,19,109
1,12,10,1,13,1,0,0,0,38
1,12,10,1,13,1,4,15,0,57
1,12,10,1,13,9,1,0,0,47
1,12,10,1,13,9,1,4,15,66
1,12,10,1,13,9,1,8,0,55
1,12,10,15,2,1,0,0,0,41
1,12,10,15,6,1,9,14,1,69
1,12,11,0,0,0,0,0,0,24
1,12,11,1,8,5,19,20,0,77
1,12,11,1,8,5,19,20,19,96
1,12,11,1,12,5,13,9,1,65
1,12,11,1,12,9,0,0,0,46
1,12,11,1,12,9,3,0,0,49
1,12,11,1,12,9,5,19,0,70
1,12,11,1,12,9,6,25,0,77
1,12,11,1,12,9,7,5,14,72
1,12,11,1,12,9,14,0,0,60
1,12,11,1,12,9,14,5,0,65
1,12,11,1,12,9,19,0,0,65
1,12,11,1,12,9,19,5,0,70
1,12,11,1,12,9,19,5,4,74
1,12,11,1,12,9,19,5,18,88
1,12,11,1,12,9,19,5,19,89
1,12,11,1,12,9,26,5,0,77
1,12,11,1,12,9,26,5,4,81
1,12,11,1,12,9,26,5,18,95
1,12,11,1,12,9,26,5,19,96
1,12,11,1,12,15,9,4,0,65
1,12,11,1,12,15,9,4,19,84
1,12,11,1,12,15,19,9,19,99
1,12,11,1,12,15,21,19,0,92
1,12,11,1,13,9,14,0,0,61
1,12,11,1,13,9,14,5,0,66
1,12,11,1,14,1,12,0,0,52
1,12,11,1,14,5,0,0,0,44
1,12,11,1,14,5,19,0,0,63
1,12,11,1,14,5,20,0,0,64
1,12,11,1,14,5,20,19,0,83
1,12,11,1,14,14,9,14,0,76
1,12,11,1,14,15,12,0,0,66
1,12,11,1,16,20,15,14,0,90
1,12,11,1,16,20,15,14,5,95
1,12,11,1,18,7,5,14,0,69
1,12,11,1,18,19,9,14,0,85
1,12,11,1,18,19,9,14,5,90
1,12,11,5,4,1,22,25,0,81
1,12,11,5,11,5,14,7,9,75
1,12,11,5,14,5,0,0,0,48
1,12,11,5,14,5,19,0,0,67
1,12,11,5,14,25,12,0,0,80
1,12,11,5,14,14,1,0,0,58
1,12,11,5,18,13,5,19,0,84
1,12,11,25,0,0,0,0,0,49
1,12,11,25,4,0,0,0,0,53
1,12,11,9,4,5,0,0,0,42
1,12,11,25,4,19,0,0,0,72
1,12,11,9,5,19,0,0,0,57
1,12,11,25,12,0,0,0,0,61
1,12,11,25,12,1,20,5,0,87
1,12,11,25,12,1,20,5,4,91
1,12,11,25,12,1,20,5,19,106
1,12,11,25,12,5,14,5,0,85
1,12,11,25,12,9,3,0,0,73
1,12,11,25,12,9,26,5,0,101
1,12,11,25,12,15,7,5,14,102
1,12,11,25,12,15,12,0,0,88
1,12,11,25,12,15,24,25,0,125
1,12,11,25,12,19,0,0,0,80
1,12,11,9,14,0,0,0,0,47
1,12,11,9,14,5,0,0,0,52
1,12,11,25,14,5,0,0,0,68
1,12,11,9,14,5,19,0,0,71
1,12,11,25,14,5,19,0,0,87
1,12,11,9,20,18,1,14,0,86
1,12,11,15,15,12,0,0,0,66
1,12,11,15,24,25,0,0,0,88
1,12,11,15,24,9,4,0,0,76
1,12,11,15,24,9,4,5,0,81
1,12,11,15,24,25,12,0,0,100
1,12,12,0,0,0,0,0,0,25
1,12,12,1,2,21,20,1,0,70
1,12,12,1,3,20,9,20,5,83
1,12,12,1,7,9,20,5,0,67
1,12,12,1,25,0,0,0,0,51
1,12,12,1,25,5,4,0,0,60
1,12,12,1,25,5,18,0,0,74
1,12,12,1,25,5,18,19,0,93
1,12,12,1,25,9,14,7,0,81
1,12,12,1,25,13,5,14,20,103
1,12,12,1,25,19,0,0,0,70
1,12,12,1,13,15,14,20,9,97
1,12,12,1,13,15,20,8,0,82
1,12,12,1,13,15,20,20,9,103
1,12,12,1,14,9,20,5,0,74
1,12,12,1,14,9,20,5,19,93
1,12,12,1,14,9,20,9,3,81
1,12,12,1,14,20,15,9,3,87
1,12,12,1,14,20,15,9,4,88
1,12,12,1,14,20,15,9,14,98
1,12,12,1,14,20,15,9,19,103
1,12,12,1,20,9,22,5,0,82
1,12,12,1,20,18,1,20,5,90
1,12,12,2,15,14,5,0,0,61
1,12,12,5,3,18,5,20,0,76
1,12,12,5,3,20,0,0,0,53
1,12,12,5,3,20,15,18,25,111
1,12,12,5,7,1,20,1,0,59
1,12,12,5,7,1,20,5,0,63
1,12,12,5,7,1,20,15,18,91
1,12,12,5,7,1,20,21,13,92
1,12,12,5,7,5,0,0,0,42
1,12,12,5,7,5,4,0,0,46
1,12,12,5,7,5,4,12,25,83
1,12,12,5,7,5,18,0,0,60
1,12,12,5,7,5,18,19,0,79
1,12,12,5,7,5,19,0,0,61
1,12,12,5,7,9,1,14,20,81
1,12,12,5,7,9,1,18,5,70
1,12,12,5,7,9,14,7,0,67
1,12,12,5,7,15,18,25,0,95
1,12,12,5,7,15,18,9,3,82
1,12,12,5,7,18,15,0,0,70
1,12,12,5,7,18,15,19,0,89
1,12,12,5,25,5,4,0,0,64
1,12,12,5,25,9,20,5,0,89
1,12,12,5,25,19,0,0,0,74
1,12,12,5,25,23,1,25,0,104
1,12,12,5,25,23,1,25,19,123
1,12,12,5,12,5,0,0,0,47
1,12,12,5,12,5,19,0,0,66
1,12,12,5,12,5,21,0,0,68
1,12,12,5,12,9,3,0,0,54
1,12,12,5,12,9,19,13,0,83
1,12,12,5,12,9,19,13,19,102
1,12,12,5,12,21,9,1,8,81
1,12,12,5,12,21,9,1,19,92
1,12,12,5,12,21,10,1,0,74
1,12,12,5,12,22,9,1,0,74
1,12,12,5,13,1,14,4,0,62
1,12,12,5,13,1,14,4,5,67
1,12,12,5,13,1,14,4,19,81
1,12,12,5,14,1,18,12,25,100
1,12,12,5,14,9,1,20,5,79
1,12,12,5,14,20,1,20,15,100
1,12,12,5,18,0,0,0,0,48
1,12,12,5,18,7,5,14,0,74
1,12,12,5,18,7,5,14,19,93
1,12,12,5,18,7,25,0,0,80
1,12,12,5,18,7,9,1,0,65
1,12,12,5,18,7,9,3,0,67
1,12,12,5,18,7,9,5,19,88
1,12,12,5,18,7,9,14,0,78
1,12,12,5,18,7,9,14,19,97
1,12,12,5,18,7,9,19,20,103
1,12,12,5,18,9,15,14,0,86
1,12,12,5,20,8,18,9,14,99
1,12,12,5,22,5,0,0,0,57
1,12,12,5,22,9,1,14,20,96
1,12,12,5,22,9,1,20,5,87
1,12,12,5,26,0,0,0,0,56
1,12,12,7,15,22,9,20,5,103
1,12,12,8,5,1,12,0,0,51
1,12,12,8,5,1,12,19,0,70
1,12,12,25,0,0,0,0,0,50
1,12,12,9,1,2,12,5,0,54
1,12,12,9,1,2,12,25,0,74
1,12,12,9,1,7,5,0,0,47
1,12,12,9,1,14,3,5,4,61
1,12,12,9,1,14,3,5,18,75
1,12,12,9,1,14,3,5,19,76
1,12,12,9,1,14,20,0,0,69
1,12,12,9,3,5,0,0,0,42
1,12,12,9,3,9,5,14,20,85
1,12,12,9,3,9,14,0,0,60
1,12,12,9,3,9,14,19,0,79
1,12,12,9,3,9,20,0,0,66
1,12,12,9,7,1,20,5,0,67
1,12,12,9,7,1,20,5,4,71
1,12,12,9,7,1,20,15,18,95
1,12,12,25,9,3,0,0,0,62
1,12,12,25,9,14,7,0,0,80
1,12,12,25,12,0,0,0,0,62
1,12,12,25,12,1,20,5,0,88
1,12,12,25,12,5,14,5,0,86
1,12,12,25,12,9,3,0,0,74
1,12,12,25,12,19,0,0,0,81
1,12,12,9,14,5,1,20,5,79
1,12,12,25,15,21,0,0,0,86
1,12,12,9,19,9,15,14,0,91
1,12,12,9,20,5,18,1,12,90
1,12,12,9,20,21,18,9,3,105
1,12,12,9,21,13,19,0,0,87
1,12,12,13,15,21,20,8,0,102
1,12,12,13,15,21,20,8,19,121
1,12,12,14,5,19,19,0,0,82
1,12,12,15,0,0,0,0,0,40
1,12,12,15,2,1,18,0,0,61
1,12,12,15,2,1,18,9,3,73
1,12,12,15,2,1,18,19,0,80
1,12,12,15,3,1,2,12,5,63
1,12,12,15,3,1,20,5,0,69
1,12,12,15,3,1,20,5,4,73
1,12,12,15,3,1,20,5,5,74
1,12,12,15,3,1,20,5,19,88
1,12,12,15,3,1,20,15,18,97
1,12,12,15,3,1,20,21,18,103
1,12,12,15,3,12,1,19,5,80
1,12,12,15,3,21,20,5,0,89
1,12,12,15,4,0,0,0,0,44
1,12,12,15,4,7,5,0,0,56
1,12,12,15,4,25,0,0,0,69
1,12,12,15,4,9,1,0,0,54
1,12,12,15,4,9,1,12,0,66
1,12,12,15,4,9,1,14,0,68
1,12,12,15,4,9,1,18,25,97
1,12,12,15,4,9,5,19,0,77
1,12,12,15,4,9,21,13,0,87
1,12,12,15,4,19,0,0,0,63
1,12,12,15,5,15,19,9,19,107
1,12,12,15,5,15,20,9,3,92
1,12,12,15,7,1,13,25,0,86
1,12,12,15,7,5,14,5,0,71
1,12,12,15,7,5,14,9,3,78
1,12,12,15,7,18,1,6,20,92
1,12,12,15,7,18,1,16,8,90
1,12,12,15,25,0,0,0,0,65
1,12,12,15,25,1,7,5,0,78
1,12,12,15,25,5,4,0,0,74
1,12,12,15,25,9,14,7,0,95
1,12,12,15,25,19,0,0,0,84
1,12,12,15,12,1,12,9,1,75
1,12,12,15,12,1,12,9,3,77
1,12,12,15,13,5,20,18,25,121
1,12,12,15,13,15,18,16,8,110
1,12,12,15,13,21,3,9,3,89
1,12,12,15,14,7,5,0,0,66
1,12,12,15,14,7,5,19,0,85
1,12,12,15,14,25,13,0,0,92
1,12,12,15,14,25,13,19,0,111
1,12,12,15,15,0,0,0,0,55
1,12,12,15,16,1,20,8,0,85
1,12,12,15,16,1,20,8,25,110
1,12,12,15,16,1,20,8,19,104
1,12,12,15,16,1,20,18,25,120
1,12,12,15,16,8,1,14,5,84
1,12,12,15,16,8,25,12,5,106
1,12,12,15,16,8,9,20,5,98
1,12,12,15,16,8,15,14,5,98
1,12,12,15,16,8,15,18,5,102
1,12,12,15,16,12,1,19,13,101
1,12,12,15,16,12,1,19,20,108
1,12,12,15,17,21,25,0,0,103
1,12,12,15,17,21,9,1,12,100
1,12,12,15,19,1,21,18,0,99
1,12,12,15,19,5,0,0,0,64
1,12,12,15,19,15,13,5,0,92
1,12,12,15,20,0,0,0,0,60
1,12,12,15,20,5,4,0,0,69
1,12,12,15,20,5,5,0,0,70
1,12,12,15,20,25,16,5,0,106
1,12,12,15,20,25,16,5,19,125
1,12,12,15,20,25,16,25,0,126
1,12,12,15,20,25,16,9,3,113
1,12,12,15,20,13,5,14,20,112
1,12,12,15,20,18,15,16,5,114
1,12,12,15,20,18,15,16,25,134
1,12,12,15,20,19,0,0,0,79
1,12,12,15,20,20,5,4,0,89
1,12,12,15,20,20,5,5,0,90
1,12,12,15,20,20,5,5,19,109
1,12,12,15,20,20,5,18,0,103
1,12,12,15,20,20,5,18,25,128
1,12,12,15,20,20,5,18,19,122
1,12,12,15,20,20,9,14,7,110
1,12,12,15,22,5,18,0,0,85
1,12,12,15,22,5,18,19,0,104
1,12,12,15,23,0,0,0,0,63
1,12,12,15,23,1,2,12,5,83
1,12,12,15,23,1,2,12,25,103
1,12,12,15,23,1,14,3,5,86
1,12,12,15,23,5,4,0,0,72
1,12,12,15,23,5,4,12,25,109
1,12,12,15,23,5,18,0,0,86
1,12,12,15,23,9,14,7,0,93
1,12,12,15,23,19,0,0,0,82
1,12,12,15,24,1,14,0,0,79
1,12,12,15,24,1,14,9,3,91
1,12,12,15,24,1,14,19,0,98
1,12,12,15,24,25,0,0,0,89
1,12,12,15,24,21,18,9,3,115
1,12,12,15,26,15,15,9,4,109
1,12,12,18,15,21,14,4,0,97
1,12,12,19,0,0,0,0,0,44
1,12,12,19,5,5,4,0,0,58
1,12,12,19,5,5,4,19,0,77
1,12,12,19,16,9,3,5,0,77
1,12,12,19,16,9,3,5,19,96
1,12,12,20,8,9,14,7,0,83
1,12,12,20,8,15,18,14,0,100
1,12,12,20,21,4,0,0,0,70
1,12,12,21,4,5,0,0,0,55
1,12,12,21,4,5,4,0,0,59
1,12,12,21,4,5,19,0,0,74
1,12,12,21,4,9,14,7,0,80
1,12,12,21,13,5,20,20,5,109
1,12,12,21,13,9,14,5,0,87
1,12,12,21,13,9,14,15,18,115
1,12,12,21,18,1,14,3,5,87
1,12,12,21,18,5,0,0,0,69
1,12,12,21,18,5,4,0,0,73
1,12,12,21,18,5,18,0,0,87
1,12,12,21,18,5,18,19,0,106
1,12,12,21,18,5,19,0,0,88
1,12,12,21,18,9,14,7,0,94
1,12,12,21,19,9,15,14,0,103
1,12,12,21,19,9,15,14,19,122
1,12,12,21,19,9,22,5,0,101
1,12,12,21,19,15,18,25,0,123
1,12,12,21,22,9,1,0,0,78
1,12,12,21,22,9,1,12,0,90
1,12,12,21,22,9,1,12,19,109
1,12,12,21,22,9,1,20,5,103
1,12,12,21,22,9,15,0,0,92
1,12,12,21,22,9,15,14,0,106
1,12,12,21,22,9,15,14,19,125
1,12,12,21,22,9,15,21,19,132
1,12,12,21,22,9,21,13,0,111
1,12,12,21,22,9,21,13,19,130
1,12,12,21,22,9,22,9,1,109
1,12,12,23,8,5,18,5,0,84
1,12,12,23,15,18,11,0,0,92
1,12,13,1,3,5,14,0,0,49
1,12,13,1,3,9,7,1,0,47
1,12,13,1,3,9,7,15,0,61
1,12,13,1,4,9,1,0,0,41
1,12,13,1,4,9,5,0,0,45
1,12,13,1,7,5,19,20,19,97
1,12,13,1,7,18,1,0,0,53
1,12,13,1,8,0,0,0,0,35
1,12,13,1,8,19,0,0,0,54
1,12,13,1,9,14,5,0,0,55
1,12,13,1,14,1,3,0,0,45
1,12,13,1,14,1,3,19,0,64
1,12,13,1,14,4,5,18,0,68
1,12,13,1,14,4,9,14,5,73
1,12,13,1,14,4,9,20,5,79
1,12,13,1,14,14,5,18,0,78
1,12,13,1,19,0,0,0,0,46
1,12,13,5,0,0,0,0,0,31
1,12,13,5,8,0,0,0,0,39
1,12,13,5,8,19,0,0,0,58
1,12,13,5,9,4,9,14,1,68
1,12,13,5,13,1,18,0,0,63
1,12,13,5,13,1,18,19,0,82
1,12,13,5,13,15,18,0,0,77
1,12,13,5,14,4,18,15,0,82
1,12,13,5,14,4,18,15,14,96
1,12,13,5,18,25,0,0,0,74
1,12,13,5,18,9,5,19,0,82
1,12,13,5,18,9,9,20,5,92
1,12,13,5,19,0,0,0,0,50
1,12,13,9,3,5,0,0,0,43
1,12,13,9,3,15,18,5,0,76
1,12,13,9,7,8,20,0,0,70
1,12,13,9,17,21,5,0,0,78
1,12,13,9,18,1,8,0,0,62
1,12,13,9,19,20,18,25,0,117
1,12,13,14,5,18,0,0,0,63
1,12,13,14,5,18,19,0,0,82
1,12,13,15,3,18,5,2,5,74
1,12,13,15,7,1,22,1,18,90
1,12,13,15,9,7,14,0,0,71
1,12,13,15,9,14,0,0,0,64
1,12,13,15,14,1,7,5,0,68
1,12,13,15,14,4,25,0,0,84
1,12,13,15,14,4,19,0,0,78
1,12,13,15,14,5,18,0,0,78
1,12,13,15,14,5,18,19,0,97
1,12,13,15,14,9,14,7,0,85
1,12,13,15,14,18,25,0,0,98
1,12,13,15,14,18,9,5,19,106
1,12,13,15,19,5,0,0,0,65
1,12,13,15,19,20,0,0,0,80
1,12,13,15,21,19,0,0,0,81
1,12,13,19,0,0,0,0,0,45
1,12,13,19,4,5,5,4,0,63
1,12,13,19,6,15,12,11,0,89
1,12,13,19,6,21,12,0,0,84
1,12,13,19,7,9,22,5,18,106
1,12,13,19,8,15,21,19,5,113
1,12,13,19,13,1,14,0,0,73
1,12,13,19,13,5,14,0,0,77
1,12,13,19,13,15,14,5,25,117
1,12,13,19,23,15,13,1,14,111
1,12,13,19,23,15,13,5,14,115
1,12,13,21,3,5,0,0,0,55
1,12,13,21,3,5,19,0,0,74
1,12,13,21,4,0,0,0,0,51
1,12,13,21,4,5,0,0,0,56
1,12,13,21,4,5,19,0,0,75
1,12,13,21,4,19,0,0,0,70
1,12,13,21,5,18,26,15,0,111
1,12,13,21,7,0,0,0,0,54
1,12,13,21,7,19,0,0,0,73
1,12,13,21,18,25,0,0,0,90
1,12,13,21,20,5,14,0,0,86
1,12,14,0,0,0,0,0,0,27
1,12,14,1,7,5,0,0,0,40
1,12,14,1,7,5,18,0,0,58
1,12,14,1,20,8,0,0,0,56
1,12,14,5,9,14,0,0,0,55
1,12,14,9,3,15,5,19,0,78
1,12,14,15,9,20,5,0,0,76
1,12,14,21,9,14,0,0,0,71
1,12,15,3,8,9,1,0,0,49
1,12,15,4,0,0,0,0,0,32
1,12,15,4,4,9,1,0,0,46
1,12,15,4,25,0,0,0,0,57
1,12,15,4,9,1,0,0,0,42
1,12,15,4,9,1,12,0,0,54
1,12,15,4,9,1,12,12,25,91
1,12,15,4,9,1,12,20,25,99
1,12,15,4,9,1,14,0,0,56
1,12,15,4,9,1,18,25,0,85
1,12,15,4,9,5,19,0,0,65
1,12,15,4,9,21,13,0,0,75
1,12,15,5,0,0,0,0,0,33
1,12,15,5,4,0,0,0,0,37
1,12,15,5,4,1,18,25,0,81
1,12,15,5,12,9,11,5,0,70
1,12,15,5,13,15,4,9,14,88
1,12,15,5,18,15,15,20,0,101
1,12,15,5,19,0,0,0,0,52
1,12,15,5,19,15,12,0,0,79
1,12,15,5,19,23,15,15,4,109
1,12,15,5,20,9,3,0,0,65
1,12,15,5,20,9,3,1,12,78
1,12,15,5,23,15,15,4,0,90
1,12,15,6,20,0,0,0,0,54
1,12,15,7,25,0,0,0,0,60
1,12,15,7,9,1,0,0,0,45
1,12,15,7,9,3,1,12,0,60
1,12,15,7,9,19,13,0,0,76
1,12,15,8,1,19,0,0,0,56
1,12,15,25,1,21,0,0,0,75
1,12,15,9,4,0,0,0,0,41
1,12,15,9,14,19,0,0,0,70
1,12,15,9,19,9,9,20,5,99
1,12,15,13,1,0,0,0,0,42
1,12,15,13,1,14,3,25,0,84
1,12,15,14,5,0,0,0,0,47
1,12,15,14,5,12,25,0,0,84
1,12,15,14,5,14,5,19,19,104
1,12,15,14,7,0,0,0,0,49
1,12,15,14,7,19,9,4,5,86
1,12,15,14,7,19,20,0,0,88
1,12,15,15,6,0,0,0,0,49
1,12,15,15,6,5,0,0,0,54
1,12,15,15,6,12,25,0,0,86
1,12,15,15,6,14,5,19,19,106
1,12,15,15,19,5,0,0,0,67
1,12,15,16,0,0,0,0,0,44
1,12,15,16,1,20,8,9,3,85
1,12,15,16,5,3,9,1,0,62
1,12,15,16,5,3,9,3,0,64
1,12,15,16,5,3,9,19,20,100
1,12,15,16,5,3,15,9,4,80
1,12,15,16,5,11,1,9,0,70
1,12,15,16,5,11,5,0,0,65
1,12,15,16,8,1,19,0,0,72
1,12,15,18,3,9,14,9,3,84
1,12,15,19,5,0,0,0,0,52
1,12,15,21,1,20,20,5,0,95
1,12,15,21,4,0,0,0,0,53
1,12,15,21,5,20,20,5,19,118
1,12,15,21,20,0,0,0,0,69
1,12,15,23,0,0,0,0,0,51
1,12,15,23,5,0,0,0,0,56
1,12,16,1,3,1,0,0,0,34
1,12,16,1,3,1,19,0,0,53
1,12,16,1,18,7,1,20,1,77
1,12,16,1,19,15,20,5,19,108
1,12,16,5,5,14,0,0,0,53
1,12,16,5,14,7,12,15,23,105
1,12,16,5,14,8,15,18,14,103
1,12,16,5,19,20,18,1,12,104
1,12,16,8,1,2,5,20,0,65
1,12,16,8,1,2,5,20,19,84
1,12,16,8,1,19,0,0,0,57
1,12,16,8,5,14,9,3,0,68
1,12,16,8,25,12,0,0,0,74
1,12,16,8,25,12,19,0,0,93
1,12,16,8,9,14,0,0,0,60
1,12,16,8,25,14,0,0,0,76
1,12,16,8,15,12,0,0,0,64
1,12,16,8,15,14,19,9,14,108
1,12,16,8,15,18,14,0,0,84
1,12,16,8,15,18,14,19,0,103
1,12,16,8,15,19,0,0,0,71
1,12,16,8,15,19,9,19,0,99
1,12,16,9,5,21,0,0,0,64
1,12,16,9,7,5,14,5,0,69
1,12,16,9,14,5,12,25,0,94
1,12,16,9,14,5,18,25,0,100
1,12,16,9,14,5,19,0,0,76
1,12,16,9,14,9,19,13,19,112
1,12,16,9,14,9,19,20,19,119
1,12,16,9,19,20,0,0,0,77
1,12,16,9,19,20,5,0,0,82
1,12,17,21,5,9,18,5,0,88
1,12,17,21,9,5,18,0,0,83
1,12,17,21,9,6,15,21,0,102
1,12,18,1,21,14,0,0,0,67
1,12,18,5,1,4,25,0,0,66
1,12,18,9,7,8,20,0,0,75
1,12,18,9,7,8,20,25,0,100
1,12,18,15,15,20,0,0,0,81
1,12,18,21,14,1,0,0,0,67
1,12,18,21,14,5,0,0,0,71
1,12,19,9,6,9,12,13,0,81
1,12,19,9,11,5,0,0,0,57
1,12,19,9,11,5,19,0,0,76
1,12,19,13,5,11,9,12,12,94
1,12,19,15,15,14,0,0,0,76
1,12,19,20,15,14,9,14,5,109
1,12,19,20,15,14,9,20,5,115
1,12,19,23,5,9,12,12,0,93
1,12,19,23,9,20,8,0,0,92
1,12,20,0,0,0,0,0,0,33
1,12,20,1,9,20,5,0,0,68
1,12,20,1,18,0,0,0,0,52
1,12,20,1,18,1,7,5,0,65
1,12,20,1,18,5,4,0,0,61
1,12,20,1,18,9,19,20,0,100
1,12,20,1,18,12,5,20,0,89
1,12,20,1,18,19,0,0,0,71
1,12,20,1,18,23,9,19,5,108
1,12,20,5,18,0,0,0,0,56
1,12,20,5,18,1,2,12,5,76
1,12,20,5,18,1,2,12,25,96
1,12,20,5,18,1,14,20,0,91
1,12,20,5,18,1,14,20,19,110
1,12,20,5,18,1,20,5,0,82
1,12,20,5,18,3,1,20,5,85
1,12,20,5,18,5,4,0,0,65
1,12,20,5,18,5,18,0,0,79
1,12,20,5,18,5,18,19,0,98
1,12,20,5,18,9,14,7,0,86
1,12,20,5,18,9,20,25,0,110
1,12,20,5,18,9,21,19,0,105
1,12,20,5,18,13,1,14,0,84
1,12,20,5,18,14,0,0,0,70
1,12,20,5,18,14,1,3,25,99
1,12,20,5,18,14,1,14,20,105
1,12,20,5,18,14,1,20,0,91
1,12,20,5,18,14,1,20,5,96
1,12,20,5,18,14,5,0,0,75
1,12,20,5,18,14,9,20,25,124
1,12,20,5,18,14,9,26,5,110
1,12,20,5,18,19,0,0,0,75
1,12,20,5,18,21,13,0,0,90
1,12,20,5,19,19,5,0,0,81
1,12,20,5,26,1,0,0,0,65
1,12,20,5,26,26,1,0,0,91
1,12,20,8,1,5,1,19,0,67
1,12,20,8,1,5,9,14,0,70
1,12,20,8,5,1,19,0,0,66
1,12,20,8,5,9,14,0,0,69
1,12,20,8,5,9,14,5,0,74
1,12,20,8,9,15,14,9,3,91
1,12,20,8,15,0,0,0,0,56
1,12,20,8,15,18,14,0,0,88
1,12,20,8,15,18,14,19,0,107
1,12,20,8,15,21,7,8,0,92
1,12,20,9,6,25,0,0,0,73
1,12,20,9,7,18,1,16,8,92
1,12,20,9,12,9,11,0,0,74
1,12,20,9,13,5,20,5,18,103
1,12,20,9,13,5,20,18,25,123
1,12,20,9,14,0,0,0,0,56
1,12,20,9,14,3,1,18,0,78
1,12,20,9,14,9,14,3,11,93
1,12,20,9,19,3,15,16,5,100
1,12,20,9,19,19,9,13,15,117
1,12,20,9,20,21,4,5,0,92
1,12,20,9,20,21,4,5,19,111
1,12,20,15,0,0,0,0,0,48
1,12,20,15,9,19,20,0,0,96
1,12,20,15,9,19,20,19,0,115
1,12,20,15,13,5,20,5,18,109
1,12,20,15,19,0,0,0,0,67
1,12,20,15,21,14,0,0,0,83
1,12,20,18,9,3,5,19,0,87
1,12,20,18,9,3,9,1,12,85
1,12,20,18,15,19,5,0,0,90
1,12,20,18,21,9,19,13,0,113
1,12,20,18,21,9,19,13,19,132
1,12,20,18,21,9,19,20,0,120
1,12,20,18,21,9,19,20,19,139
1,12,20,19,0,0,0,0,0,52
1,12,20,19,3,8,9,14,0,86
1,12,20,21,13,1,12,0,0,80
1,12,20,21,14,0,0,0,0,68
1,12,20,21,18,5,0,0,0,77
1,12,21,4,5,12,0,0,0,55
1,12,21,4,5,12,19,0,0,74
1,12,21,12,1,0,0,0,0,47
1,12,21,12,1,5,0,0,0,52
1,12,21,12,1,18,0,0,0,65
1,12,21,12,5,20,0,0,0,71
1,12,21,13,0,0,0,0,0,47
1,12,21,13,2,12,15,15,13,104
1,12,21,13,2,18,1,4,15,87
1,12,21,13,5,14,0,0,0,66
1,12,21,13,5,20,9,26,5,112
1,12,21,13,9,1,14,0,0,71
1,12,21,13,9,3,0,0,0,59
1,12,21,13,9,14,0,0,0,70
1,12,21,13,9,14,1,0,0,71
1,12,21,13,9,14,1,19,0,90
1,12,21,13,9,14,1,20,5,96
1,12,21,13,9,14,5,0,0,75
1,12,21,13,9,14,5,19,0,94
1,12,21,13,9,14,9,3,0,82
1,12,21,13,9,14,9,4,5,88
1,12,21,13,9,14,25,12,0,107
1,12,21,13,9,14,9,19,5,103
1,12,21,13,9,14,9,19,8,106
1,12,21,13,9,14,9,20,5,104
1,12,21,13,9,14,9,21,13,113
1,12,21,13,9,14,9,26,5,110
1,12,21,13,9,14,15,19,5,109
1,12,21,13,9,14,15,21,19,125
1,12,21,13,9,14,19,0,0,89
1,12,21,13,9,14,21,13,0,104
1,12,21,13,9,14,21,13,19,123
1,12,21,13,9,19,8,0,0,83
1,12,21,13,9,20,5,0,0,81
1,12,21,13,9,21,13,0,0,90
1,12,21,13,14,1,0,0,0,62
1,12,21,13,14,1,5,0,0,67
1,12,21,13,14,1,12,0,0,74
1,12,21,13,14,9,0,0,0,70
1,12,21,13,14,9,1,20,5,96
1,12,21,13,14,21,19,0,0,101
1,12,21,13,18,15,15,20,0,115
1,12,21,13,18,15,15,20,19,134
1,12,21,13,19,0,0,0,0,66
1,12,21,13,19,20,15,14,5,120
1,12,21,14,9,20,5,0,0,82
1,12,21,14,9,20,5,19,0,101
1,12,21,14,15,7,5,14,0,89
1,12,21,16,1,7,0,0,0,58
1,12,21,18,5,0,0,0,0,57
1,12,21,18,7,9,20,5,0,93
1,12,21,19,8,20,9,20,5,115
1,12,21,20,1,0,0,0,0,55
1,12,22,5,1,18,25,0,0,84
1,12,22,5,1,18,9,5,19,92
1,12,22,5,1,18,9,21,13,102
1,12,22,5,1,20,5,4,0,70
1,12,22,5,12,15,19,0,0,86
1,12,22,5,12,15,26,0,0,93
1,12,22,5,15,12,1,0,0,68
1,12,22,5,15,12,1,5,0,73
1,12,22,5,15,12,1,18,0,86
1,12,22,5,15,12,1,18,25,111
1,12,22,5,15,12,1,18,19,105
1,12,22,5,15,12,1,20,5,93
1,12,22,5,15,12,5,0,0,72
1,12,22,5,15,12,9,0,0,76
1,12,22,5,15,12,9,20,5,101
1,12,22,5,15,12,21,19,0,107
1,12,22,5,21,19,0,0,0,80
1,12,22,9,1,0,0,0,0,45
1,12,22,9,14,5,0,0,0,63
1,12,22,9,20,5,0,0,0,69
1,12,22,21,19,0,0,0,0,75
1,12,23,0,0,0,0,0,0,36
1,12,23,1,25,0,0,0,0,62
1,12,23,1,25,19,0,0,0,81
1,12,23,9,19,5,0,0,0,69
1,12,23,9,20,5,0,0,0,70
1,12,26,8,5,9,13,5,18,97
1,13,2,1,3,8,0,0,0,28
1,13,2,1,7,5,0,0,0,29
1,13,2,1,7,5,19,0,0,48
1,13,2,1,7,9,15,21,19,88
1,13,2,1,25,0,0,0,0,42
1,13,2,1,12,1,13,0,0,43
1,13,2,1,14,0,0,0,0,31
1,13,2,1,18,0,0,0,0,35
1,13,2,1,18,5,5,0,0,45
1,13,2,1,18,5,12,12,1,65
1,13,2,1,18,9,0,0,0,44
1,13,2,1,18,25,0,0,0,60
1,13,2,1,18,9,5,19,0,68
1,13,2,1,18,9,19,0,0,63
1,13,2,1,19,0,0,0,0,36
1,13,2,1,19,8,0,0,0,44
1,13,2,1,19,19,1,4,5,65
1,13,2,1,19,19,1,7,5,68
1,13,2,1,19,19,25,0,0,80
1,13,2,1,20,3,8,0,0,48
1,13,2,5,0,0,0,0,0,21
1,13,2,5,5,18,0,0,0,44
1,13,2,5,5,18,19,0,0,63
1,13,2,5,18,6,9,19,8,81
1,13,2,5,18,7,18,9,19,92
1,13,2,5,18,25,0,0,0,64
1,13,2,5,18,9,5,19,0,72
1,13,2,5,18,9,14,1,0,63
1,13,2,5,18,9,20,5,0,73
1,13,2,5,18,10,1,3,11,64
1,13,2,5,18,12,9,11,5,76
1,13,2,5,18,15,9,4,0,67
1,13,2,5,18,15,9,4,19,86
1,13,2,5,18,15,21,19,0,94
1,13,2,5,18,19,0,0,0,58
1,13,2,9,1,14,3,5,0,48
1,13,2,9,1,14,3,5,19,67
1,13,2,9,5,14,3,5,0,52
1,13,2,9,5,14,3,5,19,71
1,13,2,9,5,14,3,25,0,72
1,13,2,9,5,14,19,0,0,63
1,13,2,9,5,14,20,0,0,64
1,13,2,9,5,14,20,19,0,83
1,13,2,9,5,18,0,0,0,48
1,13,2,9,7,5,14,1,12,64
1,13,2,9,7,21,0,0,0,53
1,13,2,9,7,21,9,20,25,107
1,13,2,9,7,21,15,21,19,108
1,13,2,9,12,9,1,14,0,61
1,13,2,9,12,15,7,25,0,84
1,13,2,9,15,16,9,1,0,66
1,13,2,9,20,0,0,0,0,45
1,13,2,9,20,1,12,0,0,58
1,13,2,9,20,9,15,14,0,83
1,13,2,9,20,9,15,14,19,102
1,13,2,9,20,9,15,21,19,109
1,13,2,9,20,19,0,0,0,64
1,13,2,9,20,20,25,0,0,90
1,13,2,9,20,21,19,0,0,85
1,13,2,9,22,5,18,20,0,90
1,13,2,9,22,5,18,20,19,109
1,13,2,12,5,4,0,0,0,37
1,13,2,12,5,18,19,0,0,70
1,13,2,12,5,19,0,0,0,52
1,13,2,12,25,7,15,14,0,89
1,13,2,12,9,14,7,0,0,58
1,13,2,12,9,14,7,12,25,95
1,13,2,12,25,15,16,5,0,89
1,13,2,12,25,15,16,9,1,94
1,13,2,12,25,15,16,9,3,96
1,13,2,12,25,16,15,4,0,88
1,13,2,12,15,19,9,19,0,90
1,13,2,12,15,20,9,3,0,75
1,13,2,15,0,0,0,0,0,31
1,13,2,15,25,14,1,0,0,71
1,13,2,15,9,14,1,19,0,74
1,13,2,15,25,14,1,19,0,90
1,13,2,15,12,9,3,0,0,55
1,13,2,15,14,5,19,0,0,69
1,13,2,15,14,9,20,5,0,79
1,13,2,15,19,0,0,0,0,50
1,13,2,18,1,3,1,14,0,53
1,13,2,18,1,9,14,0,0,58
1,13,2,18,5,1,20,5,0,65
1,13,2,18,5,9,3,0,0,51
1,13,2,18,5,9,14,0,0,62
1,13,2,18,5,20,20,5,0,84
1,13,2,18,25,0,0,0,0,59
1,13,2,18,9,5,19,0,0,67
1,13,2,18,9,20,5,0,0,68
1,13,2,18,15,9,4,0,0,62
1,13,2,18,15,9,4,19,0,81
1,13,2,18,15,12,15,7,25,108
1,13,2,18,15,19,9,1,3,81
1,13,2,18,15,19,9,1,12,90
1,13,2,18,15,19,9,1,19,97
1,13,2,18,15,19,9,14,0,91
1,13,2,18,15,20,25,16,5,115
1,13,2,19,1,3,5,0,0,44
1,13,2,19,1,3,5,19,0,63
1,13,2,21,12,1,3,18,1,72
1,13,2,21,12,1,14,3,5,72
1,13,2,21,12,1,14,20,0,84
1,13,2,21,12,1,14,20,5,89
1,13,2,21,12,1,20,5,0,75
1,13,2,21,12,1,20,5,4,79
1,13,2,21,12,1,20,5,19,94
1,13,2,21,12,1,20,9,15,94
1,13,2,21,12,1,20,15,18,103
1,13,2,21,12,9,1,0,0,59
1,13,2,21,12,9,14,7,0,79
1,13,2,21,18,2,9,1,12,79
1,13,2,21,18,25,0,0,0,80
1,13,2,21,19,3,1,4,5,69
1,13,2,21,19,3,1,4,15,79
1,13,2,21,19,8,0,0,0,64
1,13,2,21,19,8,5,4,0,73
1,13,2,21,19,8,5,18,0,87
1,13,2,21,19,8,5,18,19,106
1,13,2,21,19,8,5,19,0,88
1,13,2,21,19,8,9,14,7,94
1,13,2,21,19,20,9,15,14,114
1,13,3,8,15,15,18,0,0,73
1,13,4,1,8,12,0,0,0,39
1,13,4,20,0,0,0,0,0,38
1,13,5,2,1,0,0,0,0,22
1,13,5,2,1,5,0,0,0,27
1,13,5,2,1,14,0,0,0,36
1,13,5,2,1,19,0,0,0,41
1,13,5,2,5,1,14,0,0,41
1,13,5,2,9,1,14,0,0,45
1,13,5,2,9,1,19,9,19,78
1,13,5,2,9,3,0,0,0,33
1,13,5,2,9,3,9,4,5,51
1,13,5,2,9,4,0,0,0,34
1,13,5,2,9,6,15,18,13,82
1,13,5,2,15,3,25,20,5,89
1,13,5,2,15,9,4,0,0,49
1,13,5,2,15,21,19,0,0,76
1,13,5,2,21,12,1,0,0,55
1,13,5,5,4,0,0,0,0,28
1,13,5,5,14,0,0,0,0,38
1,13,5,5,18,0,0,0,0,42
1,13,5,5,18,1,20,5,0,68
1,13,5,5,18,1,20,5,19,87
1,13,5,5,18,19,0,0,0,61
1,13,5,9,15,19,9,19,0,90
1,13,5,9,15,20,9,3,0,75
1,13,5,12,0,0,0,0,0,31
1,13,5,12,1,14,4,0,0,50
1,13,5,12,3,15,18,14,0,81
1,13,5,12,3,15,18,14,19,100
1,13,5,12,5,20,0,0,0,56
1,13,5,12,12,21,19,0,0,83
1,13,5,12,21,0,0,0,0,52
1,13,5,12,21,19,0,0,0,71
1,13,5,14,1,2,12,5,0,53
1,13,5,14,1,2,12,25,0,73
1,13,5,14,1,7,5,0,0,46
1,13,5,14,1,14,3,5,0,56
1,13,5,14,4,1,2,12,5,57
1,13,5,14,4,5,0,0,0,42
1,13,5,14,4,5,4,0,0,46
1,13,5,14,4,5,18,0,0,60
1,13,5,14,4,5,18,19,0,79
1,13,5,14,4,9,14,7,0,67
1,13,5,14,4,13,5,14,20,89
1,13,5,14,4,19,0,0,0,56
1,13,5,14,5,0,0,0,0,38
1,13,5,14,9,20,25,0,0,87
1,13,5,14,9,20,9,5,19,95
1,13,5,14,15,18,18,8,15,107
1,13,5,14,19,0,0,0,0,52
1,13,5,14,20,0,0,0,0,53
1,13,5,14,20,1,0,0,0,54
1,13,5,14,20,1,12,0,0,66
1,13,5,14,20,25,0,0,0,78
1,13,5,14,20,9,1,0,0,63
1,13,5,14,20,9,1,19,0,82
1,13,5,14,20,19,0,0,0,72
1,13,5,14,20,21,12,1,0,87
1,13,5,14,20,21,12,21,13,120
1,13,5,14,20,21,13,0,0,87
1,13,5,14,21,19,5,0,0,78
1,13,5,18,3,5,0,0,0,45
1,13,5,18,3,5,4,0,0,49
1,13,5,18,3,5,18,0,0,63
1,13,5,18,3,5,18,19,0,82
1,13,5,18,3,5,19,0,0,64
1,13,5,18,3,9,14,7,0,70
1,13,5,18,9,3,1,14,19,83
1,13,5,18,9,3,1,19,0,69
1,13,5,18,9,3,9,21,13,92
1,13,5,18,9,11,1,14,9,81
1,13,5,18,9,14,4,19,0,83
1,13,5,18,9,19,13,0,0,78
1,13,5,18,9,19,20,9,3,97
1,13,5,18,22,5,9,12,0,85
1,13,5,19,1,3,5,0,0,47
1,13,5,19,1,3,5,19,0,66
1,13,5,19,9,20,5,0,0,72
1,13,5,19,19,0,0,0,0,57
1,13,5,20,1,2,15,12,5,74
1,13,5,20,1,2,15,12,25,94
1,13,5,20,8,25,19,20,19,130
1,13,5,20,18,9,1,0,0,67
1,13,5,20,18,15,16,5,0,93
1,13,5,20,18,15,16,9,1,98
1,13,5,20,18,15,16,9,3,100
1,13,5,20,18,15,21,19,0,112
1,13,7,1,18,14,0,0,0,54
1,13,8,1,18,0,0,0,0,41
1,13,8,18,1,14,0,0,0,55
1,13,9,1,2,12,5,0,0,43
1,13,9,1,2,12,25,0,0,63
1,13,9,1,14,20,0,0,0,58
1,13,9,1,14,20,8,0,0,66
1,13,9,1,14,20,8,21,19,106
1,13,9,1,14,20,21,19,0,98
1,13,25,1,20,15,14,9,3,101
1,13,9,3,0,0,0,0,0,26
1,13,9,3,1,2,12,5,0,46
1,13,9,3,1,2,12,25,0,66
1,13,9,3,1,12,0,0,0,39
1,13,9,3,5,4,0,0,0,35
1,13,9,3,5,19,0,0,0,50
1,13,9,3,9,0,0,0,0,35
1,13,9,3,9,3,9,4,5,56
1,13,9,3,15,21,19,0,0,81
1,13,9,3,18,15,2,9,3,73
1,13,9,3,18,15,14,0,0,73
1,13,25,3,20,9,3,0,0,74
1,13,9,3,20,21,19,0,0,86
1,13,9,3,21,19,0,0,0,66
1,13,9,4,0,0,0,0,0,27
1,13,9,4,1,19,5,0,0,52
1,13,9,4,1,19,5,19,0,71
1,13,9,4,1,20,5,0,0,53
1,13,9,4,1,20,5,4,0,57
1,13,9,4,1,20,9,14,7,78
1,13,9,4,1,20,9,15,14,86
1,13,9,4,5,0,0,0,0,32
1,13,9,4,5,19,0,0,0,51
1,13,9,4,9,3,0,0,0,39
1,13,9,4,9,4,0,0,0,40
1,13,9,4,9,4,5,0,0,45
1,13,9,4,9,14,0,0,0,50
1,13,9,4,9,14,5,0,0,55
1,13,9,4,9,14,5,19,0,74
1,13,9,4,9,14,19,0,0,69
1,13,9,4,13,15,19,20,0,94
1,13,9,4,15,0,0,0,0,42
1,13,9,4,15,1,26,15,0,84
1,13,9,4,15,7,5,14,0,68
1,13,9,4,15,7,5,14,19,87
1,13,9,4,15,12,19,0,0,73
1,13,25,4,15,14,0,0,0,72
1,13,9,4,15,14,5,0,0,61
1,13,9,4,15,14,5,19,0,80
1,13,9,4,15,24,25,0,0,91
1,13,9,4,15,24,25,12,0,103
1,13,9,4,15,24,9,13,5,93
1,13,9,4,19,0,0,0,0,46
1,13,9,4,19,8,9,16,0,79
1,13,9,4,19,8,9,16,19,98
1,13,9,4,19,20,0,0,0,66
1,13,9,4,21,12,9,14,0,83
1,13,9,4,23,1,18,4,0,73
1,13,25,5,12,9,1,0,0,66
1,13,25,5,12,9,3,0,0,68
1,13,25,5,12,9,14,9,3,91
1,13,25,5,12,15,14,9,3,97
1,13,25,5,12,15,21,19,0,111
1,13,9,5,19,0,0,0,0,47
1,13,9,7,1,0,0,0,0,31
1,13,9,7,1,19,0,0,0,50
1,13,25,7,4,1,12,0,0,63
1,13,25,7,4,1,12,1,0,64
1,13,25,7,4,1,12,1,5,69
1,13,25,7,4,1,12,5,0,68
1,13,25,7,4,1,12,5,19,87
1,13,25,7,4,1,12,9,3,75
1,13,25,7,4,1,12,9,14,86
1,13,25,7,4,21,12,5,0,88
1,13,25,7,4,21,12,5,19,107
1,13,9,7,15,0,0,0,0,45
1,13,9,7,15,19,0,0,0,64
1,13,25,12,0,0,0,0,0,51
1,13,25,12,1,13,9,14,5,93
1,13,25,12,1,14,0,0,0,66
1,13,25,12,1,19,5,0,0,76
1,13,25,12,1,19,5,19,0,95
1,13,25,12,1,20,5,0,0,77
1,13,9,12,4,1,18,0,0,58
1,13,25,12,5,13,9,1,0,79
1,13,25,12,5,14,5,0,0,75
1,13,25,12,5,14,5,19,0,94
1,13,25,12,5,14,15,12,0,97
1,13,25,12,9,3,0,0,0,63
1,13,25,12,9,4,5,14,5,88
1,13,25,12,9,14,0,0,0,74
1,13,25,12,15,0,0,0,0,66
1,13,25,12,15,7,5,14,0,92
1,13,25,12,15,7,5,14,19,111
1,13,25,12,15,9,4,0,0,79
1,13,25,12,15,9,4,1,12,92
1,13,25,12,15,9,4,19,0,98
1,13,25,12,15,13,0,0,0,79
1,13,25,12,15,13,5,0,0,84
1,13,25,12,15,14,0,0,0,80
1,13,25,12,15,16,19,9,14,124
1,13,25,12,15,19,5,0,0,90
1,13,25,12,15,19,5,19,0,109
1,13,25,12,15,19,9,19,0,113
1,13,25,12,19,0,0,0,0,70
1,13,25,12,21,13,0,0,0,85
1,13,25,12,21,13,19,0,0,104
1,13,25,12,21,18,9,1,0,100
1,13,9,13,9,1,0,0,0,46
1,13,9,13,9,4,5,0,0,54
1,13,9,14,1,19,5,0,0,62
1,13,9,14,1,20,5,0,0,63
1,13,9,14,1,20,5,4,0,67
1,13,9,14,1,20,9,14,7,88
1,13,9,14,1,20,9,15,14,96
1,13,9,14,4,5,4,0,0,50
1,13,9,14,5,0,0,0,0,42
1,13,9,14,5,19,0,0,0,61
1,13,9,14,9,0,0,0,0,46
1,13,9,14,9,3,0,0,0,49
1,13,9,14,9,19,8,0,0,73
1,13,9,14,9,20,25,0,0,91
1,13,9,14,9,20,9,5,19,99
1,13,9,14,9,26,5,0,0,77
1,13,9,14,15,0,0,0,0,52
1,13,9,14,15,1,26,15,0,94
1,13,25,14,15,4,15,14,20,121
1,13,9,14,15,7,5,14,0,78
1,13,9,14,15,9,4,0,0,65
1,13,9,14,15,17,21,9,14,113
1,13,9,14,15,19,9,19,0,99
1,13,9,14,19,0,0,0,0,56
1,13,25,15,20,1,24,9,1,109
1,13,25,15,20,15,14,9,1,113
1,13,25,15,21,19,0,0,0,94
1,13,9,18,1,25,0,0,0,67
1,13,9,18,1,12,0,0,0,54
1,13,9,18,1,20,5,0,0,67
1,13,9,18,1,20,5,19,0,86
1,13,9,18,5,0,0,0,0,46
1,13,25,18,9,14,0,0,0,80
1,13,25,18,15,12,0,0,0,84
1,13,25,18,15,15,20,0,0,107
1,13,9,18,19,0,0,0,0,60
1,13,9,18,19,8,9,16,0,93
1,13,9,19,19,0,0,0,0,61
1,13,9,19,19,9,2,12,5,89
1,13,9,19,19,9,14,7,0,91
1,13,9,19,19,9,15,14,0,99
1,13,9,19,19,14,5,19,19,118
1,13,9,20,0,0,0,0,0,43
1,13,9,20,1,20,5,0,0,69
1,13,9,20,9,5,19,0,0,76
1,13,9,20,15,19,5,19,0,101
1,13,9,20,15,19,9,19,0,105
1,13,9,20,15,20,9,3,0,90
1,13,9,20,18,15,12,5,0,93
1,13,9,20,18,15,12,5,19,112
1,13,9,20,21,12,1,18,0,95
1,13,9,24,9,1,0,0,0,57
1,13,12,1,0,0,0,0,0,27
1,13,12,1,3,18,1,0,0,49
1,13,12,5,20,0,0,0,0,51
1,13,12,9,0,0,0,0,0,35
1,13,12,9,11,1,18,0,0,65
1,13,12,15,14,7,0,0,0,62
1,13,13,5,12,9,4,5,0,62
1,13,13,5,12,9,14,0,0,67
1,13,13,5,12,9,14,5,0,72
1,13,13,5,15,19,0,0,0,66
1,13,13,5,18,0,0,0,0,50
1,13,13,5,20,5,18,0,0,75
1,13,13,5,20,5,18,19,0,94
1,13,13,9,14,5,0,0,0,55
1,13,13,9,14,5,19,0,0,74
1,13,13,9,14,15,0,0,0,65
1,13,13,9,15,12,9,20,5,97
1,13,13,9,18,1,12,0,0,67
1,13,13,9,20,5,19,0,0,80
1,13,13,15,0,0,0,0,0,42
1,13,13,15,3,5,20,5,0,75
1,13,13,15,3,5,20,5,19,94
1,13,13,15,3,15,5,20,5,90
1,13,13,15,4,25,20,5,0,96
1,13,13,15,14,1,12,0,0,69
1,13,13,15,14,1,12,19,0,88
1,13,13,15,14,1,20,5,0,82
1,13,13,15,14,9,1,0,0,66
1,13,13,15,14,9,1,3,0,69
1,13,13,15,14,9,1,3,19,88
1,13,13,15,14,9,1,19,0,85
1,13,13,15,14,9,1,20,5,91
1,13,13,15,14,9,3,0,0,68
1,13,13,15,14,9,3,1,12,81
1,13,13,15,14,9,6,25,0,96
1,13,13,15,14,9,15,14,0,94
1,13,13,15,14,9,20,9,3,97
1,13,13,15,14,9,21,13,0,99
1,13,13,15,14,9,21,13,19,118
1,13,13,15,14,15,0,0,0,71
1,13,13,15,14,15,9,4,0,84
1,13,13,15,14,15,9,4,19,103
1,13,13,15,19,0,0,0,0,61
1,13,13,21,0,0,0,0,0,48
1,13,14,5,13,15,14,9,3,87
1,13,14,5,19,9,1,0,0,62
1,13,14,5,19,9,1,3,0,65
1,13,14,5,19,9,1,3,19,84
1,13,14,5,19,9,1,19,0,81
1,13,14,5,19,9,3,0,0,64
1,13,14,5,19,9,3,19,0,83
1,13,14,5,19,20,25,0,0,97
1,13,14,5,19,20,9,3,0,84
1,13,14,5,19,20,9,5,4,90
1,13,14,5,19,20,9,5,19,105
1,13,14,9,1,0,0,0,0,38
1,13,14,9,1,3,0,0,0,41
1,13,14,9,1,20,9,3,0,70
1,13,14,9,3,0,0,0,0,40
1,13,14,9,14,9,1,0,0,61
1,13,14,9,14,9,15,14,19,108
1,13,14,9,15,14,0,0,0,66
1,13,14,9,15,14,1,20,5,92
1,13,14,9,15,14,9,1,0,76
1,13,14,9,15,14,9,3,0,78
1,13,14,9,15,14,19,0,0,85
1,13,14,9,15,19,0,0,0,71
1,13,14,9,15,20,5,0,0,77
1,13,14,9,15,20,5,19,0,96
1,13,14,9,15,20,9,3,0,84
1,13,14,9,15,20,9,14,0,95
1,13,14,9,15,20,15,13,5,105
1,13,15,2,5,18,0,0,0,54
1,13,15,2,25,18,0,0,0,74
1,13,15,5,2,1,0,0,0,37
1,13,15,5,2,1,5,0,0,42
1,13,15,5,2,1,5,1,14,57
1,13,15,5,2,1,5,21,13,76
1,13,15,5,2,1,14,0,0,51
1,13,15,5,2,1,19,0,0,56
1,13,15,5,2,5,1,14,0,56
1,13,15,5,2,5,21,13,0,75
1,13,15,5,2,9,1,14,0,60
1,13,15,5,2,9,3,0,0,48
1,13,15,5,2,9,4,0,0,49
1,13,15,5,2,15,9,4,0,64
1,13,15,5,2,15,21,19,0,91
1,13,15,5,2,21,12,1,0,70
1,13,15,9,2,9,20,5,0,74
1,13,15,9,14,4,5,18,0,79
1,13,15,11,0,0,0,0,0,40
1,13,15,11,5,0,0,0,0,45
1,13,15,11,19,0,0,0,0,59
1,13,15,12,5,0,0,0,0,46
1,13,15,12,5,19,0,0,0,65
1,13,15,12,9,12,12,1,0,75
1,13,15,12,9,19,8,0,0,77
1,13,15,12,12,9,19,8,0,89
1,13,15,13,1,12,0,0,0,55
1,13,15,13,21,13,0,0,0,76
1,13,15,14,7,0,0,0,0,50
1,13,15,14,7,19,20,0,0,89
1,13,15,18,1,4,15,0,0,67
1,13,15,18,1,9,3,0,0,60
1,13,15,18,1,9,13,0,0,70
1,13,15,18,1,12,0,0,0,60
1,13,15,18,1,12,9,19,13,101
1,13,15,18,1,12,9,19,20,108
1,13,15,18,1,12,9,20,25,114
1,13,15,18,1,12,9,26,5,100
1,13,15,18,1,12,12,25,0,97
1,13,15,18,5,20,20,15,0,107
1,13,15,18,5,20,20,15,19,126
1,13,15,18,9,14,9,0,0,79
1,13,15,18,9,14,15,0,0,85
1,13,15,18,9,19,13,0,0,88
1,13,15,18,9,19,20,0,0,95
1,13,15,18,9,19,20,9,3,107
1,13,15,18,9,19,20,19,0,114
1,13,15,18,14,9,14,7,19,110
1,13,15,18,15,19,1,0,0,82
1,13,15,18,15,19,9,20,25,135
1,13,15,18,15,19,15,0,0,96
1,13,15,18,15,21,19,0,0,102
1,13,15,18,15,21,19,12,25,139
1,13,15,18,16,8,0,0,0,71
1,13,15,18,16,8,9,0,0,80
1,13,15,18,16,8,25,0,0,96
1,13,15,18,16,8,9,1,0,81
1,13,15,18,16,8,9,3,0,83
1,13,15,18,16,8,9,19,13,112
1,13,15,18,16,8,15,21,19,126
1,13,15,18,16,8,21,19,0,111
1,13,15,18,20,0,0,0,0,67
1,13,15,18,20,9,19,5,0,100
1,13,15,18,20,9,19,5,4,104
1,13,15,18,20,9,19,5,19,119
1,13,15,18,20,9,26,5,0,107
1,13,15,18,20,9,26,5,4,111
1,13,15,18,20,9,26,5,19,126
1,13,15,19,9,20,5,0,0,82
1,13,15,20,9,15,14,0,0,87
1,13,15,20,9,15,14,19,0,106
1,13,15,20,21,19,0,0,0,89
1,13,15,21,12,9,0,0,0,71
1,13,15,21,14,20,0,0,0,84
1,13,15,21,14,20,5,4,0,93
1,13,15,21,14,20,5,18,0,107
1,13,15,21,14,20,5,18,19,126
1,13,15,21,14,20,9,14,7,114
1,13,15,21,14,20,19,0,0,103
1,13,15,21,18,0,0,0,0,68
1,13,15,21,18,5,20,0,0,93
1,13,15,21,18,5,20,20,5,118
1,13,15,21,18,9,19,20,0,116
1,13,15,21,18,19,0,0,0,87
1,13,15,22,1,2,12,5,0,71
1,13,15,22,5,0,0,0,0,56
1,13,15,22,5,4,0,0,0,60
1,13,15,22,9,14,7,0,0,81
1,13,15,23,20,0,0,0,0,72
1,13,16,1,12,1,25,1,0,70
1,13,16,1,12,5,1,0,0,49
1,13,16,1,18,15,0,0,0,64
1,13,16,1,19,19,25,0,0,94
1,13,16,5,12,9,20,5,0,81
1,13,16,5,12,9,20,9,3,88
1,13,16,5,18,0,0,0,0,53
1,13,16,5,18,1,7,5,0,66
1,13,16,5,18,1,7,5,19,85
1,13,16,5,18,5,19,0,0,77
1,13,16,5,18,25,0,0,0,78
1,13,16,5,18,19,1,14,4,91
1,13,16,8,9,0,0,0,0,47
1,13,16,8,9,2,0,0,0,49
1,13,16,8,9,2,1,12,9,71
1,13,16,8,9,2,9,1,12,71
1,13,16,8,9,2,9,1,14,73
1,13,16,8,9,2,9,15,14,87
1,13,16,8,9,2,9,21,13,92
1,13,16,8,9,2,15,12,5,81
1,13,16,8,9,2,15,12,25,101
1,13,16,8,9,3,15,13,5,83
1,13,16,8,9,4,0,0,0,51
1,13,16,8,9,4,5,0,0,56
1,13,16,8,9,4,9,19,3,82
1,13,16,8,9,4,9,19,11,90
1,13,16,8,9,7,1,13,0,68
1,13,16,8,9,7,5,1,14,74
1,13,16,8,9,7,5,14,0,73
1,13,16,8,9,7,5,14,5,78
1,13,16,8,9,7,15,14,25,108
1,13,16,8,9,7,15,18,25,112
1,13,16,8,9,12,15,7,25,106
1,13,16,8,9,15,24,9,19,114
1,13,16,8,9,15,24,21,19,126
1,13,16,8,9,16,15,4,0,82
1,13,16,8,9,16,15,4,19,101
1,13,16,8,9,19,3,9,9,87
1,13,16,8,9,20,5,14,5,91
1,13,16,8,9,20,15,11,25,118
1,13,16,8,9,20,18,15,14,114
1,13,16,8,15,7,5,14,25,104
1,13,16,8,15,12,25,20,5,115
1,13,16,8,15,16,8,9,12,98
1,13,16,8,15,18,1,0,0,72
1,13,16,8,15,18,1,5,0,77
1,13,16,8,15,18,1,12,0,84
1,13,16,8,15,18,1,19,0,91
1,13,16,8,15,18,5,0,0,76
1,13,16,8,15,18,9,3,0,83
1,13,16,8,15,18,15,21,19,126
1,13,16,25,3,5,19,0,0,82
1,13,16,25,24,5,19,0,0,103
1,13,16,12,5,0,0,0,0,47
1,13,16,12,5,3,20,0,0,70
1,13,16,12,5,14,5,19,19,104
1,13,16,12,5,18,0,0,0,65
1,13,16,12,5,19,20,0,0,86
1,13,16,12,5,24,0,0,0,71
1,13,16,12,5,24,21,19,0,111
1,13,16,12,25,0,0,0,0,67
1,13,16,12,9,1,20,5,0,77
1,13,16,12,9,4,25,14,5,99
1,13,16,12,9,6,25,0,0,82
1,13,16,12,9,6,9,5,4,75
1,13,16,12,9,6,9,5,18,89
1,13,16,12,9,6,9,5,19,90
1,13,16,12,9,20,21,4,5,101
1,13,16,15,14,7,21,5,0,92
1,13,16,15,21,12,5,0,0,83
1,13,16,15,21,12,5,19,0,102
1,13,16,21,12,0,0,0,0,63
1,13,16,21,12,1,20,5,0,89
1,13,16,21,12,1,20,5,4,93
1,13,16,21,12,5,0,0,0,68
1,13,16,21,12,5,19,0,0,87
1,13,16,21,12,12,1,0,0,76
1,13,16,21,12,12,1,5,0,81
1,13,16,21,12,12,1,18,0,94
1,13,16,21,12,12,1,18,25,119
1,13,16,21,12,12,1,20,5,101
1,13,16,21,12,12,21,12,1,109
1,13,16,21,12,19,0,0,0,82
1,13,16,21,20,1,20,5,0,97
1,13,16,21,20,1,20,5,4,101
1,13,16,21,20,1,20,5,19,116
1,13,16,21,20,1,20,15,18,125
1,13,16,21,20,5,5,0,0,81
1,13,16,21,20,5,5,19,0,100
1,13,18,1,0,0,0,0,0,33
1,13,18,5,5,20,1,0,0,63
1,13,18,5,5,20,1,19,0,82
1,13,18,5,12,12,5,0,0,66
1,13,18,9,20,0,0,0,0,61
1,13,18,9,20,1,19,0,0,81
1,13,19,1,20,8,0,0,0,62
1,13,19,5,12,0,0,0,0,50
1,13,20,13,1,14,0,0,0,62
1,13,20,13,5,14,0,0,0,66
1,13,20,18,1,3,0,0,0,56
1,13,20,18,1,3,11,0,0,67
1,13,20,18,1,3,11,19,0,86
1,13,20,18,1,3,19,0,0,75
1,13,21,3,11,0,0,0,0,49
1,13,21,3,11,19,0,0,0,68
1,13,21,7,9,19,0,0,0,70
1,13,21,7,21,9,19,0,0,91
1,13,21,25,15,14,0,0,0,89
1,13,21,25,15,14,7,0,0,96
1,13,21,12,1,0,0,0,0,48
1,13,21,12,1,5,0,0,0,53
1,13,21,12,1,19,0,0,0,67
1,13,21,12,5,20,0,0,0,72
1,13,21,12,5,20,9,3,0,84
1,13,21,12,5,20,19,0,0,91
1,13,21,12,12,1,0,0,0,60
1,13,21,14,1,13,0,0,0,63
1,13,21,18,3,1,0,0,0,57
1,13,21,18,3,15,21,19,0,111
1,13,21,19,0,0,0,0,0,54
1,13,21,19,1,2,12,5,0,74
1,13,21,19,5,0,0,0,0,59
1,13,21,19,5,4,0,0,0,63
1,13,21,19,5,4,12,25,0,100
1,13,21,19,5,5,0,0,0,64
1,13,21,19,5,13,5,14,20,111
1,13,21,19,5,18,0,0,0,77
1,13,21,19,5,18,19,0,0,96
1,13,21,19,5,19,0,0,0,78
1,13,21,19,5,20,20,5,0,104
1,13,21,19,9,1,0,0,0,64
1,13,21,19,9,1,19,0,0,83
1,13,21,19,9,14,7,0,0,84
1,13,21,19,9,14,7,12,25,121
1,13,21,19,9,22,5,0,0,90
1,13,21,19,9,22,5,12,25,127
1,13,21,20,20,5,18,0,0,98
1,13,21,26,5,0,0,0,0,66
1,13,21,26,26,12,5,0,0,104
1,13,22,9,19,0,0,0,0,64
1,13,26,5,12,0,0,0,0,57
1,14,2,1,0,0,0,0,0,18
1,14,2,21,18,25,0,0,0,81
1,14,3,5,0,0,0,0,0,23
1,14,3,5,19,20,15,18,0,95
1,14,3,5,19,20,15,18,19,114
1,14,3,5,19,20,18,1,12,93
1,14,3,5,19,20,18,25,0,105
1,14,3,8,9,5,20,9,14,83
1,14,3,8,25,12,15,19,5,102
1,14,3,8,15,9,3,0,0,53
1,14,3,8,15,18,0,0,0,59
1,14,3,8,15,18,1,20,5,85
1,14,3,8,15,18,5,4,0,68
1,14,3,8,15,18,5,18,0,82
1,14,3,8,15,18,5,19,19,102
1,14,3,8,15,18,5,20,0,84
1,14,3,8,15,18,5,20,19,103
1,14,3,8,15,18,25,0,0,84
1,14,3,8,15,18,9,14,7,89
1,14,3,8,15,18,9,20,5,93
1,14,3,8,15,18,13,1,14,87
1,14,3,8,15,18,13,5,14,91
1,14,3,8,15,18,19,0,0,78
1,14,3,8,15,22,5,20,1,89
1,14,3,8,15,22,25,0,0,88
1,14,3,8,15,22,9,5,19,96
1,14,3,8,21,19,1,19,0,86
1,14,3,8,21,19,9,14,0,89
1,14,3,8,21,19,9,14,5,94
1,14,3,8,21,19,9,14,19,108
1,14,3,25,0,0,0,0,0,43
1,14,3,9,5,14,0,0,0,46
1,14,3,9,5,14,3,5,0,54
1,14,3,9,5,14,3,25,0,74
1,14,3,9,5,14,19,0,0,65
1,14,3,9,5,14,20,0,0,66
1,14,3,9,5,14,20,5,18,89
1,14,3,9,5,14,20,25,0,91
1,14,3,9,5,14,20,12,25,103
1,14,3,9,5,14,20,18,25,109
1,14,3,9,5,14,20,19,0,85
1,14,3,9,12,5,0,0,0,44
1,14,3,9,12,9,1,0,0,49
1,14,3,9,12,12,1,0,0,52
1,14,3,9,12,12,1,5,0,57
1,14,3,9,12,12,1,18,25,95
1,14,3,9,12,12,1,19,0,71
1,14,3,9,12,12,5,0,0,56
1,14,3,25,12,15,16,15,4,105
1,14,3,25,12,15,19,5,0,94
1,14,3,9,16,9,20,1,12,85
1,14,3,25,18,15,9,4,0,89
1,14,3,12,5,0,0,0,0,35
1,14,3,15,4,15,14,20,0,86
1,14,3,15,12,25,0,0,0,70
1,14,3,15,13,5,0,0,0,51
1,14,3,15,14,1,4,0,0,52
1,14,3,15,14,1,7,18,1,74
1,14,3,15,14,1,12,0,0,60
1,14,3,15,14,1,19,0,0,67
1,14,3,15,14,5,0,0,0,52
1,14,3,15,14,5,1,12,0,65
1,14,3,15,14,5,9,0,0,61
1,14,3,15,14,5,15,21,19,107
1,14,3,15,14,5,19,0,0,71
1,14,3,15,14,5,21,19,0,92
1,14,3,15,14,25,0,0,0,72
1,14,3,15,14,9,20,9,19,104
1,14,3,15,14,15,9,4,0,75
1,14,3,15,18,0,0,0,0,51
1,14,3,15,18,1,0,0,0,52
1,14,3,15,18,1,12,0,0,64
1,14,3,18,5,0,0,0,0,41
1,14,3,18,5,19,19,0,0,79
1,14,3,18,5,19,19,5,19,103
1,14,4,0,0,0,0,0,0,19
1,14,4,1,0,0,0,0,0,20
1,14,4,1,2,1,20,1,0,44
1,14,4,1,13,5,14,20,1,73
1,14,4,1,13,5,14,20,15,87
1,14,4,1,14,20,5,0,0,59
1,14,4,1,14,20,5,19,0,78
1,14,4,1,14,20,9,14,9,86
1,14,4,1,14,20,9,14,15,92
1,14,4,5,4,0,0,0,0,28
1,14,4,5,18,21,14,0,0,77
1,14,4,5,19,9,14,5,0,71
1,14,4,5,19,9,20,5,0,77
1,14,4,5,19,25,20,5,0,93
1,14,4,5,19,9,20,5,19,96
1,14,4,5,19,25,20,5,19,112
1,14,4,5,19,9,20,9,3,84
1,14,4,9,1,0,0,0,0,29
1,14,4,9,14,7,0,0,0,49
1,14,4,9,18,9,14,0,0,69
1,14,4,9,18,9,14,5,0,74
1,14,4,9,18,15,2,1,0,64
1,14,4,9,18,15,14,0,0,75
1,14,4,9,18,15,14,19,0,94
1,14,4,15,18,0,0,0,0,52
1,14,4,15,18,9,20,5,0,86
1,14,4,15,18,15,2,1,0,70
1,14,4,15,21,9,12,12,5,93
1,14,4,18,1,4,9,20,5,76
1,14,4,18,1,7,15,7,25,92
1,14,4,18,1,18,3,8,25,92
1,14,4,18,5,14,9,4,0,69
1,14,4,18,25,0,0,0,0,62
1,14,4,18,9,5,19,0,0,70
1,14,4,18,9,20,5,0,0,71
1,14,4,18,15,3,25,20,5,105
1,14,4,18,15,5,3,9,1,70
1,14,4,18,15,7,5,14,0,78
1,14,4,18,15,7,5,14,19,97
1,14,4,18,15,7,25,14,0,98
1,14,4,18,15,7,25,14,5,103
1,14,4,18,15,7,25,14,25,123
1,14,4,18,15,7,15,14,5,93
1,14,4,18,15,9,4,0,0,65
1,14,4,18,15,9,4,1,12,78
1,14,4,18,15,9,4,5,19,89
1,14,4,18,15,9,4,19,0,84
1,14,4,18,15,12,0,0,0,64
1,14,4,18,15,13,5,4,0,74
1,14,4,18,15,19,5,13,5,94
1,14,4,18,15,19,9,14,0,94
1,14,4,18,15,20,15,13,25,125
1,14,4,18,15,21,19,0,0,92
1,14,4,19,0,0,0,0,0,38
1,14,5,0,0,0,0,0,0,20
1,14,5,1,18,0,0,0,0,39
1,14,5,1,18,5,4,0,0,48
1,14,5,1,18,9,14,7,0,69
1,14,5,1,18,19,0,0,0,58
1,14,5,1,20,8,0,0,0,49
1,14,5,3,4,25,19,9,19,99
1,14,5,3,4,15,20,1,0,63
1,14,5,3,4,15,20,1,12,75
1,14,5,3,4,15,20,5,0,67
1,14,5,3,4,15,20,5,19,86
1,14,5,3,4,15,20,9,3,74
1,14,5,3,8,15,9,3,0,58
1,14,5,12,1,3,5,0,0,41
1,14,5,12,1,19,20,9,3,84
1,14,5,12,5,0,0,0,0,37
1,14,5,12,5,4,0,0,0,41
1,14,5,12,5,19,0,0,0,56
1,14,5,12,9,14,7,0,0,62
1,14,5,13,1,20,9,26,5,94
1,14,5,13,9,1,19,0,0,62
1,14,5,13,9,3,0,0,0,45
1,14,5,13,9,15,21,19,0,97
1,14,5,13,15,7,18,1,13,87
1,14,5,13,15,12,15,7,25,107
1,14,5,13,15,14,1,12,0,75
1,14,5,13,15,14,5,0,0,67
1,14,5,13,15,14,5,19,0,86
1,14,5,13,15,14,25,0,0,87
1,14,5,13,15,14,9,14,0,85
1,14,5,13,15,14,15,12,0,89
1,14,5,13,15,19,5,19,0,91
1,14,5,13,15,19,9,19,0,95
1,14,5,14,4,0,0,0,0,38
1,14,5,14,5,18,7,9,1,74
1,14,5,14,19,20,0,0,0,73
1,14,5,14,20,0,0,0,0,54
1,14,5,16,9,1,0,0,0,46
1,14,5,18,5,20,9,3,0,75
1,14,5,18,7,25,0,0,0,70
1,14,5,18,7,9,1,0,0,55
1,14,5,18,7,9,1,19,0,74
1,14,5,18,7,9,3,0,0,57
1,14,5,18,7,9,5,19,0,78
1,14,5,18,12,25,0,0,0,75
1,14,5,18,15,9,4,0,0,66
1,14,5,18,15,9,4,19,0,85
1,14,5,18,15,20,9,3,0,85
1,14,5,19,0,0,0,0,0,39
1,14,5,19,9,19,0,0,0,67
1,14,5,19,15,14,5,0,0,73
1,14,5,19,20,8,25,12,0,104
1,14,5,19,20,18,9,0,0,86
1,14,5,19,20,18,15,21,19,132
1,14,5,19,20,18,21,19,0,117
1,14,5,20,8,5,14,5,0,72
1,14,5,20,8,15,12,0,0,75
1,14,5,20,8,15,12,5,0,80
1,14,5,20,8,15,12,5,19,99
1,14,5,20,8,15,12,19,0,94
1,14,5,20,9,3,0,0,0,52
1,14,5,21,3,8,0,0,0,52
1,14,5,21,16,12,15,9,4,97
1,14,5,21,18,9,1,0,0,69
1,14,5,21,18,9,3,0,0,71
1,14,5,21,18,9,14,5,0,87
1,14,5,21,18,9,14,19,0,101
1,14,5,21,18,9,19,13,0,100
1,14,5,21,18,25,19,13,0,116
1,14,5,21,18,9,19,13,19,119
1,14,5,21,18,25,19,13,19,135
1,14,5,23,0,0,0,0,0,43
1,14,6,5,5,12,4,0,0,47
1,14,6,18,1,3,20,0,0,63
1,14,7,1,0,0,0,0,0,23
1,14,7,1,11,15,11,0,0,60
1,14,7,1,11,15,11,19,0,79
1,14,7,1,11,21,20,0,0,75
1,14,7,1,18,5,2,0,0,48
1,14,7,1,18,5,5,2,0,53
1,14,7,1,18,5,16,0,0,62
1,14,7,1,18,25,0,0,0,66
1,14,7,1,18,9,1,0,0,51
1,14,7,1,18,9,1,19,0,70
1,14,7,1,18,9,5,19,0,74
1,14,7,1,19,0,0,0,0,42
1,14,7,5,25,15,11,0,0,78
1,14,7,5,11,11,15,11,0,75
1,14,7,5,11,15,11,0,0,64
1,14,7,5,11,21,20,0,0,79
1,14,7,5,12,1,20,5,0,65
1,14,7,5,12,4,15,13,0,71
1,14,7,5,12,5,4,0,0,48
1,14,7,5,12,5,5,14,0,63
1,14,7,5,12,5,25,5,19,93
1,14,7,5,12,5,20,0,0,64
1,14,7,5,12,6,9,19,8,81
1,14,7,5,12,8,15,15,4,81
1,14,7,5,12,9,3,1,19,71
1,14,7,5,12,9,3,9,3,63
1,14,7,5,12,9,13,0,0,61
1,14,7,5,12,9,14,0,0,62
1,14,7,5,12,9,14,7,0,69
1,14,7,5,12,9,20,15,0,83
1,14,7,5,12,9,26,5,0,79
1,14,7,5,12,9,26,5,4,83
1,14,7,5,12,12,9,11,5,76
1,14,7,5,12,15,14,0,0,68
1,14,7,5,12,15,20,0,0,74
1,14,7,5,12,19,0,0,0,58
1,14,7,5,12,19,8,9,16,91
1,14,7,5,12,21,19,5,19,103
1,14,7,5,18,0,0,0,0,45
1,14,7,5,18,5,4,0,0,54
1,14,7,5,18,9,14,7,0,75
1,14,7,5,18,12,5,19,19,100
1,14,7,5,18,12,25,0,0,82
1,14,7,9,1,0,0,0,0,32
1,14,7,9,3,15,0,0,0,49
1,14,7,9,9,20,9,19,0,88
1,14,7,9,12,4,0,0,0,47
1,14,7,9,12,9,0,0,0,52
1,14,7,9,12,15,0,0,0,58
1,14,7,9,14,1,0,0,0,46
1,14,7,9,14,1,12,0,0,58
1,14,7,9,14,1,19,0,0,65
1,14,7,9,14,15,9,4,0,73
1,14,7,9,14,15,19,5,0,84
1,14,7,9,14,15,21,19,0,100
1,14,7,9,15,3,1,18,16,84
1,14,7,9,15,3,25,19,20,113
1,14,7,9,15,7,5,14,25,97
1,14,7,9,15,7,18,1,13,85
1,14,7,9,15,9,4,0,0,59
1,14,7,9,15,12,9,20,8,95
1,14,7,9,15,12,15,7,25,105
1,14,7,9,15,13,1,0,0,60
1,14,7,9,15,13,1,19,0,79
1,14,7,9,15,13,1,20,1,81
1,14,7,9,15,14,15,13,1,89
1,14,7,9,15,19,9,19,0,93
1,14,7,9,15,20,15,13,5,99
1,14,7,9,15,20,15,13,25,119
1,14,7,9,16,15,18,20,0,100
1,14,7,11,8,1,11,0,0,53
1,14,7,12,1,9,19,5,0,68
1,14,7,12,5,4,0,0,0,43
1,14,7,12,5,4,15,7,0,65
1,14,7,12,5,8,15,15,11,88
1,14,7,12,5,16,15,4,0,74
1,14,7,12,5,16,15,4,19,93
1,14,7,12,5,18,0,0,0,57
1,14,7,12,5,18,19,0,0,76
1,14,7,12,5,19,9,20,5,92
1,14,7,12,5,23,9,14,7,92
1,14,7,12,5,23,9,19,5,95
1,14,7,12,5,23,15,18,13,108
1,14,7,12,9,1,5,0,0,49
1,14,7,12,9,1,14,19,0,77
1,14,7,12,9,3,1,14,19,80
1,14,7,12,9,14,7,0,0,64
1,14,7,12,9,14,7,19,0,83
1,14,7,12,15,9,4,0,0,62
1,14,7,15,0,0,0,0,0,37
1,14,7,15,9,19,5,0,0,70
1,14,7,15,12,1,14,0,0,64
1,14,7,15,12,1,14,19,0,83
1,14,7,15,12,1,18,0,0,68
1,14,7,15,18,0,0,0,0,55
1,14,7,15,18,1,19,0,0,75
1,14,7,18,25,0,0,0,0,65
1,14,7,18,9,5,18,0,0,72
1,14,7,18,9,5,19,20,0,93
1,14,7,18,9,12,25,0,0,86
1,14,7,18,9,14,5,19,19,106
1,14,7,18,9,20,5,0,0,74
1,14,7,19,20,0,0,0,0,61
1,14,7,19,20,5,18,0,0,84
1,14,7,19,20,18,15,13,19,126
1,14,7,19,20,19,0,0,0,80
1,14,7,21,9,4,0,0,0,56
1,14,7,21,9,6,15,18,13,104
1,14,7,21,9,12,12,5,0,81
1,14,7,21,9,14,5,0,0,71
1,14,7,21,9,14,5,1,12,84
1,14,7,21,9,16,5,4,0,77
1,14,7,21,9,19,8,0,0,79
1,14,7,21,9,19,8,5,4,88
1,14,7,21,9,19,8,5,19,103
1,14,7,21,12,1,0,0,0,56
1,14,7,21,12,1,18,0,0,74
1,14,7,21,12,1,18,5,0,79
1,14,7,21,12,1,18,9,1,84
1,14,7,21,12,1,18,12,25,111
1,14,7,21,12,1,20,5,0,81
1,14,7,21,12,1,20,5,4,85
1,14,7,21,12,1,20,5,19,100
1,14,7,21,12,5,0,0,0,60
1,14,7,21,12,15,19,5,0,94
1,14,7,21,12,15,21,19,0,110
1,14,7,21,12,21,19,0,0,95
1,14,7,21,18,9,1,0,0,71
1,14,7,21,19,5,19,0,0,86
1,14,7,21,19,20,0,0,0,82
1,14,7,21,19,20,1,20,5,108
1,14,7,21,19,20,9,1,0,92
1,14,7,21,19,20,21,18,1,122
1,14,7,23,9,3,8,0,0,65
1,14,8,1,12,9,14,5,0,64
1,14,8,1,12,15,14,9,14,88
1,14,8,1,14,7,0,0,0,45
1,14,8,5,4,15,14,9,1,71
1,14,8,5,4,15,14,9,3,73
1,14,8,5,4,18,1,12,0,63
1,14,8,5,4,18,15,14,0,79
1,14,8,5,12,5,0,0,0,45
1,14,8,5,12,15,19,5,0,79
1,14,8,5,12,15,21,19,0,95
1,14,8,25,4,0,0,0,0,52
1,14,8,25,4,18,1,20,5,96
1,14,8,25,4,18,9,3,0,82
1,14,8,25,4,18,9,4,5,88
1,14,8,25,4,18,9,20,5,104
1,14,8,25,4,18,9,26,5,110
1,14,8,25,4,18,15,21,19,125
1,14,8,9,13,1,0,0,0,46
1,14,8,9,14,7,1,0,0,54
1,14,8,9,14,7,1,19,0,73
1,14,8,9,19,20,9,3,0,83
1,14,8,9,19,20,15,21,19,126
1,14,8,21,14,7,18,25,0,108
1,14,25,2,15,4,25,0,0,86
1,14,25,2,15,4,25,4,0,90
1,14,25,2,15,4,9,5,19,94
1,14,9,3,3,1,0,0,0,31
1,14,9,3,15,14,9,3,0,68
1,14,9,3,15,14,9,19,13,97
1,14,9,3,21,12,1,18,0,79
1,14,9,3,21,20,0,0,0,68
1,14,9,4,9,1,14,0,0,52
1,14,9,4,18,15,19,9,19,108
1,14,9,5,14,20,5,0,0,68
1,14,9,5,14,20,9,19,5,96
1,14,9,7,8,0,0,0,0,39
1,14,9,7,8,20,0,0,0,59
1,14,9,7,8,20,19,0,0,78
1,14,25,8,15,23,0,0,0,86
1,14,9,12,1,15,0,0,0,52
1,14,9,12,1,21,0,0,0,58
1,14,9,12,5,0,0,0,0,41
1,14,9,12,5,14,5,19,19,98
1,14,9,12,9,3,0,0,0,48
1,14,9,12,9,4,0,0,0,49
1,14,9,12,9,4,5,0,0,54
1,14,9,12,9,4,9,3,0,61
1,14,9,12,9,9,4,0,0,58
1,14,9,12,9,14,0,0,0,59
1,14,9,12,9,14,5,0,0,64
1,14,9,12,9,14,5,19,0,83
1,14,9,12,9,14,7,21,19,106
1,14,9,12,9,14,9,19,13,100
1,14,9,12,9,14,15,0,0,74
1,14,9,12,9,14,19,0,0,78
1,14,9,12,9,20,25,0,0,90
1,14,9,12,9,20,9,5,19,98
1,14,9,12,12,1,0,0,0,49
1,14,9,12,19,0,0,0,0,55
1,14,9,13,0,0,0,0,0,37
1,14,9,13,1,0,0,0,0,38
1,14,9,13,1,2,12,5,0,57
1,14,9,13,1,3,21,12,5,79
1,14,9,13,1,12,0,0,0,50
1,14,9,13,1,12,1,0,0,51
1,14,9,13,1,12,9,1,14,74
1,14,9,13,1,12,9,3,0,62
1,14,9,13,1,12,9,5,18,82
1,14,9,13,1,12,9,19,5,83
1,14,9,13,1,12,9,19,8,86
1,14,9,13,1,12,9,19,13,91
1,14,9,13,1,12,9,19,20,98
1,14,9,13,1,12,9,20,25,104
1,14,9,13,1,12,9,26,5,90
1,14,9,13,1,12,12,25,0,87
1,14,9,13,1,12,19,0,0,69
1,14,9,13,1,14,4,15,0,71
1,14,9,13,1,14,20,0,0,72
1,14,9,13,1,19,20,9,3,89
1,14,9,13,1,20,5,0,0,63
1,14,9,13,1,20,5,4,0,67
1,14,9,13,1,20,5,12,25,100
1,14,9,13,1,20,5,18,0,81
1,14,9,13,1,20,5,18,19,100
1,14,9,13,1,20,5,19,0,82
1,14,9,13,1,20,9,14,7,88
1,14,9,13,1,20,9,15,14,96
1,14,9,13,1,20,9,19,13,99
1,14,9,13,1,20,9,19,20,106
1,14,9,13,1,20,9,22,5,94
1,14,9,13,1,20,15,0,0,73
1,14,9,13,1,20,15,18,0,91
1,14,9,13,1,20,15,18,19,110
1,14,9,13,5,0,0,0,0,42
1,14,9,13,5,19,0,0,0,61
1,14,9,13,5,20,20,1,0,83
1,14,9,13,9,0,0,0,0,46
1,14,9,13,9,11,9,20,5,91
1,14,9,13,9,14,5,0,0,65
1,14,9,13,9,19,0,0,0,65
1,14,9,13,9,19,13,0,0,78
1,14,9,13,9,19,13,19,0,97
1,14,9,13,9,19,20,0,0,85
1,14,9,13,9,19,20,9,3,97
1,14,9,13,9,19,20,19,0,104
1,14,9,13,9,26,5,0,0,77
1,14,9,13,9,26,5,4,0,81
1,14,9,13,15,0,0,0,0,52
1,14,25,13,15,18,5,0,0,91
1,14,9,13,15,19,5,0,0,76
1,14,9,13,15,19,9,20,25,125
1,14,9,13,15,19,15,0,0,86
1,14,9,13,15,21,19,0,0,92
1,14,9,13,21,19,0,0,0,77
1,14,9,13,21,19,5,19,0,101
1,14,9,15,14,0,0,0,0,53
1,14,25,15,14,5,0,0,0,74
1,14,9,15,14,9,3,0,0,65
1,14,9,15,14,9,3,19,0,84
1,14,9,15,14,19,0,0,0,72
1,14,25,16,12,1,3,5,0,77
1,14,9,18,9,4,9,1,0,65
1,14,9,19,1,4,15,0,0,63
1,14,9,19,1,12,0,0,0,56
1,14,9,19,1,13,9,4,5,75
1,14,9,19,1,20,5,0,0,69
1,14,9,19,1,20,5,4,0,73
1,14,9,19,5,0,0,0,0,48
1,14,9,19,5,5,4,0,0,57
1,14,9,19,5,5,4,19,0,76
1,14,9,19,5,12,9,11,5,85
1,14,9,19,5,18,15,15,20,116
1,14,9,19,5,19,0,0,0,67
1,14,9,19,5,20,20,5,0,93
1,14,9,19,5,20,20,5,19,112
1,14,9,19,9,3,0,0,0,55
1,14,9,19,9,4,9,14,0,79
1,14,9,19,9,4,9,14,5,84
1,14,9,19,9,4,9,14,15,94
1,14,9,19,9,12,0,0,0,64
1,14,9,19,25,12,0,0,0,80
1,14,9,19,9,12,9,3,0,76
1,14,9,19,15,4,15,14,20,111
1,14,9,19,15,7,1,13,25,104
1,14,9,19,15,7,5,14,25,109
1,14,9,19,15,25,12,0,0,95
1,14,9,19,15,9,14,0,0,81
1,14,9,19,15,12,0,0,0,70
1,14,9,19,15,12,5,0,0,75
1,14,9,19,15,12,5,19,0,94
1,14,9,19,15,16,9,1,0,84
1,14,9,19,15,16,15,4,0,93
1,14,9,19,21,13,0,0,0,77
1,14,9,19,21,18,9,1,0,92
1,14,9,20,8,5,18,0,0,75
1,14,25,20,8,9,14,7,0,98
1,14,25,20,8,9,14,7,19,117
1,14,25,20,9,13,5,0,0,87
1,14,9,20,15,19,0,0,0,78
1,14,25,23,1,25,0,0,0,89
1,14,25,23,1,25,19,0,0,108
1,14,25,23,8,5,14,0,0,90
1,14,25,23,8,5,14,3,5,98
1,14,25,23,8,5,18,5,0,99
1,14,25,23,8,5,18,5,19,118
1,14,25,23,8,25,0,0,0,96
1,14,25,23,9,19,5,0,0,96
1,14,25,23,9,20,8,5,18,123
1,14,10,1,14,0,0,0,0,40
1,14,11,5,5,0,0,0,0,36
1,14,11,5,18,0,0,0,0,49
1,14,11,5,18,8,15,12,4,88
1,14,11,5,18,9,20,5,0,83
1,14,11,5,18,9,20,5,19,102
1,14,11,8,0,0,0,0,0,34
1,14,11,8,19,0,0,0,0,53
1,14,11,25,12,15,19,0,0,97
1,14,11,25,12,15,19,5,0,102
1,14,11,25,12,15,19,5,4,106
1,14,11,25,12,15,19,5,19,121
1,14,11,25,12,15,19,9,19,125
1,14,11,25,12,15,20,9,1,108
1,14,11,25,12,15,20,9,3,110
1,14,11,25,18,15,9,4,0,97
1,14,11,12,5,0,0,0,0,43
1,14,11,12,5,2,15,14,5,79
1,14,11,12,5,4,0,0,0,47
1,14,11,12,5,10,1,3,11,68
1,14,11,12,5,19,0,0,0,62
1,14,11,12,5,20,0,0,0,63
1,14,11,12,5,20,19,0,0,82
1,14,11,12,9,14,7,0,0,68
1,14,11,12,15,14,7,0,0,74
1,14,11,12,21,14,7,0,0,80
1,14,11,21,19,0,0,0,0,66
1,14,11,21,19,5,19,0,0,90
1,14,11,21,19,8,0,0,0,74
1,14,11,21,19,8,1,0,0,75
1,14,11,21,19,8,5,19,0,98
1,14,12,1,3,5,0,0,0,36
1,14,12,1,3,5,19,0,0,55
1,14,12,1,7,5,14,0,0,54
1,14,12,1,7,5,19,0,0,59
1,14,12,1,19,0,0,0,0,47
1,14,12,1,19,5,19,0,0,71
1,14,12,1,21,20,0,0,0,69
1,14,12,1,21,20,5,0,0,74
1,14,12,5,20,0,0,0,0,52
1,14,12,9,1,0,0,0,0,37
1,14,13,9,1,0,0,0,0,38
1,14,14,1,12,0,0,0,0,42
1,14,14,1,12,25,0,0,0,67
1,14,14,1,12,9,1,0,0,52
1,14,14,1,12,9,14,5,0,70
1,14,14,1,12,9,19,13,0,83
1,14,14,1,12,9,19,20,0,90
1,14,14,1,12,9,19,20,19,109
1,14,14,1,12,9,26,5,0,82
1,14,14,1,12,19,0,0,0,61
1,14,14,1,18,4,0,0,0,52
1,14,14,1,18,25,0,0,0,73
1,14,14,1,19,0,0,0,0,49
1,14,14,1,20,0,0,0,0,50
1,14,14,1,20,5,19,0,0,74
1,14,14,1,20,19,0,0,0,69
1,14,14,1,20,20,15,0,0,85
1,14,14,1,20,20,15,19,0,104
1,14,14,5,1,12,0,0,0,47
1,14,14,5,1,12,5,4,0,56
1,14,14,5,1,12,5,18,0,70
1,14,14,5,1,12,5,18,19,89
1,14,14,5,1,12,9,14,7,77
1,14,14,5,1,12,19,0,0,66
1,14,14,5,3,20,0,0,0,57
1,14,14,5,3,20,1,14,20,92
1,14,14,5,3,20,5,14,20,96
1,14,14,5,3,20,9,15,14,95
1,14,14,5,12,9,4,0,0,59
1,14,14,5,12,9,4,1,14,74
1,14,14,5,12,9,4,19,0,78
1,14,14,5,12,9,19,13,0,87
1,14,14,5,12,15,9,4,0,74
1,14,14,5,18,18,5,0,0,75
1,14,14,5,20,0,0,0,0,54
1,14,14,5,24,0,0,0,0,58
1,14,14,5,24,1,0,0,0,59
1,14,14,5,24,1,2,12,5,78
1,14,14,5,24,1,12,0,0,71
1,14,14,5,24,5,0,0,0,63
1,14,14,5,24,5,4,0,0,67
1,14,14,5,24,5,18,0,0,81
1,14,14,5,24,5,19,0,0,82
1,14,14,5,24,9,14,7,0,88
1,14,14,5,24,9,15,14,0,96
1,14,14,5,24,9,20,9,19,115
1,14,14,5,24,9,22,5,0,94
1,14,14,5,24,13,5,14,20,110
1,14,14,5,24,21,18,5,0,102
1,14,14,9,3,21,20,0,0,82
1,14,14,9,4,1,12,9,14,78
1,14,14,9,8,9,12,0,0,67
1,14,14,9,20,5,0,0,0,63
1,14,14,9,22,0,0,0,0,60
1,14,14,9,22,5,18,19,5,107
1,14,14,15,0,0,0,0,0,44
1,14,14,15,4,1,20,5,4,78
1,14,14,15,25,0,0,0,0,69
1,14,14,15,25,1,14,3,5,92
1,14,14,15,25,5,4,0,0,78
1,14,14,15,25,5,18,0,0,92
1,14,14,15,25,5,18,19,0,111
1,14,14,15,25,6,21,12,0,108
1,14,14,15,25,9,14,7,0,99
1,14,14,15,25,13,5,14,20,121
1,14,14,15,25,15,21,19,0,124
1,14,14,15,25,19,0,0,0,88
1,14,14,15,14,3,5,0,0,66
1,14,14,15,20,0,0,0,0,64
1,14,14,15,20,1,20,5,0,90
1,14,14,15,20,1,20,5,4,94
1,14,14,15,20,1,20,5,18,108
1,14,14,15,20,1,20,5,19,109
1,14,14,15,20,1,20,15,18,118
1,14,14,15,20,9,14,5,0,92
1,14,14,15,20,20,15,0,0,99
1,14,14,15,21,14,3,5,0,87
1,14,14,15,21,14,3,5,4,91
1,14,14,15,21,14,3,5,18,105
1,14,14,15,21,14,3,5,19,106
1,14,14,21,1,12,0,0,0,63
1,14,14,21,1,12,9,19,20,111
1,14,14,21,1,12,9,26,5,103
1,14,14,21,1,12,12,25,0,100
1,14,14,21,1,12,19,0,0,82
1,14,14,21,1,18,25,0,0,94
1,14,14,21,1,20,9,15,14,109
1,14,14,21,5,12,5,18,0,90
1,14,14,21,5,12,12,5,18,102
1,14,14,21,5,14,20,0,0,89
1,14,14,21,9,20,1,14,20,114
1,14,14,21,9,20,25,0,0,104
1,14,14,21,9,20,9,5,19,112
1,14,14,21,12,0,0,0,0,62
1,14,14,21,12,1,18,0,0,81
1,14,14,21,12,1,18,25,0,106
1,14,14,21,12,1,18,12,25,118
1,14,14,21,12,1,20,5,0,88
1,14,14,21,12,1,20,5,4,92
1,14,14,21,12,5,0,0,0,67
1,14,14,21,12,5,18,0,0,85
1,14,14,21,12,5,20,0,0,87
1,14,14,21,12,5,20,19,0,106
1,14,14,21,12,9,0,0,0,71
1,14,14,21,12,9,19,13,0,103
1,14,14,21,12,12,1,20,5,100
1,14,14,21,12,12,5,4,0,83
1,14,14,21,12,12,5,18,0,97
1,14,14,21,12,12,9,0,0,83
1,14,14,21,12,12,9,14,7,104
1,14,14,21,12,13,5,14,20,114
1,14,14,21,12,15,9,4,0,90
1,14,14,21,12,15,19,1,14,111
1,14,14,21,12,15,19,5,0,101
1,14,14,21,12,19,0,0,0,81
1,14,14,21,12,21,19,0,0,102
1,14,14,21,12,21,19,5,19,126
1,14,14,21,13,0,0,0,0,63
1,14,14,21,19,0,0,0,0,69
1,14,15,1,0,0,0,0,0,31
1,14,15,1,19,0,0,0,0,50
1,14,15,2,9,14,7,0,0,62
1,14,15,4,1,12,0,0,0,47
1,14,15,4,1,12,12,25,0,84
1,14,15,4,5,0,0,0,0,39
1,14,15,4,5,19,0,0,0,58
1,14,15,4,9,3,0,0,0,46
1,14,15,4,9,14,5,0,0,62
1,14,15,4,25,14,5,0,0,78
1,14,15,4,25,14,5,19,0,97
1,14,15,4,25,14,9,1,0,83
1,14,15,4,25,14,9,3,0,85
1,14,15,4,25,14,15,21,19,128
1,14,15,4,9,26,5,0,0,74
1,14,15,4,9,26,5,4,0,78
1,14,15,4,9,26,5,19,0,93
1,14,15,4,9,26,9,14,7,99
1,14,15,4,15,14,20,9,1,93
1,14,15,4,15,19,0,0,0,68
1,14,15,5,19,9,1,0,0,64
1,14,15,5,19,9,19,0,0,82
1,14,15,5,19,20,18,21,13,126
1,14,15,5,19,20,18,21,19,132
1,14,15,5,20,9,3,0,0,67
1,14,15,7,5,14,9,3,0,68
1,14,15,9,1,0,0,0,0,40
1,14,15,9,12,0,0,0,0,51
1,14,15,9,14,5,0,0,0,58
1,14,15,9,14,20,0,0,0,73
1,14,15,9,14,20,5,4,0,82
1,14,15,9,14,20,5,18,0,96
1,14,15,9,14,20,5,18,19,115
1,14,15,9,14,20,9,14,7,103
1,14,15,9,14,20,19,0,0,92
1,14,15,12,5,0,0,0,0,47
1,14,15,12,5,19,0,0,0,66
1,14,15,12,9,0,0,0,0,51
1,14,15,12,9,1,14,0,0,66
1,14,15,12,25,20,5,0,0,92
1,14,15,12,25,20,5,19,0,111
1,14,15,13,1,12,0,0,0,56
1,14,15,13,1,12,25,0,0,81
1,14,15,13,1,12,9,5,19,89
1,14,15,13,1,12,9,19,13,97
1,14,15,13,1,12,9,19,20,104
1,14,15,13,1,12,15,21,19,111
1,14,15,13,1,12,21,18,5,100
1,14,15,13,5,18,0,0,0,66
1,14,15,13,25,0,0,0,0,68
1,14,15,13,9,3,0,0,0,55
1,14,15,13,9,5,0,0,0,57
1,14,15,13,9,5,19,0,0,76
1,14,15,13,9,20,5,0,0,77
1,14,15,13,15,4,15,14,20,111
1,14,15,13,15,21,18,1,14,112
1,14,15,13,21,18,1,12,0,95
1,14,15,13,21,18,1,14,0,97
1,14,15,13,21,18,15,21,19,137
1,14,15,14,0,0,0,0,0,44
1,14,15,14,1,4,0,0,0,49
1,14,15,14,1,14,7,0,0,66
1,14,15,14,3,9,12,12,15,95
1,14,15,14,25,3,8,9,1,90
1,14,15,14,25,13,0,0,0,82
1,14,15,14,25,13,1,0,0,83
1,14,15,14,25,13,5,0,0,87
1,14,15,14,25,13,9,20,25,136
1,14,15,14,25,13,15,21,19,137
1,14,15,14,25,13,19,0,0,101
1,14,15,14,15,12,0,0,0,71
1,14,15,15,16,19,9,1,0,90
1,14,15,15,16,19,9,1,19,109
1,14,15,16,8,5,12,5,0,76
1,14,15,16,8,25,20,5,0,104
1,14,15,16,8,15,18,9,1,97
1,14,15,16,9,1,0,0,0,56
1,14,15,16,9,1,19,0,0,75
1,14,15,16,19,25,0,0,0,90
1,14,15,16,19,9,1,0,0,75
1,14,15,16,19,9,1,19,0,94
1,14,15,16,21,2,9,3,0,81
1,14,15,18,1,11,0,0,0,60
1,14,15,18,1,11,19,0,0,79
1,14,15,18,3,8,9,0,0,68
1,14,15,18,3,8,9,1,0,69
1,14,15,18,3,8,9,19,13,100
1,14,15,18,3,8,15,21,19,114
1,14,15,18,3,8,21,19,0,99
1,14,15,18,5,3,20,1,12,89
1,14,15,18,5,3,20,9,3,88
1,14,15,18,5,20,9,3,0,85
1,14,15,18,5,24,25,0,0,102
1,14,15,18,5,24,9,1,0,87
1,14,15,18,5,24,9,1,19,106
1,14,15,18,5,24,9,3,0,89
1,14,15,18,5,24,9,3,19,108
1,14,15,18,5,24,9,5,19,110
1,14,15,18,7,1,14,1,0,71
1,14,15,18,7,1,14,9,3,82
1,14,15,18,13,1,12,0,0,74
1,14,15,18,14,0,0,0,0,62
1,14,15,18,20,8,0,0,0,76
1,14,15,18,20,8,9,3,0,88
1,14,15,18,20,8,9,20,5,110
1,14,15,18,20,8,15,19,5,115
1,14,15,19,3,15,16,5,0,88
1,14,15,19,3,15,16,25,0,108
1,14,15,19,13,1,20,9,3,95
1,14,15,19,13,9,1,0,0,72
1,14,15,19,13,9,1,19,0,91
1,14,15,19,13,9,3,0,0,74
1,14,15,19,16,9,14,1,12,101
1,14,15,19,20,15,19,9,19,131
1,14,15,20,5,18,9,20,5,107
1,14,15,20,9,1,0,0,0,60
1,14,15,20,18,15,16,9,1,109
1,14,15,20,20,1,0,0,0,71
1,14,15,20,20,15,0,0,0,85
1,14,15,20,21,19,0,0,0,90
1,14,15,21,14,15,21,0,0,101
1,14,15,21,18,0,0,0,0,69
1,14,15,21,18,1,0,0,0,70
1,14,15,21,18,5,0,0,0,74
1,14,15,21,18,15,21,19,0,124
1,14,15,22,21,12,1,14,20,120
1,14,15,22,21,12,1,18,0,104
1,14,15,24,1,5,13,9,1,83
1,14,15,24,1,5,13,9,3,85
1,14,15,24,5,13,9,1,0,82
1,14,15,24,5,13,9,1,19,101
1,14,15,24,5,13,9,3,0,84
1,14,15,24,9,1,0,0,0,64
1,14,15,24,9,1,19,0,0,83
1,14,15,24,9,3,0,0,0,66
1,14,17,21,5,18,1,0,0,77
1,14,18,5,0,0,0,0,0,38
1,14,19,0,0,0,0,0,0,34
1,14,19,1,0,0,0,0,0,35
1,14,19,1,5,0,0,0,0,40
1,14,19,1,20,5,0,0,0,60
1,14,19,1,20,5,4,0,0,64
1,14,19,1,20,9,15,14,0,93
1,14,19,5,18,1,20,5,4,87
1,14,19,5,18,9,14,0,0,80
1,14,19,5,18,9,14,5,0,85
1,14,19,5,18,9,14,5,19,104
1,14,19,5,18,15,21,19,0,112
1,14,19,20,15,19,19,0,0,107
1,14,19,20,15,19,19,5,0,112
1,14,19,21,0,0,0,0,0,55
1,14,19,21,12,1,20,5,0,93
1,14,19,23,5,18,0,0,0,80
1,14,19,23,5,18,5,4,0,89
1,14,19,23,5,18,5,18,0,103
1,14,19,23,5,18,5,18,19,122
1,14,19,23,5,18,9,14,7,110
1,14,19,23,5,18,19,0,0,99
1,14,20,0,0,0,0,0,0,35
1,14,20,1,3,9,4,0,0,52
1,14,20,1,3,9,4,19,0,71
1,14,20,1,3,18,9,4,0,70
1,14,20,1,5,0,0,0,0,41
1,14,20,1,7,15,14,25,0,97
1,14,20,1,12,7,9,3,0,67
1,14,20,1,12,7,9,3,19,86
1,14,20,1,12,7,15,12,0,82
1,14,20,1,12,11,1,12,9,81
1,14,20,1,14,5,13,9,3,80
1,14,20,1,16,5,24,0,0,81
1,14,20,1,16,5,24,5,19,105
1,14,20,1,16,9,3,5,19,88
1,14,20,1,16,15,3,8,1,79
1,14,20,1,18,1,12,1,0,68
1,14,20,1,18,1,14,7,1,77
1,14,20,1,18,3,8,25,0,90
1,14,20,1,19,0,0,0,0,55
1,14,20,2,9,18,4,0,0,68
1,14,20,4,15,13,0,0,0,67
1,14,20,5,0,0,0,0,0,40
1,14,20,5,1,3,20,0,0,64
1,14,20,5,1,12,0,0,0,53
1,14,20,5,1,20,5,18,0,84
1,14,20,5,1,20,5,18,19,103
1,14,20,5,2,1,20,8,0,71
1,14,20,5,3,5,4,1,12,65
1,14,20,5,3,5,4,5,0,57
1,14,20,5,3,5,4,5,4,61
1,14,20,5,3,5,4,5,19,76
1,14,20,5,3,5,12,12,0,72
1,14,20,5,3,8,15,9,18,93
1,14,20,5,3,15,12,9,3,82
1,14,20,5,3,15,18,14,21,111
1,14,20,5,3,15,21,18,20,117
1,14,20,5,3,15,24,1,12,95
1,14,20,5,4,0,0,0,0,44
1,14,20,5,4,1,20,5,0,70
1,14,20,5,4,1,20,5,4,74
1,14,20,5,4,1,20,5,19,89
1,14,20,5,4,1,23,14,0,82
1,14,20,5,4,15,14,9,14,96
1,14,20,5,5,4,0,0,0,49
1,14,20,5,6,1,3,20,0,70
1,14,20,5,6,9,24,0,0,79
1,14,20,5,6,9,24,1,0,80
1,14,20,5,6,9,24,1,12,92
1,14,20,5,6,9,24,5,19,103
1,14,20,5,6,21,18,3,1,89
1,14,20,5,7,18,1,4,5,75
1,14,20,5,8,1,12,12,0,73
1,14,20,5,8,21,13,1,14,97
1,14,20,5,9,14,7,0,0,70
1,14,20,5,12,5,7,1,12,77
1,14,20,5,12,15,16,5,0,88
1,14,20,5,12,15,16,5,19,107
1,14,20,5,12,21,3,1,14,91
1,14,20,5,12,21,4,5,0,82
1,14,20,5,13,1,19,11,0,84
1,14,20,5,13,5,20,9,3,90
1,14,20,5,13,21,18,1,12,105
1,14,20,5,14,1,20,1,12,88
1,14,20,5,14,1,20,9,0,84
1,14,20,5,14,1,20,21,19,115
1,14,20,5,14,1,22,5,0,82
1,14,20,5,14,14,1,0,0,69
1,14,20,5,14,14,1,5,0,74
1,14,20,5,14,14,1,12,0,81
1,14,20,5,14,14,1,18,25,112
1,14,20,5,14,14,1,19,0,88
1,14,20,5,14,14,1,20,5,94
1,14,20,5,14,14,21,12,1,102
1,14,20,5,14,14,21,12,5,106
1,14,20,5,14,15,4,1,12,86
1,14,20,5,14,15,15,14,0,98
1,14,20,5,16,1,19,20,0,96
1,14,20,5,16,1,19,20,19,115
1,14,20,5,16,15,14,5,0,90
1,14,20,5,16,15,18,3,8,100
1,14,20,5,16,15,18,20,0,109
1,14,20,5,17,21,1,12,13,104
1,14,20,5,18,7,9,3,0,77
1,14,20,5,18,9,0,0,0,67
1,14,20,5,18,9,1,4,0,72
1,14,20,5,18,9,14,0,0,81
1,14,20,5,18,9,15,18,0,100
1,14,20,5,18,9,15,18,19,119
1,14,20,5,18,15,15,13,0,101
1,14,20,5,18,15,15,13,19,120
1,14,20,5,19,0,0,0,0,59
1,14,20,5,20,8,5,13,0,86
1,14,20,5,20,25,16,5,0,106
1,14,20,5,20,25,16,5,19,125
1,14,20,5,22,5,18,20,0,105
1,14,20,5,22,5,18,20,19,124
1,14,20,5,23,1,18,0,0,82
1,14,20,8,4,9,1,0,0,57
1,14,20,8,5,12,1,0,0,61
1,14,20,8,5,12,1,5,0,66
1,14,20,8,5,12,9,1,0,70
1,14,20,8,5,12,9,15,14,98
1,14,20,8,5,12,9,24,0,93
1,14,20,8,5,13,0,0,0,61
1,14,20,8,5,13,1,0,0,62
1,14,20,8,5,13,1,19,0,81
1,14,20,8,5,13,1,20,1,83
1,14,20,8,5,13,5,4,0,70
1,14,20,8,5,13,5,14,5,85
1,14,20,8,5,13,25,0,0,86
1,14,20,8,5,13,9,1,0,71
1,14,20,8,5,13,9,14,7,91
1,14,20,8,5,13,9,15,14,99
1,14,20,8,5,13,19,0,0,80
1,14,20,8,5,18,0,0,0,66
1,14,20,8,5,18,1,12,0,79
1,14,20,8,5,18,9,4,0,79
1,14,20,8,5,18,9,4,19,98
1,14,20,8,5,18,9,14,5,94
1,14,20,8,5,18,15,9,4,94
1,14,20,8,5,18,19,0,0,85
1,14,20,8,5,19,5,19,0,91
1,14,20,8,5,19,9,19,0,95
1,14,20,8,9,12,12,0,0,76
1,14,20,8,9,12,12,19,0,95
1,14,20,8,9,14,5,0,0,71
1,14,20,8,15,2,9,1,14,84
1,14,20,8,15,3,1,18,16,96
1,14,20,8,15,3,25,1,14,101
1,14,20,8,15,4,9,1,0,72
1,14,20,8,15,4,9,21,13,105
1,14,20,8,15,9,4,0,0,71
1,14,20,8,15,11,25,1,14,109
1,14,20,8,15,12,0,0,0,70
1,14,20,8,15,12,9,20,5,104
1,14,20,8,15,12,15,7,25,117
1,14,20,8,15,15,4,0,0,77
1,14,20,8,15,18,9,14,5,104
1,14,20,8,15,19,0,0,0,77
1,14,20,8,15,20,1,24,25,128
1,14,20,8,15,26,15,1,14,114
1,14,20,8,15,26,15,9,3,111
1,14,20,8,15,26,15,15,14,128
1,14,20,8,18,1,3,5,19,89
1,14,20,8,18,1,3,9,1,75
1,14,20,8,18,1,3,9,3,77
1,14,20,8,18,1,3,25,12,102
1,14,20,8,18,1,3,9,14,88
1,14,20,8,18,1,12,9,14,97
1,14,20,8,18,1,13,9,14,98
1,14,20,8,18,1,14,9,12,97
1,14,20,8,18,1,14,25,12,113
1,14,20,8,18,1,14,15,12,103
1,14,20,8,18,1,24,0,0,86
1,14,20,8,18,9,2,9,4,85
1,14,20,8,18,25,12,0,0,98
1,14,20,8,18,15,9,3,0,88
1,14,20,8,18,15,12,0,0,88
1,14,20,8,18,15,14,5,0,95
1,14,20,8,18,15,16,0,0,92
1,14,20,8,18,15,16,9,3,104
1,14,20,8,18,15,16,15,12,119
1,14,20,8,18,15,24,1,14,115
1,14,20,9,1,2,18,9,14,88
1,14,20,9,1,3,9,4,0,61
1,14,20,9,1,5,0,0,0,50
1,14,20,9,1,7,5,18,0,75
1,14,20,9,1,12,9,5,14,85
1,14,20,9,1,18,0,0,0,63
1,14,20,9,1,18,9,14,0,86
1,14,20,9,1,18,9,14,19,105
1,14,20,9,1,18,19,0,0,82
1,14,20,9,1,20,15,13,0,93
1,14,20,9,1,20,15,13,19,112
1,14,20,9,1,21,24,9,14,113
1,14,20,9,2,1,12,13,0,72
1,14,20,9,2,1,14,11,0,72
1,14,20,9,2,9,1,19,0,75
1,14,20,9,2,9,15,14,20,104
1,14,20,9,2,12,1,3,11,73
1,14,20,9,2,12,15,3,11,87
1,14,20,9,2,12,21,5,0,84
1,14,20,9,2,15,4,25,0,90
1,14,20,9,2,15,19,19,0,99
1,14,20,9,2,21,7,0,0,74
1,14,20,9,3,0,0,0,0,47
1,14,20,9,3,1,0,0,0,48
1,14,20,9,3,1,12,0,0,60
1,14,20,9,3,1,12,12,25,97
1,14,20,9,3,1,18,0,0,66
1,14,20,9,3,1,19,20,5,92
1,14,20,9,3,8,12,15,18,100
1,14,20,9,3,25,14,9,3,98
1,14,20,9,3,9,20,25,0,101
1,14,20,9,3,9,22,9,3,90
1,14,20,9,3,9,22,9,12,99
1,14,20,9,3,9,26,5,0,87
1,14,20,9,3,11,0,0,0,58
1,14,20,9,3,11,5,4,0,67
1,14,20,9,3,11,5,18,0,81
1,14,20,9,3,11,9,14,7,88
1,14,20,9,3,11,19,0,0,77
1,14,20,9,3,11,20,0,0,78
1,14,20,9,3,12,25,0,0,84
1,14,20,9,3,12,9,14,5,87
1,14,20,9,3,14,5,19,19,104
1,14,20,9,3,15,4,15,14,95
1,14,20,9,3,15,12,4,0,78
1,14,20,9,3,15,12,9,3,86
1,14,20,9,3,15,13,5,20,100
1,14,20,9,3,15,18,0,0,80
1,14,20,9,3,15,18,14,0,94
1,14,20,9,3,15,21,18,20,121
1,14,20,9,3,15,21,19,0,102
1,14,20,9,3,18,5,5,16,91
1,14,20,9,3,18,9,13,5,92
1,14,20,9,3,19,0,0,0,66
1,14,20,9,3,21,12,20,0,100
1,14,20,9,3,21,13,0,0,81
1,14,20,9,3,21,19,0,0,87
1,14,20,9,4,9,14,9,3,83
1,14,20,9,4,15,18,1,0,82
1,14,20,9,4,15,18,15,14,110
1,14,20,9,4,15,20,1,12,96
1,14,20,9,4,15,20,5,0,88
1,14,20,9,4,15,20,5,4,92
1,14,20,9,4,15,20,5,19,107
1,14,20,9,4,18,1,6,20,93
1,14,20,9,4,18,1,7,0,74
1,14,20,9,4,18,15,13,25,119
1,14,20,9,4,18,21,7,0,94
1,14,20,9,4,21,11,5,0,85
1,14,20,9,5,14,20,0,0,83
1,14,20,9,6,1,3,5,0,59
1,14,20,9,6,1,13,5,0,69
1,14,20,9,6,1,20,0,0,71
1,14,20,9,6,5,12,15,14,96
1,14,20,9,6,9,18,5,0,82
1,14,20,9,6,12,1,19,8,90
1,14,20,9,6,12,21,24,0,107
1,14,20,9,6,15,1,13,0,79
1,14,20,9,6,15,23,12,0,100
1,14,20,9,6,18,1,21,4,94
1,14,20,9,6,18,15,19,20,122
1,14,20,9,7,1,25,0,0,77
1,14,20,9,7,5,14,0,0,70
1,14,20,9,7,5,14,5,0,75
1,14,20,9,7,5,14,5,19,94
1,14,20,9,7,5,14,9,3,82
1,14,20,9,7,5,14,19,0,89
1,14,20,9,7,12,1,18,5,87
1,14,20,9,7,15,4,0,0,70
1,14,20,9,7,18,1,6,20,96
1,14,20,9,7,18,1,16,8,94
1,14,20,9,7,21,14,0,0,86
1,14,20,9,8,5,12,9,24,102
1,14,20,9,8,5,18,15,0,90
1,14,20,9,8,21,6,6,0,85
1,14,20,9,8,21,13,0,0,86
1,14,20,9,8,21,13,1,14,101
1,14,20,9,10,1,13,0,0,68
1,14,20,9,11,9,14,7,0,85
1,14,20,9,11,9,14,7,19,104
1,14,20,9,11,14,15,3,11,98
1,14,20,9,12,1,2,15,18,92
1,14,20,9,12,1,16,19,5,97
1,14,20,9,12,5,1,11,0,73
1,14,20,9,12,5,6,20,0,87
1,14,20,9,12,5,13,9,3,86
1,14,20,9,12,5,14,19,0,94
1,14,20,9,12,9,6,5,0,76
1,14,20,9,12,9,6,20,0,91
1,14,20,9,12,25,19,9,14,123
1,14,20,9,12,25,19,9,19,128
1,14,20,9,12,25,20,9,3,113
1,14,20,9,12,15,7,0,0,78
1,14,20,9,12,15,7,25,0,103
1,14,20,9,12,15,7,9,3,90
1,14,20,9,12,15,7,19,0,97
1,14,20,9,12,15,17,21,25,134
1,14,20,9,13,1,12,5,0,75
1,14,20,9,13,1,14,0,0,72
1,14,20,9,13,1,18,11,0,87
1,14,20,9,13,1,19,11,0,88
1,14,20,9,13,1,19,11,19,107
1,14,20,9,13,5,18,5,0,85
1,14,20,9,13,5,18,5,19,104
1,14,20,9,13,5,18,9,3,92
1,14,20,9,13,5,19,9,1,91
1,14,20,9,13,5,19,15,14,110
1,14,20,9,13,5,20,5,18,105
1,14,20,9,13,15,4,5,12,93
1,14,20,9,13,15,14,25,0,111
1,14,20,9,13,15,14,9,3,98
1,14,20,9,13,15,14,9,4,99
1,14,20,9,13,15,14,25,12,123
1,14,20,9,13,15,18,1,12,103
1,14,20,9,14,5,7,18,15,103
1,14,20,9,14,7,0,0,0,65
1,14,20,9,14,7,19,0,0,84
1,14,20,9,14,9,1,12,0,80
1,14,20,9,14,9,15,14,0,96
1,14,20,9,14,15,4,1,12,90
1,14,20,9,14,15,4,5,0,82
1,14,20,9,14,15,4,5,19,101
1,14,20,9,14,15,9,19,5,106
1,14,20,9,14,15,13,5,0,91
1,14,20,9,14,15,13,25,0,111
1,14,20,9,14,15,13,9,3,98
1,14,20,9,14,15,22,5,12,112
1,14,20,9,14,21,11,5,0,95
1,14,20,9,15,4,15,14,20,112
1,14,20,9,15,16,9,21,13,118
1,14,20,9,16,1,16,1,12,90
1,14,20,9,16,1,18,20,0,99
1,14,20,9,16,1,19,19,0,99
1,14,20,9,16,1,19,20,9,109
1,14,20,9,16,1,19,20,15,115
1,14,20,9,16,1,20,8,25,114
1,14,20,9,16,5,4,1,12,82
1,14,20,9,16,8,1,19,5,93
1,14,20,9,16,8,15,14,0,97
1,14,20,9,16,8,15,14,1,98
1,14,20,9,16,8,15,14,25,122
1,14,20,9,16,8,15,14,19,116
1,14,20,9,16,25,9,3,0,97
1,14,20,9,16,25,9,3,19,116
1,14,20,9,16,9,12,12,0,93
1,14,20,9,16,25,18,25,12,140
1,14,20,9,16,25,18,9,14,126
1,14,20,9,16,15,4,1,12,92
1,14,20,9,16,15,4,5,0,84
1,14,20,9,16,15,4,9,3,91
1,14,20,9,16,15,12,1,18,106
1,14,20,9,16,15,12,5,0,92
1,14,20,9,16,15,12,5,19,111
1,14,20,9,16,15,12,15,0,102
1,14,20,9,16,15,15,12,0,102
1,14,20,9,16,15,16,5,0,96
1,14,20,9,16,15,16,5,19,115
1,14,20,9,16,15,20,0,0,95
1,14,20,9,16,18,9,13,5,105
1,14,20,9,16,18,9,19,13,119
1,14,20,9,16,21,4,9,3,97
1,14,20,9,17,0,0,0,0,61
1,14,20,9,17,21,1,0,0,83
1,14,20,9,17,21,1,18,25,126
1,14,20,9,17,21,1,20,5,108
1,14,20,9,17,21,5,0,0,87
1,14,20,9,17,21,5,4,0,91
1,14,20,9,17,21,5,12,25,124
1,14,20,9,17,21,5,18,0,105
1,14,20,9,17,21,5,18,19,124
1,14,20,9,17,21,5,19,0,106
1,14,20,9,17,21,9,14,7,112
1,14,20,9,17,21,9,19,20,130
1,14,20,9,17,21,9,20,25,136
1,14,20,9,17,21,21,13,0,116
1,14,20,9,18,1,2,9,3,77
1,14,20,9,18,1,3,5,18,89
1,14,20,9,18,1,16,5,0,84
1,14,20,9,18,5,4,0,0,71
1,14,20,9,18,5,14,20,0,101
1,14,20,9,18,9,3,9,14,97
1,14,20,9,18,9,15,20,0,106
1,14,20,9,18,15,2,9,14,102
1,14,20,9,18,15,25,1,12,115
1,14,20,9,18,15,12,12,0,101
1,14,20,9,18,21,13,15,18,129
1,14,20,9,18,21,14,0,0,97
1,14,20,9,18,21,19,20,0,122
1,14,20,9,18,21,19,20,19,141
1,14,20,9,19,0,0,0,0,63
1,14,20,9,19,1,7,0,0,71
1,14,20,9,19,3,1,12,5,84
1,14,20,9,19,3,9,1,0,76
1,14,20,9,19,3,9,9,0,84
1,14,20,9,19,3,9,15,14,104
1,14,20,9,19,5,18,1,0,87
1,14,20,9,19,5,18,21,13,120
1,14,20,9,19,5,24,0,0,92
1,14,20,9,19,8,9,16,0,96
1,14,20,9,19,9,14,5,0,91
1,14,20,9,19,25,14,15,4,121
1,14,20,9,19,11,9,4,0,87
1,14,20,9,19,12,9,16,0,100
1,14,20,9,19,13,15,7,0,98
1,14,20,9,19,13,21,20,0,117
1,14,20,9,19,14,15,2,0,94
1,14,20,9,19,15,12,1,18,109
1,14,20,9,19,16,1,3,5,88
1,14,20,9,19,16,1,19,20,119
1,14,20,9,19,20,1,20,0,104
1,14,20,9,19,20,1,20,5,109
1,14,20,9,19,20,5,19,0,107
1,14,20,9,19,20,15,3,11,112
1,14,20,9,19,21,14,0,0,98
1,14,20,9,20,1,14,11,0,90
1,14,20,9,20,1,24,0,0,89
1,14,20,9,20,8,5,6,20,103
1,14,20,9,20,8,5,20,0,97
1,14,20,9,20,25,16,1,12,118
1,14,20,9,20,25,16,5,0,110
1,14,20,9,20,25,16,5,19,129
1,14,20,9,20,25,16,25,0,130
1,14,20,9,20,25,16,9,3,117
1,14,20,9,20,15,14,9,3,105
1,14,20,9,20,15,24,9,3,115
1,14,20,9,20,15,24,9,14,126
1,14,20,9,20,18,1,4,5,92
1,14,20,9,20,18,1,7,9,99
1,14,20,9,20,18,15,16,5,118
1,14,20,9,20,18,15,16,25,138
1,14,20,9,20,18,21,19,20,142
1,14,20,9,20,21,13,15,18,131
1,14,20,9,21,12,3,5,18,103
1,14,20,9,21,14,9,15,14,117
1,14,20,9,21,18,2,1,14,100
1,14,20,9,22,5,14,9,14,108
1,14,20,9,22,5,14,15,13,113
1,14,20,9,22,9,3,5,0,83
1,14,20,9,22,9,18,1,12,106
1,14,20,9,22,9,18,21,19,133
1,14,20,9,23,1,18,0,0,86
1,14,20,9,23,1,19,20,5,112
1,14,20,9,23,5,1,18,0,91
1,14,20,9,23,5,4,7,5,88
1,14,20,9,23,5,5,4,0,81
1,14,20,9,23,8,9,20,5,109
1,14,20,9,23,9,20,0,0,96
1,14,20,9,23,15,13,1,14,110
1,14,20,9,23,15,18,12,4,116
1,14,20,9,26,25,13,9,3,120
1,14,20,9,26,15,5,1,0,91
1,14,20,10,1,18,0,0,0,64
1,14,20,12,5,18,0,0,0,70
1,14,20,12,5,18,5,4,0,79
1,14,20,12,5,18,9,20,5,104
1,14,20,12,9,1,20,5,0,82
1,14,20,12,9,11,5,0,0,72
1,14,20,12,9,14,7,0,0,77
1,14,20,12,9,15,14,0,0,85
1,14,20,12,9,15,14,19,0,104
1,14,20,12,21,5,20,9,3,105
1,14,20,15,3,21,12,1,18,105
1,14,20,15,5,3,9,0,0,67
1,14,20,15,5,3,9,1,14,82
1,14,20,15,14,25,13,0,0,102
1,14,20,15,14,25,13,25,0,127
1,14,20,15,14,25,13,9,3,114
1,14,20,15,14,25,13,19,0,121
1,14,20,15,26,15,14,5,0,110
1,14,20,16,18,15,15,6,0,105
1,14,20,18,1,0,0,0,0,54
1,14,20,18,1,12,0,0,0,66
1,14,20,18,1,12,7,9,1,83
1,14,20,18,5,0,0,0,0,58
1,14,20,18,5,19,0,0,0,77
1,14,20,18,9,14,0,0,0,76
1,14,20,18,9,20,9,19,0,110
1,14,20,18,15,3,5,12,5,93
1,14,20,18,15,18,19,5,0,110
1,14,20,18,15,20,15,13,5,121
1,14,20,18,15,20,15,13,25,141
1,14,20,18,15,22,5,18,20,133
1,14,20,18,21,13,0,0,0,87
1,14,20,18,21,13,19,0,0,106
1,14,20,19,0,0,0,0,0,54
1,14,20,19,8,9,16,0,0,87
1,14,20,19,8,18,9,11,5,105
1,14,20,19,25,0,0,0,0,79
1,14,20,19,9,5,18,0,0,86
1,14,20,19,9,5,19,20,0,107
1,14,20,19,9,7,14,5,0,89
1,14,20,20,8,18,21,19,8,129
1,14,20,23,9,19,5,0,0,91
1,14,21,2,9,14,0,0,0,61
1,14,21,2,9,14,7,0,0,68
1,14,21,3,12,5,1,20,5,82
1,14,21,11,1,2,9,5,20,84
1,14,21,12,15,13,1,0,0,77
1,14,21,14,4,5,18,0,0,77
1,14,21,18,1,12,0,0,0,67
1,14,21,18,1,14,0,0,0,69
1,14,21,18,1,14,19,0,0,88
1,14,21,18,5,19,5,19,0,102
1,14,21,18,5,19,9,19,0,106
1,14,21,18,5,20,9,3,0,91
1,14,21,18,25,0,0,0,0,79
1,14,21,18,9,1,0,0,0,64
1,14,21,18,9,1,19,0,0,83
1,14,21,18,9,3,0,0,0,66
1,14,21,18,15,21,19,0,0,109
1,14,21,19,0,0,0,0,0,55
1,14,21,19,5,19,0,0,0,79
1,14,21,19,9,13,0,0,0,77
1,14,21,19,22,1,18,1,0,97
1,14,22,1,19,19,5,18,0,99
1,14,22,9,12,0,0,0,0,58
1,14,22,9,12,5,4,0,0,67
1,14,22,9,12,9,14,7,0,88
1,14,22,9,12,12,5,4,0,79
1,14,22,9,12,12,9,14,7,100
1,14,22,9,12,19,0,0,0,77
1,14,22,9,12,20,15,16,0,109
1,14,22,9,12,20,15,16,19,128
1,14,24,9,5,20,25,0,0,98
1,14,24,9,5,20,9,5,19,106
1,14,24,9,5,20,21,4,5,103
1,14,24,9,15,21,19,0,0,103
1,14,24,9,15,21,19,12,25,140
1,15,2,0,0,0,0,0,0,18
1,15,7,9,18,9,0,0,0,59
1,15,12,9,0,0,0,0,0,37
1,15,14,1,3,8,0,0,0,42
1,15,18,0,0,0,0,0,0,34
1,15,18,9,19,20,0,0,0,82
1,15,18,9,19,20,9,3,0,94
1,15,18,9,19,20,19,0,0,101
1,15,18,20,1,0,0,0,0,55
1,15,18,20,1,5,0,0,0,60
1,15,18,20,1,12,0,0,0,67
1,15,18,20,1,19,0,0,0,74
1,15,18,20,9,3,0,0,0,66
1,15,18,20,9,19,13,0,0,95
1,15,18,20,9,20,9,19,0,111
1,15,18,20,15,12,9,20,8,118
1,15,18,20,15,20,15,13,25,142
1,15,19,13,9,3,0,0,0,60
1,15,21,1,4,0,0,0,0,42
1,15,21,1,4,19,0,0,0,61
1,15,21,4,1,4,0,0,0,46
1,15,21,4,1,4,19,0,0,65
1,16,5,1,11,0,0,0,0,34
1,16,5,3,20,15,13,25,0,98
1,16,5,4,0,0,0,0,0,26
1,16,5,4,15,13,0,0,0,54
1,16,5,5,11,0,0,0,0,38
1,16,5,8,15,15,4,0,0,64
1,16,5,9,18,15,14,0,0,78
1,16,5,12,5,20,0,0,0,59
1,16,5,12,9,11,5,0,0,59
1,16,5,12,9,14,7,0,0,64
1,16,5,12,12,15,21,19,0,101
1,16,5,13,1,14,0,0,0,50
1,16,5,14,20,5,18,9,3,91
1,16,5,16,19,25,0,0,0,82
1,16,5,16,19,9,1,0,0,67
1,16,5,16,19,9,14,9,1,90
1,16,5,16,20,9,3,0,0,70
1,16,5,18,0,0,0,0,0,40
1,16,5,18,3,8,0,0,0,51
1,16,5,18,3,21,0,0,0,64
1,16,5,18,3,21,19,0,0,83
1,16,5,18,5,1,0,0,0,46
1,16,5,18,25,0,0,0,0,65
1,16,5,18,9,5,14,20,0,88
1,16,5,18,9,5,14,20,19,107
1,16,5,18,9,5,19,0,0,73
1,16,5,18,9,15,4,9,3,80
1,16,5,18,9,20,9,6,0,84
1,16,5,18,9,20,9,6,19,103
1,16,5,18,9,20,9,22,5,105
1,16,5,18,19,0,0,0,0,59
1,16,5,18,19,5,5,0,0,69
1,16,5,18,20,0,0,0,0,60
1,16,5,18,20,9,15,14,0,98
1,16,5,18,20,12,25,0,0,97
1,16,5,18,20,14,5,19,19,117
1,16,5,18,20,21,13,0,0,94
1,16,5,18,20,21,18,1,12,112
1,16,5,18,20,21,18,5,0,104
1,16,5,18,20,21,18,5,4,108
1,16,5,18,20,21,18,5,19,123
1,16,5,19,0,0,0,0,0,41
1,16,5,20,1,12,25,0,0,80
1,16,5,20,1,12,9,5,19,88
1,16,5,20,1,12,15,9,4,83
1,16,5,20,1,12,15,19,5,94
1,16,5,20,1,12,15,21,19,110
1,16,5,24,0,0,0,0,0,46
1,16,5,24,5,4,0,0,0,55
1,16,5,24,5,19,0,0,0,70
1,16,5,24,9,14,7,0,0,76
1,16,8,0,0,0,0,0,0,25
1,16,8,1,3,9,1,0,0,39
1,16,8,1,3,9,1,12,0,51
1,16,8,1,3,9,3,0,0,41
1,16,8,1,7,9,1,0,0,43
1,16,8,1,7,9,1,19,0,62
1,16,8,1,11,9,1,0,0,47
1,16,8,1,11,9,1,12,0,59
1,16,8,1,11,9,3,0,0,49
1,16,8,1,14,9,19,9,1,78
1,16,8,1,14,9,19,9,19,96
1,16,8,1,14,9,20,5,0,74
1,16,8,1,14,9,20,5,19,93
1,16,8,1,14,9,20,9,3,81
1,16,8,1,19,9,1,0,0,55
1,16,8,1,19,9,1,3,0,58
1,16,8,1,19,9,1,3,19,77
1,16,8,1,19,9,1,19,0,74
1,16,8,1,19,9,3,0,0,57
1,16,8,1,19,9,3,19,0,76
1,16,8,5,12,9,1,0,0,52
1,16,8,5,12,9,1,14,0,66
1,16,8,5,12,9,12,9,1,73
1,16,8,5,12,9,15,14,0,80
1,16,8,5,13,9,1,0,0,53
1,16,8,5,13,9,3,0,0,55
1,16,8,5,18,5,19,9,19,100
1,16,8,5,18,5,20,9,3,85
1,16,8,5,19,5,19,0,0,73
1,16,8,5,19,9,19,0,0,77
1,16,8,5,20,1,0,0,0,51
1,16,8,5,20,9,3,0,0,62
1,16,8,5,20,9,19,13,0,91
1,16,8,5,20,9,26,5,0,90
1,16,8,9,3,9,4,1,12,63
1,16,8,9,3,9,4,5,0,55
1,16,8,9,4,0,0,0,0,38
1,16,8,9,4,5,19,0,0,62
1,16,8,9,4,9,1,14,0,62
1,16,8,9,4,9,1,14,19,81
1,16,8,9,4,9,4,0,0,51
1,16,8,9,4,9,15,21,19,102
1,16,8,9,4,12,9,15,14,88
1,16,8,9,4,15,26,5,18,102
1,16,8,9,4,19,0,0,0,57
1,16,8,25,12,12,25,0,0,99
1,16,8,25,12,12,9,5,19,107
1,16,8,25,12,12,15,19,5,113
1,16,8,25,12,12,15,21,19,129
1,16,8,25,18,9,3,0,0,80
1,16,8,9,19,12,9,15,14,103
1,16,8,9,26,15,7,0,0,82
1,16,8,12,1,19,20,15,14,106
1,16,8,12,5,2,9,1,0,54
1,16,8,14,15,12,15,7,25,113
1,16,8,15,4,1,12,0,0,57
1,16,8,15,4,9,0,0,0,53
1,16,8,15,4,9,1,14,0,68
1,16,8,15,4,21,19,0,0,84
1,16,8,15,12,1,20,5,0,78
1,16,8,15,12,1,20,5,19,97
1,16,8,15,14,25,0,0,0,79
1,16,8,15,14,9,1,0,0,64
1,16,8,15,14,9,1,19,0,83
1,16,8,15,14,9,3,0,0,66
1,16,8,15,14,9,3,19,0,85
1,16,8,15,14,15,21,19,0,109
1,16,8,15,18,9,1,0,0,68
1,16,8,15,18,9,19,5,0,91
1,16,8,15,18,9,19,5,4,95
1,16,8,15,18,9,19,5,18,109
1,16,8,15,18,9,19,5,19,110
1,16,8,15,18,9,19,13,0,99
1,16,8,15,18,9,19,13,19,118
1,16,8,15,18,9,19,20,0,106
1,16,8,15,18,9,19,20,19,125
1,16,8,15,18,9,26,5,0,98
1,16,8,15,18,9,26,5,4,102
1,16,8,15,18,9,26,5,18,116
1,16,8,15,18,9,26,5,19,117
1,16,8,15,20,1,24,9,19,113
1,16,8,15,20,9,3,0,0,72
1,16,8,18,1,19,9,1,0,73
1,16,8,18,9,20,5,0,0,77
1,16,8,18,9,26,9,20,5,112
1,16,8,18,15,12,9,20,5,104
1,16,8,18,15,14,9,1,0,82
1,16,8,20,8,1,0,0,0,54
1,16,8,20,8,1,5,0,0,59
1,16,8,20,8,9,3,0,0,65
1,16,8,20,8,15,9,4,0,81
1,16,8,20,8,15,14,7,0,89
1,16,8,20,8,15,21,19,0,108
1,16,9,1,3,5,15,21,19,90
1,16,9,1,14,0,0,0,0,41
1,16,9,1,18,25,0,0,0,70
1,16,9,1,18,9,1,14,0,69
1,16,9,1,18,9,1,14,19,88
1,16,9,1,18,9,5,19,0,78
1,16,9,1,18,9,19,20,0,93
1,16,9,1,18,9,19,20,19,112
1,16,9,1,20,15,18,0,0,80
1,16,9,3,1,4,0,0,0,34
1,16,9,3,1,12,0,0,0,42
1,16,9,3,1,12,12,25,0,79
1,16,9,3,1,12,19,0,0,61
1,16,9,3,5,19,0,0,0,53
1,16,9,3,9,1,12,0,0,51
1,16,9,3,9,12,1,18,0,69
1,16,9,3,9,20,9,19,0,86
1,16,9,3,11,2,1,3,11,57
1,16,9,3,11,16,1,3,11,71
1,16,9,3,21,12,1,0,0,63
1,16,9,3,21,12,1,18,0,81
1,16,9,3,21,12,1,20,5,88
1,16,9,3,21,12,9,0,0,71
1,16,9,3,21,12,21,19,0,102
1,16,9,5,3,5,0,0,0,39
1,16,9,5,3,5,19,0,0,58
1,16,9,7,5,14,9,14,0,75
1,16,9,9,0,0,0,0,0,35
1,16,9,9,14,0,0,0,0,49
1,16,9,11,15,18,5,19,0,94
1,16,9,11,15,18,15,19,0,104
1,16,9,11,15,18,19,9,13,111
1,16,9,12,1,18,25,0,0,82
1,16,9,12,9,0,0,0,0,47
1,16,9,13,1,14,9,1,0,64
1,16,9,13,1,14,9,1,19,83
1,16,9,14,3,8,0,0,0,51
1,16,9,14,7,0,0,0,0,47
1,16,9,14,15,9,4,0,0,68
1,16,9,15,0,0,0,0,0,41
1,16,9,15,9,4,0,0,0,54
1,16,9,15,9,4,1,12,0,67
1,16,9,15,12,0,0,0,0,53
1,16,9,15,12,5,0,0,0,58
1,16,9,15,12,9,14,0,0,76
1,16,9,15,12,15,7,25,0,100
1,16,25,15,14,9,14,0,0,94
1,16,9,15,14,15,12,0,0,82
1,16,9,15,19,5,0,0,0,65
1,16,9,16,8,15,2,9,1,77
1,16,25,18,1,19,5,0,0,85
1,16,25,18,1,19,5,19,0,104
1,16,25,18,5,14,5,0,0,84
1,16,25,18,5,20,9,3,0,97
1,16,25,18,5,24,25,0,0,114
1,16,25,18,5,24,9,1,0,99
1,16,25,18,5,24,9,1,12,111
1,16,25,18,15,20,25,16,5,141
1,16,25,18,15,21,19,0,0,115
1,16,9,19,8,0,0,0,0,53
1,16,9,19,8,12,25,0,0,90
1,16,9,19,8,14,5,19,19,110
1,16,9,19,13,0,0,0,0,58
1,16,9,20,15,14,7,0,0,82
1,16,9,20,16,1,20,0,0,83
1,16,9,22,15,18,15,21,19,136
1,16,10,15,8,14,9,20,5,98
1,16,12,1,3,5,0,0,0,38
1,16,12,1,14,1,20,0,0,65
1,16,12,1,14,1,20,9,3,77
1,16,12,1,19,9,1,0,0,59
1,16,12,1,19,9,1,19,0,78
1,16,12,1,19,20,9,3,0,81
1,16,12,5,14,20,25,0,0,93
1,16,12,9,20,5,0,0,0,63
1,16,12,9,20,5,19,0,0,82
1,16,12,9,20,9,3,0,0,70
1,16,12,15,13,2,0,0,0,59
1,16,12,15,13,2,19,0,0,78
1,16,12,15,13,5,0,0,0,62
1,16,12,15,20,15,13,25,0,117
1,16,12,21,19,20,18,1,0,108
1,16,12,21,19,20,18,5,0,112
1,16,12,21,19,20,18,9,1,117
1,16,14,5,1,0,0,0,0,37
1,16,14,5,1,12,0,0,0,49
1,16,14,5,1,19,0,0,0,56
1,16,14,5,9,3,0,0,0,48
1,16,14,5,21,19,9,19,0,104
1,16,14,5,21,19,20,9,3,108
1,16,14,15,5,1,0,0,0,52
1,16,14,15,5,1,12,0,0,64
1,16,14,15,5,1,19,0,0,71
1,16,14,15,5,9,3,0,0,63
1,16,15,1,16,19,9,19,0,96
1,16,15,2,9,15,20,9,3,90
1,16,15,2,12,1,19,20,0,86
1,16,15,3,1,12,25,16,20,109
1,16,15,3,1,18,16,0,0,70
1,16,15,3,1,18,16,25,0,95
1,16,15,3,1,18,16,19,0,89
1,16,15,3,5,14,20,5,18,97
1,16,15,3,5,14,20,18,5,97
1,16,15,3,8,1,0,0,0,44
1,16,15,3,8,1,5,0,0,49
1,16,15,3,8,15,12,9,3,82
1,16,15,3,25,20,5,0,0,85
1,16,15,3,15,16,1,20,5,92
1,16,15,3,15,16,5,0,0,71
1,16,15,3,15,16,5,19,0,90
1,16,15,3,15,16,9,3,0,78
1,16,15,3,18,5,14,9,3,84
1,16,15,3,18,9,14,5,0,81
1,16,15,3,18,25,16,8,0,102
1,16,15,4,0,0,0,0,0,36
1,16,15,4,1,12,0,0,0,49
1,16,15,4,1,14,0,0,0,51
1,16,15,4,5,9,16,14,1,81
1,16,15,4,5,9,24,9,19,102
1,16,15,4,5,13,1,0,0,55
1,16,15,4,5,13,1,12,0,67
1,16,15,4,5,13,1,19,0,74
1,16,15,4,5,13,1,20,1,76
1,16,15,4,5,13,5,0,0,59
1,16,15,4,9,3,20,9,3,80
1,16,15,4,9,15,24,9,19,112
1,16,15,4,9,24,9,19,0,97
1,16,15,4,15,19,5,19,0,94
1,16,15,4,15,19,9,19,0,98
1,16,15,4,15,21,19,0,0,91
1,16,15,4,19,0,0,0,0,55
1,16,15,5,14,26,25,13,5,120
1,16,15,7,1,5,9,3,0,57
1,16,15,7,1,9,3,0,0,52
1,16,15,7,1,13,25,0,0,78
1,16,15,7,1,13,9,3,0,65
1,16,15,7,1,13,9,5,19,86
1,16,15,7,1,13,15,21,19,108
1,16,15,7,5,1,12,0,0,57
1,16,15,7,5,1,14,0,0,59
1,16,15,7,5,5,0,0,0,49
1,16,15,7,5,5,19,0,0,68
1,16,15,7,5,9,3,0,0,56
1,16,15,7,5,14,25,0,0,83
1,16,15,7,5,14,15,21,19,113
1,16,15,7,15,14,9,4,0,81
1,16,15,7,18,1,16,8,0,82
1,16,15,8,25,1,12,0,0,78
1,16,15,9,11,9,1,0,0,62
1,16,15,9,15,21,19,0,0,96
1,16,15,9,19,5,0,0,0,65
1,16,15,10,15,22,5,0,0,84
1,16,15,11,18,5,1,0,0,67
1,16,15,11,18,5,15,19,0,100
1,16,15,12,1,18,0,0,0,63
1,16,15,12,1,18,9,20,25,117
1,16,15,12,25,19,9,19,0,116
1,16,15,12,15,7,0,0,0,66
1,16,15,12,15,7,1,12,0,79
1,16,15,12,15,7,5,18,0,89
1,16,15,12,15,7,5,20,5,96
1,16,15,12,15,7,25,0,0,91
1,16,15,12,15,7,9,1,0,76
1,16,15,12,15,7,9,1,5,81
1,16,15,12,15,7,9,1,19,95
1,16,15,12,15,7,9,5,19,99
1,16,15,12,15,7,9,19,5,99
1,16,15,12,15,7,9,19,20,114
1,16,15,12,15,7,9,26,5,106
1,16,15,12,15,7,19,0,0,85
1,16,15,12,15,7,21,5,0,92
1,16,15,12,15,7,21,5,19,111
1,16,15,12,15,21,19,9,19,127
1,16,15,12,21,14,5,0,0,84
1,16,15,12,21,14,5,19,0,103
1,16,15,12,21,19,9,19,0,112
1,16,15,13,9,3,20,0,0,77
1,16,15,13,9,3,20,9,3,89
1,16,15,13,9,3,20,19,0,96
1,16,15,13,9,24,5,19,0,102
1,16,15,13,9,24,9,19,0,106
1,16,15,14,9,1,0,0,0,56
1,16,15,14,9,3,0,0,0,58
1,16,15,15,16,0,0,0,0,63
1,16,15,16,8,1,19,9,19,104
1,16,15,16,8,1,20,9,3,89
1,16,15,16,8,25,7,5,0,93
1,16,15,16,8,25,7,5,19,112
1,16,15,16,8,25,19,5,19,124
1,16,15,16,8,25,19,9,19,128
1,16,15,16,8,12,5,7,13,93
1,16,15,16,8,15,14,25,0,110
1,16,15,16,8,15,14,9,1,95
1,16,15,16,8,15,14,9,3,97
1,16,15,16,25,12,5,0,0,90
1,16,15,16,12,5,24,0,0,89
1,16,15,16,12,5,24,25,0,114
1,16,15,18,5,20,9,3,0,87
1,16,15,18,9,1,0,0,0,60
1,16,15,18,9,1,5,0,0,65
1,16,15,18,9,1,19,0,0,79
1,16,15,18,15,19,5,0,0,89
1,16,15,18,16,8,9,14,0,97
1,16,15,18,16,8,9,14,5,102
1,16,15,18,18,8,5,1,0,82
1,16,15,18,18,8,15,5,1,97
1,16,15,18,20,0,0,0,0,70
1,16,15,18,20,12,1,19,20,122
1,16,15,18,20,15,9,19,5,118
1,16,15,19,1,20,21,18,14,125
1,16,15,19,5,12,5,14,5,92
1,16,15,19,9,1,0,0,0,61
1,16,15,19,9,20,9,1,0,90
1,16,15,19,9,20,9,3,0,92
1,16,15,19,15,18,15,0,0,99
1,16,15,19,16,15,18,25,0,125
1,16,15,19,16,15,18,9,3,112
1,16,15,19,20,1,3,25,0,100
1,16,15,19,20,1,19,25,0,116
1,16,15,19,20,1,19,9,19,119
1,16,15,19,20,1,20,5,0,97
1,16,15,19,20,1,20,5,19,116
1,16,15,19,20,1,20,9,3,104
1,16,15,19,20,1,24,9,19,124
1,16,15,19,20,5,13,0,0,89
1,16,15,19,20,5,13,5,0,94
1,16,15,19,20,8,9,1,0,89
1,16,15,19,20,8,21,13,5,118
1,16,15,19,20,9,12,0,0,92
1,16,15,19,20,9,12,12,5,109
1,16,15,19,20,9,12,19,0,111
1,16,15,19,20,12,5,0,0,88
1,16,15,19,20,15,9,12,5,112
1,16,15,19,20,15,12,9,0,107
1,16,15,19,20,21,13,5,0,110
1,16,15,20,5,12,5,19,13,106
1,16,15,20,8,5,3,0,0,68
1,16,15,20,8,5,3,1,12,81
1,16,15,20,8,5,3,5,0,73
1,16,15,20,8,5,3,5,19,92
1,16,15,20,8,5,3,9,1,78
1,16,15,20,8,5,7,13,0,85
1,16,15,20,8,5,7,13,19,104
1,16,15,20,8,5,13,0,0,78
1,16,15,20,8,5,13,19,0,97
1,16,15,20,8,5,15,19,5,104
1,16,15,20,8,5,19,9,19,112
1,16,15,20,8,7,13,0,0,80
1,16,15,20,25,16,5,0,0,98
1,16,15,20,25,16,9,3,0,105
1,16,15,20,15,13,5,0,0,85
1,16,15,21,20,0,0,0,0,73
1,16,15,24,5,19,9,19,0,108
1,16,15,26,5,13,0,0,0,76
1,16,15,26,5,13,1,0,0,77
1,16,15,26,25,13,1,19,5,121
1,16,16,1,25,0,0,0,0,59
1,16,16,1,9,18,0,0,0,61
1,16,16,1,12,0,0,0,0,46
1,16,16,1,12,5,0,0,0,51
1,16,16,1,12,12,0,0,0,58
1,16,16,1,12,12,5,4,0,67
1,16,16,1,12,12,9,14,7,88
1,16,16,1,12,12,19,0,0,77
1,16,16,1,12,13,5,14,20,98
1,16,16,1,12,19,0,0,0,65
1,16,16,1,12,20,15,0,0,81
1,16,16,1,14,1,7,5,0,61
1,16,16,1,14,1,7,5,4,65
1,16,16,1,14,1,7,5,19,80
1,16,16,1,18,0,0,0,0,52
1,16,16,1,18,1,9,12,0,74
1,16,16,1,18,1,14,3,5,75
1,16,16,1,18,1,20,0,0,73
1,16,16,1,18,1,20,19,0,92
1,16,16,1,18,1,20,21,19,113
1,16,16,1,18,5,12,0,0,69
1,16,16,1,18,5,12,5,4,78
1,16,16,1,18,5,12,19,0,88
1,16,16,1,18,5,14,3,5,79
1,16,16,1,18,5,14,3,25,99
1,16,16,1,18,5,14,19,0,90
1,16,16,1,18,5,14,20,0,91
1,16,16,1,18,9,20,15,18,114
1,16,16,1,19,20,0,0,0,73
1,16,16,1,21,13,5,0,0,73
1,16,16,1,21,13,5,5,0,78
1,16,16,4,0,0,0,0,0,37
1,16,16,5,1,3,8,0,0,50
1,16,16,5,1,3,8,5,18,73
1,16,16,5,1,12,0,0,0,51
1,16,16,5,1,12,5,4,0,60
1,16,16,5,1,12,5,18,0,74
1,16,16,5,1,12,5,18,19,93
1,16,16,5,1,12,9,14,7,81
1,16,16,5,1,12,19,0,0,70
1,16,16,5,1,18,0,0,0,57
1,16,16,5,1,18,5,4,0,66
1,16,16,5,1,18,5,18,0,80
1,16,16,5,1,18,5,18,19,99
1,16,16,5,1,18,9,14,7,87
1,16,16,5,1,18,19,0,0,76
1,16,16,5,1,19,5,0,0,63
1,16,16,5,1,19,5,4,0,67
1,16,16,5,1,19,5,18,0,81
1,16,16,5,1,19,5,18,19,100
1,16,16,5,1,19,5,19,0,82
1,16,16,5,1,19,9,14,7,88
1,16,16,5,1,19,9,22,5,94
1,16,16,5,12,12,1,14,20,97
1,16,16,5,12,12,1,20,5,88
1,16,16,5,12,12,5,5,0,72
1,16,16,5,12,12,5,5,19,91
1,16,16,5,12,12,15,18,0,95
1,16,16,5,12,12,15,18,19,114
1,16,16,5,12,19,0,0,0,69
1,16,16,5,14,1,7,5,0,65
1,16,16,5,14,4,0,0,0,56
1,16,16,5,14,4,1,7,5,69
1,16,16,5,14,4,1,14,20,91
1,16,16,5,14,4,5,4,0,65
1,16,16,5,14,4,5,14,20,95
1,16,16,5,14,4,5,18,0,79
1,16,16,5,14,4,5,18,19,98
1,16,16,5,14,4,9,3,5,73
1,16,16,5,14,4,9,14,7,86
1,16,16,5,14,4,9,24,0,89
1,16,16,5,14,4,19,0,0,75
1,16,16,5,14,14,1,7,5,79
1,16,16,5,14,19,5,0,0,76
1,16,16,5,14,20,9,3,5,89
1,16,16,5,18,5,0,0,0,61
1,16,16,5,18,9,12,0,0,77
1,16,16,5,18,20,0,0,0,76
1,16,16,5,18,20,1,9,14,100
1,16,16,5,18,20,9,19,5,109
1,16,16,5,19,20,1,20,0,98
1,16,16,5,19,20,1,20,19,117
1,16,16,5,20,0,0,0,0,58
1,16,16,5,20,5,0,0,0,63
1,16,16,5,20,5,14,3,5,85
1,16,16,5,20,5,14,3,25,105
1,16,16,5,20,5,14,20,0,97
1,16,16,5,20,9,2,12,5,86
1,16,16,5,20,9,19,5,18,109
1,16,16,5,20,9,19,19,5,110
1,16,16,5,20,9,20,0,0,87
1,16,16,5,20,9,20,5,0,92
1,16,16,5,20,9,20,5,19,111
1,16,16,5,20,9,26,5,0,98
1,16,16,5,20,9,26,5,4,102
1,16,16,5,20,9,26,5,18,116
1,16,16,9,14,9,20,5,0,90
1,16,16,12,0,0,0,0,0,45
1,16,16,12,1,14,1,20,5,86
1,16,16,12,1,21,4,0,0,71
1,16,16,12,1,21,4,5,4,80
1,16,16,12,1,21,4,5,18,94
1,16,16,12,1,21,4,19,0,90
1,16,16,12,1,21,19,5,0,91
1,16,16,12,1,21,19,5,19,110
1,16,16,12,5,3,1,18,20,92
1,16,16,12,5,4,0,0,0,54
1,16,16,12,5,10,1,3,11,75
1,16,16,12,5,10,15,8,14,97
1,16,16,12,5,14,21,20,0,105
1,16,16,12,5,18,15,15,20,118
1,16,16,12,5,19,0,0,0,69
1,16,16,12,5,23,9,6,5,93
1,16,16,12,5,23,15,15,4,107
1,16,16,12,25,0,0,0,0,70
1,16,16,12,9,1,2,12,5,74
1,16,16,12,9,1,2,12,25,94
1,16,16,12,9,1,14,3,5,77
1,16,16,12,9,1,14,20,0,89
1,16,16,12,9,3,1,14,20,92
1,16,16,12,9,3,1,20,5,83
1,16,16,12,9,5,4,0,0,63
1,16,16,12,9,5,4,12,25,100
1,16,16,12,9,5,18,0,0,77
1,16,16,12,9,5,18,19,0,96
1,16,16,12,9,5,19,0,0,78
1,16,16,12,25,9,14,7,0,100
1,16,16,12,25,13,5,14,20,122
1,16,16,12,9,17,21,5,0,97
1,16,16,12,9,17,21,5,4,101
1,16,16,12,9,17,21,5,19,116
1,16,16,12,15,19,9,15,14,117
1,16,16,12,15,19,9,22,5,115
1,16,16,12,15,20,0,0,0,80
1,16,16,13,20,0,0,0,0,66
1,16,16,15,9,14,20,0,0,91
1,16,16,15,9,14,20,5,0,96
1,16,16,15,9,14,20,5,4,100
1,16,16,15,9,14,20,5,5,101
1,16,16,15,9,14,20,5,18,114
1,16,16,15,9,14,20,15,18,124
1,16,16,15,9,14,20,19,0,110
1,16,16,15,18,20,0,0,0,86
1,16,16,15,18,20,9,15,14,124
1,16,16,15,19,1,2,12,5,87
1,16,16,15,19,5,0,0,0,72
1,16,16,15,19,5,4,0,0,76
1,16,16,15,19,5,18,0,0,90
1,16,16,15,19,5,18,19,0,109
1,16,16,15,19,5,19,0,0,91
1,16,16,15,19,9,14,7,0,97
1,16,16,15,19,9,20,5,0,101
1,16,16,18,1,9,19,1,12,93
1,16,16,18,1,9,19,5,0,85
1,16,16,18,1,9,19,5,4,89
1,16,16,18,1,9,19,5,18,103
1,16,16,18,1,9,19,5,19,104
1,16,16,18,5,3,1,20,5,85
1,16,16,18,5,8,5,14,4,87
1,16,16,18,5,14,4,0,0,74
1,16,16,18,5,14,19,5,0,94
1,16,16,18,5,19,19,0,0,94
1,16,16,18,5,19,19,5,4,103
1,16,16,18,5,19,19,15,18,127
1,16,16,18,5,19,20,0,0,95
1,16,16,18,5,20,5,21,18,120
1,16,16,18,5,22,5,0,0,83
1,16,16,18,9,19,5,0,0,84
1,16,16,18,9,19,5,4,0,88
1,16,16,18,9,19,5,18,0,102
1,16,16,18,9,19,5,18,19,121
1,16,16,18,9,19,5,19,0,103
1,16,16,18,9,19,9,14,7,109
1,16,16,18,9,26,1,12,0,99
1,16,16,18,9,26,5,0,0,91
1,16,16,18,9,26,5,4,0,95
1,16,16,18,9,26,5,18,0,109
1,16,16,18,9,26,5,18,19,128
1,16,16,18,9,26,5,19,0,110
1,16,16,18,9,26,9,14,7,116
1,16,16,18,15,0,0,0,0,66
1,16,16,18,15,1,3,8,0,78
1,16,16,18,15,2,1,20,5,94
1,16,16,18,15,13,16,20,0,115
1,16,16,18,15,15,6,0,0,87
1,16,16,18,15,16,18,5,0,105
1,16,16,18,15,22,1,12,0,101
1,16,16,18,15,22,1,12,19,120
1,16,16,18,15,22,5,0,0,93
1,16,16,18,15,22,5,4,0,97
1,16,16,18,15,22,5,18,0,111
1,16,16,18,15,22,5,18,19,130
1,16,16,18,15,22,5,19,0,112
1,16,16,18,15,22,9,14,7,118
1,16,16,18,15,24,0,0,0,90
1,16,16,20,0,0,0,0,0,53
1,16,16,20,4,0,0,0,0,57
1,16,16,21,9,0,0,0,0,63
1,16,16,21,12,19,5,0,0,90
1,16,16,21,12,19,5,19,0,109
1,16,16,21,12,19,9,15,14,123
1,16,16,21,12,19,9,22,5,121
1,16,18,1,3,20,9,3,0,71
1,16,18,1,24,9,1,0,0,70
1,16,18,1,24,9,1,19,0,89
1,16,18,1,24,9,3,0,0,72
1,16,18,5,25,14,20,5,0,104
1,16,18,5,14,4,9,26,0,93
1,16,18,5,19,0,0,0,0,59
1,16,18,9,3,1,20,5,0,73
1,16,18,9,3,11,12,5,0,75
1,16,18,9,3,15,20,0,0,82
1,16,18,9,3,15,20,19,0,101
1,16,18,9,15,18,9,0,0,86
1,16,18,9,15,18,9,19,13,118
1,16,18,9,15,18,9,19,20,125
1,16,18,9,15,18,9,20,25,131
1,16,18,9,20,9,6,0,0,79
1,16,18,15,3,20,9,1,0,83
1,16,18,15,3,20,15,21,19,128
1,16,18,15,14,0,0,0,0,64
1,16,18,15,14,5,4,0,0,73
1,16,18,15,14,5,5,18,0,92
1,16,18,15,14,6,21,12,0,103
1,16,18,15,14,9,14,7,0,94
1,16,18,15,14,12,5,19,19,119
1,16,18,15,14,12,9,11,5,101
1,16,18,15,14,19,0,0,0,83
1,16,18,15,16,15,19,0,0,100
1,16,18,15,19,5,24,9,1,108
1,16,18,15,19,15,16,9,1,110
1,16,18,15,23,12,0,0,0,85
1,16,19,5,19,0,0,0,0,60
1,16,19,25,3,8,9,1,0,82
1,16,19,9,4,0,0,0,0,49
1,16,19,9,4,1,12,0,0,62
1,16,19,9,4,1,12,12,25,99
1,16,19,9,4,5,19,0,0,73
1,16,19,9,4,9,15,12,5,90
1,16,19,9,19,0,0,0,0,64
1,16,20,1,20,5,0,0,0,63
1,16,20,5,18,0,0,0,0,60
1,16,20,5,18,1,12,0,0,73
1,16,20,5,18,1,14,0,0,75
1,16,20,5,18,9,1,0,0,70
1,16,20,5,18,9,1,12,0,82
1,16,20,5,18,25,12,1,0,98
1,16,20,5,18,9,21,13,0,103
1,16,20,5,18,25,24,5,19,133
1,16,20,5,18,15,9,4,0,88
1,16,20,5,18,15,21,19,0,115
1,16,20,5,19,20,0,0,0,81
1,16,20,25,1,12,9,1,0,85
1,16,20,25,1,12,9,19,13,116
1,16,20,25,3,8,21,19,0,113
1,16,20,9,20,21,4,5,0,96
1,16,20,9,20,21,4,5,19,115
1,16,20,12,25,0,0,0,0,74
1,16,20,14,5,19,19,0,0,94
1,16,20,14,5,19,19,5,19,118
1,16,20,15,20,5,0,0,0,77
1,16,20,15,20,9,3,0,0,84
1,16,20,19,0,0,0,0,0,56
1,16,21,12,13,15,14,9,3,104
1,16,21,12,19,5,0,0,0,74
1,16,21,18,16,15,19,5,0,111
1,16,24,0,0,0,0,0,0,41
1,17,21,1,0,0,0,0,0,40
1,17,21,1,2,5,12,12,5,76
1,17,21,1,2,9,2,0,0,53
1,17,21,1,3,1,4,5,0,53
1,17,21,1,3,1,4,5,19,72
1,17,21,1,4,1,7,0,0,52
1,17,21,1,4,21,3,20,0,88
1,17,21,1,4,21,3,20,19,107
1,17,21,1,5,0,0,0,0,45
1,17,21,1,6,5,18,0,0,69
1,17,21,1,7,5,0,0,0,52
1,17,21,1,7,18,5,5,14,89
1,17,21,1,11,5,0,0,0,56
1,17,21,1,12,21,14,7,0,94
1,17,21,1,13,5,20,5,18,101
1,17,21,1,14,1,21,20,0,96
1,17,21,1,14,1,21,20,19,115
1,17,21,1,16,12,1,14,5,88
1,17,21,1,18,5,7,9,1,80
1,17,21,1,18,5,12,12,5,92
1,17,21,1,18,9,1,0,0,68
1,17,21,1,18,9,1,12,0,80
1,17,21,1,18,9,1,14,19,101
1,17,21,1,18,9,9,1,0,77
1,17,21,1,18,9,9,19,20,115
1,17,21,1,18,9,19,20,0,106
1,17,21,1,18,9,19,20,19,125
1,17,21,1,18,9,21,13,0,101
1,17,21,1,18,9,21,13,19,120
1,17,21,1,18,20,5,18,0,101
1,17,21,1,19,0,0,0,0,59
1,17,21,1,19,3,15,16,5,98
1,17,21,1,19,8,15,23,0,105
1,17,21,1,20,5,0,0,0,65
1,17,21,1,20,9,3,0,0,72
1,17,21,1,20,9,3,1,12,85
1,17,21,1,20,9,3,19,0,91
1,17,21,1,20,9,12,5,0,86
1,17,21,1,20,9,14,20,0,103
1,17,21,1,20,9,14,20,1,104
1,17,21,1,20,9,14,20,19,122
1,17,21,1,20,9,15,14,0,98
1,17,21,1,20,15,14,5,0,94
1,17,21,1,20,15,14,5,19,113
1,17,21,1,22,9,20,0,0,91
1,17,21,1,22,9,20,19,0,110
1,17,21,5,4,21,3,20,0,92
1,17,21,5,4,21,3,20,19,111
1,17,21,5,9,20,25,0,0,98
1,17,21,5,14,3,8,0,0,69
1,17,21,5,15,21,19,0,0,99
1,17,21,5,15,21,19,12,25,136
1,17,21,5,18,14,5,0,0,81
1,17,21,9,3,12,21,4,5,93
1,17,21,9,6,5,18,0,0,77
1,17,21,9,6,5,18,19,0,96
1,17,21,9,6,15,18,13,0,100
1,17,21,9,6,21,7,5,0,87
1,17,21,9,12,5,7,5,0,77
1,17,21,9,12,9,1,0,0,70
1,17,21,9,12,9,14,5,0,88
1,17,21,9,12,9,14,15,0,98
1,17,21,9,12,15,14,0,0,89
1,17,21,9,22,5,18,0,0,93
1,17,21,15,0,0,0,0,0,54
1,17,21,15,19,5,0,0,0,78
1,17,21,15,19,9,20,25,0,127
1,17,21,15,20,9,26,5,0,114
1,18,2,0,0,0,0,0,0,21
1,18,2,1,0,0,0,0,0,22
1,18,2,1,3,9,14,0,0,48
1,18,2,1,12,5,19,20,0,78
1,18,2,1,12,5,19,20,19,97
1,18,2,1,12,9,19,20,0,82
1,18,2,1,12,9,19,20,19,101
1,18,2,1,12,15,0,0,0,49
1,18,2,1,12,15,19,0,0,68
1,18,2,5,12,5,19,20,0,82
1,18,2,9,14,15,19,5,0,83
1,18,2,9,20,5,18,0,0,73
1,18,2,9,20,5,18,19,0,92
1,18,2,9,20,8,0,0,0,58
1,18,2,9,20,18,1,7,5,81
1,18,2,9,20,18,1,12,0,81
1,18,2,9,20,18,1,18,25,112
1,18,2,9,20,18,1,20,5,94
1,18,2,9,20,18,5,0,0,73
1,18,2,9,20,18,5,18,0,91
1,18,2,9,20,18,5,19,19,111
1,18,2,9,20,18,25,0,0,93
1,18,2,12,1,19,20,0,0,73
1,18,2,15,12,15,3,15,0,81
1,18,2,15,18,0,0,0,0,54
1,18,2,15,18,1,12,0,0,67
1,18,2,15,18,1,18,25,0,98
1,18,2,15,18,1,20,15,18,108
1,18,2,15,18,5,1,0,0,60
1,18,2,15,18,5,1,12,0,72
1,18,2,15,18,5,1,14,0,74
1,18,2,15,18,5,4,0,0,63
1,18,2,15,18,5,15,21,19,114
1,18,2,15,18,5,18,0,0,77
1,18,2,15,18,5,19,0,0,78
1,18,2,15,18,5,20,0,0,79
1,18,2,15,18,5,20,1,0,80
1,18,2,15,18,5,20,21,13,113
1,18,2,15,18,25,0,0,0,79
1,18,2,15,18,9,3,1,12,79
1,18,2,15,18,9,19,5,0,87
1,18,2,15,18,9,19,20,0,102
1,18,2,15,18,9,19,20,19,121
1,18,2,15,18,9,26,5,0,94
1,18,2,15,18,9,26,5,4,98
1,18,2,15,18,9,26,5,19,113
1,18,2,15,18,15,9,4,0,82
1,18,2,15,18,15,21,19,0,109
1,18,2,15,18,19,0,0,0,73
1,18,2,15,18,23,1,25,0,103
1,18,2,15,20,1,0,0,0,57
1,18,2,15,21,18,0,0,0,75
1,18,2,15,21,18,5,4,0,84
1,18,2,15,21,18,19,0,0,94
1,18,2,15,22,9,18,21,19,125
1,18,2,19,0,0,0,0,0,40
1,18,2,20,18,14,0,0,0,73
1,18,2,21,19,3,12,5,0,81
1,18,2,21,19,3,12,5,19,100
1,18,2,21,19,3,21,12,1,98
1,18,2,21,19,3,21,12,5,102
1,18,2,21,19,20,0,0,0,81
1,18,2,21,19,20,1,0,0,82
1,18,2,21,19,20,21,13,0,115
1,18,2,21,20,1,19,5,0,87
1,18,2,21,20,5,0,0,0,67
1,18,2,21,20,5,1,14,0,82
1,18,2,21,20,5,19,0,0,86
1,18,2,21,20,9,14,0,0,85
1,18,2,21,20,21,19,0,0,102
1,18,2,21,20,21,19,5,19,126
1,18,3,1,0,0,0,0,0,23
1,18,3,1,4,5,0,0,0,32
1,18,3,1,4,5,4,0,0,36
1,18,3,1,4,5,19,0,0,51
1,18,3,1,4,9,1,14,19,70
1,18,3,1,4,9,1,19,0,56
1,18,3,1,4,9,14,7,0,57
1,18,3,1,4,9,14,7,19,76
1,18,3,1,5,0,0,0,0,28
1,18,3,1,14,1,0,0,0,38
1,18,3,1,14,1,12,0,0,50
1,18,3,1,14,5,0,0,0,42
1,18,3,1,14,9,19,20,0,85
1,18,3,1,14,9,20,5,0,71
1,18,3,1,14,21,13,19,0,90
1,18,3,1,20,5,0,0,0,48
1,18,3,1,20,15,0,0,0,58
1,18,3,1,20,21,18,5,0,87
1,18,3,1,20,21,18,5,19,106
1,18,3,3,15,19,0,0,0,59
1,18,3,3,15,19,9,14,5,87
1,18,3,5,4,0,0,0,0,31
1,18,3,5,19,0,0,0,0,46
1,18,3,6,15,18,13,0,0,74
1,18,3,8,0,0,0,0,0,30
1,18,3,8,1,5,0,0,0,36
1,18,3,8,1,5,15,12,0,63
1,18,3,8,1,5,21,19,0,76
1,18,3,8,1,9,0,0,0,40
1,18,3,8,1,9,3,1,12,56
1,18,3,8,1,9,19,5,0,64
1,18,3,8,1,9,19,5,4,68
1,18,3,8,1,9,19,5,18,82
1,18,3,8,1,9,19,5,19,83
1,18,3,8,1,9,19,13,0,72
1,18,3,8,1,9,19,13,19,91
1,18,3,8,1,9,19,20,0,79
1,18,3,8,1,9,19,20,19,98
1,18,3,8,1,9,26,5,0,71
1,18,3,8,1,9,26,5,4,75
1,18,3,8,1,9,26,5,18,89
1,18,3,8,1,9,26,5,19,90
1,18,3,8,1,18,9,15,19,92
1,18,3,8,2,1,14,3,0,50
1,18,3,8,2,1,14,3,19,69
1,18,3,8,2,1,14,4,0,51
1,18,3,8,3,8,9,5,6,61
1,18,3,8,3,9,20,25,0,87
1,18,3,8,3,15,21,14,20,103
1,18,3,8,3,18,15,23,14,103
1,18,3,8,4,5,1,14,0,54
1,18,3,8,4,5,13,15,14,81
1,18,3,8,4,5,22,9,12,82
1,18,3,8,4,15,12,20,0,81
1,18,3,8,4,18,21,9,4,86
1,18,3,8,4,21,3,1,12,71
1,18,3,8,4,21,3,8,25,91
1,18,3,8,4,21,11,5,0,71
1,18,3,8,4,21,11,5,19,90
1,18,3,8,4,21,24,5,0,84
1,18,3,8,5,0,0,0,0,35
1,18,3,8,5,1,12,0,0,48
1,18,3,8,5,1,18,12,0,66
1,18,3,8,5,2,1,14,3,55
1,18,3,8,5,4,0,0,0,39
1,18,3,8,5,7,1,25,0,68
1,18,3,8,5,7,15,14,5,76
1,18,3,8,5,7,15,14,25,96
1,18,3,8,5,9,15,14,0,73
1,18,3,8,5,12,15,7,25,94
1,18,3,8,5,14,5,13,25,92
1,18,3,8,5,14,9,1,0,59
1,18,3,8,5,15,12,0,0,62
1,18,3,8,5,18,5,19,19,96
1,18,3,8,5,18,25,0,0,78
1,18,3,8,5,18,9,5,19,86
1,18,3,8,5,18,19,0,0,72
1,18,3,8,5,19,20,0,0,74
1,18,3,8,5,20,25,16,5,101
1,18,3,8,5,20,20,15,0,90
1,18,3,8,5,20,20,15,19,109
1,18,3,8,5,21,19,0,0,75
1,18,3,8,6,5,12,15,14,82
1,18,3,8,6,9,18,5,0,68
1,18,3,8,6,15,5,0,0,56
1,18,3,8,6,15,15,12,0,78
1,18,3,8,6,15,18,13,0,82
1,18,3,8,7,15,4,0,0,56
1,18,3,8,8,5,1,4,0,48
1,18,3,8,8,5,1,18,20,82
1,18,3,8,8,15,19,20,0,92
1,18,3,8,8,15,21,19,5,98
1,18,3,8,25,0,0,0,0,55
1,18,3,8,9,1,20,5,18,83
1,18,3,8,9,3,1,12,0,55
1,18,3,8,9,3,1,18,16,77
1,18,3,8,9,3,25,20,5,92
1,18,3,8,9,4,15,13,5,76
1,18,3,8,9,7,15,14,25,100
1,18,3,8,9,12,0,0,0,51
1,18,3,8,9,12,12,1,0,64
1,18,3,8,9,12,15,23,5,94
1,18,3,8,9,12,19,0,0,70
1,18,3,8,9,12,21,20,5,97
1,18,3,8,9,13,1,7,5,65
1,18,3,8,9,13,9,13,5,79
1,18,3,8,9,14,0,0,0,53
1,18,3,8,9,14,5,0,0,58
1,18,3,8,9,14,5,19,0,77
1,18,3,8,9,14,7,0,0,60
1,18,3,8,9,14,7,19,0,79
1,18,3,8,9,16,9,14,0,78
1,18,3,8,9,20,0,0,0,59
1,18,3,8,9,20,5,3,20,87
1,18,3,8,9,20,9,19,0,87
1,18,3,8,9,22,1,12,0,74
1,18,3,8,9,22,5,0,0,66
1,18,3,8,9,22,5,4,0,70
1,18,3,8,9,22,5,18,0,84
1,18,3,8,9,22,5,18,19,103
1,18,3,8,9,22,5,19,0,85
1,18,3,8,9,22,9,14,7,91
1,18,3,8,9,22,9,19,20,109
1,18,3,8,9,22,15,12,20,108
1,18,3,8,9,26,15,9,3,92
1,18,3,8,11,9,14,7,0,71
1,18,3,8,11,14,1,22,5,83
1,18,3,8,12,5,20,0,0,67
1,18,3,8,12,25,0,0,0,67
1,18,3,8,12,9,1,18,0,70
1,18,3,8,12,21,20,5,0,88
1,18,3,8,13,9,13,5,0,70
1,18,3,8,13,15,3,11,0,72
1,18,3,8,14,5,19,19,0,87
1,18,3,8,15,3,5,12,5,70
1,18,3,8,15,12,15,7,25,104
1,18,3,8,15,14,0,0,0,59
1,18,3,8,15,14,19,0,0,78
1,18,3,8,15,14,20,0,0,79
1,18,3,8,15,14,20,9,3,91
1,18,3,8,16,1,12,12,0,71
1,18,3,8,16,9,5,3,5,68
1,18,3,8,16,15,5,20,0,86
1,18,3,8,18,5,2,5,12,72
1,18,3,8,18,15,7,21,5,96
1,18,3,8,18,21,12,5,18,104
1,18,3,8,19,1,9,14,20,93
1,18,3,8,19,5,5,0,0,59
1,18,3,8,19,5,23,5,18,100
1,18,3,8,19,9,14,0,0,72
1,18,3,8,19,14,15,2,0,80
1,18,3,8,19,16,25,0,0,90
1,18,3,8,20,0,0,0,0,50
1,18,3,8,20,8,9,5,6,78
1,18,3,8,21,18,7,5,18,99
1,18,3,8,23,1,7,0,0,61
1,18,3,8,23,1,25,0,0,79
1,18,3,8,23,1,25,19,0,98
1,18,3,8,23,5,14,3,8,83
1,18,3,8,23,9,6,5,0,73
1,18,3,8,23,9,19,5,0,86
1,18,3,9,6,15,18,13,0,83
1,18,3,9,14,7,0,0,0,52
1,18,3,11,5,4,0,0,0,42
1,18,3,11,9,14,7,0,0,63
1,18,3,12,5,14,7,20,8,88
1,18,3,12,9,11,5,0,0,59
1,18,3,15,7,18,1,16,8,87
1,18,3,15,19,5,0,0,0,61
1,18,3,15,19,15,12,9,1,93
1,18,3,19,9,14,0,0,0,64
1,18,3,19,9,14,5,0,0,69
1,18,3,19,9,14,5,19,0,88
1,18,3,20,1,14,0,0,0,57
1,18,3,20,1,20,9,15,14,101
1,18,3,20,9,1,14,0,0,66
1,18,3,20,9,3,9,1,14,78
1,18,3,20,9,3,9,26,5,94
1,18,3,20,9,3,19,0,0,73
1,18,3,20,9,9,4,0,0,64
1,18,3,20,9,20,21,4,5,101
1,18,3,20,15,9,4,0,0,70
1,18,3,21,1,12,0,0,0,56
1,18,3,21,1,12,5,0,0,61
1,18,3,21,1,12,9,1,0,66
1,18,3,21,1,20,5,0,0,69
1,18,3,21,1,20,5,4,0,73
1,18,3,21,1,20,5,12,25,106
1,18,3,21,1,20,9,15,14,102
1,18,3,21,2,15,19,0,0,79
1,18,3,21,12,1,0,0,0,56
1,18,3,21,12,9,20,5,0,89
1,18,3,21,19,0,0,0,0,62
1,18,3,21,19,5,19,0,0,86
1,18,4,0,0,0,0,0,0,23
1,18,4,1,19,19,0,0,0,62
1,18,4,1,19,19,9,14,5,90
1,18,4,5,2,0,0,0,0,30
1,18,4,5,2,19,0,0,0,49
1,18,4,5,9,4,0,0,0,41
1,18,4,5,12,9,15,0,0,64
1,18,4,5,12,12,1,5,0,58
1,18,4,5,14,3,25,0,0,70
1,18,4,5,14,3,9,5,19,78
1,18,4,5,14,14,9,20,5,90
1,18,4,5,14,20,0,0,0,62
1,18,4,5,14,20,12,25,0,99
1,18,4,5,18,0,0,0,0,46
1,18,4,9,12,12,1,0,0,57
1,18,4,9,19,8,0,0,0,59
1,18,4,9,20,9,0,0,0,61
1,18,4,9,20,15,0,0,0,67
1,18,4,15,9,19,5,0,0,71
1,18,4,15,18,0,0,0,0,56
1,18,4,15,18,19,0,0,0,75
1,18,4,15,21,18,0,0,0,77
1,18,4,15,21,18,19,0,0,96
1,18,4,18,9,0,0,0,0,50
1,18,4,18,9,7,8,0,0,65
1,18,4,21,0,0,0,0,0,44
1,18,4,21,9,14,9,20,5,101
1,18,4,21,15,21,19,0,0,99
1,18,4,21,15,21,19,12,25,136
1,18,4,21,18,5,0,0,0,67
1,18,4,21,18,15,21,19,0,117
1,18,5,1,0,0,0,0,0,25
1,18,5,1,3,8,0,0,0,36
1,18,5,1,4,0,0,0,0,29
1,18,5,1,4,25,0,0,0,54
1,18,5,1,5,0,0,0,0,30
1,18,5,1,12,0,0,0,0,37
1,18,5,1,12,9,20,25,0,91
1,18,5,1,12,12,25,0,0,74
1,18,5,1,18,0,0,0,0,43
1,18,5,1,19,0,0,0,0,44
1,18,5,1,19,15,14,0,0,73
1,18,5,1,19,15,14,5,18,96
1,18,5,1,23,1,25,0,0,74
1,18,5,1,23,1,25,19,0,93
1,18,5,1,23,9,4,5,0,66
1,18,5,3,1,9,4,9,14,64
1,18,5,3,1,9,14,0,0,51
1,18,5,3,1,9,14,5,0,56
1,18,5,3,1,19,0,0,0,47
1,18,5,3,8,5,0,0,0,40
1,18,5,3,15,12,9,14,0,77
1,18,5,3,15,12,9,14,5,82
1,18,5,4,0,0,0,0,0,28
1,18,5,5,11,0,0,0,0,40
1,18,5,5,12,0,0,0,0,41
1,18,5,6,1,3,20,0,0,54
1,18,5,6,25,0,0,0,0,55
1,18,5,7,0,0,0,0,0,31
1,18,5,9,3,0,0,0,0,36
1,18,5,9,20,15,0,0,0,68
1,18,5,14,0,0,0,0,0,38
1,18,5,14,1,5,0,0,0,44
1,18,5,14,1,18,9,1,5,72
1,18,5,14,1,19,0,0,0,58
1,18,5,14,1,20,9,15,14,97
1,18,5,14,4,0,0,0,0,42
1,18,5,14,4,1,20,15,18,96
1,18,5,14,7,0,0,0,0,45
1,18,5,14,9,3,15,12,5,82
1,18,5,14,9,20,5,0,0,72
1,18,5,14,9,20,5,19,0,91
1,18,5,14,15,9,4,0,0,66
1,18,5,14,15,19,5,0,0,77
1,18,5,14,15,19,9,20,25,126
1,18,5,14,15,21,19,0,0,93
1,18,5,14,20,0,0,0,0,58
1,18,5,14,21,12,15,21,19,126
1,18,5,15,12,1,0,0,0,52
1,18,5,15,12,1,5,0,0,57
1,18,5,15,12,1,18,0,0,70
1,18,5,15,12,1,19,0,0,71
1,18,5,15,12,1,20,5,0,77
1,18,5,15,12,1,20,5,4,81
1,18,5,15,12,5,0,0,0,56
1,18,5,15,12,5,19,0,0,75
1,18,5,15,12,5,20,0,0,76
1,18,5,15,12,15,7,25,0,98
1,18,5,15,12,15,7,9,3,85
1,18,5,15,13,5,20,5,18,100
1,18,5,15,13,5,20,18,25,120
1,18,5,15,16,1,7,25,0,88
1,18,5,15,19,20,25,12,5,120
1,18,5,18,5,0,0,0,0,47
1,18,5,18,15,12,1,0,0,70
1,18,5,19,20,0,0,0,0,63
1,18,5,20,1,9,3,19,0,76
1,18,5,20,1,12,15,7,25,104
1,18,5,20,5,19,0,0,0,68
1,18,5,20,8,21,19,1,19,112
1,18,5,23,0,0,0,0,0,47
1,18,6,9,12,12,9,20,5,92
1,18,6,19,0,0,0,0,0,44
1,18,7,1,9,12,5,0,0,53
1,18,7,1,12,0,0,0,0,39
1,18,7,1,12,1,0,0,0,40
1,18,7,1,12,1,19,0,0,59
1,18,7,1,12,9,0,0,0,48
1,18,7,1,12,9,19,0,0,67
1,18,7,1,12,19,0,0,0,58
1,18,7,1,14,0,0,0,0,41
1,18,7,1,14,4,0,0,0,45
1,18,7,1,14,19,0,0,0,60
1,18,7,1,19,9,4,0,0,59
1,18,7,5,5,18,19,0,0,73
1,18,7,5,12,0,0,0,0,43
1,18,7,5,13,1,0,0,0,45
1,18,7,5,13,15,14,25,0,98
1,18,7,5,14,15,12,0,0,72
1,18,7,5,14,20,1,12,0,78
1,18,7,5,14,20,1,14,0,80
1,18,7,5,14,20,1,20,5,91
1,18,7,5,14,20,5,18,0,88
1,18,7,5,14,20,5,21,13,104
1,18,7,5,14,20,9,3,0,77
1,18,7,5,14,20,9,4,5,83
1,18,7,5,14,20,9,14,0,88
1,18,7,5,14,20,9,15,14,103
1,18,7,5,14,20,9,20,5,99
1,18,7,5,14,20,15,12,0,92
1,18,7,5,14,20,15,14,0,94
1,18,7,5,14,20,15,19,5,104
1,18,7,5,14,20,15,21,19,120
1,18,7,5,14,20,18,25,0,108
1,18,7,5,14,20,19,0,0,84
1,18,7,5,14,20,21,13,0,99
1,18,7,5,14,20,21,13,19,118
1,18,7,8,0,0,0,0,0,34
1,18,7,8,1,14,0,0,0,49
1,18,7,8,5,12,0,0,0,51
1,18,7,8,15,15,12,0,0,76
1,18,7,8,15,21,12,0,0,82
1,18,7,9,6,25,0,0,0,66
1,18,7,9,12,0,0,0,0,47
1,18,7,25,12,5,19,0,0,87
1,18,7,9,12,12,9,3,0,71
1,18,7,9,12,12,15,9,4,87
1,18,7,9,12,12,15,21,19,114
1,18,7,25,12,12,19,0,0,94
1,18,7,9,12,19,0,0,0,66
1,18,7,9,14,0,0,0,0,49
1,18,7,9,14,1,19,5,0,74
1,18,7,9,14,1,19,5,19,93
1,18,7,9,14,5,0,0,0,54
1,18,7,9,14,9,14,5,0,77
1,18,7,9,14,9,14,5,19,96
1,18,7,25,18,9,1,0,0,79
1,18,7,25,18,9,3,0,0,81
1,18,7,25,18,9,20,5,0,103
1,18,7,25,18,15,19,5,0,108
1,18,7,25,18,15,19,9,19,131
1,18,7,12,5,0,0,0,0,43
1,18,7,12,5,4,0,0,0,47
1,18,7,12,5,19,0,0,0,62
1,18,7,12,9,14,7,0,0,68
1,18,7,15,12,0,0,0,0,53
1,18,7,15,12,5,20,0,0,78
1,18,7,15,12,19,0,0,0,72
1,18,7,15,14,0,0,0,0,55
1,18,7,15,14,1,21,20,19,116
1,18,7,15,14,15,14,0,0,84
1,18,7,15,14,19,0,0,0,74
1,18,7,15,19,25,0,0,0,85
1,18,7,15,19,9,5,19,0,93
1,18,7,15,19,9,14,5,0,88
1,18,7,15,20,0,0,0,0,61
1,18,7,15,20,9,3,0,0,73
1,18,7,15,20,19,0,0,0,80
1,18,7,21,1,2,12,5,0,67
1,18,7,21,1,2,12,25,0,87
1,18,7,21,5,0,0,0,0,52
1,18,7,21,5,4,0,0,0,56
1,18,7,21,5,14,4,15,0,85
1,18,7,21,5,18,0,0,0,70
1,18,7,21,5,18,19,0,0,89
1,18,7,21,5,19,0,0,0,71
1,18,7,21,6,25,0,0,0,78
1,18,7,21,6,9,5,4,0,71
1,18,7,21,6,9,5,18,0,85
1,18,7,21,6,9,5,18,19,104
1,18,7,21,6,9,5,19,0,86
1,18,7,21,6,25,9,14,7,108
1,18,7,21,9,14,7,0,0,77
1,18,7,21,13,5,14,20,0,99
1,18,7,21,13,5,14,20,1,100
1,18,7,21,13,5,14,20,19,118
1,18,7,21,19,5,19,0,0,90
1,18,7,21,19,6,9,19,8,108
1,18,7,21,20,1,0,0,0,68
1,18,7,21,20,5,0,0,0,72
1,18,7,21,20,5,12,25,0,109
1,18,8,1,18,0,0,0,0,46
1,18,8,1,20,19,0,0,0,67
1,18,8,25,20,8,13,9,1,103
1,18,8,25,20,8,13,9,3,105
1,18,25,0,0,0,0,0,0,44
1,18,9,1,14,0,0,0,0,43
1,18,9,1,14,9,19,20,0,91
1,18,9,1,14,9,19,20,19,110
1,18,25,1,14,19,0,0,0,78
1,18,9,1,19,0,0,0,0,48
1,18,25,2,1,12,12,9,0,80
1,18,25,2,1,12,12,15,9,95
1,18,25,2,1,12,12,15,19,105
1,18,25,2,1,12,12,21,19,111
1,18,25,2,2,1,12,12,9,82
1,18,9,2,9,14,0,0,0,53
1,18,9,2,9,14,5,0,0,58
1,18,9,3,9,14,0,0,0,54
1,18,9,3,9,14,5,0,0,59
1,18,9,4,0,0,0,0,0,32
1,18,9,4,5,18,0,0,0,55
1,18,9,4,5,19,20,0,0,76
1,18,9,4,7,5,0,0,0,44
1,18,9,4,9,1,14,0,0,56
1,18,9,4,9,20,25,0,0,86
1,18,9,4,9,20,9,5,19,94
1,18,9,4,12,25,0,0,0,69
1,18,9,4,14,5,19,19,0,89
1,18,9,5,7,9,20,5,0,74
1,18,9,5,12,19,0,0,0,64
1,18,9,5,14,26,15,0,0,88
1,18,9,5,20,1,20,5,0,79
1,18,9,5,20,20,1,0,0,74
1,18,9,5,20,20,1,19,0,93
1,18,9,5,20,20,5,0,0,78
1,18,9,5,20,20,5,19,0,97
1,18,9,7,8,20,0,0,0,63
1,18,9,7,8,20,12,25,0,100
1,18,9,7,21,5,0,0,0,61
1,18,9,11,9,0,0,0,0,48
1,18,9,12,0,0,0,0,0,40
1,18,25,12,0,0,0,0,0,56
1,18,25,12,1,13,9,14,5,98
1,18,25,12,1,13,9,14,15,108
1,18,25,12,1,20,5,0,0,82
1,18,25,12,1,20,5,4,0,86
1,18,25,12,1,20,9,14,7,107
1,18,25,12,1,20,9,15,14,115
1,18,9,12,5,4,0,0,0,49
1,18,25,12,9,4,5,0,0,74
1,18,9,12,12,1,18,25,0,96
1,18,9,12,12,1,20,5,0,78
1,18,9,12,12,1,20,5,4,82
1,18,9,12,12,5,4,0,0,61
1,18,9,12,12,9,0,0,0,61
1,18,9,12,12,15,4,5,0,76
1,18,9,12,12,15,4,5,19,95
1,18,9,12,12,15,9,4,0,80
1,18,9,12,12,21,19,0,0,92
1,18,9,12,19,0,0,0,0,59
1,18,25,12,19,0,0,0,0,75
1,18,9,15,12,1,20,5,0,81
1,18,9,15,12,5,0,0,0,60
1,18,9,15,19,5,0,0,0,67
1,18,9,15,19,9,0,0,0,71
1,18,9,15,19,15,0,0,0,77
1,18,9,15,19,15,19,0,0,96
1,18,9,15,20,0,0,0,0,63
1,18,9,15,21,19,0,0,0,83
1,18,9,16,16,12,5,0,0,77
1,18,9,19,1,9,4,0,0,61
1,18,9,19,1,18,4,0,0,70
1,18,9,19,5,0,0,0,0,52
1,18,9,19,5,4,0,0,0,56
1,18,9,19,5,14,0,0,0,66
1,18,9,19,5,18,0,0,0,70
1,18,9,19,5,19,0,0,0,71
1,18,9,19,8,0,0,0,0,55
1,18,9,19,9,14,7,0,0,77
1,18,9,19,9,14,7,19,0,96
1,18,9,19,20,0,0,0,0,67
1,18,9,19,20,1,5,0,0,73
1,18,9,19,20,1,19,0,0,87
1,18,9,19,20,1,20,5,0,93
1,18,9,19,20,5,0,0,0,72
1,18,9,19,20,5,9,1,0,82
1,18,9,19,20,15,9,0,0,91
1,18,9,19,20,15,19,0,0,101
1,18,9,20,5,0,0,0,0,53
1,18,25,20,5,14,15,9,4,111
1,18,9,20,8,0,0,0,0,56
1,18,25,20,8,13,9,1,0,95
1,18,25,20,8,13,9,1,19,114
1,18,9,20,8,13,9,3,0,81
1,18,25,20,8,13,9,3,0,97
1,18,9,21,13,0,0,0,0,62
1,18,9,26,15,14,1,14,19,117
1,18,9,26,15,14,9,20,5,117
1,18,11,1,14,19,1,14,19,98
1,18,11,1,14,19,9,20,5,98
1,18,11,15,19,5,0,0,0,69
1,18,11,15,19,5,19,0,0,88
1,18,11,15,19,9,3,0,0,76
1,18,11,19,0,0,0,0,0,49
1,18,11,19,21,20,9,20,5,124
1,18,12,5,0,0,0,0,0,36
1,18,12,5,19,19,0,0,0,74
1,18,12,9,14,7,0,0,0,61
1,18,12,15,21,16,0,0,0,83
1,18,13,1,4,1,19,0,0,57
1,18,13,1,4,9,12,12,1,71
1,18,13,1,4,9,12,12,15,85
1,18,13,1,7,14,1,3,19,77
1,18,13,1,13,5,14,20,0,85
1,18,13,1,13,5,14,20,19,104
1,18,13,1,14,7,9,20,5,88
1,18,13,1,18,25,0,0,0,76
1,18,13,1,18,9,1,0,0,61
1,18,13,1,18,9,1,14,0,75
1,18,13,1,18,9,5,19,0,84
1,18,13,1,18,9,21,13,0,94
1,18,13,1,20,21,18,5,0,97
1,18,13,1,20,21,18,5,4,101
1,18,13,1,20,21,18,5,19,116
1,18,13,2,1,14,4,0,0,53
1,18,13,2,1,14,4,19,0,72
1,18,13,2,15,14,5,0,0,68
1,18,13,3,8,1,9,18,0,71
1,18,13,3,8,1,9,18,19,90
1,18,13,5,4,0,0,0,0,41
1,18,13,5,14,9,1,14,19,94
1,18,13,5,14,9,20,5,0,85
1,18,13,5,18,0,0,0,0,55
1,18,13,5,18,19,0,0,0,74
1,18,13,5,20,0,0,0,0,57
1,18,13,5,20,19,0,0,0,76
1,18,13,6,21,12,0,0,0,71
1,18,13,6,21,12,19,0,0,90
1,18,13,7,1,21,14,20,0,95
1,18,13,7,21,1,18,4,0,83
1,18,13,8,15,12,5,0,0,72
1,18,13,8,15,12,5,19,0,91
1,18,13,8,15,15,16,0,0,86
1,18,13,25,0,0,0,0,0,57
1,18,13,9,5,4,0,0,0,50
1,18,13,9,5,19,0,0,0,65
1,18,13,9,7,5,18,0,0,71
1,18,13,9,7,5,18,1,12,84
1,18,13,9,7,5,18,9,0,80
1,18,13,9,7,5,18,15,0,86
1,18,13,9,7,5,18,15,19,105
1,18,13,9,7,5,18,19,0,90
1,18,13,9,12,12,0,0,0,65
1,18,13,9,12,12,1,5,0,71
1,18,13,9,12,12,1,18,25,109
1,18,13,9,12,12,1,20,5,91
1,18,13,9,14,5,0,0,0,60
1,18,13,9,14,7,0,0,0,62
1,18,13,9,14,7,19,0,0,81
1,18,13,9,19,20,9,3,5,97
1,18,13,9,20,0,0,0,0,61
1,18,13,9,20,1,19,0,0,81
1,18,13,25,23,15,18,13,0,126
1,18,13,25,23,15,18,13,19,145
1,18,13,12,5,19,19,0,0,87
1,18,13,12,5,19,19,12,25,124
1,18,13,12,5,20,0,0,0,69
1,18,13,12,5,20,19,0,0,88
1,18,13,12,9,11,5,0,0,69
1,18,13,12,15,1,4,0,0,64
1,18,13,12,15,1,4,19,0,83
1,18,13,12,15,3,11,0,0,73
1,18,13,12,15,3,11,19,0,92
1,18,13,15,9,18,5,0,0,79
1,18,13,15,9,18,5,19,0,98
1,18,13,15,13,1,14,3,25,103
1,18,13,15,14,9,1,3,0,74
1,18,13,15,14,9,3,1,0,74
1,18,13,15,14,9,3,1,19,93
1,18,13,15,18,0,0,0,0,65
1,18,13,15,18,5,4,0,0,74
1,18,13,15,18,5,18,0,0,88
1,18,13,15,18,5,18,19,0,107
1,18,13,15,18,25,0,0,0,90
1,18,13,15,18,9,1,12,0,87
1,18,13,15,18,9,1,12,19,106
1,18,13,15,18,9,5,4,0,83
1,18,13,15,18,9,5,19,0,98
1,18,13,15,18,9,14,7,0,95
1,18,13,15,18,9,19,20,0,113
1,18,13,15,18,12,5,19,19,120
1,18,13,15,18,19,0,0,0,84
1,18,13,15,18,23,9,19,5,121
1,18,13,15,21,18,5,4,0,95
1,18,13,15,21,18,5,18,0,109
1,18,13,15,21,18,5,18,19,128
1,18,13,15,21,18,25,0,0,111
1,18,13,15,21,18,9,5,19,119
1,18,13,15,21,18,9,14,7,116
1,18,13,15,21,18,19,0,0,105
1,18,13,15,26,5,5,14,0,97
1,18,13,15,26,9,14,5,0,101
1,18,13,16,1,4,0,0,0,53
1,18,13,16,9,5,3,5,0,70
1,18,13,16,9,20,0,0,0,77
1,18,13,16,9,20,19,0,0,96
1,18,13,16,12,1,20,5,0,86
1,18,13,18,1,3,11,0,0,65
1,18,13,18,5,19,20,0,0,94
1,18,13,18,5,19,20,19,0,113
1,18,13,19,0,0,0,0,0,51
1,18,13,19,3,25,5,0,0,84
1,18,13,19,5,25,5,0,0,86
1,18,13,19,6,21,12,0,0,90
1,18,13,19,9,26,5,0,0,91
1,18,13,21,18,5,0,0,0,76
1,18,13,21,18,5,19,0,0,95
1,18,14,0,0,0,0,0,0,33
1,18,14,1,0,0,0,0,0,34
1,18,14,1,20,20,1,0,0,75
1,18,14,1,20,20,15,0,0,89
1,18,14,1,20,20,15,19,0,108
1,18,14,2,5,18,18,25,0,101
1,18,14,5,5,0,0,0,0,43
1,18,14,5,13,5,14,20,0,90
1,18,14,9,3,1,0,0,0,46
1,18,14,9,3,1,19,0,0,65
1,18,14,15,20,20,1,0,0,89
1,18,14,15,20,20,15,0,0,103
1,18,14,15,20,20,15,19,0,122
1,18,14,21,20,0,0,0,0,74
1,18,15,1,18,0,0,0,0,53
1,18,15,1,19,20,0,0,0,74
1,18,15,5,9,18,1,0,0,67
1,18,15,9,4,0,0,0,0,47
1,18,15,9,4,5,15,21,19,107
1,18,15,9,4,19,0,0,0,66
1,18,15,9,14,20,0,0,0,77
1,18,15,25,14,20,0,0,0,93
1,18,15,9,14,20,5,4,0,86
1,18,15,25,14,20,5,4,0,102
1,18,15,9,14,20,9,14,7,107
1,18,15,25,14,20,9,14,7,123
1,18,15,9,14,20,19,0,0,96
1,18,15,25,14,20,19,0,0,112
1,18,15,12,9,1,0,0,0,56
1,18,15,12,9,21,13,0,0,89
1,18,15,12,12,1,0,0,0,59
1,18,15,13,1,0,0,0,0,48
1,18,15,13,1,3,9,20,25,105
1,18,15,13,1,12,0,0,0,60
1,18,15,13,1,20,1,0,0,69
1,18,15,13,1,20,9,3,0,80
1,18,15,13,1,20,9,3,19,99
1,18,15,13,1,20,9,19,5,101
1,18,15,13,1,20,9,20,5,102
1,18,15,13,1,20,9,26,5,108
1,18,15,13,1,20,15,21,19,123
1,18,15,15,14,0,0,0,0,63
1,18,15,16,8,0,0,0,0,58
1,18,15,19,5,0,0,0,0,58
1,18,15,21,14,4,0,0,0,73
1,18,15,21,19,1,2,12,5,94
1,18,15,21,19,1,12,0,0,87
1,18,15,21,19,1,12,19,0,106
1,18,15,21,19,5,0,0,0,79
1,18,15,21,19,5,4,0,0,83
1,18,15,21,19,5,18,0,0,97
1,18,15,21,19,5,18,19,0,116
1,18,15,21,19,5,19,0,0,98
1,18,15,21,19,9,14,7,0,104
1,18,15,23,0,0,0,0,0,57
1,18,15,24,25,12,0,0,0,95
1,18,16,5,7,7,9,15,0,78
1,18,16,5,7,7,9,15,19,97
1,18,16,5,14,0,0,0,0,54
1,18,16,5,14,19,0,0,0,73
1,18,16,5,14,20,0,0,0,74
1,18,16,5,14,20,5,21,18,118
1,18,16,5,14,20,19,0,0,93
1,18,17,21,1,20,5,4,0,87
1,18,17,21,5,2,21,19,0,104
1,18,17,21,5,18,9,20,5,114
1,18,17,21,9,6,15,21,24,132
1,18,18,0,0,0,0,0,0,37
1,18,18,1,3,1,3,8,0,53
1,18,18,1,3,1,3,8,1,54
1,18,18,1,3,5,0,0,0,46
1,18,18,1,3,8,0,0,0,49
1,18,18,1,3,11,0,0,0,52
1,18,18,1,3,11,19,0,0,71
1,18,18,1,7,5,0,0,0,50
1,18,18,1,8,0,0,0,0,46
1,18,18,1,25,0,0,0,0,63
1,18,18,1,25,1,12,0,0,76
1,18,18,1,25,1,12,19,0,95
1,18,18,1,25,1,14,0,0,78
1,18,18,1,25,5,4,0,0,72
1,18,18,1,25,5,18,0,0,86
1,18,18,1,25,5,18,19,0,105
1,18,18,1,9,7,14,0,0,68
1,18,18,1,9,7,14,5,4,77
1,18,18,1,9,7,14,5,18,91
1,18,18,1,9,7,14,19,0,87
1,18,18,1,25,9,14,7,0,93
1,18,18,1,25,13,5,14,20,115
1,18,18,1,25,19,0,0,0,82
1,18,18,1,13,5,0,0,0,56
1,18,18,1,14,4,0,0,0,56
1,18,18,1,14,7,5,0,0,64
1,18,18,1,14,7,5,4,0,68
1,18,18,1,14,7,5,18,0,82
1,18,18,1,14,7,5,18,19,101
1,18,18,1,14,7,5,19,0,83
1,18,18,1,14,7,9,14,7,89
1,18,18,1,14,20,0,0,0,72
1,18,18,1,14,20,12,25,0,109
1,18,18,1,19,5,4,0,0,66
1,18,18,1,19,5,14,5,0,81
1,18,18,1,19,5,19,0,0,81
1,18,18,1,19,20,18,1,0,96
1,18,18,1,19,20,18,5,0,100
1,18,18,1,20,5,12,0,0,75
1,18,18,5,1,18,0,0,0,61
1,18,18,5,1,18,1,7,5,74
1,18,18,5,1,18,19,0,0,80
1,18,18,5,3,20,0,0,0,65
1,18,18,5,3,20,1,18,25,109
1,18,18,5,3,20,15,18,0,98
1,18,18,5,14,20,0,0,0,76
1,18,18,5,16,20,9,15,14,116
1,18,18,5,19,20,0,0,0,81
1,18,18,5,19,20,1,14,20,116
1,18,18,5,19,20,5,4,0,90
1,18,18,5,19,20,5,5,0,91
1,18,18,5,19,20,5,5,19,110
1,18,18,5,19,20,5,18,0,104
1,18,18,5,19,20,5,18,19,123
1,18,18,5,19,20,9,14,7,111
1,18,18,5,19,20,9,22,5,117
1,18,18,5,19,20,15,18,0,114
1,18,18,5,19,20,15,18,19,133
1,18,18,5,19,20,19,0,0,100
1,18,18,5,20,0,0,0,0,62
1,18,18,5,20,5,26,0,0,93
1,18,18,7,20,0,0,0,0,64
1,18,18,8,1,0,0,0,0,46
1,18,18,8,1,12,0,0,0,58
1,18,18,8,5,14,1,12,0,77
1,18,18,8,5,14,15,9,4,92
1,18,18,8,9,14,9,1,0,78
1,18,18,8,25,20,8,13,25,136
1,18,18,8,9,26,1,12,0,93
1,18,18,8,9,26,15,21,19,135
1,18,18,9,1,7,5,0,0,59
1,18,18,9,2,1,4,1,19,73
1,18,18,9,3,3,9,0,0,61
1,18,18,9,3,3,9,15,0,76
1,18,18,9,3,3,9,15,19,95
1,18,18,9,4,5,0,0,0,55
1,18,18,9,4,5,4,0,0,59
1,18,18,9,4,7,5,0,0,62
1,18,18,9,4,9,14,7,0,80
1,18,18,9,5,0,0,0,0,51
1,18,18,9,5,18,5,0,0,74
1,18,18,9,5,18,15,0,0,84
1,18,18,9,13,2,25,0,0,86
1,18,18,9,19,0,0,0,0,65
1,18,18,9,19,5,19,0,0,89
1,18,18,9,19,8,0,0,0,73
1,18,18,9,19,23,1,25,19,133
1,18,18,9,19,23,9,19,5,121
1,18,18,25,20,8,13,9,1,113
1,18,18,25,20,8,13,9,3,115
1,18,18,9,22,1,7,5,0,81
1,18,18,9,22,1,12,0,0,81
1,18,18,9,22,1,12,19,0,100
1,18,18,9,22,1,14,3,5,91
1,18,18,9,22,5,0,0,0,73
1,18,18,9,22,5,4,0,0,77
1,18,18,9,22,5,18,0,0,91
1,18,18,9,22,5,18,19,0,110
1,18,18,9,22,5,19,0,0,92
1,18,18,9,22,9,14,7,0,98
1,18,18,9,22,9,19,13,0,109
1,18,18,9,22,9,19,13,5,114
1,18,18,9,22,9,19,20,0,116
1,18,18,9,22,9,19,20,5,121
1,18,18,15,2,1,0,0,0,55
1,18,18,15,2,1,19,0,0,74
1,18,18,15,4,5,0,0,0,61
1,18,18,15,7,1,14,3,5,82
1,18,18,15,7,1,14,3,25,102
1,18,18,15,7,1,14,20,0,94
1,18,18,15,7,1,20,5,0,85
1,18,18,15,7,1,20,5,4,89
1,18,18,15,7,1,20,5,19,104
1,18,18,15,7,1,20,15,18,113
1,18,18,15,25,1,0,0,0,78
1,18,18,15,25,15,0,0,0,92
1,18,18,15,25,15,19,0,0,111
1,18,18,15,25,21,5,12,15,130
1,18,18,15,14,4,9,0,0,79
1,18,18,15,16,5,0,0,0,73
1,18,18,15,19,9,15,14,0,109
1,18,18,15,19,9,22,5,0,107
1,18,18,15,21,14,4,0,0,91
1,18,18,15,21,19,5,0,0,97
1,18,18,15,23,0,0,0,0,75
1,18,18,15,23,2,21,19,8,125
1,18,18,15,23,5,4,0,0,84
1,18,18,15,23,8,5,1,4,93
1,18,18,15,23,25,0,0,0,100
1,18,18,15,23,9,14,7,0,105
1,18,18,15,23,12,5,1,6,99
1,18,18,15,23,12,5,19,19,130
1,18,18,15,23,12,5,20,0,112
1,18,18,15,23,12,9,11,5,112
1,18,18,15,23,18,15,15,20,143
1,18,18,15,23,19,0,0,0,94
1,18,18,15,23,23,5,5,4,112
1,18,18,15,23,23,15,15,4,132
1,18,18,15,23,23,15,18,13,144
1,18,18,15,26,0,0,0,0,78
1,18,18,20,5,26,0,0,0,88
1,18,19,1,14,9,12,9,3,86
1,18,19,5,0,0,0,0,0,43
1,18,19,5,4,9,14,5,0,75
1,18,19,5,6,15,15,20,0,99
1,18,19,5,8,15,12,5,0,83
1,18,19,5,14,1,12,0,0,70
1,18,19,5,14,1,12,19,0,89
1,18,19,5,14,1,20,5,0,83
1,18,19,5,14,1,20,5,19,102
1,18,19,5,14,5,20,5,4,91
1,18,19,5,14,6,1,19,20,103
1,18,19,5,14,9,1,20,5,92
1,18,19,5,14,9,3,0,0,69
1,18,19,5,14,9,3,1,12,82
1,18,19,5,14,9,3,19,0,88
1,18,19,5,14,9,4,5,0,75
1,18,19,5,14,9,4,5,19,94
1,18,19,5,14,25,12,0,0,94
1,18,19,5,14,9,12,12,15,105
1,18,19,5,14,9,15,21,19,121
1,18,19,5,14,9,19,13,0,98
1,18,19,5,14,9,20,5,0,91
1,18,19,5,14,9,20,5,19,110
1,18,19,5,14,9,21,13,0,100
1,18,19,5,14,15,0,0,0,72
1,18,19,5,14,15,21,19,0,112
1,18,19,5,19,0,0,0,0,62
1,18,19,5,19,13,1,18,20,114
1,18,19,8,5,5,14,0,0,70
1,18,19,8,9,14,0,0,0,69
1,18,19,8,9,14,5,0,0,74
1,18,19,8,9,14,19,0,0,88
1,18,19,25,12,0,0,0,0,75
1,18,19,25,12,5,14,5,0,99
1,18,19,9,14,5,0,0,0,66
1,18,19,9,14,5,19,0,0,85
1,18,19,9,14,9,3,0,0,73
1,18,19,9,14,15,0,0,0,76
1,18,19,9,19,0,0,0,0,66
1,18,19,25,22,5,18,19,25,152
1,18,19,12,5,0,0,0,0,55
1,18,19,13,5,20,9,11,0,96
1,18,19,13,5,20,18,25,0,119
1,18,19,13,5,20,18,9,11,114
1,18,19,14,9,3,11,5,18,98
1,18,19,15,9,20,5,0,0,87
1,18,19,15,14,0,0,0,0,67
1,18,19,15,14,1,20,5,0,93
1,18,19,15,14,9,3,0,0,79
1,18,19,15,14,9,19,20,0,115
1,18,19,15,14,9,19,20,19,134
1,18,19,15,14,9,20,5,0,101
1,18,19,15,14,9,21,13,0,110
1,18,19,15,14,15,0,0,0,82
1,18,19,15,14,15,21,19,0,122
1,18,19,15,14,19,0,0,0,86
1,18,20,0,0,0,0,0,0,39
1,18,20,1,2,1,0,0,0,43
1,18,20,1,2,5,0,0,0,47
1,18,20,1,12,0,0,0,0,52
1,18,20,1,18,0,0,0,0,58
1,18,20,1,18,9,14,0,0,81
1,18,20,1,18,9,14,5,0,86
1,18,20,3,18,1,6,20,0,87
1,18,20,5,6,1,3,0,0,54
1,18,20,5,6,1,3,20,0,74
1,18,20,5,6,1,3,20,19,93
1,18,20,5,12,0,0,0,0,56
1,18,20,5,12,19,0,0,0,75
1,18,20,5,13,9,19,9,3,97
1,18,20,5,13,9,19,9,14,108
1,18,20,5,13,15,14,0,0,86
1,18,20,5,18,0,0,0,0,62
1,18,20,5,18,25,0,0,0,87
1,18,20,5,18,9,1,0,0,72
1,18,20,5,18,9,1,3,0,75
1,18,20,5,18,9,1,5,0,77
1,18,20,5,18,9,1,12,0,84
1,18,20,5,18,9,1,12,19,103
1,18,20,5,18,9,5,4,0,80
1,18,20,5,18,9,5,19,0,95
1,18,20,5,18,25,9,14,7,117
1,18,20,5,18,9,14,0,0,85
1,18,20,5,18,9,15,12,5,103
1,18,20,5,18,9,15,21,19,126
1,18,20,5,18,9,20,9,19,119
1,18,20,6,21,12,0,0,0,78
1,18,20,6,21,12,12,25,0,115
1,18,20,8,5,12,0,0,0,64
1,18,20,8,5,13,9,19,0,93
1,18,20,8,15,7,18,1,13,101
1,18,20,8,18,1,0,0,0,66
1,18,20,8,18,1,7,18,1,92
1,18,20,8,18,1,12,0,0,78
1,18,20,8,18,9,20,9,3,106
1,18,20,8,18,9,20,9,19,122
1,18,20,8,18,15,4,9,1,94
1,18,20,8,18,15,4,9,3,96
1,18,20,8,18,15,14,0,0,94
1,18,20,8,18,15,16,15,4,115
1,18,20,8,18,15,19,5,19,123
1,18,20,8,18,15,19,9,1,109
1,18,20,8,18,15,19,9,19,127
1,18,20,8,18,15,21,19,0,120
1,18,20,9,1,4,0,0,0,53
1,18,20,9,3,0,0,0,0,51
1,18,20,9,3,8,15,11,5,90
1,18,20,9,3,12,5,0,0,68
1,18,20,9,3,12,5,4,0,72
1,18,20,9,3,12,5,19,0,87
1,18,20,9,3,12,9,14,7,93
1,18,20,9,3,21,12,1,18,103
1,18,20,9,3,21,12,21,19,124
1,18,20,9,5,18,0,0,0,71
1,18,20,9,5,19,20,0,0,92
1,18,20,9,6,1,3,20,0,78
1,18,20,9,6,1,3,20,19,97
1,18,20,9,6,5,24,0,0,83
1,18,20,9,6,9,3,5,0,71
1,18,20,9,6,9,3,5,18,89
1,18,20,9,6,9,3,5,19,90
1,18,20,9,12,25,0,0,0,85
1,18,20,9,12,9,26,5,0,100
1,18,20,9,12,12,5,18,0,95
1,18,20,9,12,12,5,18,25,120
1,18,20,9,14,5,19,19,0,105
1,18,20,9,14,9,20,5,0,96
1,18,20,9,19,1,14,0,0,82
1,18,20,9,19,1,14,1,12,95
1,18,20,9,19,1,14,18,25,125
1,18,20,9,19,1,14,19,0,101
1,18,20,9,19,20,0,0,0,87
1,18,20,9,19,20,4,15,13,119
1,18,20,9,19,20,5,0,0,92
1,18,20,9,19,20,5,19,0,111
1,18,20,9,19,20,5,19,19,130
1,18,20,9,19,20,9,3,0,99
1,18,20,9,19,20,18,25,0,130
1,18,20,9,19,20,19,0,0,106
1,18,20,9,26,5,0,0,0,79
1,18,20,12,5,19,19,0,0,94
1,18,20,12,5,19,19,12,25,131
1,18,20,12,5,20,0,0,0,76
1,18,20,12,25,0,0,0,0,76
1,18,20,12,9,11,5,0,0,76
1,18,20,13,15,2,9,12,5,95
1,18,20,15,12,1,20,5,18,110
1,18,20,15,12,1,20,18,25,130
1,18,20,15,20,25,16,5,0,120
1,18,20,15,20,25,16,25,0,140
1,18,20,15,21,0,0,0,0,75
1,18,20,19,0,0,0,0,0,58
1,18,20,19,25,0,0,0,0,83
1,18,20,19,9,5,18,0,0,90
1,18,20,19,9,5,19,20,0,111
1,18,20,19,13,1,14,0,0,86
1,18,20,23,1,18,5,0,0,86
1,18,20,23,15,18,11,0,0,106
1,18,20,23,15,18,11,19,0,125
1,18,21,7,15,12,1,0,0,75
1,18,21,7,15,12,1,19,0,94
1,18,21,7,21,12,1,0,0,81
1,18,21,7,21,12,1,19,0,100
1,18,21,9,0,0,0,0,0,49
1,18,21,11,5,0,0,0,0,56
1,18,21,13,9,14,0,0,0,76
1,18,21,13,12,9,11,5,0,90
1,18,21,13,19,0,0,0,0,72
1,18,21,16,1,0,0,0,0,57
1,18,21,19,1,0,0,0,0,60
1,18,21,19,16,5,24,0,0,104
1,18,21,19,16,9,3,5,0,92
1,18,21,19,16,9,3,5,19,111
1,18,21,19,16,9,3,25,0,112
1,18,21,19,20,12,5,0,0,96
1,18,22,5,10,15,14,0,0,85
1,18,22,5,12,0,0,0,0,58
1,18,22,9,3,15,12,5,0,85
1,18,22,15,19,0,0,0,0,75
1,18,24,0,0,0,0,0,0,43
1,18,26,1,14,0,0,0,0,60
1,18,26,18,21,14,9,20,5,132
1,18,26,21,14,0,0,0,0,80
1,19,2,0,0,0,0,0,0,22
1,19,2,5,19,20,0,0,0,66
1,19,2,5,19,20,9,3,0,78
1,19,2,5,19,20,9,14,5,94
1,19,2,5,19,20,15,9,4,94
1,19,2,5,19,20,15,19,0,100
1,19,2,5,19,20,15,21,19,121
1,19,2,5,19,20,21,19,0,106
1,19,2,15,12,1,14,0,0,64
1,19,2,15,12,1,14,5,0,69
1,19,2,15,12,9,14,0,0,72
1,19,2,15,12,9,14,5,0,77
1,19,2,15,12,9,20,5,0,83
1,19,3,1,14,0,0,0,0,38
1,19,3,1,16,5,0,0,0,45
1,19,3,1,18,5,0,0,0,47
1,19,3,1,18,5,4,0,0,51
1,19,3,1,18,9,4,0,0,55
1,19,3,1,18,9,4,5,19,79
1,19,3,1,18,9,4,15,12,82
1,19,3,1,18,9,4,19,0,74
1,19,3,1,18,15,14,0,0,71
1,19,3,5,2,3,0,0,0,33
1,19,3,5,12,12,9,0,0,61
1,19,3,5,12,12,21,19,0,92
1,19,3,5,14,3,5,0,0,50
1,19,3,5,14,4,0,0,0,46
1,19,3,5,14,4,1,14,20,81
1,19,3,5,14,4,5,4,0,55
1,19,3,5,14,4,5,14,20,85
1,19,3,5,14,4,5,18,0,69
1,19,3,5,14,4,5,18,19,88
1,19,3,5,14,4,9,14,7,76
1,19,3,5,14,4,19,0,0,65
1,19,3,5,14,19,5,21,18,105
1,19,3,5,14,19,9,22,5,97
1,19,3,5,14,19,15,18,0,94
1,19,3,5,14,20,0,0,0,62
1,19,3,5,14,20,19,0,0,81
1,19,3,5,18,20,1,9,14,90
1,19,3,5,19,3,5,14,20,89
1,19,3,5,19,5,19,0,0,71
1,19,3,5,19,9,19,0,0,75
1,19,3,5,20,9,3,0,0,60
1,19,3,5,20,9,3,1,12,73
1,19,3,5,20,9,3,19,0,79
1,19,3,8,5,18,0,0,0,54
1,19,3,8,9,19,20,9,3,91
1,19,3,9,0,0,0,0,0,32
1,19,3,9,1,14,0,0,0,47
1,19,3,9,1,14,19,0,0,66
1,19,3,9,3,9,4,9,1,58
1,19,3,9,4,9,1,14,0,60
1,19,3,9,4,9,1,14,19,79
1,19,3,9,4,9,1,20,5,71
1,19,3,9,4,9,9,1,0,55
1,19,3,9,4,9,15,9,4,73
1,19,3,9,4,9,21,13,0,79
1,19,3,9,12,12,0,0,0,56
1,19,3,25,16,8,15,21,19,127
1,19,3,9,20,1,14,0,0,67
1,19,3,9,20,2,0,0,0,54
1,19,3,9,20,5,0,0,0,57
1,19,3,9,20,5,19,0,0,76
1,19,3,9,20,9,3,0,0,64
1,19,3,9,20,9,3,1,12,77
1,19,3,12,5,14,20,0,0,74
1,19,3,12,5,16,9,14,0,79
1,19,3,15,3,1,18,16,0,76
1,19,3,15,3,1,18,16,19,95
1,19,3,15,7,15,14,5,0,79
1,19,3,15,7,15,14,9,1,84
1,19,3,15,13,1,0,0,0,52
1,19,3,15,13,1,20,1,0,73
1,19,3,15,14,0,0,0,0,52
1,19,3,15,14,9,1,0,0,62
1,19,3,15,14,15,9,4,0,80
1,19,3,15,16,8,15,18,5,100
1,19,3,15,18,2,1,20,5,84
1,19,3,15,18,2,9,3,0,70
1,19,3,15,19,16,15,18,5,111
1,19,3,15,20,19,0,0,0,77
1,19,3,18,25,0,0,0,0,66
1,19,3,18,9,2,5,0,0,57
1,19,3,18,9,2,5,4,0,61
1,19,3,18,9,2,5,19,0,76
1,19,3,18,9,2,9,14,7,82
1,19,3,18,9,16,20,0,0,86
1,19,3,18,9,22,5,0,0,77
1,19,3,21,12,1,0,0,0,57
1,19,3,21,12,1,5,0,0,62
1,19,4,9,3,19,0,0,0,55
1,19,5,0,0,0,0,0,0,25
1,19,5,1,0,0,0,0,0,26
1,19,5,1,18,3,8,0,0,55
1,19,5,5,20,8,5,0,0,63
1,19,5,9,19,13,9,3,0,78
1,19,5,9,20,1,19,0,0,74
1,19,5,9,20,25,0,0,0,79
1,19,5,12,1,18,0,0,0,56
1,19,5,12,7,5,9,1,0,59
1,19,5,12,12,1,20,5,0,75
1,19,5,13,0,0,0,0,0,38
1,19,5,13,1,19,9,1,0,68
1,19,5,13,9,1,0,0,0,48
1,19,5,13,9,3,0,0,0,50
1,19,5,16,1,12,15,21,19,109
1,19,5,16,19,5,19,0,0,84
1,19,5,16,19,9,19,0,0,88
1,19,5,16,20,1,20,5,0,87
1,19,5,16,20,9,3,0,0,73
1,19,5,16,20,9,6,25,0,101
1,19,5,16,20,15,12,0,0,88
1,19,5,16,20,15,12,9,14,111
1,19,5,24,21,1,12,0,0,83
1,19,5,24,21,1,12,12,25,120
1,19,5,24,21,1,12,19,0,102
1,19,6,1,19,20,0,0,0,66
1,19,6,5,20,9,4,1,0,65
1,19,7,4,0,0,0,0,0,31
1,19,7,13,20,0,0,0,0,60
1,19,8,1,11,5,0,0,0,45
1,19,8,1,13,5,0,0,0,47
1,19,8,1,13,5,4,0,0,51
1,19,8,1,13,5,4,12,25,88
1,19,8,1,13,14,21,0,0,77
1,19,8,2,5,18,18,25,0,96
1,19,8,3,1,11,5,0,0,48
1,19,8,3,1,14,0,0,0,46
1,19,8,3,1,14,19,0,0,65
1,19,8,5,4,0,0,0,0,37
1,19,8,5,14,0,0,0,0,47
1,19,8,5,18,25,0,0,0,76
1,19,8,5,18,9,5,19,0,84
1,19,8,5,20,0,0,0,0,53
1,19,8,6,1,12,12,0,0,59
1,19,8,25,0,0,0,0,0,53
1,19,8,9,5,18,0,0,0,60
1,19,8,9,5,19,20,0,0,81
1,19,8,9,12,25,0,0,0,74
1,19,8,9,13,13,5,18,0,86
1,19,8,9,14,5,0,0,0,56
1,19,8,9,14,5,19,19,0,94
1,19,8,9,14,7,0,0,0,58
1,19,8,9,22,5,18,0,0,82
1,19,8,11,5,25,0,0,0,69
1,19,8,11,15,11,15,0,0,80
1,19,8,12,1,18,0,0,0,59
1,19,8,12,1,18,5,4,0,68
1,19,8,12,1,18,9,14,7,89
1,19,8,12,1,18,19,0,0,78
1,19,8,12,5,18,0,0,0,63
1,19,8,12,5,18,5,4,0,72
1,19,8,12,5,18,9,14,7,93
1,19,8,12,5,18,19,0,0,82
1,19,8,12,5,19,19,0,0,83
1,19,8,13,5,14,0,0,0,60
1,19,8,15,18,5,0,0,0,66
1,19,8,15,20,0,0,0,0,63
1,19,8,16,1,14,0,0,0,59
1,19,8,16,9,20,0,0,0,73
1,19,8,16,12,1,14,20,0,91
1,19,8,16,12,1,14,20,19,110
1,19,8,18,1,6,9,0,0,62
1,19,8,18,1,13,0,0,0,60
1,19,8,18,1,13,1,0,0,61
1,19,8,18,1,13,19,0,0,79
1,19,8,19,20,15,14,5,0,101
1,19,8,20,8,18,15,1,20,110
1,19,8,20,18,1,25,0,0,92
1,19,8,20,18,1,25,19,0,111
1,19,8,23,5,5,4,0,0,65
1,19,8,23,15,18,20,0,0,104
1,19,9,1,12,9,1,0,0,52
1,19,9,1,14,19,0,0,0,63
1,19,9,4,5,0,0,0,0,38
1,19,9,4,5,8,1,14,4,65
1,19,9,4,5,14,0,0,0,52
1,19,9,4,5,14,5,19,19,95
1,19,9,4,5,18,9,20,5,90
1,19,9,4,5,19,0,0,0,57
1,19,9,4,5,21,0,0,0,59
1,19,9,5,14,20,15,0,0,83
1,19,25,12,1,0,0,0,0,58
1,19,25,12,1,2,9,1,0,70
1,19,25,12,5,0,0,0,0,62
1,19,9,12,9,4,0,0,0,54
1,19,25,12,12,1,2,9,1,82
1,19,25,12,12,1,2,9,3,84
1,19,25,12,21,13,0,0,0,91
1,19,25,12,21,13,19,0,0,110
1,19,25,13,2,15,12,9,1,97
1,19,25,13,2,15,12,9,3,99
1,19,9,13,5,14,0,0,0,61
1,19,9,13,13,5,18,0,0,78
1,19,25,13,13,5,20,18,25,139
1,19,25,13,16,20,15,20,5,134
1,19,25,13,20,15,20,5,0,118
1,19,25,13,20,15,20,5,19,137
1,19,25,13,20,15,20,9,3,125
1,19,25,14,1,16,19,9,19,123
1,19,25,14,1,16,20,9,3,108
1,19,25,14,3,0,0,0,0,62
1,19,25,14,4,5,19,9,19,115
1,19,25,14,4,5,20,1,0,89
1,19,25,14,4,5,20,9,3,100
1,19,25,14,4,5,20,15,14,117
1,19,9,14,5,7,15,0,0,70
1,19,9,14,5,7,15,5,19,94
1,19,25,14,5,18,7,25,0,114
1,19,25,14,5,18,7,9,1,99
1,19,25,14,7,1,13,25,0,105
1,19,25,14,7,1,13,9,3,92
1,19,9,14,9,14,5,0,0,71
1,19,9,14,9,14,5,12,25,108
1,19,9,14,9,14,9,20,25,120
1,19,9,19,0,0,0,0,0,48
1,19,25,19,20,15,12,5,0,116
1,19,25,19,20,15,12,9,3,123
1,19,9,20,9,1,0,0,0,59
1,19,11,1,2,12,5,0,0,51
1,19,11,1,14,3,5,0,0,54
1,19,11,1,14,20,0,0,0,66
1,19,11,1,16,1,18,20,0,87
1,19,11,1,18,0,0,0,0,50
1,19,11,1,18,5,12,0,0,67
1,19,11,1,18,9,19,0,0,78
1,19,11,5,4,0,0,0,0,40
1,19,11,5,18,0,0,0,0,54
1,19,11,5,18,19,0,0,0,73
1,19,11,5,19,5,19,0,0,79
1,19,11,5,19,9,19,0,0,83
1,19,11,5,23,0,0,0,0,59
1,19,11,5,23,7,5,5,0,76
1,19,11,5,23,14,5,19,19,116
1,19,11,9,12,5,0,0,0,57
1,19,11,9,14,7,0,0,0,61
1,19,11,9,14,7,12,25,0,98
1,19,11,9,14,7,19,0,0,80
1,19,11,9,16,0,0,0,0,56
1,19,11,12,5,14,20,0,0,82
1,19,11,15,9,0,0,0,0,55
1,19,11,15,25,5,0,0,0,76
1,19,11,15,19,0,0,0,0,65
1,19,11,19,0,0,0,0,0,50
1,19,12,1,11,5,0,0,0,49
1,19,12,1,14,20,0,0,0,67
1,19,12,1,22,5,18,0,0,78
1,19,12,5,5,16,0,0,0,58
1,19,12,15,16,0,0,0,0,63
1,19,12,15,16,5,0,0,0,68
1,19,12,21,13,2,5,18,0,91
1,19,13,1,3,11,0,0,0,48
1,19,13,1,12,20,5,0,0,71
1,19,13,5,1,18,0,0,0,57
1,19,13,9,12,5,0,0,0,59
1,19,13,15,11,5,0,0,0,64
1,19,13,15,12,4,5,18,0,87
1,19,14,9,6,6,12,5,0,72
1,19,14,15,18,20,0,0,0,87
1,19,15,1,11,0,0,0,0,47
1,19,15,3,9,1,12,0,0,60
1,19,15,11,0,0,0,0,0,46
1,19,15,13,1,20,15,21,19,124
1,19,15,14,1,14,20,0,0,84
1,19,15,14,9,1,0,0,0,59
1,19,15,16,0,0,0,0,0,51
1,19,15,18,0,0,0,0,0,53
1,19,15,21,20,8,0,0,0,84
1,19,16,1,3,5,0,0,0,45
1,19,16,1,18,1,7,9,3,75
1,19,16,1,18,1,7,25,12,100
1,19,16,1,18,1,7,9,14,86
1,19,16,1,18,1,7,21,19,103
1,19,16,1,18,1,13,9,3,81
1,19,16,1,18,11,12,5,0,83
1,19,16,1,18,20,1,20,5,101
1,19,16,1,18,20,9,3,0,87
1,19,16,1,18,20,25,12,0,112
1,19,16,5,3,20,0,0,0,64
1,19,16,5,3,20,1,14,20,99
1,19,16,5,3,20,9,15,14,102
1,19,16,5,3,20,19,0,0,83
1,19,16,5,3,20,21,1,12,98
1,19,16,5,14,19,0,0,0,74
1,19,16,5,18,0,0,0,0,59
1,19,16,5,18,1,20,5,0,85
1,19,16,5,18,1,20,5,4,89
1,19,16,5,18,1,20,5,19,104
1,19,16,5,18,7,5,0,0,71
1,19,16,5,18,7,5,18,0,89
1,19,16,5,18,7,9,12,0,87
1,19,16,5,18,7,9,12,12,99
1,19,16,5,18,9,20,5,0,93
1,19,16,5,18,9,20,25,0,113
1,19,16,5,18,12,25,0,0,96
1,19,16,5,18,13,9,1,0,82
1,19,16,5,18,13,9,3,0,84
1,19,16,5,18,13,15,21,19,127
1,19,16,5,18,14,0,0,0,73
1,19,16,5,18,14,5,19,19,116
1,19,16,5,18,15,21,19,0,114
1,19,16,5,18,19,5,0,0,83
1,19,16,5,18,19,5,4,0,87
1,19,16,5,18,19,5,18,0,101
1,19,16,5,18,19,5,18,19,120
1,19,16,5,18,19,5,19,0,102
1,19,16,5,18,19,9,14,7,108
1,19,16,5,18,19,9,15,14,116
1,19,16,5,18,19,9,22,5,114
1,19,16,5,18,19,15,9,18,120
1,19,16,5,18,19,15,18,0,111
1,19,16,5,18,19,15,18,25,136
1,19,16,5,18,19,15,18,19,130
1,19,16,8,1,12,20,0,0,77
1,19,16,8,1,12,20,5,4,86
1,19,16,8,1,12,20,5,18,100
1,19,16,8,1,12,20,9,3,89
1,19,16,8,1,12,20,19,0,96
1,19,16,8,1,12,20,21,13,111
1,19,16,8,1,12,20,21,19,117
1,19,16,8,5,18,9,3,0,79
1,19,16,8,25,3,20,9,3,104
1,19,16,8,25,24,25,0,0,118
1,19,16,8,25,24,9,1,0,103
1,19,16,8,25,24,9,1,12,115
1,19,16,8,25,24,9,1,19,122
1,19,16,8,25,24,9,5,4,111
1,19,16,8,25,24,9,5,19,126
1,19,16,8,15,4,5,12,0,80
1,19,16,8,15,4,5,12,19,99
1,19,16,25,0,0,0,0,0,61
1,19,16,9,3,0,0,0,0,48
1,19,16,9,3,19,0,0,0,67
1,19,16,9,4,1,20,5,0,75
1,19,16,9,4,5,0,0,0,54
1,19,16,9,4,9,14,15,12,99
1,19,16,9,4,9,21,13,0,92
1,19,16,9,17,21,5,5,0,93
1,19,16,9,18,1,14,20,0,98
1,19,16,9,18,1,14,20,19,117
1,19,16,9,18,1,20,1,0,85
1,19,16,9,18,1,20,1,5,90
1,19,16,9,18,1,20,5,0,89
1,19,16,9,18,1,20,5,4,93
1,19,16,9,18,1,20,5,19,108
1,19,16,9,18,1,20,15,18,117
1,19,16,9,18,5,0,0,0,68
1,19,16,9,18,5,4,0,0,72
1,19,16,9,18,5,5,0,0,73
1,19,16,9,18,5,18,0,0,86
1,19,16,9,18,5,18,19,0,105
1,19,16,9,18,5,19,0,0,87
1,19,16,9,18,9,14,0,0,86
1,19,16,9,18,9,14,7,0,93
1,19,16,9,18,9,14,19,0,105
1,19,16,9,19,0,0,0,0,64
1,19,16,9,19,5,19,0,0,88
1,19,16,9,19,8,0,0,0,72
1,19,16,15,18,15,21,19,0,124
1,19,16,15,18,20,0,0,0,89
1,19,16,15,21,20,0,0,0,92
1,19,16,18,1,23,12,0,0,90
1,19,16,18,5,1,4,0,0,64
1,19,16,18,5,20,5,0,0,84
1,19,16,18,9,14,7,0,0,84
1,19,16,18,15,21,20,0,0,110
1,19,16,19,0,0,0,0,0,55
1,19,17,21,1,18,5,0,0,82
1,19,17,21,1,20,0,0,0,79
1,19,17,21,5,1,12,0,0,76
1,19,17,21,9,14,20,0,0,101
1,19,17,21,9,18,13,0,0,98
1,19,18,1,13,1,0,0,0,53
1,19,18,1,13,1,19,0,0,72
1,19,19,1,3,21,0,0,0,64
1,19,19,1,7,1,9,0,0,57
1,19,19,1,7,1,9,5,4,66
1,19,19,1,7,1,9,19,0,76
1,19,19,1,8,25,0,0,0,73
1,19,19,1,9,0,0,0,0,49
1,19,19,1,25,0,0,0,0,65
1,19,19,1,25,1,2,12,5,85
1,19,19,1,25,5,4,0,0,74
1,19,19,1,25,5,18,0,0,88
1,19,19,1,25,5,18,19,0,107
1,19,19,1,25,9,14,7,0,95
1,19,19,1,9,12,0,0,0,61
1,19,19,1,9,12,1,14,20,96
1,19,19,1,9,12,5,4,0,70
1,19,19,1,9,12,5,18,0,84
1,19,19,1,9,12,5,18,19,103
1,19,19,1,9,12,9,14,7,91
1,19,19,1,9,12,19,0,0,80
1,19,19,1,9,19,0,0,0,68
1,19,19,1,25,19,0,0,0,84
1,19,19,1,12,20,15,0,0,87
1,19,19,1,13,1,18,0,0,72
1,19,19,1,16,1,14,0,0,71
1,19,19,1,16,1,14,9,3,83
1,19,19,1,18,25,0,0,0,83
1,19,19,1,18,9,15,14,0,96
1,19,19,1,18,20,0,0,0,78
1,19,19,1,19,19,9,14,19,120
1,19,19,1,20,5,0,0,0,65
1,19,19,1,20,9,15,14,0,98
1,19,19,1,21,12,20,0,0,93
1,19,19,1,21,12,20,5,4,102
1,19,19,1,21,12,20,5,18,116
1,19,19,1,21,12,20,19,0,112
1,19,19,1,21,19,9,22,5,116
1,19,19,1,21,20,0,0,0,81
1,19,19,2,1,1,0,0,0,43
1,19,19,5,0,0,0,0,0,44
1,19,19,5,1,12,0,0,0,57
1,19,19,5,3,21,18,5,0,91
1,19,19,5,4,1,20,0,0,69
1,19,19,5,7,1,9,0,0,61
1,19,19,5,7,1,9,5,4,70
1,19,19,5,7,1,9,14,7,82
1,19,19,5,7,1,9,19,0,80
1,19,19,5,9,26,5,0,0,84
1,19,19,5,12,6,0,0,0,62
1,19,19,5,13,2,12,0,0,71
1,19,19,5,13,2,12,5,0,76
1,19,19,5,13,2,12,5,4,80
1,19,19,5,13,2,12,5,5,81
1,19,19,5,13,2,12,5,18,94
1,19,19,5,13,2,12,5,19,95
1,19,19,5,14,20,0,0,0,78
1,19,19,5,14,20,5,4,0,87
1,19,19,5,14,20,5,18,0,101
1,19,19,5,14,20,5,18,19,120
1,19,19,5,14,20,9,14,7,108
1,19,19,5,14,20,9,22,5,114
1,19,19,5,14,20,15,18,0,111
1,19,19,5,14,20,15,18,19,130
1,19,19,5,14,20,19,0,0,97
1,19,19,5,15,21,18,0,0,98
1,19,19,5,18,20,0,0,0,82
1,19,19,5,18,20,1,0,0,83
1,19,19,5,18,20,5,4,0,91
1,19,19,5,18,20,5,18,0,105
1,19,19,5,18,20,5,18,19,124
1,19,19,5,18,20,9,14,7,112
1,19,19,5,18,20,9,15,14,120
1,19,19,5,18,20,9,22,5,118
1,19,19,5,18,20,15,18,0,115
1,19,19,5,18,20,15,18,25,140
1,19,19,5,18,20,15,18,19,134
1,19,19,5,18,20,18,9,24,133
1,19,19,5,18,20,19,0,0,101
1,19,19,5,18,20,21,13,0,116
1,19,19,5,18,22,5,0,0,89
1,19,19,5,19,0,0,0,0,63
1,19,19,5,19,19,0,0,0,82
1,19,19,5,19,19,5,4,0,91
1,19,19,5,19,19,5,5,0,92
1,19,19,5,19,19,5,19,0,106
1,19,19,5,19,19,9,14,7,112
1,19,19,5,19,19,9,15,14,120
1,19,19,5,19,19,15,18,0,115
1,19,19,5,19,19,15,18,25,140
1,19,19,5,19,19,15,18,19,134
1,19,19,5,20,0,0,0,0,64
1,19,19,5,20,8,0,0,0,72
1,19,19,5,20,19,0,0,0,83
1,19,19,5,22,5,18,0,0,89
1,19,19,5,23,5,18,0,0,90
1,19,19,8,5,1,4,0,0,57
1,19,19,8,15,12,5,0,0,79
1,19,19,8,15,12,5,19,0,98
1,19,19,9,0,0,0,0,0,48
1,19,19,9,4,5,14,20,0,91
1,19,19,9,4,21,1,12,0,86
1,19,19,9,4,21,1,20,5,99
1,19,19,9,4,21,9,20,25,127
1,19,19,9,4,21,15,21,19,128
1,19,19,9,5,7,5,0,0,65
1,19,19,9,5,14,20,15,0,102
1,19,19,9,5,20,20,5,0,98
1,19,19,9,6,25,0,0,0,79
1,19,19,9,7,14,0,0,0,69
1,19,19,9,7,14,1,20,0,90
1,19,19,9,7,14,1,20,19,109
1,19,19,9,7,14,5,4,0,78
1,19,19,9,7,14,5,5,0,79
1,19,19,9,7,14,5,5,19,98
1,19,19,9,7,14,5,18,0,92
1,19,19,9,7,14,5,18,19,111
1,19,19,9,7,14,9,14,7,99
1,19,19,9,7,14,15,18,0,102
1,19,19,9,7,14,15,18,19,121
1,19,19,9,7,14,19,0,0,88
1,19,19,9,12,1,7,0,0,68
1,19,19,9,14,5,7,15,0,89
1,19,19,25,14,20,9,20,5,132
1,19,19,9,14,21,1,20,5,109
1,19,19,25,18,9,1,14,19,125
1,19,19,9,19,0,0,0,0,67
1,19,19,9,19,1,0,0,0,68
1,19,19,9,19,5,0,0,0,72
1,19,19,9,19,8,0,0,0,75
1,19,19,9,19,8,12,25,0,112
1,19,19,9,19,20,0,0,0,87
1,19,19,9,19,20,1,14,20,122
1,19,19,9,19,20,5,4,0,96
1,19,19,9,19,20,5,18,0,110
1,19,19,9,19,20,5,18,19,129
1,19,19,9,19,20,6,21,12,126
1,19,19,9,19,20,9,14,7,117
1,19,19,9,19,20,9,22,5,123
1,19,19,9,19,20,15,18,0,120
1,19,19,9,19,20,15,18,19,139
1,19,19,9,19,20,19,0,0,106
1,19,19,9,20,8,0,0,0,76
1,19,19,25,20,8,0,0,0,92
1,19,19,9,26,5,0,0,0,79
1,19,19,9,26,5,4,0,0,83
1,19,19,9,26,5,18,0,0,97
1,19,19,9,26,5,19,0,0,98
1,19,19,9,26,9,14,7,0,104
1,19,19,12,9,11,5,0,0,76
1,19,19,13,1,14,0,0,0,67
1,19,19,15,2,18,5,0,0,79
1,19,19,15,3,0,0,0,0,57
1,19,19,15,3,9,1,20,5,92
1,19,19,15,3,9,5,0,0,71
1,19,19,15,9,12,0,0,0,75
1,19,19,15,9,12,5,4,0,84
1,19,19,15,9,12,9,14,7,105
1,19,19,15,9,12,19,0,0,94
1,19,19,15,9,12,26,9,5,115
1,19,19,15,9,14,0,0,0,77
1,19,19,15,12,21,20,15,0,122
1,19,19,15,14,1,14,3,5,91
1,19,19,15,14,1,14,20,0,103
1,19,19,15,14,1,14,20,19,122
1,19,19,15,14,1,20,5,0,94
1,19,19,15,18,9,1,0,0,82
1,19,19,15,18,20,0,0,0,92
1,19,19,15,18,20,5,4,0,101
1,19,19,15,18,20,5,18,0,115
1,19,19,15,18,20,5,18,19,134
1,19,19,15,18,20,9,14,7,122
1,19,19,15,18,20,9,22,5,128
1,19,19,15,18,20,19,0,0,111
1,19,19,15,20,0,0,0,0,74
1,19,19,20,0,0,0,0,0,59
1,19,19,21,1,4,5,0,0,70
1,19,19,21,1,7,5,0,0,73
1,19,19,21,1,7,5,4,0,77
1,19,19,21,1,7,5,18,0,91
1,19,19,21,1,7,5,19,0,92
1,19,19,21,1,7,9,14,7,98
1,19,19,21,1,19,9,22,5,116
1,19,19,21,5,20,21,4,5,115
1,19,19,21,13,1,2,12,5,93
1,19,19,21,13,1,2,12,25,113
1,19,19,21,13,5,0,0,0,78
1,19,19,21,13,5,4,0,0,82
1,19,19,21,13,5,4,12,25,119
1,19,19,21,13,5,14,20,0,112
1,19,19,21,13,5,18,0,0,96
1,19,19,21,13,5,18,19,0,115
1,19,19,21,13,5,19,0,0,97
1,19,19,21,13,9,14,7,0,103
1,19,19,21,13,13,15,14,0,115
1,19,19,21,13,16,19,9,20,137
1,19,19,21,13,16,20,0,0,109
1,19,19,21,18,1,2,12,5,98
1,19,19,21,18,1,14,3,5,101
1,19,19,21,18,1,14,20,0,113
1,19,19,21,18,1,20,5,0,104
1,19,19,21,18,4,0,0,0,82
1,19,19,21,18,5,0,0,0,83
1,19,19,21,18,5,4,0,0,87
1,19,19,21,18,5,4,12,25,124
1,19,19,21,18,5,4,19,0,106
1,19,19,21,18,5,18,0,0,101
1,19,19,21,18,5,18,19,0,120
1,19,19,21,18,5,19,0,0,102
1,19,19,21,18,7,5,0,0,90
1,19,19,21,18,7,5,14,20,124
1,19,19,21,18,9,14,7,0,108
1,19,19,21,18,15,18,0,0,111
1,19,19,21,18,15,18,19,0,130
1,19,19,23,1,7,5,0,0,75
1,19,19,23,1,7,5,4,0,79
1,19,19,23,1,7,5,19,0,94
1,19,19,23,1,7,9,14,7,100
1,19,20,0,0,0,0,0,0,40
1,19,20,1,2,12,5,0,0,60
1,19,20,1,3,9,1,14,0,68
1,19,20,1,25,0,0,0,0,66
1,19,20,1,12,11,0,0,0,64
1,19,20,1,18,5,0,0,0,64
1,19,20,1,18,20,0,0,0,79
1,19,20,1,19,9,1,0,0,70
1,19,20,1,19,9,1,19,0,89
1,19,20,1,20,5,0,0,0,66
1,19,20,1,20,9,3,0,0,73
1,19,20,1,20,9,14,5,0,89
1,19,20,1,20,9,14,5,19,108
1,19,20,1,20,9,26,5,0,101
1,19,20,1,20,9,26,5,4,105
1,19,20,1,20,9,26,5,18,119
1,19,20,5,1,13,0,0,0,59
1,19,20,5,5,16,0,0,0,66
1,19,20,5,5,18,0,0,0,68
1,19,20,5,9,19,13,0,0,86
1,19,20,5,12,0,0,0,0,57
1,19,20,5,12,25,0,0,0,82
1,19,20,5,12,9,3,0,0,69
1,19,20,5,18,0,0,0,0,63
1,19,20,5,18,9,1,5,0,78
1,19,20,5,18,9,1,12,0,85
1,19,20,5,18,9,11,15,19,117
1,19,20,5,18,9,14,0,0,86
1,19,20,5,18,9,15,9,4,100
1,19,20,5,18,9,19,11,0,102
1,19,20,5,18,9,19,11,19,121
1,19,20,5,18,9,19,13,0,104
1,19,20,5,18,9,19,13,19,123
1,19,20,5,18,9,20,5,0,97
1,19,20,5,18,9,24,9,19,124
1,19,20,5,18,14,0,0,0,77
1,19,20,5,18,14,1,12,0,90
1,19,20,5,18,14,9,1,0,87
1,19,20,5,18,15,9,4,0,91
1,19,20,5,18,15,9,4,19,110
1,19,20,5,18,19,0,0,0,82
1,19,20,5,18,20,0,0,0,83
1,19,20,5,18,23,15,18,20,139
1,19,20,8,5,14,25,0,0,92
1,19,20,8,5,14,9,1,0,77
1,19,20,8,5,14,9,1,19,96
1,19,20,8,5,14,9,3,0,79
1,19,20,8,5,14,9,3,19,98
1,19,20,8,5,14,9,5,19,100
1,19,20,8,5,14,15,16,5,103
1,19,20,8,13,1,0,0,0,62
1,19,20,8,13,1,19,0,0,81
1,19,20,8,13,1,20,9,3,94
1,19,20,8,15,18,5,0,0,86
1,19,20,8,15,18,9,14,0,104
1,19,20,9,3,8,15,21,19,115
1,19,20,9,7,13,1,20,0,90
1,19,20,9,7,13,9,1,0,79
1,19,20,9,7,13,9,1,19,98
1,19,20,9,7,13,9,3,0,81
1,19,20,9,7,13,9,19,13,110
1,19,20,25,12,1,18,0,0,96
1,19,20,25,12,12,5,14,0,108
1,19,20,9,14,20,0,0,0,83
1,19,20,9,18,0,0,0,0,67
1,19,20,9,20,5,0,0,0,74
1,19,20,15,7,5,14,25,0,106
1,19,20,15,13,1,20,1,12,102
1,19,20,15,13,9,1,0,0,78
1,19,20,15,13,15,21,19,0,123
1,19,20,15,14,4,0,0,0,73
1,19,20,15,14,5,0,0,0,74
1,19,20,15,14,5,4,0,0,78
1,19,20,15,14,25,0,0,0,94
1,19,20,15,14,9,5,4,0,87
1,19,20,15,14,9,5,19,0,102
1,19,20,15,14,25,9,14,7,124
1,19,20,15,14,9,19,8,0,105
1,19,20,15,15,16,0,0,0,86
1,19,20,15,18,5,0,0,0,78
1,19,20,15,21,14,4,0,0,94
1,19,20,15,21,14,4,5,4,103
1,19,20,15,21,14,4,19,0,113
1,19,20,18,0,0,0,0,0,58
1,19,20,18,1,3,9,19,13,103
1,19,20,18,1,4,4,12,5,84
1,19,20,18,1,5,9,4,0,77
1,19,20,18,1,7,1,12,0,79
1,19,20,18,1,7,1,12,9,88
1,19,20,18,1,7,1,12,19,98
1,19,20,18,1,25,0,0,0,84
1,19,20,18,1,9,14,0,0,82
1,19,20,18,1,12,0,0,0,71
1,19,20,18,1,12,12,25,0,108
1,19,20,18,1,12,19,0,0,90
1,19,20,18,1,14,4,0,0,77
1,19,20,18,5,0,0,0,0,63
1,19,20,18,5,1,13,0,0,77
1,19,20,18,5,1,14,0,0,78
1,19,20,18,5,18,0,0,0,81
1,19,20,18,9,3,20,0,0,90
1,19,20,18,9,3,20,5,4,99
1,19,20,18,9,3,20,19,0,109
1,19,20,18,9,4,5,0,0,76
1,19,20,18,9,5,18,0,0,90
1,19,20,18,9,12,4,0,0,83
1,19,20,18,9,14,7,5,0,93
1,19,20,18,9,14,7,5,4,97
1,19,20,18,9,14,7,5,18,111
1,19,20,18,9,14,7,5,19,112
1,19,20,18,9,15,14,0,0,96
1,19,20,18,15,3,25,20,5,126
1,19,20,18,15,4,15,13,5,110
1,19,20,18,15,6,5,12,0,96
1,19,20,18,15,6,5,12,12,108
1,19,20,18,15,7,1,20,5,106
1,19,20,18,15,7,5,14,25,124
1,19,20,18,15,7,12,9,1,102
1,19,20,18,15,7,15,14,25,134
1,19,20,18,15,9,4,0,0,86
1,19,20,18,15,9,20,5,0,107
1,19,20,18,15,12,0,0,0,85
1,19,20,18,15,12,1,2,5,93
1,19,20,18,15,12,15,7,0,107
1,19,20,18,15,12,15,7,5,112
1,19,20,18,15,12,15,7,25,132
1,19,20,18,15,13,5,4,1,96
1,19,20,18,15,14,0,0,0,87
1,19,20,18,15,14,1,21,20,129
1,19,20,18,15,14,15,13,25,140
1,19,20,18,15,16,8,5,12,114
1,19,20,18,15,16,8,9,12,118
1,19,20,18,15,19,5,0,0,97
1,19,20,18,21,20,0,0,0,99
1,19,20,21,3,9,15,21,19,128
1,19,20,21,3,9,20,25,0,118
1,19,20,21,20,5,0,0,0,86
1,19,20,21,20,5,12,25,0,123
1,19,20,21,20,9,15,21,19,145
1,19,21,1,14,7,0,0,0,63
1,19,21,4,4,5,14,0,0,68
1,19,21,14,4,5,18,0,0,82
1,19,23,1,25,0,0,0,0,69
1,19,23,1,9,12,0,0,0,65
1,19,23,1,18,13,0,0,0,75
1,19,23,1,19,8,0,0,0,71
1,19,23,5,1,20,0,0,0,69
1,19,23,5,12,12,0,0,0,72
1,19,23,5,22,5,0,0,0,75
1,19,23,9,13,0,0,0,0,65
1,19,23,9,14,7,0,0,0,73
1,19,23,9,18,12,0,0,0,82
1,19,23,9,20,8,5,0,0,85
1,19,23,15,15,14,0,0,0,87
1,19,23,15,15,14,5,4,0,96
1,19,23,15,21,7,8,0,0,94
1,20,2,1,19,8,0,0,0,51
1,20,5,0,0,0,0,0,0,26
1,20,5,2,18,9,14,0,0,69
1,20,5,3,8,14,25,0,0,76
1,20,5,3,8,14,9,3,0,63
1,20,5,4,0,0,0,0,0,30
1,20,5,5,19,0,0,0,0,50
1,20,5,5,20,5,18,0,0,74
1,20,5,6,0,0,0,0,0,32
1,20,5,11,14,9,1,0,0,61
1,20,5,12,5,14,5,0,0,62
1,20,5,12,5,20,19,0,0,82
1,20,5,12,25,0,0,0,0,63
1,20,5,12,9,3,0,0,0,50
1,20,5,12,9,5,18,0,0,70
1,20,5,12,9,5,18,19,0,89
1,20,5,12,9,15,19,9,19,109
1,20,5,12,9,15,20,9,3,94
1,20,5,12,15,0,0,0,0,53
1,20,5,13,15,25,1,0,0,80
1,20,5,13,16,15,18,1,12,101
1,20,5,19,0,0,0,0,0,45
1,20,5,21,3,8,9,0,0,67
1,20,5,21,3,8,21,19,0,98
1,20,8,1,12,12,9,14,5,82
1,20,8,1,14,1,19,25,0,89
1,20,8,1,14,1,19,9,1,74
1,20,8,1,14,15,18,0,0,77
1,20,8,1,18,0,0,0,0,48
1,20,8,2,1,19,8,0,0,59
1,20,8,5,3,1,20,5,0,63
1,20,8,5,9,19,13,0,0,75
1,20,8,5,9,19,13,19,0,94
1,20,8,5,9,19,20,0,0,82
1,20,8,5,9,19,20,9,3,94
1,20,8,5,9,19,20,19,0,101
1,20,8,5,9,26,5,0,0,74
1,20,8,5,9,26,5,18,0,92
1,20,8,5,12,9,1,0,0,56
1,20,8,5,12,9,14,7,0,76
1,20,8,5,12,9,14,7,19,95
1,20,8,5,13,1,20,9,3,80
1,20,8,5,14,5,5,0,0,58
1,20,8,5,14,5,21,13,0,87
1,20,8,5,14,5,21,13,19,106
1,20,8,5,14,9,1,14,19,91
1,20,8,5,14,15,18,0,0,81
1,20,8,5,15,12,15,7,25,108
1,20,8,5,15,21,19,0,0,89
1,20,8,5,18,9,14,5,0,80
1,20,8,5,18,13,9,3,0,77
1,20,8,5,18,13,15,21,19,120
1,20,8,5,18,15,13,1,0,81
1,20,8,5,18,15,13,1,19,100
1,20,8,5,20,5,19,9,19,106
1,20,8,5,20,9,26,5,0,94
1,20,8,5,20,9,26,5,4,98
1,20,8,5,20,15,9,4,0,82
1,20,8,5,20,15,9,4,19,101
1,20,8,5,20,15,19,9,3,100
1,20,8,5,20,15,19,9,19,116
1,20,8,5,20,15,20,9,3,101
1,20,8,25,13,25,0,0,0,92
1,20,8,25,13,9,1,0,0,77
1,20,8,25,13,9,3,0,0,79
1,20,8,9,14,7,0,0,0,59
1,20,8,9,14,11,0,0,0,63
1,20,8,25,18,9,1,0,0,82
1,20,8,25,18,9,4,0,0,85
1,20,8,25,18,15,9,4,0,100
1,20,8,25,18,15,19,9,19,134
1,20,8,9,18,19,20,0,0,95
1,20,8,12,5,20,5,0,0,71
1,20,8,12,5,20,5,19,0,90
1,20,8,12,5,20,9,3,0,78
1,20,8,12,5,20,9,3,19,97
1,20,8,12,5,20,9,19,13,107
1,20,8,15,4,25,4,0,0,77
1,20,8,15,4,25,4,19,0,96
1,20,8,15,7,5,14,0,0,70
1,20,8,15,12,4,0,0,0,60
1,20,8,15,14,9,20,5,0,92
1,20,8,15,18,20,0,0,0,82
1,20,8,18,5,16,19,9,1,97
1,20,8,18,5,16,20,9,3,100
1,20,8,18,9,12,12,0,0,80
1,20,8,18,9,22,5,0,0,83
1,20,8,18,15,2,0,0,0,64
1,20,8,18,15,3,25,20,5,115
1,20,8,18,15,14,7,0,0,83
1,20,8,18,15,21,7,8,0,98
1,20,8,21,13,9,1,0,0,73
1,20,8,23,1,18,20,0,0,91
1,20,9,3,0,0,0,0,0,33
1,20,9,12,5,0,0,0,0,47
1,20,9,12,20,0,0,0,0,62
1,20,9,13,25,0,0,0,0,68
1,20,9,13,15,14,0,0,0,72
1,20,9,14,7,0,0,0,0,51
1,20,9,14,7,1,0,0,0,52
1,20,9,14,7,12,5,0,0,68
1,20,9,14,11,12,5,0,0,72
1,20,9,15,14,0,0,0,0,59
1,20,9,16,0,0,0,0,0,46
1,20,25,16,25,0,0,0,0,87
1,20,25,16,9,3,0,0,0,74
1,20,25,16,9,3,1,12,0,87
1,20,9,16,20,15,5,0,0,86
1,20,9,22,5,0,0,0,0,57
1,20,12,1,14,20,1,4,0,73
1,20,12,1,14,20,1,12,0,81
1,20,12,1,14,20,5,19,0,92
1,20,12,1,14,20,9,20,5,102
1,20,12,1,19,5,19,0,0,77
1,20,12,1,20,12,0,0,0,66
1,20,12,1,20,12,19,0,0,85
1,20,12,5,0,0,0,0,0,38
1,20,12,15,1,24,15,9,4,101
1,20,12,15,9,4,0,0,0,61
1,20,12,15,9,4,5,1,14,81
1,20,13,1,0,0,0,0,0,35
1,20,13,1,14,19,0,0,0,68
1,20,13,1,19,0,0,0,0,54
1,20,13,9,1,20,18,25,0,107
1,20,13,9,4,0,0,0,0,47
1,20,13,15,0,0,0,0,0,49
1,20,13,15,7,5,14,9,3,87
1,20,13,15,7,18,1,16,8,99
1,20,13,15,12,25,19,5,19,129
1,20,13,15,12,25,19,9,19,133
1,20,13,15,12,25,26,5,0,117
1,20,13,15,12,25,26,5,18,135
1,20,13,15,12,15,7,25,0,108
1,20,13,15,12,15,7,9,3,95
1,20,13,15,13,5,20,5,18,110
1,20,13,15,13,5,20,18,25,130
1,20,13,15,16,8,9,12,5,99
1,20,13,15,19,0,0,0,0,68
1,20,13,15,19,20,5,1,0,94
1,20,13,15,19,20,5,1,12,106
1,20,13,15,19,20,5,15,14,122
1,20,15,3,8,1,0,0,0,48
1,20,15,3,9,1,0,0,0,49
1,20,15,11,1,12,0,0,0,60
1,20,15,11,5,0,0,0,0,52
1,20,15,11,15,21,19,0,0,102
1,20,15,12,5,0,0,0,0,53
1,20,15,12,12,0,0,0,0,60
1,20,15,12,12,19,0,0,0,79
1,20,15,13,0,0,0,0,0,49
1,20,15,13,1,20,9,3,0,82
1,20,15,13,5,18,7,0,0,79
1,20,15,13,25,0,0,0,0,74
1,20,15,13,9,3,0,0,0,61
1,20,15,13,9,3,1,12,0,74
1,20,15,13,9,3,9,1,14,85
1,20,15,13,9,3,9,19,13,102
1,20,15,13,9,3,9,20,25,115
1,20,15,13,9,3,19,0,0,80
1,20,15,13,9,5,19,0,0,82
1,20,15,13,9,19,5,0,0,82
1,20,15,13,9,19,5,4,0,86
1,20,15,13,9,19,5,19,0,101
1,20,15,13,9,19,9,14,7,107
1,20,15,13,9,19,13,0,0,90
1,20,15,13,9,19,13,19,0,109
1,20,15,13,9,19,20,0,0,97
1,20,15,13,9,19,20,9,3,109
1,20,15,13,9,19,20,19,0,116
1,20,15,13,9,20,25,0,0,103
1,20,15,13,9,26,5,0,0,89
1,20,15,13,9,26,5,4,0,93
1,20,15,13,9,26,5,18,0,107
1,20,15,13,9,26,5,18,19,126
1,20,15,13,9,26,5,19,0,108
1,20,15,13,9,26,9,14,7,114
1,20,15,13,15,12,15,7,25,123
1,20,15,14,1,2,12,5,0,70
1,20,15,14,1,12,0,0,0,63
1,20,15,14,1,12,9,19,13,104
1,20,15,14,1,12,9,19,20,111
1,20,15,14,1,12,9,20,25,117
1,20,15,14,1,12,12,25,0,100
1,20,15,14,5,0,0,0,0,55
1,20,15,14,5,1,2,12,5,75
1,20,15,14,5,4,0,0,0,59
1,20,15,14,5,13,5,14,20,107
1,20,15,14,5,14,5,19,19,112
1,20,15,14,5,18,0,0,0,73
1,20,15,14,5,18,19,0,0,92
1,20,15,14,5,19,0,0,0,74
1,20,15,14,25,0,0,0,0,75
1,20,15,14,9,1,0,0,0,60
1,20,15,14,9,3,0,0,0,62
1,20,15,14,9,3,9,20,25,116
1,20,15,14,9,3,19,0,0,81
1,20,15,14,9,5,19,0,0,83
1,20,15,14,9,14,7,0,0,80
1,20,15,14,9,14,7,12,25,117
1,20,15,16,0,0,0,0,0,52
1,20,15,16,5,14,0,0,0,71
1,20,15,16,25,0,0,0,0,77
1,20,15,16,9,3,0,0,0,64
1,20,15,16,9,5,19,0,0,85
1,20,15,16,9,20,5,0,0,86
1,20,15,18,0,0,0,0,0,54
1,20,15,18,25,0,0,0,0,79
1,20,15,21,18,0,0,0,0,75
1,20,15,24,9,3,0,0,0,72
1,20,16,15,9,14,20,19,0,114
1,20,18,1,2,9,12,1,18,82
1,20,18,1,2,9,12,5,0,68
1,20,18,1,9,12,0,0,0,61
1,20,18,1,13,5,14,20,0,92
1,20,18,1,26,9,14,5,0,94
1,20,18,1,26,9,14,5,19,113
1,20,18,5,4,5,0,0,0,53
1,20,18,5,13,1,20,5,0,83
1,20,18,5,13,2,12,5,0,76
1,20,18,5,14,0,0,0,0,58
1,20,18,5,14,14,5,0,0,77
1,20,18,5,16,19,25,0,0,104
1,20,18,5,16,20,9,3,0,92
1,20,18,5,19,25,0,0,0,88
1,20,18,5,19,9,1,0,0,73
1,20,18,5,19,9,1,19,0,92
1,20,18,5,19,9,3,0,0,75
1,20,18,5,20,9,3,0,0,76
1,20,18,25,0,0,0,0,0,64
1,20,18,9,1,0,0,0,0,49
1,20,18,9,1,12,0,0,0,61
1,20,18,9,2,12,5,0,0,67
1,20,18,9,3,8,9,1,0,69
1,20,18,9,3,8,9,3,0,71
1,20,18,9,3,8,15,21,19,114
1,20,18,9,3,11,12,5,0,79
1,20,18,9,5,14,19,5,19,110
1,20,18,9,5,14,19,9,19,114
1,20,18,9,15,16,15,18,5,117
1,20,18,9,16,0,0,0,0,64
1,20,18,25,16,15,9,4,0,108
1,20,18,9,21,13,0,0,0,82
1,20,18,9,21,13,19,0,0,101
1,20,18,15,3,5,0,0,0,62
1,20,18,15,3,8,1,0,0,66
1,20,18,15,3,8,1,12,0,78
1,20,18,15,3,8,15,21,19,120
1,20,18,15,3,9,15,21,19,121
1,20,18,15,3,9,20,25,0,111
1,20,18,15,16,1,12,0,0,83
1,20,18,15,16,8,25,0,0,103
1,20,18,15,16,8,9,1,0,88
1,20,18,15,16,8,9,1,19,107
1,20,18,15,16,8,9,3,0,90
1,20,18,15,16,8,9,5,4,96
1,20,18,15,16,8,9,5,19,111
1,20,18,15,16,8,15,21,19,133
1,20,18,15,16,9,1,0,0,80
1,20,18,15,16,9,3,0,0,82
1,20,18,15,16,9,14,0,0,93
1,20,18,15,16,9,14,5,0,98
1,20,18,15,16,9,14,5,19,117
1,20,18,15,16,9,14,19,0,112
1,20,18,15,16,9,19,13,0,111
1,20,18,15,16,9,19,13,19,130
1,20,18,15,16,15,21,19,0,125
1,20,18,15,19,3,9,14,5,104
1,20,18,15,21,19,0,0,0,94
1,20,19,1,18,1,0,0,0,60
1,20,20,1,2,1,2,25,0,72
1,20,20,1,2,1,12,0,0,57
1,20,20,1,2,15,25,0,0,84
1,20,20,1,3,3,1,0,0,49
1,20,20,1,3,3,15,0,0,63
1,20,20,1,3,8,0,0,0,53
1,20,20,1,3,8,5,0,0,58
1,20,20,1,3,8,5,4,0,62
1,20,20,1,3,8,5,18,0,76
1,20,20,1,3,8,5,18,19,95
1,20,20,1,3,8,5,19,0,77
1,20,20,1,3,8,9,14,7,83
1,20,20,1,3,11,0,0,0,56
1,20,20,1,3,11,5,4,0,65
1,20,20,1,3,11,5,18,0,79
1,20,20,1,3,11,5,18,19,98
1,20,20,1,3,11,9,14,7,86
1,20,20,1,3,11,13,1,14,84
1,20,20,1,3,11,19,0,0,75
1,20,20,1,7,1,12,0,0,62
1,20,20,1,7,5,14,0,0,68
1,20,20,1,7,8,1,14,0,72
1,20,20,1,7,9,18,12,0,88
1,20,20,1,9,14,0,0,0,65
1,20,20,1,9,14,4,5,18,92
1,20,20,1,9,14,5,4,0,74
1,20,20,1,9,14,5,18,0,88
1,20,20,1,9,14,5,18,19,107
1,20,20,1,9,14,9,14,7,95
1,20,20,1,9,14,15,18,0,98
1,20,20,1,9,14,19,0,0,84
1,20,20,1,9,14,20,0,0,85
1,20,20,1,9,14,20,5,4,94
1,20,20,1,9,14,20,19,0,104
1,20,20,1,12,0,0,0,0,54
1,20,20,1,12,5,8,0,0,67
1,20,20,1,13,5,0,0,0,60
1,20,20,1,18,0,0,0,0,60
1,20,20,1,18,7,21,12,0,100
1,20,20,1,18,19,0,0,0,79
1,20,20,1,19,11,0,0,0,72
1,20,20,1,19,20,5,0,0,86
1,20,20,1,20,3,8,5,4,82
1,20,20,1,20,3,8,5,19,97
1,20,20,5,0,0,0,0,0,46
1,20,20,5,1,12,0,0,0,59
1,20,20,5,13,16,5,18,0,98
1,20,20,5,13,16,5,18,19,117
1,20,20,5,13,16,18,5,0,98
1,20,20,5,13,16,20,0,0,95
1,20,20,5,13,16,20,5,4,104
1,20,20,5,13,16,20,5,18,118
1,20,20,5,13,16,20,19,0,114
1,20,20,5,14,4,0,0,0,64
1,20,20,5,14,4,1,14,20,99
1,20,20,5,14,4,5,4,0,73
1,20,20,5,14,4,5,5,0,74
1,20,20,5,14,4,5,5,19,93
1,20,20,5,14,4,5,18,0,87
1,20,20,5,14,4,5,18,19,106
1,20,20,5,14,4,9,14,7,94
1,20,20,5,14,4,19,0,0,83
1,20,20,5,14,19,9,20,25,133
1,20,20,5,14,20,0,0,0,80
1,20,20,5,14,20,1,20,0,101
1,20,20,5,14,20,1,20,5,106
1,20,20,5,14,20,9,15,14,118
1,20,20,5,14,20,9,22,5,116
1,20,20,5,14,20,12,25,0,117
1,20,20,5,14,21,1,14,20,116
1,20,20,5,14,21,1,20,5,107
1,20,20,5,18,0,0,0,0,64
1,20,20,5,18,3,15,16,0,98
1,20,20,5,18,3,18,15,16,116
1,20,20,5,18,25,0,0,0,89
1,20,20,5,18,13,9,14,5,105
1,20,20,5,18,14,0,0,0,78
1,20,20,5,18,18,0,0,0,82
1,20,20,5,18,18,1,20,5,108
1,20,20,5,19,20,0,0,0,85
1,20,20,5,19,20,1,14,20,120
1,20,20,5,19,20,5,4,0,94
1,20,20,5,19,20,5,18,0,108
1,20,20,5,19,20,5,18,19,127
1,20,20,5,19,20,9,14,7,115
1,20,20,5,19,20,9,22,5,121
1,20,20,5,19,20,15,18,0,118
1,20,20,5,19,20,15,18,19,137
1,20,20,5,19,20,19,0,0,104
1,20,20,25,0,0,0,0,0,66
1,20,20,9,3,5,0,0,0,58
1,20,20,9,3,9,19,13,19,113
1,20,20,9,3,9,19,20,19,120
1,20,20,9,3,19,0,0,0,72
1,20,20,9,4,0,0,0,0,54
1,20,20,9,14,7,5,0,0,76
1,20,20,9,14,7,5,14,20,110
1,20,20,9,18,1,9,12,0,90
1,20,20,9,18,5,0,0,0,73
1,20,20,9,18,5,4,0,0,77
1,20,20,9,18,5,18,0,0,91
1,20,20,9,18,5,19,0,0,92
1,20,20,9,18,9,14,7,0,98
1,20,20,9,20,21,4,5,0,100
1,20,20,9,20,21,4,5,19,119
1,20,20,12,5,0,0,0,0,58
1,20,20,14,0,0,0,0,0,55
1,20,20,14,20,18,16,0,0,109
1,20,20,15,12,12,5,14,20,119
1,20,20,15,13,25,0,0,0,94
1,20,20,15,18,14,0,0,0,88
1,20,20,15,18,14,1,18,5,112
1,20,20,15,18,14,5,4,0,97
1,20,20,15,18,14,5,25,0,118
1,20,20,15,18,14,5,25,19,137
1,20,20,15,18,14,9,14,7,118
1,20,20,15,18,14,19,0,0,107
1,20,20,15,21,18,0,0,0,95
1,20,20,15,21,18,14,5,0,114
1,20,20,18,1,3,20,0,0,83
1,20,20,18,1,3,20,5,4,92
1,20,20,18,1,3,20,5,18,106
1,20,20,18,1,3,20,15,18,116
1,20,20,18,1,3,20,19,0,102
1,20,20,18,1,8,5,14,20,107
1,20,20,18,1,16,0,0,0,76
1,20,20,18,25,0,0,0,0,84
1,20,20,18,9,2,0,0,0,70
1,20,20,18,9,2,21,20,5,116
1,20,20,18,9,19,20,0,0,107
1,20,20,18,9,20,5,0,0,93
1,20,20,18,9,20,5,4,0,97
1,20,20,18,9,20,9,14,7,118
1,20,20,18,9,20,9,15,14,126
1,20,20,18,9,20,9,22,5,124
1,20,20,18,9,20,21,19,0,128
1,20,20,21,14,5,0,0,0,81
1,20,20,21,14,5,4,0,0,85
1,20,20,21,14,5,12,25,0,118
1,20,20,21,14,5,19,0,0,100
1,20,20,21,14,9,14,7,0,106
1,20,20,21,18,14,0,0,0,94
1,20,21,1,0,0,0,0,0,43
1,20,21,12,5,0,0,0,0,59
1,20,21,13,2,12,5,0,0,74
1,20,21,14,5,0,0,0,0,61
1,20,22,5,5,14,0,0,0,67
1,20,23,1,9,14,0,0,0,68
1,20,23,5,5,12,0,0,0,66
1,20,23,5,5,14,0,0,0,68
1,20,23,9,14,0,0,0,0,67
1,20,23,9,14,4,0,0,0,71
1,20,23,9,18,12,0,0,0,83
1,20,23,9,19,20,0,0,0,92
1,20,23,9,20,3,8,0,0,84
1,20,23,9,20,5,0,0,0,78
1,20,23,9,20,20,5,18,0,116
1,20,23,9,24,20,0,0,0,97
1,20,23,15,0,0,0,0,0,59
1,21,2,1,4,5,0,0,0,34
1,21,2,1,4,5,19,0,0,53
1,21,2,1,9,14,0,0,0,48
1,21,2,1,9,14,5,0,0,53
1,21,2,5,16,9,14,5,0,73
1,21,2,5,18,7,5,19,0,78
1,21,2,5,18,7,9,14,5,82
1,21,2,18,5,20,9,1,0,77
1,21,2,18,5,20,9,1,19,96
1,21,2,18,9,5,20,1,0,77
1,21,2,18,9,5,20,1,19,96
1,21,2,18,9,20,5,0,0,76
1,21,2,21,18,14,19,0,0,96
1,21,3,8,5,14,9,21,13,95
1,21,3,8,12,5,20,0,0,70
1,21,3,8,20,0,0,0,0,53
1,21,3,20,1,18,25,0,0,89
1,21,3,20,9,15,14,0,0,83
1,21,3,20,9,15,14,5,4,92
1,21,3,20,9,15,14,19,0,102
1,21,3,20,15,18,0,0,0,78
1,21,3,20,15,18,9,1,12,100
1,21,3,20,15,18,19,0,0,97
1,21,3,21,2,1,19,0,0,68
1,21,3,21,16,1,20,5,0,88
1,21,4,0,0,0,0,0,0,26
1,21,4,1,3,5,0,0,0,35
1,21,4,1,3,9,15,21,19,94
1,21,4,1,3,9,20,25,0,84
1,21,4,1,4,0,0,0,0,31
1,21,4,1,4,19,0,0,0,50
1,21,4,9,2,12,5,0,0,54
1,21,4,9,2,12,5,19,0,73
1,21,4,9,2,12,25,0,0,74
1,21,4,9,5,14,3,5,0,62
1,21,4,9,5,14,3,5,18,80
1,21,4,9,5,14,3,5,19,81
1,21,4,9,5,14,3,9,1,67
1,21,4,9,5,14,20,0,0,74
1,21,4,9,5,14,20,19,0,93
1,21,4,9,12,5,0,0,0,52
1,21,4,9,12,5,19,0,0,71
1,21,4,9,14,7,0,0,0,56
1,21,4,9,14,7,19,0,0,75
1,21,4,9,15,0,0,0,0,50
1,21,4,9,15,7,18,1,13,89
1,21,4,9,15,12,15,7,25,109
1,21,4,9,15,19,0,0,0,69
1,21,4,9,15,20,1,16,5,92
1,21,4,9,16,8,15,14,5,93
1,21,4,9,20,0,0,0,0,55
1,21,4,9,20,1,2,12,5,75
1,21,4,9,20,5,4,0,0,64
1,21,4,9,20,9,14,7,0,85
1,21,4,9,20,9,15,14,0,93
1,21,4,9,20,9,15,14,19,112
1,21,4,9,20,9,22,5,0,91
1,21,4,9,20,9,22,5,19,110
1,21,4,9,20,15,18,0,0,88
1,21,4,9,20,15,18,25,0,113
1,21,4,9,20,15,18,9,1,98
1,21,4,9,20,15,18,19,0,107
1,21,4,9,20,18,5,19,19,116
1,21,4,9,20,19,0,0,0,74
1,21,4,9,20,21,1,12,0,89
1,21,4,9,22,9,19,5,0,90
1,21,4,9,22,9,19,5,18,108
1,21,6,0,0,0,0,0,0,28
1,21,6,1,9,20,0,0,0,58
1,21,6,7,1,2,5,0,0,43
1,21,6,20,1,11,20,0,0,80
1,21,7,1,14,9,20,5,0,78
1,21,7,5,12,9,20,5,0,80
1,21,7,5,14,0,0,0,0,48
1,21,7,5,14,4,0,0,0,52
1,21,7,5,14,4,19,0,0,71
1,21,7,5,18,0,0,0,0,52
1,21,7,5,18,5,18,0,0,75
1,21,7,5,18,19,0,0,0,71
1,21,7,5,20,0,0,0,0,54
1,21,7,8,0,0,0,0,0,37
1,21,7,8,20,0,0,0,0,57
1,21,7,8,20,12,9,14,19,111
1,21,7,8,20,19,0,0,0,76
1,21,7,9,20,5,0,0,0,63
1,21,7,9,20,5,19,0,0,82
1,21,7,9,20,9,3,0,0,70
1,21,7,9,20,9,20,5,0,92
1,21,7,13,5,14,20,0,0,81
1,21,7,13,5,14,20,5,4,90
1,21,7,13,5,14,20,5,18,104
1,21,7,13,5,14,20,15,18,114
1,21,7,13,5,14,20,19,0,100
1,21,7,18,9,13,0,0,0,69
1,21,7,21,18,0,0,0,0,68
1,21,7,21,18,1,12,0,0,81
1,21,7,21,18,1,20,5,0,94
1,21,7,21,18,5,0,0,0,73
1,21,7,21,18,5,4,0,0,77
1,21,7,21,18,5,18,0,0,91
1,21,7,21,18,5,18,19,0,110
1,21,7,21,18,25,0,0,0,93
1,21,7,21,18,9,1,12,0,90
1,21,7,21,18,9,5,19,0,101
1,21,7,21,18,9,14,7,0,98
1,21,7,21,18,15,21,19,0,123
1,21,7,21,18,19,0,0,0,87
1,21,7,21,18,19,8,9,16,120
1,21,7,21,19,20,1,12,0,102
1,21,7,21,19,20,5,18,0,112
1,21,7,21,19,20,5,19,20,133
1,21,7,21,19,20,12,25,0,126
1,21,8,0,0,0,0,0,0,30
1,21,8,21,8,21,0,0,0,80
1,21,11,12,5,20,0,0,0,70
1,21,11,12,5,20,19,0,0,89
1,21,11,19,0,0,0,0,0,52
1,21,11,19,9,14,1,9,0,85
1,21,11,19,9,14,1,19,0,95
1,21,11,19,9,14,21,0,0,96
1,21,12,0,0,0,0,0,0,34
1,21,12,1,0,0,0,0,0,35
1,21,12,1,5,0,0,0,0,40
1,21,12,1,18,9,1,14,0,77
1,21,12,1,19,0,0,0,0,54
1,21,12,4,0,0,0,0,0,38
1,21,12,4,5,18,0,0,0,61
1,21,12,4,5,19,20,0,0,82
1,21,12,5,20,1,9,0,0,69
1,21,12,5,20,5,0,0,0,64
1,21,12,5,20,5,19,0,0,83
1,21,12,5,20,9,3,0,0,71
1,21,12,5,20,18,9,19,0,105
1,21,12,9,3,0,0,0,0,46
1,21,12,9,3,1,12,0,0,59
1,21,12,9,3,9,19,13,0,87
1,21,12,12,1,25,0,0,0,72
1,21,12,15,9,0,0,0,0,58
1,21,12,15,16,8,25,20,5,123
1,21,12,15,19,0,0,0,0,68
1,21,12,21,0,0,0,0,0,55
1,21,13,1,7,1,0,0,0,44
1,21,13,1,9,12,0,0,0,57
1,21,13,1,11,21,1,0,0,69
1,21,13,2,18,25,0,0,0,80
1,21,13,2,18,9,5,19,0,88
1,21,13,5,18,25,0,0,0,83
1,21,13,9,12,0,0,0,0,56
1,21,13,9,12,4,1,18,0,79
1,21,13,15,14,9,5,18,5,101
1,21,13,15,21,19,0,0,0,90
1,21,13,18,9,5,0,0,0,67
1,21,14,3,5,12,0,0,0,56
1,21,14,5,0,0,0,0,0,41
1,21,14,20,0,0,0,0,0,56
1,21,14,20,5,18,0,0,0,79
1,21,14,20,5,18,19,0,0,98
1,21,14,20,8,15,15,4,0,98
1,21,14,20,8,15,15,4,19,117
1,21,14,20,25,0,0,0,0,81
1,21,14,20,9,5,0,0,0,70
1,21,14,20,9,5,19,0,0,89
1,21,14,20,9,19,8,0,0,92
1,21,14,20,12,25,0,0,0,93
1,21,14,20,12,9,5,18,0,100
1,21,14,20,12,9,5,19,20,121
1,21,14,20,12,9,11,5,0,93
1,21,14,20,18,5,0,0,0,79
1,21,14,20,18,15,21,19,0,129
1,21,14,20,19,0,0,0,0,75
1,21,14,20,19,1,18,25,0,119
1,21,14,20,19,8,9,16,0,108
1,21,16,1,11,1,0,0,0,51
1,21,18,1,5,0,0,0,0,46
1,21,18,1,12,12,25,0,0,90
1,21,18,1,13,9,14,0,0,77
1,21,18,1,13,9,14,5,0,82
1,21,18,1,14,7,0,0,0,62
1,21,18,1,14,20,9,1,0,85
1,21,18,1,18,0,0,0,0,59
1,21,18,1,19,0,0,0,0,60
1,21,18,1,20,1,0,0,0,62
1,21,18,1,20,5,0,0,0,66
1,21,18,1,20,5,4,0,0,70
1,21,18,5,1,12,0,0,0,58
1,21,18,5,1,20,5,0,0,71
1,21,18,5,1,20,5,12,25,108
1,21,18,5,1,20,9,15,14,104
1,21,18,5,9,0,0,0,0,54
1,21,18,5,9,20,25,0,0,99
1,21,18,5,14,5,0,0,0,64
1,21,18,5,15,12,1,0,0,73
1,21,18,5,15,12,1,5,0,78
1,21,18,5,15,12,1,19,0,92
1,21,18,5,15,12,5,0,0,77
1,21,18,5,15,12,5,4,0,81
1,21,18,5,15,12,5,19,0,96
1,21,18,5,15,12,9,14,0,95
1,21,18,5,15,12,9,14,5,100
1,21,18,5,15,12,9,14,7,102
1,21,18,5,15,21,19,0,0,100
1,21,18,5,15,21,19,12,25,137
1,21,18,5,19,3,1,0,0,68
1,21,18,5,21,19,0,0,0,85
1,21,18,9,3,12,5,0,0,69
1,21,18,9,3,12,5,4,0,73
1,21,18,9,3,12,5,19,0,88
1,21,18,9,3,21,12,1,5,91
1,21,18,9,3,21,12,1,18,104
1,21,18,9,3,21,12,1,19,105
1,21,18,9,3,21,12,15,0,100
1,21,18,9,4,5,0,0,0,58
1,21,18,9,6,5,24,0,0,84
1,21,18,9,6,25,0,0,0,80
1,21,18,9,6,9,3,0,0,67
1,21,18,9,6,9,5,4,0,73
1,21,18,9,6,25,9,14,7,110
1,21,18,9,6,15,18,13,0,101
1,21,18,9,7,1,12,0,0,69
1,21,18,9,7,15,0,0,0,71
1,21,18,25,12,0,0,0,0,77
1,21,18,9,12,1,22,5,0,89
1,21,18,9,14,0,0,0,0,63
1,21,18,9,14,1,19,1,12,96
1,21,18,9,14,5,0,0,0,68
1,21,18,9,16,8,15,14,5,107
1,21,18,9,18,0,0,0,0,67
1,21,18,9,19,0,0,0,0,68
1,21,18,9,19,3,1,12,16,100
1,21,18,9,19,3,15,16,5,107
1,21,18,9,19,3,15,16,25,127
1,21,18,9,19,20,0,0,0,88
1,21,18,9,19,20,19,0,0,107
1,21,18,9,20,5,0,0,0,74
1,21,18,9,20,5,4,0,0,78
1,21,18,15,1,21,18,9,3,107
1,21,18,15,3,8,0,0,0,66
1,21,18,15,3,8,19,0,0,85
1,21,18,15,3,8,19,5,19,109
1,21,18,15,14,1,12,0,0,82
1,21,18,15,16,8,15,18,5,117
1,21,18,15,18,1,5,0,0,79
1,21,18,15,18,1,12,0,0,86
1,21,18,15,18,1,12,12,25,123
1,21,18,15,18,1,19,0,0,93
1,21,18,15,18,5,1,14,0,93
1,21,18,15,18,9,21,13,0,116
1,21,18,15,21,19,0,0,0,95
1,21,18,18,5,19,3,21,0,106
1,21,18,21,12,5,14,20,0,112
1,21,18,21,13,19,0,0,0,93
1,21,18,21,14,7,0,0,0,82
1,21,18,21,18,5,0,0,0,84
1,21,19,3,21,12,20,0,0,97
1,21,19,6,15,18,13,0,0,93
1,21,19,6,15,18,13,5,4,102
1,21,19,6,15,18,13,19,0,112
1,21,19,12,1,21,20,0,0,95
1,21,19,12,1,21,20,5,0,100
1,21,19,16,5,24,0,0,0,86
1,21,19,16,9,3,1,20,5,95
1,21,19,16,9,3,5,0,0,74
1,21,19,16,9,3,5,19,0,93
1,21,19,16,9,3,25,0,0,94
1,21,19,16,9,3,9,1,12,91
1,21,19,19,9,5,19,0,0,93
1,21,19,20,1,21,19,3,8,113
1,21,19,20,5,13,16,5,18,118
1,21,19,20,5,14,9,20,5,114
1,21,19,20,5,18,5,0,0,89
1,21,19,20,5,18,5,12,25,126
1,21,19,20,5,18,5,18,0,107
1,21,19,20,5,18,5,19,20,128
1,21,19,20,5,18,9,20,25,138
1,21,19,20,5,18,21,19,0,124
1,21,19,20,18,1,12,19,0,111
1,21,19,20,18,9,1,14,19,122
1,21,19,20,18,9,14,5,0,107
1,21,19,20,18,9,21,13,0,122
1,21,19,21,0,0,0,0,0,62
1,21,19,21,2,15,0,0,0,79
1,21,19,21,2,15,19,0,0,98
1,21,20,1,3,15,9,4,0,74
1,21,20,1,3,15,9,4,19,93
1,21,20,1,18,3,8,0,0,72
1,21,20,1,18,3,8,25,0,97
1,21,20,1,18,3,8,9,3,84
1,21,20,1,18,11,25,0,0,97
1,21,20,1,18,11,9,3,0,84
1,21,20,1,18,11,9,5,19,105
1,21,20,1,18,11,9,11,0,92
1,21,20,1,18,11,9,19,20,120
1,21,20,5,0,0,0,0,0,47
1,21,20,5,3,25,0,0,0,75
1,21,20,5,3,9,15,21,19,114
1,21,20,5,3,9,19,13,0,91
1,21,20,5,3,9,19,13,19,110
1,21,20,5,13,0,0,0,0,60
1,21,20,5,18,5,0,0,0,70
1,21,20,5,21,18,0,0,0,86
1,21,20,5,21,18,9,19,13,127
1,21,20,5,21,18,19,0,0,105
1,21,20,5,24,15,21,19,25,151
1,21,20,8,0,0,0,0,0,50
1,21,20,8,5,14,20,9,3,101
1,21,20,8,9,7,5,14,5,90
1,21,20,8,15,18,0,0,0,83
1,21,20,8,15,18,5,4,0,92
1,21,20,8,15,18,5,19,19,126
1,21,20,8,15,18,9,1,12,105
1,21,20,8,15,18,9,14,7,113
1,21,20,8,15,18,9,19,5,116
1,21,20,8,15,18,9,19,8,119
1,21,20,8,15,18,9,19,13,124
1,21,20,8,15,18,9,20,25,137
1,21,20,8,15,18,9,26,5,123
1,21,20,8,15,18,12,25,0,120
1,21,20,8,15,18,19,0,0,102
1,21,20,8,15,20,25,16,5,131
1,21,20,9,19,13,0,0,0,83
1,21,20,9,19,13,19,0,0,102
1,21,20,9,19,20,0,0,0,90
1,21,20,9,19,20,9,3,0,102
1,21,20,15,0,0,0,0,0,57
1,21,20,15,1,12,1,18,13,102
1,21,20,15,2,1,8,14,19,101
1,21,20,15,2,12,1,19,20,111
1,21,20,15,2,15,1,20,0,95
1,21,20,15,2,21,19,0,0,99
1,21,20,15,2,21,19,5,19,123
1,21,20,15,3,1,2,0,0,63
1,21,20,15,3,1,4,5,0,70
1,21,20,15,3,1,4,5,19,89
1,21,20,15,3,1,12,12,0,85
1,21,20,15,3,1,13,16,0,90
1,21,20,15,3,1,18,0,0,79
1,21,20,15,3,1,18,16,0,95
1,21,20,15,3,8,20,15,14,117
1,21,20,15,3,25,3,12,5,105
1,21,20,15,3,9,4,5,0,78
1,21,20,15,3,12,1,22,5,100
1,21,20,15,3,15,4,5,18,102
1,21,20,15,3,15,9,4,0,88
1,21,20,15,3,15,9,4,19,107
1,21,20,15,3,15,19,13,0,107
1,21,20,15,3,18,1,3,25,107
1,21,20,15,3,18,1,20,0,99
1,21,20,15,3,18,1,20,19,118
1,21,20,15,3,18,15,19,19,131
1,21,20,15,3,21,5,0,0,86
1,21,20,15,4,9,1,12,0,83
1,21,20,15,4,9,1,12,19,102
1,21,20,15,4,25,14,5,0,105
1,21,20,15,4,25,14,5,19,124
1,21,20,15,4,18,15,13,5,112
1,21,20,15,5,3,25,0,0,90
1,21,20,15,5,3,9,3,0,77
1,21,20,15,5,3,9,19,13,106
1,21,20,15,5,3,15,21,19,120
1,21,20,15,5,4,0,0,0,66
1,21,20,15,5,20,20,5,0,107
1,21,20,15,7,1,13,25,0,103
1,21,20,15,7,1,13,9,3,90
1,21,20,15,7,1,21,7,5,98
1,21,20,15,7,5,14,25,0,108
1,21,20,15,7,5,14,9,3,95
1,21,20,15,7,25,18,15,0,122
1,21,20,15,7,9,18,15,19,125
1,21,20,15,7,25,18,15,19,141
1,21,20,15,7,18,1,6,20,109
1,21,20,15,7,18,1,13,0,96
1,21,20,15,7,18,1,16,8,107
1,21,20,15,8,5,13,9,3,95
1,21,20,15,9,3,15,21,19,124
1,21,20,15,9,14,4,5,24,113
1,21,20,15,9,14,7,0,0,87
1,21,20,15,9,19,20,0,0,105
1,21,20,15,12,1,20,5,18,113
1,21,20,15,12,1,20,18,25,133
1,21,20,15,12,25,19,5,0,118
1,21,20,15,12,25,19,9,14,136
1,21,20,15,12,25,19,9,19,141
1,21,20,15,12,9,20,8,0,106
1,21,20,15,12,25,20,9,3,126
1,21,20,15,12,25,26,5,0,125
1,21,20,15,12,25,26,5,4,129
1,21,20,15,12,25,26,5,19,144
1,21,20,15,12,15,7,25,0,116
1,21,20,15,13,1,0,0,0,71
1,21,20,15,13,1,3,25,0,99
1,21,20,15,13,1,11,5,18,105
1,21,20,15,13,1,14,0,0,85
1,21,20,15,13,1,14,9,1,95
1,21,20,15,13,1,20,0,0,91
1,21,20,15,13,1,20,1,0,92
1,21,20,15,13,1,20,5,0,96
1,21,20,15,13,1,20,5,4,100
1,21,20,15,13,1,20,5,19,115
1,21,20,15,13,1,20,9,3,103
1,21,20,15,13,1,20,9,14,114
1,21,20,15,13,1,20,15,14,120
1,21,20,15,13,1,20,19,0,110
1,21,20,15,13,5,12,15,14,116
1,21,20,15,13,5,14,0,0,89
1,21,20,15,13,5,20,18,25,138
1,21,20,15,13,15,18,16,8,127
1,21,20,15,13,15,20,15,18,138
1,21,20,15,13,15,23,5,18,131
1,21,20,15,13,16,14,5,0,105
1,21,20,15,14,25,13,0,0,109
1,21,20,15,14,15,13,25,0,124
1,21,20,15,14,15,13,9,3,111
1,21,20,15,16,1,20,8,25,127
1,21,20,15,16,8,1,7,9,98
1,21,20,15,16,8,1,7,25,114
1,21,20,15,16,8,25,20,5,131
1,21,20,15,16,8,15,2,25,123
1,21,20,15,16,8,15,14,0,110
1,21,20,15,16,8,15,14,5,115
1,21,20,15,16,8,15,14,25,135
1,21,20,15,16,9,12,15,20,129
1,21,20,15,16,9,19,20,1,122
1,21,20,15,16,12,1,19,20,125
1,21,20,15,16,15,9,14,20,131
1,21,20,15,16,15,12,1,18,119
1,21,20,15,16,15,12,15,0,115
1,21,20,15,16,15,18,5,0,111
1,21,20,15,16,19,25,0,0,117
1,21,20,15,16,19,9,3,0,104
1,21,20,15,16,19,9,5,4,110
1,21,20,15,16,19,9,5,19,125
1,21,20,15,16,19,9,19,20,140
1,21,20,15,16,20,9,3,0,105
1,21,20,15,16,21,20,0,0,114
1,21,20,15,18,0,0,0,0,75
1,21,20,15,18,1,9,12,0,97
1,21,20,15,18,9,19,5,18,126
1,21,20,15,18,15,21,20,5,136
1,21,20,15,19,0,0,0,0,76
1,21,20,15,19,3,15,16,5,115
1,21,20,15,19,3,15,16,25,135
1,21,20,15,19,5,18,21,13,133
1,21,20,15,19,9,7,8,20,120
1,21,20,15,19,9,7,14,0,106
1,21,20,15,19,9,20,5,0,110
1,21,20,15,19,9,20,9,3,117
1,21,20,15,19,12,5,4,0,97
1,21,20,15,19,12,9,16,0,113
1,21,20,15,19,15,13,1,12,117
1,21,20,15,19,15,13,5,0,109
1,21,20,15,19,15,13,5,19,128
1,21,20,15,19,16,15,18,5,130
1,21,20,15,19,16,18,1,25,136
1,21,20,15,19,20,1,7,5,109
1,21,20,15,19,20,25,12,25,158
1,21,20,15,20,1,0,0,0,78
1,21,20,15,20,5,12,9,3,106
1,21,20,15,20,9,13,5,18,122
1,21,20,15,20,25,16,5,0,123
1,21,20,15,20,25,16,5,19,142
1,21,20,15,20,25,16,25,0,143
1,21,20,15,20,25,16,9,3,130
1,21,20,15,20,15,13,25,0,130
1,21,20,15,20,15,13,9,3,117
1,21,20,15,20,15,24,9,3,128
1,21,20,15,20,15,24,9,14,139
1,21,20,15,20,15,24,9,19,144
1,21,20,15,20,18,15,16,8,134
1,21,20,15,20,18,21,3,11,130
1,21,20,15,21,18,9,14,5,124
1,21,20,15,22,1,12,5,20,117
1,21,20,15,22,1,12,22,5,119
1,21,20,15,24,5,14,25,0,125
1,21,20,15,26,15,15,9,4,126
1,21,20,18,5,0,0,0,0,65
1,21,20,18,5,6,15,9,19,114
1,21,20,21,13,14,1,12,0,103
1,21,20,21,13,14,9,1,14,114
1,21,20,21,13,14,9,20,25,144
1,21,20,21,13,14,19,0,0,109
1,21,20,21,14,9,20,5,0,111
1,21,20,21,14,9,20,5,19,130
1,21,20,21,18,7,25,0,0,113
1,21,24,5,19,5,19,0,0,94
1,21,24,5,19,9,19,0,0,98
1,21,24,5,20,9,3,0,0,83
1,21,24,5,20,9,3,1,12,96
1,21,24,5,20,9,3,19,0,102
1,21,24,9,12,0,0,0,0,67
1,21,24,9,12,9,1,18,0,95
1,21,24,9,12,9,1,18,25,120
1,21,24,9,12,9,1,20,5,102
1,21,24,9,12,25,20,9,3,124
1,21,24,9,12,9,21,13,0,110
1,21,24,9,12,12,1,18,25,123
1,21,24,9,13,15,14,5,0,102
1,21,24,9,14,0,0,0,0,69
1,21,24,9,14,9,3,0,0,81
1,21,24,9,14,19,0,0,0,88
1,21,24,15,2,12,1,19,20,115
1,21,24,15,2,15,4,25,0,107
1,21,24,15,3,25,20,5,0,114
1,21,24,15,6,12,15,18,5,117
1,21,24,15,6,12,21,15,18,133
1,21,24,15,7,18,1,16,8,111
1,21,24,15,12,15,7,25,0,120
1,21,24,15,13,5,20,5,18,122
1,21,24,15,19,16,15,18,5,134
1,21,24,15,20,15,14,9,3,122
1,21,24,15,20,15,24,0,0,120
1,21,24,15,20,18,15,16,8,138
1,22,4,16,0,0,0,0,0,43
1,22,5,12,12,0,0,0,0,52
1,22,5,12,12,1,14,0,0,67
1,22,5,12,12,1,14,5,0,72
1,22,5,12,12,1,14,15,0,82
1,22,5,12,15,14,7,5,0,81
1,22,5,12,15,26,0,0,0,81
1,22,5,14,1,7,5,0,0,55
1,22,5,14,1,12,9,14,0,78
1,22,5,14,1,14,20,0,0,77
1,22,5,14,1,18,25,0,0,86
1,22,5,14,5,18,0,0,0,65
1,22,5,14,5,18,25,0,0,90
1,22,5,14,7,5,0,0,0,54
1,22,5,14,7,5,4,0,0,58
1,22,5,14,7,5,6,21,12,93
1,22,5,14,7,5,18,0,0,72
1,22,5,14,7,5,18,19,0,91
1,22,5,14,7,5,19,0,0,73
1,22,5,14,7,9,14,7,0,79
1,22,5,14,25,0,0,0,0,67
1,22,5,14,9,4,1,0,0,56
1,22,5,14,9,6,15,18,13,103
1,22,5,14,9,14,0,0,0,65
1,22,5,14,9,14,5,0,0,70
1,22,5,14,15,12,9,20,8,106
1,22,5,14,15,21,19,0,0,97
1,22,5,14,19,0,0,0,0,61
1,22,5,14,19,5,19,0,0,85
1,22,5,14,20,1,9,12,0,84
1,22,5,14,20,1,25,12,5,105
1,22,5,14,20,1,9,12,19,103
1,22,5,14,20,18,5,0,0,85
1,22,5,14,20,21,18,5,0,106
1,22,5,14,20,21,18,9,14,124
1,22,5,14,21,5,0,0,0,68
1,22,5,14,21,5,19,0,0,87
1,22,5,18,0,0,0,0,0,46
1,22,5,18,1,7,5,0,0,59
1,22,5,18,1,7,5,4,0,63
1,22,5,18,1,7,5,12,25,96
1,22,5,18,1,7,5,18,0,77
1,22,5,18,1,7,5,19,0,78
1,22,5,18,1,7,9,14,7,84
1,22,5,18,1,8,0,0,0,55
1,22,5,18,9,1,0,0,0,56
1,22,5,18,9,14,0,0,0,69
1,22,5,18,9,19,8,0,0,82
1,22,5,18,13,5,14,20,0,98
1,22,5,18,13,5,14,20,19,117
1,22,5,18,14,0,0,0,0,60
1,22,5,18,18,1,2,12,5,84
1,22,5,18,18,1,12,0,0,77
1,22,5,18,18,5,4,0,0,73
1,22,5,18,18,5,18,0,0,87
1,22,5,18,18,9,14,7,0,94
1,22,5,18,19,0,0,0,0,65
1,22,5,18,19,1,14,20,0,100
1,22,5,18,19,5,0,0,0,70
1,22,5,18,19,5,12,25,0,107
1,22,5,18,19,9,15,14,0,103
1,22,5,18,19,9,15,14,19,122
1,22,5,18,19,9,22,5,0,101
1,22,5,18,20,0,0,0,0,66
1,22,5,18,20,1,2,12,5,86
1,22,5,18,20,5,4,0,0,75
1,22,5,18,20,5,4,12,25,112
1,22,5,18,20,5,18,0,0,89
1,22,5,18,20,9,2,12,5,94
1,22,5,18,20,9,14,7,0,96
1,22,5,18,20,9,22,5,0,102
1,22,5,18,20,19,0,0,0,85
1,22,5,19,20,18,21,26,0,132
1,22,5,21,7,12,5,0,0,73
1,22,7,0,0,0,0,0,0,30
1,22,7,1,19,0,0,0,0,50
1,22,7,1,19,5,19,0,0,74
1,22,7,1,19,19,5,19,0,93
1,22,9,1,4,15,18,0,0,70
1,22,9,1,14,0,0,0,0,47
1,22,9,1,14,9,26,5,0,87
1,22,9,1,14,9,26,5,4,91
1,22,9,1,14,9,26,5,19,106
1,22,9,1,14,19,0,0,0,66
1,22,9,1,18,25,0,0,0,76
1,22,9,1,18,9,5,19,0,84
1,22,9,1,18,9,19,20,0,99
1,22,9,1,18,9,19,20,19,118
1,22,9,1,20,5,0,0,0,58
1,22,9,1,20,5,4,0,0,62
1,22,9,1,20,5,19,0,0,77
1,22,9,1,20,9,3,0,0,65
1,22,9,1,20,9,14,7,0,83
1,22,9,1,20,9,15,14,0,91
1,22,9,1,20,9,15,14,19,110
1,22,9,1,20,15,18,0,0,86
1,22,9,1,20,15,18,25,0,111
1,22,9,1,20,15,18,19,0,105
1,22,9,1,20,18,5,19,19,114
1,22,9,1,20,18,9,3,5,88
1,22,9,1,20,18,9,24,0,104
1,22,9,3,8,9,0,0,0,52
1,22,9,3,9,4,5,0,0,53
1,22,9,3,11,0,0,0,0,46
1,22,9,3,15,12,15,21,19,117
1,22,9,3,21,12,1,18,0,87
1,22,9,4,0,0,0,0,0,36
1,22,9,4,25,1,0,0,0,62
1,22,9,4,9,14,0,0,0,59
1,22,9,4,9,14,19,0,0,78
1,22,9,4,9,15,21,19,0,100
1,22,9,4,9,20,25,0,0,90
1,22,9,4,9,20,9,5,19,98
1,22,9,4,12,25,0,0,0,73
1,22,9,4,14,5,19,19,0,93
1,22,9,4,15,21,19,0,0,91
1,22,9,5,23,0,0,0,0,60
1,22,9,6,1,21,14,1,0,75
1,22,9,6,1,21,14,1,5,80
1,22,9,6,1,21,14,1,12,87
1,22,9,6,1,21,14,1,19,94
1,22,9,7,1,20,5,0,0,65
1,22,9,7,1,20,9,15,14,98
1,22,9,7,1,20,15,18,0,93
1,22,9,7,1,20,15,18,19,112
1,22,9,10,10,1,0,0,0,53
1,22,9,12,1,18,9,1,0,73
1,22,9,12,5,0,0,0,0,49
1,22,9,12,5,13,5,14,20,101
1,22,9,14,5,0,0,0,0,51
1,22,9,15,12,9,20,5,0,93
1,22,9,15,14,0,0,0,0,61
1,22,9,15,14,9,3,0,0,73
1,22,9,15,14,9,3,19,0,92
1,22,9,15,14,19,0,0,0,80
1,22,9,18,21,12,5,14,20,122
1,22,25,19,0,0,0,0,0,67
1,22,9,19,9,15,14,0,0,89
1,22,9,19,15,0,0,0,0,66
1,22,9,19,15,19,0,0,0,85
1,22,9,20,1,12,0,0,0,65
1,22,9,20,9,3,0,0,0,64
1,22,9,22,5,19,0,0,0,78
1,22,9,26,1,14,4,21,13,111
1,22,14,0,0,0,0,0,0,37
1,22,15,3,1,4,15,0,0,61
1,22,15,3,1,4,15,5,19,85
1,22,15,3,1,4,15,19,0,80
1,22,15,3,1,20,0,0,0,62
1,22,15,3,1,20,5,0,0,67
1,22,15,3,1,20,9,15,14,100
1,22,15,3,1,20,9,22,5,98
1,22,15,3,1,20,15,18,25,120
1,22,15,3,5,20,0,0,0,66
1,22,15,3,5,20,19,0,0,85
1,22,15,4,9,18,5,0,0,74
1,22,15,4,9,18,5,19,0,93
1,22,15,7,18,1,13,0,0,77
1,22,15,25,0,0,0,0,0,63
1,22,15,9,4,0,0,0,0,51
1,22,15,9,4,1,2,12,5,71
1,22,15,9,4,1,2,12,25,91
1,22,15,9,4,1,14,3,5,74
1,22,15,9,4,1,14,20,0,86
1,22,15,9,4,5,4,0,0,60
1,22,15,9,4,5,18,0,0,74
1,22,15,9,4,5,18,19,0,93
1,22,15,9,4,9,14,7,0,81
1,22,15,9,4,12,5,19,19,106
1,22,15,9,4,13,5,14,20,103
1,22,15,9,4,19,0,0,0,70
1,22,15,25,5,18,0,0,0,86
1,22,15,9,18,0,0,0,0,65
1,22,15,11,5,0,0,0,0,54
1,22,15,12,1,20,5,0,0,76
1,22,15,12,1,20,9,15,14,109
1,22,15,19,0,0,0,0,0,57
1,22,15,19,5,20,0,0,0,82
1,22,15,19,5,20,19,0,0,101
1,22,15,21,3,8,0,0,0,70
1,22,15,21,3,8,5,4,0,79
1,22,15,21,3,8,5,18,0,93
1,22,15,21,3,8,5,18,19,112
1,22,15,21,3,8,5,19,0,94
1,22,15,21,3,8,9,14,7,100
1,22,15,21,5,0,0,0,0,64
1,22,15,21,18,0,0,0,0,77
1,22,15,21,18,5,0,0,0,82
1,22,15,21,18,14,5,5,14,115
1,22,15,21,20,5,18,0,0,102
1,22,15,21,20,18,25,0,0,122
1,22,15,23,0,0,0,0,0,61
1,22,15,23,1,2,12,5,0,81
1,22,15,23,1,2,12,25,0,101
1,22,15,23,1,12,0,0,0,74
1,22,15,23,1,12,19,0,0,93
1,22,15,23,1,14,3,5,0,84
1,22,15,23,1,14,20,0,0,96
1,22,15,23,5,0,0,0,0,66
1,22,15,23,5,4,0,0,0,70
1,22,15,23,5,4,12,25,0,107
1,22,15,23,5,18,0,0,0,84
1,22,15,23,5,18,19,0,0,103
1,22,15,23,9,14,7,0,0,91
1,22,15,23,18,25,0,0,0,104
1,22,15,23,18,9,5,19,0,112
1,22,15,23,19,0,0,0,0,80
1,22,15,23,20,5,18,0,0,104
1,22,21,12,19,5,0,0,0,80
1,22,21,12,19,5,4,0,0,84
1,22,21,12,19,5,19,0,0,99
1,22,21,12,19,9,14,7,0,105
1,22,21,12,19,9,15,14,0,113
1,22,21,12,19,9,15,14,19,132
1,22,21,14,3,21,12,1,18,113
1,23,2,5,18,0,0,0,0,49
1,23,4,0,0,0,0,0,0,28
1,23,5,0,0,0,0,0,0,29
1,23,5,1,18,25,0,0,0,73
1,23,5,1,18,9,5,4,0,66
1,23,5,1,20,8,5,18,0,81
1,23,5,2,1,14,4,0,0,50
1,23,5,4,0,0,0,0,0,33
1,23,5,4,12,25,0,0,0,70
1,23,5,4,14,5,19,19,0,90
1,23,5,5,0,0,0,0,0,34
1,23,5,5,11,0,0,0,0,45
1,23,5,5,12,0,0,0,0,46
1,23,5,9,7,8,0,0,0,53
1,23,5,9,14,7,0,0,0,59
1,23,5,12,5,19,19,0,0,84
1,23,5,19,0,0,0,0,0,48
1,23,5,19,15,13,5,0,0,81
1,23,5,19,15,13,5,12,25,118
1,23,5,19,20,0,0,0,0,68
1,23,5,19,20,18,9,11,5,111
1,23,5,19,20,18,21,3,11,121
1,23,5,20,15,0,0,0,0,64
1,23,6,21,0,0,0,0,0,51
1,23,6,21,12,0,0,0,0,63
1,23,6,21,12,12,5,18,0,98
1,23,6,21,12,12,5,19,20,119
1,23,6,21,12,12,25,0,0,100
1,23,6,21,12,14,5,19,19,120
1,23,8,1,16,5,0,0,0,54
1,23,8,5,5,12,0,0,0,54
1,23,8,5,6,20,0,0,0,63
1,23,8,5,20,0,0,0,0,57
1,23,8,9,12,5,0,0,0,58
1,23,8,9,18,0,0,0,0,59
1,23,8,9,18,12,0,0,0,71
1,23,9,4,5,0,0,0,0,42
1,23,9,7,7,12,5,0,0,64
1,23,9,11,9,23,9,11,9,105
1,23,9,14,0,0,0,0,0,47
1,23,9,14,7,0,0,0,0,54
1,23,9,14,7,12,25,0,0,91
1,23,9,14,11,0,0,0,0,58
1,23,9,23,9,0,0,0,0,65
1,23,11,12,25,0,0,0,0,72
1,23,11,23,1,18,4,0,0,81
1,23,11,23,1,18,4,5,18,104
1,23,11,23,1,18,4,12,25,118
1,23,12,5,19,19,0,0,0,79
1,23,12,19,0,0,0,0,0,55
1,23,12,23,15,18,20,0,0,112
1,23,12,23,15,18,20,19,0,131
1,23,13,0,0,0,0,0,0,37
1,23,13,2,18,9,5,0,0,71
1,23,13,15,21,19,0,0,0,92
1,23,14,0,0,0,0,0,0,38
1,23,14,5,4,0,0,0,0,47
1,23,14,5,18,0,0,0,0,61
1,23,14,25,0,0,0,0,0,63
1,23,14,9,14,7,0,0,0,68
1,23,14,9,14,7,5,4,0,77
1,23,14,9,14,7,19,0,0,87
1,23,14,12,5,19,19,0,0,93
1,23,14,12,9,11,5,0,0,75
1,23,14,19,0,0,0,0,0,57
1,23,15,11,5,0,0,0,0,55
1,23,15,11,5,14,0,0,0,69
1,23,15,12,19,0,0,0,0,70
1,23,15,14,4,5,18,0,0,80
1,23,15,18,11,0,0,0,0,68
1,23,15,18,18,25,0,0,0,100
1,23,15,18,20,8,0,0,0,85
1,23,18,5,1,11,0,0,0,59
1,23,18,5,3,11,0,0,0,61
1,23,18,25,0,0,0,0,0,67
1,23,18,9,19,20,0,0,0,90
1,23,18,15,14,7,0,0,0,78
1,23,21,14,3,20,9,22,5,118
1,24,2,18,5,1,11,5,18,85
1,24,5,4,0,0,0,0,0,34
1,24,5,12,19,0,0,0,0,61
1,24,5,13,1,14,0,0,0,58
1,24,5,13,1,19,20,5,18,106
1,24,5,13,5,14,0,0,0,62
1,24,5,14,9,3,0,0,0,56
1,24,5,18,0,0,0,0,0,48
1,24,5,18,19,0,0,0,0,67
1,24,5,19,0,0,0,0,0,49
1,24,6,5,20,3,8,0,0,67
1,24,8,1,13,13,5,18,0,83
1,24,8,5,1,4,0,0,0,43
1,24,9,1,12,0,0,0,0,47
1,24,9,1,12,9,20,25,0,101
1,24,9,1,12,12,25,0,0,84
1,24,9,1,20,5,0,0,0,60
1,24,9,1,20,9,15,14,0,93
1,24,9,6,5,18,15,21,19,118
1,24,9,6,15,18,13,0,0,86
1,24,9,6,21,7,1,12,0,81
1,24,9,12,0,0,0,0,0,46
1,24,9,12,5,0,0,0,0,51
1,24,9,12,5,13,13,1,0,78
1,24,9,12,5,13,13,1,19,97
1,24,9,12,12,1,0,0,0,59
1,24,9,12,12,1,5,0,0,64
1,24,9,12,12,1,14,20,0,93
1,24,9,12,12,1,18,0,0,77
1,24,9,12,12,1,18,25,0,102
1,24,9,12,12,1,18,19,0,96
1,24,9,12,12,1,19,0,0,78
1,24,9,12,19,0,0,0,0,65
1,24,9,14,0,0,0,0,0,48
1,24,9,14,5,0,0,0,0,53
1,24,9,14,7,0,0,0,0,55
1,24,9,14,9,6,15,18,13,109
1,24,9,14,9,20,5,0,0,82
1,24,9,15,12,9,20,5,0,95
1,24,9,15,12,9,20,9,3,102
1,24,9,15,12,15,7,25,0,108
1,24,9,15,13,0,0,0,0,62
1,24,9,15,13,1,20,9,3,95
1,24,9,15,13,19,0,0,0,81
1,24,9,15,14,0,0,0,0,63
1,24,9,15,16,9,19,20,25,138
1,24,9,19,5,4,0,0,0,62
1,24,9,19,5,19,0,0,0,77
1,24,9,20,5,0,0,0,0,59
1,24,9,20,5,19,0,0,0,78
1,24,12,5,0,0,0,0,0,42
1,24,12,5,4,0,0,0,0,46
1,24,12,5,19,0,0,0,0,61
1,24,12,5,19,13,9,20,8,111
1,24,12,5,20,18,5,5,0,90
1,24,12,5,20,18,5,5,19,109
1,24,12,9,11,5,0,0,0,62
1,24,13,1,11,5,18,0,0,73
1,24,13,1,11,9,14,7,0,80
1,24,13,1,14,0,0,0,0,53
1,24,13,1,14,19,8,9,16,105
1,24,13,1,19,20,5,18,0,101
1,24,13,5,14,0,0,0,0,57
1,24,15,6,21,7,1,12,0,87
1,24,15,7,1,13,25,0,0,86
1,24,15,9,4,0,0,0,0,53
1,24,15,9,4,5,1,14,0,73
1,24,15,12,5,13,13,1,0,84
1,24,15,12,25,19,9,19,0,124
1,24,15,12,15,20,12,0,0,99
1,24,15,12,15,20,12,19,0,118
1,24,15,13,5,20,5,18,0,101
1,24,15,13,5,20,18,25,0,121
1,24,15,13,5,20,18,9,3,108
1,24,15,14,0,0,0,0,0,54
1,24,15,14,1,12,0,0,0,67
1,24,15,14,5,0,0,0,0,59
1,24,15,14,5,13,1,12,0,85
1,24,15,14,5,13,5,0,0,77
1,24,15,14,5,13,5,19,0,96
1,24,15,14,5,19,0,0,0,78
1,24,15,14,5,21,18,5,0,103
1,24,15,14,5,21,18,15,14,127
1,24,15,14,9,3,0,0,0,66
1,24,15,14,15,19,20,0,0,108
1,24,15,14,19,0,0,0,0,73
1,24,15,16,5,20,1,12,0,94
1,24,15,16,8,25,20,5,0,114
1,24,15,16,12,1,19,13,0,101
1,24,15,16,12,1,19,13,19,120
1,24,15,16,15,4,9,1,0,85
1,24,15,16,15,4,9,21,13,118
1,24,15,19,20,25,12,5,0,121
1,24,15,20,15,13,15,21,19,143
1,24,19,5,5,4,0,0,0,58
1,24,19,5,5,4,19,0,0,77
1,24,19,20,15,14,5,0,0,98
1,24,20,18,5,5,0,0,0,73
1,24,21,14,7,5,0,0,0,72
1,24,23,5,5,4,0,0,0,62
1,24,23,9,19,5,0,0,0,81
1,24,23,15,18,20,0,0,0,101
1,26,5,4,1,18,1,3,0,59
1,26,5,4,1,18,1,3,8,67
1,26,5,12,1,9,3,0,0,57
1,26,5,12,1,20,5,0,0,70
1,26,5,15,20,18,15,16,5,121
1,26,5,15,20,18,15,16,25,141
1,26,9,4,5,19,0,0,0,64
1,26,9,4,15,0,0,0,0,55
1,26,9,5,20,8,1,14,5,89
1,26,25,7,15,19,0,0,0,93
1,26,25,7,15,19,5,19,0,117
1,26,25,7,15,20,5,0,0,99
1,26,25,7,15,21,19,0,0,114
1,26,9,12,21,20,0,0,0,89
1,26,25,13,5,0,0,0,0,70
1,26,9,13,5,14,5,0,0,73
1,26,9,13,9,4,5,0,0,67
1,26,9,13,9,14,0,0,0,72
1,26,9,13,9,14,5,0,0,77
1,26,9,13,9,14,15,0,0,87
1,26,25,13,9,20,5,0,0,99
1,26,25,13,15,21,19,0,0,120
1,26,9,13,21,20,8,0,0,98
1,26,9,13,21,20,8,1,12,111
1,26,9,13,21,20,8,19,0,117
1,26,9,14,5,0,0,0,0,55
1,26,9,14,5,19,0,0,0,74
1,26,9,15,12,1,0,0,0,64
1,26,12,1,3,20,15,14,5,97
1,26,12,15,14,0,0,0,0,68
1,26,12,15,14,19,0,0,0,87
1,26,15,0,0,0,0,0,0,42
1,26,15,2,1,3,20,5,18,91
1,26,15,2,5,14,26,9,12,110
1,26,15,2,5,14,26,15,12,116
1,26,15,2,12,1,3,11,0,71
1,26,15,3,8,0,0,0,0,53
1,26,15,3,25,3,12,9,3,97
1,26,15,5,15,19,9,14,0,104
1,26,15,6,25,0,0,0,0,73
1,26,15,6,9,5,18,0,0,80
1,26,15,6,15,18,13,9,3,106
1,26,15,7,18,5,5,14,0,91
1,26,15,8,21,13,9,3,0,96
1,26,15,9,3,0,0,0,0,54
1,26,15,9,13,9,4,5,0,82
1,26,15,12,5,0,0,0,0,59
1,26,15,12,5,19,0,0,0,78
1,26,15,12,9,20,13,9,14,119
1,26,15,14,0,0,0,0,0,56
1,26,15,14,1,12,0,0,0,69
1,26,15,14,9,3,0,0,0,68
1,26,15,14,9,21,13,0,0,99
1,26,15,14,19,0,0,0,0,75
1,26,15,15,12,15,7,25,0,116
1,26,15,16,8,5,14,0,0,85
1,26,15,16,8,5,14,25,12,122
1,26,15,16,8,5,14,15,12,112
1,26,15,18,9,20,5,0,0,94
1,26,15,18,21,2,9,14,5,111
1,26,15,20,1,5,13,9,1,91
1,26,15,20,1,20,5,0,0,88
1,26,15,20,5,0,0,0,0,67
1,26,15,20,5,1,0,0,0,68
1,26,15,20,5,4,0,0,0,71
1,26,15,20,5,13,9,1,0,90
1,26,15,20,5,13,9,1,19,109
1,26,15,20,5,13,9,3,0,92
1,26,15,20,5,19,0,0,0,86
1,26,15,20,8,0,0,0,0,70
1,26,15,20,8,19,0,0,0,89
1,26,15,20,9,3,0,0,0,74
1,26,15,20,9,14,0,0,0,85
1,26,15,20,9,14,5,0,0,90
1,26,15,20,9,19,5,0,0,95
1,26,15,20,9,19,5,4,0,99
1,26,15,20,9,19,5,19,0,114
1,26,15,20,9,19,9,14,7,120
1,26,15,20,9,20,5,0,0,96
1,26,15,20,9,26,5,0,0,102
1,26,15,20,9,26,5,4,0,106
1,26,15,20,9,26,5,19,0,121
1,26,15,20,9,26,9,14,7,127
1,26,15,20,15,21,19,0,0,117
1,26,15,20,21,18,9,1,0,111
1,26,15,20,21,18,9,1,19,130
1,26,15,24,0,0,0,0,0,66
1,26,15,24,1,26,15,12,5,125
1,26,15,24,25,0,0,0,0,91
1,26,15,24,9,13,5,0,0,93
1,26,15,24,9,14,5,0,0,94
1,26,15,24,15,14,9,21,13,138
1,26,20,5,3,19,0,0,0,74
1,26,21,12,5,10,15,0,0,90
1,26,21,12,5,10,15,19,0,109
1,26,21,12,5,14,5,0,0,84
1,26,21,12,9,14,5,0,0,88
1,26,21,12,9,20,5,0,0,94
1,26,21,12,13,9,3,0,0,85
1,26,21,13,2,18,5,0,0,86
1,26,21,18,5,0,0,0,0,71
1,26,21,18,5,1,14,0,0,86
1,26,21,18,5,4,0,0,0,75
1,26,21,18,5,14,5,19,19,128
1,26,21,18,5,15,21,19,0,126
1,26,21,18,5,19,0,0,0,90
1,26,21,18,25,0,0,0,0,91
1,26,21,18,9,14,5,0,0,94
1,26,21,18,9,20,5,0,0,100
1,26,21,18,9,20,5,19,0,119
1,26,21,18,15,21,19,0,0,121
2,2,12,19,0,0,0,0,0,35
2,2,19,0,0,0,0,0,0,23
2,3,6,0,0,0,0,0,0,11
2,3,8,19,0,0,0,0,0,32
2,4,5,12,12,9,4,0,0,48
2,4,5,12,12,9,21,13,0,78
2,4,5,12,12,9,21,13,19,97
2,4,5,12,12,15,9,4,0,63
2,4,6,20,0,0,0,0,0,32
2,4,12,0,0,0,0,0,0,18
2,4,12,5,0,0,0,0,0,23
2,4,12,19,0,0,0,0,0,37
2,4,18,13,0,0,0,0,0,37
2,5,2,1,3,11,0,0,0,24
2,5,2,1,25,0,0,0,0,35
2,5,2,1,9,20,0,0,0,39
2,5,2,1,12,12,5,4,0,43
2,5,2,1,14,7,0,0,0,31
2,5,2,1,18,0,0,0,0,28
2,5,2,1,18,15,14,0,0,57
2,5,2,1,19,20,5,0,0,54
2,5,2,1,20,0,0,0,0,30
2,5,2,1,20,8,5,0,0,43
2,5,2,1,20,20,5,18,0,73
2,5,2,5,1,19,20,0,0,54
2,5,2,5,4,0,0,0,0,18
2,5,2,5,5,18,9,14,0,60
2,5,2,5,5,18,9,14,5,65
2,5,2,5,5,18,21,0,0,58
2,5,2,5,5,18,21,19,0,77
2,5,2,5,12,20,5,4,0,55
2,5,2,9,12,25,1,0,0,56
2,5,2,9,20,5,0,0,0,43
2,5,2,12,1,9,14,0,0,45
2,5,2,12,5,1,18,0,0,45
2,5,2,12,5,4,0,0,0,30
2,5,2,12,5,5,4,0,0,35
2,5,2,12,5,19,19,0,0,64
2,5,2,12,9,19,20,5,18,92
2,5,2,12,15,15,4,0,0,55
2,5,2,12,15,15,4,5,4,64
2,5,2,12,15,15,4,19,0,74
2,5,2,12,15,15,13,0,0,64
2,5,2,12,15,20,0,0,0,56
2,5,2,12,15,20,3,8,0,67
2,5,2,12,21,2,2,5,18,69
2,5,2,15,7,0,0,0,0,31
2,5,2,15,16,0,0,0,0,40
2,5,2,15,16,16,5,18,0,79
2,5,2,15,16,16,5,18,19,98
2,5,2,15,16,19,0,0,0,59
2,5,2,15,19,19,0,0,0,62
2,5,2,15,20,3,8,0,0,55
2,5,2,18,1,22,5,0,0,55
2,5,2,18,5,5,3,8,0,48
2,5,2,18,9,14,5,0,0,55
2,5,2,18,15,20,8,5,18,93
2,5,2,18,21,19,8,0,0,75
2,5,2,21,13,16,0,0,0,59
2,5,2,21,19,25,0,0,0,74
2,5,3,0,0,0,0,0,0,10
2,5,3,1,6,9,3,15,0,44
2,5,3,1,12,12,0,0,0,35
2,5,3,1,12,13,0,0,0,36
2,5,3,1,12,13,5,4,0,45
2,5,3,1,12,13,9,14,7,66
2,5,3,1,12,13,19,0,0,55
2,5,3,1,13,5,0,0,0,29
2,5,3,1,16,0,0,0,0,27
2,5,3,1,16,16,5,4,0,52
2,5,3,1,16,16,9,14,7,73
2,5,3,1,16,19,0,0,0,46
2,5,3,1,18,4,0,0,0,33
2,5,3,1,18,16,5,20,0,70
2,5,3,1,18,16,5,20,19,89
2,5,3,1,18,22,5,0,0,56
2,5,3,1,19,19,5,0,0,54
2,5,3,1,19,19,9,14,5,77
2,5,3,1,20,5,18,0,0,54
2,5,3,1,21,19,5,0,0,56
2,5,3,3,1,3,3,9,1,30
2,5,3,3,1,6,9,3,15,47
2,5,3,3,8,9,0,0,0,30
2,5,3,3,15,0,0,0,0,28
2,5,3,5,14,19,5,0,0,53
2,5,3,8,1,9,14,5,4,51
2,5,3,8,1,12,11,0,0,42
2,5,3,8,1,12,11,5,4,51
2,5,3,8,1,12,11,19,0,61
2,5,3,8,1,13,5,12,0,49
2,5,3,8,1,13,5,12,19,68
2,5,3,8,1,14,3,5,0,41
2,5,3,8,1,14,3,5,4,45
2,5,3,8,1,14,3,5,19,60
2,5,3,8,1,18,13,0,0,50
2,5,3,8,1,18,13,5,4,59
2,5,3,8,1,18,13,19,0,69
2,5,3,8,1,19,5,0,0,43
2,5,3,8,1,20,20,5,18,82
2,5,3,8,5,0,0,0,0,23
2,5,3,8,5,3,11,0,0,37
2,5,3,8,5,18,0,0,0,41
2,5,3,8,5,18,14,0,0,55
2,5,3,8,9,3,0,0,0,30
2,5,3,8,9,18,16,0,0,61
2,5,3,9,18,3,12,5,4,61
2,5,3,9,22,5,20,0,0,66
2,5,3,11,5,4,0,0,0,30
2,5,3,11,5,12,9,20,5,72
2,5,3,11,5,20,19,0,0,65
2,5,3,11,9,14,7,0,0,51
2,5,3,11,9,18,15,14,0,77
2,5,3,11,15,14,0,0,0,50
2,5,3,11,15,14,5,4,0,59
2,5,3,11,15,14,5,18,0,73
2,5,3,11,15,14,5,18,19,92
2,5,3,11,15,14,9,14,7,80
2,5,3,11,15,14,19,0,0,69
2,5,3,11,19,0,0,0,0,40
2,5,3,12,1,4,0,0,0,27
2,5,3,12,1,13,15,18,0,69
2,5,3,12,1,13,15,18,19,88
2,5,3,12,1,13,15,21,18,90
2,5,3,12,1,14,7,0,0,44
2,5,3,12,1,16,0,0,0,39
2,5,3,12,1,18,20,0,0,61
2,5,3,12,1,19,16,0,0,58
2,5,3,12,1,19,16,5,4,67
2,5,3,12,1,19,16,19,0,77
2,5,3,12,1,20,20,5,18,86
2,5,3,12,1,23,0,0,0,46
2,5,3,12,9,16,0,0,0,47
2,5,3,12,15,1,11,0,0,49
2,5,3,12,15,1,11,5,4,58
2,5,3,12,15,1,11,19,0,68
2,5,3,12,15,7,0,0,0,44
2,5,3,12,15,7,7,5,4,60
2,5,3,12,15,7,19,0,0,63
2,5,3,12,15,19,5,0,0,61
2,5,3,12,15,20,8,5,0,70
2,5,3,12,15,20,8,5,4,74
2,5,3,12,15,20,8,5,19,89
2,5,3,12,15,21,4,0,0,62
2,5,3,12,15,21,4,5,4,71
2,5,3,12,15,21,4,19,0,81
2,5,3,12,15,21,20,0,0,78
2,5,3,12,15,23,14,0,0,74
2,5,3,12,15,23,14,5,4,83
2,5,3,12,15,23,14,19,0,93
2,5,3,12,21,19,20,5,18,105
2,5,3,15,2,23,5,2,0,57
2,5,3,15,9,6,6,5,4,55
2,5,3,15,12,12,9,5,18,81
2,5,3,15,12,13,5,0,0,55
2,5,3,15,12,15,18,0,0,70
2,5,3,15,13,2,5,4,0,49
2,5,3,15,13,5,0,0,0,43
2,5,3,15,13,5,4,0,0,47
2,5,3,15,13,5,19,0,0,62
2,5,3,15,13,5,20,8,0,71
2,5,3,15,13,9,14,7,0,68
2,5,3,15,13,9,14,7,19,87
2,5,3,15,13,13,1,0,0,52
2,5,3,15,13,16,1,19,19,93
2,5,3,15,15,13,0,0,0,53
2,5,3,15,18,5,19,8,0,75
2,5,3,15,19,20,0,0,0,64
2,5,3,15,22,5,20,0,0,72
2,5,3,15,23,1,18,4,0,71
2,5,3,15,23,1,18,4,19,90
2,5,3,18,1,13,0,0,0,42
2,5,3,18,1,13,16,0,0,58
2,5,3,18,1,13,16,15,14,87
2,5,3,18,1,23,12,0,0,64
2,5,3,18,1,23,12,5,4,73
2,5,3,18,1,23,12,19,0,83
2,5,3,18,5,5,16,0,0,54
2,5,3,18,25,0,0,0,0,53
2,5,3,18,9,13,5,0,0,55
2,5,3,18,9,13,5,4,0,59
2,5,3,18,9,13,5,19,0,74
2,5,3,18,9,13,9,14,7,80
2,5,3,18,9,13,19,15,14,98
2,5,3,18,9,16,16,12,5,86
2,5,3,18,15,1,11,0,0,55
2,5,3,18,15,19,19,0,0,81
2,5,3,18,15,23,4,0,0,70
2,5,3,18,15,23,4,5,4,79
2,5,3,18,15,23,4,19,0,89
2,5,3,18,15,23,14,0,0,80
2,5,3,18,21,19,8,0,0,76
2,5,3,18,21,19,20,0,0,88
2,5,3,18,21,19,20,5,4,97
2,5,3,18,21,19,20,19,0,107
2,5,3,21,4,7,5,12,0,59
2,5,3,21,4,7,5,12,19,78
2,5,3,21,6,6,5,4,0,52
2,5,3,21,9,2,1,0,0,43
2,5,3,21,13,2,5,18,0,69
2,5,3,21,14,1,0,0,0,46
2,5,3,21,18,12,0,0,0,61
2,5,3,21,18,18,25,0,0,92
2,5,3,21,18,19,5,0,0,73
2,5,3,21,18,19,5,4,0,77
2,5,3,21,18,19,5,19,0,92
2,5,3,21,18,19,9,14,7,98
2,5,3,21,18,19,20,0,0,88
2,5,3,21,20,0,0,0,0,51
2,5,4,1,2,2,12,5,0,33
2,5,4,1,2,2,12,5,4,37
2,5,4,1,2,2,12,5,19,52
2,5,4,1,6,6,0,0,0,24
2,5,4,1,7,7,12,5,0,43
2,5,4,1,25,0,0,0,0,37
2,5,4,1,13,14,0,0,0,39
2,5,4,1,13,14,5,4,0,48
2,5,4,1,13,14,9,14,7,69
2,5,4,1,13,14,19,0,0,58
2,5,4,1,13,16,0,0,0,41
2,5,4,1,14,7,12,5,4,54
2,5,4,1,18,5,0,0,0,35
2,5,4,1,18,11,0,0,0,41
2,5,4,1,18,11,5,14,0,60
2,5,4,1,18,11,5,14,19,79
2,5,4,1,19,8,0,0,0,39
2,5,4,1,21,2,0,0,0,35
2,5,4,1,21,2,5,4,0,44
2,5,4,1,21,2,9,14,7,65
2,5,4,1,21,2,19,0,0,54
2,5,4,1,23,5,5,0,0,45
2,5,4,1,23,14,0,0,0,49
2,5,4,1,26,5,0,0,0,43
2,5,4,1,26,5,4,0,0,47
2,5,4,1,26,26,12,5,0,81
2,5,4,1,26,26,12,5,4,85
2,5,4,1,26,26,12,5,19,100
2,5,4,2,15,1,18,4,0,51
2,5,4,2,21,7,0,0,0,41
2,5,4,2,21,7,19,0,0,60
2,5,4,3,1,16,0,0,0,31
2,5,4,3,1,19,5,0,0,39
2,5,4,3,8,1,9,18,0,50
2,5,4,3,8,1,9,18,19,69
2,5,4,3,15,18,4,0,0,51
2,5,4,3,15,22,5,18,0,74
2,5,4,3,15,22,5,18,19,93
2,5,4,4,1,2,12,5,0,35
2,5,4,4,5,4,0,0,0,24
2,5,4,4,5,18,0,0,0,38
2,5,4,4,5,18,19,0,0,57
2,5,4,4,9,14,7,0,0,45
2,5,4,4,9,14,7,19,0,64
2,5,4,5,1,4,0,0,0,21
2,5,4,5,1,6,0,0,0,23
2,5,4,5,1,6,5,14,0,42
2,5,4,5,1,6,5,14,19,61
2,5,4,5,2,20,0,0,0,38
2,5,4,5,3,11,0,0,0,30
2,5,4,5,3,11,5,4,0,39
2,5,4,5,3,11,9,14,7,60
2,5,4,5,3,11,19,0,0,49
2,5,4,5,5,14,0,0,0,35
2,5,4,5,7,1,18,0,0,42
2,5,4,5,7,21,1,18,0,63
2,5,4,5,8,15,21,19,5,84
2,5,4,5,12,0,0,0,0,28
2,5,4,5,12,12,19,0,0,59
2,5,4,5,12,19,0,0,0,47
2,5,4,5,12,22,5,0,0,55
2,5,4,5,13,1,14,0,0,44
2,5,4,5,13,5,14,0,0,48
2,5,4,5,14,0,0,0,0,30
2,5,4,5,14,5,0,0,0,35
2,5,4,5,19,13,1,14,0,63
2,5,4,5,19,13,5,14,0,67
2,5,4,5,22,9,12,0,0,59
2,5,4,5,22,9,12,5,4,68
2,5,4,5,22,9,12,19,0,78
2,5,4,5,23,0,0,0,0,39
2,5,4,5,23,5,4,0,0,48
2,5,4,5,23,5,18,0,0,62
2,5,4,5,23,9,14,7,0,69
2,5,4,5,23,15,13,1,14,82
2,5,4,5,23,19,0,0,0,58
2,5,4,6,1,19,20,0,0,57
2,5,4,6,5,12,12,15,23,84
2,5,4,6,12,15,23,5,18,90
2,5,4,6,15,15,20,0,0,67
2,5,4,6,18,1,13,5,0,54
2,5,4,6,18,1,13,5,19,73
2,5,4,7,5,18,25,0,0,66
2,5,4,7,15,5,18,0,0,56
2,5,4,7,15,23,14,0,0,70
2,5,4,7,15,23,14,19,0,89
2,5,4,9,1,16,5,18,0,60
2,5,4,9,1,16,5,18,19,79
2,5,4,25,5,0,0,0,0,41
2,5,4,9,7,8,20,0,0,55
2,5,4,9,7,8,20,5,4,64
2,5,4,9,7,8,20,19,0,74
2,5,4,9,11,1,8,0,0,40
2,5,4,9,13,0,0,0,0,33
2,5,4,9,13,13,5,4,0,55
2,5,4,9,13,13,9,14,7,76
2,5,4,9,13,16,12,5,0,66
2,5,4,9,13,16,12,5,4,70
2,5,4,9,13,16,12,5,19,85
2,5,4,9,13,19,0,0,0,52
2,5,4,9,14,0,0,0,0,34
2,5,4,9,16,0,0,0,0,36
2,5,4,9,18,20,0,0,0,58
2,5,4,9,18,20,5,18,0,81
2,5,4,9,18,20,25,0,0,83
2,5,4,9,18,20,9,5,4,76
2,5,4,9,18,20,9,5,19,91
2,5,4,9,19,13,1,12,0,65
2,5,4,9,26,5,14,0,0,65
2,5,4,9,26,5,14,5,4,74
2,5,4,9,26,5,14,19,0,84
2,5,4,11,5,25,0,0,0,52
2,5,4,12,1,13,0,0,0,37
2,5,4,12,1,13,5,18,0,60
2,5,4,12,1,13,9,19,5,70
2,5,4,12,1,13,9,19,13,78
2,5,4,12,1,13,9,20,5,71
2,5,4,12,1,13,9,26,5,77
2,5,4,12,1,13,16,0,0,53
2,5,4,12,1,13,16,19,0,72
2,5,4,12,1,13,19,0,0,56
2,5,4,12,1,18,0,0,0,42
2,5,4,12,5,19,19,0,0,66
2,5,4,12,9,4,19,0,0,55
2,5,4,12,9,7,8,20,0,67
2,5,4,12,9,11,5,0,0,48
2,5,4,13,1,11,5,18,0,59
2,5,4,13,1,11,5,18,19,78
2,5,4,13,1,11,9,14,7,66
2,5,4,13,1,14,0,0,0,39
2,5,4,13,1,20,5,0,0,50
2,5,4,13,1,20,5,19,0,69
2,5,4,14,9,7,8,20,19,88
2,5,4,15,3,20,15,18,0,82
2,5,4,15,7,0,0,0,0,33
2,5,4,15,25,15,0,0,0,66
2,5,4,15,12,20,0,0,0,58
2,5,4,15,20,0,0,0,0,46
2,5,4,15,20,5,0,0,0,51
2,5,4,15,20,20,5,4,0,75
2,5,4,15,21,19,5,0,0,71
2,5,4,15,23,14,0,0,0,63
2,5,4,16,1,4,0,0,0,32
2,5,4,16,1,14,0,0,0,42
2,5,4,16,1,14,19,0,0,61
2,5,4,16,12,1,20,5,0,65
2,5,4,16,12,1,20,5,19,84
2,5,4,16,15,19,20,0,0,81
2,5,4,16,15,19,20,19,0,100
2,5,4,17,21,9,12,20,0,90
2,5,4,17,21,9,12,20,19,109
2,5,4,18,1,2,2,12,5,51
2,5,4,18,1,7,7,12,5,61
2,5,4,18,1,9,12,0,0,51
2,5,4,18,1,9,12,19,0,70
2,5,4,18,1,12,0,0,0,42
2,5,4,18,1,16,5,0,0,51
2,5,4,18,1,16,5,4,0,55
2,5,4,18,1,16,5,19,0,70
2,5,4,18,1,16,9,14,7,76
2,5,4,18,1,22,5,12,0,69
2,5,4,18,5,1,4,0,0,39
2,5,4,18,5,12,0,0,0,46
2,5,4,18,5,14,3,8,0,59
2,5,4,18,5,19,19,0,0,72
2,5,4,18,9,2,2,12,5,59
2,5,4,18,9,4,0,0,0,42
2,5,4,18,9,4,4,5,14,65
2,5,4,18,9,6,20,0,0,64
2,5,4,18,9,7,8,20,0,73
2,5,4,18,9,16,0,0,0,54
2,5,4,18,9,20,5,0,0,63
2,5,4,18,9,22,5,12,0,77
2,5,4,18,9,22,5,12,19,96
2,5,4,18,9,26,26,12,5,107
2,5,4,18,15,3,11,0,0,58
2,5,4,18,15,3,11,19,0,77
2,5,4,18,15,12,12,0,0,68
2,5,4,18,15,12,12,19,0,87
2,5,4,18,15,15,13,0,0,72
2,5,4,18,15,15,13,19,0,91
2,5,4,18,15,16,0,0,0,60
2,5,4,18,15,23,14,0,0,81
2,5,4,18,15,23,19,5,0,91
2,5,4,18,21,7,0,0,0,57
2,5,4,18,21,7,7,5,4,73
2,5,4,18,21,7,19,0,0,76
2,5,4,19,3,18,5,23,0,79
2,5,4,19,8,5,5,20,0,68
2,5,4,19,8,5,5,20,19,87
2,5,4,19,9,3,11,0,0,53
2,5,4,19,9,4,5,0,0,48
2,5,4,19,9,4,5,19,0,67
2,5,4,19,9,20,0,0,0,59
2,5,4,19,9,20,5,0,0,64
2,5,4,19,9,20,20,5,18,102
2,5,4,19,15,3,11,0,0,59
2,5,4,19,15,14,9,1,0,69
2,5,4,19,15,14,9,1,19,88
2,5,4,19,15,18,5,0,0,68
2,5,4,19,15,18,5,19,0,87
2,5,4,19,16,18,5,1,4,74
2,5,4,19,16,18,9,14,7,94
2,5,4,19,20,1,6,6,0,63
2,5,4,19,20,1,14,4,0,69
2,5,4,19,20,1,14,4,19,88
2,5,4,19,20,1,22,5,19,97
2,5,4,19,20,5,1,4,0,60
2,5,4,19,20,5,1,4,19,79
2,5,4,19,20,15,3,11,0,79
2,5,4,19,20,18,1,23,0,92
2,5,4,19,20,18,1,23,19,111
2,5,4,19,20,18,9,14,7,98
2,5,4,20,9,3,11,0,0,54
2,5,4,20,9,3,11,19,0,73
2,5,4,20,9,13,5,0,0,58
2,5,4,20,9,13,5,19,0,77
2,5,4,21,2,0,0,0,0,34
2,5,4,21,3,8,5,19,19,86
2,5,4,21,3,11,0,0,0,46
2,5,4,21,11,5,0,0,0,48
2,5,4,21,12,12,0,0,0,56
2,5,4,21,13,2,0,0,0,47
2,5,4,21,13,2,5,4,0,56
2,5,4,21,13,2,9,14,7,77
2,5,4,21,13,2,19,0,0,66
2,5,4,21,14,3,5,0,0,54
2,5,4,21,14,3,5,4,0,58
2,5,4,21,14,3,5,19,0,73
2,5,4,21,14,3,8,0,0,57
2,5,4,21,14,3,9,14,7,79
2,5,4,21,14,7,0,0,0,53
2,5,4,21,18,0,0,0,0,50
2,5,4,21,19,11,0,0,0,62
2,5,4,21,19,20,0,0,0,71
2,5,4,23,1,25,0,0,0,60
2,5,4,23,1,25,19,0,0,79
2,5,4,23,1,18,4,0,0,57
2,5,4,23,1,18,4,19,0,76
2,5,4,23,1,18,6,0,0,59
2,5,4,23,1,18,6,5,4,68
2,5,4,23,1,18,6,19,0,78
2,5,4,23,1,18,13,5,18,89
2,5,5,1,18,14,0,0,0,45
2,5,5,2,1,12,12,0,0,39
2,5,5,2,5,5,0,0,0,24
2,5,5,2,5,5,19,0,0,43
2,5,5,2,18,5,1,4,0,42
2,5,5,2,18,5,1,4,19,61
2,5,5,3,8,0,0,0,0,23
2,5,5,3,8,5,14,0,0,42
2,5,5,3,8,5,19,0,0,47
2,5,5,3,8,25,0,0,0,48
2,5,5,3,8,9,5,18,0,55
2,5,5,3,8,9,5,19,20,76
2,5,5,3,8,14,21,20,0,78
2,5,5,3,8,14,21,20,19,97
2,5,5,3,8,23,15,15,4,80
2,5,5,4,7,5,4,0,0,32
2,5,5,4,9,0,0,0,0,25
2,5,5,4,15,13,0,0,0,44
2,5,5,6,0,0,0,0,0,18
2,5,5,6,1,12,15,0,0,46
2,5,5,6,1,12,15,5,19,70
2,5,5,6,1,12,15,19,0,65
2,5,5,6,3,1,11,5,0,38
2,5,5,6,3,1,11,5,19,57
2,5,5,6,5,1,20,5,18,67
2,5,5,6,5,4,0,0,0,27
2,5,5,6,5,18,0,0,0,41
2,5,5,6,5,18,19,0,0,60
2,5,5,6,8,5,1,4,0,36
2,5,5,6,25,0,0,0,0,43
2,5,5,6,9,5,18,0,0,50
2,5,5,6,9,5,19,20,0,71
2,5,5,6,9,12,25,0,0,64
2,5,5,6,9,14,0,0,0,41
2,5,5,6,9,14,5,19,19,84
2,5,5,6,9,14,7,0,0,48
2,5,5,6,9,19,8,0,0,54
2,5,5,6,12,5,19,19,0,73
2,5,5,6,12,15,23,5,18,91
2,5,5,6,19,0,0,0,0,37
2,5,5,6,19,20,5,1,11,74
2,5,5,6,23,15,15,4,0,75
2,5,5,6,23,15,15,4,19,94
2,5,5,7,5,18,9,20,5,76
2,5,5,8,5,1,4,0,0,30
2,5,5,8,5,1,4,5,4,39
2,5,5,8,5,18,4,0,0,47
2,5,5,8,9,22,5,19,0,75
2,5,5,25,1,18,4,0,0,60
2,5,5,9,19,8,0,0,0,48
2,5,5,11,0,0,0,0,0,23
2,5,5,11,5,5,16,5,18,72
2,5,5,11,9,20,5,0,0,57
2,5,5,12,2,15,23,0,0,64
2,5,5,12,5,0,0,0,0,29
2,5,5,12,9,11,5,0,0,49
2,5,5,12,9,14,5,0,0,52
2,5,5,12,9,14,5,19,0,71
2,5,5,12,15,12,0,0,0,51
2,5,5,13,1,14,0,0,0,40
2,5,5,13,1,19,20,5,18,88
2,5,5,13,5,14,0,0,0,44
2,5,5,14,0,0,0,0,0,26
2,5,5,14,14,21,20,0,0,81
2,5,5,14,20,0,0,0,0,46
2,5,5,14,20,15,0,0,0,61
2,5,5,16,0,0,0,0,0,28
2,5,5,16,5,4,0,0,0,37
2,5,5,16,5,18,0,0,0,51
2,5,5,16,5,18,19,0,0,70
2,5,5,16,9,14,7,0,0,58
2,5,5,16,19,0,0,0,0,47
2,5,5,18,1,7,5,0,0,43
2,5,5,18,2,5,12,12,25,86
2,5,5,18,5,7,1,18,0,61
2,5,5,18,8,15,21,19,5,98
2,5,5,18,25,0,0,0,0,55
2,5,5,18,9,5,18,0,0,62
2,5,5,18,9,5,19,20,0,83
2,5,5,18,9,12,25,0,0,76
2,5,5,18,9,14,5,19,19,96
2,5,5,18,9,19,8,0,0,66
2,5,5,18,9,19,8,12,25,103
2,5,5,18,13,1,11,5,18,78
2,5,5,18,16,21,12,12,0,91
2,5,5,19,0,0,0,0,0,31
2,5,5,19,20,0,0,0,0,51
2,5,5,19,20,9,14,7,0,81
2,5,5,19,20,9,14,7,19,100
2,5,5,19,20,18,9,4,5,87
2,5,5,19,23,1,24,0,0,79
2,5,5,19,23,1,24,5,19,103
2,5,5,19,23,9,14,7,0,84
2,5,5,19,23,9,14,7,19,103
2,5,5,20,0,0,0,0,0,32
2,5,5,20,5,23,11,0,0,71
2,5,5,20,6,12,25,0,0,75
2,5,5,20,8,0,0,0,0,40
2,5,5,20,25,0,0,0,0,57
2,5,5,20,9,5,19,20,0,85
2,5,5,20,12,5,0,0,0,49
2,5,5,20,12,5,4,0,0,53
2,5,5,20,12,5,18,0,0,67
2,5,5,20,12,5,18,19,0,86
2,5,5,20,12,5,19,0,0,68
2,5,5,20,12,9,11,5,0,69
2,5,5,20,12,9,14,7,0,74
2,5,5,20,18,1,22,5,0,78
2,5,5,20,18,15,15,20,0,100
2,5,5,20,18,15,15,20,25,125
2,5,5,20,18,15,15,20,19,119
2,5,5,20,19,0,0,0,0,51
2,5,5,22,5,0,0,0,0,39
2,5,5,22,5,19,0,0,0,58
2,5,5,22,9,19,8,0,0,70
2,5,5,23,1,25,0,0,0,61
2,5,5,23,1,18,5,0,0,59
2,5,5,23,5,5,4,0,0,49
2,5,5,23,9,14,7,5,4,74
2,5,5,23,9,19,5,0,0,68
2,5,5,23,15,18,20,0,0,88
2,5,5,26,5,18,0,0,0,61
2,5,5,26,5,18,19,0,0,80
2,5,6,1,12,12,0,0,0,38
2,5,6,1,12,12,5,14,0,57
2,5,6,1,12,12,9,14,7,68
2,5,6,1,12,12,19,0,0,57
2,5,6,1,13,5,0,0,0,32
2,5,6,1,13,9,14,5,0,55
2,5,6,1,14,0,0,0,0,28
2,5,6,1,14,3,25,0,0,56
2,5,6,1,14,14,5,4,0,51
2,5,6,1,22,15,18,0,0,69
2,5,6,1,22,15,21,18,0,90
2,5,6,5,1,20,8,5,18,70
2,5,6,5,12,12,0,0,0,42
2,5,6,5,18,14,5,4,0,59
2,5,6,5,20,20,5,18,0,81
2,5,6,5,26,26,5,4,0,79
2,5,6,6,18,15,25,0,0,77
2,5,6,9,4,4,12,5,0,47
2,5,6,9,12,3,8,0,0,45
2,5,6,9,12,5,0,0,0,39
2,5,6,9,12,13,5,4,0,56
2,5,6,9,12,20,8,0,0,62
2,5,6,9,14,7,5,18,0,66
2,5,6,9,14,7,5,18,19,85
2,5,6,9,18,5,0,0,0,45
2,5,6,9,19,20,0,0,0,61
2,5,6,9,20,0,0,0,0,42
2,5,6,9,20,19,0,0,0,61
2,5,6,9,20,20,5,4,0,71
2,5,6,9,20,20,9,14,7,92
2,5,6,12,1,7,0,0,0,33
2,5,6,12,1,7,7,5,4,49
2,5,6,12,1,7,19,0,0,52
2,5,6,12,1,14,14,5,12,71
2,5,6,12,1,16,0,0,0,42
2,5,6,12,1,20,20,5,18,89
2,5,6,12,5,1,0,0,0,31
2,5,6,12,5,1,5,4,0,40
2,5,6,12,5,1,9,14,7,61
2,5,6,12,5,1,19,0,0,50
2,5,6,12,5,3,11,0,0,44
2,5,6,12,5,3,11,5,4,53
2,5,6,12,5,3,11,19,0,63
2,5,6,12,15,21,14,3,5,83
2,5,6,12,15,21,18,0,0,79
2,5,6,12,15,21,20,0,0,81
2,5,6,12,15,23,5,18,0,86
2,5,6,12,15,23,5,18,19,105
2,5,6,12,21,13,0,0,0,59
2,5,6,12,21,19,20,5,18,108
2,5,6,15,1,13,0,0,0,42
2,5,6,15,7,0,0,0,0,35
2,5,6,15,7,7,5,4,0,51
2,5,6,15,7,7,9,14,7,72
2,5,6,15,7,19,0,0,0,54
2,5,6,15,15,12,0,0,0,55
2,5,6,15,15,12,5,4,0,64
2,5,6,15,15,12,9,14,7,85
2,5,6,15,15,12,19,0,0,74
2,5,6,15,16,0,0,0,0,44
2,5,6,15,18,5,0,0,0,51
2,5,6,15,18,20,21,14,5,106
2,5,6,15,21,12,0,0,0,61
2,5,6,15,21,12,5,4,0,70
2,5,6,15,21,12,5,18,0,84
2,5,6,15,21,12,5,18,19,103
2,5,6,15,21,12,9,5,18,93
2,5,6,15,21,12,9,14,7,91
2,5,6,15,21,12,19,0,0,80
2,5,6,18,1,21,7,8,20,88
2,5,6,18,5,3,11,12,5,67
2,5,6,18,5,5,26,5,0,72
2,5,6,18,5,9,7,8,20,80
2,5,6,18,5,20,0,0,0,56
2,5,6,18,5,20,19,0,0,75
2,5,6,18,5,20,20,5,4,85
2,5,6,18,9,5,14,4,0,63
2,5,6,18,9,5,14,4,19,82
2,5,6,18,9,12,12,0,0,64
2,5,6,18,9,12,12,5,4,73
2,5,6,18,9,14,7,5,0,66
2,5,6,18,9,14,7,5,4,70
2,5,6,18,9,14,7,5,19,85
2,5,6,18,9,26,0,0,0,66
2,5,6,18,15,3,11,5,4,69
2,5,6,18,15,7,7,5,4,69
2,5,6,18,15,21,14,3,5,89
2,5,6,18,21,13,16,12,5,98
2,5,6,21,4,4,12,5,0,59
2,5,6,21,4,4,12,5,4,63
2,5,6,21,4,4,12,5,18,77
2,5,6,21,4,4,12,5,19,78
2,5,6,21,13,5,0,0,0,52
2,5,6,21,18,0,0,0,0,52
2,5,6,21,18,18,5,4,0,79
2,5,7,0,0,0,0,0,0,14
2,5,7,1,2,12,5,4,0,38
2,5,7,1,4,0,0,0,0,19
2,5,7,1,25,0,0,0,0,40
2,5,7,1,12,12,0,0,0,39
2,5,7,1,12,12,5,4,0,48
2,5,7,1,12,12,9,14,7,69
2,5,7,1,12,12,19,0,0,58
2,5,7,1,14,0,0,0,0,29
2,5,7,1,14,9,0,0,0,38
2,5,7,1,18,0,0,0,0,33
2,5,7,1,18,9,0,0,0,42
2,5,7,1,18,25,0,0,0,58
2,5,7,1,18,9,5,0,0,47
2,5,7,1,18,14,9,19,8,83
2,5,7,1,19,8,0,0,0,42
2,5,7,1,19,19,0,0,0,53
2,5,7,1,20,0,0,0,0,35
2,5,7,1,20,19,0,0,0,54
2,5,7,1,20,20,1,12,0,68
2,5,7,1,21,4,0,0,0,40
2,5,7,1,21,4,25,0,0,65
2,5,7,1,26,5,0,0,0,46
2,5,7,1,26,5,4,0,0,50
2,5,7,1,26,5,19,0,0,65
2,5,7,1,26,9,14,7,0,71
2,5,7,5,3,11,0,0,0,33
2,5,7,5,13,0,0,0,0,32
2,5,7,5,13,13,5,4,0,54
2,5,7,5,13,13,9,14,7,75
2,5,7,5,20,0,0,0,0,39
2,5,7,5,20,19,0,0,0,58
2,5,7,5,20,20,1,12,0,72
2,5,7,5,20,20,5,18,0,82
2,5,7,5,20,20,5,18,19,101
2,5,7,5,20,20,9,14,7,89
2,5,7,7,1,2,12,5,0,41
2,5,7,7,1,18,0,0,0,40
2,5,7,7,1,18,4,15,13,72
2,5,7,7,1,18,5,4,0,49
2,5,7,7,1,18,5,18,0,63
2,5,7,7,1,18,5,19,19,83
2,5,7,7,1,18,25,0,0,65
2,5,7,7,1,18,9,5,19,73
2,5,7,7,1,18,9,14,7,70
2,5,7,7,1,18,9,19,13,81
2,5,7,7,1,18,12,25,0,77
2,5,7,7,1,18,13,1,14,68
2,5,7,7,1,18,19,0,0,59
2,5,7,7,5,4,0,0,0,30
2,5,7,7,5,18,0,0,0,44
2,5,7,7,9,14,7,0,0,51
2,5,7,7,9,14,7,12,25,88
2,5,7,9,6,20,0,0,0,49
2,5,7,9,7,7,12,5,0,54
2,5,7,9,12,4,0,0,0,39
2,5,7,9,14,7,5,18,0,67
2,5,7,9,14,14,5,18,0,74
2,5,7,9,14,14,5,18,19,93
2,5,7,9,14,14,9,14,7,81
2,5,7,9,14,19,0,0,0,56
2,5,7,9,18,4,0,0,0,45
2,5,7,9,18,4,5,4,0,54
2,5,7,9,18,4,9,14,7,75
2,5,7,9,18,4,12,5,0,62
2,5,7,9,18,4,12,5,4,66
2,5,7,9,18,4,12,5,19,81
2,5,7,9,18,4,19,0,0,64
2,5,7,9,18,20,0,0,0,61
2,5,7,12,1,4,0,0,0,31
2,5,7,12,1,4,4,5,4,44
2,5,7,12,1,4,19,0,0,50
2,5,7,12,1,13,15,21,18,94
2,5,7,12,1,18,5,0,0,50
2,5,7,12,5,18,2,5,7,63
2,5,7,12,5,18,2,5,25,81
2,5,7,12,5,23,0,0,0,54
2,5,7,12,9,3,0,0,0,38
2,5,7,12,9,4,5,0,0,44
2,5,7,12,9,20,20,5,18,98
2,5,7,12,15,2,5,4,0,52
2,5,7,12,15,15,13,0,0,69
2,5,7,12,15,15,13,5,4,78
2,5,7,12,15,15,13,19,0,88
2,5,7,12,15,26,5,0,0,72
2,5,7,12,21,3,0,0,0,50
2,5,7,12,21,5,0,0,0,52
2,5,7,14,1,23,0,0,0,52
2,5,7,14,1,23,5,4,0,61
2,5,7,14,1,23,14,0,0,66
2,5,7,15,0,0,0,0,0,29
2,5,7,15,2,0,0,0,0,31
2,5,7,15,2,19,0,0,0,50
2,5,7,15,4,0,0,0,0,33
2,5,7,15,7,7,12,5,4,64
2,5,7,15,8,13,0,0,0,50
2,5,7,15,14,5,0,0,0,48
2,5,7,15,14,9,1,0,0,53
2,5,7,15,14,9,1,19,0,72
2,5,7,15,18,1,8,0,0,56
2,5,7,15,18,18,1,0,0,66
2,5,7,15,18,18,1,8,0,74
2,5,7,15,18,18,25,0,0,90
2,5,7,15,20,0,0,0,0,49
2,5,7,15,20,20,5,14,0,88
2,5,7,15,21,4,0,0,0,54
2,5,7,15,23,11,0,0,0,63
2,5,7,15,23,14,5,4,0,75
2,5,7,18,1,3,5,0,0,41
2,5,7,18,1,25,0,0,0,58
2,5,7,18,1,9,14,0,0,56
2,5,7,18,1,22,5,0,0,60
2,5,7,18,5,1,19,5,0,62
2,5,7,18,5,5,14,0,0,56
2,5,7,18,5,20,20,0,0,77
2,5,7,18,9,13,0,0,0,54
2,5,7,18,9,13,5,0,0,59
2,5,7,18,9,13,5,4,0,63
2,5,7,18,9,13,5,18,0,77
2,5,7,18,9,13,5,19,0,78
2,5,7,18,9,13,9,14,7,84
2,5,7,18,9,13,13,5,4,76
2,5,7,18,9,13,19,0,0,73
2,5,7,18,9,16,5,0,0,62
2,5,7,18,15,1,14,0,0,62
2,5,7,18,15,1,14,5,4,71
2,5,7,18,15,1,14,19,0,81
2,5,7,18,15,23,14,0,0,84
2,5,7,18,21,4,7,5,0,69
2,5,7,18,21,4,7,5,4,73
2,5,7,18,21,4,7,5,18,87
2,5,7,18,21,4,7,5,19,88
2,5,7,18,21,14,20,12,5,104
2,5,7,18,21,20,3,8,0,84
2,5,7,18,21,20,20,5,14,112
2,5,7,19,0,0,0,0,0,33
2,5,7,19,20,5,18,0,0,76
2,5,7,21,1,18,4,0,0,58
2,5,7,21,5,19,19,0,0,78
2,5,7,21,9,12,5,0,0,61
2,5,7,21,9,12,5,4,0,65
2,5,7,21,9,12,5,18,0,79
2,5,7,21,9,12,5,18,19,98
2,5,7,21,9,12,5,19,0,80
2,5,7,21,9,12,9,14,7,86
2,5,7,21,9,14,5,19,0,82
2,5,7,21,12,6,0,0,0,53
2,5,7,21,12,6,5,4,0,62
2,5,7,21,12,6,9,14,7,83
2,5,7,21,12,6,19,0,0,72
2,5,7,21,13,0,0,0,0,48
2,5,7,21,13,13,5,4,0,70
2,5,7,21,13,13,9,14,7,91
2,5,7,21,13,19,0,0,0,67
2,5,7,21,14,0,0,0,0,49
2,5,7,21,14,11,0,0,0,60
2,5,7,21,20,0,0,0,0,55
2,5,8,1,12,5,0,0,0,33
2,5,8,1,12,6,0,0,0,34
2,5,8,1,12,12,15,23,0,78
2,5,8,1,12,22,5,19,0,74
2,5,8,1,13,13,5,18,0,65
2,5,8,1,14,7,0,0,0,37
2,5,8,1,16,0,0,0,0,32
2,5,8,1,20,20,5,4,0,65
2,5,8,1,22,0,0,0,0,38
2,5,8,1,22,5,0,0,0,43
2,5,8,1,22,5,4,0,0,47
2,5,8,1,22,5,18,0,0,61
2,5,8,1,22,5,18,19,0,80
2,5,8,1,22,5,19,0,0,62
2,5,8,1,22,9,14,7,0,68
2,5,8,1,22,9,15,18,0,80
2,5,8,1,22,9,15,18,19,99
2,5,8,1,22,9,15,21,18,101
2,5,8,5,1,4,0,0,0,25
2,5,8,5,1,4,1,12,0,38
2,5,8,5,1,4,5,4,0,34
2,5,8,5,1,4,5,18,0,48
2,5,8,5,1,4,9,14,7,55
2,5,8,5,1,4,19,0,0,44
2,5,8,5,1,18,0,0,0,39
2,5,8,5,1,18,19,0,0,58
2,5,8,5,1,18,19,5,0,63
2,5,8,5,4,7,5,0,0,36
2,5,8,5,9,18,1,0,0,48
2,5,8,5,12,4,0,0,0,36
2,5,8,5,12,16,0,0,0,48
2,5,8,5,13,15,20,8,0,76
2,5,8,5,13,15,20,8,19,95
2,5,8,5,14,0,0,0,0,34
2,5,8,5,14,1,20,5,0,60
2,5,8,5,14,9,3,0,0,46
2,5,8,5,19,20,0,0,0,59
2,5,8,5,19,20,19,0,0,78
2,5,8,5,23,0,0,0,0,43
2,5,8,9,7,8,20,0,0,59
2,5,8,25,13,14,0,0,0,67
2,5,8,9,14,4,0,0,0,42
2,5,8,9,14,4,5,18,0,65
2,5,8,9,14,4,19,0,0,61
2,5,8,9,14,20,0,0,0,58
2,5,8,9,20,8,5,18,0,75
2,5,8,15,12,4,0,0,0,46
2,5,8,15,12,4,5,14,0,65
2,5,8,15,12,4,5,18,0,69
2,5,8,15,12,4,5,18,19,88
2,5,8,15,12,4,9,14,7,76
2,5,8,15,12,4,19,0,0,65
2,5,8,15,14,5,25,0,0,74
2,5,8,15,15,6,0,0,0,51
2,5,8,15,15,16,5,4,0,70
2,5,8,15,15,20,0,0,0,65
2,5,8,15,15,22,5,0,0,72
2,5,8,15,15,22,5,4,0,76
2,5,8,15,15,22,5,19,0,91
2,5,8,15,15,22,9,14,7,97
2,5,8,15,18,14,0,0,0,62
2,5,8,15,18,18,15,18,0,99
2,5,8,15,22,5,0,0,0,57
2,5,8,15,22,5,4,0,0,61
2,5,8,15,22,5,12,25,0,94
2,5,8,15,22,5,19,0,0,76
2,5,8,15,22,9,14,7,0,82
2,5,8,15,23,12,0,0,0,65
2,5,8,15,23,12,5,4,0,74
2,5,8,15,23,12,9,14,7,95
2,5,8,15,23,12,19,0,0,84
2,5,8,21,14,7,0,0,0,57
2,5,8,21,19,2,1,14,4,76
2,5,25,0,0,0,0,0,0,32
2,5,9,3,5,0,0,0,0,24
2,5,25,4,15,13,0,0,0,64
2,5,25,5,18,9,20,5,0,89
2,5,9,7,5,0,0,0,0,28
2,5,9,7,5,12,0,0,0,40
2,5,9,7,5,19,0,0,0,47
2,5,9,7,25,0,0,0,0,48
2,5,9,7,14,5,20,0,0,62
2,5,9,7,14,5,20,19,0,81
2,5,9,12,4,0,0,0,0,32
2,5,25,12,9,3,1,12,0,69
2,5,25,12,9,3,19,0,0,75
2,5,25,12,9,11,0,0,0,64
2,5,25,12,9,11,19,0,0,83
2,5,9,14,7,0,0,0,0,37
2,5,9,14,7,12,5,19,19,92
2,5,9,14,7,14,5,19,19,94
2,5,9,14,7,19,0,0,0,56
2,5,9,14,11,5,4,0,0,50
2,5,9,14,12,25,0,0,0,67
2,5,9,14,14,5,19,19,0,87
2,5,25,15,14,4,0,0,0,65
2,5,25,15,14,4,19,0,0,84
2,5,25,19,0,0,0,0,0,51
2,5,9,19,1,0,0,0,0,36
2,5,9,19,1,14,3,5,0,58
2,5,25,19,8,9,16,0,0,84
2,5,10,1,2,2,5,18,19,64
2,5,10,1,2,5,18,19,0,62
2,5,10,1,4,5,0,0,0,27
2,5,10,1,14,0,0,0,0,32
2,5,10,1,14,20,0,0,0,52
2,5,10,1,16,5,0,0,0,39
2,5,10,1,26,26,0,0,0,70
2,5,10,5,12,0,0,0,0,34
2,5,10,5,12,5,4,0,0,43
2,5,10,5,12,9,14,7,0,64
2,5,10,5,12,12,5,4,0,55
2,5,10,5,12,12,9,14,7,76
2,5,10,5,19,21,9,20,0,91
2,5,10,5,19,21,19,0,0,81
2,5,10,5,23,5,12,0,0,62
2,5,10,5,23,5,12,5,4,71
2,5,10,5,23,5,12,19,0,81
2,5,10,5,26,5,2,5,12,72
2,5,10,9,7,0,0,0,0,33
2,5,10,21,3,15,0,0,0,56
2,5,10,21,7,7,12,5,0,69
2,5,10,21,13,2,12,5,0,70
2,5,10,21,13,2,12,5,4,74
2,5,10,21,13,2,12,5,19,89
2,5,11,9,3,11,0,0,0,41
2,5,11,9,12,20,5,4,0,68
2,5,11,9,14,7,0,0,0,48
2,5,11,9,19,19,0,0,0,65
2,5,11,9,19,19,5,4,0,74
2,5,11,9,19,19,5,19,0,89
2,5,11,9,19,19,9,14,7,95
2,5,11,11,15,0,0,0,0,44
2,5,11,14,1,22,5,0,0,60
2,5,11,14,9,7,8,20,0,76
2,5,11,14,9,7,8,20,19,95
2,5,11,14,9,20,0,0,0,61
2,5,11,14,9,22,5,4,0,72
2,5,11,14,15,20,0,0,0,67
2,5,11,14,15,20,19,0,0,86
2,5,11,14,15,20,20,5,4,96
2,5,11,14,15,23,0,0,0,70
2,5,11,14,15,23,14,0,0,84
2,5,12,1,2,15,18,0,0,55
2,5,12,1,2,15,18,5,4,64
2,5,12,1,2,15,18,19,0,74
2,5,12,1,2,15,21,18,0,76
2,5,12,1,2,15,21,18,19,95
2,5,12,1,3,5,0,0,0,28
2,5,12,1,3,5,4,0,0,32
2,5,12,1,4,25,0,0,0,49
2,5,12,1,4,9,5,4,0,42
2,5,12,1,4,9,5,19,0,57
2,5,12,1,4,25,9,14,7,79
2,5,12,1,4,12,5,0,0,41
2,5,12,1,7,5,0,0,0,32
2,5,12,1,8,0,0,0,0,28
2,5,12,1,25,0,0,0,0,45
2,5,12,1,25,5,4,0,0,54
2,5,12,1,25,5,18,0,0,68
2,5,12,1,25,9,14,7,0,75
2,5,12,1,25,19,0,0,0,64
2,5,12,1,13,0,0,0,0,33
2,5,12,1,13,15,21,18,0,87
2,5,12,1,14,4,1,0,0,39
2,5,12,1,14,4,5,18,0,61
2,5,12,1,16,0,0,0,0,36
2,5,12,1,18,0,0,0,0,38
2,5,12,1,18,4,0,0,0,42
2,5,12,1,19,8,0,0,0,47
2,5,12,1,19,20,0,0,0,59
2,5,12,1,20,0,0,0,0,40
2,5,12,1,20,5,0,0,0,45
2,5,12,1,20,5,4,0,0,49
2,5,12,1,20,5,4,12,25,86
2,5,12,1,20,9,14,7,0,70
2,5,12,1,21,4,0,0,0,45
2,5,12,1,21,4,5,4,0,54
2,5,12,1,21,4,5,18,0,68
2,5,12,1,21,4,9,14,7,75
2,5,12,1,21,4,19,0,0,64
2,5,12,3,8,0,0,0,0,30
2,5,12,3,8,5,4,0,0,39
2,5,12,3,8,5,18,19,0,72
2,5,12,3,8,5,19,0,0,54
2,5,12,3,8,9,14,7,0,60
2,5,12,4,0,0,0,0,0,23
2,5,12,4,1,13,0,0,0,37
2,5,12,4,1,13,5,0,0,42
2,5,12,4,1,13,5,19,0,61
2,5,12,4,1,13,19,0,0,56
2,5,12,4,5,18,0,0,0,46
2,5,12,4,21,17,21,5,0,87
2,5,12,5,1,6,0,0,0,31
2,5,12,5,1,7,21,5,18,76
2,5,12,5,1,16,0,0,0,41
2,5,12,5,1,16,5,4,0,50
2,5,12,5,1,16,9,14,7,71
2,5,12,5,1,16,19,0,0,60
2,5,12,5,1,16,20,0,0,61
2,5,12,5,1,22,5,0,0,52
2,5,12,5,3,20,9,15,14,85
2,5,12,5,3,20,21,18,5,91
2,5,12,5,5,0,0,0,0,29
2,5,12,5,5,4,0,0,0,33
2,5,12,5,6,20,0,0,0,50
2,5,12,5,13,14,9,4,0,64
2,5,12,5,13,14,9,20,5,85
2,5,12,5,13,14,15,9,4,79
2,5,12,5,16,5,18,0,0,63
2,5,12,5,19,16,18,9,20,106
2,5,12,5,20,20,5,18,0,87
2,5,12,5,22,5,0,0,0,51
2,5,12,6,1,20,8,5,18,77
2,5,12,6,18,25,0,0,0,68
2,5,12,6,18,9,5,4,0,61
2,5,12,6,18,9,5,19,0,76
2,5,12,7,1,0,0,0,0,27
2,5,12,7,1,18,4,0,0,49
2,5,12,7,1,19,0,0,0,46
2,5,12,7,9,1,14,19,0,69
2,5,12,9,2,5,12,0,0,47
2,5,12,9,2,5,12,5,4,56
2,5,12,9,3,11,0,0,0,42
2,5,12,9,5,0,0,0,0,33
2,5,12,9,5,4,0,0,0,37
2,5,12,9,5,6,0,0,0,39
2,5,12,9,5,6,6,21,12,78
2,5,12,9,5,6,19,0,0,58
2,5,12,9,5,18,19,0,0,70
2,5,12,9,5,19,0,0,0,52
2,5,12,9,5,22,5,0,0,60
2,5,12,9,5,22,5,4,0,64
2,5,12,9,5,22,5,18,0,78
2,5,12,9,5,22,5,18,19,97
2,5,12,9,5,22,5,19,0,79
2,5,12,9,5,22,5,20,8,88
2,5,12,9,5,22,9,14,7,85
2,5,12,9,7,8,20,0,0,63
2,5,12,9,9,14,7,0,0,58
2,5,12,25,9,14,7,0,0,74
2,5,12,25,9,14,7,12,25,111
2,5,12,9,11,5,0,0,0,44
2,5,12,9,11,5,4,0,0,48
2,5,12,9,11,5,12,25,0,81
2,5,12,9,13,5,0,0,0,46
2,5,12,9,15,14,0,0,0,57
2,5,12,9,17,21,15,18,0,99
2,5,12,9,17,21,15,18,19,118
2,5,12,9,20,5,0,0,0,53
2,5,12,9,20,20,5,18,0,91
2,5,12,9,20,20,12,5,0,85
2,5,12,9,20,20,12,5,4,89
2,5,12,9,20,20,12,5,18,103
2,5,12,9,20,20,12,5,19,104
2,5,12,9,22,5,0,0,0,55
2,5,12,12,2,9,14,4,0,60
2,5,12,12,2,9,14,5,0,61
2,5,12,12,2,9,18,4,0,64
2,5,12,12,2,9,18,4,19,83
2,5,12,12,2,15,25,0,0,73
2,5,12,12,2,15,25,19,0,92
2,5,12,12,5,4,0,0,0,40
2,5,12,12,5,4,15,13,0,68
2,5,12,12,5,5,11,19,0,71
2,5,12,12,5,8,15,15,4,78
2,5,12,12,5,18,9,3,0,66
2,5,12,12,5,19,0,0,0,55
2,5,12,12,5,20,5,18,0,79
2,5,12,12,8,15,16,0,0,70
2,5,12,12,8,15,16,19,0,89
2,5,12,12,8,15,21,19,5,99
2,5,12,12,9,0,0,0,0,40
2,5,12,12,25,0,0,0,0,56
2,5,12,12,25,1,3,8,5,73
2,5,12,12,25,2,1,14,4,77
2,5,12,12,9,2,15,14,5,76
2,5,12,12,9,3,0,0,0,43
2,5,12,12,9,3,1,12,0,56
2,5,12,12,9,3,9,19,13,84
2,5,12,12,9,3,9,19,20,91
2,5,12,12,9,3,15,19,5,82
2,5,12,12,9,5,4,0,0,49
2,5,12,12,25,5,18,0,0,79
2,5,12,12,9,5,19,0,0,64
2,5,12,12,25,6,9,19,8,98
2,5,12,12,25,6,21,12,0,95
2,5,12,12,25,6,21,12,12,107
2,5,12,12,25,6,21,12,19,114
2,5,12,12,25,9,14,7,0,86
2,5,12,12,25,12,1,14,4,87
2,5,12,12,25,12,9,11,5,93
2,5,12,12,25,13,1,14,0,84
2,5,12,12,9,14,7,0,0,61
2,5,12,12,9,20,5,0,0,65
2,5,12,12,13,1,11,5,18,79
2,5,12,12,13,1,14,0,0,59
2,5,12,12,13,5,14,0,0,63
2,5,12,12,13,15,21,20,8,108
2,5,12,12,15,14,0,0,0,60
2,5,12,12,15,14,9,15,14,98
2,5,12,12,15,15,20,0,0,81
2,5,12,12,15,20,1,0,0,67
2,5,12,12,15,20,5,0,0,71
2,5,12,12,15,23,5,4,0,78
2,5,12,12,15,23,5,18,0,92
2,5,12,12,15,23,5,18,19,111
2,5,12,12,15,23,9,14,7,99
2,5,12,12,16,21,12,12,0,92
2,5,12,12,16,21,12,12,19,111
2,5,12,12,18,1,7,19,0,76
2,5,12,12,20,1,9,12,0,73
2,5,12,12,21,9,14,5,0,80
2,5,12,12,21,13,0,0,0,65
2,5,12,12,23,1,18,5,0,78
2,5,12,12,23,1,22,5,18,100
2,5,12,12,23,5,5,4,0,68
2,5,12,12,23,9,14,4,0,81
2,5,12,12,23,9,14,5,0,82
2,5,12,12,23,15,18,20,0,107
2,5,12,12,23,15,18,20,19,126
2,5,12,15,1,13,0,0,0,48
2,5,12,15,3,11,0,0,0,48
2,5,12,15,9,4,0,0,0,47
2,5,12,15,13,1,14,3,25,90
2,5,12,15,14,7,0,0,0,55
2,5,12,15,14,7,5,4,0,64
2,5,12,15,14,7,5,18,0,78
2,5,12,15,14,7,9,14,7,85
2,5,12,15,14,7,19,0,0,74
2,5,12,15,14,9,4,0,0,61
2,5,12,15,14,9,20,5,0,82
2,5,12,15,14,15,9,4,0,76
2,5,12,15,15,11,0,0,0,60
2,5,12,15,18,4,0,0,0,56
2,5,12,15,20,20,5,0,0,79
2,5,12,15,21,11,5,0,0,71
2,5,12,15,21,20,0,0,0,75
2,5,12,15,22,5,0,0,0,61
2,5,12,15,22,5,4,0,0,65
2,5,12,15,22,5,4,19,0,84
2,5,12,15,23,0,0,0,0,57
2,5,12,15,23,19,0,0,0,76
2,5,12,19,0,0,0,0,0,38
2,5,12,19,9,18,5,0,0,70
2,5,12,20,0,0,0,0,0,39
2,5,12,20,5,4,0,0,0,48
2,5,12,20,9,5,0,0,0,53
2,5,12,20,9,14,5,0,0,67
2,5,12,20,9,14,7,0,0,69
2,5,12,20,9,14,7,19,0,88
2,5,12,20,12,5,19,19,0,94
2,5,12,20,12,9,14,5,0,79
2,5,12,20,12,9,14,5,19,98
2,5,12,20,13,1,11,5,18,87
2,5,12,20,13,1,14,0,0,67
2,5,12,20,13,5,14,0,0,71
2,5,12,20,19,0,0,0,0,58
2,5,12,20,23,1,25,0,0,88
2,5,12,20,23,1,25,19,0,107
2,5,12,20,23,9,19,5,0,95
2,5,12,21,5,0,0,0,0,45
2,5,12,21,7,1,0,0,0,48
2,5,12,21,7,1,19,0,0,67
2,5,12,21,7,9,20,5,0,81
2,5,12,21,20,5,0,0,0,65
2,5,12,22,5,0,0,0,0,46
2,5,12,26,5,2,21,2,0,75
2,5,12,26,5,2,21,20,8,101
2,5,13,1,4,0,0,0,0,25
2,5,13,1,4,1,13,0,0,39
2,5,13,1,4,1,13,5,4,48
2,5,13,1,4,1,13,19,0,58
2,5,13,1,4,4,5,14,0,48
2,5,13,1,4,4,5,14,19,67
2,5,13,1,9,12,0,0,0,42
2,5,13,1,9,13,0,0,0,43
2,5,13,1,10,5,19,20,25,100
2,5,13,1,14,0,0,0,0,35
2,5,13,1,14,7,12,5,0,59
2,5,13,1,14,20,12,5,0,72
2,5,13,1,18,0,0,0,0,39
2,5,13,1,18,20,25,18,0,102
2,5,13,1,19,0,0,0,0,40
2,5,13,1,19,11,0,0,0,51
2,5,13,1,19,20,5,18,0,83
2,5,13,1,20,0,0,0,0,41
2,5,13,1,20,1,0,0,0,42
2,5,13,1,21,12,0,0,0,54
2,5,13,1,26,5,4,0,0,56
2,5,13,5,0,0,0,0,0,25
2,5,13,5,1,12,0,0,0,38
2,5,13,5,1,14,0,0,0,40
2,5,13,5,1,14,5,4,0,49
2,5,13,5,1,14,9,14,7,70
2,5,13,5,1,14,19,0,0,59
2,5,13,5,4,1,12,5,4,51
2,5,13,5,5,20,0,0,0,50
2,5,13,5,14,20,9,20,5,93
2,5,13,5,18,3,25,0,0,71
2,5,13,5,20,5,0,0,0,50
2,5,13,9,14,7,12,5,0,67
2,5,13,9,14,7,12,5,4,71
2,5,13,9,14,7,12,5,19,86
2,5,13,9,18,5,0,0,0,52
2,5,13,9,18,5,4,0,0,56
2,5,13,9,18,5,19,0,0,71
2,5,13,9,18,9,14,7,0,77
2,5,13,9,18,18,15,18,0,98
2,5,13,9,19,20,0,0,0,68
2,5,13,9,19,20,5,4,0,77
2,5,13,9,19,20,9,14,7,98
2,5,13,9,19,20,19,0,0,87
2,5,13,9,20,5,18,5,4,81
2,5,13,9,20,18,5,4,0,76
2,5,13,9,24,0,0,0,0,53
2,5,13,9,24,5,4,0,0,62
2,5,13,9,24,5,19,0,0,77
2,5,13,9,24,9,14,7,0,83
2,5,13,9,24,20,0,0,0,73
2,5,13,15,1,14,0,0,0,50
2,5,13,15,1,14,5,4,0,59
2,5,13,15,1,14,5,18,0,73
2,5,13,15,1,14,9,14,7,80
2,5,13,15,1,14,19,0,0,69
2,5,13,15,1,20,0,0,0,56
2,5,13,15,3,11,0,0,0,49
2,5,13,15,3,11,5,4,0,58
2,5,13,15,3,11,9,14,7,79
2,5,13,15,3,11,19,0,0,68
2,5,13,15,9,12,0,0,0,56
2,5,13,15,9,19,20,5,14,102
2,5,13,15,12,0,0,0,0,47
2,5,13,15,12,5,0,0,0,52
2,5,13,15,12,20,0,0,0,67
2,5,13,15,14,19,20,5,18,111
2,5,13,15,15,14,0,0,0,64
2,5,13,15,20,20,15,0,0,90
2,5,13,15,21,12,20,0,0,88
2,5,13,15,21,18,14,0,0,88
2,5,13,15,21,20,8,0,0,84
2,5,13,21,3,11,0,0,0,55
2,5,13,21,4,0,0,0,0,45
2,5,13,21,4,4,25,0,0,74
2,5,13,21,4,4,12,5,0,66
2,5,13,21,4,4,12,5,4,70
2,5,13,21,4,4,12,5,19,85
2,5,13,21,6,6,12,5,0,70
2,5,13,21,18,13,21,18,0,111
2,5,13,21,18,13,21,18,5,116
2,5,13,21,18,13,21,18,19,130
2,5,13,21,19,5,0,0,0,65
2,5,13,21,19,5,4,0,0,69
2,5,13,21,19,5,4,12,25,106
2,5,13,21,19,5,19,0,0,84
2,5,13,21,19,9,14,7,0,90
2,5,13,21,19,11,0,0,0,71
2,5,13,21,26,26,12,5,0,110
2,5,13,21,26,26,12,5,4,114
2,5,13,21,26,26,12,5,19,129
2,5,14,1,2,0,0,0,0,24
2,5,14,1,13,5,0,0,0,40
2,5,14,1,13,5,4,0,0,44
2,5,14,1,13,5,5,0,0,45
2,5,14,1,13,5,19,0,0,59
2,5,14,1,13,9,0,0,0,44
2,5,14,1,13,9,4,1,18,67
2,5,14,1,13,9,14,7,0,65
2,5,14,1,19,20,25,0,0,86
2,5,14,2,5,14,0,0,0,42
2,5,14,3,8,0,0,0,0,32
2,5,14,3,8,5,4,0,0,41
2,5,14,3,8,5,18,0,0,55
2,5,14,3,8,5,18,19,0,74
2,5,14,3,8,5,19,0,0,56
2,5,14,3,8,6,21,12,0,71
2,5,14,3,8,25,0,0,0,57
2,5,14,3,8,9,14,7,0,62
2,5,14,3,8,12,1,14,4,63
2,5,14,3,8,12,5,19,19,87
2,5,14,3,8,12,5,20,0,69
2,5,14,3,8,13,1,14,0,60
2,5,14,3,8,13,1,18,0,64
2,5,14,3,8,13,1,18,11,75
2,5,14,3,8,13,5,14,0,64
2,5,14,3,8,23,15,18,11,99
2,5,14,3,9,20,5,0,0,58
2,5,14,4,1,2,12,5,0,45
2,5,14,4,1,25,0,0,0,51
2,5,14,4,1,25,5,4,0,60
2,5,14,4,1,25,9,14,7,81
2,5,14,4,1,25,19,0,0,70
2,5,14,4,5,4,0,0,0,34
2,5,14,4,5,5,0,0,0,35
2,5,14,4,5,5,19,0,0,54
2,5,14,4,5,12,12,0,0,54
2,5,14,4,5,18,19,0,0,67
2,5,14,4,25,0,0,0,0,50
2,5,14,4,9,5,19,0,0,58
2,5,14,4,9,14,7,0,0,55
2,5,14,4,9,14,7,12,25,92
2,5,14,4,25,19,0,0,0,69
2,5,14,4,12,5,20,0,0,62
2,5,14,4,19,0,0,0,0,44
2,5,14,4,19,15,13,5,0,77
2,5,14,4,23,1,25,19,0,93
2,5,14,4,23,9,19,5,0,81
2,5,14,5,1,16,5,4,0,52
2,5,14,5,1,20,8,0,0,55
2,5,14,5,4,9,3,11,19,72
2,5,14,5,4,9,3,20,19,81
2,5,14,5,4,9,7,8,20,74
2,5,14,5,6,1,3,20,0,56
2,5,14,5,6,9,3,0,0,44
2,5,14,5,6,9,3,5,0,49
2,5,14,5,6,9,3,5,4,53
2,5,14,5,6,9,3,5,19,68
2,5,14,5,6,9,20,0,0,61
2,5,14,5,6,9,20,5,4,70
2,5,14,5,6,9,20,5,18,84
2,5,14,5,6,9,20,19,0,80
2,5,14,5,7,18,15,0,0,66
2,5,14,5,13,5,0,0,0,44
2,5,14,5,13,16,20,0,0,75
2,5,14,5,13,16,20,5,4,84
2,5,14,5,20,20,5,4,0,75
2,5,14,5,20,20,9,14,7,96
2,5,14,5,20,20,12,5,0,83
2,5,14,5,21,18,15,21,19,120
2,5,14,7,1,12,9,14,5,69
2,5,14,7,1,12,19,0,0,60
2,5,14,9,3,0,0,0,0,33
2,5,14,9,7,8,20,0,0,65
2,5,14,9,7,8,20,5,4,74
2,5,14,9,7,8,20,5,14,84
2,5,14,9,7,8,20,5,18,88
2,5,14,9,7,14,0,0,0,51
2,5,14,9,7,14,1,14,20,86
2,5,14,9,7,14,9,20,25,105
2,5,14,9,7,14,12,25,0,88
2,5,14,9,13,0,0,0,0,43
2,5,14,9,19,5,5,4,0,63
2,5,14,9,19,15,14,0,0,78
2,5,14,9,19,15,14,19,0,97
2,5,14,9,20,9,5,18,0,82
2,5,14,9,20,15,9,20,5,99
2,5,14,10,0,0,0,0,0,31
2,5,14,10,1,13,9,14,19,87
2,5,14,10,15,9,14,0,0,69
2,5,14,13,15,19,20,0,0,88
2,5,14,14,5,0,0,0,0,40
2,5,14,14,5,12,0,0,0,52
2,5,14,14,5,19,0,0,0,59
2,5,14,14,5,20,19,0,0,79
2,5,14,14,9,5,19,0,0,68
2,5,14,14,9,19,0,0,0,63
2,5,14,14,9,19,5,5,4,77
2,5,14,15,13,25,12,0,0,86
2,5,14,15,13,25,12,19,0,105
2,5,14,15,18,20,8,0,0,82
2,5,14,15,20,5,0,0,0,61
2,5,14,19,0,0,0,0,0,40
2,5,14,19,1,9,12,0,0,62
2,5,14,19,1,12,12,0,0,65
2,5,14,19,5,12,0,0,0,57
2,5,14,19,5,12,12,0,0,69
2,5,14,19,8,0,0,0,0,48
2,5,14,19,8,5,1,0,0,54
2,5,14,19,8,5,5,0,0,58
2,5,14,19,8,9,0,0,0,57
2,5,14,19,9,12,0,0,0,61
2,5,14,20,1,14,7,0,0,63
2,5,14,20,7,18,1,19,19,105
2,5,14,20,8,1,12,0,0,62
2,5,14,20,8,9,3,0,0,61
2,5,14,20,8,15,14,0,0,78
2,5,14,20,8,15,14,9,3,90
2,5,14,20,8,15,19,0,0,83
2,5,14,20,8,15,19,5,19,107
2,5,14,20,25,0,0,0,0,66
2,5,14,20,9,14,5,19,19,107
2,5,14,20,9,14,7,0,0,71
2,5,14,20,12,5,20,0,0,78
2,5,14,20,15,14,9,20,5,104
2,5,14,20,19,0,0,0,0,60
2,5,14,20,19,20,1,18,0,99
2,5,14,20,23,15,15,4,0,98
2,5,14,20,23,15,15,4,19,117
2,5,14,21,13,2,0,0,0,57
2,5,14,21,13,2,5,4,0,66
2,5,14,21,13,2,9,14,7,87
2,5,14,21,13,2,19,0,0,76
2,5,14,23,1,18,4,0,0,67
2,5,14,23,5,5,4,0,0,58
2,5,14,26,1,12,0,0,0,60
2,5,14,26,1,13,9,4,5,79
2,5,14,26,1,13,9,4,15,89
2,5,14,26,1,13,9,14,5,89
2,5,14,26,1,13,9,14,15,99
2,5,14,26,1,26,9,4,5,92
2,5,14,26,1,26,9,14,5,102
2,5,14,26,1,26,15,12,5,106
2,5,14,26,5,9,14,0,0,75
2,5,14,26,5,14,5,0,0,71
2,5,14,26,5,14,5,19,0,90
2,5,14,26,5,14,25,12,0,103
2,5,14,26,5,14,15,9,4,94
2,5,14,26,9,4,9,14,0,83
2,5,14,26,9,4,9,14,5,88
2,5,14,26,9,4,9,14,15,98
2,5,14,26,9,4,9,14,19,102
2,5,14,26,9,12,0,0,0,68
2,5,14,26,25,12,0,0,0,84
2,5,14,26,9,12,9,3,0,80
2,5,14,26,25,12,9,3,0,96
2,5,14,26,25,12,19,0,0,103
2,5,14,26,9,14,0,0,0,70
2,5,14,26,9,14,5,0,0,75
2,5,14,26,9,14,5,19,0,94
2,5,14,26,9,14,19,0,0,89
2,5,14,26,15,0,0,0,0,62
2,5,14,26,15,1,20,5,0,88
2,5,14,26,15,1,20,5,4,92
2,5,14,26,15,1,20,5,19,107
2,5,14,26,15,2,9,19,0,92
2,5,14,26,15,9,3,0,0,74
2,5,14,26,15,9,4,0,0,75
2,5,14,26,15,25,12,0,0,99
2,5,14,26,15,25,12,19,0,118
2,5,14,26,15,9,14,0,0,85
2,5,14,26,15,9,14,19,0,104
2,5,14,26,15,12,0,0,0,74
2,5,14,26,15,12,1,20,5,100
2,5,14,26,15,12,5,0,0,79
2,5,14,26,15,12,5,19,0,98
2,5,14,26,15,12,9,14,5,102
2,5,14,26,15,12,9,26,5,114
2,5,14,26,15,12,19,0,0,93
2,5,14,26,15,24,1,20,5,112
2,5,14,26,15,24,25,0,0,111
2,5,15,4,5,0,0,0,0,31
2,5,16,1,9,4,0,0,0,37
2,5,16,1,9,14,20,5,4,76
2,5,16,1,9,14,20,19,0,86
2,5,16,1,12,5,0,0,0,41
2,5,16,1,16,5,18,0,0,63
2,5,16,1,18,3,8,0,0,53
2,5,16,1,18,15,4,25,0,86
2,5,16,1,18,19,5,0,0,66
2,5,16,1,18,20,0,0,0,62
2,5,16,1,19,20,5,0,0,68
2,5,16,1,20,0,0,0,0,44
2,5,16,1,20,3,8,5,4,64
2,5,16,1,23,0,0,0,0,47
2,5,16,5,1,18,12,0,0,59
2,5,16,5,12,20,0,0,0,60
2,5,16,5,14,0,0,0,0,42
2,5,16,5,16,16,5,18,0,83
2,5,16,5,19,20,5,18,0,90
2,5,16,5,23,5,4,0,0,60
2,5,16,8,9,12,20,5,18,95
2,5,16,8,18,1,19,5,0,74
2,5,16,9,3,20,21,18,5,99
2,5,16,9,5,3,5,0,0,45
2,5,16,9,5,18,3,5,0,63
2,5,16,9,12,5,0,0,0,49
2,5,16,9,12,12,0,0,0,56
2,5,16,9,13,16,12,5,0,78
2,5,16,9,13,16,12,5,4,82
2,5,16,9,13,16,12,5,19,97
2,5,16,9,14,3,8,0,0,57
2,5,16,9,20,25,0,0,0,77
2,5,16,12,1,7,21,5,0,69
2,5,16,12,1,9,4,5,4,58
2,5,16,12,1,19,20,5,18,98
2,5,16,12,21,13,5,4,0,78
2,5,16,15,13,13,5,12,0,81
2,5,16,15,23,4,5,18,0,88
2,5,16,18,1,25,0,0,0,67
2,5,16,18,1,9,19,5,0,75
2,5,16,18,1,9,19,5,18,93
2,5,16,18,1,14,11,0,0,67
2,5,16,18,1,14,11,5,4,76
2,5,16,18,5,1,3,8,0,58
2,5,16,18,5,19,19,0,0,84
2,5,16,18,5,20,20,25,0,111
2,5,16,18,9,4,5,0,0,59
2,5,16,18,15,19,5,0,0,80
2,5,16,21,4,4,12,5,0,69
2,5,16,21,6,6,0,0,0,56
2,5,16,21,6,6,5,4,0,65
2,5,16,21,14,0,0,0,0,58
2,5,16,21,18,16,12,5,0,95
2,5,16,21,26,26,12,5,0,113
2,5,17,21,1,12,13,0,0,71
2,5,17,21,5,1,20,8,0,79
2,5,17,21,5,1,20,8,19,98
2,5,17,21,5,19,20,0,0,89
2,5,17,21,5,19,20,19,0,108
2,5,17,21,9,18,20,12,5,109
2,5,17,21,15,20,5,0,0,85
2,5,17,23,5,20,5,0,0,77
2,5,18,1,25,0,0,0,0,51
2,5,18,1,9,14,0,0,0,49
2,5,18,1,9,18,15,21,0,89
2,5,18,1,11,1,8,0,0,46
2,5,18,1,11,5,0,0,0,42
2,5,18,1,11,5,4,0,0,46
2,5,18,1,11,5,19,0,0,61
2,5,18,1,11,9,14,7,0,67
2,5,18,1,11,15,20,0,0,72
2,5,18,1,11,15,20,8,0,80
2,5,18,1,16,20,0,0,0,62
2,5,18,1,19,3,1,12,0,61
2,5,18,1,19,3,1,12,19,80
2,5,18,1,20,0,0,0,0,46
2,5,18,1,20,5,0,0,0,51
2,5,18,1,20,5,4,0,0,55
2,5,18,1,20,5,19,0,0,70
2,5,18,1,20,9,14,7,0,76
2,5,18,1,20,20,12,5,0,83
2,5,18,1,21,14,9,20,5,95
2,5,18,2,1,13,9,14,5,69
2,5,18,2,5,18,25,0,0,75
2,5,18,2,5,18,9,1,0,60
2,5,18,2,5,18,9,4,0,63
2,5,18,2,5,18,9,14,0,73
2,5,18,2,5,18,9,14,5,78
2,5,18,2,5,18,9,14,19,92
2,5,18,2,5,18,18,25,0,93
2,5,18,2,5,18,19,0,0,69
2,5,18,3,5,1,21,0,0,55
2,5,18,3,5,12,5,20,0,70
2,5,18,3,5,21,19,5,0,78
2,5,18,3,5,21,19,5,19,97
2,5,18,4,1,3,8,5,0,46
2,5,18,4,1,3,8,5,19,65
2,5,18,4,1,19,8,0,0,57
2,5,18,5,0,0,0,0,0,30
2,5,18,5,1,18,5,6,20,80
2,5,18,5,1,19,15,14,0,79
2,5,18,5,1,22,5,0,0,58
2,5,18,5,1,22,5,4,0,62
2,5,18,5,1,22,5,14,0,72
2,5,18,5,1,22,5,18,0,76
2,5,18,5,1,22,5,18,19,95
2,5,18,5,1,22,5,19,0,77
2,5,18,5,1,22,9,14,7,83
2,5,18,5,4,5,0,0,0,39
2,5,18,5,6,20,0,0,0,56
2,5,18,5,14,4,0,0,0,48
2,5,18,5,14,4,15,0,0,63
2,5,18,5,14,7,5,14,1,71
2,5,18,5,19,9,20,5,0,83
2,5,18,5,20,19,0,0,0,69
2,5,18,5,20,20,1,19,0,90
2,5,18,5,23,9,3,11,0,76
2,5,18,7,1,12,9,20,8,82
2,5,18,7,1,12,12,0,0,57
2,5,18,7,1,13,9,15,12,82
2,5,18,7,1,13,15,20,19,100
2,5,18,7,1,14,4,5,18,74
2,5,18,7,5,18,5,0,0,60
2,5,18,7,5,18,5,19,0,79
2,5,18,7,5,18,5,20,0,80
2,5,18,7,6,1,12,12,0,63
2,5,18,7,7,25,12,20,0,96
2,5,18,7,8,1,1,14,0,56
2,5,18,7,25,0,0,0,0,57
2,5,18,7,25,12,20,0,0,89
2,5,18,7,9,14,9,26,5,95
2,5,18,7,12,5,20,0,0,69
2,5,18,7,15,13,1,19,11,91
2,5,18,7,19,0,0,0,0,51
2,5,18,7,21,20,0,0,0,73
2,5,18,8,25,13,5,0,0,76
2,5,18,8,25,13,5,4,0,80
2,5,18,8,25,13,5,19,0,95
2,5,18,8,25,13,9,14,7,101
2,5,18,9,2,2,15,14,0,67
2,5,18,9,2,5,18,0,0,59
2,5,18,9,2,5,18,9,0,68
2,5,18,9,2,5,18,9,3,71
2,5,18,9,2,5,18,9,19,87
2,5,18,9,2,5,18,19,0,78
2,5,18,25,3,9,4,0,0,66
2,5,18,25,3,9,14,5,0,81
2,5,18,25,3,15,9,4,0,81
2,5,18,9,4,5,0,0,0,43
2,5,18,9,7,15,18,1,0,75
2,5,18,25,12,1,20,5,0,88
2,5,18,25,12,9,14,5,0,90
2,5,18,25,12,12,1,20,5,100
2,5,18,25,12,12,9,1,0,84
2,5,18,25,12,12,9,14,5,102
2,5,18,25,12,12,9,21,13,117
2,5,18,25,12,12,15,9,4,102
2,5,18,25,12,19,0,0,0,81
2,5,18,9,13,5,0,0,0,52
2,5,18,9,13,5,4,0,0,56
2,5,18,9,13,5,19,0,0,71
2,5,18,9,13,9,14,7,0,77
2,5,18,9,14,7,5,4,0,64
2,5,18,9,14,7,9,20,5,89
2,5,18,9,14,19,5,0,0,72
2,5,18,11,5,12,9,21,13,96
2,5,18,11,15,22,5,20,19,117
2,5,18,11,15,22,20,19,9,121
2,5,18,12,5,25,0,0,0,67
2,5,18,12,9,14,1,0,0,61
2,5,18,12,9,14,5,0,0,65
2,5,18,12,9,14,5,18,19,102
2,5,18,12,9,14,5,19,0,84
2,5,18,12,9,14,9,20,5,94
2,5,18,12,9,14,19,0,0,79
2,5,18,12,15,17,21,5,0,95
2,5,18,13,0,0,0,0,0,38
2,5,18,13,5,0,0,0,0,43
2,5,18,13,5,14,19,3,8,87
2,5,18,13,5,19,0,0,0,62
2,5,18,13,19,0,0,0,0,57
2,5,18,13,21,4,9,20,5,97
2,5,18,14,1,3,12,5,0,60
2,5,18,14,9,3,12,5,0,68
2,5,18,14,9,3,12,5,19,87
2,5,18,14,15,15,0,0,0,69
2,5,18,15,2,0,0,0,0,42
2,5,18,15,2,5,4,0,0,51
2,5,18,15,7,21,5,0,0,73
2,5,18,15,12,12,0,0,0,64
2,5,18,15,21,7,5,4,0,77
2,5,18,15,21,14,4,0,0,79
2,5,18,18,5,1,22,5,0,76
2,5,18,18,5,1,22,5,4,80
2,5,18,18,5,1,22,5,19,95
2,5,18,18,5,14,4,15,0,81
2,5,18,18,5,20,0,0,0,68
2,5,18,18,5,20,20,1,0,89
2,5,18,18,5,20,20,1,19,108
2,5,18,18,25,2,21,19,8,118
2,5,18,18,9,3,8,15,14,92
2,5,18,18,9,5,4,0,0,61
2,5,18,18,9,5,18,0,0,75
2,5,18,18,9,5,19,0,0,76
2,5,18,18,9,7,1,14,0,74
2,5,18,18,25,9,14,7,0,98
2,5,18,18,25,12,5,19,19,123
2,5,18,18,25,12,9,11,5,105
2,5,18,18,21,7,1,20,5,97
2,5,18,19,5,5,13,0,0,67
2,5,18,19,5,5,13,19,0,86
2,5,18,19,5,18,11,0,0,78
2,5,18,19,5,18,11,5,18,101
2,5,18,19,5,18,11,19,0,97
2,5,18,19,9,13,0,0,0,66
2,5,18,19,11,9,14,0,0,78
2,5,18,19,20,5,12,0,0,81
2,5,18,20,8,0,0,0,0,53
2,5,18,20,8,1,7,5,0,66
2,5,18,20,8,1,19,0,0,73
2,5,18,20,8,5,4,0,0,62
2,5,18,20,8,5,18,0,0,76
2,5,18,20,8,9,14,7,0,83
2,5,18,20,8,19,0,0,0,72
2,5,18,20,9,14,0,0,0,68
2,5,18,20,18,21,13,0,0,97
2,5,18,21,6,6,5,4,0,67
2,5,18,21,6,6,12,5,4,79
2,5,18,21,14,0,0,0,0,60
2,5,18,21,19,20,0,0,0,85
2,5,18,22,9,5,0,0,0,61
2,5,19,1,0,0,0,0,0,27
2,5,19,1,7,14,5,0,0,53
2,5,19,1,7,21,5,0,0,60
2,5,19,1,9,5,12,0,0,53
2,5,19,1,9,12,5,0,0,53
2,5,19,1,25,12,5,0,0,69
2,5,19,1,9,14,20,0,0,70
2,5,19,1,14,0,0,0,0,41
2,5,19,1,14,4,0,0,0,45
2,5,19,1,21,3,5,0,0,56
2,5,19,3,1,2,0,0,0,32
2,5,19,3,1,18,6,0,0,54
2,5,19,3,1,20,20,5,18,93
2,5,19,3,5,14,20,0,0,68
2,5,19,3,15,18,3,8,0,73
2,5,19,3,15,18,14,0,0,76
2,5,19,3,15,21,18,0,0,83
2,5,19,3,15,21,18,5,4,92
2,5,19,3,15,21,18,7,5,95
2,5,19,3,15,21,18,19,0,102
2,5,19,3,18,1,16,5,0,69
2,5,19,3,18,1,20,3,8,79
2,5,19,3,18,1,23,12,0,83
2,5,19,3,18,5,5,14,0,71
2,5,19,3,18,5,5,14,19,90
2,5,19,3,21,18,6,0,0,74
2,5,19,3,21,18,22,25,0,115
2,5,19,5,1,13,0,0,0,45
2,5,19,5,5,0,0,0,0,36
2,5,19,5,5,3,8,0,0,47
2,5,19,5,5,3,8,5,4,56
2,5,19,5,5,3,8,5,18,70
2,5,19,5,5,3,8,5,19,71
2,5,19,5,5,11,0,0,0,47
2,5,19,5,5,13,0,0,0,49
2,5,19,5,5,13,5,4,0,58
2,5,19,5,5,13,9,14,7,79
2,5,19,5,5,13,12,25,0,86
2,5,19,5,5,13,19,0,0,68
2,5,19,5,5,14,0,0,0,50
2,5,19,5,9,7,5,0,0,52
2,5,19,5,20,0,0,0,0,51
2,5,19,5,20,13,5,14,20,103
2,5,19,5,20,19,0,0,0,70
2,5,19,5,20,20,5,18,0,94
2,5,19,5,20,20,5,18,19,113
2,5,19,5,20,20,9,14,7,101
2,5,19,5,23,0,0,0,0,54
2,5,19,8,1,3,11,12,5,66
2,5,19,8,1,4,5,0,0,44
2,5,19,8,1,4,15,23,0,77
2,5,19,8,1,4,15,23,19,96
2,5,19,8,1,7,0,0,0,42
2,5,19,8,1,11,5,0,0,51
2,5,19,8,1,13,5,0,0,53
2,5,19,8,1,13,5,4,0,57
2,5,19,8,1,13,5,19,0,72
2,5,19,8,1,13,9,14,7,78
2,5,19,8,1,23,12,5,4,79
2,5,19,8,5,1,18,0,0,58
2,5,19,8,5,12,12,0,0,63
2,5,19,8,9,5,12,4,0,64
2,5,19,8,9,14,5,0,0,62
2,5,19,8,9,22,5,18,0,88
2,5,19,8,9,22,5,18,19,107
2,5,19,8,12,9,11,0,0,66
2,5,19,8,15,4,0,0,0,53
2,5,19,8,15,21,20,0,0,90
2,5,19,8,15,21,20,5,4,99
2,5,19,8,15,21,20,19,0,109
2,5,19,8,15,23,0,0,0,72
2,5,19,8,15,23,5,18,0,95
2,5,19,8,18,5,23,0,0,80
2,5,19,8,18,5,23,5,4,89
2,5,19,8,18,5,23,19,0,99
2,5,19,8,18,9,5,11,0,77
2,5,19,8,18,9,22,5,12,100
2,5,19,8,18,15,21,4,0,92
2,5,19,8,18,15,21,4,19,111
2,5,19,9,4,5,0,0,0,44
2,5,19,9,4,5,19,0,0,63
2,5,19,9,5,7,5,0,0,52
2,5,19,9,5,7,5,4,0,56
2,5,19,9,5,7,5,18,0,70
2,5,19,9,5,7,5,18,19,89
2,5,19,9,5,7,5,19,0,71
2,5,19,9,5,7,9,14,7,77
2,5,19,9,7,8,0,0,0,50
2,5,19,9,12,22,5,18,0,92
2,5,19,9,14,0,0,0,0,49
2,5,19,9,14,7,0,0,0,56
2,5,19,9,18,5,14,0,0,72
2,5,19,9,20,0,0,0,0,55
2,5,19,12,1,2,0,0,0,41
2,5,19,12,1,2,2,5,18,66
2,5,19,12,1,16,0,0,0,55
2,5,19,12,1,19,8,0,0,66
2,5,19,12,1,22,5,0,0,66
2,5,19,12,1,22,5,4,0,70
2,5,19,12,1,22,5,18,0,84
2,5,19,12,5,5,22,5,0,75
2,5,19,12,9,13,5,0,0,65
2,5,19,12,9,13,5,4,0,69
2,5,19,12,9,13,5,18,0,83
2,5,19,12,9,13,5,19,0,84
2,5,19,12,9,13,9,14,7,90
2,5,19,12,9,14,7,19,0,87
2,5,19,12,9,16,16,5,18,102
2,5,19,12,15,2,2,5,18,80
2,5,19,12,15,23,0,0,0,76
2,5,19,12,21,2,2,5,18,86
2,5,19,12,21,9,20,0,0,88
2,5,19,12,21,18,0,0,0,77
2,5,19,12,21,19,8,5,4,95
2,5,19,13,5,1,18,0,0,63
2,5,19,13,5,1,18,5,4,72
2,5,19,13,5,1,18,5,18,86
2,5,19,13,5,1,18,19,0,82
2,5,19,13,5,12,12,0,0,68
2,5,19,13,9,12,5,0,0,65
2,5,19,13,9,12,5,4,0,69
2,5,19,13,9,12,5,19,0,84
2,5,19,13,9,12,9,14,7,90
2,5,19,13,9,18,3,8,0,77
2,5,19,13,15,11,5,0,0,70
2,5,19,13,15,11,5,4,0,74
2,5,19,13,15,11,5,19,0,89
2,5,19,13,15,11,9,14,7,95
2,5,19,13,15,15,20,8,0,97
2,5,19,13,15,15,20,8,19,116
2,5,19,13,15,20,8,5,18,105
2,5,19,13,15,21,3,8,0,86
2,5,19,13,21,4,7,5,0,76
2,5,19,13,21,4,7,5,4,80
2,5,19,13,21,4,7,5,19,95
2,5,19,13,21,20,0,0,0,80
2,5,19,13,21,20,3,8,0,91
2,5,19,13,21,20,19,0,0,99
2,5,19,13,21,20,20,5,4,109
2,5,19,14,1,18,5,0,0,64
2,5,19,14,5,5,18,0,0,68
2,5,19,14,9,22,5,12,0,88
2,5,19,14,15,23,0,0,0,78
2,5,19,14,15,23,5,4,0,87
2,5,19,14,15,23,9,14,7,108
2,5,19,14,15,23,19,0,0,97
2,5,19,14,21,6,6,0,0,73
2,5,19,15,4,4,5,14,0,68
2,5,19,15,7,14,5,0,0,67
2,5,19,15,7,14,9,5,18,94
2,5,19,15,9,12,0,0,0,62
2,5,19,15,9,14,0,0,0,64
2,5,19,15,13,0,0,0,0,54
2,5,19,15,13,5,18,0,0,77
2,5,19,15,13,19,0,0,0,73
2,5,19,15,14,9,15,0,0,79
2,5,19,15,14,14,5,20,0,94
2,5,19,15,15,20,0,0,0,76
2,5,19,15,15,20,8,5,0,89
2,5,19,15,15,20,8,5,4,93
2,5,19,15,15,20,8,5,19,108
2,5,19,15,18,20,0,0,0,79
2,5,19,15,20,0,0,0,0,61
2,5,19,15,20,13,5,14,20,113
2,5,19,15,20,19,0,0,0,80
2,5,19,15,20,20,5,4,0,90
2,5,19,15,20,20,5,18,0,104
2,5,19,15,20,20,9,14,7,111
2,5,19,15,21,7,8,20,0,97
2,5,19,15,21,12,0,0,0,74
2,5,19,15,21,18,0,0,0,80
2,5,19,15,21,20,8,0,0,90
2,5,19,16,1,11,5,0,0,59
2,5,19,16,1,14,7,12,5,81
2,5,19,16,1,20,5,0,0,68
2,5,19,16,1,20,20,5,18,106
2,5,19,16,1,23,12,0,0,78
2,5,19,16,5,1,11,0,0,59
2,5,19,16,5,1,11,5,18,82
2,5,19,16,5,1,11,19,0,78
2,5,19,16,5,3,11,5,4,70
2,5,19,16,5,3,11,12,5,78
2,5,19,16,5,4,0,0,0,51
2,5,19,16,5,5,3,8,0,63
2,5,19,16,5,5,4,0,0,56
2,5,19,16,5,12,12,0,0,71
2,5,19,16,5,12,12,5,4,80
2,5,19,16,5,14,4,0,0,65
2,5,19,16,5,20,5,0,0,72
2,5,19,16,5,23,0,0,0,70
2,5,19,16,25,0,0,0,0,67
2,5,19,16,9,3,5,0,0,59
2,5,19,16,9,12,12,0,0,75
2,5,19,16,9,14,0,0,0,65
2,5,19,16,9,18,9,20,0,98
2,5,19,16,9,20,0,0,0,71
2,5,19,16,12,1,19,8,0,82
2,5,19,16,12,9,20,0,0,83
2,5,19,16,15,11,5,0,0,73
2,5,19,16,15,11,5,14,0,87
2,5,19,16,15,20,0,0,0,77
2,5,19,16,15,20,20,5,4,106
2,5,19,16,15,21,19,5,0,102
2,5,19,16,15,21,19,5,4,106
2,5,19,16,15,21,19,5,19,121
2,5,19,16,15,21,20,0,0,98
2,5,19,16,18,1,25,0,0,86
2,5,19,16,18,5,1,4,0,70
2,5,19,16,18,5,1,4,19,89
2,5,19,16,18,5,14,7,0,86
2,5,19,16,18,5,14,20,0,99
2,5,19,16,18,9,14,7,0,90
2,5,19,16,21,18,18,5,4,108
2,5,19,16,21,18,20,0,0,101
2,5,19,16,21,20,20,5,18,126
2,5,19,17,21,5,5,26,5,105
2,5,19,17,21,9,2,0,0,75
2,5,19,17,21,9,18,20,0,111
2,5,19,18,1,0,0,0,0,45
2,5,19,19,5,19,0,0,0,69
2,5,19,20,1,2,0,0,0,49
2,5,19,20,1,4,0,0,0,51
2,5,19,20,1,25,0,0,0,72
2,5,19,20,1,25,5,4,0,81
2,5,19,20,1,9,14,0,0,70
2,5,19,20,1,13,16,0,0,76
2,5,19,20,1,14,4,0,0,65
2,5,19,20,1,18,0,0,0,65
2,5,19,20,1,18,5,0,0,70
2,5,19,20,1,18,22,5,0,92
2,5,19,20,1,20,21,5,4,97
2,5,19,20,5,1,4,0,0,56
2,5,19,20,5,1,4,5,4,65
2,5,19,20,5,1,4,19,0,75
2,5,19,20,5,1,12,0,0,64
2,5,19,20,5,4,0,0,0,55
2,5,19,20,5,5,18,0,0,74
2,5,19,20,5,14,3,8,0,76
2,5,19,20,5,18,0,0,0,69
2,5,19,20,9,1,12,0,0,68
2,5,19,20,9,1,12,12,25,105
2,5,19,20,9,1,12,19,0,87
2,5,19,20,9,1,14,0,0,70
2,5,19,20,9,1,18,25,0,99
2,5,19,20,9,3,11,0,0,69
2,5,19,20,9,12,12,0,0,79
2,5,19,20,9,14,7,0,0,76
2,5,19,20,9,14,11,0,0,80
2,5,19,20,9,18,0,0,0,73
2,5,19,20,9,18,18,5,4,100
2,5,19,20,9,18,19,0,0,92
2,5,19,20,14,5,19,19,0,103
2,5,19,20,15,3,11,0,0,75
2,5,19,20,15,18,5,0,0,84
2,5,19,20,15,18,13,0,0,92
2,5,19,20,15,22,5,0,0,88
2,5,19,20,15,23,0,0,0,84
2,5,19,20,15,23,1,7,5,97
2,5,19,20,15,23,1,12,0,97
2,5,19,20,15,23,1,12,19,116
2,5,19,20,15,23,5,4,0,93
2,5,19,20,15,23,5,18,0,107
2,5,19,20,15,23,9,14,7,114
2,5,19,20,15,23,19,0,0,103
2,5,19,20,18,1,23,0,0,88
2,5,19,20,18,5,1,11,0,81
2,5,19,20,18,5,1,13,0,83
2,5,19,20,18,5,23,0,0,92
2,5,19,20,18,5,23,5,4,101
2,5,19,20,18,5,23,14,0,106
2,5,19,20,18,5,23,19,0,111
2,5,19,20,18,9,4,0,0,77
2,5,19,20,18,9,4,5,0,82
2,5,19,20,18,9,4,5,4,86
2,5,19,20,18,9,4,5,19,101
2,5,19,20,18,9,16,5,0,94
2,5,19,20,18,15,4,5,0,88
2,5,19,20,18,15,23,0,0,102
2,5,19,20,18,15,23,5,4,111
2,5,19,20,18,15,23,14,0,116
2,5,19,20,18,15,23,19,0,121
2,5,19,20,18,21,20,0,0,105
2,5,19,20,19,0,0,0,0,65
2,5,19,20,21,2,2,12,5,88
2,5,19,20,21,3,11,0,0,81
2,5,19,20,21,4,0,0,0,71
2,5,19,20,21,4,4,5,4,84
2,5,19,20,21,4,19,0,0,90
2,5,19,20,21,21,18,0,0,106
2,5,19,21,7,1,18,0,0,73
2,5,19,21,7,15,0,0,0,69
2,5,19,21,9,20,0,0,0,76
2,5,19,21,12,12,25,0,0,96
2,5,19,23,1,18,13,0,0,81
2,5,19,23,1,18,13,5,4,90
2,5,19,23,1,18,13,19,0,100
2,5,19,23,5,5,20,5,14,98
2,5,19,23,5,12,20,5,18,109
2,5,19,23,9,13,0,0,0,71
2,5,19,23,9,14,7,5,0,84
2,5,19,23,9,14,11,0,0,83
2,5,19,23,9,20,3,8,0,89
2,5,20,0,0,0,0,0,0,27
2,5,20,1,3,1,9,14,5,60
2,5,20,1,3,9,19,13,0,72
2,5,20,1,6,9,20,5,0,68
2,5,20,1,7,0,0,0,0,35
2,5,20,1,9,12,0,0,0,49
2,5,20,1,9,12,15,18,0,82
2,5,20,1,9,14,0,0,0,51
2,5,20,1,9,14,5,0,0,56
2,5,20,1,9,14,5,19,0,75
2,5,20,1,11,5,0,0,0,44
2,5,20,1,11,5,14,0,0,58
2,5,20,1,11,5,19,0,0,63
2,5,20,1,11,9,14,7,0,69
2,5,20,1,12,11,0,0,0,51
2,5,20,1,12,12,15,23,0,90
2,5,20,1,14,7,12,5,0,66
2,5,20,1,19,0,0,0,0,47
2,5,20,1,19,11,0,0,0,58
2,5,20,1,19,19,5,12,0,83
2,5,20,1,20,18,15,14,0,95
2,5,20,1,20,18,15,14,19,114
2,5,20,1,20,20,5,18,0,91
2,5,20,1,20,20,5,18,19,110
2,5,20,1,24,5,4,0,0,61
2,5,20,5,0,0,0,0,0,32
2,5,20,5,1,3,8,0,0,44
2,5,20,5,1,18,0,0,0,51
2,5,20,5,5,12,1,0,0,50
2,5,20,5,5,13,0,0,0,50
2,5,20,5,12,0,0,0,0,44
2,5,20,5,12,12,0,0,0,56
2,5,20,5,12,14,21,20,0,99
2,5,20,5,12,14,21,20,19,118
2,5,20,5,12,19,0,0,0,63
2,5,20,5,19,0,0,0,0,51
2,5,20,8,1,2,1,18,1,58
2,5,20,8,1,14,11,0,0,61
2,5,20,8,1,14,11,5,4,70
2,5,20,8,1,14,11,9,20,90
2,5,20,8,1,14,11,19,0,80
2,5,20,8,5,12,19,0,0,71
2,5,20,8,5,19,4,1,19,83
2,5,20,8,25,12,9,4,0,85
2,5,20,8,9,14,11,0,0,69
2,5,20,8,9,14,11,19,0,88
2,5,20,8,15,18,14,0,0,82
2,5,20,8,15,18,14,5,4,91
2,5,20,8,15,18,14,19,0,101
2,5,20,8,15,21,7,8,20,106
2,5,20,8,18,1,12,12,0,78
2,5,20,8,18,15,15,20,0,103
2,5,20,8,19,0,0,0,0,54
2,5,20,8,21,13,2,0,0,71
2,5,20,8,21,13,16,0,0,85
2,5,20,8,21,13,16,5,4,94
2,5,20,8,21,13,16,19,0,104
2,5,20,8,21,14,4,5,18,97
2,5,20,8,23,1,3,11,0,73
2,5,20,8,23,9,14,5,0,86
2,5,20,9,4,5,0,0,0,45
2,5,20,9,4,5,4,0,0,49
2,5,20,9,4,5,19,0,0,64
2,5,20,9,4,9,14,7,0,70
2,5,20,9,13,2,5,18,0,74
2,5,20,9,13,5,0,0,0,54
2,5,20,9,13,5,19,0,0,73
2,5,20,9,14,7,5,0,0,62
2,5,20,9,16,16,12,5,0,85
2,5,20,9,18,5,0,0,0,59
2,5,20,9,19,0,0,0,0,55
2,5,20,9,19,5,0,0,0,60
2,5,20,9,19,5,19,0,0,79
2,5,20,9,20,12,5,0,0,73
2,5,20,15,3,19,9,14,0,87
2,5,20,15,9,12,0,0,0,63
2,5,20,15,11,5,14,0,0,72
2,5,20,15,11,5,14,5,4,81
2,5,20,15,11,5,14,5,18,95
2,5,20,15,11,5,14,19,0,91
2,5,20,15,14,0,0,0,0,56
2,5,20,15,14,5,0,0,0,61
2,5,20,15,14,7,21,5,0,89
2,5,20,15,14,25,0,0,0,81
2,5,20,15,14,9,5,19,0,89
2,5,20,15,14,19,0,0,0,75
2,5,20,15,15,11,0,0,0,68
2,5,20,15,18,3,9,14,0,86
2,5,20,15,18,14,0,0,0,74
2,5,20,15,19,19,0,0,0,80
2,5,20,15,23,5,12,0,0,82
2,5,20,15,23,5,18,5,4,97
2,5,20,18,1,3,5,0,0,54
2,5,20,18,1,25,0,0,0,71
2,5,20,18,1,25,1,12,0,84
2,5,20,18,1,25,1,12,19,103
2,5,20,18,1,25,5,4,0,80
2,5,20,18,1,25,5,18,0,94
2,5,20,18,1,25,5,18,19,113
2,5,20,18,1,25,9,14,7,101
2,5,20,18,1,9,12,0,0,67
2,5,20,18,1,25,19,0,0,90
2,5,20,18,1,9,19,5,0,79
2,5,20,18,1,13,16,12,5,92
2,5,20,18,1,16,0,0,0,62
2,5,20,18,1,22,5,12,0,85
2,5,20,18,5,1,4,0,0,55
2,5,20,18,5,14,4,0,0,68
2,5,20,18,9,13,0,0,0,67
2,5,20,18,9,14,11,5,20,104
2,5,20,18,15,20,8,0,0,88
2,5,20,18,15,20,8,1,12,101
2,5,20,18,15,20,8,5,4,97
2,5,20,18,15,20,8,19,0,107
2,5,20,18,15,21,7,8,0,96
2,5,20,18,21,13,16,5,20,120
2,5,20,18,21,14,11,0,0,91
2,5,20,18,21,19,20,0,0,105
2,5,20,19,0,0,0,0,0,46
2,5,20,19,15,0,0,0,0,61
2,5,20,20,1,19,0,0,0,67
2,5,20,20,5,4,0,0,0,56
2,5,20,20,5,18,0,0,0,70
2,5,20,20,5,18,5,4,0,79
2,5,20,20,5,18,5,18,0,93
2,5,20,20,5,18,9,14,7,100
2,5,20,20,5,18,12,25,0,107
2,5,20,20,5,18,19,0,0,89
2,5,20,20,9,5,19,0,0,80
2,5,20,20,9,14,7,0,0,77
2,5,20,20,15,14,7,0,0,83
2,5,20,20,15,14,7,1,0,84
2,5,20,20,15,18,0,0,0,80
2,5,20,20,15,18,19,0,0,99
2,5,20,21,12,9,14,0,0,83
2,5,20,21,12,9,14,9,3,95
2,5,20,21,12,9,14,15,12,110
2,5,20,21,13,2,12,5,4,84
2,5,20,21,19,11,5,4,0,87
2,5,20,21,20,15,18,0,0,101
2,5,20,21,20,15,18,5,4,110
2,5,20,23,5,5,14,0,0,74
2,5,20,23,5,5,14,19,0,93
2,5,20,23,9,14,5,0,0,78
2,5,20,23,9,20,0,0,0,79
2,5,20,23,9,24,5,14,0,102
2,5,20,23,9,24,20,0,0,103
2,5,21,4,1,14,9,20,5,81
2,5,21,14,3,12,5,4,0,66
2,5,21,18,18,5,0,0,0,69
2,5,22,1,18,9,14,7,0,78
2,5,22,1,20,18,15,14,0,97
2,5,22,1,20,18,15,14,19,116
2,5,22,5,9,12,0,0,0,55
2,5,22,5,12,0,0,0,0,46
2,5,22,5,12,5,4,0,0,55
2,5,22,5,12,5,18,0,0,69
2,5,22,5,12,5,18,19,0,88
2,5,22,5,12,9,14,7,0,76
2,5,22,5,12,12,5,4,0,67
2,5,22,5,12,12,5,18,0,81
2,5,22,5,12,12,5,18,19,100
2,5,22,5,12,12,9,14,7,88
2,5,22,5,12,13,5,14,20,98
2,5,22,5,12,19,0,0,0,65
2,5,22,5,14,15,13,0,0,76
2,5,22,5,18,1,7,5,0,65
2,5,22,5,18,1,7,5,19,84
2,5,22,5,18,19,5,0,0,76
2,5,22,5,20,15,0,0,0,69
2,5,22,25,0,0,0,0,0,54
2,5,22,9,5,19,0,0,0,62
2,5,22,9,12,0,0,0,0,50
2,5,22,9,12,12,1,9,14,86
2,5,22,9,12,12,5,4,0,71
2,5,22,9,14,5,4,0,0,61
2,5,22,15,9,12,5,4,0,74
2,5,22,15,13,9,20,0,0,86
2,5,22,15,13,9,20,5,4,95
2,5,22,15,13,9,20,19,0,105
2,5,22,15,18,0,0,0,0,62
2,5,22,15,18,19,0,0,0,81
2,5,22,21,5,0,0,0,0,55
2,5,23,1,9,12,0,0,0,52
2,5,23,1,9,12,5,4,0,61
2,5,23,1,9,12,5,18,0,75
2,5,23,1,9,12,5,18,19,94
2,5,23,1,9,12,9,14,7,82
2,5,23,1,9,12,19,0,0,71
2,5,23,1,11,5,0,0,0,47
2,5,23,1,12,12,0,0,0,55
2,5,23,1,18,5,0,0,0,54
2,5,23,1,18,5,4,0,0,58
2,5,23,1,18,5,19,0,0,73
2,5,23,1,18,25,0,0,0,74
2,5,23,1,18,9,14,7,0,79
2,5,23,1,19,8,0,0,0,58
2,5,23,1,19,20,5,0,0,75
2,5,23,1,20,5,18,0,0,74
2,5,23,5,1,18,25,0,0,79
2,5,23,5,1,18,9,5,4,72
2,5,23,5,1,18,9,5,19,87
2,5,23,5,5,16,0,0,0,56
2,5,23,5,5,16,5,18,0,79
2,5,23,5,5,16,9,14,7,86
2,5,23,5,5,16,19,0,0,75
2,5,23,5,12,3,15,13,5,83
2,5,23,5,12,20,5,18,0,90
2,5,23,5,14,4,0,0,0,53
2,5,23,5,16,20,0,0,0,71
2,5,23,5,19,20,0,0,0,74
2,5,23,5,20,0,0,0,0,55
2,5,23,8,9,7,0,0,0,54
2,5,23,8,9,19,11,5,18,100
2,5,23,8,9,19,16,5,18,105
2,5,23,8,9,19,20,12,5,103
2,5,23,8,9,20,5,0,0,72
2,5,23,8,9,20,5,14,0,86
2,5,23,8,15,18,5,0,0,76
2,5,23,9,4,15,23,0,0,81
2,5,23,9,5,12,4,0,0,60
2,5,23,9,7,0,0,0,0,46
2,5,23,9,7,7,5,4,0,62
2,5,23,9,7,7,9,14,7,83
2,5,23,9,7,19,0,0,0,65
2,5,23,9,12,4,5,18,0,78
2,5,23,9,12,4,5,18,19,97
2,5,23,9,13,16,12,5,0,85
2,5,23,9,14,7,5,4,0,69
2,5,23,9,14,20,5,18,0,96
2,5,23,9,18,5,4,0,0,66
2,5,23,9,20,0,0,0,0,59
2,5,23,9,20,3,8,0,0,70
2,5,23,9,20,3,8,5,4,79
2,5,23,9,20,3,8,5,18,93
2,5,23,9,20,3,8,5,19,94
2,5,23,9,20,8,0,0,0,67
2,5,23,9,26,1,18,4,0,88
2,5,23,15,14,4,5,18,0,86
2,5,23,15,18,11,0,0,0,74
2,5,23,15,18,13,0,0,0,76
2,5,23,15,18,13,5,4,0,85
2,5,23,15,18,13,9,14,7,106
2,5,23,15,18,13,19,0,0,95
2,5,23,15,18,14,0,0,0,77
2,5,23,15,18,18,25,0,0,106
2,5,23,15,18,18,9,5,4,99
2,5,23,15,18,18,9,5,19,114
2,5,23,15,18,19,8,9,16,115
2,5,23,16,5,18,19,0,0,88
2,5,23,18,1,25,0,0,0,74
2,5,23,18,1,25,5,4,0,83
2,5,23,18,1,25,5,18,0,97
2,5,23,18,1,25,5,18,19,116
2,5,23,18,1,25,9,14,7,104
2,5,23,18,1,25,19,0,0,93
2,5,23,18,1,16,0,0,0,65
2,5,23,18,1,16,16,5,4,90
2,5,23,18,1,16,19,0,0,84
2,5,23,18,1,16,20,0,0,85
2,5,23,18,1,20,8,5,4,86
2,5,23,18,5,1,11,0,0,65
2,5,23,18,5,1,20,8,0,82
2,5,23,18,5,3,11,0,0,67
2,5,23,18,25,0,0,0,0,73
2,5,23,18,9,20,5,0,0,82
2,5,23,18,15,21,7,8,20,119
2,5,23,23,5,16,20,0,0,94
2,5,26,1,14,0,0,0,0,48
2,5,26,1,14,20,0,0,0,68
2,5,26,1,14,20,5,0,0,73
2,5,26,1,14,20,5,5,0,78
2,5,26,1,14,20,25,0,0,93
2,5,26,1,14,20,19,0,0,87
2,5,26,1,26,26,0,0,0,86
2,5,26,1,26,26,5,19,0,110
2,5,26,5,12,0,0,0,0,50
2,5,26,5,12,19,0,0,0,69
2,5,26,5,19,20,5,5,14,101
2,5,26,5,20,20,1,0,0,79
2,5,26,5,20,20,5,0,0,83
2,5,26,9,12,0,0,0,0,54
2,5,26,9,12,19,0,0,0,73
2,5,26,9,17,21,5,0,0,85
2,5,26,9,17,21,5,19,0,104
2,5,26,15,1,18,0,0,0,67
2,5,26,15,1,18,4,9,3,83
2,5,26,15,1,18,19,0,0,86
2,5,26,15,14,9,1,14,0,86
2,5,26,26,1,14,20,0,0,94
2,5,26,26,1,14,20,19,0,113
2,5,26,26,9,0,0,0,0,68
2,5,26,26,12,5,0,0,0,76
2,5,26,26,12,5,4,0,0,80
2,5,26,26,12,9,14,7,0,101
2,5,26,26,15,0,0,0,0,74
2,8,4,0,0,0,0,0,0,14
2,8,5,5,19,20,25,0,0,84
2,8,5,5,19,20,9,5,0,73
2,8,5,5,19,20,9,5,19,92
2,8,9,11,8,1,18,9,0,66
2,8,9,14,4,9,0,0,0,46
2,8,9,19,8,20,9,0,0,75
2,8,9,19,20,9,0,0,0,67
2,8,9,19,20,9,5,0,0,72
2,8,9,19,20,9,5,19,0,91
2,8,15,25,0,0,0,0,0,50
2,8,15,11,18,1,0,0,0,55
2,8,15,15,19,1,0,0,0,60
2,8,15,15,20,0,0,0,0,60
2,8,15,15,20,19,0,0,0,79
2,8,21,13,9,4,1,18,0,76
2,8,21,14,4,5,18,0,0,72
2,8,21,14,7,9,0,0,0,61
2,8,21,14,7,9,14,9,0,84
2,8,21,20,0,0,0,0,0,51
2,8,21,20,19,0,0,0,0,70
2,9,2,1,3,9,15,21,19,81
2,9,2,1,3,9,20,25,0,71
2,9,2,1,19,9,3,0,0,45
2,9,2,1,19,9,12,1,18,73
2,9,2,1,20,9,15,14,0,72
2,9,2,2,0,0,0,0,0,15
2,9,2,2,5,4,0,0,0,24
2,9,2,2,5,18,0,0,0,38
2,9,2,2,5,18,25,0,0,63
2,9,2,2,5,18,9,5,19,71
2,9,2,2,5,18,19,0,0,57
2,9,2,2,9,14,7,0,0,45
2,9,2,2,12,5,0,0,0,32
2,9,2,2,12,5,4,0,0,36
2,9,2,2,12,5,18,0,0,50
2,9,2,2,12,9,14,7,0,57
2,9,2,2,15,14,19,0,0,63
2,9,2,2,19,0,0,0,0,34
2,9,2,3,15,3,11,0,0,45
2,9,2,3,15,3,11,19,0,64
2,9,2,5,12,15,20,0,0,65
2,9,2,5,12,15,20,19,0,84
2,9,2,5,14,26,25,12,0,95
2,9,2,5,18,15,14,0,0,65
2,9,2,9,15,14,9,4,0,64
2,9,2,9,18,9,0,0,0,49
2,9,2,9,18,21,0,0,0,61
2,9,2,9,20,15,18,25,0,100
2,9,2,12,5,19,0,0,0,49
2,9,2,12,5,19,19,0,0,68
2,9,2,12,9,11,5,0,0,50
2,9,2,12,9,15,7,0,0,56
2,9,2,12,9,15,20,9,3,81
2,9,2,12,9,19,20,19,0,92
2,9,2,12,15,19,0,0,0,59
2,9,2,12,21,19,0,0,0,65
2,9,2,15,18,1,20,5,0,72
2,9,2,19,0,0,0,0,0,32
2,9,2,21,12,15,21,19,0,101
2,9,3,1,12,22,15,21,19,104
2,9,3,1,13,5,18,1,12,64
2,9,3,1,18,2,0,0,0,35
2,9,3,1,18,2,9,4,5,53
2,9,3,1,18,2,19,0,0,54
2,9,3,1,21,4,1,12,0,53
2,9,3,1,21,4,1,20,5,66
2,9,3,3,8,5,4,0,0,34
2,9,3,5,14,20,18,1,12,84
2,9,3,5,14,20,18,9,3,83
2,9,3,5,16,0,0,0,0,35
2,9,3,5,16,19,0,0,0,54
2,9,3,5,16,19,5,19,0,78
2,9,3,5,19,0,0,0,0,38
2,9,3,5,20,25,12,0,0,76
2,9,3,8,25,0,0,0,0,47
2,9,3,8,9,18,0,0,0,49
2,9,3,8,15,18,4,0,0,59
2,9,3,8,15,19,0,0,0,56
2,9,3,8,18,15,13,5,0,73
2,9,3,8,18,15,13,9,3,80
2,9,3,25,1,14,9,4,5,72
2,9,3,25,3,12,5,0,0,59
2,9,3,25,3,12,5,4,0,63
2,9,3,25,3,12,5,18,0,77
2,9,3,25,3,12,5,18,19,96
2,9,3,25,3,12,5,19,0,78
2,9,3,25,3,12,9,3,0,66
2,9,3,25,3,12,9,14,7,84
2,9,3,25,3,12,9,19,13,95
2,9,3,25,3,12,9,19,20,102
2,9,3,25,3,12,15,0,0,69
2,9,3,25,3,21,12,1,18,94
2,9,3,9,12,9,1,20,5,70
2,9,3,9,16,9,20,1,12,81
2,9,3,9,18,18,15,19,5,98
2,9,3,11,5,18,0,0,0,48
2,9,3,11,5,18,5,4,0,57
2,9,3,11,5,18,5,18,0,71
2,9,3,11,5,18,5,18,19,90
2,9,3,11,5,18,9,14,7,78
2,9,3,11,5,18,14,0,0,62
2,9,3,11,5,18,19,0,0,67
2,9,3,11,9,18,15,14,0,81
2,9,3,12,1,22,1,20,5,75
2,9,3,12,9,14,9,1,0,59
2,9,3,12,9,14,9,21,13,92
2,25,3,15,11,5,20,0,0,81
2,9,3,15,12,15,18,0,0,74
2,9,3,15,12,15,18,5,4,83
2,9,3,15,12,15,18,19,0,93
2,9,3,15,12,15,21,18,0,95
2,9,3,15,12,15,21,18,19,114
2,9,3,15,13,16,1,3,20,82
2,9,3,15,14,3,1,22,5,74
2,9,3,15,14,5,0,0,0,48
2,9,3,15,14,9,3,0,0,55
2,9,3,15,14,9,3,1,12,68
2,9,3,15,14,22,5,24,0,94
2,9,3,15,18,14,1,20,5,87
2,9,3,15,18,14,5,0,0,66
2,9,3,15,18,14,5,4,0,70
2,9,3,15,18,14,5,19,0,85
2,9,3,15,18,14,15,21,19,116
2,9,3,15,18,14,21,20,5,107
2,9,3,15,19,20,1,20,5,94
2,9,3,18,5,14,1,20,5,77
2,9,3,18,15,14,0,0,0,61
2,9,3,18,15,14,19,0,0,80
2,9,3,18,21,18,1,12,0,84
2,9,3,21,18,19,1,12,0,85
2,9,3,21,19,16,9,4,0,83
2,9,3,21,19,16,9,4,19,102
2,9,4,1,3,20,25,12,0,76
2,9,4,1,3,20,25,12,5,81
2,9,4,1,18,0,0,0,0,34
2,9,4,1,18,11,1,0,0,46
2,9,4,1,18,11,1,19,0,65
2,9,4,1,18,11,5,5,0,55
2,9,4,1,18,11,5,5,19,74
2,9,4,3,15,3,11,0,0,47
2,9,4,4,1,2,12,5,0,39
2,9,4,4,1,2,12,25,0,59
2,9,4,4,1,14,3,5,0,42
2,9,4,4,5,14,0,0,0,38
2,9,4,4,5,18,0,0,0,42
2,9,4,4,5,18,25,0,0,67
2,9,4,4,5,18,19,0,0,61
2,9,4,4,9,5,19,0,0,52
2,9,4,4,9,14,7,0,0,49
2,9,4,4,9,14,7,19,0,68
2,9,4,5,0,0,0,0,0,20
2,9,4,5,4,0,0,0,0,24
2,9,4,5,14,5,0,0,0,39
2,9,4,5,14,20,0,0,0,54
2,9,4,5,14,20,1,12,0,67
2,9,4,5,14,20,1,20,5,80
2,9,4,5,14,20,5,4,0,63
2,9,4,5,14,20,9,1,12,76
2,9,4,5,18,0,0,0,0,38
2,9,4,5,18,25,0,0,0,63
2,9,4,5,18,19,0,0,0,57
2,9,4,5,19,0,0,0,0,39
2,9,4,5,20,0,0,0,0,40
2,9,4,5,20,19,0,0,0,59
2,9,4,9,0,0,0,0,0,24
2,9,4,9,14,7,0,0,0,45
2,9,4,9,21,18,14,1,12,90
2,9,4,18,5,5,0,0,0,43
2,9,4,18,9,0,0,0,0,42
2,9,4,18,25,0,0,0,0,58
2,9,4,19,0,0,0,0,0,34
2,9,4,19,20,1,14,4,0,73
2,9,4,21,15,21,19,0,0,91
2,25,5,0,0,0,0,0,0,32
2,9,5,2,5,18,9,20,5,75
2,25,5,5,0,0,0,0,0,37
2,9,5,5,14,14,9,1,0,59
2,25,5,7,1,5,9,14,0,68
2,25,5,12,1,23,0,0,0,68
2,25,5,12,1,23,19,0,0,87
2,9,5,12,2,25,0,0,0,55
2,9,5,12,2,18,9,5,6,68
2,9,5,12,4,0,0,0,0,32
2,9,5,12,4,5,4,0,0,41
2,9,5,12,4,25,0,0,0,57
2,9,5,12,4,9,14,7,0,62
2,9,5,12,4,19,0,0,0,51
2,9,5,12,5,14,9,20,5,81
2,25,5,13,1,14,0,0,0,60
2,9,5,14,0,0,0,0,0,30
2,9,5,14,12,25,0,0,0,67
2,9,5,14,14,1,12,5,0,62
2,9,5,14,14,1,12,5,19,81
2,9,5,14,14,5,19,19,0,87
2,9,5,14,14,9,1,0,0,54
2,9,5,14,14,9,1,12,0,66
2,9,5,14,14,9,1,12,19,85
2,9,5,14,14,9,21,13,0,87
2,9,5,14,14,9,21,13,19,106
2,9,5,14,19,0,0,0,0,49
2,9,5,14,20,20,0,0,0,70
2,9,5,14,22,5,14,21,0,92
2,9,5,14,22,5,14,21,5,97
2,25,5,16,1,20,8,0,0,77
2,9,5,18,0,0,0,0,0,34
2,9,5,18,2,1,12,11,0,60
2,25,5,18,9,20,5,0,0,84
2,25,5,18,12,9,20,5,0,96
2,9,5,18,19,0,0,0,0,53
2,9,5,18,19,20,21,2,5,101
2,25,5,19,0,0,0,0,0,51
2,9,5,19,20,9,14,7,19,104
2,25,5,19,20,18,5,5,20,119
2,9,5,20,8,14,9,3,0,70
2,9,5,20,12,5,0,0,0,53
2,25,5,23,15,18,11,5,18,122
2,9,6,1,3,5,0,0,0,26
2,9,6,1,3,5,19,0,0,45
2,9,6,1,3,9,1,12,0,43
2,9,6,1,14,7,5,4,0,48
2,9,6,1,18,1,0,0,0,37
2,9,6,1,18,9,15,21,19,100
2,9,6,5,18,0,0,0,0,40
2,9,6,5,18,15,21,19,0,95
2,9,6,6,0,0,0,0,0,23
2,9,6,6,5,4,0,0,0,32
2,9,6,6,25,0,0,0,0,48
2,9,6,6,9,5,19,0,0,56
2,9,6,6,9,14,0,0,0,46
2,9,6,6,9,14,7,0,0,53
2,9,6,6,9,14,19,0,0,65
2,9,6,6,19,0,0,0,0,42
2,9,6,9,4,0,0,0,0,30
2,9,6,9,4,1,20,5,0,56
2,9,6,9,4,1,20,5,4,60
2,9,6,9,4,9,20,25,0,84
2,9,6,9,4,12,25,0,0,67
2,9,6,9,12,1,18,0,0,57
2,9,6,9,12,1,18,12,25,94
2,9,6,12,5,3,20,5,4,66
2,9,6,12,5,24,0,0,0,58
2,9,6,12,15,18,1,20,5,88
2,9,6,12,15,18,15,21,19,117
2,9,6,12,21,15,18,9,4,96
2,9,6,15,3,1,12,0,0,48
2,9,6,15,3,1,12,19,0,67
2,9,6,15,9,12,0,0,0,53
2,9,6,15,12,4,0,0,0,48
2,9,6,15,12,9,1,0,0,54
2,9,6,15,12,9,1,20,5,79
2,9,6,15,12,9,21,13,0,87
2,9,6,15,18,1,20,5,0,76
2,9,6,15,18,9,14,0,0,73
2,9,6,15,18,9,14,5,0,78
2,9,6,15,18,11,5,4,0,70
2,9,6,15,18,11,9,14,7,91
2,9,6,15,18,13,0,0,0,63
2,9,6,15,18,13,5,4,0,72
2,9,6,15,18,13,9,20,25,117
2,9,6,15,18,15,21,19,0,105
2,9,6,18,15,14,20,0,0,84
2,9,6,18,15,14,20,1,12,97
2,9,6,18,15,14,20,5,4,93
2,9,6,20,5,3,11,0,0,56
2,9,6,21,18,3,1,12,0,72
2,9,6,21,18,3,1,20,5,85
2,9,6,21,18,3,15,21,19,114
2,9,7,0,0,0,0,0,0,18
2,9,7,1,0,0,0,0,0,19
2,9,7,1,5,0,0,0,0,24
2,9,7,1,13,0,0,0,0,32
2,9,7,1,13,25,0,0,0,57
2,9,7,1,13,9,3,0,0,44
2,9,7,1,13,9,5,19,0,65
2,9,7,1,13,9,19,20,0,80
2,9,7,1,13,9,19,20,19,99
2,9,7,1,13,9,26,5,0,72
2,9,7,1,13,9,26,5,4,76
2,9,7,1,13,15,21,19,0,87
2,25,7,1,14,5,0,0,0,54
2,25,7,1,14,7,9,14,7,86
2,9,7,1,18,1,4,5,0,47
2,9,7,1,18,1,4,5,19,66
2,9,7,1,18,15,15,14,0,81
2,9,7,1,18,15,15,14,19,100
2,9,7,1,19,0,0,0,0,38
2,9,7,1,20,5,0,0,0,44
2,9,7,2,12,15,15,13,0,75
2,9,7,2,21,18,25,0,0,84
2,9,7,5,25,5,0,0,0,53
2,9,7,5,25,5,19,0,0,72
2,9,7,5,13,9,14,1,0,60
2,9,7,5,13,9,14,1,12,72
2,9,7,5,13,9,14,25,0,84
2,9,7,5,13,9,14,21,13,93
2,9,7,5,14,5,18,0,0,60
2,9,7,5,14,5,18,9,3,72
2,9,7,5,14,20,9,1,12,79
2,9,7,6,5,5,20,0,0,54
2,9,7,6,15,15,20,0,0,74
2,9,7,6,15,15,20,19,0,93
2,9,7,7,1,8,0,0,0,34
2,9,7,7,5,4,0,0,0,34
2,9,7,7,5,14,0,0,0,44
2,9,7,7,5,14,5,4,0,53
2,9,7,7,5,14,9,14,7,74
2,9,7,7,5,18,0,0,0,48
2,9,7,7,5,19,20,0,0,69
2,9,7,7,5,20,25,0,0,75
2,9,7,7,25,0,0,0,0,50
2,9,7,7,9,5,0,0,0,39
2,9,7,7,9,5,19,0,0,58
2,9,7,7,9,14,0,0,0,48
2,9,7,7,9,14,7,0,0,55
2,9,7,7,9,14,7,19,0,74
2,9,7,7,9,14,19,0,0,67
2,9,7,7,9,19,8,0,0,61
2,9,7,7,9,20,25,0,0,79
2,9,7,7,15,14,5,20,0,79
2,9,7,8,1,0,0,0,0,27
2,9,7,8,5,1,4,0,0,36
2,9,7,8,5,1,4,5,4,45
2,9,7,8,5,1,4,19,0,55
2,9,7,8,20,0,0,0,0,46
2,9,7,8,20,5,4,0,0,55
2,9,7,8,20,9,14,7,0,76
2,9,7,8,20,19,0,0,0,65
2,9,7,12,5,14,15,9,4,77
2,9,7,12,25,0,0,0,0,55
2,9,7,12,15,20,0,0,0,65
2,9,7,13,9,20,20,0,0,80
2,9,7,13,15,21,20,8,0,95
2,9,7,13,15,21,20,8,19,114
2,9,7,14,5,19,19,0,0,75
2,9,7,14,5,19,19,5,19,99
2,9,7,14,15,14,9,1,4,75
2,9,7,14,15,14,9,1,19,90
2,9,7,14,15,21,0,0,0,68
2,25,7,15,0,0,0,0,0,49
2,25,7,15,9,14,7,0,0,79
2,25,7,15,14,5,0,0,0,68
2,25,7,15,14,5,19,0,0,87
2,9,7,15,14,9,1,3,0,60
2,9,7,15,14,9,1,12,0,69
2,9,7,15,20,5,4,0,0,62
2,9,7,15,20,5,4,12,25,99
2,9,7,15,20,8,5,18,15,99
2,9,7,15,20,9,19,8,0,89
2,9,7,15,20,18,25,0,0,96
2,9,7,15,20,18,9,5,19,104
2,9,7,15,20,19,0,0,0,72
2,9,7,15,20,20,25,0,0,98
2,9,7,18,1,13,0,0,0,50
2,9,7,18,15,15,20,0,0,86
2,9,7,20,8,1,20,3,8,78
2,9,7,21,1,14,9,4,5,72
2,9,7,21,20,20,1,20,5,105
2,9,7,23,9,7,0,0,0,57
2,9,7,23,9,7,7,5,4,73
2,9,7,23,9,7,19,0,0,76
2,9,8,1,12,22,5,0,0,59
2,9,8,1,13,1,20,5,0,59
2,25,8,1,14,4,0,0,0,54
2,9,8,15,21,18,12,25,0,110
2,9,25,5,1,18,12,25,0,97
2,9,10,1,0,0,0,0,0,22
2,9,10,1,19,1,12,0,0,54
2,9,10,5,3,20,9,15,14,87
2,9,10,5,3,20,9,22,5,85
2,9,10,15,21,0,0,0,0,57
2,9,10,15,21,19,0,0,0,76
2,9,10,15,21,24,0,0,0,81
2,9,10,21,7,1,20,5,0,75
2,9,10,21,7,15,21,19,0,104
2,9,10,21,7,21,12,1,18,101
2,9,10,23,15,14,5,18,0,96
2,9,11,5,0,0,0,0,0,27
2,9,11,5,4,0,0,0,0,31
2,9,11,5,18,0,0,0,0,45
2,9,11,5,18,19,0,0,0,64
2,9,11,5,19,0,0,0,0,46
2,9,11,5,23,1,25,0,0,76
2,9,11,5,23,1,25,19,0,95
2,9,11,8,0,0,0,0,0,30
2,9,11,9,5,0,0,0,0,36
2,9,11,9,5,19,0,0,0,55
2,9,11,9,14,7,0,0,0,52
2,9,11,9,14,9,5,4,0,63
2,9,11,9,14,9,19,0,0,73
2,9,11,11,21,18,9,13,0,94
2,9,12,1,2,5,0,0,0,31
2,9,12,1,2,9,1,12,0,48
2,9,12,1,2,9,1,12,19,67
2,9,12,1,2,9,1,20,5,61
2,9,12,1,25,5,18,0,0,72
2,9,12,1,25,5,18,19,0,91
2,9,12,1,12,15,0,0,0,51
2,9,12,1,13,9,14,1,18,79
2,9,12,1,14,4,0,0,0,42
2,25,12,1,14,4,0,0,0,58
2,9,12,1,14,4,5,18,0,65
2,25,12,1,14,4,5,18,0,81
2,9,12,1,14,4,5,18,19,84
2,9,12,1,20,5,18,1,12,80
2,25,12,1,23,0,0,0,0,63
2,25,12,1,23,13,1,14,0,91
2,25,12,1,23,19,0,0,0,82
2,9,12,2,5,18,18,25,0,91
2,9,12,2,9,0,0,0,0,34
2,9,12,2,25,0,0,0,0,50
2,9,12,2,9,5,0,0,0,39
2,9,12,2,9,5,19,0,0,58
2,9,12,2,15,0,0,0,0,40
2,9,12,2,15,1,0,0,0,41
2,9,12,2,15,1,19,0,0,60
2,9,12,2,15,5,19,0,0,64
2,9,12,2,15,17,21,5,20,103
2,9,12,2,15,19,0,0,0,59
2,9,12,3,8,0,0,0,0,34
2,9,12,3,15,3,11,0,0,55
2,9,12,4,1,18,0,0,0,46
2,9,12,4,5,18,0,0,0,50
2,9,12,4,5,18,19,0,0,69
2,9,12,5,0,0,0,0,0,28
2,9,12,5,3,20,9,15,14,89
2,9,12,5,19,20,15,14,5,101
2,9,12,5,22,5,0,0,0,55
2,9,12,5,23,8,9,20,0,88
2,9,12,7,5,0,0,0,0,35
2,9,12,7,5,4,0,0,0,39
2,9,12,7,5,19,0,0,0,54
2,9,12,7,5,23,1,25,0,84
2,9,12,7,25,0,0,0,0,55
2,9,12,7,9,5,18,0,0,62
2,9,12,7,9,5,19,20,0,83
2,9,12,7,9,14,7,0,0,60
2,9,12,8,1,18,26,9,3,88
2,9,12,9,1,14,9,3,0,59
2,9,12,9,1,18,25,0,0,76
2,9,12,9,1,20,5,0,0,58
2,9,12,9,1,20,9,15,14,91
2,9,12,9,3,0,0,0,0,35
2,9,12,9,6,25,0,0,0,63
2,9,12,9,8,21,13,9,14,97
2,9,12,9,13,2,9,0,0,56
2,9,12,9,13,2,9,14,7,77
2,9,12,9,13,2,9,19,0,75
2,9,12,9,13,5,14,20,0,84
2,25,12,9,14,1,0,0,0,63
2,25,12,9,14,5,0,0,0,67
2,9,12,9,14,5,1,18,0,70
2,9,12,9,14,5,1,20,5,77
2,25,12,9,14,5,4,0,0,71
2,25,12,9,14,5,18,0,0,85
2,25,12,9,14,5,18,19,0,104
2,25,12,9,14,5,19,0,0,86
2,9,12,9,14,7,21,1,12,87
2,9,12,9,14,7,21,1,18,93
2,25,12,9,14,25,0,0,0,87
2,25,12,9,14,9,14,7,0,92
2,9,12,9,14,9,20,5,0,80
2,9,12,9,15,0,0,0,0,47
2,9,12,9,15,21,19,0,0,87
2,9,12,9,15,21,19,12,25,124
2,9,12,9,18,21,2,9,14,96
2,9,12,9,20,5,18,1,12,88
2,9,12,9,20,8,0,0,0,60
2,9,12,9,20,8,15,14,0,89
2,9,12,11,0,0,0,0,0,34
2,9,12,11,5,4,0,0,0,43
2,9,12,11,5,18,0,0,0,57
2,9,12,11,5,18,19,0,0,76
2,9,12,11,9,14,7,0,0,64
2,9,12,11,9,19,0,0,0,62
2,9,12,11,19,0,0,0,0,53
2,9,12,12,1,0,0,0,0,36
2,9,12,12,1,2,12,5,0,55
2,9,12,12,1,2,15,14,7,74
2,9,12,12,1,7,5,0,0,48
2,9,12,12,1,18,4,0,0,58
2,9,12,12,2,1,3,11,0,52
2,9,12,12,2,15,1,18,4,75
2,9,12,12,2,21,7,0,0,65
2,9,12,12,2,21,7,19,0,84
2,9,12,12,5,4,0,0,0,44
2,9,12,12,5,18,0,0,0,58
2,9,12,12,5,18,19,0,0,77
2,9,12,12,5,20,0,0,0,60
2,9,12,12,5,20,5,0,0,65
2,9,12,12,5,20,5,4,0,69
2,9,12,12,5,20,5,18,0,83
2,9,12,12,5,20,5,18,19,102
2,9,12,12,5,20,25,0,0,85
2,9,12,12,5,20,9,14,7,90
2,9,12,12,5,20,19,0,0,79
2,9,12,12,5,20,20,5,0,85
2,9,12,12,5,20,20,25,0,105
2,9,12,12,6,9,19,8,0,77
2,9,12,12,6,15,12,4,0,72
2,9,12,12,6,15,12,4,19,91
2,9,12,12,8,5,1,4,0,53
2,9,12,12,8,5,1,4,19,72
2,9,12,12,8,15,15,11,0,84
2,9,12,12,8,15,15,11,19,103
2,9,12,12,9,1,14,0,0,59
2,9,12,12,9,1,18,4,0,67
2,9,12,12,9,1,18,4,19,86
2,9,12,12,25,2,15,25,0,102
2,9,12,12,25,3,1,14,0,78
2,9,12,12,25,3,1,14,19,97
2,9,12,12,25,3,15,3,11,92
2,9,12,12,25,5,18,0,0,83
2,9,12,12,9,5,19,0,0,68
2,9,12,12,25,8,15,15,4,102
2,9,12,12,9,11,9,14,0,78
2,9,12,12,9,14,7,0,0,65
2,9,12,12,25,15,0,0,0,75
2,9,12,12,9,15,14,0,0,73
2,9,12,12,9,15,14,19,0,92
2,9,12,12,9,15,14,20,8,101
2,9,12,12,25,23,9,24,0,116
2,9,12,12,13,1,14,0,0,63
2,9,12,12,13,5,14,0,0,67
2,9,12,12,15,14,0,0,0,64
2,9,12,12,15,14,19,0,0,83
2,9,12,12,15,20,0,0,0,70
2,9,12,12,15,23,0,0,0,73
2,9,12,12,15,23,5,4,0,82
2,9,12,12,15,23,25,0,0,98
2,9,12,12,15,23,9,5,18,105
2,9,12,12,15,23,9,14,7,103
2,9,12,12,20,15,14,7,0,91
2,9,12,15,0,0,0,0,0,38
2,9,12,15,2,1,20,5,0,66
2,9,12,15,2,1,20,5,4,70
2,9,12,15,2,5,0,0,0,45
2,9,12,15,2,5,4,0,0,49
2,9,12,15,2,9,1,20,5,75
2,9,12,15,2,21,12,1,18,92
2,9,12,15,3,21,12,1,18,93
2,9,12,15,17,21,9,19,20,124
2,9,12,15,19,0,0,0,0,57
2,9,12,19,8,0,0,0,0,50
2,9,12,19,20,5,4,0,0,71
2,9,12,19,20,5,4,19,0,90
2,9,12,20,15,14,7,0,0,79
2,9,12,20,15,14,7,19,0,98
2,9,12,20,15,14,7,21,5,105
2,9,13,1,8,0,0,0,0,33
2,9,13,1,8,19,0,0,0,52
2,9,13,1,12,1,18,0,0,56
2,9,13,1,14,1,12,0,0,52
2,9,13,1,14,5,0,0,0,44
2,9,13,1,14,15,21,19,0,94
2,9,13,1,14,21,1,12,0,73
2,9,13,1,18,9,14,5,0,71
2,9,13,1,19,0,0,0,0,44
2,9,13,1,19,20,25,0,0,89
2,9,13,1,19,20,9,3,0,76
2,9,13,1,19,20,9,19,13,105
2,9,13,1,19,20,15,9,4,92
2,9,13,2,1,19,8,9,0,63
2,9,13,2,9,12,0,0,0,47
2,9,13,2,15,0,0,0,0,41
2,9,13,2,15,5,19,0,0,65
2,9,13,2,15,19,0,0,0,60
2,9,13,5,2,25,0,0,0,56
2,9,13,5,4,9,1,12,0,55
2,9,13,5,14,19,1,12,0,75
2,9,13,5,19,20,5,18,0,91
2,9,13,5,19,20,5,18,19,110
2,9,13,5,20,1,12,0,0,62
2,9,13,5,20,1,12,9,3,74
2,9,13,5,20,1,12,19,0,81
2,9,13,5,20,8,25,12,0,94
2,9,13,5,20,8,25,12,19,113
2,9,13,15,4,1,12,0,0,56
2,9,13,15,4,21,12,5,0,81
2,9,13,15,4,21,12,21,19,116
2,9,13,15,14,7,0,0,0,60
2,9,13,15,14,20,8,12,25,118
2,9,13,15,18,16,8,0,0,81
2,9,13,15,18,16,8,19,0,100
2,9,13,15,20,15,18,0,0,92
2,9,13,15,20,15,18,5,4,101
2,9,13,15,20,15,18,19,0,111
2,9,14,0,0,0,0,0,0,25
2,9,14,1,12,0,0,0,0,38
2,25,14,1,13,5,0,0,0,60
2,25,14,1,13,5,19,0,0,79
2,9,14,1,16,20,8,25,12,107
2,9,14,1,18,25,0,0,0,69
2,9,14,1,18,9,5,19,0,77
2,9,14,1,18,9,21,13,0,87
2,9,14,1,20,5,0,0,0,51
2,9,14,1,20,5,12,25,0,88
2,9,14,1,20,9,15,14,0,84
2,9,14,1,21,18,1,12,0,78
2,9,14,2,1,19,8,9,0,64
2,9,14,4,1,2,12,5,0,49
2,9,14,4,5,18,0,0,0,52
2,9,14,4,5,18,25,0,0,77
2,9,14,4,5,18,9,5,19,85
2,9,14,4,5,18,19,0,0,71
2,9,14,4,9,0,0,0,0,38
2,9,14,4,9,14,7,0,0,59
2,9,14,4,9,14,7,12,25,96
2,9,14,4,9,14,7,19,0,78
2,9,14,4,9,19,0,0,0,57
2,9,14,4,12,5,0,0,0,46
2,9,14,4,12,5,19,0,0,65
2,9,14,4,12,5,20,0,0,66
2,9,14,4,15,18,5,5,0,72
2,9,14,4,19,0,0,0,0,48
2,9,14,4,23,5,2,0,0,59
2,9,14,4,23,5,5,4,0,66
2,9,14,4,23,5,5,4,19,85
2,9,14,4,23,9,20,8,0,89
2,9,14,4,23,15,15,4,0,86
2,9,14,5,0,0,0,0,0,30
2,9,14,5,18,22,1,20,5,96
2,9,14,5,19,0,0,0,0,49
2,9,14,5,23,5,5,4,0,67
2,9,14,6,21,12,0,0,0,64
2,9,14,7,5,0,0,0,0,37
2,9,14,7,5,4,0,0,0,41
2,9,14,7,5,5,0,0,0,42
2,9,14,7,5,25,0,0,0,62
2,9,14,7,5,9,14,7,0,67
2,9,14,7,5,25,19,0,0,81
2,9,14,7,5,19,0,0,0,56
2,9,14,7,8,9,0,0,0,49
2,9,14,7,25,0,0,0,0,57
2,9,14,7,9,5,19,0,0,65
2,9,14,7,9,14,7,0,0,62
2,9,14,7,12,5,0,0,0,49
2,9,14,7,15,0,0,0,0,47
2,9,14,7,15,19,0,0,0,66
2,9,14,8,0,0,0,0,0,33
2,9,14,9,15,4,9,4,5,71
2,9,14,9,15,21,0,0,0,70
2,9,14,9,20,0,0,0,0,54
2,9,14,9,20,19,0,0,0,73
2,9,14,13,1,14,0,0,0,53
2,9,14,13,5,14,0,0,0,57
2,9,14,14,1,0,0,0,0,40
2,9,14,14,1,3,12,5,0,60
2,9,14,14,1,3,12,5,19,79
2,9,14,14,5,4,0,0,0,48
2,9,14,14,9,14,7,0,0,69
2,9,14,14,9,20,5,0,0,73
2,9,14,14,15,7,21,5,0,87
2,9,14,15,0,0,0,0,0,40
2,9,14,15,3,12,5,0,0,60
2,9,14,15,3,12,5,19,0,79
2,9,14,15,3,19,0,0,0,62
2,9,14,15,3,21,12,1,18,95
2,9,14,15,4,1,12,0,0,57
2,9,14,15,4,5,0,0,0,49
2,9,14,15,4,15,19,5,0,83
2,9,14,15,4,15,21,19,0,99
2,9,14,15,13,5,14,0,0,72
2,9,14,15,13,25,0,0,0,78
2,9,14,15,13,9,1,12,0,75
2,9,14,15,13,9,1,12,19,94
2,9,14,15,13,9,14,1,12,89
2,9,14,15,18,13,1,12,0,84
2,9,14,15,20,9,3,0,0,72
2,9,14,15,21,19,0,0,0,80
2,9,14,15,24,9,4,5,0,82
2,9,14,19,0,0,0,0,0,44
2,9,14,20,0,0,0,0,0,45
2,9,14,20,1,14,7,15,18,100
2,9,14,20,19,0,0,0,0,64
2,9,14,20,21,18,15,14,7,120
2,9,14,21,3,12,5,1,18,85
2,9,14,21,11,1,21,0,0,79
2,9,15,0,0,0,0,0,0,26
2,9,15,1,19,19,1,25,0,91
2,9,15,1,19,19,1,25,19,110
2,9,15,2,12,1,19,20,0,80
2,9,15,3,8,5,13,25,0,80
2,9,15,3,8,5,13,9,3,67
2,9,15,3,8,15,18,5,0,75
2,9,15,3,8,18,15,14,0,84
2,9,15,3,25,3,12,5,0,74
2,9,15,3,25,3,12,5,19,93
2,9,15,3,9,4,1,12,0,55
2,9,15,3,9,4,5,0,0,47
2,9,15,3,9,4,5,19,0,66
2,9,15,3,12,5,1,14,0,61
2,9,15,4,0,0,0,0,0,30
2,9,15,4,25,14,5,0,0,74
2,9,15,5,20,8,9,3,0,71
2,9,15,5,20,8,9,3,19,90
2,9,15,6,15,7,0,0,0,54
2,9,15,7,0,0,0,0,0,33
2,9,15,7,1,19,0,0,0,53
2,9,15,7,1,19,5,19,0,77
2,9,15,7,1,19,19,5,19,96
2,9,15,7,5,14,0,0,0,52
2,9,15,7,5,14,1,19,5,77
2,9,15,7,5,14,25,0,0,77
2,9,15,7,5,14,9,3,0,64
2,9,15,7,5,14,9,5,19,85
2,9,15,7,5,14,15,21,19,107
2,9,15,7,5,14,19,0,0,71
2,9,15,7,14,15,19,9,19,109
2,9,15,7,18,1,16,8,0,76
2,9,15,7,18,1,16,8,25,101
2,9,15,8,1,26,1,18,4,84
2,9,15,8,5,18,13,0,0,70
2,9,15,8,5,18,13,19,0,89
2,9,15,12,0,0,0,0,0,38
2,9,15,12,25,19,5,19,0,106
2,9,15,12,25,19,9,19,0,110
2,9,15,12,9,20,5,0,0,72
2,9,15,12,9,20,8,0,0,75
2,9,15,12,25,20,9,3,0,95
2,9,15,12,15,7,5,19,5,89
2,9,15,12,15,7,25,0,0,85
2,9,15,12,15,7,9,3,0,72
2,9,15,12,15,7,9,3,19,91
2,9,15,12,15,7,9,5,19,93
2,9,15,12,15,7,9,19,13,101
2,9,15,12,15,7,9,19,20,108
2,9,15,12,15,7,9,26,5,100
2,9,15,13,1,19,19,0,0,78
2,9,15,13,1,19,19,5,19,102
2,9,15,13,5,0,0,0,0,44
2,9,15,13,5,19,0,0,0,63
2,9,15,13,5,20,5,18,0,87
2,9,15,13,5,20,18,25,0,107
2,9,15,13,5,20,18,9,3,94
2,25,15,14,0,0,0,0,0,56
2,9,15,14,5,18,7,25,0,95
2,9,15,14,9,3,0,0,0,52
2,9,15,14,9,3,19,0,0,71
2,9,15,14,15,13,25,0,0,93
2,9,15,14,15,13,9,3,0,80
2,9,15,14,15,13,9,3,19,99
2,9,15,14,15,13,9,5,19,101
2,9,15,14,15,13,9,19,20,116
2,9,15,14,20,0,0,0,0,60
2,9,15,14,20,9,3,0,0,72
2,9,15,14,20,19,0,0,0,79
2,9,15,16,8,1,7,25,0,83
2,9,15,16,8,25,19,9,3,106
2,9,15,16,8,25,20,5,0,100
2,9,15,16,8,15,18,0,0,83
2,9,15,16,8,15,18,5,0,88
2,9,15,16,9,3,0,0,0,54
2,9,15,16,12,1,19,13,0,87
2,9,15,16,12,1,19,13,19,106
2,9,15,16,12,1,19,20,0,94
2,9,15,16,15,5,19,9,19,109
2,9,15,16,19,25,0,0,0,86
2,9,15,16,19,9,3,0,0,73
2,9,15,16,19,9,5,19,0,94
2,9,15,16,20,9,3,0,0,74
2,9,15,18,1,12,0,0,0,57
2,9,15,18,2,9,20,1,12,88
2,9,15,18,4,9,14,1,12,84
2,25,15,18,4,9,14,1,18,106
2,9,15,18,7,1,14,0,0,66
2,9,15,18,8,25,20,8,13,118
2,9,15,19,3,15,16,5,0,84
2,9,15,19,3,15,16,5,19,103
2,9,15,19,3,15,16,25,0,104
2,9,15,19,3,15,16,9,3,91
2,9,15,19,5,0,0,0,0,50
2,9,15,19,5,14,19,15,18,116
2,9,15,19,5,19,20,15,14,118
2,9,15,19,9,19,0,0,0,73
2,9,15,19,15,3,9,1,12,85
2,9,15,19,15,13,5,0,0,78
2,9,15,19,16,8,5,18,5,97
2,9,15,19,20,1,20,9,3,98
2,9,15,19,20,5,18,9,14,111
2,9,15,19,20,5,18,15,12,115
2,9,15,19,20,18,15,13,5,116
2,9,15,20,1,19,0,0,0,66
2,9,15,20,1,24,25,0,0,96
2,9,15,20,5,3,8,0,0,62
2,9,15,20,5,3,8,19,0,81
2,9,15,20,9,3,0,0,0,58
2,9,15,20,9,3,1,12,0,71
2,9,15,20,9,3,19,0,0,77
2,9,15,20,9,14,0,0,0,69
2,9,15,20,9,14,19,0,0,88
2,9,15,20,25,16,5,0,0,92
2,9,15,20,25,16,5,19,0,111
2,9,15,20,25,16,9,3,0,99
2,9,15,20,9,20,5,0,0,80
2,9,15,20,9,20,5,19,0,99
2,9,15,20,9,20,9,3,0,87
2,9,15,20,15,13,5,0,0,79
2,9,15,20,15,13,25,0,0,99
2,9,15,20,15,16,5,0,0,82
2,9,15,20,15,16,5,19,0,101
2,9,15,20,15,24,9,14,0,108
2,9,15,20,15,24,9,14,19,127
2,9,15,20,18,15,14,0,0,93
2,9,15,20,18,15,14,19,0,112
2,25,15,21,19,0,0,0,0,82
2,25,15,21,19,12,25,0,0,119
2,9,15,22,21,12,1,18,0,100
2,9,15,22,21,12,1,20,5,107
2,9,15,24,1,12,1,20,5,89
2,9,15,24,9,4,5,0,0,68
2,9,15,26,15,14,5,0,0,86
2,25,16,0,0,0,0,0,0,43
2,9,16,1,3,11,0,0,0,42
2,9,16,1,3,11,19,0,0,61
2,9,16,1,12,13,1,20,5,79
2,9,16,1,18,15,21,19,0,101
2,9,16,1,18,20,5,4,0,75
2,9,16,1,18,20,25,0,0,91
2,9,16,1,18,20,9,12,5,92
2,9,16,1,18,20,9,20,5,100
2,9,16,1,19,3,8,1,12,71
2,25,16,1,19,19,0,0,0,82
2,25,16,1,19,19,5,4,0,91
2,25,16,1,19,19,5,18,0,105
2,25,16,1,19,19,5,19,0,106
2,25,16,1,19,19,9,14,7,112
2,25,16,1,19,20,0,0,0,83
2,25,16,1,20,8,0,0,0,72
2,25,16,1,20,8,19,0,0,91
2,9,16,5,4,0,0,0,0,36
2,9,16,5,4,1,12,0,0,49
2,9,16,5,4,9,19,13,0,77
2,9,16,5,4,19,0,0,0,55
2,9,16,5,12,20,1,20,5,90
2,9,16,5,14,14,1,20,5,86
2,9,16,8,1,19,5,0,0,60
2,9,16,8,1,19,9,3,0,67
2,9,16,8,5,14,25,12,0,91
2,9,16,8,5,14,25,12,19,110
2,9,16,8,5,14,15,12,0,81
2,9,16,9,14,14,1,20,5,90
2,9,16,25,18,1,13,9,4,97
2,9,16,25,18,9,4,25,12,120
2,9,16,12,1,3,5,0,0,48
2,25,16,12,1,3,5,0,0,64
2,25,16,12,1,25,0,0,0,81
2,25,16,12,1,25,19,0,0,100
2,9,16,12,1,14,1,12,0,67
2,9,16,12,1,14,1,18,0,73
2,9,16,12,1,14,5,0,0,59
2,9,16,12,1,14,5,19,0,78
2,9,16,12,9,3,1,20,5,77
2,9,16,12,9,3,9,20,25,105
2,9,16,12,15,19,9,15,14,111
2,9,16,12,15,19,9,22,5,109
2,9,16,15,4,0,0,0,0,46
2,9,16,15,4,19,0,0,0,65
2,9,16,15,12,1,18,0,0,73
2,9,16,15,18,15,19,5,0,99
2,9,16,15,18,15,21,19,0,115
2,9,16,18,9,19,13,0,0,86
2,25,16,18,15,4,21,3,20,124
2,9,16,18,15,14,7,0,0,81
2,9,16,21,14,3,20,1,12,98
2,9,17,21,1,18,20,26,0,114
2,9,18,1,3,9,1,12,0,55
2,9,18,1,4,9,1,12,0,56
2,9,18,1,4,9,1,20,5,69
2,9,18,1,13,15,19,5,0,82
2,9,18,1,13,15,21,19,0,98
2,9,18,3,8,2,1,18,11,72
2,9,18,3,8,5,4,0,0,49
2,9,18,3,8,5,14,0,0,59
2,9,18,3,8,5,18,19,0,82
2,9,18,3,8,9,14,7,0,70
2,9,18,3,8,13,1,14,0,68
2,9,18,4,2,1,20,8,0,64
2,9,18,4,2,1,20,8,19,83
2,9,18,4,2,5,18,18,25,101
2,9,18,4,2,18,1,9,14,77
2,9,18,4,3,1,7,5,0,49
2,9,18,4,3,1,7,5,19,68
2,9,18,4,3,1,12,12,0,61
2,9,18,4,3,1,12,12,19,80
2,9,18,4,3,18,1,6,20,81
2,9,18,4,4,15,13,0,0,65
2,9,18,4,5,0,0,0,0,38
2,9,18,4,5,4,0,0,0,42
2,9,18,4,5,5,14,0,0,57
2,9,18,4,5,18,0,0,0,56
2,9,18,4,5,18,19,0,0,75
2,9,18,4,6,1,18,13,0,71
2,9,18,4,6,1,18,13,19,90
2,9,18,4,7,12,21,5,0,78
2,9,18,4,8,15,15,4,0,75
2,9,18,4,8,15,21,19,5,101
2,9,18,4,25,0,0,0,0,58
2,9,18,4,25,2,1,3,11,75
2,9,18,4,9,5,4,0,0,51
2,9,18,4,9,5,9,14,7,77
2,9,18,4,9,5,19,0,0,66
2,9,18,4,9,11,9,14,0,76
2,9,18,4,9,14,7,0,0,63
2,9,18,4,9,14,7,19,0,82
2,9,18,4,12,1,14,4,0,64
2,9,18,4,12,5,19,19,0,88
2,9,18,4,12,5,20,0,0,70
2,9,18,4,12,9,6,5,0,65
2,9,18,4,12,9,11,5,0,70
2,9,18,4,12,9,13,5,0,72
2,9,18,4,12,9,13,5,4,76
2,9,18,4,12,9,13,5,19,91
2,9,18,4,12,9,14,7,0,75
2,9,18,4,12,15,18,5,0,83
2,9,18,4,13,1,14,0,0,61
2,9,18,4,13,5,14,0,0,65
2,9,18,4,14,5,19,20,0,91
2,9,18,4,19,1,12,12,0,77
2,9,18,4,19,5,5,4,0,66
2,9,18,4,19,5,5,4,19,85
2,9,18,4,19,5,25,5,19,106
2,9,18,4,19,8,15,20,0,95
2,9,18,4,19,8,15,20,19,114
2,9,18,4,19,14,5,19,20,110
2,9,18,4,19,15,14,7,0,88
2,9,18,4,19,20,15,14,5,106
2,9,18,4,23,1,20,3,8,88
2,9,18,4,23,5,5,4,0,70
2,9,18,4,23,9,19,5,0,89
2,9,18,4,23,15,13,1,14,99
2,9,18,4,23,15,13,5,14,103
2,25,18,5,0,0,0,0,0,50
2,25,18,5,13,1,14,0,0,78
2,9,18,5,13,5,0,0,0,52
2,9,18,5,13,5,19,0,0,71
2,25,18,5,19,0,0,0,0,69
2,9,18,5,20,20,1,0,0,75
2,9,18,5,20,20,1,19,0,94
2,25,18,5,23,1,18,4,19,115
2,25,18,5,23,15,13,1,14,116
2,9,18,7,1,14,4,0,0,55
2,9,18,9,0,0,0,0,0,38
2,9,18,9,1,14,9,0,0,62
2,9,18,9,2,1,0,0,0,41
2,9,18,9,13,15,19,5,0,90
2,9,18,11,5,14,0,0,0,59
2,9,18,11,25,0,0,0,0,65
2,9,18,11,9,5,0,0,0,54
2,9,18,11,9,5,19,0,0,73
2,9,18,11,19,0,0,0,0,59
2,9,18,12,0,0,0,0,0,41
2,25,18,12,1,4,25,0,0,87
2,25,18,12,1,11,9,14,0,92
2,25,18,12,1,23,0,0,0,81
2,25,18,12,1,23,13,1,14,109
2,25,18,12,1,23,13,5,14,113
2,9,18,12,5,0,0,0,0,46
2,9,18,12,5,4,0,0,0,50
2,25,18,12,5,4,0,0,0,66
2,9,18,12,5,18,0,0,0,64
2,9,18,12,5,18,19,0,0,83
2,9,18,12,5,19,0,0,0,65
2,9,18,12,9,5,0,0,0,55
2,9,18,12,9,5,13,1,14,83
2,9,18,12,9,14,7,0,0,71
2,25,18,12,9,14,7,0,0,87
2,9,18,12,9,14,7,19,0,90
2,9,18,12,9,14,14,0,0,78
2,9,18,12,19,0,0,0,0,60
2,25,18,12,19,0,0,0,0,76
2,9,18,13,1,0,0,0,0,43
2,9,18,14,0,0,0,0,0,43
2,9,18,14,5,0,0,0,0,48
2,9,18,14,25,0,0,0,0,68
2,25,18,14,9,5,0,0,0,73
2,25,18,14,9,5,19,0,0,92
2,25,18,15,1,4,0,0,0,65
2,25,18,15,1,4,19,0,0,84
2,9,18,15,4,15,0,0,0,63
2,9,18,15,20,1,0,0,0,65
2,9,18,18,0,0,0,0,0,47
2,9,18,18,5,4,0,0,0,56
2,9,18,18,5,20,20,1,0,93
2,9,18,18,5,20,20,1,19,112
2,9,18,18,9,0,0,0,0,56
2,25,18,18,9,0,0,0,0,72
2,9,18,18,9,14,7,0,0,77
2,9,18,18,15,20,3,8,0,93
2,9,18,18,19,0,0,0,0,66
2,9,18,18,21,19,0,0,0,87
2,25,18,18,21,19,0,0,0,103
2,9,18,19,5,0,0,0,0,53
2,9,18,19,5,19,0,0,0,72
2,9,18,19,25,0,0,0,0,73
2,9,18,19,9,20,0,0,0,77
2,9,18,19,12,5,0,0,0,65
2,9,18,20,8,0,0,0,0,57
2,9,18,20,8,2,5,4,0,68
2,9,18,20,8,4,1,25,0,87
2,9,18,20,8,4,1,25,19,106
2,9,18,20,8,4,1,20,5,87
2,9,18,20,8,4,15,13,0,89
2,9,18,20,8,5,4,0,0,66
2,9,18,20,8,25,0,0,0,82
2,9,18,20,8,9,14,7,0,87
2,9,18,20,8,12,1,14,4,88
2,9,18,20,8,12,5,19,19,112
2,9,18,20,8,13,1,18,11,100
2,9,18,20,8,13,1,20,5,96
2,9,18,20,8,18,1,20,5,101
2,9,18,20,8,18,15,15,20,125
2,9,18,20,8,19,0,0,0,76
2,9,18,20,8,23,15,18,20,133
2,25,19,0,0,0,0,0,0,46
2,9,19,1,2,15,12,0,0,60
2,9,19,1,3,3,1,20,5,63
2,9,19,1,7,18,5,0,0,61
2,9,19,1,12,20,0,0,0,63
2,9,19,1,14,14,21,1,12,93
2,9,19,1,14,20,12,5,18,100
2,9,19,2,5,5,9,20,5,76
2,9,19,3,1,3,8,1,0,46
2,9,19,3,1,25,5,14,0,78
2,9,19,3,15,20,0,0,0,68
2,9,19,3,15,20,9,14,0,91
2,9,19,3,21,9,20,0,0,83
2,9,19,3,21,9,20,18,25,126
2,9,19,3,21,9,20,19,0,102
2,9,19,3,21,20,1,20,5,100
2,9,19,5,0,0,0,0,0,35
2,9,19,5,3,20,0,0,0,58
2,9,19,5,3,20,5,4,0,67
2,9,19,5,3,20,9,14,7,88
2,9,19,5,3,20,9,15,14,96
2,9,19,5,3,20,15,18,0,91
2,9,19,5,3,20,15,18,19,110
2,9,19,5,3,20,18,9,24,109
2,9,19,5,3,20,19,0,0,77
2,9,19,5,7,13,5,14,20,94
2,9,19,5,12,12,9,1,0,69
2,9,19,5,12,12,9,21,13,102
2,25,19,5,14,0,0,0,0,65
2,9,19,5,16,20,1,20,5,97
2,9,19,5,18,9,1,12,0,75
2,9,19,5,18,9,1,20,5,88
2,9,19,5,18,18,1,20,5,97
2,9,19,5,19,0,0,0,0,54
2,9,19,5,20,0,0,0,0,55
2,9,19,5,20,15,19,5,0,94
2,9,19,5,20,15,21,19,0,110
2,9,19,5,24,5,4,0,0,68
2,9,19,5,24,20,0,0,0,79
2,9,19,5,24,21,1,12,0,93
2,9,19,5,24,21,1,12,19,112
2,9,19,5,24,21,15,21,19,135
2,9,19,8,15,16,4,15,13,101
2,9,19,8,15,16,5,4,0,78
2,9,19,8,15,16,5,19,19,112
2,9,19,8,15,16,6,21,12,108
2,9,19,8,15,16,9,14,7,99
2,9,19,8,15,16,12,5,20,106
2,9,19,8,15,16,18,9,3,99
2,9,19,8,15,16,19,0,0,88
2,9,19,9,5,0,0,0,0,44
2,9,19,9,12,9,1,3,0,64
2,9,19,9,13,9,14,5,0,80
2,9,19,9,14,21,1,20,5,100
2,9,19,11,15,16,0,0,0,72
2,9,19,11,19,0,0,0,0,60
2,9,19,12,9,14,7,19,0,91
2,25,19,13,1,12,9,20,8,109
2,9,19,13,1,14,15,12,0,85
2,9,19,13,1,18,0,0,0,62
2,9,19,13,1,18,9,14,5,90
2,9,19,13,5,0,0,0,0,48
2,9,19,13,5,18,0,0,0,66
2,9,19,13,5,20,8,25,12,113
2,9,19,13,9,12,12,1,8,85
2,9,19,13,9,20,5,0,0,77
2,9,19,13,21,20,8,0,0,92
2,9,19,13,21,20,8,1,12,105
2,9,19,13,21,20,8,9,3,104
2,9,19,13,21,20,8,25,12,129
2,9,19,13,21,20,8,19,0,111
2,9,19,13,21,20,9,20,5,118
2,9,19,14,1,7,1,0,0,53
2,9,19,14,1,7,1,19,0,72
2,9,19,15,7,14,9,15,0,90
2,9,19,15,14,0,0,0,0,59
2,9,19,15,14,1,14,20,0,94
2,9,19,15,14,19,0,0,0,78
2,9,19,15,14,20,9,14,5,107
2,25,19,16,5,12,12,0,0,91
2,9,19,16,9,14,15,19,5,108
2,9,19,16,9,14,15,21,19,124
2,9,19,16,15,18,5,0,0,84
2,9,19,16,15,18,15,21,19,134
2,9,19,17,21,5,0,0,0,73
2,9,19,17,21,5,19,0,0,92
2,9,19,17,21,5,20,20,5,118
2,25,19,19,0,0,0,0,0,65
2,9,19,19,1,2,15,12,0,79
2,25,19,19,1,12,0,0,0,78
2,9,19,19,5,12,12,9,1,88
2,9,19,19,5,24,20,0,0,98
2,9,19,19,5,24,20,21,19,138
2,25,19,19,9,0,0,0,0,74
2,25,19,19,9,14,0,0,0,88
2,25,19,19,9,14,5,0,0,93
2,9,19,19,15,0,0,0,0,64
2,25,19,19,15,9,4,0,0,93
2,25,19,19,15,12,9,20,5,126
2,9,19,19,15,14,0,0,0,78
2,9,19,19,15,14,1,20,1,100
2,25,19,19,21,19,0,0,0,105
2,25,19,19,21,19,5,19,0,129
2,9,19,20,0,0,0,0,0,50
2,9,19,20,1,2,12,5,0,70
2,25,19,20,1,14,4,5,18,108
2,9,19,20,1,20,5,0,0,76
2,9,19,20,5,18,0,0,0,73
2,9,19,20,5,18,5,4,0,82
2,9,19,20,5,18,19,0,0,92
2,9,19,20,9,0,0,0,0,59
2,9,19,20,15,18,20,0,0,103
2,9,19,20,15,18,20,19,0,122
2,9,19,20,15,21,18,25,0,129
2,9,19,20,18,1,20,1,12,102
2,9,19,20,18,5,0,0,0,73
2,9,19,20,18,5,4,0,0,77
2,25,19,20,18,5,5,20,0,114
2,25,19,20,18,5,5,20,19,133
2,9,19,20,18,5,19,0,0,92
2,9,19,20,18,9,1,20,5,103
2,9,19,20,18,15,0,0,0,83
2,9,19,20,18,15,9,3,0,95
2,9,19,20,18,15,19,0,0,102
2,9,19,21,12,3,0,0,0,66
2,9,19,21,12,3,1,20,5,92
2,9,19,21,12,6,1,20,5,95
2,9,19,21,12,6,9,4,0,82
2,9,19,21,12,6,9,4,5,87
2,9,19,21,12,6,9,20,5,103
2,9,20,1,2,12,5,0,0,51
2,9,20,1,11,5,0,0,0,48
2,25,20,1,12,11,0,0,0,71
2,25,20,1,12,11,19,0,0,90
2,9,20,1,14,7,5,14,20,92
2,9,20,1,14,8,15,12,0,81
2,9,20,2,18,1,3,5,0,60
2,9,20,3,8,0,0,0,0,42
2,9,20,3,8,5,4,0,0,51
2,9,20,3,8,5,18,25,0,90
2,9,20,3,8,5,19,0,0,66
2,9,20,3,8,25,0,0,0,67
2,9,20,3,8,9,5,18,0,74
2,9,20,3,8,9,5,19,20,95
2,9,20,3,8,9,12,25,0,88
2,9,20,3,8,9,14,7,0,72
2,9,20,5,0,0,0,0,0,36
2,25,20,5,0,0,0,0,0,52
2,9,20,5,1,2,12,5,0,56
2,9,20,5,3,8,5,0,0,52
2,9,20,5,4,0,0,0,0,40
2,9,20,5,12,5,19,19,0,91
2,9,20,5,18,0,0,0,0,54
2,9,20,5,18,14,1,20,5,94
2,9,20,5,18,19,0,0,0,73
2,9,20,5,19,0,0,0,0,55
2,25,20,5,19,0,0,0,0,71
2,9,20,5,19,8,5,5,16,89
2,9,20,5,23,9,14,7,0,89
2,9,20,5,23,9,14,7,19,108
2,25,20,8,0,0,0,0,0,55
2,9,20,8,5,9,19,13,0,85
2,9,20,9,0,0,0,0,0,40
2,9,20,25,9,20,5,0,0,90
2,25,20,9,13,5,0,0,0,74
2,9,20,9,14,7,0,0,0,61
2,9,20,9,14,7,12,25,0,98
2,9,20,25,16,9,3,0,0,84
2,9,20,12,5,19,19,0,0,86
2,9,20,13,1,16,0,0,0,61
2,9,20,13,1,16,16,5,4,86
2,9,20,15,0,0,0,0,0,46
2,9,20,15,12,25,12,0,0,95
2,9,20,15,14,1,12,0,0,73
2,9,20,15,18,5,0,0,0,69
2,25,20,15,23,14,9,20,5,133
2,9,20,18,5,1,4,12,5,76
2,9,20,19,5,18,0,0,0,73
2,9,20,19,25,0,0,0,0,75
2,9,20,19,20,1,12,11,0,94
2,9,20,19,20,15,3,11,0,99
2,9,20,19,20,15,3,11,19,118
2,9,20,19,20,15,14,5,0,104
2,9,20,20,0,0,0,0,0,51
2,9,20,20,1,3,12,5,0,72
2,9,20,20,5,0,0,0,0,56
2,9,20,20,5,4,0,0,0,60
2,9,20,20,5,14,0,0,0,70
2,9,20,20,5,18,0,0,0,74
2,9,20,20,5,18,2,21,18,115
2,9,20,20,5,18,5,4,0,83
2,9,20,20,5,18,5,18,0,97
2,9,20,20,5,18,5,19,20,118
2,9,20,20,5,18,6,21,12,113
2,9,20,20,5,18,9,14,7,104
2,9,20,20,5,18,9,19,8,110
2,9,20,20,5,18,12,25,0,111
2,9,20,20,5,18,14,0,0,88
2,9,20,20,5,18,14,19,0,107
2,9,20,20,5,18,14,21,20,129
2,9,20,20,5,18,19,0,0,93
2,9,20,20,8,5,1,4,0,69
2,9,20,20,25,0,0,0,0,76
2,9,20,20,9,5,0,0,0,65
2,9,20,20,9,5,18,0,0,83
2,9,20,20,9,5,19,20,0,104
2,9,20,20,9,14,7,0,0,81
2,9,20,20,9,14,7,19,0,100
2,9,20,20,15,3,11,0,0,80
2,9,20,20,15,3,11,19,0,99
2,9,20,20,15,18,0,0,0,84
2,9,20,20,19,0,0,0,0,70
2,9,20,21,13,5,0,0,0,70
2,9,20,21,13,5,4,0,0,74
2,9,20,21,13,5,14,0,0,84
2,9,20,21,13,5,14,19,0,103
2,9,20,23,9,19,5,0,0,87
2,9,21,14,5,0,0,0,0,51
2,9,21,14,9,1,12,0,0,68
2,9,21,14,9,17,21,5,0,98
2,9,21,14,9,20,25,0,0,100
2,9,21,18,1,20,5,0,0,76
2,9,21,18,5,1,0,0,0,56
2,9,21,18,5,20,0,0,0,75
2,9,22,1,12,5,14,3,5,73
2,9,22,1,12,5,14,3,25,93
2,9,22,1,12,5,14,20,0,85
2,9,22,1,12,5,14,20,19,104
2,9,22,1,12,22,5,0,0,73
2,9,22,1,12,22,5,4,0,77
2,9,22,1,12,22,5,19,0,92
2,9,22,1,12,22,9,1,14,92
2,9,22,1,12,22,15,21,19,123
2,9,22,1,14,5,0,0,0,53
2,9,22,1,18,9,1,14,20,96
2,9,22,1,18,9,1,20,5,87
2,9,22,1,21,12,20,5,4,96
2,9,22,5,3,20,15,18,0,94
2,9,22,5,14,20,5,18,0,95
2,9,22,5,14,20,18,1,12,103
2,9,22,5,18,2,0,0,0,58
2,9,22,5,18,2,1,12,0,71
2,9,22,9,1,12,0,0,0,55
2,9,22,9,14,25,12,0,0,93
2,9,22,9,14,25,12,19,0,112
2,9,22,9,15,21,19,0,0,97
2,9,22,9,20,20,1,20,5,108
2,9,22,9,21,13,0,0,0,76
2,9,22,15,3,1,12,0,0,64
2,9,22,15,12,20,9,14,5,108
2,9,22,15,21,1,3,0,0,73
2,9,22,15,21,1,3,5,4,82
2,9,22,15,21,1,3,11,19,103
2,9,22,15,21,1,3,19,0,92
2,9,22,22,25,0,0,0,0,80
2,9,23,1,0,0,0,0,0,35
2,25,23,1,25,0,0,0,0,76
2,25,23,1,25,19,0,0,0,95
2,25,23,1,12,11,0,0,0,74
2,25,23,1,12,11,5,18,0,97
2,25,23,1,12,11,9,14,7,104
2,25,23,1,18,4,0,0,0,73
2,9,23,5,5,11,12,25,0,92
2,9,23,9,14,20,5,18,0,100
2,25,23,15,14,5,18,0,0,102
2,25,23,15,18,4,0,0,0,87
2,25,23,15,18,4,19,0,0,106
2,25,23,15,18,11,0,0,0,94
2,25,23,15,18,11,19,0,0,113
2,9,24,1,3,5,15,21,19,99
2,9,24,2,25,9,20,5,0,96
2,9,24,9,14,0,0,0,0,58
2,9,26,0,0,0,0,0,0,37
2,9,26,1,14,20,0,0,0,72
2,25,26,1,14,20,0,0,0,88
2,25,26,1,14,20,19,0,0,107
2,9,26,1,18,4,9,20,5,94
2,9,26,1,18,18,5,0,0,79
2,9,26,1,18,18,5,12,25,116
2,9,26,1,18,18,5,19,0,98
2,9,26,3,1,3,8,1,0,53
2,9,26,5,0,0,0,0,0,42
2,9,26,5,12,0,0,0,0,54
2,9,26,5,19,0,0,0,0,61
2,9,26,14,1,7,1,0,0,60
2,9,26,14,1,7,1,19,0,79
2,9,26,15,14,1,12,0,0,79
2,9,26,15,14,5,0,0,0,71
2,9,26,15,14,5,19,0,0,90
2,9,26,26,0,0,0,0,0,63
2,9,26,26,1,18,18,15,0,115
2,10,15,18,14,5,0,0,0,64
2,11,2,14,4,18,0,0,0,51
2,11,3,25,0,0,0,0,0,41
2,11,7,0,0,0,0,0,0,20
2,11,7,4,0,0,0,0,0,24
2,11,12,18,0,0,0,0,0,43
2,11,16,18,0,0,0,0,0,47
2,11,16,20,0,0,0,0,0,49
2,11,19,0,0,0,0,0,0,32
2,11,20,0,0,0,0,0,0,33
2,12,4,0,0,0,0,0,0,18
2,12,4,7,0,0,0,0,0,25
2,12,4,18,0,0,0,0,0,36
2,12,5,0,0,0,0,0,0,19
2,12,5,1,0,0,0,0,0,20
2,12,5,1,2,5,18,18,25,88
2,12,5,1,3,8,0,0,0,31
2,12,5,1,3,8,5,4,0,40
2,12,5,1,3,8,5,18,0,54
2,12,5,1,3,8,5,18,25,79
2,12,5,1,3,8,5,18,19,73
2,12,5,1,3,8,5,19,0,55
2,12,5,1,3,8,9,14,7,61
2,12,5,1,3,8,13,1,14,59
2,12,5,1,3,8,19,0,0,50
2,12,5,1,11,0,0,0,0,31
2,12,5,1,11,5,18,0,0,54
2,12,5,1,11,5,19,20,0,75
2,12,5,1,11,25,0,0,0,56
2,12,5,1,11,9,19,8,0,67
2,12,5,1,11,12,25,0,0,68
2,12,5,1,11,14,5,19,19,88
2,12,5,1,11,19,0,0,0,50
2,12,5,1,18,0,0,0,0,38
2,12,5,1,18,5,4,0,0,47
2,12,5,1,18,5,25,5,0,73
2,12,5,1,18,5,25,5,4,77
2,12,5,1,18,25,0,0,0,63
2,12,5,1,18,9,5,18,0,70
2,12,5,1,18,9,5,19,20,91
2,12,5,1,18,9,12,25,0,84
2,12,5,1,18,9,14,7,0,68
2,12,5,1,18,14,5,19,19,95
2,12,5,1,18,19,0,0,0,57
2,12,5,1,20,0,0,0,0,40
2,12,5,1,20,5,4,0,0,49
2,12,5,1,20,5,18,0,0,63
2,12,5,1,20,5,18,19,0,82
2,12,5,1,20,25,0,0,0,65
2,12,5,1,20,9,14,7,0,70
2,12,5,1,20,19,0,0,0,59
2,12,5,1,21,14,20,0,0,75
2,12,5,2,0,0,0,0,0,21
2,12,5,2,2,25,0,0,0,48
2,12,5,2,19,0,0,0,0,40
2,12,5,3,8,14,15,9,4,72
2,12,5,3,11,0,0,0,0,33
2,12,5,4,0,0,0,0,0,23
2,12,5,5,0,0,0,0,0,24
2,12,5,5,4,0,0,0,0,28
2,12,5,5,4,5,18,0,0,51
2,12,5,5,4,5,18,19,0,70
2,12,5,5,4,9,14,7,0,58
2,12,5,5,4,9,14,7,19,77
2,12,5,5,4,19,0,0,0,47
2,12,5,5,11,2,15,11,0,63
2,12,5,5,16,0,0,0,0,40
2,12,5,5,16,5,4,0,0,49
2,12,5,5,16,9,14,7,0,70
2,12,5,5,16,19,0,0,0,59
2,12,5,5,18,25,0,0,0,67
2,12,5,5,26,5,0,0,0,55
2,12,5,5,26,25,0,0,0,75
2,12,5,25,13,5,19,0,0,81
2,12,5,12,12,21,13,0,0,77
2,12,5,12,12,21,13,19,0,96
2,12,5,13,9,19,8,0,0,68
2,12,5,13,9,19,8,5,4,77
2,12,5,13,9,19,8,5,18,91
2,12,5,13,9,19,8,5,19,92
2,12,5,14,3,8,0,0,0,44
2,12,5,14,3,8,5,4,0,53
2,12,5,14,3,8,5,18,0,67
2,12,5,14,3,8,5,18,19,86
2,12,5,14,3,8,5,19,0,68
2,12,5,14,3,8,9,14,7,74
2,12,5,14,3,15,18,14,0,83
2,12,5,14,4,0,0,0,0,37
2,12,5,14,4,3,15,18,14,87
2,12,5,14,4,5,0,0,0,42
2,12,5,14,4,5,4,0,0,46
2,12,5,14,4,5,18,0,0,60
2,12,5,14,4,5,18,19,0,79
2,12,5,14,4,5,19,0,0,61
2,12,5,14,4,9,14,7,0,67
2,12,5,14,4,15,18,0,0,70
2,12,5,14,4,19,0,0,0,56
2,12,5,14,4,21,18,5,0,81
2,12,5,14,11,0,0,0,0,44
2,12,5,14,14,25,0,0,0,72
2,12,5,14,14,9,5,19,0,80
2,12,5,14,14,9,9,4,0,69
2,12,5,14,14,9,15,9,4,84
2,12,5,14,14,15,9,4,0,75
2,12,5,14,14,15,13,1,0,76
2,12,5,14,14,15,19,9,19,109
2,12,5,14,14,21,18,9,1,96
2,12,5,14,19,0,0,0,0,52
2,12,5,14,20,0,0,0,0,53
2,12,5,15,0,0,0,0,0,34
2,12,5,15,13,25,3,9,14,98
2,12,5,16,8,1,18,1,0,63
2,12,5,16,8,1,18,1,12,75
2,12,5,18,5,0,0,0,0,42
2,12,5,19,2,15,11,0,0,66
2,12,5,19,2,15,11,19,0,85
2,12,5,19,2,21,3,11,0,75
2,12,5,19,2,21,3,11,19,94
2,12,5,19,13,15,12,0,0,78
2,12,5,19,19,0,0,0,0,57
2,12,5,19,19,5,0,0,0,62
2,12,5,19,19,5,4,0,0,66
2,12,5,19,19,5,4,5,18,89
2,12,5,19,19,5,4,12,25,103
2,12,5,19,19,5,18,0,0,80
2,12,5,19,19,5,18,19,0,99
2,12,5,19,19,5,19,0,0,81
2,12,5,19,19,9,14,7,19,106
2,12,5,19,20,0,0,0,0,58
2,12,5,20,0,0,0,0,0,39
2,12,5,20,8,5,0,0,0,52
2,12,5,20,8,5,18,0,0,70
2,12,5,20,8,5,18,5,4,79
2,12,5,20,8,5,18,19,0,89
2,12,5,20,15,14,9,19,13,109
2,12,5,20,19,0,0,0,0,58
2,12,5,20,20,5,4,0,0,68
2,12,5,20,20,9,14,7,0,89
2,12,5,21,0,0,0,0,0,40
2,12,5,23,0,0,0,0,0,42
2,12,5,23,9,20,19,0,0,90
2,12,9,1,21,20,0,0,0,65
2,12,9,2,5,0,0,0,0,30
2,12,9,3,11,0,0,0,0,37
2,12,9,3,11,5,25,0,0,67
2,12,9,3,11,5,25,19,0,86
2,12,9,3,11,25,0,0,0,62
2,12,9,3,11,9,5,0,0,51
2,12,9,3,11,9,5,19,0,70
2,12,9,5,18,0,0,0,0,46
2,12,9,5,19,20,0,0,0,67
2,12,9,7,8,20,5,4,0,67
2,12,9,7,8,20,5,18,0,81
2,12,9,7,8,20,5,18,19,100
2,12,9,7,8,20,9,5,19,91
2,12,9,7,8,20,9,14,7,88
2,12,9,7,8,20,19,0,0,77
2,12,9,10,22,5,18,0,0,78
2,12,9,13,2,9,14,7,0,68
2,12,9,13,5,25,0,0,0,66
2,12,9,13,25,0,0,0,0,61
2,12,9,13,16,9,19,8,0,88
2,12,9,13,16,19,0,0,0,71
2,12,9,14,0,0,0,0,0,37
2,12,9,14,4,0,0,0,0,41
2,12,9,14,4,1,7,5,0,54
2,12,9,14,4,1,7,5,19,73
2,12,9,14,4,2,1,12,12,68
2,12,9,14,4,3,1,20,0,65
2,12,9,14,4,5,4,0,0,50
2,12,9,14,4,5,4,12,25,87
2,12,9,14,4,5,25,5,19,95
2,12,9,14,4,5,18,0,0,64
2,12,9,14,4,5,18,19,0,83
2,12,9,14,4,5,19,20,0,85
2,12,9,14,4,6,1,19,20,87
2,12,9,14,4,6,9,19,8,83
2,12,9,14,4,6,15,12,4,78
2,12,9,14,4,9,14,7,0,71
2,12,9,14,4,9,19,8,0,77
2,12,9,14,4,9,19,13,0,82
2,12,9,14,4,12,5,19,19,96
2,12,9,14,4,12,25,0,0,78
2,12,9,14,4,12,9,14,7,83
2,12,9,14,4,13,1,14,0,69
2,12,9,14,4,14,5,19,19,98
2,12,9,14,4,19,0,0,0,60
2,12,9,14,4,23,5,5,4,78
2,12,9,14,4,23,15,18,13,110
2,12,9,14,7,5,18,0,0,67
2,12,9,14,9,0,0,0,0,46
2,12,9,14,25,0,0,0,0,62
2,12,9,14,9,19,0,0,0,65
2,12,9,14,11,0,0,0,0,48
2,12,9,14,11,1,18,4,0,71
2,12,9,14,11,1,18,4,19,90
2,12,9,14,11,5,4,0,0,57
2,12,9,14,11,5,18,0,0,71
2,12,9,14,11,5,18,5,4,80
2,12,9,14,11,5,18,19,0,90
2,12,9,14,11,25,0,0,0,73
2,12,9,14,11,9,14,7,0,78
2,12,9,14,11,19,0,0,0,67
2,12,9,14,20,5,18,0,0,80
2,12,9,14,20,26,0,0,0,83
2,12,9,14,20,26,5,0,0,88
2,12,9,14,20,26,5,19,0,107
2,12,9,16,0,0,0,0,0,39
2,12,25,16,5,0,0,0,0,60
2,12,25,16,5,19,0,0,0,79
2,12,9,16,16,5,4,0,0,64
2,12,9,16,16,5,18,19,0,97
2,12,9,16,16,9,14,7,0,85
2,12,9,16,19,0,0,0,0,58
2,12,9,18,20,0,0,0,0,61
2,12,9,19,19,5,4,0,0,70
2,12,9,19,19,5,19,0,0,85
2,12,9,19,19,6,21,12,0,100
2,12,9,19,19,9,14,7,0,91
2,12,9,19,19,12,5,19,19,116
2,12,9,19,19,15,13,0,0,89
2,12,9,19,20,0,0,0,0,62
2,12,9,19,20,5,18,0,0,85
2,12,9,19,20,5,18,5,4,94
2,12,9,19,20,5,18,25,0,110
2,12,9,19,20,5,18,19,0,104
2,12,9,20,5,0,0,0,0,48
2,12,9,20,5,19,0,0,0,67
2,12,9,20,8,5,6,21,12,95
2,12,9,20,8,5,12,25,0,93
2,12,9,20,8,5,14,0,0,70
2,12,9,20,8,5,18,0,0,74
2,12,9,20,8,5,18,5,4,83
2,12,9,20,8,5,18,19,0,93
2,12,9,20,8,5,19,20,0,95
2,12,9,20,20,5,18,0,0,86
2,12,9,20,26,5,4,0,0,78
2,12,9,20,26,5,19,0,0,93
2,12,9,20,26,9,14,7,0,99
2,12,9,26,26,0,0,0,0,75
2,12,9,26,26,1,18,4,0,98
2,12,9,26,26,1,18,4,25,123
2,12,9,26,26,1,18,4,19,117
2,12,11,0,0,0,0,0,0,25
2,12,11,19,9,26,5,0,0,84
2,12,15,0,0,0,0,0,0,29
2,12,15,1,20,0,0,0,0,50
2,12,15,1,20,5,4,0,0,59
2,12,15,1,20,5,18,0,0,73
2,12,15,1,20,5,18,19,0,92
2,12,15,1,20,9,14,7,0,80
2,12,15,1,20,19,0,0,0,69
2,12,15,2,0,0,0,0,0,31
2,12,15,2,2,5,4,0,0,42
2,12,15,2,2,5,18,0,0,56
2,12,15,2,2,25,0,0,0,58
2,12,15,2,2,9,5,18,0,65
2,12,15,2,2,9,5,19,20,86
2,12,15,2,2,9,14,7,0,63
2,12,15,3,0,0,0,0,0,32
2,12,15,3,1,7,5,0,0,45
2,12,15,3,11,1,4,5,0,53
2,12,15,3,11,1,4,5,4,57
2,12,15,3,11,1,4,5,18,71
2,12,15,3,11,1,4,5,19,72
2,12,15,3,11,1,7,5,0,56
2,12,15,3,11,1,7,5,19,75
2,12,15,3,11,5,4,0,0,52
2,12,15,3,11,5,18,19,0,85
2,12,15,3,11,8,5,1,4,61
2,12,15,3,11,8,15,12,5,83
2,12,15,3,11,25,0,0,0,68
2,12,15,3,11,9,5,18,0,75
2,12,15,3,11,9,5,19,20,96
2,12,15,3,11,9,14,7,0,73
2,12,15,3,11,9,19,8,0,79
2,12,15,3,11,12,9,11,5,80
2,12,15,3,11,12,9,14,5,83
2,12,15,3,11,13,1,14,0,71
2,12,15,3,11,15,21,20,0,99
2,12,15,3,11,16,1,20,5,85
2,12,15,3,11,19,0,0,0,62
2,12,15,3,11,19,8,9,16,95
2,12,15,3,11,23,15,15,4,100
2,12,15,3,19,0,0,0,0,51
2,12,15,4,9,20,5,0,0,67
2,12,15,5,4,9,20,5,0,72
2,12,15,11,5,0,0,0,0,45
2,12,15,11,5,19,0,0,0,64
2,12,15,12,12,25,0,0,0,78
2,12,15,13,1,14,0,0,0,57
2,12,15,14,4,0,0,0,0,47
2,12,15,14,4,5,0,0,0,52
2,12,15,14,4,5,18,0,0,70
2,12,15,14,4,5,19,0,0,71
2,12,15,14,4,5,19,20,0,91
2,12,15,14,4,9,14,5,0,75
2,12,15,14,4,9,19,8,0,83
2,12,15,14,4,14,5,19,19,104
2,12,15,14,4,19,0,0,0,66
2,12,15,15,4,1,12,16,0,77
2,12,15,15,4,2,1,20,8,79
2,12,15,15,4,2,5,1,20,76
2,12,15,15,4,2,9,18,4,81
2,12,15,15,4,4,18,15,16,101
2,12,15,15,4,5,4,0,0,57
2,12,15,15,4,6,9,14,0,77
2,12,15,15,4,6,9,14,19,96
2,12,15,15,4,25,0,0,0,73
2,12,15,15,4,9,5,4,0,66
2,12,15,15,4,9,5,18,0,80
2,12,15,15,4,9,5,19,0,81
2,12,15,15,4,9,5,19,20,101
2,12,15,15,4,25,9,14,7,103
2,12,15,15,4,9,12,25,0,94
2,12,15,15,4,9,14,7,0,78
2,12,15,15,4,9,14,7,19,97
2,12,15,15,4,12,5,1,6,72
2,12,15,15,4,12,5,19,19,103
2,12,15,15,4,12,9,11,5,85
2,12,15,15,4,12,9,14,5,88
2,12,15,15,4,12,21,19,20,120
2,12,15,15,4,14,15,21,14,112
2,12,15,15,4,18,5,4,0,75
2,12,15,15,4,18,9,16,5,96
2,12,15,15,4,18,15,15,20,116
2,12,15,15,4,19,0,0,0,67
2,12,15,15,4,19,8,5,4,84
2,12,15,15,4,19,8,15,20,110
2,12,15,15,4,19,21,3,11,102
2,12,15,15,4,20,5,19,20,112
2,12,15,15,4,23,5,5,4,85
2,12,15,15,4,23,9,20,0,100
2,12,15,15,4,23,9,20,5,105
2,12,15,15,4,23,15,15,4,105
2,12,15,15,4,23,15,18,13,117
2,12,15,15,4,23,15,18,20,124
2,12,15,15,5,25,0,0,0,74
2,12,15,15,9,5,0,0,0,58
2,12,15,15,13,1,7,5,0,70
2,12,15,15,13,5,4,0,0,66
2,12,15,15,13,5,18,19,0,99
2,12,15,15,13,6,5,12,12,92
2,12,15,15,13,25,0,0,0,82
2,12,15,15,13,9,5,18,0,89
2,12,15,15,13,9,5,19,20,110
2,12,15,15,13,9,14,7,0,87
2,12,15,15,13,11,9,14,0,91
2,12,15,15,13,12,5,19,19,112
2,12,15,15,13,19,0,0,0,76
2,12,15,15,16,0,0,0,0,60
2,12,15,15,16,5,4,0,0,69
2,12,15,15,16,5,18,0,0,83
2,12,15,15,16,5,18,19,0,102
2,12,15,15,16,9,14,7,0,90
2,12,15,15,16,19,0,0,0,79
2,12,15,15,20,8,0,0,0,72
2,12,15,18,5,0,0,0,0,52
2,12,15,19,13,25,0,0,0,86
2,12,15,19,19,15,13,5,4,104
2,12,15,19,19,15,13,25,0,120
2,12,15,19,19,15,13,18,25,138
2,12,15,19,19,15,13,19,0,114
2,12,15,20,0,0,0,0,0,49
2,12,15,20,3,8,0,0,0,60
2,12,15,20,3,8,5,4,0,69
2,12,15,20,3,8,5,19,0,84
2,12,15,20,3,8,25,0,0,85
2,12,15,20,3,8,9,5,18,92
2,12,15,20,3,8,9,12,25,106
2,12,15,20,3,8,9,14,7,90
2,12,15,20,5,0,0,0,0,54
2,12,15,20,12,5,19,19,0,104
2,12,15,20,19,0,0,0,0,68
2,12,15,20,20,5,4,0,0,78
2,12,15,20,20,5,18,0,0,92
2,12,15,20,20,5,18,19,0,111
2,12,15,20,20,25,0,0,0,94
2,12,15,20,20,9,5,18,0,101
2,12,15,20,20,9,5,19,20,122
2,12,15,20,20,9,14,7,0,99
2,12,15,20,20,15,0,0,0,84
2,12,15,20,20,20,15,0,0,104
2,12,15,21,19,5,0,0,0,74
2,12,15,21,19,5,4,0,0,78
2,12,15,21,19,5,19,0,0,93
2,12,15,21,19,25,0,0,0,94
2,12,15,21,19,9,5,18,0,101
2,12,15,21,19,9,5,19,20,122
2,12,15,21,19,9,12,25,0,115
2,12,15,21,19,9,14,7,0,99
2,12,15,21,19,15,14,0,0,98
2,12,15,21,19,15,14,19,0,117
2,12,15,21,20,0,0,0,0,70
2,12,15,22,9,1,20,5,0,86
2,12,15,22,9,1,20,5,4,90
2,12,15,22,9,1,20,5,19,105
2,12,15,23,2,1,3,11,0,69
2,12,15,23,2,1,3,11,19,88
2,12,15,23,2,1,12,12,0,79
2,12,15,23,2,1,12,12,19,98
2,12,15,23,2,25,0,0,0,79
2,12,15,23,2,25,19,0,0,98
2,12,15,23,3,1,19,5,0,80
2,12,15,23,3,15,3,11,0,84
2,12,15,23,4,15,23,14,0,108
2,12,15,23,5,4,0,0,0,61
2,12,15,23,5,14,0,0,0,71
2,12,15,23,5,18,0,0,0,75
2,12,15,23,5,18,19,0,0,94
2,12,15,23,5,19,19,0,0,95
2,12,15,23,6,9,19,8,0,94
2,12,15,23,6,12,25,0,0,95
2,12,15,23,6,12,9,5,19,103
2,12,15,23,7,21,14,0,0,94
2,12,15,23,7,21,14,19,0,113
2,12,15,23,8,1,18,4,0,83
2,12,15,23,8,1,18,4,19,102
2,12,15,23,8,15,12,5,0,92
2,12,15,23,8,15,12,5,19,111
2,12,15,23,25,0,0,0,0,77
2,12,15,23,9,5,0,0,0,66
2,12,15,23,9,5,18,0,0,84
2,12,15,23,9,5,19,20,0,105
2,12,15,23,9,14,5,19,19,118
2,12,15,23,9,14,7,0,0,82
2,12,15,23,9,14,7,19,0,101
2,12,15,23,9,18,15,14,0,108
2,12,15,23,10,15,2,0,0,79
2,12,15,23,10,15,2,19,0,98
2,12,15,23,12,1,13,16,0,94
2,12,15,23,12,9,14,5,0,92
2,12,15,23,14,0,0,0,0,66
2,12,15,23,15,6,6,0,0,79
2,12,15,23,15,6,6,19,0,98
2,12,15,23,15,21,20,0,0,108
2,12,15,23,15,21,20,19,0,127
2,12,15,23,16,9,16,5,0,98
2,12,15,23,16,9,16,5,19,117
2,12,15,23,16,9,20,0,0,97
2,12,15,23,16,15,9,14,20,126
2,12,15,23,16,18,15,15,6,122
2,12,15,23,19,0,0,0,0,71
2,12,15,23,19,5,0,0,0,76
2,12,15,23,19,5,4,0,0,80
2,12,15,23,19,25,0,0,0,96
2,12,15,23,19,9,5,18,0,103
2,12,15,23,19,9,5,19,20,124
2,12,15,23,19,9,12,25,0,117
2,12,15,23,19,16,18,1,25,131
2,12,15,23,20,8,0,0,0,80
2,12,15,23,20,15,18,3,8,116
2,12,15,23,20,21,2,5,0,100
2,12,15,23,20,21,2,5,19,119
2,12,15,23,21,16,0,0,0,89
2,12,15,23,21,16,19,0,0,108
2,12,15,23,26,5,0,0,0,83
2,12,15,23,26,5,4,0,0,87
2,12,15,23,26,25,0,0,0,103
2,12,15,23,26,9,5,18,0,110
2,12,15,23,26,9,5,19,20,131
2,12,15,23,26,9,12,25,0,124
2,12,15,23,26,9,14,7,0,108
2,12,21,2,0,0,0,0,0,37
2,12,21,2,2,5,4,0,0,48
2,12,21,2,2,5,18,0,0,62
2,12,21,2,2,5,18,5,4,71
2,12,21,2,2,5,18,5,18,85
2,12,21,2,2,5,18,25,0,87
2,12,21,2,2,5,18,19,0,81
2,12,21,2,2,9,14,7,0,69
2,12,21,3,8,5,18,19,0,88
2,12,21,4,7,5,0,0,0,51
2,12,21,4,7,5,4,0,0,55
2,12,21,4,7,5,15,14,0,80
2,12,21,4,7,5,15,14,19,99
2,12,21,4,7,5,18,0,0,69
2,12,21,4,7,9,14,7,0,76
2,12,21,5,2,1,3,11,0,57
2,12,21,5,2,1,12,12,19,86
2,12,21,5,2,5,1,4,0,52
2,12,21,5,2,5,12,12,19,90
2,12,21,5,2,5,18,18,25,108
2,12,21,5,2,9,12,12,0,75
2,12,21,5,2,9,12,12,19,94
2,12,21,5,2,9,18,4,0,73
2,12,21,5,2,9,18,4,19,92
2,12,21,5,2,12,1,3,11,69
2,12,21,5,2,12,1,23,0,78
2,12,21,5,2,12,15,15,4,88
2,12,21,5,2,15,15,11,0,83
2,12,21,5,2,15,15,11,19,102
2,12,21,5,2,21,3,11,0,77
2,12,21,5,2,21,19,8,0,90
2,12,21,5,3,1,16,0,0,60
2,12,21,5,3,1,16,19,0,79
2,12,21,5,3,15,1,20,0,79
2,12,21,5,3,15,1,20,19,98
2,12,21,5,3,21,16,0,0,80
2,12,21,5,3,21,18,12,19,113
2,12,21,5,4,0,0,0,0,44
2,12,21,5,6,9,14,0,0,69
2,12,21,5,6,9,14,19,0,88
2,12,21,5,6,9,19,8,0,82
2,12,21,5,7,9,12,12,0,80
2,12,21,5,7,9,12,12,19,99
2,12,21,5,7,15,23,14,0,99
2,12,21,5,7,18,1,19,19,104
2,12,21,5,7,21,13,0,0,81
2,12,21,5,7,21,13,19,0,100
2,12,21,5,8,5,1,4,0,58
2,12,21,5,8,5,1,4,19,77
2,12,21,5,9,14,7,0,0,70
2,12,21,5,9,14,7,19,0,89
2,12,21,5,25,19,0,0,0,84
2,12,21,5,9,19,8,0,0,76
2,12,21,5,10,1,3,11,0,65
2,12,21,5,10,1,3,11,19,84
2,12,21,5,10,1,25,19,0,95
2,12,21,5,10,15,9,14,20,108
2,12,21,5,12,5,7,0,0,64
2,12,21,5,12,5,7,19,0,83
2,12,21,5,12,25,0,0,0,77
2,12,21,5,12,9,14,5,0,80
2,12,21,5,12,9,14,5,19,99
2,12,21,5,14,5,19,19,0,97
2,12,21,5,14,15,19,5,0,93
2,12,21,5,14,15,19,5,4,97
2,12,21,5,14,15,19,5,19,112
2,12,21,5,16,15,9,14,20,114
2,12,21,5,16,18,9,14,20,117
2,12,21,5,18,0,0,0,0,58
2,12,21,5,19,0,0,0,0,59
2,12,21,5,19,25,0,0,0,84
2,12,21,5,19,9,4,5,19,96
2,12,21,5,19,9,5,18,0,91
2,12,21,5,19,13,1,14,0,87
2,12,21,5,19,13,5,14,0,91
2,12,21,5,19,20,0,0,0,79
2,12,21,5,19,20,5,13,0,97
2,12,21,5,19,20,5,13,19,116
2,12,21,5,19,20,15,14,5,113
2,12,21,5,20,8,0,0,0,68
2,12,21,5,20,9,3,11,0,83
2,12,21,5,20,9,20,0,0,89
2,12,21,5,20,15,16,0,0,91
2,12,21,5,20,15,16,19,0,110
2,12,21,5,20,19,0,0,0,79
2,12,21,5,23,5,5,4,0,77
2,12,21,5,23,5,5,4,19,96
2,12,21,5,23,9,14,7,0,93
2,12,21,5,23,15,15,4,0,97
2,12,21,5,23,15,15,4,19,116
2,12,21,6,6,0,0,0,0,47
2,12,21,6,6,1,2,12,5,67
2,12,21,6,6,5,4,0,0,56
2,12,21,6,6,5,18,0,0,70
2,12,21,6,6,5,18,19,0,89
2,12,21,6,6,5,19,20,0,91
2,12,21,6,6,25,0,0,0,72
2,12,21,6,6,9,14,7,0,77
2,12,21,6,6,12,25,0,0,84
2,12,21,6,6,14,5,19,19,104
2,12,21,6,20,5,18,0,0,84
2,12,21,7,7,25,0,0,0,74
2,12,21,9,14,7,0,0,0,65
2,12,21,9,14,7,19,0,0,84
2,12,21,9,19,8,0,0,0,71
2,12,21,9,19,13,0,0,0,76
2,12,21,9,19,14,5,19,19,120
2,12,21,13,5,0,0,0,0,53
2,12,21,13,5,4,0,0,0,57
2,12,21,13,5,19,0,0,0,72
2,12,21,13,9,14,7,0,0,78
2,12,21,14,4,5,18,0,0,76
2,12,21,14,4,5,18,5,4,85
2,12,21,14,4,5,18,5,18,99
2,12,21,14,4,5,18,19,0,95
2,12,21,14,7,5,0,0,0,61
2,12,21,14,7,5,4,0,0,65
2,12,21,14,7,5,18,0,0,79
2,12,21,14,7,5,18,19,0,98
2,12,21,14,7,5,19,0,0,80
2,12,21,14,7,9,14,7,0,86
2,12,21,14,11,5,18,0,0,83
2,12,21,14,11,5,20,0,0,85
2,12,21,14,11,19,0,0,0,79
2,12,21,14,14,5,14,0,0,82
2,12,21,14,20,5,4,0,0,78
2,12,21,14,20,5,18,0,0,92
2,12,21,14,20,5,19,20,0,113
2,12,21,14,20,8,5,1,4,87
2,12,21,14,20,9,5,0,0,83
2,12,21,14,20,9,14,7,0,99
2,12,21,14,20,9,19,8,0,105
2,12,21,14,20,12,25,0,0,106
2,12,21,14,20,14,5,19,19,126
2,12,21,14,20,19,0,0,0,88
2,12,21,16,0,0,0,0,0,51
2,12,21,18,0,0,0,0,0,53
2,12,21,18,2,0,0,0,0,55
2,12,21,18,2,5,4,0,0,64
2,12,21,18,2,9,14,7,0,85
2,12,21,18,2,9,19,20,0,103
2,12,21,18,2,19,0,0,0,74
2,12,21,18,16,9,14,7,0,99
2,12,21,18,18,5,4,0,0,80
2,12,21,18,18,5,4,12,25,117
2,12,21,18,18,5,18,0,0,94
2,12,21,18,18,25,0,0,0,96
2,12,21,18,18,9,5,18,0,103
2,12,21,18,18,9,5,19,20,124
2,12,21,18,18,9,12,25,0,117
2,12,21,18,18,9,14,7,0,101
2,12,21,18,19,0,0,0,0,72
2,12,21,18,20,0,0,0,0,73
2,12,21,18,20,5,4,0,0,82
2,12,21,18,20,5,18,0,0,96
2,12,21,18,20,5,18,19,0,115
2,12,21,18,20,9,14,7,0,103
2,12,21,18,20,19,0,0,0,92
2,12,21,19,8,0,0,0,0,62
2,12,21,19,8,5,4,0,0,71
2,12,21,19,8,5,18,0,0,85
2,12,21,19,8,5,18,19,0,104
2,12,21,19,8,5,19,0,0,86
2,12,21,19,8,5,20,0,0,87
2,12,21,19,8,6,21,12,0,101
2,12,21,19,8,25,0,0,0,87
2,12,21,19,8,9,14,7,0,92
2,12,21,19,8,12,5,19,19,117
2,12,21,19,8,20,0,0,0,82
2,12,21,19,8,23,15,18,20,138
2,12,21,19,20,5,18,0,0,97
2,12,21,19,20,5,18,5,4,106
2,12,21,19,20,5,18,5,18,120
2,12,21,19,20,5,18,25,0,122
2,12,21,19,20,5,18,19,0,116
2,12,21,20,23,21,18,19,20,156
2,15,2,1,0,0,0,0,0,20
2,15,2,1,3,0,0,0,0,23
2,15,2,1,3,8,5,0,0,36
2,15,2,1,3,8,5,5,0,41
2,15,2,1,14,3,5,0,0,42
2,15,2,2,5,4,0,0,0,30
2,15,2,2,5,10,1,1,14,52
2,15,2,2,5,18,0,0,0,44
2,15,2,2,5,18,25,0,0,69
2,15,2,2,5,18,9,5,19,77
2,15,2,2,5,18,19,0,0,63
2,15,2,2,9,5,19,0,0,54
2,15,2,2,9,14,0,0,0,44
2,15,2,2,9,14,5,18,0,67
2,15,2,2,9,14,5,20,0,69
2,15,2,2,9,14,5,20,19,88
2,15,2,2,9,14,7,0,0,51
2,15,2,2,9,14,19,0,0,63
2,15,2,2,9,19,8,0,0,57
2,15,2,2,9,19,8,12,25,94
2,15,2,2,12,5,0,0,0,38
2,15,2,2,12,5,4,0,0,42
2,15,2,2,12,5,19,0,0,57
2,15,2,2,12,9,14,7,0,63
2,15,2,3,1,20,0,0,0,43
2,15,2,3,1,20,19,0,0,62
2,15,2,3,15,1,20,0,0,58
2,15,2,5,3,8,5,0,0,40
2,15,2,5,3,8,5,19,0,59
2,15,2,5,20,0,0,0,0,44
2,15,2,6,12,25,0,0,0,62
2,15,2,6,12,9,5,19,0,70
2,15,2,6,12,15,1,20,0,73
2,15,2,10,5,18,15,13,0,80
2,15,2,12,5,20,0,0,0,56
2,15,2,15,12,0,0,0,0,46
2,15,2,15,12,9,14,11,0,80
2,15,2,15,12,9,14,11,19,99
2,15,2,15,15,20,9,0,0,78
2,15,2,15,20,5,5,0,0,64
2,15,2,15,20,9,5,0,0,68
2,15,2,15,23,12,5,18,0,92
2,15,2,19,0,0,0,0,0,38
2,15,2,19,12,5,4,0,0,59
2,15,2,19,12,5,4,5,4,68
2,15,2,19,12,5,4,19,0,78
2,15,2,19,12,5,9,7,8,79
2,15,2,19,20,1,25,0,0,84
2,15,2,19,20,1,25,19,0,103
2,15,2,20,1,9,12,0,0,61
2,15,2,20,1,9,12,5,4,70
2,15,2,20,1,9,12,19,0,80
2,15,2,23,8,9,20,5,19,103
2,15,2,23,15,15,4,0,0,76
2,15,3,1,3,3,9,15,0,51
2,15,3,1,3,3,9,15,19,70
2,15,3,1,7,5,0,0,0,33
2,15,3,1,12,0,0,0,0,33
2,15,3,1,18,4,15,0,0,58
2,15,3,1,19,9,14,0,0,63
2,15,3,1,19,9,14,5,0,68
2,15,3,3,1,0,0,0,0,24
2,15,3,3,1,12,5,0,0,41
2,15,3,3,1,18,15,0,0,57
2,15,3,3,5,0,0,0,0,28
2,15,3,3,5,19,0,0,0,47
2,15,3,3,9,0,0,0,0,32
2,15,3,3,9,1,0,0,0,33
2,15,3,3,9,1,19,0,0,52
2,15,3,3,9,5,0,0,0,37
2,15,3,3,9,5,19,0,0,56
2,15,3,3,9,19,0,0,0,51
2,15,3,5,0,0,0,0,0,25
2,15,3,8,5,18,0,0,0,51
2,15,3,8,5,19,0,0,0,52
2,15,3,8,21,18,0,0,0,67
2,15,3,11,5,25,0,0,0,61
2,15,3,11,5,18,5,12,0,71
2,15,3,11,5,18,5,20,0,79
2,15,3,11,9,14,7,0,0,61
2,15,3,11,19,0,0,0,0,50
2,15,3,15,25,0,0,0,0,60
2,15,3,19,20,1,6,6,0,72
2,15,4,1,3,8,0,0,0,33
2,15,4,1,3,9,15,21,19,89
2,15,4,4,1,7,8,0,0,41
2,15,4,4,12,5,0,0,0,42
2,15,4,5,4,0,0,0,0,30
2,15,4,5,6,21,12,0,0,65
2,15,4,5,6,21,12,12,25,102
2,15,4,5,7,1,19,0,0,53
2,15,4,5,7,15,14,0,0,62
2,15,4,5,7,15,14,5,19,86
2,15,4,5,13,5,14,20,0,78
2,15,4,5,13,5,14,20,19,97
2,15,4,5,14,0,0,0,0,40
2,15,4,5,18,0,0,0,0,44
2,15,4,5,19,0,0,0,0,45
2,15,4,5,23,1,19,8,0,77
2,15,4,5,23,15,18,4,0,86
2,15,4,7,5,0,0,0,0,33
2,15,4,7,5,18,0,0,0,51
2,15,4,7,5,18,25,0,0,76
2,15,4,7,9,5,0,0,0,42
2,15,4,8,9,0,0,0,0,38
2,15,4,8,9,19,1,20,0,78
2,15,4,25,2,21,9,12,4,94
2,15,4,9,3,5,0,0,0,38
2,15,4,9,3,5,4,0,0,42
2,15,4,9,3,5,19,0,0,57
2,15,4,25,3,8,5,3,11,76
2,15,4,9,5,4,0,0,0,39
2,15,4,9,5,18,0,0,0,53
2,15,4,9,5,18,15,14,0,82
2,15,4,9,5,19,0,0,0,54
2,15,4,25,7,21,1,18,4,97
2,15,4,25,8,15,15,4,0,88
2,15,4,25,9,14,7,0,0,76
2,15,4,9,11,9,14,0,0,64
2,15,4,25,11,9,14,19,0,99
2,15,4,9,12,5,19,19,0,85
2,15,4,25,12,5,19,19,0,101
2,15,4,9,12,25,0,0,0,67
2,15,4,9,12,9,26,5,0,82
2,15,4,25,13,1,11,5,18,94
2,15,4,9,13,5,14,20,0,82
2,15,4,9,14,7,0,0,0,51
2,15,4,9,14,7,12,25,0,88
2,15,4,9,14,7,19,0,0,70
2,15,4,25,16,12,1,20,5,100
2,15,4,25,19,8,9,18,20,120
2,15,4,25,19,21,9,20,0,115
2,15,4,25,19,21,9,20,19,134
2,15,4,25,19,21,18,6,0,110
2,15,4,25,19,21,18,6,19,129
2,15,4,25,23,5,1,18,0,93
2,15,4,25,23,9,19,5,0,102
2,15,4,25,23,15,15,4,0,103
2,15,4,25,23,15,18,11,0,113
2,15,4,25,23,15,18,11,19,132
2,15,4,11,5,14,0,0,0,51
2,15,4,11,9,14,19,0,0,74
2,15,4,12,5,0,0,0,0,38
2,15,4,15,3,11,0,0,0,50
2,15,4,15,14,9,4,0,0,63
2,15,4,18,1,7,0,0,0,47
2,15,4,18,1,7,5,0,0,52
2,15,4,19,0,0,0,0,0,40
2,15,4,19,20,9,3,11,0,83
2,15,4,23,15,18,4,0,0,81
2,15,5,0,0,0,0,0,0,22
2,15,5,8,13,9,20,5,19,96
2,15,5,15,20,1,18,3,8,87
2,15,5,18,19,0,0,0,0,59
2,15,5,20,20,14,5,18,0,99
2,15,6,6,9,14,0,0,0,52
2,15,6,6,9,14,19,0,0,71
2,15,6,6,15,0,0,0,0,44
2,15,6,6,15,12,1,0,0,57
2,15,6,6,15,12,1,19,0,76
2,15,6,6,15,19,0,0,0,63
2,15,6,6,19,0,0,0,0,48
2,15,7,0,0,0,0,0,0,24
2,15,7,1,0,0,0,0,0,25
2,15,7,1,3,8,0,0,0,36
2,15,7,1,14,19,0,0,0,58
2,15,7,1,20,25,18,0,0,88
2,15,7,2,5,1,14,0,0,46
2,15,7,2,5,1,14,19,0,65
2,15,7,2,5,18,18,25,0,92
2,15,7,5,25,5,4,0,0,63
2,15,7,5,25,9,14,7,0,84
2,15,7,5,25,13,1,14,0,82
2,15,7,5,25,13,5,14,0,86
2,15,7,5,25,19,0,0,0,73
2,15,7,5,20,0,0,0,0,49
2,15,7,6,5,18,14,0,0,67
2,15,7,7,1,18,4,0,0,54
2,15,7,7,1,18,20,0,0,70
2,15,7,7,5,4,0,0,0,40
2,15,7,7,25,0,0,0,0,56
2,15,7,7,9,5,18,0,0,63
2,15,7,7,9,5,19,20,0,84
2,15,7,7,9,14,0,0,0,54
2,15,7,7,9,14,5,19,19,97
2,15,7,7,9,14,7,0,0,61
2,15,7,7,9,19,8,0,0,67
2,15,7,7,12,5,0,0,0,48
2,15,7,7,12,5,2,15,0,65
2,15,7,7,12,5,4,0,0,52
2,15,7,7,12,5,18,0,0,66
2,15,7,7,12,5,18,19,0,85
2,15,7,7,12,5,19,0,0,67
2,15,7,7,12,9,14,7,0,73
2,15,7,7,12,9,19,8,0,79
2,15,7,8,15,12,5,0,0,64
2,15,7,25,0,0,0,0,0,49
2,15,7,25,4,15,13,0,0,81
2,15,7,9,5,13,1,14,0,66
2,15,7,9,5,18,0,0,0,56
2,15,7,9,5,19,0,0,0,57
2,15,7,25,9,19,13,0,0,90
2,15,7,25,9,19,13,19,0,109
2,15,7,25,12,1,14,4,0,80
2,15,7,25,13,1,14,0,0,77
2,15,7,25,13,5,14,0,0,81
2,15,7,25,19,0,0,0,0,68
2,15,7,12,1,14,4,0,0,55
2,15,7,12,1,14,4,5,18,78
2,15,7,12,5,0,0,0,0,41
2,15,7,12,5,4,0,0,0,45
2,15,7,12,5,4,15,13,0,73
2,15,7,12,5,19,0,0,0,60
2,15,7,12,5,20,0,0,0,61
2,15,7,13,1,14,0,0,0,52
2,15,7,13,9,18,5,0,0,69
2,15,7,15,14,7,0,0,0,60
2,15,7,15,20,1,14,1,0,75
2,15,7,19,0,0,0,0,0,43
2,15,7,19,21,3,11,5,18,101
2,15,7,20,18,15,20,0,0,97
2,15,7,21,5,4,0,0,0,54
2,15,7,21,9,14,7,0,0,75
2,15,7,21,13,0,0,0,0,58
2,15,7,21,19,0,0,0,0,64
2,15,7,21,19,14,5,19,19,121
2,15,7,23,1,25,0,0,0,73
2,15,7,23,15,15,4,0,0,81
2,15,7,23,15,15,4,19,0,100
2,15,7,23,15,18,20,0,0,100
2,15,8,0,0,0,0,0,0,25
2,15,8,1,23,14,0,0,0,63
2,15,8,5,1,19,0,0,0,50
2,15,8,5,13,9,1,14,19,86
2,15,8,5,13,9,1,19,0,72
2,15,8,5,13,9,21,13,0,86
2,15,8,5,18,5,5,14,0,72
2,15,8,9,18,5,5,14,0,76
2,15,8,13,9,20,5,0,0,72
2,15,8,15,0,0,0,0,0,40
2,15,8,15,18,0,0,0,0,58
2,15,8,15,18,1,0,0,0,59
2,15,8,15,18,15,11,0,0,84
2,15,8,21,14,11,0,0,0,71
2,15,8,21,14,11,19,0,0,90
2,15,25,1,14,7,0,0,0,64
2,15,25,1,18,0,0,0,0,61
2,15,25,1,18,4,0,0,0,65
2,15,25,1,18,4,9,19,13,106
2,15,25,1,18,4,15,13,0,93
2,15,25,1,18,4,19,0,0,84
2,15,25,1,18,9,19,13,0,102
2,15,25,1,18,9,19,13,19,121
2,15,25,1,18,19,0,0,0,80
2,15,25,1,21,0,0,0,0,64
2,15,25,1,21,19,0,0,0,83
2,15,25,1,21,24,0,0,0,88
2,15,25,3,8,9,3,11,0,76
2,15,25,3,8,9,3,11,19,95
2,15,25,3,8,9,11,0,0,73
2,15,25,3,8,9,11,19,0,92
2,15,25,3,15,20,20,0,0,100
2,15,25,3,15,20,20,5,4,109
2,15,25,3,15,20,20,5,18,123
2,15,25,3,15,20,20,19,0,119
2,15,9,4,0,0,0,0,0,30
2,15,25,4,5,11,25,14,0,101
2,15,25,4,15,13,0,0,0,74
2,15,9,5,20,20,5,0,0,76
2,15,25,6,18,9,5,14,4,98
2,15,25,7,0,0,0,0,0,49
2,15,9,7,9,4,0,0,0,46
2,15,9,7,21,1,3,21,0,79
2,15,25,8,15,15,4,0,0,84
2,15,25,8,15,15,4,19,0,103
2,15,25,9,19,8,0,0,0,78
2,15,25,9,19,8,12,25,0,115
2,15,25,9,19,13,0,0,0,83
2,15,9,12,0,0,0,0,0,38
2,15,25,12,1,0,0,0,0,55
2,15,9,12,1,2,12,5,0,58
2,15,25,12,1,19,0,0,0,74
2,15,9,12,4,15,23,14,0,94
2,15,9,12,5,4,0,0,0,47
2,15,9,12,5,18,0,0,0,61
2,15,9,12,5,18,6,21,12,100
2,15,9,12,5,18,25,0,0,86
2,15,9,12,5,18,13,1,14,89
2,15,9,12,5,18,19,0,0,80
2,15,9,12,25,0,0,0,0,63
2,15,25,12,9,11,5,0,0,79
2,15,9,12,9,14,7,0,0,68
2,15,9,12,9,14,7,12,25,105
2,15,9,12,15,6,6,0,0,65
2,15,9,12,15,6,6,19,0,84
2,15,9,12,15,22,5,18,0,98
2,15,9,12,19,0,0,0,0,57
2,15,9,14,7,0,0,0,0,47
2,15,25,15,0,0,0,0,0,57
2,15,25,15,12,15,7,25,0,116
2,15,25,15,19,0,0,0,0,76
2,15,9,19,5,18,9,5,0,82
2,15,9,19,5,18,9,5,19,101
2,15,25,19,8,9,16,0,0,94
2,15,9,19,19,5,1,21,0,91
2,15,9,19,19,5,1,21,24,115
2,15,9,19,20,0,0,0,0,65
2,15,9,19,20,15,21,19,0,120
2,15,9,20,5,0,0,0,0,51
2,15,9,20,5,19,0,0,0,70
2,15,9,20,8,18,9,14,0,95
2,15,25,21,14,1,0,0,0,78
2,15,10,9,20,5,0,0,0,61
2,15,10,15,0,0,0,0,0,42
2,15,11,1,4,1,13,0,0,47
2,15,11,1,18,4,0,0,0,51
2,15,11,1,18,11,0,0,0,58
2,15,11,5,0,0,0,0,0,33
2,15,11,15,0,0,0,0,0,43
2,15,11,15,13,0,0,0,0,56
2,15,11,15,19,0,0,0,0,62
2,15,12,1,0,0,0,0,0,30
2,15,12,1,18,0,0,0,0,48
2,15,12,1,19,0,0,0,0,49
2,15,12,1,19,5,19,0,0,73
2,15,12,2,1,14,1,3,0,50
2,15,12,2,15,14,1,3,0,64
2,15,12,4,0,0,0,0,0,33
2,15,12,4,5,4,0,0,0,42
2,15,12,4,5,14,0,0,0,52
2,15,12,4,5,18,0,0,0,56
2,15,12,4,5,19,20,0,0,77
2,15,12,4,6,1,3,5,0,48
2,15,12,4,6,1,3,5,4,52
2,15,12,4,6,1,3,5,19,67
2,15,12,4,9,14,0,0,0,56
2,15,12,4,9,14,5,0,0,61
2,15,12,4,9,14,7,0,0,63
2,15,12,4,12,25,0,0,0,70
2,15,12,4,14,5,19,19,0,90
2,15,12,4,15,0,0,0,0,48
2,15,12,4,15,9,14,5,0,76
2,15,12,4,15,19,0,0,0,67
2,15,12,5,0,0,0,0,0,34
2,15,12,5,3,20,9,15,14,95
2,15,12,5,4,0,0,0,0,38
2,15,12,5,9,20,5,0,0,68
2,15,12,5,12,9,11,5,0,71
2,15,12,5,18,15,0,0,0,67
2,15,12,5,18,15,19,0,0,86
2,15,12,5,20,5,0,0,0,59
2,15,12,5,20,5,19,0,0,78
2,15,12,5,20,9,0,0,0,63
2,15,12,5,20,9,3,0,0,66
2,15,12,5,20,21,19,5,19,118
2,15,12,5,23,5,5,4,0,71
2,15,12,5,23,15,18,20,0,110
2,15,12,9,3,8,5,0,0,54
2,15,12,9,4,5,0,0,0,47
2,15,12,9,4,5,19,0,0,66
2,15,12,9,13,2,1,0,0,54
2,15,12,9,19,0,0,0,0,57
2,15,12,9,20,1,0,0,0,59
2,15,12,9,22,1,18,5,19,103
2,15,12,9,22,1,18,19,0,98
2,15,12,9,22,9,1,14,15,99
2,15,12,9,22,9,1,14,19,103
2,15,12,9,22,9,1,19,0,89
2,15,12,11,0,0,0,0,0,40
2,15,12,12,1,18,4,0,0,64
2,15,12,12,1,18,4,19,0,83
2,15,12,12,5,4,0,0,0,50
2,15,12,12,5,18,0,0,0,64
2,15,12,12,25,0,0,0,0,66
2,15,12,12,9,5,19,0,0,74
2,15,12,12,9,20,15,0,0,85
2,15,12,12,9,24,0,0,0,74
2,15,12,12,9,24,5,4,0,83
2,15,12,12,9,24,5,19,0,98
2,15,12,12,9,24,9,14,7,104
2,15,12,12,15,3,11,0,0,70
2,15,12,12,15,3,11,19,0,89
2,15,12,12,15,24,0,0,0,80
2,15,12,12,15,24,5,4,0,89
2,15,12,12,15,24,5,19,0,104
2,15,12,12,15,24,9,14,7,110
2,15,12,12,19,0,0,0,0,60
2,15,12,12,23,15,18,13,0,110
2,15,12,12,23,15,18,13,19,129
2,15,12,15,2,1,12,12,0,71
2,15,12,15,5,4,0,0,0,53
2,15,12,15,7,14,1,19,0,85
2,15,12,15,7,18,1,16,8,94
2,15,12,15,9,14,7,0,0,74
2,15,12,15,13,1,14,0,0,72
2,15,12,15,13,5,14,0,0,76
2,15,12,15,13,5,20,5,18,105
2,15,12,15,14,5,25,0,0,88
2,15,12,15,14,5,25,19,0,107
2,15,12,15,18,15,15,20,0,112
2,15,12,15,19,0,0,0,0,63
2,15,12,19,15,14,0,0,0,77
2,15,12,19,15,14,19,0,0,96
2,15,12,19,20,5,18,0,0,91
2,15,12,19,20,5,18,5,4,100
2,15,12,19,20,5,18,5,18,114
2,15,12,19,20,5,18,19,0,110
2,15,12,20,1,7,5,0,0,62
2,15,12,20,1,14,20,0,0,84
2,15,12,20,5,4,0,0,0,58
2,15,12,20,5,12,0,0,0,66
2,15,12,20,5,18,0,0,0,72
2,15,12,20,5,18,19,0,0,91
2,15,12,20,8,5,1,4,0,67
2,15,12,20,8,5,1,4,19,86
2,15,12,20,8,15,12,5,0,89
2,15,12,20,8,15,12,5,19,108
2,15,12,20,9,0,0,0,0,58
2,15,12,20,25,0,0,0,0,74
2,15,12,20,9,14,0,0,0,72
2,15,12,20,9,14,7,0,0,79
2,15,12,20,9,14,7,19,0,98
2,15,12,20,12,5,19,19,0,104
2,15,12,20,12,9,11,5,0,86
2,15,12,20,13,1,11,5,18,97
2,15,12,20,15,14,9,1,19,107
2,15,12,20,15,14,9,20,5,112
2,15,12,20,18,15,16,5,0,103
2,15,12,20,18,15,16,5,19,122
2,15,12,20,19,0,0,0,0,68
2,15,12,20,19,13,9,20,8,118
2,15,12,20,23,15,18,11,0,116
2,15,12,21,19,0,0,0,0,69
2,15,12,21,19,5,19,0,0,93
2,15,13,2,0,0,0,0,0,32
2,15,13,2,1,2,12,5,0,52
2,15,13,2,1,3,5,0,0,41
2,15,13,2,1,18,4,0,0,55
2,15,13,2,1,18,4,5,0,60
2,15,13,2,1,18,4,5,4,64
2,15,13,2,1,18,4,5,18,78
2,15,13,2,1,18,4,15,0,70
2,15,13,2,1,18,4,15,14,84
2,15,13,2,1,18,4,19,0,74
2,15,13,2,1,19,9,14,5,80
2,15,13,2,1,19,20,0,0,72
2,15,13,2,1,19,20,5,18,95
2,15,13,2,1,19,20,9,3,84
2,15,13,2,1,19,20,18,25,115
2,15,13,2,1,19,20,19,0,91
2,15,13,2,1,26,5,5,14,83
2,15,13,2,1,26,5,20,0,84
2,15,13,2,1,26,9,14,5,87
2,15,13,2,5,0,0,0,0,37
2,15,13,2,5,4,0,0,0,41
2,15,13,2,5,18,0,0,0,55
2,15,13,2,5,18,19,0,0,74
2,15,13,2,5,19,0,0,0,56
2,15,13,2,5,19,9,14,0,79
2,15,13,2,5,19,9,14,19,98
2,15,13,2,9,3,0,0,0,44
2,15,13,2,25,3,9,4,0,73
2,15,13,2,25,3,9,4,19,92
2,15,13,2,25,3,9,14,5,88
2,15,13,2,9,12,1,20,5,79
2,15,13,2,9,12,12,1,0,66
2,15,13,2,9,12,12,1,19,85
2,15,13,2,9,14,1,20,5,81
2,15,13,2,9,14,7,0,0,62
2,15,13,2,9,14,7,19,0,81
2,15,13,2,25,24,5,19,0,105
2,15,13,2,12,5,0,0,0,49
2,15,13,2,12,9,14,5,0,72
2,15,13,2,12,15,1,4,0,64
2,15,13,2,12,15,1,4,19,83
2,15,13,2,15,0,0,0,0,47
2,15,13,2,15,12,1,0,0,60
2,15,13,2,15,14,14,5,0,80
2,15,13,2,15,18,1,0,0,66
2,15,13,2,15,21,19,0,0,87
2,15,13,2,16,18,15,15,6,102
2,15,13,2,19,0,0,0,0,51
2,15,13,2,19,8,5,12,12,88
2,15,13,2,19,9,7,8,20,95
2,15,13,9,0,0,0,0,0,39
2,15,13,15,19,0,0,0,0,64
2,15,14,1,3,5,0,0,0,40
2,15,14,1,3,9,0,0,0,44
2,15,14,1,3,9,19,0,0,63
2,15,14,1,7,8,0,0,0,47
2,15,14,1,7,8,20,0,0,67
2,15,14,1,9,12,9,5,0,67
2,15,14,1,9,18,12,25,0,96
2,15,14,1,12,12,25,0,0,81
2,15,14,1,13,1,14,15,0,75
2,15,14,1,14,7,0,0,0,53
2,15,14,1,14,26,1,0,0,73
2,15,14,1,14,26,1,19,0,92
2,15,14,1,19,19,21,19,0,110
2,15,14,1,19,21,19,0,0,91
2,15,14,1,21,7,8,20,0,88
2,15,14,1,22,0,0,0,0,54
2,15,14,1,22,9,19,20,0,102
2,15,14,2,15,14,0,0,0,62
2,15,14,2,15,14,19,0,0,81
2,15,14,3,5,0,0,0,0,39
2,15,14,3,8,9,5,6,0,62
2,15,14,4,1,2,12,5,0,55
2,15,14,4,1,7,5,0,0,48
2,15,14,4,1,7,5,18,0,66
2,15,14,4,1,7,5,19,0,67
2,15,14,4,1,18,0,0,0,54
2,15,14,4,5,4,0,0,0,44
2,15,14,4,5,18,0,0,0,58
2,15,14,4,5,18,9,26,5,98
2,15,14,4,5,18,13,1,14,86
2,15,14,4,5,18,19,0,0,77
2,15,14,4,6,15,12,11,0,79
2,15,14,4,8,15,12,4,0,74
2,15,14,4,9,14,7,0,0,65
2,15,14,4,9,14,7,19,0,84
2,15,14,4,12,1,14,4,0,66
2,15,14,4,12,5,19,19,0,90
2,15,14,4,13,1,9,4,0,62
2,15,14,4,13,1,9,4,19,81
2,15,14,4,13,1,14,0,0,63
2,15,14,4,13,5,14,0,0,67
2,15,14,4,15,3,0,0,0,53
2,15,14,4,19,0,0,0,0,54
2,15,14,4,19,8,9,16,0,87
2,15,14,4,19,12,1,22,5,94
2,15,14,4,19,13,1,14,0,82
2,15,14,4,19,13,5,14,0,86
2,15,14,4,19,20,15,14,5,108
2,15,14,4,21,3,0,0,0,59
2,15,14,4,21,3,14,21,20,114
2,15,14,4,21,3,19,0,0,78
2,15,14,4,23,15,13,1,14,101
2,15,14,4,23,15,13,5,14,105
2,15,14,5,1,3,8,5,0,53
2,15,14,5,2,12,1,3,11,65
2,15,14,5,4,0,0,0,0,40
2,15,14,5,4,15,7,0,0,62
2,15,14,5,4,18,25,0,0,83
2,15,14,5,5,14,0,0,0,55
2,15,14,5,6,9,19,8,0,78
2,15,14,5,8,5,1,4,0,54
2,15,14,5,8,5,1,4,19,73
2,15,14,5,25,1,18,4,0,84
2,15,14,5,25,1,18,4,19,103
2,15,14,5,12,5,19,19,0,91
2,15,14,5,12,5,20,0,0,73
2,15,14,5,12,9,11,5,0,73
2,15,14,5,13,5,1,12,0,67
2,15,14,5,18,0,0,0,0,54
2,15,14,5,18,19,0,0,0,73
2,15,14,5,19,0,0,0,0,55
2,15,14,5,19,5,20,0,0,80
2,15,14,5,19,5,20,19,0,99
2,15,14,5,19,8,1,22,5,91
2,15,14,5,19,8,1,23,0,87
2,15,14,5,20,1,9,12,0,78
2,15,14,5,20,5,0,0,0,61
2,15,14,5,20,20,1,0,0,77
2,15,14,5,23,15,15,4,0,93
2,15,14,5,23,15,18,11,0,103
2,15,14,5,23,15,18,20,0,112
2,15,14,6,9,18,5,0,0,69
2,15,14,6,9,18,5,19,0,88
2,15,14,7,0,0,0,0,0,38
2,15,14,7,1,18,0,0,0,57
2,15,14,7,5,4,0,0,0,47
2,15,14,7,9,14,7,0,0,68
2,15,14,7,15,5,19,0,0,77
2,15,14,7,15,9,19,20,0,101
2,15,14,7,15,9,19,20,19,120
2,15,14,7,15,19,0,0,0,72
2,15,14,7,18,1,3,5,0,65
2,15,14,7,19,0,0,0,0,57
2,15,14,8,15,13,9,5,0,81
2,15,14,8,15,13,9,5,19,100
2,15,14,8,15,13,13,9,5,94
2,15,14,8,15,13,15,21,19,122
2,15,14,25,0,0,0,0,0,56
2,15,14,9,1,20,1,0,0,62
2,15,14,9,5,18,0,0,0,63
2,15,14,9,5,19,20,0,0,84
2,15,14,9,6,1,3,5,19,74
2,15,14,9,6,25,0,0,0,71
2,15,14,25,6,9,19,8,0,98
2,15,14,9,6,15,18,13,0,92
2,15,14,9,12,1,19,19,0,91
2,15,14,9,14,5,19,19,0,97
2,15,14,9,14,7,0,0,0,61
2,15,14,9,14,9,20,5,0,88
2,15,14,9,19,13,0,0,0,72
2,15,14,25,20,1,9,12,0,98
2,15,14,9,20,1,18,25,0,104
2,15,14,9,20,1,19,0,0,80
2,15,14,9,20,25,0,0,0,85
2,15,14,9,20,15,0,0,0,75
2,15,14,9,20,15,5,19,0,99
2,15,14,9,20,15,19,0,0,94
2,15,14,10,15,21,18,0,0,95
2,15,14,11,0,0,0,0,0,42
2,15,14,11,5,4,0,0,0,51
2,15,14,11,5,18,19,0,0,84
2,15,14,11,9,14,7,0,0,72
2,15,14,11,19,0,0,0,0,61
2,15,14,14,5,18,9,14,7,98
2,15,14,14,5,20,5,4,0,79
2,15,14,14,5,20,5,18,0,93
2,15,14,14,5,20,9,14,7,100
2,15,14,14,5,20,13,1,14,98
2,15,14,14,5,20,13,5,14,102
2,15,14,14,5,20,19,0,0,89
2,15,14,14,9,2,5,12,0,73
2,15,14,14,9,5,18,0,0,77
2,15,14,14,9,5,19,20,0,98
2,15,14,14,25,9,19,8,0,106
2,15,14,14,9,12,25,0,0,91
2,15,14,14,9,14,5,19,19,111
2,15,14,14,9,22,5,0,0,81
2,15,14,14,25,22,9,19,0,120
2,15,14,14,14,5,0,0,0,64
2,15,14,14,14,5,19,0,0,83
2,15,14,14,15,3,11,0,0,74
2,15,14,14,15,3,11,19,0,93
2,15,14,14,23,9,19,0,0,96
2,15,14,15,18,21,13,0,0,98
2,15,14,15,19,0,0,0,0,65
2,15,14,19,0,0,0,0,0,50
2,15,14,19,1,9,0,0,0,60
2,15,14,19,5,12,1,0,0,68
2,15,14,19,5,18,0,0,0,73
2,15,14,19,15,9,18,0,0,92
2,15,14,19,16,5,12,12,0,95
2,15,14,19,16,5,12,12,19,114
2,15,14,19,16,9,5,12,0,92
2,15,14,19,16,9,5,12,19,111
2,15,14,20,5,2,15,11,0,84
2,15,14,20,5,2,15,11,19,103
2,15,14,20,5,2,21,3,11,93
2,15,14,20,5,5,0,0,0,61
2,15,14,21,13,0,0,0,0,65
2,15,14,21,19,0,0,0,0,71
2,15,14,21,19,5,19,0,0,95
2,15,14,24,9,5,0,0,0,69
2,15,14,26,5,0,0,0,0,62
2,15,14,26,5,18,0,0,0,80
2,15,14,26,5,18,25,0,0,105
2,15,14,26,5,19,0,0,0,81
2,15,14,26,9,1,14,0,0,81
2,15,15,0,0,0,0,0,0,32
2,15,15,2,0,0,0,0,0,34
2,15,15,2,5,4,0,0,0,43
2,15,15,2,5,18,25,0,0,82
2,15,15,2,25,0,0,0,0,59
2,15,15,2,9,1,12,12,1,69
2,15,15,2,25,1,12,12,1,85
2,15,15,2,9,5,0,0,0,48
2,15,15,2,9,5,19,0,0,67
2,15,15,2,25,9,19,8,0,95
2,15,15,2,25,9,19,13,0,100
2,15,15,2,9,12,25,0,0,80
2,15,15,2,9,14,7,0,0,64
2,15,15,2,9,19,8,0,0,70
2,15,15,2,15,9,19,9,5,91
2,15,15,2,15,15,0,0,0,64
2,15,15,2,15,15,11,0,0,75
2,15,15,2,15,15,19,0,0,83
2,15,15,2,19,0,0,0,0,53
2,15,15,4,0,0,0,0,0,36
2,15,15,4,8,0,0,0,0,44
2,15,15,4,9,5,0,0,0,50
2,15,15,4,12,5,0,0,0,53
2,15,15,4,12,5,4,0,0,57
2,15,15,4,12,5,4,15,13,85
2,15,15,4,12,5,9,19,13,94
2,15,15,4,12,5,9,26,5,93
2,15,15,4,12,5,18,0,0,71
2,15,15,4,12,5,18,19,0,90
2,15,15,4,12,5,19,0,0,72
2,15,15,4,12,9,14,7,0,78
2,15,15,5,4,0,0,0,0,41
2,15,15,6,0,0,0,0,0,38
2,15,15,7,1,12,15,15,0,82
2,15,15,7,5,25,13,1,14,97
2,15,15,7,5,25,13,5,14,101
2,15,15,7,5,18,0,0,0,62
2,15,15,7,5,18,13,1,14,90
2,15,15,7,5,18,19,0,0,81
2,15,15,7,25,0,0,0,0,64
2,15,15,7,9,5,0,0,0,53
2,15,15,7,9,5,4,0,0,57
2,15,15,7,9,5,19,0,0,72
2,15,15,7,25,9,14,7,0,94
2,15,15,7,25,13,1,14,0,92
2,15,15,7,25,13,5,14,0,96
2,15,15,7,21,13,0,0,0,73
2,15,15,8,15,15,0,0,0,70
2,15,15,8,15,15,5,4,0,79
2,15,15,8,15,15,9,14,7,100
2,15,15,8,15,15,19,0,0,89
2,15,15,9,14,7,0,0,0,62
2,15,15,10,21,13,0,0,0,76
2,15,15,11,1,2,12,5,0,63
2,15,15,11,2,9,14,4,0,72
2,15,15,11,2,15,1,18,4,83
2,15,15,11,3,1,19,5,0,71
2,15,15,11,3,1,19,5,19,90
2,15,15,11,3,18,1,6,20,91
2,15,15,11,4,15,13,0,0,75
2,15,15,11,5,4,0,0,0,52
2,15,15,11,5,14,4,0,0,66
2,15,15,11,5,14,4,19,0,85
2,15,15,11,5,18,25,0,0,91
2,15,15,11,5,18,19,0,0,85
2,15,15,11,6,1,9,18,0,77
2,15,15,11,6,15,12,4,0,80
2,15,15,11,6,21,12,0,0,82
2,15,15,11,6,21,12,19,0,101
2,15,15,11,8,15,15,4,0,85
2,15,15,11,25,0,0,0,0,68
2,15,15,11,9,5,0,0,0,57
2,15,15,11,9,5,19,0,0,76
2,15,15,11,9,14,5,19,19,109
2,15,15,11,9,14,7,0,0,73
2,15,15,11,9,14,7,19,0,92
2,15,15,11,9,19,8,0,0,79
2,15,15,11,9,19,8,12,25,116
2,15,15,11,9,19,13,0,0,84
2,15,15,11,9,20,0,0,0,72
2,15,15,11,11,5,5,16,0,80
2,15,15,11,11,5,5,16,19,99
2,15,15,11,12,1,14,4,0,74
2,15,15,11,12,5,1,18,0,79
2,15,15,11,12,5,19,19,0,98
2,15,15,11,12,5,20,0,0,80
2,15,15,11,12,5,20,19,0,99
2,15,15,11,12,9,3,5,0,72
2,15,15,11,12,9,6,20,0,90
2,15,15,11,12,9,11,5,0,80
2,15,15,11,12,9,14,7,0,85
2,15,15,11,12,9,19,20,19,122
2,15,15,11,12,15,18,5,0,93
2,15,15,11,12,15,18,5,19,112
2,15,15,11,12,15,21,19,5,115
2,15,15,11,12,15,22,5,18,115
2,15,15,11,13,1,11,5,18,91
2,15,15,11,13,1,18,11,0,86
2,15,15,11,13,1,18,11,19,105
2,15,15,11,13,1,20,5,0,82
2,15,15,11,13,5,14,0,0,75
2,15,15,11,16,12,1,20,5,97
2,15,15,11,16,18,5,19,19,120
2,15,15,11,18,1,3,11,0,76
2,15,15,11,18,1,3,11,19,95
2,15,15,11,18,5,19,20,0,105
2,15,15,11,18,5,19,20,19,124
2,15,15,11,18,15,15,13,0,104
2,15,15,11,19,0,0,0,0,62
2,15,15,11,19,8,5,12,6,93
2,15,15,11,19,8,15,16,0,101
2,15,15,11,19,8,15,16,19,120
2,15,15,11,19,25,0,0,0,87
2,15,15,11,19,20,1,3,11,97
2,15,15,11,19,20,1,12,12,107
2,15,15,11,19,20,1,14,4,101
2,15,15,11,19,20,15,18,5,120
2,15,15,11,23,1,25,19,0,111
2,15,15,11,23,1,18,4,0,89
2,15,15,11,23,1,18,4,19,108
2,15,15,11,23,9,19,5,0,99
2,15,15,11,23,15,18,11,0,110
2,15,15,11,23,15,18,13,0,112
2,15,15,11,23,15,18,13,19,131
2,15,15,12,0,0,0,0,0,44
2,15,15,12,5,1,14,0,0,64
2,15,15,12,5,1,14,19,0,83
2,15,15,12,5,25,0,0,0,74
2,15,15,12,5,25,19,0,0,93
2,15,15,12,25,0,0,0,0,69
2,15,15,12,25,1,0,0,0,70
2,15,15,12,9,5,19,0,0,77
2,15,15,13,0,0,0,0,0,45
2,15,15,13,1,2,12,5,0,65
2,15,15,13,1,7,5,0,0,58
2,15,15,13,1,8,0,0,0,54
2,15,15,13,2,15,1,20,0,83
2,15,15,13,2,15,24,0,0,86
2,15,15,13,2,15,24,5,19,110
2,15,15,13,4,1,19,0,0,69
2,15,15,13,5,4,0,0,0,54
2,15,15,13,5,18,1,14,7,90
2,15,15,13,5,18,19,0,0,87
2,15,15,13,25,0,0,0,0,70
2,15,15,13,9,5,18,0,0,77
2,15,15,13,9,5,19,20,0,98
2,15,15,13,9,14,5,19,19,111
2,15,15,13,9,14,7,0,0,75
2,15,15,13,9,14,7,12,25,112
2,15,15,13,11,9,14,0,0,79
2,15,15,13,11,9,14,19,0,98
2,15,15,13,12,5,19,19,0,100
2,15,15,13,12,5,20,0,0,82
2,15,15,13,12,5,20,19,0,101
2,15,15,13,15,18,1,8,0,87
2,15,15,13,19,0,0,0,0,64
2,15,15,13,19,12,1,14,7,98
2,15,15,13,19,20,5,18,0,107
2,15,15,13,20,15,23,14,0,117
2,15,15,13,20,15,23,14,19,136
2,15,15,14,0,0,0,0,0,46
2,15,15,14,4,15,3,11,0,79
2,15,15,14,4,15,3,11,19,98
2,15,15,14,7,0,0,0,0,53
2,15,15,14,7,1,18,25,0,97
2,15,15,14,9,5,19,0,0,79
2,15,15,14,11,0,0,0,0,57
2,15,15,14,12,5,19,19,0,101
2,15,15,14,19,0,0,0,0,65
2,15,15,16,9,3,0,0,0,60
2,15,15,16,9,19,0,0,0,76
2,15,15,18,4,12,25,0,0,91
2,15,15,18,7,1,0,0,0,58
2,15,15,18,9,19,8,0,0,86
2,15,15,18,9,19,8,12,25,123
2,15,15,18,19,0,0,0,0,69
2,15,15,18,20,0,0,0,0,70
2,15,15,19,0,0,0,0,0,51
2,15,15,19,5,0,0,0,0,56
2,15,15,19,25,0,0,0,0,76
2,15,15,19,9,5,19,0,0,84
2,15,15,19,20,0,0,0,0,71
2,15,15,19,20,5,4,0,0,80
2,15,15,19,20,5,18,0,0,94
2,15,15,19,20,5,18,19,0,113
2,15,15,19,20,9,14,7,0,101
2,15,15,19,20,19,0,0,0,90
2,15,15,20,1,2,12,5,0,72
2,15,15,20,2,12,1,3,11,81
2,15,15,20,2,15,25,0,0,94
2,15,15,20,5,4,0,0,0,61
2,15,15,20,5,5,0,0,0,62
2,15,15,20,5,5,19,0,0,81
2,15,15,20,5,18,0,0,0,75
2,15,15,20,5,18,25,0,0,100
2,15,15,20,5,18,9,5,19,108
2,15,15,20,6,21,12,0,0,91
2,15,15,20,8,1,7,5,0,73
2,15,15,20,8,1,12,5,0,78
2,15,15,20,8,5,5,12,0,82
2,15,15,20,8,5,18,0,0,83
2,15,15,20,8,5,19,0,0,84
2,15,15,20,8,9,20,5,0,94
2,15,15,20,8,15,19,5,0,99
2,15,15,20,8,19,0,0,0,79
2,15,15,20,25,0,0,0,0,77
2,15,15,20,9,5,0,0,0,66
2,15,15,20,9,5,4,0,0,70
2,15,15,20,9,5,19,0,0,85
2,15,15,20,9,11,9,14,0,95
2,15,15,20,9,11,9,14,19,114
2,15,15,20,25,12,5,19,19,132
2,15,15,20,9,14,7,0,0,82
2,15,15,20,10,1,3,11,0,77
2,15,15,20,10,1,3,11,19,96
2,15,15,20,12,1,3,5,0,73
2,15,15,20,12,1,3,5,19,92
2,15,15,20,12,5,7,0,0,76
2,15,15,20,12,5,7,5,18,99
2,15,15,20,12,5,7,19,0,95
2,15,15,20,12,5,19,19,0,107
2,15,15,20,12,9,3,11,0,87
2,15,15,20,12,9,3,11,19,106
2,15,15,20,13,1,11,5,18,100
2,15,15,20,13,1,14,0,0,80
2,15,15,20,16,18,9,14,20,129
2,15,15,20,19,20,18,1,16,126
2,15,15,20,20,15,16,0,0,103
2,15,15,26,5,4,0,0,0,67
2,15,15,26,5,18,0,0,0,81
2,15,15,26,5,18,19,0,0,100
2,15,15,26,5,19,0,0,0,82
2,15,15,26,25,0,0,0,0,83
2,15,15,26,9,5,18,0,0,90
2,15,15,26,9,5,19,20,0,111
2,15,15,26,9,6,25,0,0,98
2,15,15,26,9,12,25,0,0,104
2,15,15,26,9,14,5,19,19,124
2,15,15,26,9,14,7,0,0,88
2,15,16,25,18,9,4,0,0,89
2,15,16,16,5,4,0,0,0,58
2,15,16,16,5,18,0,0,0,72
2,15,16,16,5,18,19,0,0,91
2,15,16,16,9,14,7,0,0,79
2,15,16,16,9,19,20,0,0,97
2,15,16,19,0,0,0,0,0,52
2,15,16,19,20,5,18,0,0,95
2,15,18,1,2,12,5,0,0,55
2,15,18,1,3,5,19,0,0,63
2,15,18,1,3,8,9,15,0,71
2,15,18,1,3,9,3,0,0,51
2,15,18,1,3,9,20,5,0,73
2,15,18,1,3,9,20,5,19,92
2,15,18,1,3,9,21,13,0,82
2,15,18,1,3,15,21,19,0,94
2,15,18,1,7,5,0,0,0,48
2,15,18,1,7,5,19,0,0,67
2,15,18,1,12,0,0,0,0,48
2,15,18,1,12,19,0,0,0,67
2,15,18,1,14,5,0,0,0,55
2,15,18,1,14,5,19,0,0,74
2,15,18,1,19,0,0,0,0,55
2,15,18,1,19,3,1,0,0,59
2,15,18,1,19,3,15,0,0,73
2,15,18,1,19,17,21,5,0,98
2,15,18,1,20,5,0,0,0,61
2,15,18,1,20,5,4,0,0,65
2,15,18,1,20,5,19,0,0,80
2,15,18,1,20,9,14,7,0,86
2,15,18,1,24,0,0,0,0,60
2,15,18,1,24,5,19,0,0,84
2,15,18,1,26,15,14,0,0,91
2,15,18,1,26,15,14,19,0,110
2,15,18,2,15,18,25,7,13,115
2,15,18,4,1,7,5,0,0,52
2,15,18,4,1,18,0,0,0,58
2,15,18,4,1,18,9,21,19,107
2,15,18,4,5,12,0,0,0,56
2,15,18,4,5,12,12,15,0,83
2,15,18,4,5,12,12,15,19,102
2,15,18,4,5,12,19,0,0,75
2,15,18,4,5,18,5,1,21,89
2,15,18,4,5,18,5,4,0,71
2,15,18,4,5,18,5,18,0,85
2,15,18,4,5,18,5,18,19,104
2,15,18,4,5,18,9,14,7,92
2,15,18,4,5,18,9,19,13,103
2,15,18,4,5,18,19,0,0,81
2,15,18,4,13,1,14,0,0,67
2,15,18,4,18,1,7,0,0,65
2,15,18,4,18,1,7,5,0,70
2,15,18,4,18,15,15,13,0,100
2,15,18,4,21,14,0,0,0,74
2,15,18,4,21,18,5,0,0,83
2,15,18,4,21,18,5,4,0,87
2,15,18,4,21,18,5,19,0,102
2,15,18,5,1,2,12,5,0,60
2,15,18,5,1,4,0,0,0,45
2,15,18,5,1,14,0,0,0,55
2,15,18,5,3,15,12,5,0,75
2,15,18,5,3,15,12,5,19,94
2,15,18,5,4,0,0,0,0,44
2,15,18,5,4,14,5,19,19,101
2,15,18,5,4,15,13,0,0,72
2,15,18,5,4,15,13,19,0,91
2,15,18,5,5,0,0,0,0,45
2,15,18,5,5,14,0,0,0,59
2,15,18,5,5,14,19,0,0,78
2,15,18,5,7,1,20,0,0,68
2,15,18,5,8,15,12,5,0,80
2,15,18,5,8,15,12,5,19,99
2,15,18,5,9,19,13,0,0,81
2,15,18,5,12,5,0,0,0,57
2,15,18,5,18,19,0,0,0,77
2,15,18,5,19,9,7,8,20,103
2,15,18,5,19,15,13,5,0,92
2,15,18,7,8,0,0,0,0,50
2,15,18,7,8,9,0,0,0,59
2,15,18,8,0,0,0,0,0,43
2,15,18,9,3,0,0,0,0,47
2,15,18,9,3,11,9,20,5,92
2,15,18,9,4,0,0,0,0,48
2,15,18,9,4,5,0,0,0,53
2,15,18,9,4,5,19,0,0,72
2,15,18,25,12,0,0,0,0,72
2,15,18,9,14,5,0,0,0,63
2,15,18,9,14,7,12,25,0,102
2,15,18,9,14,7,19,0,0,84
2,15,18,9,19,8,0,0,0,71
2,15,18,9,19,13,0,0,0,76
2,15,18,9,20,8,0,0,0,72
2,15,18,9,20,25,0,0,0,89
2,15,18,9,20,9,5,19,0,97
2,15,18,9,26,5,0,0,0,75
2,15,18,12,5,25,0,0,0,77
2,15,18,14,1,14,0,0,0,64
2,15,18,14,1,14,5,0,0,69
2,15,18,14,5,0,0,0,0,54
2,15,18,14,5,15,12,0,0,81
2,15,18,14,5,15,12,19,0,100
2,15,18,14,25,12,0,0,0,86
2,15,18,14,9,14,7,0,0,79
2,15,18,14,9,20,5,0,0,83
2,15,18,14,9,20,5,19,0,102
2,15,18,14,9,20,9,3,0,90
2,15,18,15,14,0,0,0,0,64
2,15,18,15,14,9,3,0,0,76
2,15,18,15,14,19,0,0,0,83
2,15,18,15,21,7,8,0,0,86
2,15,18,15,21,7,8,19,0,105
2,15,18,18,1,3,8,1,0,66
2,15,18,18,1,3,8,9,15,89
2,15,18,18,1,19,3,1,0,77
2,15,18,18,5,12,0,0,0,70
2,15,18,18,15,23,5,4,0,100
2,15,18,18,15,23,5,18,0,114
2,15,18,18,15,23,5,18,19,133
2,15,18,18,15,23,9,14,7,121
2,15,18,18,15,23,19,0,0,110
2,15,18,19,3,8,0,0,0,65
2,15,18,19,3,8,5,19,0,89
2,15,18,19,3,8,20,0,0,85
2,15,18,19,3,8,20,19,0,104
2,15,18,19,8,20,0,0,0,82
2,15,18,19,8,20,19,0,0,101
2,15,18,19,20,1,12,0,0,87
2,15,18,19,20,1,12,12,0,99
2,15,18,19,20,1,12,19,0,106
2,15,18,20,0,0,0,0,0,55
2,15,18,20,25,0,0,0,0,80
2,15,18,20,19,0,0,0,0,74
2,15,18,20,19,3,8,0,0,85
2,15,18,20,26,5,19,0,0,105
2,15,18,23,15,18,20,0,0,111
2,15,18,26,15,9,0,0,0,85
2,15,18,26,15,9,19,0,0,104
2,15,19,3,1,7,5,0,0,52
2,15,19,3,1,7,5,19,0,71
2,15,19,3,8,2,15,11,0,75
2,15,19,3,8,2,15,11,19,94
2,15,19,3,8,22,1,18,11,99
2,15,19,3,8,22,5,12,4,90
2,15,19,5,25,0,0,0,0,66
2,15,19,8,0,0,0,0,0,44
2,15,19,8,2,15,11,0,0,72
2,15,19,8,2,15,11,19,0,91
2,15,19,8,5,18,0,0,0,67
2,15,19,8,5,19,0,0,0,68
2,15,19,8,22,1,18,11,0,96
2,15,19,8,22,1,18,11,19,115
2,15,19,11,0,0,0,0,0,47
2,15,19,11,1,7,5,0,0,60
2,15,19,11,1,7,5,19,0,79
2,15,19,11,5,18,0,0,0,70
2,15,19,11,5,20,0,0,0,72
2,15,19,11,5,20,19,0,0,91
2,15,19,11,25,0,0,0,0,72
2,15,19,11,9,5,18,0,0,79
2,15,19,11,9,5,19,20,0,100
2,15,19,11,9,14,5,19,19,113
2,15,19,11,15,16,15,9,4,106
2,15,19,11,19,0,0,0,0,66
2,15,19,14,0,0,0,0,0,50
2,15,19,15,13,0,0,0,0,64
2,15,19,15,13,5,4,0,0,73
2,15,19,15,13,5,18,0,0,87
2,15,19,15,13,25,0,0,0,89
2,15,19,15,13,9,14,7,0,94
2,15,19,15,13,19,0,0,0,83
2,15,19,15,14,0,0,0,0,65
2,15,19,15,14,9,3,0,0,77
2,15,19,15,14,19,0,0,0,84
2,15,19,17,21,5,19,0,0,98
2,15,19,17,21,5,20,0,0,99
2,15,19,17,21,5,20,19,0,118
2,15,19,19,1,0,0,0,0,56
2,15,19,19,1,7,5,0,0,68
2,15,19,19,2,15,25,0,0,97
2,15,19,19,4,15,13,0,0,87
2,15,19,19,4,15,13,19,0,106
2,15,19,19,5,4,0,0,0,64
2,15,19,19,5,25,5,4,0,94
2,15,19,19,5,18,0,0,0,78
2,15,19,19,5,19,0,0,0,79
2,15,19,19,5,20,0,0,0,80
2,15,19,19,25,0,0,0,0,80
2,15,19,19,9,5,18,0,0,87
2,15,19,19,9,5,19,0,0,88
2,15,19,19,9,5,19,20,0,108
2,15,19,19,9,12,25,0,0,101
2,15,19,19,9,14,5,19,19,121
2,15,19,19,9,14,7,0,0,85
2,15,19,19,9,19,13,0,0,96
2,15,19,19,9,19,13,19,0,115
2,15,19,19,12,5,20,0,0,92
2,15,19,19,19,8,9,16,0,107
2,15,19,20,1,12,0,0,0,69
2,15,19,20,1,14,7,9,0,87
2,15,19,20,1,14,10,9,0,90
2,15,19,20,8,15,15,14,0,108
2,15,19,20,15,14,9,20,5,119
2,15,19,20,15,14,19,0,0,104
2,15,19,20,18,25,24,0,0,123
2,15,19,21,14,0,0,0,0,71
2,15,19,21,14,19,0,0,0,90
2,15,20,1,0,0,0,0,0,38
2,15,20,1,14,0,0,0,0,52
2,15,20,1,14,25,0,0,0,77
2,15,20,1,14,9,3,0,0,64
2,15,20,1,14,9,3,1,0,65
2,15,20,1,14,9,3,1,12,77
2,15,20,1,14,9,3,1,19,84
2,15,20,1,14,9,3,19,0,83
2,15,20,1,14,9,5,19,0,85
2,15,20,1,14,9,19,5,0,85
2,15,20,1,14,9,19,5,4,89
2,15,20,1,14,9,19,5,18,103
2,15,20,1,14,9,19,5,19,104
2,15,20,1,14,9,19,20,0,100
2,15,20,1,14,9,19,20,19,119
2,15,20,1,14,9,26,5,0,92
2,15,20,1,14,9,26,5,4,96
2,15,20,1,14,9,26,5,18,110
2,15,20,1,14,9,26,5,19,111
2,15,20,1,18,7,15,0,0,78
2,15,20,1,18,7,15,19,0,97
2,15,20,1,19,0,0,0,0,57
2,15,20,3,8,0,0,0,0,48
2,15,20,3,8,5,4,0,0,57
2,15,20,3,8,5,4,12,25,94
2,15,20,3,8,5,18,0,0,71
2,15,20,3,8,5,18,25,0,96
2,15,20,3,8,5,18,12,25,108
2,15,20,3,8,5,18,19,0,90
2,15,20,3,8,5,19,0,0,72
2,15,20,3,8,25,0,0,0,73
2,15,20,3,8,9,5,18,0,80
2,15,20,3,8,9,5,19,20,101
2,15,20,3,8,9,12,25,0,94
2,15,20,3,8,9,14,7,0,78
2,15,20,3,8,11,1,0,0,60
2,15,20,3,8,23,15,18,11,115
2,15,20,5,0,0,0,0,0,42
2,15,20,5,12,0,0,0,0,54
2,15,20,5,12,5,18,0,0,77
2,15,20,5,12,12,1,0,0,67
2,15,20,5,12,19,0,0,0,73
2,15,20,5,18,15,12,0,0,87
2,15,20,5,18,15,12,12,0,99
2,15,20,5,20,5,0,0,0,67
2,15,20,6,12,25,0,0,0,80
2,15,20,6,12,9,5,19,0,88
2,15,20,8,0,0,0,0,0,45
2,15,20,8,5,18,0,0,0,68
2,15,20,8,5,18,5,4,0,77
2,15,20,8,5,18,5,18,0,91
2,15,20,8,5,18,9,14,7,98
2,15,20,8,5,18,19,0,0,87
2,15,20,8,25,0,0,0,0,70
2,15,20,8,9,5,0,0,0,59
2,15,20,8,9,5,19,0,0,78
2,15,20,8,12,9,11,5,0,82
2,15,20,8,18,9,1,0,0,73
2,15,20,8,18,9,4,9,1,86
2,15,20,8,18,9,21,13,0,106
2,15,20,8,18,9,21,13,19,125
2,15,20,8,18,15,9,0,0,87
2,15,20,8,18,15,16,9,3,106
2,15,20,8,18,15,19,0,0,97
2,15,20,8,19,9,4,5,4,86
2,15,20,8,23,1,25,0,0,94
2,15,20,9,0,0,0,0,0,46
2,15,20,12,9,14,7,0,0,79
2,15,20,15,25,1,14,0,0,92
2,15,20,15,14,5,0,0,0,71
2,15,20,15,14,5,5,0,0,76
2,15,20,15,14,7,0,0,0,73
2,15,20,15,14,25,0,0,0,91
2,15,20,15,14,14,0,0,0,80
2,15,20,15,14,14,5,5,0,90
2,15,20,15,14,14,25,0,0,105
2,15,20,18,25,0,0,0,0,80
2,15,20,18,25,12,12,5,0,109
2,15,20,18,25,15,7,5,14,121
2,15,20,18,25,15,9,4,0,108
2,15,20,18,25,15,19,5,0,119
2,15,20,19,0,0,0,0,0,56
2,15,20,20,0,0,0,0,0,57
2,15,20,20,5,0,0,0,0,62
2,15,20,20,5,7,1,0,0,70
2,15,20,20,5,7,1,19,0,89
2,15,20,20,5,7,8,5,0,82
2,15,20,20,5,11,9,14,0,96
2,15,20,20,9,5,18,0,0,89
2,15,20,20,9,14,5,0,0,85
2,15,20,20,12,5,0,0,0,74
2,15,20,20,12,5,4,0,0,78
2,15,20,20,12,5,6,21,12,113
2,15,20,20,12,5,13,1,14,102
2,15,20,20,12,5,18,0,0,92
2,15,20,20,12,5,18,19,0,111
2,15,20,20,12,5,19,0,0,93
2,15,20,20,12,9,14,7,0,99
2,15,20,20,15,13,0,0,0,85
2,15,20,20,15,13,5,4,0,94
2,15,20,20,15,13,5,18,0,108
2,15,20,20,15,13,5,18,19,127
2,15,20,20,15,13,9,14,7,115
2,15,20,20,15,13,18,25,0,128
2,15,20,20,15,13,19,0,0,104
2,15,20,20,19,0,0,0,0,76
2,15,20,20,19,20,9,3,11,119
2,15,20,20,21,0,0,0,0,78
2,15,20,21,12,9,14,0,0,93
2,15,20,21,12,9,14,1,12,106
2,15,20,21,12,9,14,19,0,112
2,15,20,21,12,9,14,21,13,127
2,15,20,21,12,9,14,21,19,133
2,15,20,21,12,9,19,13,0,111
2,15,20,21,12,9,19,13,19,130
2,15,21,2,1,19,0,0,0,60
2,15,21,2,15,21,0,0,0,76
2,15,21,2,15,21,19,0,0,95
2,15,21,3,1,14,0,0,0,56
2,15,21,3,8,0,0,0,0,49
2,15,21,3,8,1,12,0,0,62
2,15,21,3,8,1,18,4,5,77
2,15,21,3,8,5,5,0,0,59
2,15,21,3,8,5,5,19,0,78
2,15,21,3,8,5,20,20,5,99
2,15,21,3,8,15,14,0,0,78
2,15,21,3,8,15,14,19,0,97
2,15,21,3,12,0,0,0,0,53
2,15,21,3,12,5,0,0,0,58
2,15,21,3,12,5,19,0,0,77
2,15,21,4,0,0,0,0,0,42
2,15,21,4,5,18,9,5,0,79
2,15,21,4,5,21,19,5,0,92
2,15,21,4,9,14,0,0,0,65
2,15,21,4,15,9,18,0,0,84
2,15,21,4,15,9,18,19,0,103
2,15,21,5,20,0,0,0,0,63
2,15,21,6,6,1,7,5,0,63
2,15,21,6,6,1,14,3,25,93
2,15,21,6,6,1,14,20,0,85
2,15,21,6,6,1,14,20,5,90
2,15,21,6,6,1,14,20,19,104
2,15,21,6,6,5,0,0,0,55
2,15,21,6,6,5,19,0,0,74
2,15,21,6,6,15,14,0,0,79
2,15,21,7,1,18,0,0,0,64
2,15,21,7,5,0,0,0,0,50
2,15,21,7,5,5,0,0,0,55
2,15,21,7,5,18,15,14,0,97
2,15,21,7,5,20,0,0,0,70
2,15,21,7,8,5,4,0,0,62
2,15,21,7,8,25,0,0,0,78
2,15,21,7,8,12,5,19,19,108
2,15,21,7,8,16,15,20,0,104
2,15,21,7,8,16,15,20,19,123
2,15,21,7,8,19,0,0,0,72
2,15,21,7,8,20,0,0,0,73
2,15,21,7,8,20,5,14,0,92
2,15,21,7,9,5,0,0,0,59
2,15,21,7,9,5,19,0,0,78
2,15,21,9,12,12,9,0,0,80
2,15,21,9,12,12,15,14,0,100
2,15,21,9,12,12,15,14,5,105
2,15,21,9,12,12,15,14,19,119
2,15,21,11,0,0,0,0,0,49
2,15,21,11,9,20,0,0,0,78
2,15,21,12,0,0,0,0,0,50
2,15,21,12,4,5,18,5,4,86
2,15,21,12,4,5,18,25,0,102
2,15,21,12,4,5,18,19,0,96
2,15,21,12,5,19,0,0,0,74
2,15,21,12,5,22,1,18,4,100
2,15,21,12,5,23,15,18,11,122
2,15,21,12,9,13,25,0,0,97
2,15,21,12,9,13,9,1,0,82
2,15,21,12,12,5,0,0,0,67
2,15,21,12,12,5,19,0,0,86
2,15,21,12,20,5,12,0,0,87
2,15,21,12,20,5,12,12,0,99
2,15,21,12,20,5,18,0,0,93
2,15,21,12,20,5,18,5,18,116
2,15,21,14,0,0,0,0,0,52
2,15,21,14,3,5,0,0,0,60
2,15,21,14,3,5,4,0,0,64
2,15,21,14,3,5,18,0,0,78
2,15,21,14,3,5,18,19,0,97
2,15,21,14,3,5,19,0,0,79
2,15,21,14,3,25,0,0,0,80
2,15,21,14,3,9,5,18,0,87
2,15,21,14,3,9,5,19,20,108
2,15,21,14,3,9,12,25,0,101
2,15,21,14,3,9,14,7,0,85
2,15,21,14,4,1,2,12,5,76
2,15,21,14,4,1,18,25,0,100
2,15,21,14,4,5,4,0,0,65
2,15,21,14,4,5,4,12,25,102
2,15,21,14,4,5,14,0,0,75
2,15,21,14,4,5,18,0,0,79
2,15,21,14,4,5,18,19,0,98
2,15,21,14,4,9,14,7,0,86
2,15,21,14,4,12,5,19,19,111
2,15,21,14,4,12,25,0,0,93
2,15,21,14,4,14,5,19,19,113
2,15,21,14,4,21,18,5,0,100
2,15,21,14,20,5,15,21,19,132
2,15,21,14,20,9,5,4,0,90
2,15,21,14,20,9,5,19,0,105
2,15,21,14,20,9,20,8,0,109
2,15,21,14,20,18,5,5,0,100
2,15,21,17,21,5,20,0,0,101
2,15,21,17,21,5,20,9,14,124
2,15,21,17,21,5,20,19,0,120
2,15,21,18,0,0,0,0,0,56
2,15,21,18,1,7,5,0,0,69
2,15,21,18,1,19,17,21,5,119
2,15,21,18,2,15,14,19,0,106
2,15,21,18,4,0,0,0,0,60
2,15,21,18,4,5,18,0,0,83
2,15,21,18,4,9,19,0,0,88
2,15,21,18,4,15,14,0,0,89
2,15,21,18,4,15,14,19,0,108
2,15,21,18,5,20,20,5,0,106
2,15,21,18,7,1,4,5,0,73
2,15,21,18,7,5,15,14,0,97
2,15,21,18,7,5,15,14,19,116
2,15,21,18,7,19,0,0,0,82
2,15,21,18,11,8,1,0,0,76
2,15,21,18,12,1,23,0,0,92
2,15,21,18,14,5,19,0,0,94
2,15,21,18,14,12,5,19,19,125
2,15,21,18,14,15,21,19,0,125
2,15,21,18,14,19,0,0,0,89
2,15,21,18,15,3,11,0,0,85
2,15,21,18,18,0,0,0,0,74
2,15,21,18,18,1,14,0,0,89
2,15,21,18,18,5,0,0,0,79
2,15,21,18,18,5,1,21,0,101
2,15,21,18,18,5,5,0,0,84
2,15,21,18,18,5,5,19,0,103
2,15,21,18,18,5,12,5,20,116
2,15,21,18,18,9,4,5,0,92
2,15,21,18,18,9,4,5,19,111
2,15,21,18,19,5,19,0,0,99
2,15,21,18,20,18,5,5,0,104
2,15,21,18,20,18,5,5,19,123
2,15,21,19,5,4,0,0,0,66
2,15,21,19,5,18,0,0,0,80
2,15,21,19,5,19,0,0,0,81
2,15,21,19,25,0,0,0,0,82
2,15,21,19,9,14,7,0,0,87
2,15,21,19,15,21,11,9,0,113
2,15,21,19,15,21,11,9,1,114
2,15,21,19,15,21,11,9,19,132
2,15,21,20,0,0,0,0,0,58
2,15,21,20,1,4,5,0,0,68
2,15,21,20,5,6,5,21,0,95
2,15,21,20,5,12,0,0,0,75
2,15,21,20,5,12,12,0,0,87
2,15,21,20,5,18,9,1,0,91
2,15,21,20,25,12,11,1,0,107
2,15,21,20,9,17,21,5,0,110
2,15,21,20,9,17,21,5,19,129
2,15,21,20,15,0,0,0,0,73
2,15,21,20,15,14,19,0,0,106
2,15,21,20,18,5,0,0,0,81
2,15,21,20,19,0,0,0,0,77
2,15,21,22,9,5,18,0,0,92
2,15,21,22,9,5,18,19,0,111
2,15,21,23,0,0,0,0,0,61
2,15,21,26,15,21,11,9,0,120
2,15,21,26,15,21,11,9,1,121
2,15,21,26,15,21,11,9,19,139
2,15,22,1,18,9,19,13,0,99
2,15,22,1,18,25,19,13,0,115
2,15,22,1,18,9,19,20,0,106
2,15,22,1,20,5,0,0,0,65
2,15,22,5,14,12,1,14,4,89
2,15,22,9,3,9,4,5,0,69
2,15,22,9,4,0,0,0,0,52
2,15,22,9,4,19,0,0,0,71
2,15,22,9,6,15,18,13,0,100
2,15,22,9,14,5,0,0,0,67
2,15,22,9,14,5,12,25,0,104
2,15,22,9,14,5,19,0,0,86
2,15,22,9,14,9,20,25,0,116
2,15,22,12,4,0,0,0,0,55
2,15,22,15,9,4,0,0,0,67
2,15,22,22,5,18,0,0,0,84
2,15,23,1,2,12,5,0,0,60
2,15,23,2,1,3,11,0,0,57
2,15,23,2,5,14,20,0,0,81
2,15,23,2,15,25,0,0,0,82
2,15,23,4,18,9,12,12,0,95
2,15,23,5,4,0,0,0,0,49
2,15,23,5,4,14,5,19,19,106
2,15,23,5,12,0,0,0,0,57
2,15,23,5,12,5,4,0,0,66
2,15,23,5,12,9,14,7,0,87
2,15,23,5,12,12,5,4,0,78
2,15,23,5,12,12,5,19,19,112
2,15,23,5,12,12,9,11,5,94
2,15,23,5,12,12,9,14,7,99
2,15,23,5,12,19,0,0,0,76
2,15,23,5,14,9,20,5,0,93
2,15,23,5,18,2,9,18,4,96
2,15,23,5,18,5,4,0,0,72
2,15,23,5,18,9,5,19,0,96
2,15,23,5,18,9,14,7,0,93
2,15,23,5,18,12,5,20,0,100
2,15,23,5,18,12,25,0,0,100
2,15,23,5,18,12,9,11,5,100
2,15,23,5,18,13,1,25,0,102
2,15,23,5,19,19,0,0,0,83
2,15,23,5,20,0,0,0,0,65
2,15,23,6,9,14,0,0,0,69
2,15,23,6,9,14,19,0,0,88
2,15,23,6,18,15,14,20,0,113
2,15,23,7,5,0,0,0,0,52
2,15,23,7,18,1,3,5,0,74
2,15,23,8,5,1,4,0,0,58
2,15,23,8,5,1,4,19,0,77
2,15,23,25,1,14,7,0,0,87
2,15,23,25,1,14,7,19,0,106
2,15,23,9,5,6,21,12,0,93
2,15,23,25,5,18,19,0,0,107
2,15,23,9,14,7,0,0,0,70
2,15,23,9,14,7,12,25,0,107
2,15,23,9,14,7,19,0,0,89
2,15,23,11,0,0,0,0,0,51
2,15,23,11,1,9,12,0,0,73
2,15,23,11,5,18,0,0,0,74
2,15,23,11,14,15,20,0,0,100
2,15,23,11,14,15,20,19,0,119
2,15,23,12,0,0,0,0,0,52
2,15,23,12,1,0,0,0,0,53
2,15,23,12,4,5,18,0,0,79
2,15,23,12,4,5,18,25,0,104
2,15,23,12,4,5,18,19,0,98
2,15,23,12,5,0,0,0,0,57
2,15,23,12,5,4,0,0,0,61
2,15,23,12,5,7,0,0,0,64
2,15,23,12,5,7,7,5,4,80
2,15,23,12,5,18,19,0,0,94
2,15,23,12,5,19,19,0,0,95
2,15,23,12,6,21,12,0,0,91
2,15,23,12,6,21,12,19,0,110
2,15,23,12,25,0,0,0,0,77
2,15,23,12,9,11,5,0,0,77
2,15,23,12,9,14,0,0,0,75
2,15,23,12,9,14,5,0,0,80
2,15,23,12,9,14,5,19,0,99
2,15,23,12,9,14,7,0,0,82
2,15,23,12,9,14,7,19,0,101
2,15,23,12,12,9,11,5,0,89
2,15,23,12,13,1,11,5,18,100
2,15,23,12,19,0,0,0,0,71
2,15,23,13,1,11,5,18,0,88
2,15,23,13,1,11,9,14,7,95
2,15,23,13,5,14,0,0,0,72
2,15,23,14,0,0,0,0,0,54
2,15,23,16,9,14,0,0,0,79
2,15,23,16,15,20,0,0,0,91
2,15,23,16,15,20,19,0,0,110
2,15,23,18,1,12,9,20,5,105
2,15,23,19,0,0,0,0,0,59
2,15,23,19,1,23,0,0,0,83
2,15,23,19,5,0,0,0,0,64
2,15,23,19,5,4,0,0,0,68
2,15,23,19,5,18,0,0,0,82
2,15,23,19,5,18,25,0,0,107
2,15,23,19,5,19,0,0,0,83
2,15,23,19,8,15,20,0,0,102
2,15,23,19,8,15,20,19,0,121
2,15,23,19,9,5,0,0,0,73
2,15,23,19,9,14,7,0,0,89
2,15,23,19,13,1,14,0,0,87
2,15,23,19,16,18,9,20,0,122
2,15,23,19,16,18,9,20,19,141
2,15,23,19,19,5,14,0,0,97
2,15,23,19,20,1,6,6,0,92
2,15,23,19,20,1,22,5,0,107
2,15,23,19,20,18,9,14,7,127
2,15,23,19,20,18,21,14,7,139
2,15,23,20,5,12,0,0,0,77
2,15,23,20,5,12,12,0,0,89
2,15,23,20,9,5,0,0,0,74
2,15,23,23,15,13,1,14,0,106
2,15,23,23,15,15,4,0,0,97
2,15,23,23,15,18,20,0,0,116
2,15,23,23,15,23,0,0,0,101
2,15,23,23,15,23,5,4,0,110
2,15,23,23,15,23,19,0,0,120
2,15,24,2,1,12,12,0,0,68
2,15,24,2,5,18,18,25,0,109
2,15,24,2,15,1,18,4,0,81
2,15,24,2,15,1,18,4,19,100
2,15,24,2,21,19,8,0,0,91
2,15,24,3,1,18,0,0,0,63
2,15,24,3,1,18,19,0,0,82
2,15,24,5,4,0,0,0,0,50
2,15,24,5,14,0,0,0,0,60
2,15,24,5,18,19,0,0,0,83
2,15,24,5,19,0,0,0,0,65
2,15,24,6,9,19,8,0,0,83
2,15,24,6,9,19,8,5,19,107
2,15,24,6,21,12,0,0,0,80
2,15,24,6,21,12,19,0,0,99
2,15,24,8,1,21,12,0,0,83
2,15,24,8,1,21,12,5,4,92
2,15,24,8,1,21,12,19,0,102
2,15,24,8,5,1,4,0,0,59
2,15,24,8,15,12,4,5,18,103
2,15,24,25,0,0,0,0,0,66
2,15,24,9,1,14,1,0,0,66
2,15,24,9,5,18,0,0,0,73
2,15,24,9,5,19,20,0,0,94
2,15,24,9,14,5,19,19,0,107
2,15,24,9,14,7,0,0,0,71
2,15,24,9,14,7,19,0,0,90
2,15,24,11,5,5,16,5,18,101
2,15,24,12,9,11,5,0,0,78
2,15,24,13,1,11,5,18,0,89
2,15,24,13,1,11,9,14,7,96
2,15,24,13,1,14,0,0,0,69
2,15,24,18,15,15,13,0,0,102
2,15,24,20,8,15,18,14,0,116
2,15,24,20,8,15,18,14,19,135
2,15,24,20,25,0,0,0,0,86
2,15,24,20,15,16,0,0,0,92
2,15,24,20,15,16,19,0,0,111
2,15,24,20,18,5,5,0,0,89
2,15,24,23,1,12,12,1,8,98
2,15,24,23,15,15,4,0,0,98
2,15,24,23,15,15,4,19,0,117
2,15,24,23,15,18,11,0,0,108
2,15,26,1,0,0,0,0,0,44
2,15,26,1,12,0,0,0,0,56
2,15,26,9,14,5,0,0,0,71
2,15,26,15,0,0,0,0,0,58
2,15,26,15,19,0,0,0,0,77
2,15,26,26,5,0,0,0,0,74
2,15,26,26,5,20,20,15,0,129
2,16,20,0,0,0,0,0,0,38
2,18,5,1,3,8,0,0,0,37
2,18,5,1,3,8,5,4,0,46
2,18,5,1,3,8,5,18,0,60
2,18,5,1,3,8,5,18,19,79
2,18,5,1,3,8,5,19,0,61
2,18,5,1,3,8,6,21,12,76
2,18,5,1,3,8,25,0,0,62
2,18,5,1,3,8,9,14,7,67
2,18,5,1,4,0,0,0,0,30
2,18,5,1,4,2,15,24,0,71
2,18,5,1,4,5,4,0,0,39
2,18,5,1,4,5,14,0,0,49
2,18,5,1,4,9,14,7,0,60
2,18,5,1,4,12,5,19,19,85
2,18,5,1,4,12,9,14,5,70
2,18,5,1,4,13,1,14,0,58
2,18,5,1,4,14,5,19,19,87
2,18,5,1,4,14,21,20,0,85
2,18,5,1,4,14,21,20,19,104
2,18,5,1,4,18,15,15,20,98
2,18,5,1,4,19,0,0,0,49
2,18,5,1,4,20,8,0,0,58
2,18,5,1,4,20,8,5,14,77
2,18,5,1,4,20,8,19,0,77
2,18,5,1,7,8,5,0,0,46
2,18,5,1,11,0,0,0,0,37
2,18,5,1,11,1,2,12,5,57
2,18,5,1,11,1,2,12,25,77
2,18,5,1,11,1,7,5,0,50
2,18,5,1,11,1,7,5,19,69
2,18,5,1,11,1,23,1,25,87
2,18,5,1,11,1,24,0,0,62
2,18,5,1,11,1,24,5,0,67
2,18,5,1,11,2,1,3,11,54
2,18,5,1,11,2,15,14,5,73
2,18,5,1,11,4,15,23,14,93
2,18,5,1,11,5,18,0,0,60
2,18,5,1,11,5,18,19,0,79
2,18,5,1,11,6,1,19,20,83
2,18,5,1,11,9,14,7,0,67
2,18,5,1,11,9,14,7,19,86
2,18,5,1,11,12,5,19,19,92
2,18,5,1,11,12,9,19,20,97
2,18,5,1,11,14,5,3,11,70
2,18,5,1,11,15,6,6,0,64
2,18,5,1,11,15,21,20,0,93
2,18,5,1,11,15,21,20,19,112
2,18,5,1,11,15,22,5,18,97
2,18,5,1,11,21,16,0,0,74
2,18,5,1,11,21,16,19,0,93
2,18,5,1,11,23,9,14,4,87
2,18,5,1,13,5,4,0,0,48
2,18,5,1,13,9,14,7,0,69
2,18,5,1,13,19,0,0,0,58
2,18,5,1,18,4,19,0,0,67
2,18,5,1,19,20,0,0,0,65
2,18,5,1,19,20,5,18,0,88
2,18,5,1,19,20,6,21,12,104
2,18,5,1,19,20,9,5,0,79
2,18,5,1,19,20,9,14,7,95
2,18,5,1,19,20,16,9,14,104
2,18,5,1,19,20,19,0,0,84
2,18,5,1,20,8,0,0,0,54
2,18,5,1,20,8,5,0,0,59
2,18,5,1,20,8,5,4,0,63
2,18,5,1,20,8,5,18,0,77
2,18,5,1,20,8,5,18,19,96
2,18,5,1,20,8,5,19,0,78
2,18,5,1,20,8,6,21,12,93
2,18,5,1,20,8,25,0,0,79
2,18,5,1,20,8,9,5,18,86
2,18,5,1,20,8,9,12,25,100
2,18,5,1,20,8,9,14,7,84
2,18,5,1,20,8,19,0,0,73
2,18,5,2,1,0,0,0,0,28
2,18,5,3,3,9,1,0,0,41
2,18,5,3,3,9,1,12,0,53
2,18,5,3,3,9,1,19,0,60
2,18,5,3,3,9,1,20,5,66
2,18,5,3,8,1,13,0,0,50
2,18,5,3,8,1,13,19,0,69
2,18,5,3,8,1,14,0,0,51
2,18,5,3,8,1,14,19,0,70
2,18,5,3,8,20,9,1,14,80
2,18,5,3,9,1,0,0,0,38
2,18,5,3,11,0,0,0,0,39
2,18,5,3,11,5,14,0,0,58
2,18,5,4,5,0,0,0,0,34
2,18,5,4,5,19,0,0,0,53
2,18,5,4,9,0,0,0,0,38
2,18,5,5,3,8,5,4,0,50
2,18,5,5,3,8,5,19,0,65
2,18,5,5,3,8,9,14,7,71
2,18,5,5,4,1,2,12,5,54
2,18,5,5,4,2,1,20,5,62
2,18,5,5,4,5,18,0,0,57
2,18,5,5,4,5,18,19,0,76
2,18,5,5,4,25,0,0,0,59
2,18,5,5,4,9,14,7,19,83
2,18,5,5,4,12,9,14,7,76
2,18,5,5,4,19,0,0,0,53
2,18,5,5,11,0,0,0,0,41
2,18,5,5,11,12,5,19,19,96
2,18,5,5,11,19,0,0,0,60
2,18,5,5,11,21,13,19,0,94
2,18,5,5,14,7,5,0,0,56
2,18,5,5,14,7,5,18,0,74
2,18,5,5,19,0,0,0,0,49
2,18,5,5,26,5,4,0,0,65
2,18,5,5,26,5,6,21,12,100
2,18,5,5,26,5,19,0,0,80
2,18,5,5,26,5,23,1,25,110
2,18,5,5,26,25,0,0,0,81
2,18,5,5,26,9,5,18,0,88
2,18,5,5,26,9,5,19,20,109
2,18,5,5,26,9,12,25,0,102
2,18,5,5,26,9,14,7,0,86
2,18,5,7,13,1,0,0,0,46
2,18,5,7,13,1,20,1,0,67
2,18,5,7,13,1,20,5,0,71
2,18,5,7,13,1,20,9,3,78
2,18,5,8,15,14,0,0,0,62
2,18,5,8,15,14,9,1,0,72
2,18,5,9,0,0,0,0,0,34
2,18,5,9,18,4,0,0,0,56
2,18,5,11,11,25,0,0,0,72
2,18,5,11,11,12,5,0,0,64
2,18,5,12,1,14,0,0,0,52
2,18,5,12,1,23,0,0,0,61
2,18,5,12,15,17,21,5,0,95
2,18,5,13,2,5,18,0,0,63
2,18,5,13,5,0,0,0,0,43
2,18,5,13,5,12,25,0,0,80
2,18,5,13,5,14,5,19,19,100
2,18,5,14,4,5,4,0,0,52
2,18,5,14,4,5,18,0,0,66
2,18,5,14,4,9,3,5,0,60
2,18,5,14,14,1,7,5,0,66
2,18,5,14,19,0,0,0,0,58
2,18,5,14,20,19,0,0,0,78
2,18,5,16,8,9,3,0,0,61
2,18,5,18,4,0,0,0,0,47
2,18,5,18,5,0,0,0,0,48
2,18,5,19,19,15,13,5,18,114
2,18,5,20,5,12,12,5,0,79
2,18,5,20,5,19,19,5,0,93
2,18,5,20,8,0,0,0,0,53
2,18,5,20,8,5,12,0,0,70
2,18,5,20,8,18,5,14,0,90
2,18,5,20,15,14,19,0,0,93
2,18,5,20,20,9,3,5,0,82
2,18,5,22,0,0,0,0,0,47
2,18,5,22,1,0,0,0,0,48
2,18,5,22,5,0,0,0,0,52
2,18,5,22,5,19,0,0,0,71
2,18,5,22,5,20,0,0,0,72
2,18,5,22,5,20,3,25,0,100
2,18,5,22,5,20,5,0,0,77
2,18,5,22,5,20,5,4,0,81
2,18,5,22,5,20,9,14,7,102
2,18,5,22,5,20,19,0,0,91
2,18,5,22,5,20,20,5,4,101
2,18,5,22,9,0,0,0,0,56
2,18,5,22,9,1,18,25,0,100
2,18,5,22,9,1,20,5,0,82
2,18,5,22,9,5,18,0,0,79
2,18,5,22,9,5,18,19,0,98
2,18,5,22,9,7,5,18,0,86
2,18,5,22,9,16,5,4,0,81
2,18,5,22,9,16,5,14,0,91
2,18,5,22,9,19,0,0,0,75
2,18,5,22,9,20,0,0,0,76
2,18,5,22,9,20,25,0,0,101
2,18,5,22,9,20,9,5,19,109
2,18,5,23,1,7,5,0,0,61
2,18,5,23,1,7,5,19,0,80
2,18,5,23,5,4,0,0,0,57
2,18,5,23,5,18,25,0,0,96
2,18,5,23,5,18,9,5,19,104
2,18,5,23,5,18,19,0,0,90
2,18,5,23,8,15,21,19,5,116
2,18,5,23,9,14,7,0,0,78
2,18,5,23,9,14,7,19,0,97
2,18,5,23,9,19,0,0,0,76
2,18,5,23,9,19,5,19,0,100
2,18,5,23,19,0,0,0,0,67
2,18,5,23,19,20,0,0,0,87
2,18,25,1,3,5,15,21,19,109
2,18,9,1,18,0,0,0,0,48
2,18,9,1,18,4,19,0,0,71
2,18,9,1,18,5,4,0,0,57
2,18,9,1,18,25,0,0,0,73
2,18,9,1,18,18,15,15,20,116
2,18,9,1,18,19,0,0,0,67
2,18,9,1,18,23,15,15,4,105
2,18,9,2,1,2,12,5,0,51
2,18,9,2,5,0,0,0,0,36
2,18,9,2,5,1,2,12,5,56
2,18,9,2,5,4,0,0,0,40
2,18,9,2,5,5,0,0,0,41
2,18,9,2,5,5,19,0,0,60
2,18,9,2,5,12,5,19,19,91
2,18,9,2,5,18,0,0,0,54
2,18,9,2,5,18,25,0,0,79
2,18,9,2,5,18,9,5,19,87
2,18,9,2,5,18,19,0,0,73
2,18,9,2,5,19,0,0,0,55
2,18,9,2,9,14,7,0,0,61
2,18,9,3,8,5,14,0,0,59
2,18,9,3,8,5,20,20,5,90
2,18,9,3,11,2,1,20,0,66
2,18,9,3,11,2,1,20,19,85
2,18,9,3,11,5,4,0,0,52
2,18,9,3,11,5,12,0,0,60
2,18,9,3,11,5,14,0,0,62
2,18,9,3,11,8,15,15,4,85
2,18,9,3,11,25,0,0,0,68
2,18,9,3,11,25,1,18,4,91
2,18,9,3,11,9,5,18,0,75
2,18,9,3,11,9,5,19,20,96
2,18,9,3,11,9,14,7,0,73
2,18,9,3,11,9,19,8,0,79
2,18,9,3,11,11,9,12,14,89
2,18,9,3,11,12,1,25,0,81
2,18,9,3,11,12,5,0,0,60
2,18,9,3,11,12,5,19,0,79
2,18,9,3,11,12,25,0,0,80
2,18,9,3,11,12,9,11,5,80
2,18,9,3,11,18,5,4,0,70
2,18,9,3,11,19,0,0,0,62
2,18,9,3,11,19,5,20,0,87
2,18,9,3,11,20,15,16,0,94
2,18,9,3,11,23,1,12,12,91
2,18,9,3,11,23,9,19,5,99
2,18,9,3,11,23,15,18,11,110
2,18,9,3,15,12,5,0,0,64
2,18,9,3,15,12,5,19,0,83
2,18,9,4,0,0,0,0,0,33
2,18,9,4,1,12,0,0,0,46
2,18,9,4,1,12,5,0,0,51
2,18,9,4,1,12,5,18,0,69
2,18,9,4,1,12,12,25,0,83
2,18,9,4,1,12,19,0,0,65
2,18,9,4,1,12,20,25,0,91
2,18,9,4,5,2,5,4,0,49
2,18,9,4,5,2,15,23,12,90
2,18,9,4,5,3,1,11,5,58
2,18,9,4,5,3,21,16,0,78
2,18,9,4,5,7,15,4,0,64
2,18,9,4,5,8,5,1,4,56
2,18,9,4,5,8,15,15,4,80
2,18,9,4,5,11,14,15,20,98
2,18,9,4,5,12,1,3,5,59
2,18,9,4,5,12,5,19,19,93
2,18,9,4,5,12,25,0,0,75
2,18,9,4,5,12,9,11,5,75
2,18,9,4,5,12,15,16,5,86
2,18,9,4,5,13,1,9,4,65
2,18,9,4,5,13,1,14,0,66
2,18,9,4,5,19,0,0,0,57
2,18,9,4,5,19,8,9,16,90
2,18,9,4,5,19,13,1,14,85
2,18,9,4,5,19,13,5,14,89
2,18,9,4,5,23,1,9,14,85
2,18,9,4,5,23,5,5,4,75
2,18,9,4,5,23,5,12,12,90
2,18,9,4,5,23,15,18,20,114
2,18,9,4,7,5,4,0,0,49
2,18,9,4,7,5,13,1,14,73
2,18,9,4,7,5,13,5,14,77
2,18,9,4,7,5,16,15,20,96
2,18,9,4,7,5,20,9,14,88
2,18,9,4,7,5,23,1,25,94
2,18,9,4,7,9,14,7,0,70
2,18,9,4,7,9,14,7,19,89
2,18,9,4,12,5,0,0,0,50
2,18,9,4,12,5,4,0,0,54
2,18,9,4,12,5,13,1,14,78
2,18,9,4,12,5,18,0,0,68
2,18,9,4,12,5,18,19,0,87
2,18,9,4,12,5,19,0,0,69
2,18,9,4,12,9,14,7,0,75
2,18,9,4,15,15,14,0,0,77
2,18,9,4,15,15,14,19,0,96
2,18,9,5,6,3,1,19,5,68
2,18,9,5,6,5,4,0,0,49
2,18,9,5,6,5,18,0,0,63
2,18,9,5,6,5,18,19,0,82
2,18,9,5,6,5,19,20,0,84
2,18,9,5,6,9,14,7,0,70
2,18,9,5,6,9,14,7,19,89
2,18,9,5,6,12,5,19,19,95
2,18,9,5,6,12,25,0,0,77
2,18,9,5,6,14,5,19,19,97
2,18,9,5,6,19,0,0,0,59
2,18,9,5,18,5,4,0,0,61
2,18,9,5,18,25,0,0,0,77
2,18,9,5,18,18,15,15,20,120
2,18,9,5,18,19,0,0,0,71
2,18,9,5,18,23,15,15,4,109
2,18,9,5,19,0,0,0,0,53
2,18,9,5,22,5,0,0,0,61
2,18,9,7,1,4,5,0,0,46
2,18,9,7,1,4,5,4,0,50
2,18,9,7,1,4,5,19,0,65
2,18,9,7,1,4,9,5,18,73
2,18,9,7,1,4,9,14,7,71
2,18,9,7,1,12,15,23,0,87
2,18,9,7,1,14,4,0,0,55
2,18,9,7,1,14,4,5,18,78
2,18,9,7,1,14,4,19,0,74
2,18,9,7,1,20,18,25,0,100
2,18,9,7,2,15,20,5,0,78
2,18,9,7,5,20,20,25,0,106
2,18,9,7,8,20,5,14,0,83
2,18,9,7,8,20,5,14,19,102
2,18,9,7,8,20,5,18,0,87
2,18,9,7,8,20,5,19,20,108
2,18,9,7,8,20,9,19,8,100
2,18,9,7,8,20,12,25,0,101
2,18,9,7,8,20,19,0,0,83
2,18,9,7,15,21,19,0,0,91
2,18,9,7,19,0,0,0,0,55
2,18,9,7,19,1,9,12,0,77
2,18,9,7,21,5,0,0,0,62
2,18,9,7,21,5,4,0,0,66
2,18,9,7,21,5,18,0,0,80
2,18,9,7,21,9,14,7,0,87
2,18,9,11,5,0,0,0,0,45
2,18,9,12,12,1,14,20,5,93
2,18,9,12,12,19,0,0,0,72
2,18,9,13,0,0,0,0,0,42
2,18,9,13,6,21,12,0,0,81
2,18,9,13,6,21,12,12,0,93
2,18,9,13,6,21,12,12,25,118
2,18,9,13,9,14,7,0,0,72
2,18,9,13,12,5,19,19,0,97
2,18,9,13,12,25,0,0,0,79
2,18,9,13,13,5,4,0,0,64
2,18,9,13,13,5,18,0,0,78
2,18,9,13,13,5,18,5,4,87
2,18,9,13,13,5,18,19,0,97
2,18,9,13,13,9,13,7,0,84
2,18,9,13,13,9,14,7,0,85
2,18,9,13,19,0,0,0,0,61
2,18,9,13,19,5,0,0,0,66
2,18,9,13,19,20,15,14,5,115
2,18,9,13,19,20,15,14,25,135
2,18,9,14,0,0,0,0,0,43
2,18,9,14,3,5,0,0,0,51
2,18,9,14,4,5,4,0,0,56
2,18,9,14,4,12,5,4,0,68
2,18,9,14,4,12,5,19,0,83
2,18,9,14,4,12,9,19,8,95
2,18,25,14,4,26,1,0,0,90
2,18,9,14,5,4,0,0,0,52
2,18,9,14,5,12,5,19,19,103
2,18,9,14,5,13,1,14,0,76
2,18,9,14,5,18,0,0,0,66
2,18,9,14,5,18,19,0,0,85
2,18,9,14,5,19,0,0,0,67
2,18,9,14,7,1,12,0,0,63
2,18,9,14,7,1,12,12,0,75
2,18,9,14,7,4,15,23,14,106
2,18,9,14,7,5,4,0,0,59
2,18,9,14,7,5,12,1,0,68
2,18,9,14,7,5,18,0,0,73
2,18,9,14,7,5,18,19,0,92
2,18,9,14,7,5,20,8,0,83
2,18,9,14,7,9,14,7,0,80
2,18,9,14,7,19,0,0,0,69
2,18,9,14,7,19,5,12,0,86
2,18,9,14,9,5,0,0,0,57
2,18,9,14,9,5,18,0,0,75
2,18,9,14,9,5,19,0,0,76
2,18,9,14,9,5,19,20,0,96
2,18,9,14,9,14,5,19,19,109
2,18,9,14,9,14,7,0,0,73
2,18,9,14,9,19,8,0,0,79
2,18,9,14,10,1,12,0,0,66
2,18,9,14,10,1,18,5,5,82
2,18,9,14,10,1,18,18,25,115
2,18,9,14,10,1,21,12,0,87
2,18,9,14,11,12,5,19,19,109
2,18,9,14,11,19,0,0,0,73
2,18,9,14,14,25,0,0,0,82
2,18,9,14,19,0,0,0,0,62
2,18,9,14,19,5,12,12,0,91
2,18,9,14,19,20,15,14,0,111
2,18,9,15,0,0,0,0,0,44
2,18,9,15,3,8,5,0,0,60
2,18,9,15,3,8,5,19,0,79
2,18,25,15,7,5,14,9,14,109
2,18,9,15,12,5,20,0,0,81
2,18,9,15,12,5,20,20,5,106
2,18,25,15,12,15,7,25,0,119
2,18,9,15,14,25,0,0,0,83
2,18,25,15,14,25,0,0,0,99
2,18,25,15,14,9,4,9,14,110
2,18,9,15,14,9,5,19,0,91
2,18,25,15,14,9,5,19,0,107
2,18,25,15,14,9,14,0,0,97
2,18,9,15,14,9,14,5,0,86
2,18,25,15,16,8,25,20,5,134
2,18,9,15,19,0,0,0,0,63
2,18,25,15,26,15,1,14,0,116
2,18,25,15,26,15,1,14,19,135
2,18,25,15,26,15,15,14,0,130
2,18,25,15,26,15,21,13,0,135
2,18,9,17,21,5,0,0,0,72
2,18,9,17,21,5,20,0,0,92
2,18,9,17,21,5,20,19,0,111
2,18,9,17,21,5,20,20,5,117
2,18,9,19,0,0,0,0,0,48
2,18,9,19,1,0,0,0,0,49
2,18,9,19,1,14,3,5,0,71
2,18,9,19,1,14,3,5,19,90
2,18,9,19,1,14,20,0,0,83
2,18,9,19,3,15,12,1,0,79
2,18,9,19,5,0,0,0,0,53
2,18,9,19,5,13,5,14,20,105
2,18,9,19,5,19,0,0,0,72
2,18,9,19,11,0,0,0,0,59
2,18,9,19,11,5,4,0,0,68
2,18,9,19,11,5,14,0,0,78
2,18,9,19,11,5,14,5,4,87
2,18,9,19,11,5,18,0,0,82
2,18,9,19,11,5,19,20,0,103
2,18,9,19,11,5,20,0,0,84
2,18,9,19,11,5,20,19,0,103
2,18,9,19,11,25,0,0,0,84
2,18,9,19,11,9,14,7,0,89
2,18,9,19,11,9,19,8,0,95
2,18,9,19,11,12,25,0,0,96
2,18,9,19,11,14,5,19,19,116
2,18,9,19,11,19,0,0,0,78
2,18,9,19,12,9,14,7,0,90
2,18,9,19,12,9,14,7,19,109
2,18,9,19,17,21,5,0,0,91
2,18,9,19,19,0,0,0,0,67
2,18,9,19,19,5,19,0,0,91
2,18,9,19,20,0,0,0,0,68
2,18,9,19,20,12,5,0,0,85
2,18,9,19,20,12,5,4,0,89
2,18,9,19,20,12,5,18,0,103
2,18,9,19,20,12,5,19,0,104
2,18,9,19,20,12,25,0,0,105
2,18,9,19,20,12,9,5,18,112
2,18,9,19,20,12,9,14,7,110
2,18,9,19,20,15,12,19,0,114
2,18,9,19,21,18,5,0,0,92
2,18,9,20,1,14,25,0,0,89
2,18,9,20,3,8,5,12,0,77
2,18,9,20,3,8,5,19,0,84
2,18,9,20,3,8,11,1,0,72
2,18,9,20,5,0,0,0,0,54
2,18,9,20,8,5,18,0,0,80
2,18,9,20,15,14,19,0,0,97
2,18,9,20,19,0,0,0,0,68
2,18,9,20,19,11,1,0,0,80
2,18,9,20,19,11,1,19,0,99
2,18,9,20,20,12,5,0,0,86
2,18,9,20,20,12,5,4,0,90
2,18,9,20,20,12,5,12,25,123
2,18,9,20,20,12,5,18,0,104
2,18,9,20,20,12,5,19,0,105
2,18,9,20,20,12,5,19,20,125
2,18,9,20,20,12,25,0,0,106
2,18,9,20,20,12,9,14,7,111
2,18,9,20,20,19,0,0,0,88
2,18,9,20,26,11,1,0,0,87
2,18,9,20,26,11,1,19,0,106
2,18,9,20,26,19,11,1,0,106
2,18,9,20,26,19,11,1,19,125
2,18,9,26,26,0,0,0,0,81
2,18,15,1,3,8,0,0,0,47
2,18,15,1,3,8,5,4,0,56
2,18,15,1,3,8,5,18,0,70
2,18,15,1,3,8,5,18,19,89
2,18,15,1,3,8,5,19,0,71
2,18,15,1,3,8,9,14,7,77
2,18,15,1,4,1,3,18,5,67
2,18,15,1,4,1,24,0,0,65
2,18,15,1,4,1,24,5,0,70
2,18,15,1,4,1,24,5,19,89
2,18,15,1,4,2,1,14,4,61
2,18,15,1,4,2,9,12,12,75
2,18,15,1,4,3,1,19,20,83
2,18,15,1,4,5,14,0,0,59
2,18,15,1,4,5,14,5,4,68
2,18,15,1,4,5,14,5,18,82
2,18,15,1,4,5,14,19,0,78
2,18,15,1,4,5,18,0,0,63
2,18,15,1,4,5,19,20,0,84
2,18,15,1,4,7,1,7,5,60
2,18,15,1,4,8,5,1,4,58
2,18,15,1,4,8,15,18,14,95
2,18,15,1,4,9,19,8,0,76
2,18,15,1,4,12,25,0,0,77
2,18,15,1,4,12,9,14,7,82
2,18,15,1,4,12,15,15,13,95
2,18,15,1,4,14,5,19,19,97
2,18,15,1,4,19,9,4,5,77
2,18,15,1,4,20,1,9,12,82
2,18,15,1,4,23,1,25,19,108
2,18,15,1,4,23,9,6,5,83
2,18,15,1,4,23,9,19,5,96
2,18,15,2,0,0,0,0,0,37
2,18,15,3,1,4,5,0,0,48
2,18,15,3,1,4,5,4,0,52
2,18,15,3,1,4,5,19,0,67
2,18,15,3,1,4,9,14,7,73
2,18,15,3,1,7,5,0,0,51
2,18,15,3,1,18,4,0,0,61
2,18,15,3,1,18,4,9,3,73
2,18,15,3,1,20,5,12,0,76
2,18,15,3,1,20,5,12,19,95
2,18,15,3,3,15,12,9,0,77
2,18,15,3,3,15,12,9,19,96
2,18,15,3,8,0,0,0,0,46
2,18,15,3,8,1,14,0,0,61
2,18,15,3,8,1,14,20,0,81
2,18,15,3,8,5,0,0,0,51
2,18,15,3,8,5,20,20,5,96
2,18,15,3,8,15,0,0,0,61
2,18,15,3,8,20,0,0,0,66
2,18,15,3,8,21,18,5,0,90
2,18,15,3,8,21,18,5,19,109
2,18,15,3,11,1,7,5,0,62
2,18,15,3,11,1,7,5,19,81
2,18,15,3,11,5,4,0,0,58
2,18,15,3,11,5,20,19,0,93
2,18,15,3,11,9,19,8,0,85
2,18,15,3,11,12,5,0,0,66
2,18,15,3,11,19,0,0,0,68
2,18,15,3,15,12,9,0,0,74
2,18,15,3,15,12,9,19,0,93
2,18,15,4,4,5,18,0,0,66
2,18,15,4,4,12,5,0,0,60
2,18,15,4,5,5,0,0,0,49
2,18,15,4,5,11,9,14,0,78
2,18,15,4,5,17,21,9,14,105
2,18,15,4,5,18,5,18,0,85
2,18,15,4,5,18,9,5,0,76
2,18,15,4,25,1,7,1,0,73
2,18,15,4,25,1,7,9,0,81
2,18,15,5,2,15,5,0,0,62
2,18,15,7,0,0,0,0,0,42
2,18,15,7,1,14,19,0,0,76
2,18,15,7,7,5,18,0,0,72
2,18,15,7,7,12,5,0,0,66
2,18,15,7,8,0,0,0,0,50
2,18,15,7,21,5,4,0,0,72
2,18,15,7,21,5,6,21,12,107
2,18,15,7,21,5,18,0,0,86
2,18,15,7,21,5,18,25,0,111
2,18,15,7,21,5,19,0,0,87
2,18,15,7,21,9,14,7,0,93
2,18,15,7,21,9,19,8,0,99
2,18,15,9,4,0,0,0,0,48
2,18,15,9,4,5,14,0,0,67
2,18,15,9,4,5,18,0,0,71
2,18,15,9,4,5,18,5,4,80
2,18,15,9,4,5,18,5,18,94
2,18,15,9,4,5,18,25,0,96
2,18,15,9,4,5,18,19,0,90
2,18,15,9,7,14,5,0,0,70
2,18,15,9,12,0,0,0,0,56
2,18,15,9,12,5,4,0,0,65
2,18,15,9,12,5,18,0,0,79
2,18,15,9,12,5,18,25,0,104
2,18,15,9,12,5,18,19,0,98
2,18,15,9,12,9,14,7,0,86
2,18,15,9,12,19,0,0,0,75
2,18,15,11,1,7,5,0,0,59
2,18,15,11,1,7,5,19,0,78
2,18,15,11,5,0,0,0,0,51
2,18,15,11,5,14,0,0,0,65
2,18,15,11,5,14,12,25,0,102
2,18,15,11,5,18,0,0,0,69
2,18,15,11,5,18,1,7,5,82
2,18,15,11,5,18,5,4,0,78
2,18,15,11,5,18,5,19,19,112
2,18,15,11,5,18,25,0,0,94
2,18,15,11,5,18,12,25,0,106
2,18,15,11,5,18,19,0,0,88
2,18,15,11,5,19,0,0,0,70
2,18,15,11,9,14,7,0,0,76
2,18,15,12,5,20,20,9,0,101
2,18,15,12,5,20,20,15,0,107
2,18,15,12,7,1,0,0,0,55
2,18,15,12,12,0,0,0,0,59
2,18,15,12,12,25,0,0,0,84
2,18,15,12,12,9,5,19,0,92
2,18,15,13,1,0,0,0,0,49
2,18,15,13,1,12,0,0,0,61
2,18,15,13,1,12,19,0,0,80
2,18,15,13,1,13,9,4,5,80
2,18,15,13,1,20,5,0,0,74
2,18,15,13,1,20,5,4,0,78
2,18,15,13,1,20,5,19,0,93
2,18,15,13,1,20,9,14,7,99
2,18,15,13,1,20,9,21,13,112
2,18,15,13,1,21,18,9,3,100
2,18,15,13,5,9,7,15,14,98
2,18,15,13,5,12,9,1,4,79
2,18,15,13,5,12,9,14,0,88
2,18,15,13,5,12,9,14,19,107
2,18,15,13,5,15,19,9,14,110
2,18,15,13,5,19,0,0,0,72
2,18,15,13,5,20,8,25,12,118
2,18,15,13,9,3,0,0,0,60
2,18,15,13,9,4,0,0,0,61
2,18,15,13,9,4,5,0,0,66
2,18,15,13,9,4,5,19,0,85
2,18,15,13,9,4,9,3,0,73
2,18,15,13,9,4,19,0,0,80
2,18,15,13,9,14,0,0,0,71
2,18,15,13,9,14,1,20,5,97
2,18,15,13,9,14,5,0,0,76
2,18,15,13,9,14,5,19,0,95
2,18,15,13,9,14,9,19,13,112
2,18,15,13,9,14,9,26,5,111
2,18,15,13,9,14,19,0,0,90
2,18,15,13,25,18,9,20,5,125
2,18,15,13,9,19,5,0,0,81
2,18,15,13,9,19,5,4,0,85
2,18,15,13,9,19,9,14,7,106
2,18,15,13,9,19,13,0,0,89
2,18,15,13,9,19,13,19,0,108
2,18,15,13,9,20,5,0,0,82
2,18,15,13,9,26,5,0,0,88
2,18,15,13,9,26,5,4,0,92
2,18,15,13,9,26,5,18,0,106
2,18,15,13,9,26,5,19,0,107
2,18,15,13,9,26,9,14,7,113
2,18,15,13,12,9,20,5,0,94
2,18,15,13,15,0,0,0,0,63
2,18,15,13,15,6,15,18,13,115
2,18,15,13,15,9,12,0,0,84
2,18,15,13,15,12,0,0,0,75
2,18,15,13,15,16,14,5,1,99
2,18,15,13,15,19,0,0,0,82
2,18,15,13,15,21,19,0,0,103
2,18,15,13,21,18,5,20,0,112
2,18,15,13,22,15,5,12,0,102
2,18,15,13,22,15,7,5,12,109
2,18,15,14,3,0,0,0,0,52
2,18,15,14,3,8,9,0,0,69
2,18,15,14,3,8,9,1,0,70
2,18,15,14,3,8,9,1,12,82
2,18,15,14,3,8,9,21,13,103
2,18,15,14,3,8,15,0,0,75
2,18,15,14,3,8,15,19,0,94
2,18,15,14,3,8,21,19,0,100
2,18,15,14,3,15,0,0,0,67
2,18,15,14,3,15,19,0,0,86
2,18,15,14,3,19,0,0,0,71
2,18,15,14,20,5,15,14,0,103
2,18,15,14,20,5,21,13,0,108
2,18,15,14,20,9,4,5,0,87
2,18,15,14,20,9,4,5,19,106
2,18,15,14,26,5,0,0,0,80
2,18,15,14,26,5,4,0,0,84
2,18,15,14,26,5,14,0,0,94
2,18,15,14,26,5,18,0,0,98
2,18,15,14,26,5,18,19,0,117
2,18,15,14,26,5,19,0,0,99
2,18,15,14,26,25,0,0,0,100
2,18,15,14,26,9,5,18,0,107
2,18,15,14,26,9,5,19,20,128
2,18,15,14,26,9,6,25,0,115
2,18,15,14,26,9,14,5,0,103
2,18,15,14,26,9,14,7,0,105
2,18,15,14,26,9,14,7,19,124
2,18,15,14,26,9,20,5,0,109
2,18,15,15,0,0,0,0,0,50
2,18,15,15,3,8,0,0,0,61
2,18,15,15,3,8,5,4,0,70
2,18,15,15,3,8,5,19,0,85
2,18,15,15,3,8,9,14,7,91
2,18,15,15,4,0,0,0,0,54
2,18,15,15,4,5,4,0,0,63
2,18,15,15,4,5,18,0,0,77
2,18,15,15,4,5,18,19,0,96
2,18,15,15,4,25,0,0,0,79
2,18,15,15,4,9,5,18,0,86
2,18,15,15,4,9,5,19,20,107
2,18,15,15,4,9,12,25,0,100
2,18,15,15,4,9,14,7,0,84
2,18,15,15,4,12,5,19,19,109
2,18,15,15,4,12,5,20,0,91
2,18,15,15,4,12,9,14,7,96
2,18,15,15,4,13,1,18,5,91
2,18,15,15,4,19,0,0,0,73
2,18,15,15,4,19,1,3,0,77
2,18,15,15,11,1,2,12,5,81
2,18,15,15,11,5,4,0,0,70
2,18,15,15,11,25,0,0,0,86
2,18,15,15,11,9,5,0,0,75
2,18,15,15,11,9,5,18,0,93
2,18,15,15,11,9,5,19,20,114
2,18,15,15,11,9,20,5,0,95
2,18,15,15,11,9,20,5,19,114
2,18,15,15,11,12,5,19,19,116
2,18,15,15,11,12,5,20,19,117
2,18,15,15,11,12,9,11,5,98
2,18,15,15,11,12,9,13,5,100
2,18,15,15,11,19,9,4,5,98
2,18,15,15,11,23,5,5,4,98
2,18,15,15,12,0,0,0,0,62
2,18,15,15,13,0,0,0,0,63
2,18,15,15,13,2,1,12,12,90
2,18,15,15,13,2,21,19,8,113
2,18,15,15,13,3,15,18,14,113
2,18,15,15,13,5,4,0,0,72
2,18,15,15,13,5,18,0,0,86
2,18,15,15,13,25,0,0,0,88
2,18,15,15,13,9,5,18,0,95
2,18,15,15,13,9,5,19,20,116
2,18,15,15,13,9,14,7,0,93
2,18,15,15,13,18,1,16,5,103
2,18,15,15,13,18,15,15,20,131
2,18,15,15,13,19,0,0,0,82
2,18,15,15,13,20,1,9,12,105
2,18,15,15,13,23,5,5,4,100
2,18,15,15,13,23,15,15,4,120
2,18,15,15,13,23,15,18,20,139
2,18,15,15,14,0,0,0,0,64
2,18,15,15,19,0,0,0,0,69
2,18,15,15,19,5,0,0,0,74
2,18,15,15,26,12,5,4,0,97
2,18,15,17,21,5,18,25,0,121
2,18,15,19,5,19,0,0,0,78
2,18,15,19,15,20,0,0,0,89
2,18,15,19,19,5,0,0,0,78
2,18,15,20,0,0,0,0,0,55
2,18,15,20,1,14,0,0,0,70
2,18,15,20,1,14,25,0,0,95
2,18,15,20,3,8,5,14,0,85
2,18,15,20,5,12,0,0,0,72
2,18,15,20,8,0,0,0,0,63
2,18,15,20,8,5,0,0,0,68
2,18,15,20,8,5,12,0,0,80
2,18,15,20,8,5,12,5,18,103
2,18,15,20,8,5,12,18,25,123
2,18,15,20,8,5,12,19,0,99
2,18,15,20,8,5,18,5,4,95
2,18,15,20,8,5,18,12,25,123
2,18,15,20,8,25,0,0,0,88
2,18,15,20,8,9,5,18,0,95
2,18,15,20,8,9,5,19,20,116
2,18,15,20,8,19,0,0,0,82
2,18,15,20,21,12,9,4,0,101
2,18,15,21,5,20,20,5,0,106
2,18,15,21,7,8,0,0,0,71
2,18,15,21,7,8,1,13,0,85
2,18,15,21,7,8,1,13,19,104
2,18,15,21,7,8,20,0,0,91
2,18,15,21,7,8,20,1,0,92
2,18,15,21,7,8,20,1,19,111
2,18,15,21,8,1,8,1,0,74
2,18,15,21,8,1,8,1,19,93
2,18,15,21,9,12,12,5,0,94
2,18,15,21,9,12,12,15,14,118
2,18,15,21,26,5,0,0,0,87
2,18,15,23,0,0,0,0,0,58
2,18,15,23,1,3,8,5,0,75
2,18,15,23,2,1,14,4,0,79
2,18,15,23,2,1,14,4,19,98
2,18,15,23,2,5,1,20,0,86
2,18,15,23,2,5,1,20,19,105
2,18,15,23,2,15,21,14,4,114
2,18,15,23,4,0,0,0,0,62
2,18,15,23,4,5,14,0,0,81
2,18,15,23,5,4,0,0,0,67
2,18,15,23,5,20,0,0,0,83
2,18,15,23,9,19,0,0,0,86
2,18,15,23,12,5,19,19,0,113
2,18,15,23,13,1,14,0,0,86
2,18,15,23,14,2,1,3,11,89
2,18,15,23,14,5,4,0,0,81
2,18,15,23,14,5,18,0,0,95
2,18,15,23,14,5,19,20,0,116
2,18,15,23,14,25,0,0,0,97
2,18,15,23,14,9,5,18,0,104
2,18,15,23,14,9,5,19,0,105
2,18,15,23,14,9,5,19,20,125
2,18,15,23,14,9,19,8,0,108
2,18,15,23,14,12,25,0,0,109
2,18,15,23,14,14,5,19,19,129
2,18,15,23,14,14,15,19,5,125
2,18,15,23,14,15,21,20,0,128
2,18,15,23,14,15,21,20,19,147
2,18,15,23,14,20,1,9,12,114
2,18,15,23,14,20,15,16,0,123
2,18,15,23,14,23,5,5,4,109
2,18,15,23,14,23,15,18,20,148
2,18,15,23,16,9,5,3,5,96
2,18,15,23,16,15,19,20,0,128
2,18,15,23,19,0,0,0,0,77
2,18,15,23,19,1,7,5,0,90
2,18,15,23,19,5,0,0,0,82
2,18,15,23,19,5,4,0,0,86
2,18,15,23,19,5,18,0,0,100
2,18,15,23,19,5,18,19,0,119
2,18,15,23,19,5,19,0,0,101
2,18,15,23,19,9,3,11,0,100
2,18,15,23,19,9,14,7,0,107
2,18,15,23,19,20,0,0,0,97
2,18,15,23,26,5,18,0,0,107
2,18,18,0,0,0,0,0,0,38
2,18,18,18,0,0,0,0,0,56
2,18,21,1,14,7,0,0,0,63
2,18,21,2,18,21,0,0,0,82
2,18,21,2,21,0,0,0,0,64
2,18,21,3,5,12,12,1,5,79
2,18,21,3,5,12,12,1,19,93
2,18,21,3,8,9,4,0,0,65
2,18,21,3,9,1,0,0,0,54
2,18,21,3,9,14,0,0,0,67
2,18,21,3,9,14,1,0,0,68
2,18,21,3,9,14,5,0,0,72
2,18,21,3,9,14,5,19,0,91
2,18,21,3,9,14,19,0,0,86
2,18,21,3,9,20,5,0,0,78
2,18,21,3,11,12,5,0,0,72
2,18,21,3,11,12,5,4,0,76
2,18,21,5,20,0,0,0,0,66
2,18,21,7,8,0,0,0,0,56
2,18,21,7,8,19,0,0,0,75
2,18,21,25,5,18,5,0,0,94
2,18,21,9,14,19,0,0,0,83
2,18,21,9,19,5,0,0,0,74
2,18,21,9,19,5,4,0,0,78
2,18,21,9,19,5,18,0,0,92
2,18,21,9,19,5,18,19,0,111
2,18,21,9,19,5,19,0,0,93
2,18,21,9,19,9,14,7,0,99
2,18,21,9,20,0,0,0,0,70
2,18,21,9,20,5,4,0,0,79
2,18,21,9,20,5,18,0,0,93
2,18,21,9,20,5,18,19,0,112
2,18,21,9,20,9,14,7,0,100
2,18,21,9,20,19,0,0,0,89
2,18,21,10,1,0,0,0,0,52
2,18,21,10,1,19,0,0,0,71
2,18,21,10,5,18,9,1,0,84
2,18,21,10,15,0,0,0,0,66
2,18,21,10,15,19,0,0,0,85
2,18,21,11,5,0,0,0,0,57
2,18,21,12,5,5,0,0,0,63
2,18,21,12,5,19,0,0,0,77
2,18,21,12,25,9,5,0,0,92
2,18,21,12,25,9,5,19,0,111
2,18,21,12,15,20,0,0,0,88
2,18,21,12,15,20,19,0,0,107
2,18,21,12,26,9,5,0,0,93
2,18,21,12,26,9,5,19,0,112
2,18,21,13,0,0,0,0,0,54
2,18,21,13,1,12,0,0,0,67
2,18,21,13,2,5,5,0,0,66
2,18,21,13,2,25,0,0,0,81
2,18,21,13,2,9,5,0,0,70
2,18,21,13,2,9,5,19,0,89
2,18,21,13,5,0,0,0,0,59
2,18,21,13,5,19,0,0,0,78
2,18,21,13,13,1,7,5,14,94
2,18,21,13,13,5,18,0,0,90
2,18,21,13,13,25,0,0,0,92
2,18,21,13,15,21,19,0,0,109
2,18,21,13,19,20,1,14,5,113
2,18,21,13,19,20,15,14,5,127
2,18,21,14,3,8,0,0,0,66
2,18,21,14,3,8,5,4,0,75
2,18,21,14,3,8,5,19,0,90
2,18,21,14,3,8,9,14,7,96
2,18,21,14,5,0,0,0,0,60
2,18,21,14,5,20,0,0,0,80
2,18,21,14,5,20,19,0,0,99
2,18,21,14,5,20,20,5,0,105
2,18,21,14,5,20,20,5,19,124
2,18,21,14,9,15,14,0,0,93
2,18,21,14,9,26,5,13,0,108
2,18,21,14,9,26,5,13,19,127
2,18,21,14,14,5,15,21,19,129
2,18,21,14,20,0,0,0,0,75
2,18,21,14,20,19,0,0,0,94
2,18,21,19,3,8,1,0,0,72
2,18,21,19,3,21,19,0,0,103
2,18,21,19,8,1,2,12,5,88
2,18,21,19,8,2,1,3,11,85
2,18,21,19,8,2,1,12,12,95
2,18,21,19,8,2,9,18,4,101
2,18,21,19,8,2,21,19,8,118
2,18,21,19,8,3,21,20,0,112
2,18,21,19,8,5,4,0,0,77
2,18,21,19,8,5,18,0,0,91
2,18,21,19,8,5,18,19,0,110
2,18,21,19,8,5,19,0,0,92
2,18,21,19,8,5,20,0,0,93
2,18,21,19,8,6,9,18,5,106
2,18,21,19,8,6,21,12,0,107
2,18,21,19,8,25,0,0,0,93
2,18,21,19,8,9,5,18,0,100
2,18,21,19,8,9,5,19,20,121
2,18,21,19,8,9,14,7,0,98
2,18,21,19,8,9,20,5,0,102
2,18,21,19,8,12,1,14,4,99
2,18,21,19,8,12,5,19,19,123
2,18,21,19,8,12,5,20,0,105
2,18,21,19,8,12,9,11,5,105
2,18,21,19,8,13,1,14,0,96
2,18,21,19,8,13,5,14,0,100
2,18,21,19,8,15,6,6,0,95
2,18,21,19,8,15,6,6,19,114
2,18,21,19,8,21,16,0,0,105
2,18,21,19,8,21,16,19,0,124
2,18,21,19,8,23,15,15,4,125
2,18,21,19,8,23,15,18,11,135
2,18,21,19,11,0,0,0,0,71
2,18,21,19,11,5,18,0,0,94
2,18,21,19,11,5,19,20,0,115
2,18,21,19,11,12,25,0,0,108
2,18,21,19,11,14,5,19,19,128
2,18,21,19,17,21,5,0,0,103
2,18,21,19,17,21,5,12,25,140
2,18,21,19,17,21,5,18,0,121
2,18,21,19,17,21,5,19,20,142
2,18,21,19,20,12,5,0,0,97
2,18,21,19,20,12,5,4,0,101
2,18,21,19,20,12,9,14,7,122
2,18,21,19,21,18,5,0,0,104
2,18,21,20,1,7,5,0,0,74
2,18,21,20,1,12,0,0,0,74
2,18,21,20,1,12,9,19,5,107
2,18,21,20,1,12,9,19,13,115
2,18,21,20,1,12,9,19,20,122
2,18,21,20,1,12,9,20,25,128
2,18,21,20,1,12,9,26,5,114
2,18,21,20,1,12,12,25,0,111
2,18,21,20,5,0,0,0,0,66
2,18,21,20,5,4,0,0,0,70
2,18,21,20,5,4,15,13,0,98
2,18,21,20,5,12,25,0,0,103
2,18,21,20,5,12,9,11,5,103
2,18,21,20,5,14,5,19,19,123
2,18,21,20,5,19,0,0,0,85
2,18,21,20,9,6,25,0,0,101
2,18,21,20,9,6,9,5,4,94
2,18,21,20,9,6,9,5,19,109
2,18,21,20,9,14,7,0,0,91
2,18,21,20,9,19,8,0,0,97
2,18,21,20,9,19,8,12,25,134
2,18,21,20,9,19,13,0,0,102
2,18,21,20,9,19,13,19,0,121
2,18,21,20,20,5,18,0,0,104
2,18,21,24,9,19,13,0,0,106
2,18,21,24,9,19,13,19,0,125
2,18,21,26,26,0,0,0,0,93
2,19,8,0,0,0,0,0,0,29
2,19,11,20,0,0,0,0,0,52
2,20,9,19,5,0,0,0,0,55
2,20,18,25,0,0,0,0,0,65
2,21,2,1,0,0,0,0,0,26
2,21,2,1,12,0,0,0,0,38
2,21,2,1,12,5,0,0,0,43
2,21,2,1,12,5,19,0,0,62
2,21,2,1,12,9,14,5,0,66
2,21,2,1,12,9,19,5,19,90
2,21,2,1,12,19,0,0,0,57
2,21,2,1,19,0,0,0,0,45
2,21,2,2,5,18,0,0,0,50
2,21,2,2,25,0,0,0,0,52
2,21,2,2,25,2,21,19,8,102
2,21,2,2,9,5,19,0,0,60
2,21,2,2,12,5,0,0,0,44
2,21,2,2,12,5,2,15,23,84
2,21,2,2,12,5,4,0,0,48
2,21,2,2,12,5,18,0,0,62
2,21,2,2,12,5,18,19,0,81
2,21,2,2,12,5,19,0,0,63
2,21,2,2,12,5,20,15,16,95
2,21,2,2,12,25,0,0,0,64
2,21,2,2,12,9,5,18,0,71
2,21,2,2,12,9,5,19,0,72
2,21,2,2,12,9,5,19,20,92
2,21,2,2,12,9,14,7,0,69
2,21,2,2,12,9,19,8,0,75
2,21,2,9,14,7,1,0,0,56
2,21,2,9,14,7,1,19,0,75
2,21,2,15,5,4,0,0,0,49
2,21,2,15,5,19,0,0,0,64
2,21,2,15,14,9,3,0,0,66
2,21,2,15,19,0,0,0,0,59
2,21,2,19,0,0,0,0,0,44
2,21,2,21,11,12,5,0,0,74
2,21,3,1,25,15,0,0,0,67
2,21,3,1,18,5,0,0,0,50
2,21,3,3,1,0,0,0,0,30
2,21,3,3,1,12,0,0,0,42
2,21,3,3,1,12,12,25,0,79
2,21,3,3,1,14,0,0,0,44
2,21,3,3,1,14,5,4,0,53
2,21,3,3,1,14,5,5,18,72
2,21,3,3,1,14,9,14,7,74
2,21,3,3,1,14,14,5,4,67
2,21,3,3,1,18,15,0,0,63
2,21,3,3,1,20,5,0,0,55
2,21,3,3,8,5,18,15,0,75
2,21,3,3,8,5,18,15,19,94
2,21,3,3,9,14,0,0,0,52
2,21,3,3,9,14,1,0,0,53
2,21,3,3,9,14,1,5,0,58
2,21,3,3,9,14,1,12,0,65
2,21,3,3,9,14,15,9,4,80
2,21,3,3,21,12,1,0,0,63
2,21,3,3,21,12,1,5,0,68
2,21,3,5,12,12,1,19,0,75
2,21,3,5,14,20,1,21,18,105
2,21,3,5,14,20,21,18,0,104
2,21,3,8,9,20,5,0,0,68
2,21,3,8,15,14,9,20,5,97
2,21,3,8,21,0,0,0,0,55
2,21,3,11,1,25,18,15,0,96
2,21,3,11,1,25,18,15,19,115
2,21,3,11,1,18,15,15,0,86
2,21,3,11,1,18,15,15,19,105
2,21,3,11,1,19,19,0,0,76
2,21,3,11,2,5,1,14,0,59
2,21,3,11,2,5,1,14,19,78
2,21,3,11,2,5,18,18,25,105
2,21,3,11,2,15,1,18,4,77
2,21,3,11,2,18,21,19,8,105
2,21,3,11,2,21,19,8,0,87
2,21,3,11,5,4,0,0,0,46
2,21,3,11,5,5,14,0,0,61
2,21,3,11,5,5,14,19,0,80
2,21,3,11,5,25,5,0,0,72
2,21,3,11,5,25,5,4,0,76
2,21,3,11,5,25,5,19,0,91
2,21,3,11,5,18,0,0,0,60
2,21,3,11,5,18,15,15,0,90
2,21,3,11,5,18,15,15,19,109
2,21,3,11,5,18,19,0,0,79
2,21,3,11,5,20,0,0,0,62
2,21,3,11,5,20,5,4,0,71
2,21,3,11,5,20,5,5,18,90
2,21,3,11,5,20,5,18,0,85
2,21,3,11,5,20,6,21,12,101
2,21,3,11,5,20,25,0,0,87
2,21,3,11,5,20,9,14,7,92
2,21,3,11,5,20,13,1,14,90
2,21,3,11,5,20,19,0,0,81
2,21,3,11,8,15,18,14,0,92
2,21,3,11,8,15,21,14,4,99
2,21,3,11,9,14,7,0,0,67
2,21,3,11,9,19,8,0,0,73
2,21,3,11,9,19,8,12,25,110
2,21,3,11,9,19,13,0,0,78
2,21,3,11,10,21,13,16,0,97
2,21,3,11,12,5,4,0,0,58
2,21,3,11,12,5,18,5,4,81
2,21,3,11,12,5,18,19,0,91
2,21,3,11,12,5,19,0,0,73
2,21,3,11,12,9,14,7,0,79
2,21,3,11,12,21,13,0,0,83
2,21,3,11,15,0,0,0,0,52
2,21,3,11,15,5,19,0,0,76
2,21,3,11,15,14,5,0,0,71
2,21,3,11,16,12,1,20,5,91
2,21,3,11,16,15,20,0,0,88
2,21,3,11,18,1,0,0,0,56
2,21,3,11,18,1,13,0,0,69
2,21,3,11,18,1,13,5,4,78
2,21,3,11,18,1,13,19,0,88
2,21,3,11,18,1,19,0,0,75
2,21,3,11,19,1,23,0,0,80
2,21,3,11,19,1,23,19,0,99
2,21,3,11,19,8,5,5,0,74
2,21,3,11,19,8,5,5,19,93
2,21,3,11,19,8,15,20,0,99
2,21,3,11,19,8,15,20,19,118
2,21,3,11,19,11,9,14,0,90
2,21,3,11,19,11,9,14,19,109
2,21,3,11,19,20,1,25,0,102
2,21,3,11,19,20,1,12,12,101
2,21,3,11,19,20,15,14,5,110
2,21,3,11,20,1,9,12,0,79
2,21,3,11,20,1,9,12,19,98
2,21,3,11,20,5,5,20,8,95
2,21,3,11,20,8,15,18,14,112
2,21,3,11,20,15,15,20,8,115
2,21,3,11,21,0,0,0,0,58
2,21,3,11,23,1,7,15,14,97
2,21,3,11,23,1,19,8,0,88
2,21,3,11,23,8,5,1,20,94
2,21,3,15,12,9,1,19,20,102
2,21,3,15,12,9,3,0,0,65
2,21,3,15,12,9,3,1,12,78
2,21,3,18,1,14,5,0,0,64
2,21,3,18,1,14,9,1,0,69
2,21,3,18,1,14,9,21,13,102
2,21,3,18,14,9,1,0,0,68
2,21,4,2,18,5,1,11,0,64
2,21,4,4,1,7,5,0,0,44
2,21,4,4,1,8,0,0,0,40
2,21,4,4,5,4,0,0,0,40
2,21,4,4,5,18,0,0,0,54
2,21,4,4,5,18,19,0,0,73
2,21,4,4,8,9,0,0,0,48
2,21,4,4,8,9,19,20,19,106
2,21,4,4,9,5,4,0,0,49
2,21,4,4,9,5,19,0,0,64
2,21,4,4,25,9,14,7,0,86
2,21,4,4,9,14,7,19,0,80
2,21,4,4,12,5,0,0,0,48
2,21,4,4,12,5,4,0,0,52
2,21,4,4,12,5,9,1,19,77
2,21,4,4,12,5,13,1,14,76
2,21,4,4,12,5,18,0,0,66
2,21,4,4,12,5,19,0,0,67
2,21,4,4,12,9,14,7,0,73
2,21,4,7,5,4,0,0,0,43
2,21,4,7,5,18,0,0,0,57
2,21,4,7,5,18,5,5,0,67
2,21,4,7,5,18,15,0,0,72
2,21,4,7,5,18,15,23,0,95
2,21,4,7,5,18,19,0,0,76
2,21,4,7,5,19,0,0,0,58
2,21,4,7,5,20,1,18,25,103
2,21,4,7,5,20,5,4,0,68
2,21,4,7,5,20,5,5,18,87
2,21,4,7,5,20,5,18,0,82
2,21,4,7,5,20,5,18,19,101
2,21,4,7,5,20,6,21,12,98
2,21,4,7,5,20,9,14,7,89
2,21,4,7,5,20,19,0,0,78
2,21,4,7,25,0,0,0,0,59
2,21,4,7,9,5,0,0,0,48
2,21,4,7,9,5,19,0,0,67
2,21,4,7,9,14,7,0,0,64
2,21,4,12,5,19,19,0,0,82
2,21,4,12,5,20,0,0,0,64
2,21,4,12,9,11,5,0,0,64
2,21,4,12,9,14,7,0,0,69
2,21,4,13,1,19,8,0,0,68
2,21,4,19,0,0,0,0,0,46
2,21,4,20,9,13,5,0,0,74
2,21,4,23,15,15,4,0,0,84
2,21,4,23,15,18,13,0,0,96
2,21,4,23,15,18,13,19,0,115
2,21,4,26,1,18,20,0,0,92
2,21,4,26,1,20,0,0,0,74
2,21,5,14,1,19,0,0,0,62
2,21,6,1,7,9,14,0,0,60
2,21,6,6,1,0,0,0,0,36
2,21,6,6,1,2,12,5,0,55
2,21,6,6,1,12,15,5,4,72
2,21,6,6,1,12,15,5,19,87
2,21,6,6,1,12,15,19,0,82
2,21,6,6,2,1,12,12,0,62
2,21,6,6,2,1,18,0,0,56
2,21,6,6,3,15,1,20,0,74
2,21,6,6,5,0,0,0,0,40
2,21,6,6,5,4,0,0,0,44
2,21,6,6,5,18,0,0,0,58
2,21,6,6,5,18,5,4,0,67
2,21,6,6,5,18,9,14,7,88
2,21,6,6,5,18,18,5,18,99
2,21,6,6,5,18,19,0,0,77
2,21,6,6,5,20,5,4,0,69
2,21,6,6,5,20,5,18,0,83
2,21,6,6,5,20,5,18,19,102
2,21,6,6,5,20,9,14,7,90
2,21,6,6,5,20,19,0,0,79
2,21,6,6,9,0,0,0,0,44
2,21,6,6,9,5,18,0,0,67
2,21,6,6,9,5,19,20,0,88
2,21,6,6,9,14,0,0,0,58
2,21,6,6,9,14,7,0,0,65
2,21,6,6,12,5,0,0,0,52
2,21,6,6,15,14,5,0,0,69
2,21,6,6,15,14,20,0,0,84
2,21,6,6,15,15,14,0,0,79
2,21,6,6,15,15,14,19,0,98
2,21,6,6,15,19,0,0,0,69
2,21,6,6,19,0,0,0,0,54
2,21,6,6,23,1,18,5,0,82
2,21,6,9,4,9,14,0,0,65
2,21,6,15,0,0,0,0,0,44
2,21,6,15,14,9,4,0,0,71
2,21,6,15,14,9,20,5,0,92
2,21,6,15,20,1,12,9,14,100
2,21,6,15,20,5,14,9,14,106
2,21,6,15,20,15,24,9,14,126
2,21,7,1,2,15,15,0,0,63
2,21,7,1,2,15,15,19,0,82
2,21,7,1,12,1,0,0,0,44
2,21,7,1,14,0,0,0,0,45
2,21,7,1,18,1,0,0,0,50
2,21,7,2,1,14,5,0,0,52
2,21,7,2,1,14,5,19,0,71
2,21,7,2,5,1,18,0,0,56
2,21,7,2,5,1,18,19,0,75
2,21,7,2,9,20,5,0,0,66
2,21,7,4,15,13,0,0,0,62
2,21,7,5,25,5,0,0,0,65
2,21,7,5,25,5,4,0,0,69
2,21,7,5,25,5,19,0,0,84
2,21,7,6,9,19,8,0,0,72
2,21,7,7,1,14,5,0,0,57
2,21,7,7,5,4,0,0,0,46
2,21,7,7,5,18,0,0,0,60
2,21,7,7,5,18,5,4,0,69
2,21,7,7,5,18,25,0,0,85
2,21,7,7,5,18,9,5,19,93
2,21,7,7,5,18,9,14,7,90
2,21,7,7,5,18,19,0,0,79
2,21,7,7,5,19,19,0,0,80
2,21,7,7,25,0,0,0,0,62
2,21,7,7,9,5,18,0,0,69
2,21,7,7,9,5,19,0,0,70
2,21,7,7,9,5,19,20,0,90
2,21,7,7,25,13,1,14,0,90
2,21,7,7,25,13,5,14,0,94
2,21,7,7,9,14,5,19,19,103
2,21,7,7,9,14,7,0,0,67
2,21,7,8,5,1,4,0,0,48
2,21,7,8,15,21,19,5,0,98
2,21,7,8,15,21,19,5,19,117
2,21,7,8,20,0,0,0,0,58
2,21,7,12,5,0,0,0,0,47
2,21,7,12,5,4,0,0,0,51
2,21,7,12,5,18,0,0,0,65
2,21,7,12,5,18,19,0,0,84
2,21,7,12,5,19,0,0,0,66
2,21,7,12,5,20,0,0,0,67
2,21,7,12,5,23,5,5,4,84
2,21,7,12,5,23,15,18,20,123
2,21,7,12,9,14,7,0,0,72
2,21,7,12,15,19,19,0,0,95
2,21,7,12,15,19,19,5,19,119
2,21,7,15,12,15,7,25,0,104
2,21,7,15,14,7,0,0,0,66
2,21,7,15,21,20,0,0,0,86
2,21,7,16,18,15,15,6,0,100
2,21,7,18,5,0,0,0,0,53
2,21,7,19,0,0,0,0,0,49
2,21,7,19,5,5,4,0,0,63
2,21,7,19,5,5,4,19,0,82
2,21,7,19,8,1,0,0,0,58
2,21,7,19,8,1,19,0,0,77
2,21,7,23,5,5,4,0,0,67
2,21,7,23,15,18,20,0,0,106
2,21,8,12,2,21,8,12,0,86
2,21,8,12,19,0,0,0,0,62
2,21,8,12,23,15,18,11,0,110
2,21,8,12,23,15,18,11,19,129
2,21,8,18,0,0,0,0,0,49
2,21,8,18,13,9,12,12,0,95
2,21,8,18,19,0,0,0,0,68
2,21,8,18,19,20,15,14,5,122
2,21,25,0,0,0,0,0,0,48
2,21,25,1,2,12,5,0,0,68
2,21,25,2,1,3,11,0,0,65
2,21,25,2,1,3,11,19,0,84
2,21,9,2,21,9,0,0,0,64
2,21,9,3,11,19,0,0,0,65
2,21,25,9,14,7,0,0,0,78
2,21,9,12,4,0,0,0,0,48
2,21,9,12,4,1,2,12,5,68
2,21,9,12,4,5,4,0,0,57
2,21,9,12,4,5,18,0,0,71
2,21,9,12,4,5,18,19,0,90
2,21,9,12,4,9,14,7,0,78
2,21,9,12,4,9,14,7,19,97
2,21,9,12,4,18,5,19,19,109
2,21,9,12,4,19,0,0,0,67
2,21,9,12,4,21,16,0,0,85
2,21,9,12,4,21,16,19,0,104
2,21,9,12,20,0,0,0,0,64
2,21,9,12,20,9,14,0,0,87
2,21,25,15,21,20,0,0,0,104
2,21,25,15,21,20,19,0,0,123
2,21,9,18,4,12,25,0,0,91
2,21,25,19,0,0,0,0,0,67
2,21,9,19,20,0,0,0,0,71
2,21,11,8,0,0,0,0,0,42
2,21,11,19,8,5,5,0,0,71
2,21,11,19,8,9,0,0,0,70
2,21,12,1,11,0,0,0,0,47
2,21,12,2,0,0,0,0,0,37
2,21,12,2,1,18,0,0,0,56
2,21,12,2,5,4,0,0,0,46
2,21,12,2,5,12,0,0,0,54
2,21,12,2,5,12,19,0,0,73
2,21,12,2,25,0,0,0,0,62
2,21,12,2,9,5,18,0,0,69
2,21,12,2,9,5,19,20,0,90
2,21,12,2,9,6,15,18,13,98
2,21,12,2,9,12,0,0,0,58
2,21,12,2,9,12,12,1,0,71
2,21,12,2,9,12,19,0,0,77
2,21,12,2,9,14,5,0,0,65
2,21,12,2,12,5,19,19,0,92
2,21,12,2,12,5,20,0,0,74
2,21,12,2,12,5,20,19,0,93
2,21,12,2,12,9,11,5,0,74
2,21,12,2,15,19,5,0,0,76
2,21,12,2,15,21,19,0,0,92
2,21,12,2,15,21,19,12,25,129
2,21,12,2,19,0,0,0,0,56
2,21,12,2,21,12,0,0,0,70
2,21,12,2,21,12,5,0,0,75
2,21,12,2,21,12,19,0,0,89
2,21,12,2,21,19,0,0,0,77
2,21,12,3,8,9,14,0,0,69
2,21,12,4,5,18,0,0,0,62
2,21,12,7,5,4,0,0,0,51
2,21,12,7,5,18,19,0,0,84
2,21,12,7,5,19,0,0,0,66
2,21,12,7,25,0,0,0,0,67
2,21,12,7,9,5,18,0,0,74
2,21,12,7,9,5,19,20,0,95
2,21,12,7,9,14,5,19,19,108
2,21,12,7,9,14,7,0,0,72
2,21,12,7,9,14,7,12,25,109
2,21,12,7,21,18,0,0,0,81
2,21,12,7,21,18,19,0,0,100
2,21,12,9,5,19,0,0,0,68
2,21,12,9,13,25,0,0,0,82
2,21,12,9,13,9,1,0,0,67
2,21,12,9,13,9,1,3,0,70
2,21,12,9,13,9,1,19,0,86
2,21,12,9,13,9,3,0,0,69
2,21,12,9,13,15,9,4,0,85
2,21,12,11,0,0,0,0,0,46
2,21,12,11,1,7,5,0,0,59
2,21,12,11,1,7,5,19,0,78
2,21,12,11,5,4,0,0,0,55
2,21,12,11,5,18,0,0,0,69
2,21,12,11,8,5,1,4,0,64
2,21,12,11,8,5,1,4,19,83
2,21,12,11,25,0,0,0,0,71
2,21,12,11,9,5,18,0,0,78
2,21,12,11,9,5,19,20,0,99
2,21,12,11,9,12,25,0,0,92
2,21,12,11,9,14,0,0,0,69
2,21,12,11,9,14,5,19,19,112
2,21,12,11,9,14,7,0,0,76
2,21,12,11,9,19,8,0,0,82
2,21,12,11,19,0,0,0,0,65
2,21,12,12,1,0,0,0,0,48
2,21,12,12,1,3,5,0,0,56
2,21,12,12,1,3,5,19,0,75
2,21,12,12,1,5,0,0,0,53
2,21,12,12,1,14,0,0,0,62
2,21,12,12,1,18,25,0,0,91
2,21,12,12,1,18,9,1,0,76
2,21,12,12,1,18,9,5,19,99
2,21,12,12,1,18,9,21,13,109
2,21,12,12,1,20,5,0,0,73
2,21,12,12,1,20,5,4,0,77
2,21,12,12,1,20,9,15,14,106
2,21,12,12,2,1,3,11,0,64
2,21,12,12,2,1,20,0,0,70
2,21,12,12,2,1,20,19,0,89
2,21,12,12,2,5,18,18,25,115
2,21,12,12,2,9,18,4,0,80
2,21,12,12,2,15,1,20,0,85
2,21,12,12,3,1,18,20,0,89
2,21,12,12,4,15,7,0,0,73
2,21,12,12,4,15,7,7,25,105
2,21,12,12,4,15,7,19,0,92
2,21,12,12,4,15,26,5,0,97
2,21,12,12,4,15,26,5,4,101
2,21,12,12,4,15,26,5,18,115
2,21,12,12,4,15,26,5,19,116
2,21,12,12,4,21,19,20,0,111
2,21,12,12,5,4,0,0,0,56
2,21,12,12,5,20,0,0,0,72
2,21,12,12,5,20,5,4,0,81
2,21,12,12,5,20,25,0,0,97
2,21,12,12,5,20,9,14,0,95
2,21,12,12,5,20,9,14,7,102
2,21,12,12,5,20,9,14,19,114
2,21,12,12,5,20,19,0,0,91
2,21,12,12,6,5,1,19,20,98
2,21,12,12,6,9,3,5,0,70
2,21,12,12,6,9,7,8,20,97
2,21,12,12,6,9,14,3,8,87
2,21,12,12,6,9,19,20,0,101
2,21,12,12,6,15,15,20,0,103
2,21,12,12,6,18,15,7,0,93
2,21,12,12,6,18,15,7,19,112
2,21,12,12,7,9,14,5,0,82
2,21,12,12,8,5,1,4,0,65
2,21,12,12,8,5,1,4,19,84
2,21,12,12,8,9,4,5,0,73
2,21,12,12,8,15,15,6,0,91
2,21,12,12,8,15,18,14,0,102
2,21,12,12,8,15,18,14,19,121
2,21,12,12,25,1,2,12,5,92
2,21,12,12,25,2,15,25,0,114
2,21,12,12,25,2,15,25,19,133
2,21,12,12,25,4,15,13,0,104
2,21,12,12,9,5,4,0,0,65
2,21,12,12,9,5,18,0,0,79
2,21,12,12,9,5,19,0,0,80
2,21,12,12,9,5,19,20,0,100
2,21,12,12,9,6,15,18,13,108
2,21,12,12,25,8,21,6,6,113
2,21,12,12,25,9,14,7,0,102
2,21,12,12,25,9,19,13,0,113
2,21,12,12,9,13,15,14,7,105
2,21,12,12,9,14,7,0,0,77
2,21,12,12,9,15,14,19,0,104
2,21,12,12,25,18,1,7,0,98
2,21,12,12,25,18,1,7,19,117
2,21,12,12,25,18,15,3,11,119
2,21,12,12,25,18,15,15,11,131
2,21,12,12,9,19,8,0,0,83
2,21,12,12,9,19,8,12,25,120
2,21,12,12,9,19,13,0,0,88
2,21,12,12,9,20,0,0,0,76
2,21,12,12,9,20,9,15,14,114
2,21,12,12,12,9,11,5,0,84
2,21,12,12,14,5,3,11,0,80
2,21,12,12,14,5,3,11,19,99
2,21,12,12,14,15,19,5,0,100
2,21,12,12,14,15,19,5,19,119
2,21,12,12,14,21,20,0,0,102
2,21,12,12,15,3,11,5,18,99
2,21,12,12,15,3,11,25,0,101
2,21,12,12,15,3,11,19,0,95
2,21,12,12,15,19,5,0,0,86
2,21,12,12,15,21,19,0,0,102
2,21,12,12,16,1,20,5,19,108
2,21,12,12,16,5,14,0,0,82
2,21,12,12,16,5,14,19,0,101
2,21,12,12,16,15,12,12,0,102
2,21,12,12,16,15,21,20,0,119
2,21,12,12,16,15,21,20,19,138
2,21,12,12,18,9,14,7,0,95
2,21,12,12,18,9,14,7,19,114
2,21,12,12,18,21,19,8,0,113
2,21,12,12,19,0,0,0,0,66
2,21,12,12,19,5,25,5,0,101
2,21,12,12,19,8,9,20,0,103
2,21,12,12,19,8,9,20,19,122
2,21,12,12,19,8,15,20,0,109
2,21,12,12,19,8,15,20,19,128
2,21,12,12,19,11,9,14,0,100
2,21,12,12,19,14,1,11,5,97
2,21,12,12,19,23,15,15,12,131
2,21,12,12,20,15,1,4,0,87
2,21,12,12,21,12,5,0,0,85
2,21,12,12,23,5,5,4,0,84
2,21,12,12,23,5,5,4,19,103
2,21,12,12,23,8,1,3,11,93
2,21,12,12,23,8,9,16,0,103
2,21,12,12,23,8,9,16,19,122
2,21,12,12,23,15,18,11,0,114
2,21,12,12,23,15,18,20,0,123
2,21,12,14,2,21,12,14,0,98
2,21,12,18,5,5,4,25,0,92
2,21,12,18,21,19,8,0,0,101
2,21,12,18,21,19,8,5,19,125
2,21,12,18,21,19,8,25,0,126
2,21,12,19,5,0,0,0,0,59
2,21,12,20,0,0,0,0,0,55
2,21,12,20,5,25,0,0,0,85
2,21,12,20,5,12,12,0,0,84
2,21,12,20,5,14,0,0,0,74
2,21,12,20,5,18,0,0,0,78
2,21,12,20,15,14,7,0,0,91
2,21,12,20,15,23,0,0,0,93
2,21,12,23,1,14,4,0,0,77
2,21,12,23,1,18,11,0,0,88
2,21,12,23,1,18,11,5,4,97
2,21,12,23,1,18,11,19,0,107
2,21,13,1,12,15,5,0,0,69
2,21,13,1,18,5,5,0,0,65
2,21,13,2,1,18,4,0,0,61
2,21,13,2,1,18,7,5,0,69
2,21,13,2,1,19,19,0,0,77
2,21,13,2,1,19,20,5,0,83
2,21,13,2,1,26,5,0,0,70
2,21,13,2,5,5,0,0,0,48
2,21,13,2,5,12,15,0,0,70
2,21,13,2,12,5,0,0,0,55
2,21,13,2,12,5,2,5,5,67
2,21,13,2,12,5,4,0,0,59
2,21,13,2,12,5,18,0,0,73
2,21,13,2,12,5,18,19,0,92
2,21,13,2,12,5,19,0,0,74
2,21,13,2,12,9,14,7,0,80
2,21,13,2,12,9,14,7,19,99
2,21,13,2,15,0,0,0,0,53
2,21,13,2,15,1,20,0,0,74
2,21,13,2,15,1,20,19,0,93
2,21,13,3,12,15,3,11,0,80
2,21,13,6,0,0,0,0,0,42
2,21,13,6,5,7,0,0,0,54
2,21,13,6,19,0,0,0,0,61
2,21,13,6,21,26,26,12,5,132
2,21,13,9,3,11,25,0,0,84
2,21,13,11,9,14,0,0,0,70
2,21,13,11,9,14,19,0,0,89
2,21,13,13,1,3,11,0,0,64
2,21,13,13,1,12,15,0,0,77
2,21,13,13,1,12,15,19,0,96
2,21,13,13,1,18,5,5,0,78
2,21,13,13,5,4,0,0,0,58
2,21,13,13,5,12,0,0,0,66
2,21,13,13,5,18,0,0,0,72
2,21,13,13,5,18,25,0,0,97
2,21,13,13,5,18,9,19,8,108
2,21,13,13,5,18,19,0,0,91
2,21,13,13,5,19,20,0,0,93
2,21,13,13,9,5,0,0,0,63
2,21,13,13,9,12,0,0,0,70
2,21,13,13,9,14,7,0,0,79
2,21,13,13,12,5,0,0,0,66
2,21,13,13,12,5,18,0,0,84
2,21,13,13,15,3,11,0,0,78
2,21,13,16,0,0,0,0,0,52
2,21,13,16,5,4,0,0,0,61
2,21,13,16,5,5,0,0,0,62
2,21,13,16,5,18,0,0,0,75
2,21,13,16,5,18,5,4,0,84
2,21,13,16,5,18,9,14,7,105
2,21,13,16,5,18,19,0,0,94
2,21,13,16,8,0,0,0,0,60
2,21,13,16,8,19,0,0,0,79
2,21,13,16,25,0,0,0,0,77
2,21,13,16,9,5,18,0,0,84
2,21,13,16,9,5,19,20,0,105
2,21,13,16,9,12,25,0,0,98
2,21,13,16,9,14,5,19,19,118
2,21,13,16,9,14,7,0,0,82
2,21,13,16,9,14,7,12,25,119
2,21,13,16,9,20,25,0,0,106
2,21,13,16,11,9,14,0,0,86
2,21,13,16,11,9,14,5,20,111
2,21,13,16,11,9,14,12,25,123
2,21,13,16,11,9,14,19,0,105
2,21,13,16,15,6,6,0,0,79
2,21,13,16,15,12,15,7,25,126
2,21,13,16,19,0,0,0,0,71
2,21,13,16,19,25,0,0,0,96
2,21,13,16,20,9,15,21,19,136
2,21,13,19,0,0,0,0,0,55
2,21,13,20,18,1,16,0,0,91
2,21,13,23,15,15,4,0,0,93
2,21,14,0,0,0,0,0,0,37
2,21,14,3,1,12,0,0,0,53
2,21,14,3,8,5,4,0,0,57
2,21,14,3,8,5,18,0,0,71
2,21,14,3,8,5,19,0,0,72
2,21,14,3,8,25,0,0,0,73
2,21,14,3,8,9,5,18,0,80
2,21,14,3,8,9,5,19,20,101
2,21,14,3,8,9,12,25,0,94
2,21,14,3,8,9,14,7,0,78
2,21,14,3,15,0,0,0,0,55
2,21,14,3,15,5,4,0,0,64
2,21,14,3,15,9,14,7,0,85
2,21,14,3,15,13,2,5,19,94
2,21,14,3,15,19,0,0,0,74
2,21,14,4,8,0,0,0,0,49
2,21,14,4,9,5,19,0,0,74
2,21,14,4,9,19,20,19,0,108
2,21,14,4,12,5,0,0,0,58
2,21,14,4,12,5,4,0,0,62
2,21,14,4,12,5,18,0,0,76
2,21,14,4,12,5,18,19,0,95
2,21,14,4,12,5,19,0,0,77
2,21,14,4,12,5,20,0,0,78
2,21,14,4,12,9,14,7,0,83
2,21,14,4,12,9,14,7,19,102
2,21,14,4,15,2,21,19,20,118
2,21,14,4,15,3,0,0,0,59
2,21,14,4,15,3,11,19,0,89
2,21,14,4,15,15,11,0,0,82
2,21,14,4,19,0,0,0,0,60
2,21,14,4,20,0,0,0,0,61
2,21,14,4,20,19,0,0,0,80
2,21,14,4,23,5,5,4,0,78
2,21,14,5,13,15,19,20,0,109
2,21,14,7,0,0,0,0,0,44
2,21,14,7,1,12,15,9,4,85
2,21,14,7,1,12,15,23,0,95
2,21,14,7,1,12,15,23,19,114
2,21,14,7,1,18,21,13,0,97
2,21,14,7,5,4,0,0,0,53
2,21,14,7,5,5,0,0,0,54
2,21,14,7,5,25,0,0,0,74
2,21,14,7,5,18,0,0,0,67
2,21,14,7,5,18,12,25,0,104
2,21,14,7,6,21,0,0,0,71
2,21,14,7,6,21,12,12,0,95
2,21,14,7,8,15,12,5,0,84
2,21,14,7,8,15,12,5,19,103
2,21,14,7,25,0,0,0,0,69
2,21,14,7,9,14,7,0,0,74
2,21,14,7,12,5,0,0,0,61
2,21,14,7,12,5,4,0,0,65
2,21,14,7,12,5,18,0,0,79
2,21,14,7,12,5,18,19,0,98
2,21,14,7,12,5,19,0,0,80
2,21,14,7,12,9,14,7,0,86
2,21,14,7,12,9,14,7,19,105
2,21,14,7,13,1,11,5,18,92
2,21,14,7,15,0,0,0,0,59
2,21,14,7,15,19,0,0,0,78
2,21,14,7,19,0,0,0,0,63
2,21,14,7,20,15,23,14,0,116
2,21,14,7,23,1,12,12,0,92
2,21,14,25,1,0,0,0,0,63
2,21,14,25,1,8,0,0,0,71
2,21,14,25,1,19,0,0,0,82
2,21,14,25,9,16,0,0,0,87
2,21,14,9,15,14,0,0,0,75
2,21,14,9,15,14,19,0,0,94
2,21,14,10,1,18,1,0,0,67
2,21,14,11,0,0,0,0,0,48
2,21,14,11,5,4,0,0,0,57
2,21,14,11,5,18,1,7,5,84
2,21,14,11,5,18,5,4,0,80
2,21,14,11,5,18,25,0,0,96
2,21,14,11,5,18,9,14,7,101
2,21,14,11,5,18,13,1,14,99
2,21,14,11,5,18,13,5,14,103
2,21,14,11,5,18,19,0,0,90
2,21,14,11,8,15,21,19,5,116
2,21,14,11,9,14,7,0,0,78
2,21,14,11,12,15,1,4,0,80
2,21,14,11,13,1,20,5,0,87
2,21,14,11,13,1,20,5,19,106
2,21,14,11,15,0,0,0,0,63
2,21,14,11,15,5,4,0,0,72
2,21,14,11,15,9,14,7,0,93
2,21,14,11,15,19,0,0,0,82
2,21,14,11,19,0,0,0,0,67
2,21,14,11,21,13,0,0,0,82
2,21,14,11,21,13,19,0,0,101
2,21,14,14,9,1,0,0,0,61
2,21,14,14,9,5,19,0,0,84
2,21,14,14,9,14,7,0,0,81
2,21,14,15,4,15,14,20,0,105
2,21,14,18,1,11,21,0,0,88
2,21,14,18,1,11,21,19,0,107
2,21,14,19,0,0,0,0,0,56
2,21,14,19,5,14,9,20,5,109
2,21,14,20,0,0,0,0,0,57
2,21,14,20,1,12,0,0,0,70
2,21,14,20,5,4,0,0,0,66
2,21,14,20,5,18,19,0,0,99
2,21,14,20,25,0,0,0,0,82
2,21,14,20,9,14,5,0,0,85
2,21,14,20,9,14,7,19,0,106
2,21,14,20,12,9,14,5,0,97
2,21,14,20,12,9,14,5,19,116
2,21,14,20,15,14,0,0,0,86
2,21,14,20,19,0,0,0,0,76
2,21,14,21,5,12,15,0,0,90
2,21,15,25,0,0,0,0,0,63
2,21,15,25,1,7,5,0,0,76
2,21,15,25,1,7,5,19,0,95
2,21,15,25,1,14,3,5,0,86
2,21,15,25,1,14,3,5,19,105
2,21,15,25,1,14,3,25,0,106
2,21,15,25,1,14,20,0,0,98
2,21,15,25,1,14,20,12,25,135
2,21,15,25,5,4,0,0,0,72
2,21,15,25,9,14,7,0,0,93
2,21,15,25,19,0,0,0,0,82
2,21,15,14,1,13,1,14,9,90
2,21,15,14,1,13,1,14,15,96
2,21,16,12,5,21,18,15,12,122
2,21,16,12,5,22,5,18,0,101
2,21,16,18,5,19,20,9,4,114
2,21,17,19,8,1,0,0,0,68
2,21,17,19,8,1,19,0,0,87
2,21,18,1,0,0,0,0,0,42
2,21,18,1,14,19,0,0,0,75
2,21,18,1,15,0,0,0,0,57
2,21,18,2,1,18,11,0,0,73
2,21,18,2,12,5,0,0,0,60
2,21,18,2,12,5,4,0,0,64
2,21,18,2,12,5,18,0,0,78
2,21,18,2,12,5,18,19,0,97
2,21,18,2,12,5,19,0,0,79
2,21,18,2,12,25,0,0,0,80
2,21,18,2,12,9,5,18,0,87
2,21,18,2,12,9,5,19,20,108
2,21,18,2,12,9,14,7,0,85
2,21,18,2,15,12,20,0,0,90
2,21,18,2,15,20,0,0,0,78
2,21,18,2,15,20,19,0,0,97
2,21,18,2,19,0,0,0,0,62
2,21,18,2,21,19,8,0,0,91
2,21,18,4,1,12,15,14,5,92
2,21,18,4,1,19,8,0,0,73
2,21,18,4,5,14,0,0,0,64
2,21,18,4,5,14,5,4,0,73
2,21,18,4,5,14,5,18,0,87
2,21,18,4,5,14,5,18,19,106
2,21,18,4,5,14,9,14,7,94
2,21,18,4,5,14,15,21,19,119
2,21,18,4,5,14,19,0,0,83
2,21,18,4,9,5,0,0,0,59
2,21,18,4,9,5,19,0,0,78
2,21,18,4,15,3,11,0,0,74
2,21,18,4,15,3,11,19,0,93
2,21,18,4,15,14,0,0,0,74
2,21,18,4,19,0,0,0,0,64
2,21,18,5,1,21,0,0,0,68
2,21,18,5,1,21,19,0,0,87
2,21,18,5,1,21,24,0,0,92
2,21,18,5,12,0,0,0,0,58
2,21,18,5,12,1,7,5,0,71
2,21,18,5,12,5,0,0,0,63
2,21,18,5,12,25,0,0,0,83
2,21,18,5,12,12,5,0,0,75
2,21,18,5,12,12,25,0,0,95
2,21,18,5,20,0,0,0,0,66
2,21,18,5,20,19,0,0,0,85
2,21,18,5,20,20,5,0,0,91
2,21,18,5,20,20,5,19,0,110
2,21,18,5,26,0,0,0,0,72
2,21,18,6,9,19,8,0,0,83
2,21,18,7,1,0,0,0,0,49
2,21,18,7,1,7,5,0,0,61
2,21,18,7,1,7,5,19,0,80
2,21,18,7,1,12,9,20,25,115
2,21,18,7,1,12,12,0,0,73
2,21,18,7,1,13,15,20,0,97
2,21,18,7,1,14,5,20,0,88
2,21,18,7,1,21,0,0,0,70
2,21,18,7,5,0,0,0,0,53
2,21,18,7,5,5,0,0,0,58
2,21,18,7,5,5,19,0,0,77
2,21,18,7,5,14,19,9,3,98
2,21,18,7,5,15,14,0,0,82
2,21,18,7,5,15,14,5,4,91
2,21,18,7,5,15,14,19,0,101
2,21,18,7,5,18,19,0,0,90
2,21,18,7,5,19,19,5,19,115
2,21,18,7,7,18,1,22,5,101
2,21,18,7,8,0,0,0,0,56
2,21,18,7,8,1,12,0,0,69
2,21,18,7,8,2,15,20,5,98
2,21,18,7,8,5,13,15,20,109
2,21,18,7,8,5,18,0,0,79
2,21,18,7,8,5,18,19,0,98
2,21,18,7,8,13,15,15,20,119
2,21,18,7,8,13,15,20,5,109
2,21,18,7,8,19,0,0,0,75
2,21,18,7,12,1,18,0,0,79
2,21,18,7,12,1,18,25,0,104
2,21,18,7,12,1,18,19,0,98
2,21,18,7,12,5,0,0,0,65
2,21,18,7,12,5,4,0,0,69
2,21,18,7,12,5,19,0,0,84
2,21,18,7,12,9,14,7,0,90
2,21,18,7,15,14,5,20,0,102
2,21,18,7,15,14,5,20,19,121
2,21,18,7,15,15,0,0,0,78
2,21,18,7,15,15,19,0,0,97
2,21,18,7,15,21,20,0,0,104
2,21,18,7,15,21,20,19,0,123
2,21,18,7,18,1,22,5,0,94
2,21,18,7,18,1,22,5,19,113
2,21,18,7,19,0,0,0,0,67
2,21,18,7,21,12,0,0,0,81
2,21,18,7,21,19,0,0,0,88
2,21,18,7,23,1,18,5,0,95
2,21,18,7,23,5,18,5,0,99
2,21,18,8,0,0,0,0,0,49
2,21,18,8,5,1,4,0,0,59
2,21,18,8,5,12,0,0,0,66
2,21,18,8,13,15,15,20,0,112
2,21,18,9,1,2,12,5,0,70
2,21,18,9,1,12,0,0,0,63
2,21,18,9,1,12,19,0,0,82
2,21,18,9,1,14,0,0,0,65
2,21,18,9,5,4,0,0,0,59
2,21,18,9,5,12,19,0,0,86
2,21,18,9,5,18,0,0,0,73
2,21,18,9,5,18,19,0,0,92
2,21,18,9,5,19,0,0,0,74
2,21,18,25,9,14,7,0,0,96
2,21,18,9,14,0,0,0,0,64
2,21,18,9,14,9,19,20,0,112
2,21,18,9,14,19,0,0,0,83
2,21,18,9,15,14,0,0,0,79
2,21,18,25,19,0,0,0,0,85
2,21,18,9,20,9,0,0,0,79
2,21,18,11,1,0,0,0,0,53
2,21,18,11,5,4,0,0,0,61
2,21,18,11,5,9,0,0,0,66
2,21,18,11,5,18,0,0,0,75
2,21,18,11,5,18,19,0,0,94
2,21,18,11,5,19,0,0,0,76
2,21,18,11,8,1,0,0,0,61
2,21,18,11,9,14,7,0,0,82
2,21,18,11,9,20,5,0,0,86
2,21,18,11,9,20,5,19,0,105
2,21,18,11,21,14,4,1,26,118
2,21,18,12,1,3,5,0,0,62
2,21,18,12,1,4,5,18,15,96
2,21,18,12,1,16,0,0,0,70
2,21,18,12,1,16,19,0,0,89
2,21,18,12,5,3,21,5,0,87
2,21,18,12,5,4,0,0,0,62
2,21,18,12,5,25,3,21,5,112
2,21,18,12,5,25,19,0,0,102
2,21,18,12,5,18,0,0,0,76
2,21,18,12,5,18,19,0,0,95
2,21,18,12,5,19,11,0,0,88
2,21,18,12,5,19,11,19,0,107
2,21,18,12,5,19,17,21,5,120
2,21,18,12,5,20,0,0,0,78
2,21,18,12,5,20,20,1,0,99
2,21,18,12,25,0,0,0,0,78
2,21,18,12,9,5,18,0,0,85
2,21,18,12,9,5,19,0,0,86
2,21,18,12,9,5,19,20,0,106
2,21,18,12,9,12,25,0,0,99
2,21,18,12,9,14,5,19,19,119
2,21,18,12,9,14,7,0,0,83
2,21,18,12,19,0,0,0,0,72
2,21,18,13,9,20,5,0,0,88
2,21,18,14,1,2,12,5,0,75
2,21,18,14,2,5,1,20,0,83
2,21,18,14,5,4,0,0,0,64
2,21,18,14,5,18,19,0,0,97
2,21,18,14,5,20,9,26,5,120
2,21,18,14,5,20,19,0,0,99
2,21,18,14,5,23,9,14,0,106
2,21,18,14,6,9,18,5,0,93
2,21,18,14,9,5,2,5,5,81
2,21,18,14,9,5,19,0,0,88
2,21,18,14,9,14,7,0,0,85
2,21,18,14,9,14,7,12,25,122
2,21,18,14,9,14,7,19,0,104
2,21,18,14,9,19,8,0,0,91
2,21,18,14,9,19,8,5,4,100
2,21,18,14,9,19,8,5,18,114
2,21,18,14,9,19,8,5,19,115
2,21,18,14,15,15,19,5,0,109
2,21,18,14,15,15,19,5,4,113
2,21,18,14,15,15,19,5,19,128
2,21,18,14,15,21,19,0,0,110
2,21,18,14,15,21,19,5,4,119
2,21,18,14,15,21,19,5,19,134
2,21,18,14,15,21,20,0,0,111
2,21,18,14,15,21,20,19,0,130
2,21,18,14,15,22,5,18,0,115
2,21,18,14,19,9,4,5,19,111
2,21,18,14,20,0,0,0,0,75
2,21,18,14,20,12,25,0,0,112
2,21,18,14,20,14,5,19,19,132
2,21,18,14,20,23,5,5,4,112
2,21,18,14,21,16,0,0,0,92
2,21,18,14,21,20,0,0,0,96
2,21,18,14,23,5,5,4,0,92
2,21,18,14,23,15,15,4,0,112
2,21,18,15,0,0,0,0,0,56
2,21,18,15,15,0,0,0,0,71
2,21,18,16,5,4,0,0,0,66
2,21,18,16,9,14,7,0,0,87
2,21,18,16,19,0,0,0,0,76
2,21,18,18,1,8,0,0,0,68
2,21,18,18,1,20,9,14,5,108
2,21,18,18,1,23,1,14,7,105
2,21,18,18,2,1,18,11,0,91
2,21,18,18,5,4,0,0,0,68
2,21,18,18,5,5,0,0,0,69
2,21,18,18,5,12,0,0,0,76
2,21,18,18,5,18,0,0,0,82
2,21,18,18,5,18,19,0,0,101
2,21,18,18,6,9,19,8,0,101
2,21,18,18,8,5,1,4,0,77
2,21,18,18,8,5,12,0,0,84
2,21,18,18,25,0,0,0,0,84
2,21,18,18,9,5,18,0,0,91
2,21,18,18,9,5,19,20,0,112
2,21,18,18,9,14,7,0,0,89
2,21,18,18,9,15,0,0,0,83
2,21,18,18,9,19,8,0,0,95
2,21,18,18,9,20,15,0,0,103
2,21,18,18,9,20,15,19,0,122
2,21,18,18,11,14,15,20,0,119
2,21,18,18,15,0,0,0,0,74
2,21,18,18,15,3,11,0,0,88
2,21,18,18,15,19,0,0,0,93
2,21,18,18,15,23,5,4,0,106
2,21,18,18,15,23,5,5,4,111
2,21,18,18,15,23,5,18,0,120
2,21,18,18,15,23,5,18,19,139
2,21,18,18,15,23,9,14,7,127
2,21,18,18,19,0,0,0,0,78
2,21,18,18,19,20,15,14,5,132
2,21,18,19,0,0,0,0,0,60
2,21,18,19,1,5,0,0,0,66
2,21,18,19,1,12,0,0,0,73
2,21,18,19,1,18,0,0,0,79
2,21,18,19,1,18,25,0,0,104
2,21,18,19,1,18,9,1,12,101
2,21,18,19,1,18,9,5,19,112
2,21,18,19,1,18,19,0,0,98
2,21,18,19,1,19,0,0,0,80
2,21,18,19,1,20,5,0,0,86
2,21,18,19,1,20,9,0,0,90
2,21,18,19,1,20,20,5,5,111
2,21,18,19,1,21,20,5,5,112
2,21,18,19,3,8,0,0,0,71
2,21,18,19,5,0,0,0,0,65
2,21,18,19,5,5,4,0,0,74
2,21,18,19,5,5,4,19,0,93
2,21,18,19,5,19,0,0,0,84
2,21,18,19,9,3,12,5,0,89
2,21,18,19,9,6,15,18,13,121
2,21,18,19,9,20,9,19,0,117
2,21,18,19,9,20,15,19,0,123
2,21,18,19,20,0,0,0,0,80
2,21,18,19,20,5,4,0,0,89
2,21,18,19,20,5,18,0,0,103
2,21,18,19,20,5,18,19,0,122
2,21,18,19,20,25,0,0,0,105
2,21,18,19,20,9,14,7,0,110
2,21,18,19,20,15,14,5,0,114
2,21,18,19,20,15,14,5,19,133
2,21,18,19,20,19,0,0,0,99
2,21,18,19,20,23,15,18,20,156
2,21,18,19,21,12,1,0,0,94
2,21,18,20,8,5,14,0,0,88
2,21,18,20,8,5,14,5,4,97
2,21,18,20,8,5,14,19,0,107
2,21,18,20,15,14,9,26,5,130
2,21,18,20,15,14,19,0,0,109
2,21,18,20,18,5,5,0,0,89
2,21,18,21,3,8,1,0,0,74
2,21,18,23,5,5,4,0,0,78
2,21,18,23,5,5,4,19,0,97
2,21,19,2,1,18,0,0,0,63
2,21,19,2,1,18,19,0,0,82
2,21,19,2,9,5,19,0,0,77
2,21,19,2,15,25,0,0,0,84
2,21,19,2,15,25,19,0,0,103
2,21,19,3,1,18,12,0,0,76
2,21,19,3,1,18,12,5,0,81
2,21,19,5,4,0,0,0,0,51
2,21,19,5,18,1,0,0,0,66
2,21,19,5,19,0,0,0,0,66
2,21,19,8,2,1,2,25,0,80
2,21,19,8,2,5,3,11,0,71
2,21,19,8,2,15,4,25,0,96
2,21,19,8,2,15,25,0,0,92
2,21,19,8,2,21,3,11,0,87
2,21,19,8,2,21,3,11,19,106
2,21,19,8,3,18,1,6,20,98
2,21,19,8,5,4,0,0,0,59
2,21,19,8,5,12,1,7,5,80
2,21,19,8,5,12,5,4,0,76
2,21,19,8,5,12,5,18,0,90
2,21,19,8,5,12,5,18,19,109
2,21,19,8,5,12,6,21,12,106
2,21,19,8,5,12,9,14,7,97
2,21,19,8,5,12,12,5,4,88
2,21,19,8,5,12,12,5,18,102
2,21,19,8,5,12,13,1,14,95
2,21,19,8,5,12,13,5,14,99
2,21,19,8,5,12,19,0,0,86
2,21,19,8,5,18,0,0,0,73
2,21,19,8,5,18,19,0,0,92
2,21,19,8,5,19,0,0,0,74
2,21,19,8,5,20,0,0,0,75
2,21,19,8,6,9,18,5,0,88
2,21,19,8,6,9,18,5,19,107
2,21,19,8,6,21,12,0,0,89
2,21,19,8,7,15,1,20,0,93
2,21,19,8,7,15,1,20,19,112
2,21,19,8,7,18,1,19,19,114
2,21,19,8,9,0,0,0,0,59
2,21,19,8,25,0,0,0,0,75
2,21,19,8,9,4,15,19,0,97
2,21,19,8,9,5,0,0,0,64
2,21,19,8,9,5,18,0,0,82
2,21,19,8,9,5,19,20,0,103
2,21,19,8,9,12,25,0,0,96
2,21,19,8,9,14,5,19,19,116
2,21,19,8,9,14,7,0,0,80
2,21,19,8,9,14,7,19,0,99
2,21,19,8,12,1,14,4,19,100
2,21,19,8,12,5,19,19,0,105
2,21,19,8,12,5,20,0,0,87
2,21,19,8,12,9,11,5,0,87
2,21,19,8,13,1,11,5,18,98
2,21,19,8,13,5,14,0,0,82
2,21,19,8,13,5,14,20,0,102
2,21,19,8,16,9,7,0,0,82
2,21,19,8,18,15,16,5,0,104
2,21,19,8,20,9,20,0,0,99
2,21,19,8,20,9,20,19,0,118
2,21,19,8,23,1,0,0,0,74
2,21,19,8,23,1,3,11,0,88
2,21,19,8,23,1,8,0,0,82
2,21,19,8,23,1,8,19,0,101
2,21,19,8,23,1,19,0,0,93
2,21,19,8,23,8,1,3,11,96
2,21,19,8,23,9,6,5,0,93
2,21,19,8,23,15,13,1,14,116
2,21,19,25,0,0,0,0,0,67
2,21,19,25,2,15,4,25,0,113
2,21,19,9,5,4,0,0,0,60
2,21,19,9,5,18,0,0,0,74
2,21,19,9,5,19,0,0,0,75
2,21,19,9,5,19,20,0,0,95
2,21,19,25,8,5,1,4,0,85
2,21,19,25,9,14,7,0,0,97
2,21,19,25,9,19,8,0,0,103
2,21,19,9,12,25,0,0,0,88
2,21,19,9,14,5,0,0,0,70
2,21,19,9,14,5,19,19,0,108
2,21,19,25,14,5,19,19,0,124
2,21,19,9,14,7,0,0,0,72
2,21,19,9,14,7,19,0,0,91
2,21,19,25,23,15,18,11,0,134
2,21,19,25,23,15,18,11,19,153
2,21,19,11,0,0,0,0,0,53
2,21,19,11,5,4,0,0,0,62
2,21,19,11,5,18,0,0,0,76
2,21,19,11,5,18,19,0,0,95
2,21,19,11,5,20,0,0,0,78
2,21,19,11,25,0,0,0,0,78
2,21,19,11,9,14,0,0,0,76
2,21,19,11,9,14,5,4,0,85
2,21,19,11,9,14,7,0,0,83
2,21,19,11,9,14,19,0,0,95
2,21,19,11,12,5,0,0,0,70
2,21,19,11,19,0,0,0,0,72
2,21,19,12,15,1,4,0,0,74
2,21,19,13,1,14,0,0,0,70
2,21,19,13,5,14,0,0,0,74
2,21,19,19,0,0,0,0,0,61
2,21,19,19,5,4,0,0,0,70
2,21,19,19,5,18,0,0,0,84
2,21,19,19,5,19,0,0,0,85
2,21,19,19,9,14,7,0,0,91
2,21,19,19,9,14,7,19,0,110
2,21,19,19,15,3,11,0,0,90
2,21,19,19,21,0,0,0,0,82
2,21,19,20,1,18,4,0,0,85
2,21,19,20,1,18,4,19,0,104
2,21,19,20,5,4,0,0,0,71
2,21,19,20,5,5,0,0,0,72
2,21,19,20,5,18,19,0,0,104
2,21,19,20,8,5,1,4,0,80
2,21,19,20,9,0,0,0,0,71
2,21,19,20,25,0,0,0,0,87
2,21,19,20,9,1,14,0,0,86
2,21,19,20,9,3,0,0,0,74
2,21,19,20,9,3,1,20,5,100
2,21,19,20,9,3,19,0,0,93
2,21,19,20,9,5,18,0,0,94
2,21,19,20,9,5,18,19,0,113
2,21,19,20,9,5,19,20,0,115
2,21,19,20,9,14,7,0,0,92
2,21,19,20,12,5,0,0,0,79
2,21,19,20,12,5,4,0,0,83
2,21,19,20,12,5,18,0,0,97
2,21,19,20,12,5,18,19,0,116
2,21,19,20,12,5,19,0,0,98
2,21,19,20,12,9,14,7,0,104
2,21,19,20,15,0,0,0,0,77
2,21,19,20,19,0,0,0,0,81
2,21,19,21,12,6,1,14,0,96
2,21,19,21,12,6,1,14,19,115
2,21,19,21,21,20,9,0,0,113
2,21,19,23,1,25,0,0,0,91
2,21,20,1,3,1,9,14,5,76
2,21,20,1,4,9,5,14,5,81
2,21,20,1,4,9,25,14,5,101
2,21,20,1,14,1,12,0,0,71
2,21,20,1,14,5,0,0,0,63
2,21,20,1,14,5,19,0,0,82
2,21,20,1,14,15,9,3,0,85
2,21,20,1,14,15,12,0,0,85
2,21,20,1,14,15,12,9,4,98
2,21,20,1,14,15,12,19,0,104
2,21,20,1,14,15,14,5,0,92
2,21,20,1,14,15,14,5,19,111
2,21,20,1,20,0,0,0,0,64
2,21,20,3,8,1,0,0,0,55
2,21,20,3,8,5,18,5,4,86
2,21,20,3,8,5,18,5,18,100
2,21,20,3,8,5,18,25,0,102
2,21,20,3,8,5,18,12,25,114
2,21,20,3,8,5,18,19,0,96
2,21,20,3,8,5,19,0,0,78
2,21,20,5,9,14,0,0,0,71
2,21,20,5,14,5,0,0,0,67
2,21,20,5,14,5,19,0,0,86
2,21,20,5,14,25,12,0,0,99
2,21,20,5,15,14,9,14,5,105
2,21,20,5,15,19,0,0,0,82
2,21,20,9,3,0,0,0,0,55
2,21,20,25,12,1,20,5,0,106
2,21,20,25,12,1,20,5,4,110
2,21,20,25,12,1,20,5,19,125
2,21,20,25,12,5,14,5,0,104
2,21,20,25,12,5,14,5,19,123
2,21,20,25,12,9,3,0,0,92
2,21,20,25,12,19,0,0,0,99
2,21,20,9,14,0,0,0,0,66
2,21,20,9,14,5,0,0,0,71
2,21,20,25,14,5,0,0,0,87
2,21,20,25,18,0,0,0,0,86
2,21,20,25,18,1,12,0,0,99
2,21,20,25,18,1,12,19,0,118
2,21,20,25,18,1,20,5,0,112
2,21,20,25,18,1,20,5,19,131
2,21,20,25,18,9,3,0,0,98
2,21,20,25,18,25,12,0,0,123
2,21,20,25,18,25,12,19,0,142
2,21,20,25,18,9,14,0,0,109
2,21,20,25,18,9,14,19,0,128
2,21,20,25,18,15,14,5,0,120
2,21,20,25,18,15,21,19,0,141
2,21,20,12,5,0,0,0,0,60
2,21,20,12,5,4,0,0,0,64
2,21,20,12,5,18,1,7,5,91
2,21,20,12,5,18,4,15,13,110
2,21,20,12,5,18,5,19,19,121
2,21,20,12,5,18,25,0,0,103
2,21,20,12,5,18,9,5,19,111
2,21,20,12,5,18,9,19,13,119
2,21,20,12,5,18,19,0,0,97
2,21,20,12,5,19,0,0,0,79
2,21,20,12,9,14,7,0,0,85
2,21,20,13,5,14,20,0,0,95
2,21,20,15,12,9,19,13,0,111
2,21,20,15,24,25,0,0,0,107
2,21,20,15,24,25,12,0,0,119
2,21,20,19,0,0,0,0,0,62
2,21,20,19,21,4,1,14,0,102
2,21,20,20,1,12,0,0,0,76
2,21,20,20,1,12,19,0,0,95
2,21,20,20,5,4,0,0,0,72
2,21,20,20,5,18,0,0,0,86
2,21,20,20,5,18,2,15,24,127
2,21,20,20,5,18,2,21,18,127
2,21,20,20,5,18,3,21,16,126
2,21,20,20,5,18,5,4,0,95
2,21,20,20,5,18,5,18,0,109
2,21,20,20,5,18,5,18,19,128
2,21,20,20,5,18,6,1,20,113
2,21,20,20,5,18,6,12,25,129
2,21,20,20,5,18,25,0,0,111
2,21,20,20,5,18,9,5,18,118
2,21,20,20,5,18,9,5,19,119
2,21,20,20,5,18,9,14,5,114
2,21,20,20,5,18,9,14,7,116
2,21,20,20,5,18,9,19,0,114
2,21,20,20,5,18,13,1,14,114
2,21,20,20,5,18,14,21,20,141
2,21,20,20,5,19,0,0,0,87
2,21,20,20,25,0,0,0,0,88
2,21,20,20,9,5,19,0,0,96
2,21,20,20,25,13,1,14,0,116
2,21,20,20,9,14,7,0,0,93
2,21,20,20,9,14,19,11,9,125
2,21,20,20,9,14,19,11,25,141
2,21,20,20,12,5,0,0,0,80
2,21,20,20,12,5,4,0,0,84
2,21,20,20,12,9,14,7,0,105
2,21,20,20,15,3,11,0,0,92
2,21,20,20,15,3,11,5,4,101
2,21,20,20,15,3,11,5,18,115
2,21,20,20,15,3,11,19,0,111
2,21,20,20,15,14,2,21,18,133
2,21,20,20,15,14,5,4,0,101
2,21,20,20,15,14,5,18,0,115
2,21,20,20,15,14,5,18,19,134
2,21,20,20,15,14,25,0,0,117
2,21,20,20,15,14,9,14,7,122
2,21,20,20,15,14,19,0,0,111
2,21,20,20,18,5,19,19,0,124
2,21,20,20,19,0,0,0,0,82
2,21,20,20,19,20,15,3,11,131
2,21,20,20,19,20,18,1,16,137
2,21,20,20,23,15,13,1,14,129
2,21,20,20,23,15,13,5,14,133
2,21,20,20,23,15,15,4,0,120
2,21,20,21,20,0,0,0,0,84
2,21,20,21,20,19,0,0,0,103
2,21,22,5,20,20,5,0,0,95
2,21,24,1,3,5,15,21,19,111
2,21,24,5,15,21,19,0,0,107
2,21,24,5,18,18,25,0,0,113
2,21,24,5,18,18,9,5,19,121
2,21,24,9,14,5,0,0,0,75
2,21,24,15,13,0,0,0,0,75
2,21,24,15,13,5,18,0,0,98
2,21,24,15,13,5,19,20,0,119
2,21,24,15,13,12,25,0,0,112
2,21,24,15,13,14,5,19,19,132
2,21,26,0,0,0,0,0,0,49
2,21,26,1,14,5,0,0,0,69
2,21,26,25,12,5,14,5,0,110
2,21,26,21,11,9,0,0,0,90
2,21,26,21,11,9,1,0,0,91
2,21,26,21,11,9,19,0,0,109
2,21,26,26,1,18,4,12,25,135
2,21,26,26,1,18,4,19,0,117
2,21,26,26,2,15,13,2,0,107
2,21,26,26,5,4,0,0,0,84
2,21,26,26,5,18,0,0,0,98
2,21,26,26,5,18,19,0,0,117
2,21,26,26,5,19,0,0,0,99
2,21,26,26,7,12,15,1,11,121
2,21,26,26,25,0,0,0,0,100
2,21,26,26,9,5,18,0,0,107
2,21,26,26,9,5,19,0,0,108
2,21,26,26,9,5,19,20,0,128
2,21,26,26,9,14,7,0,0,105
2,21,26,26,9,14,7,12,25,142
2,21,26,26,12,5,0,0,0,92
2,21,26,26,19,1,23,0,0,118
2,21,26,26,23,9,7,0,0,114
2,21,26,26,23,9,7,19,0,133
2,21,26,26,23,15,18,4,0,135
2,21,26,26,23,15,18,4,19,154
2,22,20,0,0,0,0,0,0,44
2,24,19,0,0,0,0,0,0,45
3,3,5,19,19,5,18,0,0,72
3,3,9,4,0,0,0,0,0,19
3,3,11,23,0,0,0,0,0,40
3,3,13,0,0,0,0,0,0,19
3,3,23,19,0,0,0,0,0,48
3,4,7,0,0,0,0,0,0,14
3,5,2,5,12,12,0,0,0,39
3,5,2,9,1,14,0,0,0,34
3,5,2,9,4,0,0,0,0,23
3,5,2,9,4,19,0,0,0,42
3,5,2,9,12,0,0,0,0,31
3,5,2,9,14,5,0,0,0,38
3,5,2,15,9,4,0,0,0,38
3,5,2,15,9,4,19,0,0,57
3,5,2,15,12,12,9,20,5,83
3,5,2,21,18,0,0,0,0,49
3,5,3,1,0,0,0,0,0,12
3,5,3,1,12,0,0,0,0,24
3,5,3,1,12,12,25,0,0,61
3,5,3,3,1,0,0,0,0,15
3,5,3,3,8,9,14,5,0,50
3,5,3,9,4,9,21,13,0,67
3,5,3,9,12,9,20,5,0,66
3,5,3,9,12,19,0,0,0,51
3,5,3,9,20,25,0,0,0,65
3,5,3,9,20,9,19,0,0,68
3,5,3,15,7,18,1,16,8,76
3,5,3,15,16,5,24,25,0,96
3,5,3,15,19,20,15,13,25,118
3,5,3,15,20,15,13,25,0,99
3,5,3,21,13,0,0,0,0,45
3,5,3,21,13,19,0,0,0,64
3,5,4,1,18,2,9,18,4,64
3,5,4,1,18,5,4,0,0,40
3,5,4,1,18,25,0,0,0,56
3,5,4,1,18,14,0,0,0,45
3,5,4,1,18,23,1,18,5,78
3,5,4,1,18,23,15,15,4,88
3,5,4,5,0,0,0,0,0,17
3,5,4,5,4,0,0,0,0,21
3,5,4,5,14,19,0,0,0,50
3,5,4,5,14,20,0,0,0,51
3,5,4,5,18,0,0,0,0,35
3,5,4,5,18,19,0,0,0,54
3,5,4,5,19,0,0,0,0,36
3,5,4,9,0,0,0,0,0,21
3,5,4,9,12,12,1,0,0,46
3,5,4,9,12,12,1,19,0,65
3,5,4,9,14,7,0,0,0,42
3,5,4,9,19,0,0,0,0,40
3,5,4,18,1,20,0,0,0,51
3,5,4,18,1,20,5,0,0,56
3,5,4,18,5,0,0,0,0,35
3,5,4,18,5,14,5,0,0,54
3,5,4,18,25,0,0,0,0,55
3,5,4,18,9,14,0,0,0,53
3,5,4,18,9,14,5,0,0,58
3,5,4,18,9,18,5,20,0,82
3,5,4,18,9,21,13,0,0,73
3,5,4,18,15,12,0,0,0,57
3,5,4,18,15,14,0,0,0,59
3,5,4,21,12,1,0,0,0,46
3,5,4,21,12,1,19,0,0,65
3,5,4,21,12,5,0,0,0,50
3,5,4,21,15,21,19,0,0,88
3,5,5,0,0,0,0,0,0,13
3,5,5,19,0,0,0,0,0,32
3,5,9,2,1,19,0,0,0,39
3,5,9,2,15,0,0,0,0,34
3,5,9,2,15,19,0,0,0,53
3,5,25,12,1,14,9,20,5,94
3,5,9,12,5,0,0,0,0,34
3,5,9,12,5,4,0,0,0,38
3,5,9,12,5,18,0,0,0,52
3,5,9,12,5,18,19,0,0,71
3,5,9,12,9,4,8,0,0,50
3,5,9,12,9,4,8,5,0,55
3,5,9,12,9,14,7,0,0,59
3,5,9,12,9,14,7,5,4,68
3,5,9,12,9,14,7,19,0,78
3,5,25,12,15,14,9,20,5,108
3,5,9,12,19,0,0,0,0,48
3,5,9,14,20,0,0,0,0,51
3,5,9,14,20,5,0,0,0,56
3,5,9,14,20,21,18,5,0,95
3,5,9,14,20,21,18,5,19,114
3,5,10,1,0,0,0,0,0,19
3,5,12,1,4,15,14,19,0,73
3,5,12,1,14,4,9,14,5,67
3,5,12,1,20,9,15,14,0,79
3,5,12,1,20,9,22,5,0,77
3,5,12,1,20,21,18,5,0,85
3,5,12,5,0,0,0,0,0,25
3,5,12,5,2,0,0,0,0,27
3,5,12,5,2,5,0,0,0,32
3,5,12,5,2,18,1,14,20,80
3,5,12,5,2,18,1,20,5,71
3,5,12,5,2,18,5,0,0,50
3,5,12,5,2,18,5,19,0,69
3,5,12,5,2,18,5,20,0,70
3,5,12,5,2,18,9,20,25,99
3,5,12,5,2,19,0,0,0,46
3,5,12,5,13,9,14,0,0,61
3,5,12,5,13,9,14,5,19,85
3,5,12,5,18,25,0,0,0,68
3,5,12,5,18,9,1,3,0,56
3,5,12,5,18,9,1,3,19,75
3,5,12,5,18,9,5,19,0,76
3,5,12,5,18,9,20,25,0,97
3,5,12,5,19,20,1,19,0,84
3,5,12,5,19,20,5,19,0,88
3,5,12,5,19,20,9,1,12,86
3,5,12,5,19,20,9,6,25,104
3,5,12,5,19,20,9,20,5,98
3,5,12,5,21,19,13,1,0,79
3,5,12,9,1,3,0,0,0,33
3,5,12,9,1,3,19,0,0,52
3,5,12,9,1,7,18,1,0,56
3,5,12,9,1,12,7,9,1,59
3,5,12,9,2,1,3,25,0,60
3,5,12,9,2,1,20,5,0,57
3,5,12,9,2,1,20,5,19,76
3,5,12,9,2,1,20,9,3,64
3,5,12,9,5,13,9,1,0,57
3,5,12,9,9,20,9,19,0,86
3,5,12,9,15,3,5,12,5,69
3,5,12,9,15,14,3,21,19,101
3,5,12,9,15,20,15,13,25,117
3,5,12,9,20,5,0,0,0,54
3,5,12,12,0,0,0,0,0,32
3,5,12,12,1,0,0,0,0,33
3,5,12,12,1,5,0,0,0,38
3,5,12,12,1,7,5,18,0,63
3,5,12,12,1,18,0,0,0,51
3,5,12,12,1,18,1,7,5,64
3,5,12,12,1,18,5,4,0,60
3,5,12,12,1,18,5,18,0,74
3,5,12,12,1,18,5,18,19,93
3,5,12,12,1,18,5,19,19,94
3,5,12,12,1,18,5,20,0,76
3,5,12,12,1,18,5,20,19,95
3,5,12,12,1,18,9,14,7,81
3,5,12,12,1,18,13,1,14,79
3,5,12,12,1,18,13,5,14,83
3,5,12,12,1,18,15,21,19,106
3,5,12,12,1,18,19,0,0,70
3,5,12,12,1,18,23,1,25,100
3,5,12,12,1,20,5,4,0,62
3,5,12,12,2,12,15,3,11,75
3,5,12,12,5,4,0,0,0,41
3,5,12,12,5,16,15,18,5,91
3,5,12,12,9,0,0,0,0,41
3,5,12,12,9,6,15,18,13,93
3,5,12,12,9,14,7,0,0,62
3,5,12,12,9,19,20,0,0,80
3,5,12,12,9,19,20,19,0,99
3,5,12,12,13,1,20,5,0,71
3,5,12,12,13,1,20,5,19,90
3,5,12,12,15,3,21,20,0,91
3,5,12,12,15,9,4,0,0,60
3,5,12,12,15,9,4,9,14,83
3,5,12,12,15,9,19,20,0,95
3,5,12,12,15,19,0,0,0,66
3,5,12,12,15,19,5,0,0,71
3,5,12,12,19,0,0,0,0,51
3,5,12,12,21,12,1,18,0,84
3,5,12,12,21,12,1,19,5,90
3,5,12,12,21,12,1,20,5,91
3,5,12,12,21,12,5,0,0,70
3,5,12,12,21,12,5,19,0,89
3,5,12,12,21,12,9,14,0,88
3,5,12,12,21,12,15,19,5,104
3,5,12,12,21,12,15,21,19,120
3,5,12,15,13,0,0,0,0,48
3,5,12,15,13,1,20,1,0,70
3,5,12,15,13,19,0,0,0,67
3,5,12,15,19,3,15,16,5,93
3,5,12,15,19,9,1,19,0,83
3,5,12,15,20,15,13,25,0,108
3,5,12,19,9,1,14,0,0,63
3,5,12,19,9,20,21,4,5,98
3,5,12,20,9,6,15,18,13,101
3,5,12,20,9,21,13,0,0,83
3,5,12,20,19,0,0,0,0,59
3,5,12,20,21,3,5,0,0,69
3,5,12,21,18,5,0,0,0,64
3,5,13,2,1,12,9,0,0,45
3,5,13,2,1,12,9,19,20,84
3,5,13,2,1,12,15,0,0,51
3,5,13,2,1,12,15,14,0,65
3,5,13,2,1,12,15,19,0,70
3,5,13,5,14,20,0,0,0,60
3,5,13,5,14,20,1,0,0,61
3,5,13,5,14,20,1,12,0,73
3,5,13,5,14,20,5,4,0,69
3,5,13,5,14,20,5,18,0,83
3,5,13,5,14,20,5,18,19,102
3,5,13,5,14,20,9,14,0,83
3,5,13,5,14,20,9,14,7,90
3,5,13,5,14,20,9,20,5,94
3,5,13,5,14,20,15,13,1,89
3,5,13,5,14,20,19,0,0,79
3,5,13,5,14,20,21,13,0,94
3,5,13,5,20,1,18,25,0,90
3,5,13,5,20,5,18,25,0,94
3,5,14,1,3,12,5,0,0,43
3,5,14,1,3,12,5,19,0,62
3,5,14,1,3,21,12,21,13,93
3,5,14,1,14,20,8,25,0,90
3,5,14,1,20,9,15,14,0,81
3,5,14,1,20,15,18,25,0,101
3,5,14,3,5,18,18,15,0,81
3,5,14,3,5,18,18,15,19,100
3,5,14,4,18,5,0,0,0,49
3,5,14,5,0,0,0,0,0,27
3,5,14,9,26,15,0,0,0,72
3,5,14,15,2,5,0,0,0,44
3,5,14,15,2,25,0,0,0,64
3,5,14,15,2,9,1,14,0,63
3,5,14,15,2,9,5,19,0,72
3,5,14,15,2,9,20,5,0,73
3,5,14,15,2,9,20,5,19,92
3,5,14,15,2,9,20,9,3,80
3,5,14,15,2,9,21,13,0,82
3,5,14,15,7,1,13,25,0,83
3,5,14,15,19,9,20,5,0,90
3,5,14,15,19,9,20,25,0,110
3,5,14,15,20,1,16,8,0,82
3,5,14,15,20,1,16,8,25,107
3,5,14,15,20,1,16,8,19,101
3,5,14,15,20,5,0,0,0,62
3,5,14,15,20,5,19,0,0,81
3,5,14,19,5,0,0,0,0,46
3,5,14,19,5,4,0,0,0,50
3,5,14,19,5,18,0,0,0,64
3,5,14,19,5,18,19,0,0,83
3,5,14,19,5,19,0,0,0,65
3,5,14,19,9,14,7,0,0,71
3,5,14,19,9,22,5,0,0,77
3,5,14,19,15,18,0,0,0,74
3,5,14,19,15,18,1,20,5,100
3,5,14,19,15,18,5,4,0,83
3,5,14,19,15,18,9,1,12,96
3,5,14,19,15,18,9,1,14,98
3,5,14,19,15,18,9,14,7,104
3,5,14,19,15,18,19,0,0,93
3,5,14,19,21,1,12,0,0,75
3,5,14,19,21,18,5,0,0,85
3,5,14,19,21,18,5,4,0,89
3,5,14,19,21,18,5,18,0,103
3,5,14,19,21,18,5,18,19,122
3,5,14,19,21,18,5,19,0,104
3,5,14,19,21,18,9,14,7,110
3,5,14,19,21,19,0,0,0,81
3,5,14,19,21,19,5,4,0,90
3,5,14,19,21,19,5,19,0,105
3,5,14,19,21,19,9,14,7,111
3,5,14,20,0,0,0,0,0,42
3,5,14,20,1,7,5,0,0,55
3,5,14,20,1,9,0,0,0,52
3,5,14,20,1,12,0,0,0,55
3,5,14,20,1,12,19,0,0,74
3,5,14,20,1,18,5,0,0,66
3,5,14,20,1,18,5,19,0,85
3,5,14,20,1,19,0,0,0,62
3,5,14,20,1,21,18,0,0,82
3,5,14,20,1,21,18,25,0,107
3,5,14,20,1,21,18,9,3,94
3,5,14,20,1,21,18,19,0,101
3,5,14,20,1,22,15,0,0,80
3,5,14,20,1,22,15,19,0,99
3,5,14,20,5,14,1,0,0,62
3,5,14,20,5,14,1,18,0,80
3,5,14,20,5,14,9,5,18,93
3,5,14,20,5,14,14,9,1,85
3,5,14,20,5,18,5,4,0,74
3,5,14,20,5,18,5,18,0,88
3,5,14,20,5,18,9,14,7,95
3,5,14,20,5,18,19,0,0,84
3,5,14,20,5,19,5,19,0,90
3,5,14,20,5,19,9,13,9,97
3,5,14,20,5,19,9,13,15,103
3,5,14,20,5,19,9,19,0,94
3,5,14,20,5,19,13,0,0,79
3,5,14,20,5,20,9,4,0,80
3,5,14,20,7,5,14,5,18,91
3,5,14,20,7,18,1,22,5,95
3,5,14,20,9,0,0,0,0,51
3,5,14,20,9,1,18,0,0,70
3,5,14,20,9,1,18,5,0,75
3,5,14,20,9,1,18,5,19,94
3,5,14,20,9,2,1,18,0,72
3,5,14,20,9,4,1,25,0,81
3,5,14,20,9,7,18,1,13,90
3,5,14,20,9,12,5,0,0,68
3,5,14,20,9,12,5,19,0,87
3,5,14,20,9,13,5,0,0,69
3,5,14,20,9,13,5,19,0,88
3,5,14,20,9,13,15,0,0,79
3,5,14,20,9,13,15,19,0,98
3,5,14,20,9,14,5,12,0,82
3,5,14,20,9,14,15,4,25,109
3,5,14,20,9,16,5,4,5,81
3,5,14,20,14,5,18,0,0,79
3,5,14,20,14,5,18,19,0,98
3,5,14,20,15,14,0,0,0,71
3,5,14,20,15,14,5,19,0,95
3,5,14,20,15,14,9,19,13,112
3,5,14,20,15,19,0,0,0,76
3,5,14,20,18,1,0,0,0,61
3,5,14,20,18,1,4,0,0,65
3,5,14,20,18,1,12,0,0,73
3,5,14,20,18,1,12,5,0,78
3,5,14,20,18,1,12,5,18,96
3,5,14,20,18,1,12,12,25,110
3,5,14,20,18,1,12,19,0,92
3,5,14,20,18,1,14,20,8,103
3,5,14,20,18,5,4,0,0,69
3,5,14,20,18,5,6,0,0,71
3,5,14,20,18,5,18,0,0,83
3,5,14,20,18,5,19,0,0,84
3,5,14,20,18,5,22,0,0,87
3,5,14,20,18,5,24,0,0,89
3,5,14,20,18,25,0,0,0,85
3,5,14,20,18,9,3,0,0,72
3,5,14,20,18,9,3,1,12,85
3,5,14,20,18,9,14,7,0,90
3,5,14,20,18,9,14,7,19,109
3,5,14,20,18,9,15,12,5,101
3,5,14,20,18,9,19,13,0,101
3,5,14,20,18,9,19,13,19,120
3,5,14,20,18,9,19,20,0,108
3,5,14,20,18,9,19,20,19,127
3,5,14,20,18,15,0,0,0,75
3,5,14,20,18,15,4,5,0,84
3,5,14,20,18,15,9,4,0,88
3,5,14,20,18,15,9,4,19,107
3,5,14,20,18,21,13,0,0,94
3,5,14,20,18,21,13,19,0,113
3,5,14,20,18,21,20,18,1,120
3,5,14,20,19,0,0,0,0,61
3,5,14,20,21,13,0,0,0,76
3,5,14,20,21,13,19,0,0,95
3,5,14,20,21,13,22,9,18,125
3,5,14,20,21,16,12,5,0,96
3,5,14,20,21,16,12,5,4,100
3,5,14,20,21,16,12,5,19,115
3,5,14,20,21,16,12,25,0,116
3,5,14,20,21,18,5,0,0,86
3,5,14,20,21,18,9,1,12,103
3,5,14,20,21,18,9,5,4,99
3,5,14,20,21,18,9,5,19,114
3,5,14,20,21,18,9,15,14,119
3,5,14,20,21,18,9,19,20,129
3,5,15,14,15,3,25,20,5,105
3,5,15,18,12,0,0,0,0,53
3,5,15,18,12,9,19,8,0,89
3,5,15,18,12,19,0,0,0,72
3,5,16,0,0,0,0,0,0,24
3,5,16,1,0,0,0,0,0,25
3,5,16,1,3,5,15,21,19,88
3,5,16,5,0,0,0,0,0,29
3,5,16,5,19,0,0,0,0,48
3,5,16,8,1,4,9,1,0,47
3,5,16,8,1,12,1,0,0,46
3,5,16,8,1,12,1,4,0,50
3,5,16,8,1,12,1,20,5,71
3,5,16,8,1,12,9,3,0,57
3,5,16,8,1,12,9,14,0,68
3,5,16,8,1,12,9,14,5,73
3,5,16,8,1,12,9,14,19,87
3,5,16,8,1,12,9,19,13,86
3,5,16,8,1,12,15,2,0,62
3,5,16,8,1,12,15,9,4,73
3,5,16,8,1,12,15,13,0,73
3,5,16,8,1,12,15,14,0,74
3,5,16,8,1,12,15,21,19,100
3,5,16,8,1,12,21,19,0,85
3,5,16,8,5,9,4,19,0,69
3,5,16,8,5,14,0,0,0,51
3,5,16,8,9,4,0,0,0,45
3,5,16,15,21,19,0,0,0,79
3,5,16,19,0,0,0,0,0,43
3,5,16,20,5,18,0,0,0,67
3,5,16,20,15,18,0,0,0,77
3,5,17,21,9,0,0,0,0,55
3,5,18,1,0,0,0,0,0,27
3,5,18,1,3,5,15,21,19,90
3,5,18,1,7,15,0,0,0,49
3,5,18,1,12,0,0,0,0,39
3,5,18,1,13,1,12,0,0,53
3,5,18,1,13,1,12,19,0,72
3,5,18,1,13,9,3,0,0,52
3,5,18,1,13,9,3,19,0,71
3,5,18,1,13,9,19,20,0,88
3,5,18,1,13,9,19,20,19,107
3,5,18,1,19,0,0,0,0,46
3,5,18,1,19,5,9,14,0,74
3,5,18,1,19,9,14,0,0,69
3,5,18,1,19,20,5,19,0,90
3,5,18,1,20,0,0,0,0,47
3,5,18,1,20,1,0,0,0,48
3,5,18,1,20,5,0,0,0,52
3,5,18,1,20,5,4,0,0,56
3,5,18,1,20,5,19,0,0,71
3,5,18,1,20,9,9,4,0,69
3,5,18,1,20,9,14,0,0,70
3,5,18,1,20,9,14,19,0,89
3,5,18,1,20,9,15,9,4,84
3,5,18,1,20,9,15,14,0,85
3,5,18,1,20,9,20,5,0,81
3,5,18,1,20,9,20,9,3,88
3,5,18,1,20,15,9,4,0,75
3,5,18,1,21,14,9,1,0,72
3,5,18,1,21,14,9,3,19,93
3,5,18,1,21,14,9,20,5,96
3,5,18,3,1,12,0,0,0,42
3,5,18,3,1,18,9,1,0,58
3,5,18,3,1,18,9,1,5,63
3,5,18,3,1,18,9,1,12,70
3,5,18,3,1,18,9,1,14,72
3,5,18,3,1,18,9,1,19,77
3,5,18,3,5,12,5,5,0,56
3,5,18,3,9,0,0,0,0,38
3,5,18,3,9,19,5,19,0,81
3,5,18,3,12,5,0,0,0,46
3,5,18,3,15,16,9,4,0,73
3,5,18,3,15,16,15,4,0,79
3,5,18,3,21,19,0,0,0,69
3,5,18,5,1,12,0,0,0,44
3,5,18,5,1,12,9,1,14,68
3,5,18,5,1,12,9,14,0,67
3,5,18,5,1,12,9,19,13,85
3,5,18,5,1,12,9,19,20,92
3,5,18,5,1,12,15,19,5,83
3,5,18,5,1,12,19,0,0,63
3,5,18,5,2,5,12,12,1,63
3,5,18,5,2,18,1,0,0,52
3,5,18,5,2,18,1,12,0,64
3,5,18,5,2,18,1,12,19,83
3,5,18,5,2,18,1,20,5,77
3,5,18,5,2,18,9,0,0,60
3,5,18,5,2,18,9,3,0,63
3,5,18,5,2,18,9,14,0,74
3,5,18,5,2,18,9,26,5,91
3,5,18,5,2,18,15,9,4,79
3,5,18,5,2,18,15,13,1,80
3,5,18,5,2,18,15,14,0,80
3,5,18,5,2,18,15,19,5,90
3,5,18,5,2,18,21,13,0,85
3,5,18,5,2,18,21,13,19,104
3,5,18,5,3,12,15,20,8,89
3,5,18,5,4,0,0,0,0,35
3,5,18,5,12,5,19,19,0,86
3,5,18,5,13,5,14,20,0,83
3,5,18,5,13,5,14,20,19,102
3,5,18,5,13,15,14,25,0,98
3,5,18,5,15,21,19,0,0,86
3,5,18,5,18,0,0,0,0,49
3,5,18,5,18,9,20,5,0,83
3,5,18,5,19,9,14,0,0,73
3,5,18,5,19,9,14,5,0,78
3,5,18,5,21,19,5,19,0,95
3,5,18,5,22,9,19,0,0,81
3,5,18,5,26,1,0,0,0,58
3,5,18,6,15,9,12,0,0,68
3,5,18,9,1,0,0,0,0,36
3,5,18,9,1,19,0,0,0,55
3,5,18,9,3,0,0,0,0,38
3,5,18,9,4,5,0,0,0,44
3,5,18,25,12,0,0,0,0,63
3,5,18,9,12,12,1,0,0,60
3,5,18,9,12,12,15,0,0,74
3,5,18,9,13,1,14,0,0,63
3,5,18,9,13,1,14,19,0,82
3,5,18,9,14,0,0,0,0,49
3,5,18,9,14,5,0,0,0,54
3,5,18,9,14,7,0,0,0,56
3,5,18,9,15,16,19,0,0,85
3,5,18,9,16,8,0,0,0,59
3,5,18,9,16,8,19,0,0,78
3,5,18,9,19,5,0,0,0,59
3,5,18,9,19,5,19,0,0,78
3,5,18,9,20,5,0,0,0,60
3,5,18,9,20,5,19,0,0,79
3,5,18,9,21,13,0,0,0,69
3,5,18,9,21,13,19,0,0,88
3,5,18,13,5,20,19,0,0,83
3,5,18,14,5,4,0,0,0,49
3,5,18,14,9,14,7,0,0,70
3,5,18,14,9,20,21,18,5,113
3,5,18,14,21,15,21,19,0,116
3,5,18,15,0,0,0,0,0,41
3,5,18,15,7,18,1,16,8,91
3,5,18,15,9,4,0,0,0,54
3,5,18,15,12,9,14,5,0,81
3,5,18,15,12,9,20,5,0,87
3,5,18,15,13,1,0,0,0,55
3,5,18,15,13,1,14,3,25,97
3,5,18,15,13,5,26,0,0,85
3,5,18,15,15,14,0,0,0,70
3,5,18,15,16,12,1,19,20,109
3,5,18,15,19,0,0,0,0,60
3,5,18,15,19,9,14,0,0,83
3,5,18,15,20,1,20,5,0,87
3,5,18,15,20,5,0,0,0,66
3,5,18,15,20,5,14,5,0,85
3,5,18,15,20,9,3,0,0,73
3,5,18,15,20,9,14,0,0,84
3,5,18,15,20,25,16,5,0,107
3,5,18,15,20,25,16,5,19,126
3,5,18,15,21,19,0,0,0,81
3,5,18,15,24,25,12,5,0,107
3,5,18,18,5,18,15,0,0,82
3,5,18,18,9,1,12,0,0,66
3,5,18,18,9,19,0,0,0,72
3,5,18,20,1,9,14,0,0,70
3,5,18,20,1,9,14,5,18,93
3,5,18,20,1,9,14,12,25,107
3,5,18,20,1,9,14,20,25,115
3,5,18,20,5,19,0,0,0,70
3,5,18,20,25,0,0,0,0,71
3,5,18,20,9,6,0,0,0,61
3,5,18,20,9,6,25,0,0,86
3,5,18,20,9,6,9,5,4,79
3,5,18,20,9,6,9,5,18,93
3,5,18,20,9,6,9,5,19,94
3,5,18,20,9,19,0,0,0,74
3,5,18,20,9,20,21,4,5,105
3,5,18,20,15,19,1,0,0,81
3,5,18,20,15,19,5,0,0,85
3,5,18,20,15,19,9,14,1,104
3,5,18,20,15,19,9,14,15,118
3,5,18,21,12,5,0,0,0,64
3,5,18,21,12,5,1,14,0,79
3,5,18,21,12,5,1,14,19,98
3,5,18,21,12,5,9,14,0,87
3,5,18,21,12,5,9,20,5,98
3,5,18,21,12,5,15,21,19,119
3,5,18,21,12,5,21,13,0,98
3,5,18,21,12,9,6,9,3,86
3,5,18,21,13,5,14,0,0,79
3,5,18,21,13,5,14,19,0,98
3,5,18,21,13,9,14,1,12,96
3,5,18,21,19,5,0,0,0,71
3,5,18,21,19,5,19,0,0,90
3,5,18,21,19,9,20,5,0,100
3,5,18,21,19,9,20,5,19,119
3,5,18,21,19,19,9,20,5,119
3,5,18,22,1,12,5,20,0,86
3,5,18,22,1,14,20,9,3,95
3,5,18,22,5,12,1,19,0,85
3,5,18,22,5,12,1,20,0,86
3,5,18,22,5,12,1,20,19,105
3,5,18,22,9,3,1,12,0,73
3,5,18,22,9,3,5,19,0,84
3,5,18,22,9,3,9,4,5,78
3,5,18,22,9,3,15,18,14,107
3,5,18,22,9,4,0,0,0,61
3,5,18,22,9,14,5,0,0,76
3,5,18,22,9,19,9,1,0,86
3,5,18,22,9,19,9,1,12,98
3,5,18,22,9,24,0,0,0,81
3,5,18,22,9,24,5,19,0,105
3,5,18,22,15,9,4,0,0,76
3,5,18,22,21,12,9,14,5,109
3,5,19,1,18,5,1,14,19,85
3,5,19,1,18,9,1,14,19,89
3,5,19,9,15,21,19,0,0,91
3,5,19,9,21,13,0,0,0,70
3,5,19,9,21,13,19,0,0,89
3,5,19,16,9,20,15,19,5,111
3,5,19,19,0,0,0,0,0,46
3,5,19,19,1,14,20,0,0,81
3,5,19,19,1,14,20,12,25,118
3,5,19,19,1,20,9,15,14,105
3,5,19,19,1,20,9,22,5,103
3,5,19,19,1,22,9,20,0,98
3,5,19,19,5,4,0,0,0,55
3,5,19,19,5,18,0,0,0,69
3,5,19,19,5,19,0,0,0,70
3,5,19,19,9,2,12,5,0,74
3,5,19,19,9,14,7,0,0,76
3,5,19,19,9,15,0,0,0,70
3,5,19,19,9,15,14,0,0,84
3,5,19,19,9,15,14,5,5,94
3,5,19,19,9,15,14,19,0,103
3,5,19,19,13,5,14,20,0,98
3,5,19,19,15,18,0,0,0,79
3,5,19,19,16,9,16,5,0,92
3,5,19,19,16,9,20,0,0,91
3,5,19,19,16,9,20,19,0,110
3,5,19,19,16,15,15,12,0,104
3,5,19,19,16,15,15,12,19,123
3,5,19,20,0,0,0,0,0,47
3,5,19,20,1,0,0,0,0,48
3,5,19,20,1,19,0,0,0,67
3,5,19,20,5,0,0,0,0,52
3,5,19,20,15,4,5,0,0,71
3,5,19,20,15,4,5,19,0,90
3,5,19,20,15,9,0,0,0,71
3,5,19,20,15,9,4,0,0,75
3,5,19,20,15,9,4,19,0,94
3,5,19,20,15,14,0,0,0,76
3,5,19,20,15,19,0,0,0,81
3,5,19,20,21,9,0,0,0,77
3,5,19,20,21,25,0,0,0,93
3,5,19,20,21,19,0,0,0,87
3,5,19,20,21,19,5,19,0,111
3,5,19,21,18,1,0,0,0,67
3,5,19,21,18,1,5,0,0,72
3,5,19,21,18,1,12,0,0,79
3,5,19,21,18,1,19,0,0,86
3,5,19,21,18,5,0,0,0,71
3,5,20,1,3,5,1,14,0,52
3,5,20,1,3,5,1,14,19,71
3,5,20,1,3,5,15,21,19,92
3,5,20,1,3,5,21,13,0,71
3,5,20,1,14,5,0,0,0,48
3,5,20,1,14,5,19,0,0,67
3,5,20,5,14,5,0,0,0,52
3,5,20,5,15,19,1,21,18,107
3,5,20,5,18,1,0,0,0,52
3,5,20,5,18,1,3,8,0,63
3,5,20,5,19,0,0,0,0,52
3,5,20,9,3,0,0,0,0,40
3,5,20,9,3,9,4,5,0,58
3,5,20,25,12,0,0,0,0,65
3,5,20,25,12,5,14,5,0,89
3,5,20,25,12,9,3,0,0,77
3,5,20,9,14,0,0,0,0,51
3,5,20,15,12,15,7,25,0,102
3,5,20,15,14,9,1,14,0,81
3,5,20,18,1,18,9,3,0,77
3,5,20,18,1,18,9,14,0,88
3,5,22,1,4,9,12,12,1,69
3,5,22,1,4,9,14,5,0,63
3,5,22,9,1,14,0,0,0,54
3,5,22,9,3,8,5,0,0,55
3,5,22,9,3,8,5,19,0,74
3,5,22,9,14,5,0,0,0,58
3,5,22,9,20,1,13,9,3,85
3,6,8,0,0,0,0,0,0,17
3,6,13,0,0,0,0,0,0,22
3,6,19,0,0,0,0,0,0,28
3,8,5,1,16,0,0,0,0,33
3,8,5,1,16,5,14,0,0,52
3,8,5,1,16,5,14,5,4,61
3,8,5,1,16,5,14,5,18,75
3,8,5,1,16,5,14,19,0,71
3,8,5,1,16,5,18,0,0,56
3,8,5,1,16,5,18,25,0,81
3,8,5,1,16,5,19,20,0,77
3,8,5,1,16,9,5,0,0,47
3,8,5,1,16,9,5,19,0,66
3,8,5,1,16,9,14,7,0,63
3,8,5,1,16,9,19,8,0,69
3,8,5,1,16,10,1,3,11,58
3,8,5,1,16,12,25,0,0,70
3,8,5,1,16,14,5,19,19,90
3,8,5,1,16,15,0,0,0,48
3,8,5,1,16,15,19,0,0,67
3,8,5,1,16,19,0,0,0,52
3,8,5,1,18,5,0,0,0,40
3,8,5,1,20,0,0,0,0,37
3,8,5,1,20,1,2,12,5,57
3,8,5,1,20,5,4,0,0,46
3,8,5,1,20,5,5,0,0,47
3,8,5,1,20,5,18,0,0,60
3,8,5,1,20,5,18,25,0,85
3,8,5,1,20,5,18,19,0,79
3,8,5,1,20,9,14,7,0,67
3,8,5,1,20,18,25,0,0,80
3,8,5,1,20,18,9,5,0,69
3,8,5,1,20,19,0,0,0,56
3,8,5,2,5,3,0,0,0,26
3,8,5,2,5,3,11,0,0,37
3,8,5,2,5,3,19,0,0,45
3,8,5,2,5,12,0,0,0,35
3,8,5,2,15,7,0,0,0,40
3,8,5,2,21,12,5,0,0,56
3,8,5,2,21,12,9,3,0,63
3,8,5,3,8,1,11,15,0,54
3,8,5,3,8,1,11,15,19,73
3,8,5,3,8,5,13,0,0,45
3,8,5,3,8,9,1,0,0,37
3,8,5,3,11,0,0,0,0,30
3,8,5,3,11,1,2,12,5,50
3,8,5,3,11,1,7,5,0,43
3,8,5,3,11,2,1,3,11,47
3,8,5,3,11,2,9,18,4,63
3,8,5,3,11,2,9,20,0,61
3,8,5,3,11,2,9,20,5,66
3,8,5,3,11,2,9,20,19,80
3,8,5,3,11,2,15,15,11,73
3,8,5,3,11,5,0,0,0,35
3,8,5,3,11,5,4,0,0,39
3,8,5,3,11,5,18,0,0,53
3,8,5,3,11,5,18,5,4,62
3,8,5,3,11,5,18,25,0,78
3,8,5,3,11,5,18,19,0,72
3,8,5,3,11,8,15,15,11,79
3,8,5,3,11,25,0,0,0,55
3,8,5,3,11,9,14,7,0,60
3,8,5,3,11,12,5,0,0,47
3,8,5,3,11,12,5,19,19,85
3,8,5,3,11,12,9,14,5,70
3,8,5,3,11,12,9,19,20,90
3,8,5,3,11,13,1,14,0,58
3,8,5,3,11,13,1,18,11,73
3,8,5,3,11,13,1,20,5,69
3,8,5,3,11,15,6,6,0,57
3,8,5,3,11,15,6,6,19,76
3,8,5,3,11,15,21,20,0,86
3,8,5,3,11,15,21,20,19,105
3,8,5,3,11,18,1,3,11,63
3,8,5,3,11,18,1,9,12,70
3,8,5,3,11,18,5,9,14,76
3,8,5,3,11,18,15,12,12,87
3,8,5,3,11,18,15,15,13,91
3,8,5,3,11,18,15,16,5,84
3,8,5,3,11,18,15,23,0,86
3,8,5,3,11,18,15,23,19,105
3,8,5,3,11,19,0,0,0,49
3,8,5,3,11,19,21,13,0,83
3,8,5,3,11,19,21,13,19,102
3,8,5,3,11,21,16,0,0,67
3,8,5,3,11,21,16,19,0,86
3,8,5,3,11,23,15,18,11,97
3,8,5,4,1,18,0,0,0,39
3,8,5,4,4,1,18,19,0,62
3,8,5,4,4,9,20,5,0,58
3,8,5,4,4,9,20,5,19,77
3,8,5,4,5,18,0,0,0,43
3,8,5,4,5,18,19,0,0,62
3,8,5,4,9,20,5,0,0,54
3,8,5,4,9,20,5,19,0,73
3,8,5,4,12,15,3,11,0,61
3,8,5,4,18,5,21,24,0,88
3,8,5,5,3,8,1,0,0,33
3,8,5,5,3,8,1,3,15,51
3,8,5,5,3,8,1,11,15,59
3,8,5,5,6,21,12,0,0,60
3,8,5,5,11,0,0,0,0,32
3,8,5,5,11,2,15,14,5,68
3,8,5,5,11,5,4,0,0,41
3,8,5,5,11,5,18,0,0,55
3,8,5,5,11,6,21,12,0,71
3,8,5,5,11,6,21,12,19,90
3,8,5,5,11,25,0,0,0,57
3,8,5,5,11,9,5,18,0,64
3,8,5,5,11,9,5,19,20,85
3,8,5,5,11,9,12,25,0,78
3,8,5,5,11,9,14,7,0,62
3,8,5,5,11,9,19,8,0,68
3,8,5,5,11,12,5,19,19,87
3,8,5,5,11,19,0,0,0,51
3,8,5,5,14,5,25,0,0,65
3,8,5,5,16,0,0,0,0,37
3,8,5,5,16,5,4,0,0,46
3,8,5,5,16,5,18,0,0,60
3,8,5,5,16,5,18,19,0,79
3,8,5,5,16,25,0,0,0,62
3,8,5,5,16,9,5,18,0,69
3,8,5,5,16,9,5,19,20,90
3,8,5,5,16,9,12,25,0,83
3,8,5,5,16,9,14,7,0,67
3,8,5,5,16,19,0,0,0,56
3,8,5,5,18,0,0,0,0,39
3,8,5,5,18,5,4,0,0,48
3,8,5,5,18,5,18,0,0,62
3,8,5,5,18,5,18,19,0,81
3,8,5,5,18,6,21,12,0,78
3,8,5,5,18,25,0,0,0,64
3,8,5,5,18,9,5,18,0,71
3,8,5,5,18,9,5,19,20,92
3,8,5,5,18,9,12,25,0,85
3,8,5,5,18,9,14,7,0,69
3,8,5,5,18,9,15,0,0,63
3,8,5,5,18,9,15,19,0,82
3,8,5,5,18,12,5,1,4,61
3,8,5,5,18,12,5,4,0,60
3,8,5,5,18,12,5,19,19,94
3,8,5,5,18,12,25,0,0,76
3,8,5,5,18,15,0,0,0,54
3,8,5,5,18,15,19,0,0,73
3,8,5,5,18,19,0,0,0,58
3,8,5,5,19,5,0,0,0,45
3,8,5,5,19,5,2,15,24,86
3,8,5,5,19,5,4,0,0,49
3,8,5,5,19,5,12,5,16,78
3,8,5,5,19,5,12,9,16,82
3,8,5,5,19,5,18,0,0,63
3,8,5,5,19,5,18,25,0,88
3,8,5,5,19,5,19,0,0,64
3,8,5,5,19,25,0,0,0,65
3,8,5,5,19,9,5,18,0,72
3,8,5,5,19,9,5,19,20,93
3,8,5,5,19,9,12,25,0,86
3,8,5,5,19,9,14,7,0,70
3,8,5,5,20,0,0,0,0,41
3,8,5,5,20,1,8,0,0,50
3,8,5,5,20,1,8,19,0,69
3,8,5,5,20,1,12,0,0,54
3,8,5,5,20,5,18,0,0,64
3,8,5,5,20,9,5,0,0,55
3,8,5,5,20,21,12,0,0,74
3,8,5,5,23,9,14,11,0,78
3,8,5,5,26,9,20,0,0,76
3,8,5,6,0,0,0,0,0,22
3,8,5,6,4,15,13,0,0,54
3,8,5,6,4,15,13,19,0,73
3,8,5,6,6,5,4,0,0,37
3,8,5,6,6,9,14,7,0,58
3,8,5,6,19,0,0,0,0,41
3,8,5,7,15,0,0,0,0,38
3,8,5,7,15,5,0,0,0,43
3,8,5,7,15,5,19,0,0,62
3,8,5,7,18,5,0,0,0,46
3,8,5,9,3,5,18,1,12,64
3,8,5,9,12,9,15,14,0,75
3,8,5,9,12,9,20,9,19,94
3,8,5,25,14,5,25,19,0,104
3,8,5,9,18,0,0,0,0,43
3,8,5,9,18,1,7,18,1,70
3,8,5,9,18,15,12,9,14,93
3,8,5,9,18,15,16,15,4,93
3,8,5,11,1,14,0,0,0,42
3,8,5,11,5,14,0,0,0,46
3,8,5,11,9,0,0,0,0,36
3,8,5,11,11,5,18,0,0,61
3,8,5,11,13,1,11,0,0,52
3,8,5,12,1,0,0,0,0,29
3,8,5,12,1,5,0,0,0,34
3,8,5,12,1,19,0,0,0,48
3,8,5,12,1,19,8,9,16,81
3,8,5,12,1,20,5,0,0,54
3,8,5,12,1,20,5,4,0,58
3,8,5,12,1,20,5,19,0,73
3,8,5,12,1,20,9,14,7,79
3,8,5,12,1,20,9,15,14,87
3,8,5,12,1,20,15,18,0,82
3,8,5,12,1,20,15,18,19,101
3,8,5,12,5,13,0,0,0,46
3,8,5,12,9,3,5,18,0,63
3,8,5,12,9,3,5,18,1,64
3,8,5,12,9,3,5,18,5,68
3,8,5,12,9,4,5,0,0,46
3,8,5,12,25,4,18,5,0,80
3,8,5,12,9,6,5,18,0,66
3,8,5,12,9,6,15,18,13,89
3,8,5,12,9,14,7,1,0,59
3,8,5,12,9,14,7,1,19,78
3,8,5,12,9,14,7,15,0,73
3,8,5,12,9,14,7,15,19,92
3,8,5,12,9,16,5,4,0,62
3,8,5,12,25,19,0,0,0,72
3,8,5,12,12,15,0,0,0,55
3,8,5,12,15,4,9,14,5,75
3,8,5,12,15,9,4,0,0,56
3,8,5,12,15,9,4,19,0,75
3,8,5,12,15,14,5,0,0,62
3,8,5,12,15,14,9,1,14,81
3,8,5,12,15,14,9,4,0,70
3,8,5,12,15,14,9,9,4,79
3,8,5,12,15,14,9,14,0,80
3,8,5,12,16,0,0,0,0,44
3,8,5,13,9,1,20,18,25,102
3,8,5,13,9,3,0,0,0,41
3,8,5,13,9,3,1,12,0,54
3,8,5,13,9,3,1,12,19,73
3,8,5,13,9,3,11,0,0,52
3,8,5,13,9,3,11,5,4,61
3,8,5,13,9,3,11,5,18,75
3,8,5,13,9,3,19,0,0,60
3,8,5,13,9,12,15,15,14,94
3,8,5,13,9,14,0,0,0,52
3,8,5,13,9,14,5,5,0,62
3,8,5,13,9,14,19,0,0,71
3,8,5,13,9,19,0,0,0,57
3,8,5,13,9,19,5,0,0,62
3,8,5,13,9,19,5,19,0,81
3,8,5,13,9,19,13,0,0,70
3,8,5,13,9,19,13,19,0,89
3,8,5,13,9,19,15,18,2,92
3,8,5,13,9,19,20,0,0,77
3,8,5,13,9,19,20,18,25,120
3,8,5,13,9,19,20,19,0,96
3,8,5,13,9,20,25,16,5,104
3,8,5,13,9,20,25,16,25,124
3,8,5,13,9,26,15,0,0,79
3,8,5,13,13,25,0,0,0,67
3,8,5,13,15,12,25,26,5,112
3,8,5,13,15,14,9,20,5,92
3,8,5,13,15,19,5,19,0,87
3,8,5,13,15,19,9,19,0,91
3,8,5,13,15,19,15,18,2,98
3,8,5,13,15,19,20,1,20,104
3,8,5,13,15,20,1,24,25,114
3,8,5,13,15,20,9,3,0,76
3,8,5,13,16,1,4,21,11,82
3,8,5,13,21,18,7,25,0,100
3,8,5,13,21,18,7,9,3,87
3,8,5,14,1,0,0,0,0,31
3,8,5,14,1,18,0,0,0,49
3,8,5,14,4,5,0,0,0,39
3,8,5,14,5,1,21,0,0,57
3,8,5,14,5,1,21,19,0,76
3,8,5,14,5,1,21,24,0,81
3,8,5,14,5,20,0,0,0,55
3,8,5,14,6,9,19,8,0,72
3,8,5,14,7,1,12,0,0,50
3,8,5,14,9,3,1,0,0,43
3,8,5,14,9,12,12,5,0,68
3,8,5,14,9,12,12,5,18,86
3,8,5,14,9,12,12,5,19,87
3,8,5,14,15,16,15,4,0,80
3,8,5,14,15,16,15,4,19,99
3,8,5,15,14,7,19,1,13,85
3,8,5,16,19,20,5,18,0,94
3,8,5,17,21,5,0,0,0,59
3,8,5,17,21,5,5,14,0,78
3,8,5,17,21,5,18,0,0,77
3,8,5,17,21,5,18,5,4,86
3,8,5,17,21,5,19,0,0,78
3,8,5,17,21,25,0,0,0,79
3,8,5,17,21,9,14,0,0,77
3,8,5,17,21,9,14,14,0,91
3,8,5,18,3,8,5,26,0,76
3,8,5,18,3,15,3,11,0,66
3,8,5,18,5,12,25,0,0,76
3,8,5,18,5,13,0,0,0,52
3,8,5,18,7,21,9,0,0,71
3,8,5,18,9,13,15,25,1,97
3,8,5,18,9,19,8,5,4,79
3,8,5,18,9,19,8,5,18,93
3,8,5,18,9,19,8,5,19,94
3,8,5,18,14,1,0,0,0,49
3,8,5,18,14,9,20,5,19,101
3,8,5,18,14,15,26,5,13,107
3,8,5,18,15,7,18,9,12,95
3,8,5,18,15,15,20,0,0,84
3,8,5,18,15,15,20,19,0,103
3,8,5,18,18,9,5,4,0,70
3,8,5,18,18,9,5,19,0,85
3,8,5,18,18,25,9,14,7,107
3,8,5,18,20,0,0,0,0,54
3,8,5,18,20,5,0,0,0,59
3,8,5,18,20,25,0,0,0,79
3,8,5,18,20,9,5,18,0,86
3,8,5,18,20,9,5,19,20,107
3,8,5,18,20,19,0,0,0,73
3,8,5,18,21,2,0,0,0,57
3,8,5,18,21,2,9,3,0,69
3,8,5,18,21,2,9,13,0,79
3,8,5,18,21,2,9,14,0,80
3,8,5,18,21,2,19,0,0,76
3,8,5,18,21,16,0,0,0,71
3,8,5,18,22,9,12,0,0,77
3,8,5,18,22,9,12,19,0,96
3,8,5,18,22,15,14,5,9,99
3,8,5,19,2,15,9,12,0,73
3,8,5,19,2,15,12,12,0,76
3,8,5,19,5,0,0,0,0,40
3,8,5,19,5,12,9,16,0,77
3,8,5,19,9,12,0,0,0,56
3,8,5,19,11,5,25,0,0,76
3,8,5,19,11,5,25,19,0,95
3,8,5,19,12,5,16,0,0,68
3,8,5,19,15,14,0,0,0,64
3,8,5,19,15,21,14,0,0,85
3,8,5,19,19,0,0,0,0,54
3,8,5,19,19,1,18,20,0,93
3,8,5,19,19,4,15,13,0,86
3,8,5,19,19,5,12,0,0,71
3,8,5,19,19,5,18,0,0,77
3,8,5,19,19,5,19,0,0,78
3,8,5,19,19,5,20,0,0,79
3,8,5,19,19,9,19,20,0,102
3,8,5,19,19,13,1,14,0,82
3,8,5,19,19,13,5,14,0,86
3,8,5,19,19,14,5,18,0,91
3,8,5,19,19,15,13,0,0,82
3,8,5,19,19,20,18,5,5,102
3,8,5,19,20,0,0,0,0,55
3,8,5,19,20,5,4,0,0,64
3,8,5,19,20,5,9,14,5,88
3,8,5,19,20,6,21,12,0,94
3,8,5,19,20,6,21,12,19,113
3,8,5,19,20,25,0,0,0,80
3,8,5,19,20,9,5,18,0,87
3,8,5,19,20,9,5,19,20,108
3,8,5,19,20,9,12,25,0,101
3,8,5,19,20,14,21,20,0,110
3,8,5,19,20,14,21,20,19,129
3,8,5,19,20,19,0,0,0,74
3,8,5,20,1,8,0,0,0,45
3,8,5,20,1,8,19,0,0,64
3,8,5,20,8,0,0,0,0,44
3,8,5,20,8,19,0,0,0,63
3,8,5,20,9,6,0,0,0,51
3,8,5,20,9,22,5,0,0,72
3,8,5,20,15,16,15,4,0,86
3,8,5,20,18,21,13,0,0,88
3,8,5,20,18,21,13,19,0,107
3,8,5,20,20,25,0,0,0,81
3,8,5,20,20,9,11,0,0,76
3,8,5,20,22,5,18,9,11,101
3,8,5,20,22,5,18,20,0,101
3,8,5,22,1,3,8,5,5,60
3,8,5,22,1,3,8,9,5,64
3,8,5,22,1,7,5,0,0,51
3,8,5,22,1,12,0,0,0,51
3,8,5,22,1,12,5,20,0,76
3,8,5,22,1,12,5,20,19,95
3,8,5,22,1,12,9,14,5,79
3,8,5,22,1,14,3,5,0,61
3,8,5,22,1,21,24,0,0,84
3,8,5,22,5,0,0,0,0,43
3,8,5,22,5,5,0,0,0,48
3,8,5,22,5,25,19,0,0,87
3,8,5,22,5,12,21,18,5,99
3,8,5,22,5,14,0,0,0,57
3,8,5,22,5,14,5,18,0,80
3,8,5,22,5,18,5,12,0,78
3,8,5,22,5,18,5,20,0,86
3,8,5,22,5,18,9,12,0,82
3,8,5,22,5,18,15,14,0,90
3,8,5,22,5,18,15,14,19,109
3,8,5,22,5,19,14,5,0,81
3,8,5,22,5,20,0,0,0,63
3,8,5,22,9,5,4,0,0,56
3,8,5,22,9,5,19,0,0,71
3,8,5,22,25,9,14,7,0,93
3,8,5,22,9,12,12,5,0,76
3,8,5,22,9,14,0,0,0,61
3,8,5,22,9,15,20,19,0,101
3,8,5,22,9,19,5,0,0,71
3,8,5,22,15,14,0,0,0,67
3,8,5,22,18,5,0,0,0,61
3,8,5,22,18,5,19,0,0,80
3,8,5,22,18,5,20,20,5,106
3,8,5,22,18,5,21,9,12,103
3,8,5,22,18,15,14,0,0,85
3,8,5,22,18,15,14,5,0,90
3,8,5,22,18,15,14,5,4,94
3,8,5,22,18,15,14,5,12,102
3,8,5,22,18,15,14,25,0,110
3,8,5,22,18,15,14,14,25,124
3,8,5,22,18,15,14,19,0,104
3,8,5,22,22,25,0,0,0,85
3,8,5,23,1,2,12,5,0,59
3,8,5,23,2,1,18,11,0,71
3,8,5,23,5,4,0,0,0,48
3,8,5,23,5,12,5,18,0,79
3,8,5,23,5,18,0,0,0,62
3,8,5,23,5,18,19,0,0,81
3,8,5,23,5,20,0,0,0,64
3,8,5,23,25,0,0,0,0,64
3,8,5,23,9,5,0,0,0,53
3,8,5,23,9,5,18,0,0,71
3,8,5,23,9,5,19,20,0,92
3,8,5,23,9,14,7,0,0,69
3,8,5,23,9,14,11,0,0,73
3,8,5,23,9,14,11,19,0,92
3,8,5,23,19,0,0,0,0,58
3,8,5,23,19,20,9,3,11,101
3,8,5,26,0,0,0,0,0,42
3,8,7,0,0,0,0,0,0,18
3,8,8,1,20,18,9,0,0,67
3,8,9,1,0,0,0,0,0,21
3,8,9,1,3,11,0,0,0,35
3,8,25,1,3,11,0,0,0,51
3,8,25,1,11,0,0,0,0,48
3,8,9,1,15,0,0,0,0,36
3,8,9,1,19,0,0,0,0,40
3,8,9,1,19,13,0,0,0,53
3,8,9,1,19,13,1,0,0,54
3,8,9,1,19,13,1,12,0,66
3,8,9,1,19,13,1,19,0,73
3,8,9,1,19,13,1,20,1,75
3,8,9,1,19,13,9,0,0,62
3,8,9,1,19,13,9,3,0,65
3,8,9,1,19,13,19,0,0,72
3,8,9,1,19,13,21,19,0,93
3,8,9,1,19,20,9,3,0,72
3,8,9,1,21,19,0,0,0,61
3,8,9,1,21,19,5,19,0,85
3,8,9,1,22,5,0,0,0,48
3,8,9,1,22,5,20,20,1,89
3,8,25,1,26,9,3,0,0,75
3,8,9,2,9,14,9,20,5,79
3,8,9,2,15,12,0,0,0,49
3,8,9,2,15,21,11,0,0,69
3,8,9,2,15,21,11,19,0,88
3,8,9,2,15,21,17,21,5,101
3,8,9,2,18,9,20,0,0,69
3,8,9,3,1,0,0,0,0,24
3,8,9,3,1,4,5,5,0,38
3,8,9,3,1,25,15,20,5,89
3,8,9,3,1,12,15,20,5,76
3,8,9,3,1,14,5,0,0,43
3,8,9,3,1,14,5,4,0,47
3,8,9,3,1,14,5,18,0,61
3,8,9,3,1,14,5,18,25,86
3,8,9,3,1,14,5,18,19,80
3,8,9,3,1,14,5,19,0,62
3,8,9,3,1,14,9,14,7,68
3,8,9,3,1,18,9,3,0,54
3,8,9,3,3,15,18,25,0,84
3,8,9,3,5,18,0,0,0,46
3,8,9,3,5,19,20,0,0,67
3,8,9,3,8,0,0,0,0,31
3,8,9,3,8,1,18,18,1,69
3,8,9,3,8,9,0,0,0,40
3,8,9,3,8,9,12,9,0,61
3,8,9,3,8,9,16,5,0,61
3,8,9,3,8,9,19,0,0,59
3,8,9,3,8,12,9,14,7,73
3,8,9,3,11,1,4,5,5,49
3,8,9,3,11,1,18,5,5,63
3,8,9,3,11,5,5,0,0,44
3,8,9,3,11,5,5,19,0,63
3,8,9,3,11,5,12,12,0,63
3,8,9,3,11,5,14,0,0,53
3,8,9,3,11,5,14,5,4,62
3,8,9,3,11,5,14,19,0,72
3,8,9,3,11,5,18,0,0,57
3,8,9,3,11,5,18,25,0,82
3,8,9,3,11,8,15,15,4,76
3,8,9,3,11,9,5,19,0,67
3,8,9,3,11,12,9,14,7,76
3,8,9,3,11,15,18,25,0,92
3,8,9,3,11,16,5,1,0,56
3,8,9,3,11,16,5,1,19,75
3,8,9,3,11,19,0,0,0,53
3,8,9,3,11,23,5,5,4,71
3,8,9,3,11,23,9,20,0,86
3,8,9,3,12,5,0,0,0,40
3,8,9,3,12,5,18,15,0,73
3,8,9,3,12,5,19,0,0,59
3,8,9,3,12,25,0,0,0,60
3,8,9,3,14,5,19,19,0,80
3,8,9,3,15,18,25,0,0,81
3,8,9,3,15,18,9,5,19,89
3,8,9,3,15,19,0,0,0,57
3,8,9,3,15,20,0,0,0,58
3,8,9,3,15,20,5,0,0,63
3,8,9,3,17,21,5,4,0,70
3,8,9,3,17,21,5,18,0,84
3,8,9,3,17,21,5,19,20,105
3,8,9,3,17,21,9,14,7,91
3,8,9,3,19,0,0,0,0,42
3,8,9,4,0,0,0,0,0,24
3,8,9,4,4,5,14,0,0,47
3,8,9,4,5,0,0,0,0,29
3,8,9,4,5,4,0,0,0,33
3,8,9,4,5,18,0,0,0,47
3,8,9,4,5,18,19,0,0,66
3,8,9,4,5,19,0,0,0,48
3,8,9,4,9,14,7,0,0,54
3,8,9,4,9,14,7,12,25,91
3,8,9,4,18,1,0,0,0,43
3,8,9,5,6,0,0,0,0,31
3,8,9,5,6,1,7,5,0,44
3,8,9,5,6,4,15,13,0,63
3,8,9,5,6,4,15,13,19,82
3,8,9,5,6,5,18,0,0,54
3,8,9,5,6,5,18,25,0,79
3,8,9,5,6,5,19,19,0,74
3,8,9,5,6,5,19,20,0,75
3,8,9,5,6,9,19,8,0,67
3,8,9,5,6,12,5,19,19,86
3,8,9,5,6,12,25,0,0,68
3,8,9,5,6,12,9,14,7,73
3,8,9,5,6,18,25,0,0,74
3,8,9,5,6,19,0,0,0,50
3,8,9,5,6,19,8,9,16,83
3,8,9,5,6,20,1,9,14,75
3,8,9,5,6,20,5,19,19,94
3,8,9,5,6,20,25,0,0,76
3,8,9,5,12,0,0,0,0,37
3,8,9,5,12,4,0,0,0,41
3,8,9,5,12,4,19,0,0,60
3,8,9,5,12,19,0,0,0,56
3,8,9,5,18,5,20,5,0,73
3,8,9,5,22,1,14,3,5,70
3,8,9,5,22,5,0,0,0,52
3,8,9,6,6,5,18,0,0,55
3,8,9,6,6,15,14,0,0,61
3,8,9,6,6,15,14,25,0,86
3,8,9,6,6,15,14,19,0,80
3,8,9,6,6,18,5,0,0,55
3,8,9,6,6,18,15,2,5,72
3,8,9,7,5,20,1,9,0,62
3,8,9,7,5,20,1,9,19,81
3,8,9,7,7,1,0,0,0,35
3,8,9,7,7,1,11,0,0,46
3,8,9,7,7,5,18,0,0,57
3,8,9,7,7,5,18,19,0,76
3,8,9,7,14,15,14,0,0,70
3,8,9,7,14,15,14,5,4,79
3,8,9,7,14,15,14,19,0,89
3,8,9,7,15,5,0,0,0,47
3,8,9,7,15,5,19,0,0,66
3,8,9,8,0,0,0,0,0,28
3,8,9,8,6,21,0,0,0,55
3,8,9,11,1,18,1,0,0,51
3,8,9,11,5,5,0,0,0,41
3,8,9,12,1,12,7,9,1,62
3,8,9,12,1,18,9,1,0,61
3,8,9,12,1,18,9,21,13,94
3,8,9,12,2,12,1,9,14,70
3,8,9,12,4,1,7,5,0,49
3,8,9,12,4,2,5,1,18,62
3,8,9,12,4,2,5,4,0,47
3,8,9,12,4,2,5,4,19,66
3,8,9,12,4,5,4,0,0,45
3,8,9,12,4,5,19,0,0,60
3,8,9,12,4,8,15,15,4,78
3,8,9,12,4,9,14,7,0,66
3,8,9,12,4,9,19,8,0,72
3,8,9,12,4,11,9,14,4,74
3,8,9,12,4,12,5,19,19,91
3,8,9,12,4,12,25,0,0,73
3,8,9,12,4,12,9,5,18,80
3,8,9,12,4,12,9,11,5,73
3,8,9,12,4,14,5,19,19,93
3,8,9,12,4,18,5,0,0,59
3,8,9,12,4,18,5,14,0,73
3,8,9,12,4,19,8,9,16,88
3,8,9,12,4,23,1,18,4,82
3,8,9,12,4,23,9,6,5,79
3,8,9,12,4,23,9,20,5,93
3,8,25,12,5,0,0,0,0,53
3,8,9,12,5,1,14,19,0,71
3,8,25,12,5,13,9,1,0,76
3,8,9,12,5,14,9,20,5,85
3,8,25,12,5,19,0,0,0,72
3,8,9,12,9,0,0,0,0,41
3,8,9,12,9,1,4,0,0,46
3,8,9,12,9,1,4,1,12,59
3,8,9,12,9,1,4,9,3,58
3,8,9,12,9,1,4,19,0,65
3,8,9,12,9,1,7,15,14,78
3,8,9,12,9,1,18,3,8,71
3,8,9,12,9,1,19,13,0,74
3,8,9,12,9,1,19,13,19,93
3,8,9,12,9,1,19,20,0,81
3,8,9,12,9,1,19,20,19,100
3,8,9,12,9,3,15,20,5,84
3,8,9,12,9,4,9,21,13,88
3,8,9,12,9,4,15,7,0,67
3,8,9,12,9,4,15,7,19,86
3,8,9,12,9,5,19,0,0,65
3,8,25,12,9,6,25,0,0,88
3,8,25,12,9,6,9,3,0,75
3,8,25,12,9,6,9,5,4,81
3,8,25,12,9,6,15,18,13,109
3,8,9,12,9,14,4,18,5,82
3,8,9,12,9,15,13,2,0,71
3,8,9,12,9,20,9,19,0,89
3,8,9,12,12,1,0,0,0,45
3,8,9,12,12,5,4,0,0,53
3,8,9,12,12,5,18,0,0,67
3,8,9,12,12,5,18,19,0,86
3,8,9,12,12,5,19,20,0,88
3,8,9,12,12,9,0,0,0,53
3,8,9,12,12,25,0,0,0,69
3,8,9,12,12,9,5,18,0,76
3,8,9,12,12,9,5,19,0,77
3,8,9,12,12,9,5,19,20,97
3,8,9,12,12,9,12,25,0,90
3,8,9,12,12,9,14,7,0,74
3,8,9,12,12,9,19,0,0,72
3,8,9,12,12,9,19,8,0,80
3,8,9,12,12,14,5,19,19,101
3,8,9,12,12,15,0,0,0,59
3,8,9,12,12,15,5,19,0,83
3,8,9,12,12,18,15,15,13,105
3,8,9,12,12,19,0,0,0,63
3,8,9,12,12,19,15,13,5,96
3,8,9,12,12,21,13,0,0,78
3,8,9,12,12,21,13,19,0,97
3,8,25,12,15,3,5,12,5,88
3,8,25,12,15,3,25,19,20,130
3,8,9,12,15,4,15,14,0,80
3,8,25,12,15,9,4,0,0,76
3,8,9,12,15,13,1,0,0,61
3,8,9,12,15,13,1,20,1,82
3,8,9,12,15,14,3,21,19,104
3,8,9,12,15,16,15,4,0,82
3,8,9,12,15,16,15,4,19,101
3,8,25,12,15,19,9,19,0,110
3,8,9,12,15,20,15,13,25,120
3,8,25,12,15,21,19,0,0,103
3,8,9,12,20,5,0,0,0,57
3,8,25,12,21,18,9,1,0,97
3,8,9,12,22,5,18,0,0,77
3,8,9,13,1,5,18,1,0,58
3,8,9,13,1,5,18,1,19,77
3,8,9,13,1,5,18,9,4,70
3,8,9,13,1,14,7,15,0,70
3,8,9,13,1,18,0,0,0,52
3,8,9,13,1,18,19,0,0,71
3,8,25,13,1,19,5,0,0,74
3,8,9,13,2,0,0,0,0,35
3,8,9,13,2,5,0,0,0,40
3,8,9,13,2,12,5,0,0,52
3,8,9,13,2,12,5,25,0,77
3,8,9,13,2,12,5,25,19,96
3,8,9,13,2,12,25,0,0,72
3,8,9,13,2,12,9,5,19,80
3,8,9,13,2,19,0,0,0,54
3,8,9,13,5,0,0,0,0,38
3,8,25,13,5,0,0,0,0,54
3,8,9,13,5,4,0,0,0,42
3,8,9,13,5,18,0,0,0,56
3,8,9,13,5,18,1,0,0,57
3,8,9,13,5,18,1,12,0,69
3,8,9,13,5,18,1,19,0,76
3,8,9,13,5,18,5,0,0,61
3,8,9,13,5,18,5,19,0,80
3,8,9,13,5,18,9,3,0,68
3,8,9,13,5,18,9,19,13,97
3,8,9,13,5,18,19,0,0,75
3,8,9,13,5,19,0,0,0,57
3,8,25,13,5,19,0,0,0,73
3,8,25,13,9,1,0,0,0,59
3,8,25,13,9,3,0,0,0,61
3,8,25,13,9,3,19,0,0,80
3,8,25,13,9,6,25,0,0,89
3,8,25,13,9,6,9,5,4,82
3,8,9,13,9,14,0,0,0,56
3,8,9,13,9,14,1,7,5,69
3,8,9,13,9,14,7,0,0,63
3,8,25,13,9,19,20,0,0,97
3,8,25,13,9,19,20,18,25,140
3,8,25,13,9,19,20,19,0,116
3,8,9,13,12,1,0,0,0,46
3,8,9,13,12,1,19,0,0,65
3,8,9,13,12,5,25,0,0,75
3,8,9,13,12,5,25,19,0,94
3,8,9,13,14,5,25,0,0,77
3,8,9,13,14,5,25,5,4,86
3,8,9,13,14,5,25,19,0,96
3,8,25,13,15,19,9,14,0,106
3,8,25,13,15,19,9,14,19,125
3,8,25,13,15,21,19,0,0,104
3,8,9,13,16,0,0,0,0,49
3,8,9,13,16,19,0,0,0,68
3,8,9,14,1,6,25,0,0,66
3,8,9,14,1,6,9,19,8,77
3,8,9,14,1,12,9,11,5,72
3,8,9,14,1,13,16,1,0,65
3,8,9,14,1,14,20,1,0,70
3,8,9,14,1,18,0,0,0,53
3,8,9,14,1,18,15,15,20,103
3,8,9,14,1,19,0,0,0,54
3,8,9,14,1,23,1,18,5,82
3,8,9,14,2,1,14,4,0,55
3,8,9,14,2,5,1,11,0,53
3,8,9,14,2,15,14,5,0,70
3,8,9,14,2,15,14,5,19,89
3,8,9,14,3,1,16,9,14,77
3,8,9,14,3,8,0,0,0,45
3,8,9,14,3,8,1,0,0,46
3,8,9,14,3,8,5,0,0,50
3,8,9,14,3,8,5,18,0,68
3,8,9,14,3,8,5,19,0,69
3,8,9,14,3,8,25,0,0,70
3,8,9,14,3,8,9,5,18,77
3,8,9,14,3,8,9,14,7,75
3,8,9,14,3,8,15,14,1,75
3,8,9,14,3,12,15,20,8,92
3,8,9,14,3,15,6,0,0,58
3,8,9,14,3,15,14,1,0,67
3,8,9,14,3,15,21,7,8,88
3,8,9,14,4,5,5,0,0,48
3,8,9,14,4,9,0,0,0,47
3,8,9,14,5,0,0,0,0,39
3,8,9,14,5,4,0,0,0,43
3,8,9,14,5,12,1,0,0,52
3,8,9,14,5,14,19,5,19,96
3,8,9,14,5,19,0,0,0,58
3,8,9,14,6,5,19,20,0,84
3,8,9,14,7,13,1,0,0,55
3,8,9,14,9,11,0,0,0,54
3,8,9,14,9,11,19,0,0,73
3,8,9,14,9,14,0,0,0,57
3,8,9,14,9,14,7,0,0,64
3,8,9,14,9,15,6,15,14,93
3,8,9,14,11,1,16,9,14,85
3,8,9,14,11,1,18,1,0,65
3,8,9,14,11,5,4,0,0,54
3,8,9,14,11,5,18,0,0,68
3,8,9,14,11,5,18,19,0,87
3,8,9,14,11,25,0,0,0,70
3,8,9,14,11,9,5,18,0,77
3,8,9,14,11,9,5,19,20,98
3,8,9,14,11,9,14,7,0,75
3,8,9,14,11,12,5,0,0,62
3,8,9,14,11,19,0,0,0,64
3,8,9,14,12,5,19,0,0,70
3,8,9,14,12,5,19,19,0,89
3,8,9,14,14,1,13,0,0,62
3,8,9,14,14,5,4,0,0,57
3,8,9,14,14,5,18,0,0,71
3,8,9,14,14,5,18,19,0,90
3,8,9,14,14,25,0,0,0,73
3,8,9,14,14,9,5,18,0,80
3,8,9,14,14,9,5,19,20,101
3,8,9,14,14,9,14,7,0,78
3,8,9,14,15,1,0,0,0,50
3,8,9,14,15,9,4,9,14,85
3,8,9,14,15,9,19,0,0,77
3,8,9,14,15,12,0,0,0,61
3,8,9,14,15,12,9,14,5,89
3,8,9,14,15,14,5,0,0,68
3,8,9,14,15,14,5,19,0,87
3,8,9,14,15,19,0,0,0,68
3,8,9,14,15,20,20,9,0,98
3,8,9,14,15,20,20,15,0,104
3,8,9,14,15,22,14,9,11,105
3,8,9,14,16,9,5,3,5,72
3,8,9,14,19,0,0,0,0,53
3,8,9,14,19,5,0,0,0,58
3,8,9,14,19,5,4,0,0,62
3,8,9,14,19,9,14,7,0,83
3,8,9,14,20,0,0,0,0,54
3,8,9,14,20,19,0,0,0,73
3,8,9,14,20,19,5,19,0,97
3,8,9,14,20,26,0,0,0,80
3,8,9,14,20,26,5,0,0,85
3,8,9,14,20,26,5,19,0,104
3,8,9,14,20,26,25,0,0,105
3,8,9,14,20,26,9,5,18,112
3,8,9,14,23,1,7,0,0,65
3,8,9,14,23,15,15,4,0,91
3,8,9,15,12,9,20,5,0,81
3,8,25,15,13,5,20,5,18,112
3,8,9,15,16,9,14,0,0,74
3,8,9,15,20,9,12,12,1,89
3,8,9,16,2,15,1,18,4,76
3,8,9,16,3,8,1,16,0,64
3,8,9,16,3,8,15,16,0,78
3,8,9,16,25,1,18,4,0,84
3,8,9,16,12,5,20,0,0,73
3,8,9,16,12,9,14,7,0,78
3,8,9,16,13,21,3,11,0,84
3,8,9,16,13,21,3,11,19,103
3,8,9,16,13,21,14,11,0,95
3,8,9,16,13,21,14,11,19,114
3,8,9,16,15,12,1,20,1,85
3,8,9,16,16,1,2,12,5,72
3,8,9,16,16,1,7,5,0,65
3,8,9,16,16,5,4,0,0,61
3,8,9,16,16,5,18,0,0,75
3,8,9,16,16,5,18,5,4,84
3,8,9,16,16,5,18,19,0,94
3,8,9,16,16,25,0,0,0,77
3,8,9,16,16,9,5,0,0,66
3,8,9,16,16,9,5,18,0,84
3,8,9,16,16,9,5,19,0,85
3,8,9,16,16,9,5,19,20,105
3,8,9,16,16,9,14,7,0,82
3,8,9,16,16,9,14,7,19,101
3,8,9,16,16,18,15,15,6,106
3,8,25,16,18,5,0,0,0,75
3,8,9,16,19,0,0,0,0,55
3,8,9,16,23,15,15,4,0,93
3,8,9,17,21,5,18,15,0,96
3,8,9,17,21,5,19,20,0,102
3,8,9,18,1,7,18,1,0,65
3,8,9,18,1,25,20,1,0,85
3,8,9,18,1,12,0,0,0,51
3,8,9,18,1,12,7,9,1,68
3,8,9,18,1,12,9,20,25,105
3,8,9,18,1,16,19,9,1,84
3,8,9,18,1,20,1,0,0,60
3,8,9,18,9,13,5,14,0,79
3,8,9,18,9,13,9,1,0,70
3,8,9,18,9,13,15,25,1,101
3,8,9,18,9,14,15,12,1,89
3,8,9,18,9,16,1,0,0,64
3,8,9,18,9,22,9,20,1,99
3,8,9,18,11,0,0,0,0,49
3,8,9,18,11,5,4,0,0,58
3,8,9,18,11,5,18,0,0,72
3,8,9,18,11,5,19,20,0,93
3,8,9,18,11,9,14,7,0,79
3,8,9,18,11,19,0,0,0,68
3,8,9,18,12,0,0,0,0,50
3,8,9,18,13,0,0,0,0,51
3,8,9,18,13,5,4,0,0,60
3,8,9,18,13,9,14,7,0,81
3,8,9,18,13,19,0,0,0,70
3,8,9,18,15,0,0,0,0,53
3,8,9,18,15,7,1,12,5,78
3,8,9,18,15,12,1,19,0,85
3,8,9,18,15,12,15,7,25,112
3,8,9,18,15,13,1,14,20,101
3,8,9,18,15,14,25,13,0,105
3,8,9,18,15,14,15,13,25,120
3,8,9,18,15,16,15,4,0,88
3,8,9,18,15,16,15,4,25,113
3,8,9,18,15,16,20,5,18,112
3,8,9,18,15,19,0,0,0,72
3,8,9,18,15,20,25,16,5,119
3,8,9,18,15,20,15,14,25,127
3,8,9,18,16,0,0,0,0,54
3,8,9,18,16,5,4,0,0,63
3,8,9,18,16,5,18,0,0,77
3,8,9,18,16,5,18,19,0,96
3,8,9,18,16,25,0,0,0,79
3,8,9,18,16,9,5,18,0,86
3,8,9,18,16,9,5,19,20,107
3,8,9,18,16,9,12,25,0,100
3,8,9,18,16,9,14,7,0,84
3,8,9,18,16,12,9,14,7,96
3,8,9,18,16,19,0,0,0,73
3,8,9,18,18,0,0,0,0,56
3,8,9,18,18,5,0,0,0,61
3,8,9,18,18,5,4,0,0,65
3,8,9,18,18,5,19,0,0,80
3,8,9,18,18,9,14,7,0,86
3,8,9,18,18,19,0,0,0,75
3,8,9,18,18,21,16,0,0,93
3,8,9,18,18,21,16,5,4,102
3,8,9,18,18,21,16,5,18,116
3,8,9,18,18,21,16,25,0,118
3,8,9,18,18,21,16,19,0,112
3,8,9,18,20,0,0,0,0,58
3,8,9,18,21,0,0,0,0,59
3,8,9,18,21,18,7,25,0,109
3,8,9,18,21,18,7,9,3,96
3,8,9,19,0,0,0,0,0,39
3,8,9,19,5,12,0,0,0,56
3,8,9,19,5,12,5,4,0,65
3,8,9,19,5,12,5,18,0,79
3,8,9,19,5,12,5,18,19,98
3,8,9,19,5,12,9,14,7,86
3,8,9,19,5,12,12,5,4,77
3,8,9,19,5,12,12,5,18,91
3,8,9,19,5,12,12,25,0,93
3,8,9,19,5,12,19,0,0,75
3,8,9,19,12,5,4,0,0,60
3,8,9,19,20,5,18,1,0,83
3,8,9,19,20,11,1,0,0,71
3,8,9,20,0,0,0,0,0,40
3,8,9,20,1,11,0,0,0,52
3,8,9,20,1,12,0,0,0,53
3,8,9,20,1,18,18,1,0,78
3,8,9,20,3,8,1,20,0,72
3,8,9,20,3,8,1,20,19,91
3,8,9,20,8,5,0,0,0,53
3,8,9,20,9,14,0,0,0,63
3,8,9,20,9,14,15,9,4,91
3,8,9,20,9,14,15,21,19,118
3,8,9,20,9,14,19,0,0,82
3,8,9,20,12,9,14,0,0,75
3,8,9,20,12,9,14,7,0,82
3,8,9,20,12,9,14,7,19,101
3,8,9,20,12,9,14,19,0,94
3,8,9,20,15,14,0,0,0,69
3,8,9,20,15,14,19,0,0,88
3,8,9,20,15,19,1,14,0,89
3,8,9,20,15,19,1,14,19,108
3,8,9,20,15,19,5,0,0,79
3,8,9,20,18,1,0,0,0,59
3,8,25,20,18,1,0,0,0,75
3,8,25,20,18,9,4,0,0,87
3,8,9,20,19,0,0,0,0,59
3,8,9,20,20,1,3,11,0,75
3,8,9,20,20,1,11,0,0,72
3,8,9,20,20,5,4,0,0,69
3,8,9,20,20,5,18,0,0,83
3,8,9,20,20,5,18,5,4,92
3,8,9,20,20,5,18,19,0,102
3,8,9,20,20,25,0,0,0,85
3,8,9,20,20,9,5,19,0,93
3,8,9,20,20,9,14,7,0,90
3,8,9,21,12,5,0,0,0,58
3,8,9,21,18,13,0,0,0,72
3,8,9,22,0,0,0,0,0,42
3,8,9,22,1,3,8,5,5,64
3,8,9,22,1,7,5,0,0,55
3,8,9,22,1,12,18,25,0,98
3,8,9,22,1,12,18,9,3,85
3,8,9,22,1,18,5,5,0,71
3,8,9,22,1,18,5,5,4,75
3,8,9,22,1,18,5,5,19,90
3,8,9,22,1,18,9,0,0,70
3,8,9,22,1,18,9,5,4,79
3,8,9,22,1,18,9,14,7,91
3,8,9,22,1,18,9,19,0,89
3,8,9,22,1,18,18,1,0,80
3,8,9,22,1,18,18,1,19,99
3,8,9,22,1,18,18,15,0,94
3,8,9,22,5,0,0,0,0,47
3,8,9,22,5,25,0,0,0,72
3,8,9,22,5,18,0,0,0,65
3,8,9,22,5,18,5,20,0,90
3,8,9,22,5,19,0,0,0,66
3,8,9,22,25,0,0,0,0,67
3,8,9,22,9,5,4,0,0,60
3,8,9,22,9,5,19,0,0,75
3,8,9,22,25,9,14,7,0,97
3,8,9,22,22,25,0,0,0,89
3,8,9,22,22,9,5,4,0,82
3,8,9,22,22,9,5,19,0,97
3,8,9,22,22,25,9,14,7,119
3,8,9,22,23,0,0,0,0,65
3,8,9,26,26,0,0,0,0,72
3,8,9,26,26,5,12,0,0,89
3,8,11,1,12,9,11,0,0,55
3,8,11,6,9,12,0,0,0,49
3,8,11,6,9,12,5,0,0,54
3,8,12,1,4,14,9,20,5,76
3,8,12,1,13,25,4,0,0,66
3,8,12,1,13,25,4,5,19,90
3,8,12,1,13,25,19,0,0,81
3,8,12,1,13,25,19,5,19,105
3,8,12,15,1,19,13,1,0,72
3,8,12,15,18,0,0,0,0,56
3,8,12,15,18,1,3,14,5,79
3,8,12,15,18,1,7,5,14,83
3,8,12,15,18,1,12,0,0,69
3,8,12,15,18,1,12,19,0,88
3,8,12,15,18,1,12,21,13,103
3,8,12,15,18,1,13,9,14,93
3,8,12,15,18,1,14,9,12,92
3,8,12,15,18,1,20,5,0,82
3,8,12,15,18,1,20,5,19,101
3,8,12,15,18,4,1,14,0,75
3,8,12,15,18,4,1,14,5,80
3,8,12,15,18,4,1,14,19,94
3,8,12,15,18,5,0,0,0,61
3,8,12,15,18,5,4,0,0,65
3,8,12,15,18,5,13,9,1,84
3,8,12,15,18,5,13,9,3,86
3,8,12,15,18,9,1,13,2,81
3,8,12,15,18,9,3,0,0,68
3,8,12,15,18,9,4,0,0,69
3,8,12,15,18,9,4,5,0,74
3,8,12,15,18,9,4,5,18,92
3,8,12,15,18,9,4,5,19,93
3,8,12,15,18,9,4,9,3,81
3,8,12,15,18,9,4,19,0,88
3,8,12,15,18,25,12,0,0,93
3,8,12,15,18,9,14,0,0,79
3,8,12,15,18,9,14,5,0,84
3,8,12,15,18,9,14,5,19,103
3,8,12,15,18,9,14,19,0,98
3,8,12,15,18,9,20,5,0,90
3,8,12,15,18,9,20,5,19,109
3,8,12,15,18,9,20,9,3,97
3,8,12,15,18,9,26,5,0,96
3,8,12,15,18,14,1,12,0,83
3,8,12,15,18,15,0,0,0,71
3,8,12,15,18,15,9,4,0,84
3,8,12,15,18,15,13,1,0,85
3,8,12,15,18,15,16,1,12,100
3,8,12,15,18,15,16,9,1,97
3,8,12,15,18,15,19,9,19,118
3,8,12,15,18,15,20,9,3,103
3,8,12,15,18,15,21,19,0,111
3,8,13,14,0,0,0,0,0,38
3,8,14,0,0,0,0,0,0,25
3,8,15,1,3,8,25,20,5,88
3,8,15,1,11,0,0,0,0,38
3,8,15,1,14,1,0,0,0,42
3,8,15,1,14,1,5,0,0,47
3,8,15,1,14,1,20,5,0,67
3,8,15,1,14,9,20,5,0,75
3,8,15,1,14,15,9,4,0,69
3,8,15,1,20,25,0,0,0,72
3,8,15,2,0,0,0,0,0,28
3,8,15,2,4,1,18,0,0,51
3,8,15,2,9,5,0,0,0,42
3,8,15,3,1,0,0,0,0,30
3,8,15,3,1,12,8,15,0,65
3,8,15,3,1,18,4,0,0,52
3,8,15,3,8,15,19,0,0,71
3,8,15,3,11,0,0,0,0,40
3,8,15,3,11,5,4,0,0,49
3,8,15,3,11,5,18,0,0,63
3,8,15,3,11,6,21,12,0,79
3,8,15,3,11,6,21,12,12,91
3,8,15,3,11,9,14,7,0,70
3,8,15,3,11,12,5,18,0,75
3,8,15,3,11,13,1,14,0,68
3,8,15,3,11,19,0,0,0,59
3,8,15,3,15,12,1,20,5,82
3,8,15,3,15,12,1,20,25,102
3,8,15,5,12,0,0,0,0,43
3,8,15,5,14,9,24,0,0,78
3,8,15,6,6,5,18,0,0,61
3,8,15,7,1,0,0,0,0,34
3,8,15,7,1,11,0,0,0,45
3,8,15,7,19,5,20,0,0,77
3,8,15,25,0,0,0,0,0,51
3,8,15,25,1,0,0,0,0,52
3,8,15,25,1,18,15,15,20,120
3,8,15,9,3,5,0,0,0,43
3,8,15,9,3,5,6,21,12,82
3,8,15,9,3,5,12,25,0,80
3,8,15,9,3,5,18,0,0,61
3,8,15,9,3,5,19,0,0,62
3,8,15,9,3,5,19,20,0,82
3,8,15,9,3,25,0,0,0,63
3,8,15,9,3,9,5,18,0,70
3,8,15,9,3,9,5,19,20,91
3,8,15,9,12,0,0,0,0,47
3,8,15,9,12,5,0,0,0,52
3,8,15,9,12,5,18,0,0,70
3,8,15,9,18,0,0,0,0,53
3,8,15,9,18,2,15,25,0,95
3,8,15,9,18,2,15,25,19,114
3,8,15,9,18,5,4,0,0,62
3,8,15,9,18,7,9,18,12,99
3,8,15,9,18,9,14,7,0,83
3,8,15,9,18,12,9,11,5,90
3,8,15,9,18,13,1,14,0,81
3,8,15,25,18,15,15,20,0,119
3,8,15,9,18,19,0,0,0,72
3,8,15,9,18,23,9,19,5,109
3,8,15,9,19,5,0,0,0,59
3,8,15,11,0,0,0,0,0,37
3,8,15,11,1,7,5,0,0,50
3,8,15,11,5,0,0,0,0,42
3,8,15,11,5,1,2,12,5,62
3,8,15,11,5,2,15,18,5,82
3,8,15,11,5,4,0,0,0,46
3,8,15,11,5,4,1,13,16,76
3,8,15,11,5,25,0,0,0,67
3,8,15,11,5,25,19,0,0,86
3,8,15,11,5,18,0,0,0,60
3,8,15,11,5,18,5,4,0,69
3,8,15,11,5,18,13,1,14,88
3,8,15,11,5,18,19,0,0,79
3,8,15,11,5,19,0,0,0,61
3,8,15,11,5,23,5,5,4,79
3,8,15,11,25,0,0,0,0,62
3,8,15,11,9,4,1,18,0,69
3,8,15,11,9,5,18,0,0,69
3,8,15,11,9,5,19,0,0,70
3,8,15,11,9,5,19,20,0,90
3,8,15,11,9,14,7,0,0,67
3,8,15,11,9,14,7,12,25,104
3,8,15,11,15,0,0,0,0,52
3,8,15,11,18,1,0,0,0,56
3,8,15,12,1,5,13,9,1,67
3,8,15,12,1,12,9,3,0,63
3,8,15,12,1,13,0,0,0,52
3,8,15,12,1,14,5,0,0,58
3,8,15,12,1,14,9,3,0,65
3,8,15,12,1,20,5,0,0,64
3,8,15,12,1,20,5,19,0,83
3,8,15,12,4,0,0,0,0,42
3,8,15,12,5,1,20,5,0,69
3,8,15,12,5,3,25,19,20,110
3,8,15,12,5,4,15,3,8,73
3,8,15,12,5,5,0,0,0,48
3,8,15,12,5,9,3,0,0,55
3,8,15,12,5,9,14,5,0,71
3,8,15,12,5,9,14,9,3,78
3,8,15,12,5,12,9,20,8,92
3,8,15,12,5,13,9,1,0,66
3,8,15,12,5,14,20,0,0,77
3,8,15,12,5,14,20,19,0,96
3,8,15,12,5,18,0,0,0,61
3,8,15,12,5,18,1,0,0,62
3,8,15,12,5,18,1,9,3,74
3,8,15,12,5,18,1,19,0,81
3,8,15,12,5,18,9,3,0,73
3,8,15,12,5,18,9,14,5,89
3,8,15,12,5,18,15,9,4,89
3,8,15,12,5,18,19,0,0,80
3,8,15,12,5,21,18,9,1,92
3,8,15,12,9,0,0,0,0,47
3,8,15,12,9,1,13,2,0,63
3,8,15,12,9,3,0,0,0,50
3,8,15,12,9,3,11,0,0,61
3,8,15,12,9,14,5,0,0,66
3,8,15,12,9,14,5,19,0,85
3,8,15,12,9,14,9,3,0,73
3,8,15,12,12,1,0,0,0,51
3,8,15,12,12,1,19,0,0,70
3,8,15,12,12,5,18,0,0,73
3,8,15,12,12,5,18,19,0,92
3,8,15,12,15,9,4,0,0,66
3,8,15,12,15,9,4,9,3,78
3,8,15,12,15,12,9,20,8,102
3,8,15,12,20,18,25,0,0,101
3,8,15,12,21,13,0,0,0,72
3,8,15,12,21,18,9,1,0,87
3,8,15,13,1,7,5,0,0,52
3,8,15,13,5,18,0,0,0,62
3,8,15,13,16,0,0,0,0,55
3,8,15,13,16,5,4,0,0,64
3,8,15,13,16,5,18,0,0,78
3,8,15,13,16,5,18,19,0,97
3,8,15,13,16,9,14,7,0,85
3,8,15,13,16,19,0,0,0,74
3,8,15,14,3,8,9,14,1,75
3,8,15,14,4,18,1,12,0,75
3,8,15,14,4,18,5,0,0,67
3,8,15,14,4,18,9,0,0,71
3,8,15,14,4,18,9,1,0,72
3,8,15,14,4,18,9,3,0,74
3,8,15,14,4,18,9,6,25,102
3,8,15,14,4,18,9,14,0,85
3,8,15,14,4,18,9,20,5,96
3,8,15,14,4,18,15,9,4,90
3,8,15,14,4,18,15,13,1,91
3,8,15,14,4,18,21,12,5,100
3,8,15,14,4,18,21,19,0,102
3,8,15,14,11,0,0,0,0,51
3,8,15,14,15,12,9,20,8,104
3,8,15,14,20,1,0,0,0,61
3,8,15,15,3,8,15,15,0,82
3,8,15,15,11,0,0,0,0,52
3,8,15,15,11,25,0,0,0,77
3,8,15,15,11,9,5,0,0,66
3,8,15,15,11,9,5,19,0,85
3,8,15,15,13,0,0,0,0,54
3,8,15,15,16,0,0,0,0,57
3,8,15,15,18,1,0,0,0,60
3,8,15,15,19,1,2,12,5,80
3,8,15,15,19,5,0,0,0,65
3,8,15,15,19,5,25,0,0,90
3,8,15,15,19,5,18,0,0,83
3,8,15,15,19,5,18,19,0,102
3,8,15,15,19,5,19,0,0,84
3,8,15,15,19,25,0,0,0,85
3,8,15,15,19,9,5,18,0,92
3,8,15,15,19,9,5,19,20,113
3,8,15,15,19,9,14,7,0,90
3,8,15,16,0,0,0,0,0,42
3,8,15,16,1,0,0,0,0,43
3,8,15,16,1,19,0,0,0,62
3,8,15,16,2,15,1,20,0,80
3,8,15,16,4,1,18,0,0,65
3,8,15,16,8,15,21,19,5,110
3,8,15,16,9,14,5,0,0,70
3,8,15,16,9,14,5,19,0,89
3,8,15,16,9,14,19,0,0,84
3,8,15,16,12,15,7,9,3,88
3,8,15,16,16,5,4,0,0,67
3,8,15,16,16,5,18,0,0,81
3,8,15,16,16,5,18,5,4,90
3,8,15,16,16,5,18,19,0,100
3,8,15,16,16,25,0,0,0,83
3,8,15,16,16,9,5,18,0,90
3,8,15,16,16,9,5,19,20,111
3,8,15,16,16,9,12,25,0,104
3,8,15,16,16,9,14,0,0,81
3,8,15,16,16,9,14,7,0,88
3,8,15,16,19,0,0,0,0,61
3,8,15,16,19,20,9,3,11,104
3,8,15,18,1,7,9,0,0,61
3,8,15,18,1,7,25,0,0,77
3,8,15,18,1,7,9,3,0,64
3,8,15,18,1,7,9,15,14,90
3,8,15,18,1,7,9,21,13,95
3,8,15,18,1,7,21,19,0,92
3,8,15,18,1,12,0,0,0,57
3,8,15,18,1,12,5,0,0,62
3,8,15,18,1,12,5,15,14,91
3,8,15,18,1,12,5,19,0,81
3,8,15,18,1,12,9,19,20,105
3,8,15,18,1,12,12,25,0,94
3,8,15,18,1,12,19,0,0,76
3,8,15,18,4,0,0,0,0,48
3,8,15,18,4,1,0,0,0,49
3,8,15,18,4,1,12,0,0,61
3,8,15,18,4,1,12,12,25,98
3,8,15,18,4,1,20,5,0,74
3,8,15,18,4,1,20,5,19,93
3,8,15,18,4,5,4,0,0,57
3,8,15,18,4,5,5,0,0,58
3,8,15,18,4,9,14,7,0,78
3,8,15,18,4,9,20,9,19,105
3,8,15,18,4,15,9,4,0,76
3,8,15,18,4,19,0,0,0,67
3,8,15,18,5,0,0,0,0,49
3,8,15,18,5,1,0,0,0,50
3,8,15,18,5,1,12,0,0,62
3,8,15,18,5,1,19,0,0,69
3,8,15,18,5,1,20,9,3,82
3,8,15,18,5,4,0,0,0,53
3,8,15,18,5,5,0,0,0,54
3,8,15,18,5,7,9,0,0,65
3,8,15,18,5,7,25,0,0,81
3,8,15,18,5,7,9,3,0,68
3,8,15,18,5,7,21,19,0,96
3,8,15,18,5,9,0,0,0,58
3,8,15,18,5,9,3,0,0,61
3,8,15,18,5,13,1,14,0,77
3,8,15,18,5,13,5,14,0,81
3,8,15,18,5,15,9,4,0,77
3,8,15,18,5,19,0,0,0,68
3,8,15,18,5,21,19,0,0,89
3,8,15,18,5,21,20,9,3,102
3,8,15,18,7,9,0,0,0,60
3,8,15,18,9,1,12,0,0,66
3,8,15,18,9,1,13,2,0,69
3,8,15,18,9,1,13,2,9,78
3,8,15,18,9,1,13,2,19,88
3,8,15,18,9,2,9,0,0,64
3,8,15,18,9,3,0,0,0,56
3,8,15,18,9,14,5,0,0,72
3,8,15,18,9,14,5,19,0,91
3,8,15,18,9,14,7,0,0,74
3,8,15,18,9,15,0,0,0,68
3,8,15,18,9,15,9,4,0,81
3,8,15,18,9,15,9,4,19,100
3,8,15,18,9,15,13,1,0,82
3,8,15,18,9,15,13,1,19,101
3,8,15,18,9,15,14,0,0,82
3,8,15,18,9,15,14,9,3,94
3,8,15,18,9,15,14,19,0,101
3,8,15,18,25,15,19,0,0,103
3,8,15,18,9,19,9,19,0,100
3,8,15,18,9,19,13,0,0,85
3,8,15,18,9,19,15,0,0,87
3,8,15,18,9,19,15,19,0,106
3,8,15,18,9,19,20,0,0,92
3,8,15,18,9,19,20,5,18,115
3,8,15,18,9,19,20,9,3,104
3,8,15,18,9,19,20,18,25,135
3,8,15,18,9,26,15,0,0,94
3,8,15,18,9,26,15,14,20,128
3,8,15,18,9,26,15,19,0,113
3,8,15,18,15,7,9,0,0,75
3,8,15,18,15,9,4,0,0,72
3,8,15,18,15,9,4,1,12,85
3,8,15,18,15,9,4,5,1,78
3,8,15,18,15,9,4,19,0,91
3,8,15,18,15,12,15,7,25,118
3,8,15,18,15,15,11,0,0,85
3,8,15,18,15,21,19,0,0,99
3,8,15,18,20,0,0,0,0,64
3,8,15,18,20,5,14,0,0,83
3,8,15,18,20,12,5,0,0,81
3,8,15,18,20,12,5,4,0,85
3,8,15,18,20,12,5,18,0,99
3,8,15,18,20,12,5,18,19,118
3,8,15,18,20,12,5,19,0,100
3,8,15,18,20,12,9,14,7,106
3,8,15,18,21,19,0,0,0,84
3,8,15,18,21,19,5,4,0,93
3,8,15,18,21,19,5,18,0,107
3,8,15,18,21,19,5,19,0,108
3,8,15,18,21,19,9,14,7,114
3,8,15,18,21,19,19,5,4,112
3,8,15,18,21,19,19,5,19,127
3,8,15,19,5,0,0,0,0,50
3,8,15,19,5,19,0,0,0,69
3,8,15,19,9,14,7,0,0,75
3,8,15,20,20,0,0,0,0,66
3,8,15,20,20,19,0,0,0,85
3,8,15,21,5,20,20,5,0,97
3,8,15,21,6,12,5,21,18,109
3,8,15,21,7,8,0,0,0,62
3,8,15,21,7,8,19,0,0,81
3,8,15,21,11,1,0,0,0,59
3,8,15,21,12,5,0,0,0,64
3,8,15,21,12,20,18,25,0,122
3,8,15,21,14,3,5,0,0,69
3,8,15,21,16,0,0,0,0,63
3,8,15,21,16,9,3,0,0,75
3,8,15,21,19,0,0,0,0,66
3,8,15,21,19,5,0,0,0,71
3,8,15,21,19,5,4,0,0,75
3,8,15,21,19,5,18,0,0,89
3,8,15,21,19,5,18,19,0,108
3,8,15,21,19,5,19,0,0,90
3,8,15,21,19,8,0,0,0,74
3,8,15,21,19,8,5,19,0,98
3,8,15,21,19,9,14,7,0,96
3,8,15,21,20,0,0,0,0,67
3,8,15,21,24,0,0,0,0,71
3,8,15,23,3,8,15,23,0,98
3,8,15,23,3,8,15,23,19,117
3,8,15,23,4,5,18,0,0,76
3,8,15,23,4,5,18,5,4,85
3,8,15,23,4,5,18,19,0,95
3,8,15,23,5,4,0,0,0,58
3,8,15,23,8,15,21,14,4,111
3,8,15,23,9,14,7,0,0,79
3,8,15,23,11,0,0,0,0,60
3,8,15,23,18,25,0,0,0,92
3,8,15,23,18,9,5,19,0,100
3,8,15,23,19,0,0,0,0,68
3,8,15,23,19,5,0,0,0,73
3,8,15,23,19,5,4,0,0,77
3,8,15,23,19,5,19,0,0,92
3,8,15,23,19,9,14,7,0,98
3,8,15,23,20,9,13,5,0,96
3,8,15,23,20,9,13,5,19,115
3,8,18,5,13,19,5,12,0,83
3,8,18,5,13,26,5,12,0,90
3,8,18,5,19,1,18,4,0,76
3,8,18,5,19,1,18,4,19,95
3,8,18,25,0,0,0,0,0,54
3,8,18,9,1,0,0,0,0,39
3,8,18,9,13,19,5,12,0,87
3,8,18,25,19,1,12,0,0,86
3,8,18,25,19,1,12,9,4,99
3,8,18,25,19,1,12,9,19,114
3,8,18,25,19,1,26,9,14,123
3,8,18,25,19,1,26,15,12,127
3,8,18,25,19,5,14,5,0,97
3,8,18,25,19,5,14,9,3,104
3,8,18,25,19,9,4,0,0,86
3,8,18,25,19,9,4,9,4,99
3,8,18,25,19,9,14,0,0,96
3,8,18,25,19,12,5,18,19,127
3,8,18,9,19,13,0,0,0,70
3,8,18,9,19,13,1,0,0,71
3,8,18,9,19,13,1,12,0,83
3,8,18,9,19,13,1,12,5,88
3,8,18,9,19,13,1,18,25,114
3,8,18,9,19,13,15,14,0,99
3,8,18,9,19,13,15,14,19,118
3,8,18,9,19,13,19,0,0,89
3,8,18,25,19,15,7,5,14,114
3,8,18,9,19,15,13,0,0,85
3,8,18,25,19,15,13,5,0,106
3,8,18,9,19,15,13,19,0,104
3,8,18,25,19,15,16,1,12,117
3,8,18,25,19,15,16,5,5,114
3,8,18,25,19,15,16,9,4,117
3,8,18,25,19,15,18,9,14,129
3,8,18,9,19,18,15,15,20,125
3,8,18,9,19,20,5,14,19,115
3,8,18,9,19,20,19,0,0,96
3,8,18,15,1,20,15,12,0,92
3,8,18,15,13,1,0,0,0,58
3,8,18,15,13,1,19,0,0,77
3,8,18,15,13,1,20,5,0,83
3,8,18,15,13,1,20,5,19,102
3,8,18,15,13,1,20,9,3,90
3,8,18,15,13,1,20,9,4,91
3,8,18,15,13,1,20,9,14,101
3,8,18,15,13,5,0,0,0,62
3,8,18,15,13,5,4,0,0,66
3,8,18,15,13,5,14,5,0,81
3,8,18,15,13,5,19,0,0,81
3,8,18,15,13,25,0,0,0,82
3,8,18,15,13,9,3,0,0,69
3,8,18,15,13,9,4,0,0,70
3,8,18,15,13,9,4,5,0,75
3,8,18,15,13,25,12,0,0,94
3,8,18,15,13,25,12,19,0,113
3,8,18,15,13,9,14,7,0,87
3,8,18,15,13,9,15,12,5,98
3,8,18,15,13,9,19,13,0,98
3,8,18,15,13,9,20,5,0,91
3,8,18,15,13,9,20,5,19,110
3,8,18,15,13,9,21,13,0,100
3,8,18,15,13,9,21,13,19,119
3,8,18,15,13,9,26,5,0,97
3,8,18,15,13,9,26,5,4,101
3,8,18,15,13,9,26,5,19,116
3,8,18,15,13,15,7,5,14,98
3,8,18,15,13,15,14,5,0,91
3,8,18,15,13,15,19,0,0,91
3,8,18,15,13,15,21,19,0,112
3,8,18,15,13,21,12,5,0,95
3,8,18,15,14,1,12,0,0,71
3,8,18,15,14,1,24,25,0,108
3,8,18,15,14,1,24,9,1,93
3,8,18,15,14,1,24,9,5,97
3,8,18,15,14,9,3,0,0,70
3,8,18,15,14,9,3,1,0,71
3,8,18,15,14,9,3,1,12,83
3,8,18,15,14,9,3,12,5,87
3,8,18,15,14,9,3,15,14,99
3,8,18,15,14,9,3,19,0,89
3,8,18,15,14,9,17,21,5,110
3,8,18,15,14,9,19,20,0,106
3,8,18,15,14,15,12,0,0,85
3,8,18,15,14,15,14,0,0,87
3,8,18,15,14,15,14,19,0,106
3,8,18,15,15,21,19,0,0,99
3,8,18,15,20,20,1,0,0,85
3,8,19,0,0,0,0,0,0,30
3,8,20,5,1,21,0,0,0,58
3,8,20,8,15,14,9,1,14,92
3,8,20,8,15,14,9,3,0,80
3,8,21,1,14,1,0,0,0,48
3,8,21,2,0,0,0,0,0,34
3,8,21,2,1,19,3,15,0,72
3,8,21,2,1,19,3,15,19,91
3,8,21,2,2,5,4,0,0,45
3,8,21,2,2,25,0,0,0,61
3,8,21,2,2,9,5,18,0,68
3,8,21,2,2,9,5,19,20,89
3,8,21,2,2,9,12,25,0,82
3,8,21,2,19,0,0,0,0,53
3,8,21,3,11,5,4,0,0,55
3,8,21,3,11,5,18,0,0,69
3,8,21,3,11,6,21,12,12,97
3,8,21,3,11,8,15,12,5,86
3,8,21,3,11,25,0,0,0,71
3,8,21,3,11,9,5,0,0,60
3,8,21,3,11,9,5,19,0,79
3,8,21,3,11,9,14,7,0,76
3,8,21,3,11,12,5,0,0,63
3,8,21,3,11,12,5,4,0,67
3,8,21,3,11,12,5,18,0,81
3,8,21,3,11,12,5,18,19,100
3,8,21,3,11,12,5,19,0,82
3,8,21,3,11,12,9,14,7,88
3,8,21,3,11,18,1,13,0,78
3,8,21,3,11,18,21,13,0,98
3,8,21,3,11,19,0,0,0,65
3,8,21,4,4,1,8,0,0,49
3,8,21,4,4,1,8,19,0,68
3,8,21,4,4,1,18,0,0,59
3,8,21,4,4,1,18,19,0,78
3,8,21,4,4,5,18,0,0,63
3,8,21,4,4,5,18,19,0,82
3,8,21,5,20,0,0,0,0,57
3,8,21,6,1,0,0,0,0,39
3,8,21,6,1,19,0,0,0,58
3,8,21,6,6,0,0,0,0,44
3,8,21,6,6,5,4,0,0,53
3,8,21,6,6,5,18,0,0,67
3,8,21,6,6,5,19,20,0,88
3,8,21,6,6,25,0,0,0,69
3,8,21,6,6,9,5,18,0,76
3,8,21,6,6,9,5,19,20,97
3,8,21,6,6,9,12,25,0,90
3,8,21,6,6,9,14,7,0,74
3,8,21,6,6,19,0,0,0,63
3,8,21,7,0,0,0,0,0,39
3,8,21,7,1,12,21,7,0,80
3,8,21,7,1,12,21,7,19,99
3,8,21,7,7,5,4,0,0,55
3,8,21,7,7,5,18,0,0,69
3,8,21,7,7,5,18,19,0,88
3,8,21,7,7,9,14,7,0,76
3,8,21,7,8,15,12,5,0,79
3,8,21,7,19,0,0,0,0,58
3,8,21,8,18,1,0,0,0,59
3,8,21,11,1,18,0,0,0,62
3,8,21,11,1,18,19,0,0,81
3,8,21,11,11,1,0,0,0,55
3,8,21,11,11,1,18,0,0,73
3,8,21,11,11,1,18,19,0,92
3,8,21,11,11,1,19,0,0,74
3,8,21,11,11,5,18,0,0,77
3,8,21,11,11,5,18,19,0,96
3,8,21,11,15,18,0,0,0,76
3,8,21,12,1,14,0,0,0,59
3,8,21,12,8,1,0,0,0,53
3,8,21,12,12,15,0,0,0,71
3,8,21,12,12,16,1,0,0,73
3,8,21,12,16,1,0,0,0,61
3,8,21,12,20,21,14,0,0,99
3,8,21,13,0,0,0,0,0,45
3,8,21,13,1,18,0,0,0,64
3,8,21,13,2,12,5,0,0,64
3,8,21,13,13,1,7,5,0,71
3,8,21,13,13,5,4,0,0,67
3,8,21,13,13,5,18,0,0,81
3,8,21,13,13,5,18,25,0,106
3,8,21,13,13,25,0,0,0,83
3,8,21,13,13,9,5,18,0,90
3,8,21,13,13,9,5,19,0,91
3,8,21,13,13,9,5,19,20,111
3,8,21,13,13,9,12,25,0,104
3,8,21,13,13,9,14,7,0,88
3,8,21,13,16,0,0,0,0,61
3,8,21,13,16,1,0,0,0,62
3,8,21,13,16,1,11,1,0,74
3,8,21,13,16,5,4,0,0,70
3,8,21,13,16,25,0,0,0,86
3,8,21,13,16,9,14,7,0,91
3,8,21,13,16,9,19,8,0,97
3,8,21,13,16,19,0,0,0,80
3,8,21,13,19,0,0,0,0,64
3,8,21,13,19,8,9,16,0,97
3,8,21,13,19,8,9,16,19,116
3,8,21,14,1,13,0,0,0,60
3,8,21,14,1,18,9,0,0,74
3,8,21,14,4,1,18,9,0,78
3,8,21,14,4,5,18,0,0,73
3,8,21,14,7,1,0,0,0,54
3,8,21,14,11,0,0,0,0,57
3,8,21,14,11,5,4,0,0,66
3,8,21,14,11,8,5,1,4,75
3,8,21,14,11,25,0,0,0,82
3,8,21,14,11,9,5,18,0,89
3,8,21,14,11,9,5,19,20,110
3,8,21,14,11,9,12,25,0,103
3,8,21,14,11,9,14,7,0,87
3,8,21,14,11,19,0,0,0,76
3,8,21,14,14,5,18,0,0,83
3,8,21,14,14,9,1,0,0,70
3,8,21,14,20,5,18,0,0,89
3,8,21,14,20,5,18,5,4,98
3,8,21,14,20,5,18,19,0,108
3,8,21,16,1,11,0,0,0,60
3,8,21,16,1,20,20,9,0,98
3,8,21,16,1,20,20,25,0,114
3,8,21,16,15,14,0,0,0,77
3,8,21,16,16,1,8,0,0,73
3,8,21,16,16,1,8,19,0,92
3,8,21,16,16,15,20,8,0,107
3,8,21,16,18,1,19,19,9,114
3,8,21,16,18,1,19,19,25,130
3,8,21,18,1,4,1,0,0,56
3,8,21,18,3,8,4,15,13,93
3,8,21,18,3,8,5,4,0,70
3,8,21,18,3,8,5,19,0,85
3,8,21,18,3,8,6,21,12,100
3,8,21,18,3,8,7,15,0,83
3,8,21,18,3,8,25,0,0,86
3,8,21,18,3,8,9,5,18,93
3,8,21,18,3,8,9,14,7,91
3,8,21,18,3,8,9,19,8,97
3,8,21,18,3,8,9,19,13,102
3,8,21,18,3,8,9,20,5,95
3,8,21,18,3,8,12,5,20,98
3,8,21,18,3,8,12,25,0,98
3,8,21,18,3,8,13,5,14,93
3,8,21,18,3,8,23,1,25,110
3,8,21,18,5,12,0,0,0,67
3,8,21,18,9,4,1,18,19,101
3,8,21,18,9,14,7,1,0,81
3,8,21,18,9,14,7,1,19,100
3,8,21,18,12,0,0,0,0,62
3,8,21,18,12,5,4,0,0,71
3,8,21,18,12,8,15,15,4,104
3,8,21,18,12,25,0,0,0,87
3,8,21,18,12,9,5,18,0,94
3,8,21,18,12,9,5,19,20,115
3,8,21,18,12,9,19,8,0,98
3,8,21,18,12,19,0,0,0,81
3,8,21,18,13,0,0,0,0,63
3,8,21,18,14,0,0,0,0,64
3,8,21,18,14,1,2,12,5,84
3,8,21,18,14,5,4,0,0,73
3,8,21,18,14,5,18,0,0,87
3,8,21,18,14,5,18,19,0,106
3,8,21,18,14,6,21,12,0,103
3,8,21,18,14,9,14,7,0,94
3,8,21,18,14,9,14,7,19,113
3,8,21,18,14,13,9,12,11,109
3,8,21,18,14,19,0,0,0,83
3,8,21,18,18,0,0,0,0,68
3,8,21,18,18,1,19,3,15,106
3,8,21,18,18,5,4,0,0,77
3,8,21,18,18,9,14,7,0,98
3,8,21,18,18,9,16,0,0,93
3,8,21,18,18,15,0,0,0,83
3,8,21,18,18,19,0,0,0,87
3,8,21,18,18,21,3,11,0,103
3,8,21,18,18,21,19,0,0,108
3,8,21,18,18,23,15,18,13,137
3,8,21,19,5,0,0,0,0,56
3,8,21,19,5,18,0,0,0,74
3,8,21,19,9,20,5,0,0,85
3,8,21,20,0,0,0,0,0,52
3,8,21,20,5,4,0,0,0,61
3,8,21,20,5,18,0,0,0,75
3,8,21,20,5,19,0,0,0,76
3,8,21,20,9,14,7,0,0,82
3,8,21,20,9,19,20,0,0,100
3,8,21,20,9,19,20,19,0,119
3,8,21,20,14,5,5,0,0,76
3,8,21,20,14,5,5,19,0,95
3,8,21,20,14,5,25,0,0,96
3,8,21,20,14,5,25,19,0,115
3,8,21,20,20,9,5,0,0,86
3,8,21,20,26,16,1,0,0,95
3,8,21,20,26,16,1,8,0,103
3,8,21,20,26,16,1,8,19,122
3,8,21,20,26,16,1,19,0,114
3,8,21,21,13,14,1,16,13,110
3,8,21,22,1,19,8,5,19,106
3,8,21,26,23,9,0,0,0,90
3,8,23,1,19,0,0,0,0,54
3,9,2,1,18,9,1,0,0,43
3,9,2,1,18,9,1,12,0,55
3,9,2,1,18,9,1,14,0,57
3,9,2,1,18,9,5,19,0,66
3,9,2,1,18,9,15,21,19,97
3,9,2,1,18,9,21,13,0,76
3,9,2,1,20,9,15,14,0,73
3,9,2,2,1,18,9,1,0,45
3,9,2,2,15,18,9,1,0,59
3,25,2,5,18,14,1,20,5,93
3,25,2,5,18,14,9,15,14,105
3,9,2,15,12,0,0,0,0,41
3,9,2,15,12,5,18,15,0,79
3,9,2,15,12,19,0,0,0,60
3,25,2,15,18,7,0,0,0,70
3,25,2,15,18,7,19,0,0,89
3,9,2,15,18,25,0,0,0,72
3,9,2,15,18,9,1,0,0,57
3,9,2,15,18,9,21,13,0,90
3,9,2,15,21,12,5,0,0,67
3,9,2,15,21,12,5,19,0,86
3,25,3,0,0,0,0,0,0,31
3,9,3,1,4,0,0,0,0,20
3,25,3,1,4,0,0,0,0,36
3,9,3,1,4,1,0,0,0,21
3,9,3,1,4,1,5,0,0,26
3,9,3,1,4,1,19,0,0,40
3,25,3,1,4,5,1,14,0,56
3,25,3,1,4,5,15,9,4,69
3,25,3,1,4,5,15,21,19,96
3,9,3,1,4,9,4,0,0,33
3,25,3,1,4,9,20,5,0,70
3,25,3,1,4,12,9,11,5,73
3,25,3,1,4,19,0,0,0,55
3,9,3,1,12,1,0,0,0,29
3,9,3,1,12,1,19,0,0,48
3,9,3,1,12,5,0,0,0,33
3,25,3,1,19,5,19,0,0,75
3,25,3,1,19,9,14,0,0,74
3,25,3,1,19,9,14,19,0,93
3,9,3,1,20,18,9,3,5,71
3,9,3,1,20,18,9,19,5,87
3,9,3,1,20,18,9,24,0,87
3,9,3,1,20,18,9,26,5,94
3,9,3,1,20,18,15,19,5,93
3,9,3,5,12,9,5,19,0,65
3,9,3,5,18,0,0,0,0,38
3,9,3,5,18,15,14,5,0,72
3,9,3,5,18,15,14,5,19,91
3,9,3,5,18,15,14,9,0,76
3,9,3,5,18,15,19,0,0,72
3,9,3,8,1,18,0,0,0,42
3,9,3,8,12,9,4,0,0,48
3,9,3,8,12,9,4,19,0,67
3,9,3,8,12,15,9,4,0,63
3,9,3,9,19,2,5,9,0,59
3,9,3,9,19,2,5,15,0,65
3,25,3,12,0,0,0,0,0,43
3,25,3,12,1,13,1,20,5,83
3,25,3,12,1,13,5,14,0,76
3,25,3,12,1,13,5,14,19,95
3,25,3,12,1,13,9,14,0,80
3,25,3,12,1,13,9,14,5,85
3,25,3,12,1,14,5,0,0,63
3,25,3,12,1,18,0,0,0,62
3,25,3,12,1,19,0,0,0,63
3,25,3,12,1,19,5,0,0,68
3,25,3,12,1,19,5,19,0,87
3,9,3,12,1,20,15,21,14,98
3,25,3,12,5,0,0,0,0,48
3,25,3,12,5,3,1,18,0,70
3,25,3,12,5,3,1,18,19,89
3,25,3,12,5,4,0,0,0,52
3,25,3,12,5,4,15,13,0,80
3,25,3,12,5,14,5,0,0,67
3,25,3,12,5,18,0,0,0,66
3,25,3,12,5,18,25,0,0,91
3,25,3,12,5,18,19,0,0,85
3,25,3,12,5,19,0,0,0,67
3,25,3,12,9,1,14,0,0,67
3,25,3,12,9,3,0,0,0,55
3,25,3,12,9,3,1,12,0,68
3,25,3,12,9,3,9,19,13,96
3,25,3,12,9,3,9,20,25,109
3,25,3,12,9,3,12,25,0,92
3,25,3,12,9,4,5,0,0,61
3,25,3,12,9,14,7,0,0,73
3,25,3,12,9,14,7,19,0,92
3,25,3,12,9,19,13,0,0,84
3,25,3,12,9,19,20,0,0,91
3,25,3,12,9,19,20,9,3,103
3,25,3,12,9,19,20,19,0,110
3,25,3,12,9,20,9,3,0,84
3,25,3,12,9,20,9,19,0,100
3,25,3,12,9,20,15,12,0,99
3,25,3,12,9,20,15,12,19,118
3,25,3,12,9,26,5,0,0,83
3,25,3,12,9,26,5,4,0,87
3,25,3,12,9,26,5,19,0,102
3,25,3,12,9,26,9,14,7,108
3,25,3,12,15,0,0,0,0,58
3,25,3,12,15,4,5,0,0,67
3,25,3,12,15,7,18,1,13,97
3,25,3,12,15,9,4,0,0,71
3,25,3,12,15,9,4,1,12,84
3,25,3,12,15,9,4,19,0,90
3,25,3,12,15,12,9,20,8,107
3,25,3,12,15,14,1,12,0,85
3,25,3,12,15,14,5,0,0,77
3,25,3,12,15,14,5,19,0,96
3,25,3,12,15,14,9,3,0,84
3,25,3,12,15,14,9,19,20,120
3,25,3,12,15,14,9,20,5,106
3,25,3,12,15,16,0,0,0,74
3,25,3,12,15,16,5,0,0,79
3,25,3,12,15,16,25,0,0,99
3,25,3,12,15,16,9,1,0,84
3,25,3,12,15,16,9,19,13,115
3,25,3,12,15,16,9,20,5,108
3,25,3,12,15,16,15,9,4,102
3,25,3,12,15,18,1,13,1,91
3,25,3,12,15,19,0,0,0,77
3,25,3,12,15,19,5,0,0,82
3,25,3,12,15,19,5,19,0,101
3,25,3,12,15,19,9,19,0,105
3,25,3,12,15,20,8,5,13,104
3,25,3,12,15,20,15,13,5,111
3,25,3,12,15,20,15,13,25,131
3,25,3,12,15,20,18,15,14,125
3,25,3,12,21,19,0,0,0,83
3,9,3,15,14,5,0,0,0,49
3,9,3,15,14,9,1,14,0,68
3,9,3,15,14,9,9,4,0,66
3,9,3,15,14,9,14,5,0,72
3,9,3,15,14,9,15,9,4,81
3,9,3,15,18,5,5,0,0,58
3,9,3,15,18,5,5,19,0,77
3,9,3,21,18,1,20,5,0,80
3,9,3,21,20,15,24,9,14,118
3,9,4,1,12,0,0,0,0,29
3,9,4,1,18,9,4,0,0,48
3,9,4,1,18,9,19,0,0,63
3,9,4,5,0,0,0,0,0,21
3,9,4,5,18,0,0,0,0,39
3,25,4,5,18,0,0,0,0,55
3,9,4,5,18,9,19,8,0,75
3,9,4,5,18,9,19,20,0,87
3,9,4,5,18,11,9,14,0,73
3,9,4,5,18,12,9,11,5,76
3,9,4,5,18,19,0,0,0,58
3,25,4,5,18,19,0,0,0,74
3,25,4,9,16,16,9,1,14,97
3,25,4,9,16,16,9,4,0,86
3,25,4,15,14,0,0,0,0,61
3,25,4,15,14,9,21,13,0,104
3,9,5,14,1,7,1,0,0,40
3,9,5,14,5,7,1,0,0,44
3,9,5,18,7,5,0,0,0,47
3,9,5,18,26,15,0,0,0,76
3,9,5,18,26,15,19,0,0,95
3,25,5,19,5,19,0,0,0,76
3,25,5,19,9,19,0,0,0,80
3,25,5,20,9,3,0,0,0,65
3,9,7,0,0,0,0,0,0,19
3,9,7,1,12,1,0,0,0,33
3,9,7,1,12,5,0,0,0,37
3,9,7,1,18,0,0,0,0,38
3,9,7,1,18,5,20,0,0,63
3,9,7,1,18,5,20,19,0,82
3,9,7,1,18,5,20,20,5,88
3,9,7,1,18,6,9,19,8,80
3,9,7,1,18,9,12,12,15,86
3,9,7,1,18,9,20,15,0,82
3,9,7,1,18,9,20,15,19,101
3,9,7,1,18,12,5,19,19,93
3,9,7,1,18,19,0,0,0,57
3,25,7,14,5,15,21,19,0,109
3,25,7,14,5,20,19,0,0,93
3,25,7,14,9,14,5,0,0,77
3,9,7,21,1,0,0,0,0,41
3,9,7,21,1,20,5,18,1,85
3,25,11,5,0,0,0,0,0,44
3,25,12,0,0,0,0,0,0,40
3,9,12,1,14,20,18,15,0,92
3,9,12,1,14,20,18,15,19,111
3,9,12,5,3,20,15,13,25,105
3,9,12,5,18,25,0,0,0,72
3,9,12,9,1,0,0,0,0,34
3,9,12,9,1,18,25,0,0,77
3,9,12,9,1,20,5,0,0,59
3,9,12,9,1,20,5,4,0,63
3,9,12,9,1,20,5,12,25,96
3,9,12,9,1,20,5,19,0,78
3,9,12,9,1,20,9,15,14,92
3,9,12,9,3,5,0,0,0,41
3,9,12,9,3,5,19,0,0,60
3,25,12,9,3,5,19,0,0,76
3,9,12,9,3,9,15,21,19,100
3,9,12,9,5,12,12,1,0,63
3,9,12,9,6,15,18,13,0,85
3,9,12,9,9,6,15,18,13,94
3,9,12,9,9,21,13,0,0,76
3,25,12,9,14,4,5,18,0,90
3,25,12,9,14,4,5,18,19,109
3,25,12,9,14,4,18,9,3,97
3,9,12,9,15,12,1,0,0,61
3,9,12,9,15,12,1,20,5,86
3,9,12,9,15,12,21,13,0,94
3,9,12,9,15,20,15,13,25,121
3,9,12,9,21,13,0,0,0,67
3,25,12,9,24,0,0,0,0,73
3,9,12,12,0,0,0,0,0,36
3,25,12,12,15,19,5,19,0,110
3,9,12,12,15,19,9,19,0,98
3,25,12,12,15,19,9,19,0,114
3,25,13,1,5,0,0,0,0,47
3,25,13,1,7,18,1,16,8,92
3,9,13,1,9,19,5,0,0,59
3,25,13,1,9,19,5,0,0,75
3,25,13,1,16,8,5,14,0,85
3,25,13,1,16,8,25,20,5,116
3,25,13,1,18,0,0,0,0,60
3,25,13,1,18,9,14,0,0,83
3,9,13,1,18,15,15,14,0,88
3,25,13,1,18,15,19,5,0,99
3,25,13,1,18,19,0,0,0,79
3,25,13,1,19,0,0,0,0,61
3,25,13,1,20,9,1,0,0,72
3,25,13,1,20,9,15,14,0,100
3,25,13,1,20,9,21,13,0,105
3,25,13,2,1,0,0,0,0,44
3,9,13,2,1,12,0,0,0,40
3,25,13,2,1,12,0,0,0,56
3,25,13,2,1,12,5,4,0,65
3,25,13,2,1,12,5,5,18,84
3,25,13,2,1,12,5,18,0,79
3,25,13,2,1,12,5,18,19,98
3,25,13,2,1,12,9,14,5,84
3,25,13,2,1,12,9,19,20,104
3,25,13,2,1,12,12,5,4,77
3,25,13,2,1,12,15,0,0,71
3,9,13,2,1,12,15,13,0,68
3,25,13,2,1,12,15,13,0,84
3,9,13,2,1,12,15,13,19,87
3,25,13,2,1,12,15,14,0,85
3,25,13,2,1,12,19,0,0,75
3,25,13,2,1,20,5,0,0,69
3,25,13,2,5,12,0,0,0,60
3,9,13,2,9,1,0,0,0,37
3,25,13,2,9,4,0,0,0,56
3,25,13,2,9,4,9,1,0,66
3,25,13,2,9,4,9,21,13,99
3,25,13,2,9,6,15,18,13,104
3,25,13,2,12,9,14,0,0,78
3,25,13,2,12,9,14,7,0,85
3,25,13,2,12,9,14,7,19,104
3,9,13,2,15,18,9,15,0,84
3,25,13,5,0,0,0,0,0,46
3,25,13,5,12,5,20,0,0,83
3,9,13,5,12,9,1,0,0,52
3,9,13,5,12,9,21,13,0,85
3,25,13,5,14,5,0,0,0,65
3,25,13,5,14,5,19,0,0,84
3,25,13,5,19,0,0,0,0,65
3,9,13,5,20,5,18,0,0,73
3,9,13,5,24,0,0,0,0,54
3,9,13,9,3,5,19,0,0,61
3,9,13,9,3,9,4,0,0,50
3,9,13,9,3,9,4,5,0,55
3,9,13,9,3,15,9,4,0,65
3,9,13,9,5,18,0,0,0,57
3,9,13,9,14,9,20,5,0,82
3,25,13,12,9,14,0,0,0,76
3,9,13,12,9,14,5,0,0,65
3,25,13,12,9,14,7,0,0,83
3,25,13,12,9,14,7,19,0,102
3,25,13,12,9,14,19,0,0,95
3,9,13,13,1,18,15,14,0,86
3,9,13,14,5,12,0,0,0,56
3,25,13,15,7,5,14,5,0,87
3,25,13,15,7,5,14,5,19,106
3,25,13,15,7,18,1,16,8,106
3,25,13,15,9,4,0,0,0,69
3,25,13,15,12,0,0,0,0,68
3,9,13,15,12,9,20,5,0,86
3,25,13,15,12,19,0,0,0,87
3,25,13,15,13,5,20,5,18,117
3,25,13,15,16,8,1,14,5,100
3,25,13,15,19,3,15,16,5,114
3,25,13,15,19,5,0,0,0,80
3,25,13,15,19,5,12,25,0,117
3,25,13,15,21,19,0,0,0,96
3,25,13,18,9,20,5,0,0,93
3,25,13,20,9,1,0,0,0,71
3,25,13,21,12,5,0,0,0,79
3,25,13,21,12,15,19,5,0,113
3,25,14,1,14,3,8,5,0,73
3,25,14,1,18,5,15,21,19,121
3,25,14,1,18,15,9,4,0,89
3,9,14,3,8,0,0,0,0,37
3,9,14,3,8,1,0,0,0,38
3,9,14,3,8,5,4,0,0,46
3,9,14,3,8,5,18,0,0,60
3,9,14,3,8,5,19,0,0,61
3,9,14,3,8,9,14,7,0,67
3,9,14,3,8,15,14,1,19,86
3,9,14,3,8,15,14,9,1,76
3,9,14,3,8,15,14,9,3,78
3,9,14,3,8,15,14,9,14,89
3,9,14,3,9,14,14,1,12,79
3,9,14,3,9,14,14,9,0,75
3,9,14,3,9,14,14,21,19,106
3,9,14,3,12,9,4,5,19,78
3,9,14,3,12,9,19,0,0,69
3,9,14,3,20,0,0,0,0,49
3,9,14,3,20,21,18,5,0,93
3,9,14,3,20,21,18,5,4,97
3,9,14,3,20,21,18,5,19,112
3,9,14,4,5,18,0,0,0,53
3,9,14,4,5,18,5,4,0,62
3,9,14,4,5,18,25,0,0,78
3,9,14,4,5,18,9,14,7,83
3,9,14,4,5,18,13,1,14,81
3,9,14,4,5,18,15,21,19,108
3,9,14,4,5,18,19,0,0,72
3,9,14,5,0,0,0,0,0,31
3,9,14,5,1,19,20,0,0,71
3,9,14,5,1,19,20,5,0,76
3,9,14,5,1,19,20,5,19,95
3,9,14,5,1,19,20,19,0,90
3,25,14,5,2,15,20,0,0,84
3,9,14,5,6,9,12,13,0,71
3,25,14,5,7,5,20,9,3,91
3,25,14,5,7,9,12,4,0,79
3,9,14,5,12,0,0,0,0,43
3,9,14,5,13,1,0,0,0,45
3,9,14,5,13,1,19,0,0,64
3,9,14,5,13,1,20,9,3,77
3,9,14,5,13,5,19,5,0,73
3,9,14,5,13,9,26,5,0,84
3,9,14,5,14,3,8,25,13,94
3,9,14,5,14,5,0,0,0,50
3,9,14,5,15,12,0,0,0,58
3,9,14,5,15,12,5,0,0,63
3,9,14,5,15,12,5,19,0,82
3,9,14,5,15,12,9,3,0,70
3,9,14,5,15,12,19,0,0,77
3,9,14,5,16,8,15,14,5,89
3,9,14,5,18,1,18,25,0,93
3,9,14,5,18,1,20,15,18,103
3,9,14,5,18,5,1,0,0,55
3,9,14,5,18,5,1,12,0,67
3,9,14,5,18,5,15,21,19,109
3,9,14,5,18,9,14,0,0,72
3,9,14,5,18,9,14,19,0,91
3,9,14,5,18,15,21,19,0,104
3,9,14,5,19,0,0,0,0,50
3,9,14,7,12,5,0,0,0,50
3,9,14,7,21,12,1,0,0,67
3,9,14,7,21,12,1,18,0,85
3,9,14,7,21,12,1,20,5,92
3,9,14,7,21,12,21,13,0,100
3,25,14,8,25,5,14,1,0,95
3,25,14,9,1,20,18,9,1,100
3,25,14,9,3,1,12,12,25,104
3,25,14,9,3,9,19,13,19,114
3,25,14,9,3,9,19,20,0,102
3,25,14,9,3,19,0,0,0,73
3,9,14,9,16,8,5,19,0,83
3,25,14,9,16,9,4,0,0,80
3,25,14,9,16,15,9,4,0,95
3,25,14,9,19,13,0,0,0,83
3,9,14,14,1,2,1,18,0,62
3,9,14,14,1,2,1,18,19,81
3,9,14,14,1,13,1,12,0,67
3,9,14,14,1,13,1,20,5,80
3,9,14,14,1,13,5,9,14,82
3,9,14,14,1,13,5,14,5,78
3,9,14,14,1,13,9,3,0,66
3,9,14,14,1,13,25,12,0,91
3,9,14,14,1,13,25,12,19,110
3,9,14,14,1,13,15,25,12,106
3,9,14,14,1,13,15,12,0,81
3,9,14,14,1,13,15,14,19,102
3,9,14,14,25,12,0,0,0,77
3,9,14,14,15,12,9,14,0,90
3,9,14,14,15,12,9,14,5,95
3,25,14,15,3,12,5,16,20,113
3,25,14,15,4,15,14,20,0,110
3,9,14,15,6,15,9,12,0,83
3,25,14,15,9,4,0,0,0,70
3,25,14,15,12,15,7,25,0,116
3,25,14,15,16,8,9,12,5,107
3,25,14,15,16,8,15,2,5,103
3,25,14,15,19,21,18,1,12,128
3,25,14,15,19,21,18,5,0,120
3,25,14,15,19,21,18,5,19,139
3,9,14,17,21,1,9,14,0,88
3,9,14,17,21,1,9,14,19,107
3,9,14,17,21,5,0,0,0,69
3,9,14,17,21,5,4,5,1,79
3,9,14,17,21,5,19,0,0,88
3,9,14,20,5,18,0,0,0,69
3,9,14,20,18,5,0,0,0,69
3,9,14,21,18,1,14,0,0,80
3,9,14,21,18,15,21,19,0,120
3,9,15,14,0,0,0,0,0,41
3,9,15,14,9,20,9,19,0,98
3,9,15,14,15,20,15,13,5,109
3,9,15,14,15,20,15,13,25,129
3,9,15,14,19,0,0,0,0,60
3,9,15,16,16,9,14,15,0,97
3,9,15,16,16,9,14,15,19,116
3,25,16,0,0,0,0,0,0,44
3,9,16,1,25,5,0,0,0,59
3,25,16,8,5,12,12,1,0,82
3,25,16,8,5,12,12,1,5,87
3,9,16,8,5,18,0,0,0,59
3,25,16,8,5,18,0,0,0,75
3,9,16,8,5,18,4,15,13,91
3,9,16,8,5,18,5,4,0,68
3,25,16,8,5,18,5,4,0,84
3,9,16,8,5,18,5,18,0,82
3,9,16,8,5,18,9,14,7,89
3,25,16,8,5,18,9,14,7,105
3,9,16,8,5,18,19,0,0,78
3,25,16,8,5,18,19,0,0,94
3,9,16,8,15,14,25,0,0,90
3,9,16,8,15,14,9,5,19,98
3,25,16,8,15,14,9,19,13,122
3,25,16,8,15,19,9,19,0,114
3,9,16,15,0,0,0,0,0,43
3,9,16,15,12,9,14,0,0,78
3,9,16,15,12,9,14,19,0,97
3,9,16,15,12,12,9,14,15,105
3,9,16,16,9,0,0,0,0,53
3,9,16,16,21,19,0,0,0,84
3,25,16,18,1,5,9,4,0,81
3,25,16,18,1,5,15,9,4,96
3,25,16,18,5,0,0,0,0,67
3,25,16,18,5,19,0,0,0,86
3,25,16,18,5,19,5,19,0,110
3,25,16,18,5,19,19,0,0,105
3,25,16,18,5,19,19,5,4,114
3,25,16,18,5,19,19,5,19,129
3,25,16,18,9,1,14,19,0,105
3,25,16,18,9,4,0,0,0,75
3,25,16,18,9,14,5,0,0,90
3,25,16,18,9,14,9,4,0,98
3,25,16,18,9,14,9,4,19,117
3,25,16,18,9,14,9,14,0,108
3,25,16,18,9,14,9,14,5,113
3,25,16,18,9,14,15,9,4,113
3,25,16,18,9,15,20,5,19,130
3,25,16,18,9,15,20,19,0,125
3,25,16,18,21,19,5,19,0,126
3,25,16,19,5,12,1,0,0,81
3,25,16,19,5,12,1,5,0,86
3,25,16,19,5,12,9,14,5,108
3,25,16,19,5,12,15,9,4,108
3,25,16,19,5,12,15,21,19,135
3,25,16,20,15,26,15,9,3,132
3,9,18,0,0,0,0,0,0,30
3,9,18,3,0,0,0,0,0,33
3,9,18,3,1,4,9,1,14,62
3,9,18,3,1,18,0,0,0,52
3,9,18,3,9,14,1,12,0,69
3,9,18,3,9,14,1,20,5,82
3,9,18,3,9,20,5,18,0,85
3,9,18,3,12,5,0,0,0,50
3,9,18,3,12,5,4,0,0,54
3,9,18,3,12,5,18,0,0,68
3,9,18,3,12,5,18,19,0,87
3,9,18,3,12,5,19,0,0,69
3,9,18,3,12,5,20,0,0,70
3,9,18,3,12,5,20,19,0,89
3,9,18,3,12,9,14,5,0,73
3,9,18,3,12,9,14,7,0,75
3,9,18,3,15,3,5,12,5,73
3,9,18,3,19,0,0,0,0,52
3,9,18,3,21,5,0,0,0,59
3,9,18,3,21,9,20,0,0,83
3,9,18,3,21,9,20,1,12,96
3,9,18,3,21,9,20,5,4,92
3,9,18,3,21,9,20,5,18,106
3,9,18,3,21,9,20,25,0,108
3,9,18,3,21,9,20,15,18,116
3,9,18,3,21,9,20,18,25,126
3,9,18,3,21,9,20,19,0,102
3,9,18,3,21,12,1,14,20,101
3,9,18,3,21,12,1,18,0,85
3,9,18,3,21,12,1,18,19,104
3,9,18,3,21,12,1,20,5,92
3,9,18,3,21,12,5,0,0,71
3,9,18,3,21,12,5,20,0,91
3,9,18,3,21,12,9,0,0,75
3,9,18,3,21,12,9,14,0,89
3,9,18,3,21,12,21,19,0,106
3,9,18,3,21,13,0,0,0,67
3,9,18,3,21,13,6,5,18,96
3,9,18,3,21,19,0,0,0,73
3,9,18,3,21,19,5,19,0,97
3,9,18,3,21,19,25,0,0,98
3,9,18,3,21,20,0,0,0,74
3,9,18,3,21,20,5,4,0,83
3,9,18,3,21,20,9,14,7,104
3,9,18,3,21,20,19,0,0,93
3,9,18,5,0,0,0,0,0,35
3,9,18,5,19,0,0,0,0,54
3,9,18,12,0,0,0,0,0,42
3,9,18,17,21,5,0,0,0,73
3,9,18,17,21,5,19,0,0,92
3,9,18,18,1,20,5,0,0,74
3,9,18,18,1,20,5,4,0,78
3,9,18,18,8,15,16,15,4,106
3,9,18,18,8,15,19,5,0,95
3,9,18,18,8,15,19,5,4,99
3,9,18,18,8,15,19,5,19,114
3,9,18,18,8,15,19,9,19,118
3,9,18,18,8,15,20,9,3,103
3,9,18,18,8,15,21,19,0,111
3,9,18,18,8,21,19,0,0,96
3,9,18,18,9,6,15,18,13,109
3,9,18,18,9,16,5,4,0,82
3,9,18,18,9,16,5,4,5,87
3,9,18,18,9,16,5,4,19,101
3,9,18,18,15,12,9,20,5,109
3,9,18,18,15,19,5,0,0,87
3,9,18,18,15,19,5,12,25,124
3,9,18,18,15,21,19,0,0,103
3,9,18,18,21,19,0,0,0,88
3,9,18,19,15,3,5,12,5,89
3,9,18,19,15,9,4,0,0,77
3,9,18,19,15,20,15,13,5,117
3,9,18,19,15,20,15,13,25,137
3,9,18,20,5,18,9,15,14,111
3,25,18,20,15,12,9,20,5,127
3,25,18,20,15,16,9,1,0,107
3,25,18,20,15,19,9,19,0,128
3,9,18,21,5,12,1,0,0,69
3,9,18,21,18,7,9,1,14,100
3,9,18,21,19,5,19,0,0,94
3,9,19,1,14,4,9,14,5,78
3,9,19,3,15,5,19,0,0,73
3,9,19,3,15,19,0,0,0,68
3,9,19,5,0,0,0,0,0,36
3,9,19,5,1,21,24,0,0,82
3,9,19,5,12,5,0,0,0,53
3,9,19,5,12,5,21,18,0,92
3,9,19,5,12,5,21,18,19,111
3,9,19,5,12,21,18,5,0,92
3,9,19,5,12,21,18,5,19,111
3,9,19,9,14,7,0,0,0,61
3,9,19,9,21,13,0,0,0,74
3,9,19,10,21,18,1,14,5,100
3,9,19,12,21,14,1,18,0,97
3,9,19,13,1,18,9,14,5,91
3,9,19,16,1,4,1,14,5,72
3,9,19,19,9,5,19,0,0,83
3,9,19,19,9,14,7,0,0,80
3,9,19,19,15,9,4,0,0,78
3,9,19,19,15,9,4,1,12,91
3,9,19,19,15,9,4,19,0,97
3,9,19,20,0,0,0,0,0,51
3,25,19,20,0,0,0,0,0,67
3,9,19,20,1,0,0,0,0,52
3,9,19,20,1,5,0,0,0,57
3,25,19,20,1,12,0,0,0,80
3,25,19,20,1,12,7,9,1,97
3,25,19,20,1,13,9,14,5,109
3,25,19,20,1,19,20,5,18,130
3,9,19,20,5,4,0,0,0,60
3,25,19,20,5,4,0,0,0,76
3,25,19,20,5,9,14,0,0,95
3,25,19,20,5,9,14,5,0,100
3,25,19,20,5,9,14,5,19,119
3,25,19,20,5,9,14,9,3,107
3,25,19,20,5,9,14,19,0,114
3,9,19,20,5,18,14,0,0,88
3,9,19,20,5,18,14,1,0,89
3,9,19,20,5,18,14,1,5,94
3,9,19,20,5,18,14,1,12,101
3,9,19,20,5,18,14,19,0,107
3,9,19,20,9,3,0,0,0,63
3,25,19,20,9,3,0,0,0,79
3,25,19,20,9,3,12,5,0,96
3,25,19,20,9,4,0,0,0,80
3,25,19,20,9,4,5,1,14,100
3,25,19,20,9,4,9,1,0,90
3,25,19,20,9,4,9,21,13,123
3,25,19,20,9,6,15,18,13,128
3,25,19,20,9,14,0,0,0,90
3,25,19,20,9,14,5,0,0,95
3,25,19,20,9,14,5,19,0,114
3,25,19,20,9,19,0,0,0,95
3,25,19,20,9,20,9,19,0,124
3,25,19,20,9,20,15,13,5,129
3,25,19,20,15,3,1,18,16,120
3,25,19,20,15,3,5,12,5,107
3,25,19,20,15,3,25,20,5,135
3,25,19,20,15,7,18,1,13,121
3,25,19,20,15,9,4,0,0,95
3,25,19,20,15,9,4,19,0,114
3,25,19,20,15,12,9,20,8,131
3,25,19,20,15,13,1,0,0,96
3,25,19,20,15,13,1,19,0,115
3,25,19,20,15,13,1,20,1,117
3,9,19,20,15,18,9,0,0,93
3,25,19,20,15,19,5,0,0,106
3,25,19,20,15,20,15,13,5,135
3,25,19,20,15,20,15,13,25,155
3,25,19,20,15,21,19,0,0,122
3,9,19,20,18,15,14,0,0,98
3,9,19,20,18,15,14,9,3,110
3,9,19,20,18,15,14,19,0,117
3,9,19,20,19,0,0,0,0,70
3,25,19,20,19,0,0,0,0,86
3,9,19,20,21,19,5,19,0,115
3,9,19,20,22,1,5,14,0,93
3,9,20,1,2,12,5,0,0,52
3,9,20,1,4,5,12,0,0,54
3,9,20,1,4,5,12,19,0,73
3,9,20,1,12,0,0,0,0,45
3,25,20,1,19,5,0,0,0,73
3,25,20,1,19,9,3,0,0,80
3,25,20,1,19,20,5,18,0,111
3,25,20,1,19,20,5,18,19,130
3,9,20,1,20,9,15,14,19,110
3,9,20,1,20,15,18,0,0,86
3,9,20,1,20,15,18,25,0,111
3,9,20,1,20,15,18,19,0,105
3,9,20,1,20,21,13,0,0,87
3,9,20,5,0,0,0,0,0,37
3,25,20,5,0,0,0,0,0,53
3,9,20,5,1,2,12,5,0,57
3,9,20,5,4,0,0,0,0,41
3,9,20,5,5,0,0,0,0,42
3,9,20,5,18,0,0,0,0,55
3,9,20,5,18,19,0,0,0,74
3,9,20,5,19,0,0,0,0,56
3,9,20,5,19,19,0,0,0,75
3,9,20,8,1,18,1,0,0,60
3,9,20,8,1,18,1,19,0,79
3,9,20,8,1,18,9,19,20,107
3,9,20,8,5,18,0,0,0,63
3,9,20,8,5,18,14,0,0,77
3,9,20,8,5,18,14,19,0,96
3,9,20,8,5,18,19,0,0,82
3,9,20,8,18,5,14,0,0,77
3,9,20,8,18,5,14,19,0,96
3,9,20,9,3,9,19,13,0,85
3,9,20,25,3,9,19,13,0,101
3,9,20,9,3,15,18,16,0,93
3,25,20,9,4,9,14,5,0,89
3,25,20,9,4,9,14,5,19,108
3,9,20,25,4,15,13,0,0,89
3,9,20,9,5,4,0,0,0,50
3,9,20,9,5,19,0,0,0,65
3,9,20,9,6,25,0,0,0,72
3,9,20,9,6,9,5,4,0,65
3,9,20,25,6,9,5,4,0,81
3,9,20,9,6,9,5,19,0,80
3,9,20,9,6,25,9,14,7,102
3,9,20,25,6,15,12,11,0,101
3,9,20,25,6,21,12,0,0,96
3,9,20,9,7,18,1,4,5,76
3,9,20,25,9,19,8,0,0,93
3,9,20,25,12,5,19,19,0,112
3,9,20,25,12,9,11,5,0,94
3,9,20,25,14,5,19,19,0,114
3,9,20,9,14,7,0,0,0,62
3,25,20,9,15,4,5,18,13,112
3,9,20,25,19,3,1,16,5,101
3,25,20,9,19,9,14,5,0,104
3,25,20,9,20,9,19,0,0,105
3,9,20,25,23,1,18,4,0,103
3,9,20,25,23,1,18,4,19,122
3,9,20,25,23,9,4,5,0,98
3,9,20,9,26,5,14,0,0,86
3,9,20,9,26,5,14,12,25,123
3,9,20,9,26,5,14,18,25,129
3,9,20,9,26,5,14,19,0,105
3,25,20,15,2,12,1,19,20,117
3,25,20,15,3,9,4,5,0,84
3,25,20,15,3,25,19,20,0,130
3,25,20,15,3,15,3,3,9,96
3,25,20,15,4,5,0,0,0,72
3,25,20,15,4,5,18,13,0,103
3,25,20,15,7,1,13,25,0,109
3,25,20,15,7,5,14,5,0,94
3,25,20,15,7,5,14,25,0,114
3,25,20,15,7,5,14,9,3,101
3,25,20,15,9,4,0,0,0,76
3,9,20,15,25,5,14,0,0,91
3,9,20,15,25,5,14,14,5,110
3,9,20,15,25,5,14,19,0,110
3,25,20,15,11,9,14,9,14,120
3,25,20,15,12,0,0,0,0,75
3,9,20,15,12,1,0,0,0,60
3,9,20,15,12,1,19,0,0,79
3,9,20,15,12,5,0,0,0,64
3,9,20,15,12,5,18,0,0,82
3,9,20,15,12,5,18,19,0,101
3,9,20,15,12,5,19,0,0,83
3,25,20,15,12,25,13,16,8,137
3,25,20,15,12,25,19,9,14,142
3,25,20,15,12,25,19,9,19,147
3,25,20,15,12,9,19,20,0,123
3,25,20,15,12,25,20,9,3,132
3,25,20,15,12,15,7,25,0,122
3,25,20,15,12,15,7,9,3,109
3,25,20,15,13,1,0,0,0,77
3,25,20,15,13,5,0,0,0,81
3,25,20,15,13,5,18,5,0,104
3,25,20,15,13,5,20,5,18,124
3,25,20,15,14,0,0,0,0,77
3,25,20,15,14,5,0,0,0,82
3,25,20,15,14,19,0,0,0,96
3,25,20,15,16,5,14,9,1,108
3,25,20,15,16,8,1,7,25,120
3,25,20,15,16,8,9,12,0,108
3,25,20,15,16,25,7,5,0,116
3,25,20,15,16,12,1,19,13,124
3,25,20,15,16,12,1,19,20,131
3,25,20,15,16,18,15,3,20,135
3,25,20,15,19,9,14,0,0,105
3,25,20,15,19,9,14,5,0,110
3,25,20,15,19,9,14,5,19,129
3,25,20,15,19,15,12,0,0,109
3,25,20,15,19,15,12,19,0,128
3,25,20,15,19,15,13,5,0,115
3,25,20,15,19,20,0,0,0,102
3,25,20,15,19,20,15,13,5,135
3,25,20,15,20,1,24,9,19,136
3,25,20,15,20,15,24,9,3,134
3,25,20,15,20,15,24,9,14,145
3,25,20,15,22,9,18,9,14,135
3,25,20,15,26,25,13,5,0,132
3,25,20,15,26,15,1,0,0,105
3,25,20,15,26,15,9,3,0,116
3,25,20,15,26,15,15,14,0,133
3,25,20,15,26,26,15,1,0,131
3,9,20,18,1,12,0,0,0,63
3,9,20,18,1,12,19,0,0,82
3,9,20,18,1,13,9,4,5,82
3,9,20,18,1,14,7,5,0,77
3,9,20,18,1,20,5,0,0,76
3,9,20,18,1,20,5,4,0,80
3,9,20,18,1,20,5,19,0,95
3,9,20,18,5,1,14,0,0,70
3,9,20,18,5,14,5,0,0,74
3,9,20,18,5,15,21,19,0,110
3,9,20,18,9,3,0,0,0,62
3,9,20,18,9,12,0,0,0,71
3,9,20,18,9,14,0,0,0,73
3,9,20,18,9,14,5,0,0,78
3,9,20,18,9,14,5,19,0,97
3,9,20,18,9,14,9,14,0,96
3,9,20,18,9,14,9,14,19,115
3,9,20,18,9,14,15,21,19,128
3,9,20,18,9,14,19,0,0,92
3,9,20,18,15,3,15,12,1,96
3,9,20,18,15,14,1,4,5,89
3,9,20,18,15,14,9,14,0,102
3,9,20,18,15,14,9,26,5,119
3,9,20,18,15,14,19,0,0,98
3,9,20,18,15,16,20,5,14,120
3,9,20,18,15,21,19,0,0,105
3,9,20,18,21,12,0,0,0,83
3,9,20,18,21,12,12,9,14,118
3,9,20,18,21,19,5,19,0,114
3,9,20,20,5,18,14,0,0,89
3,9,20,20,5,18,14,19,0,108
3,9,20,21,1,0,0,0,0,54
3,25,20,21,12,1,0,0,0,82
3,25,20,21,12,1,5,0,0,87
3,25,21,12,0,0,0,0,0,61
3,9,22,0,0,0,0,0,0,34
3,9,22,5,0,0,0,0,0,39
3,9,22,5,20,0,0,0,0,59
3,9,22,5,20,12,9,11,5,96
3,9,22,5,20,15,14,5,0,93
3,9,22,5,20,19,0,0,0,78
3,9,22,25,0,0,0,0,0,59
3,9,22,9,3,0,0,0,0,46
3,9,22,9,3,1,12,0,0,59
3,9,22,9,3,1,12,12,25,96
3,9,22,9,3,9,19,13,0,87
3,9,22,9,3,9,19,13,19,106
3,9,22,9,3,19,0,0,0,65
3,9,22,9,5,0,0,0,0,48
3,9,22,9,5,19,0,0,0,67
3,9,22,9,12,0,0,0,0,55
3,9,22,9,12,5,0,0,0,60
3,9,22,9,12,5,18,0,0,78
3,9,22,9,12,5,19,20,0,99
3,9,22,9,12,9,1,14,0,79
3,9,22,9,12,9,1,14,19,98
3,9,22,9,12,9,19,5,0,88
3,9,22,9,12,9,19,5,4,92
3,9,22,9,12,9,19,5,18,106
3,9,22,9,12,9,19,5,19,107
3,9,22,9,12,9,19,20,0,103
3,9,22,9,12,9,20,5,0,89
3,9,22,9,12,9,20,25,0,109
3,9,22,9,12,9,26,5,0,95
3,9,22,9,12,9,26,5,4,99
3,9,22,9,12,9,26,5,5,100
3,9,22,9,12,9,26,5,18,113
3,9,22,9,12,9,26,5,19,114
3,9,22,9,12,12,25,0,0,92
3,9,22,9,12,14,5,19,19,112
3,9,22,9,19,13,0,0,0,75
3,9,22,9,19,13,19,0,0,94
3,9,22,9,20,1,19,0,0,83
3,9,22,9,20,5,0,0,0,68
3,9,22,15,18,25,0,0,0,92
3,9,22,22,25,0,0,0,0,81
3,9,22,22,9,5,19,0,0,89
3,25,23,25,4,4,0,0,0,84
3,9,23,9,5,19,0,0,0,68
3,9,24,9,9,4,0,0,0,58
3,9,26,1,18,0,0,0,0,57
3,9,26,5,0,0,0,0,0,43
3,11,23,0,0,0,0,0,0,37
3,12,5,0,0,0,0,0,0,20
3,12,5,1,3,8,0,0,0,32
3,12,5,1,4,0,0,0,0,25
3,12,5,1,4,5,4,0,0,34
3,12,5,1,4,9,14,7,0,55
3,12,5,1,13,0,0,0,0,34
3,12,5,1,13,5,18,0,0,57
3,12,5,1,14,0,0,0,0,35
3,12,5,1,14,1,2,12,5,55
3,12,5,1,14,5,4,0,0,44
3,12,5,1,14,5,18,0,0,58
3,12,5,1,14,5,18,19,0,77
3,12,5,1,14,5,19,20,0,79
3,12,5,1,14,9,14,7,0,65
3,12,5,1,14,9,14,7,19,84
3,12,5,1,14,9,19,8,0,71
3,12,5,1,14,12,25,0,0,72
3,12,5,1,14,12,9,5,18,79
3,12,5,1,14,12,9,12,25,93
3,12,5,1,14,14,5,19,19,92
3,12,5,1,14,15,21,20,0,91
3,12,5,1,14,19,0,0,0,54
3,12,5,1,14,19,5,0,0,59
3,12,5,1,14,19,5,4,0,63
3,12,5,1,14,19,5,18,0,77
3,12,5,1,14,19,5,18,19,96
3,12,5,1,14,19,5,19,0,78
3,12,5,1,14,19,9,14,7,84
3,12,5,1,14,19,11,9,14,88
3,12,5,1,14,21,16,0,0,72
3,12,5,1,14,21,16,19,0,91
3,12,5,1,18,0,0,0,0,39
3,12,5,1,18,1,2,12,5,59
3,12,5,1,18,1,7,5,0,52
3,12,5,1,18,1,14,3,5,62
3,12,5,1,18,3,15,12,5,74
3,12,5,1,18,5,4,0,0,48
3,12,5,1,18,5,18,0,0,62
3,12,5,1,18,5,18,19,0,81
3,12,5,1,18,5,19,20,0,83
3,12,5,1,18,9,14,7,0,69
3,12,5,1,18,9,14,7,19,88
3,12,5,1,18,9,19,8,0,75
3,12,5,1,18,12,25,0,0,76
3,12,5,1,18,14,5,19,19,96
3,12,5,1,18,19,0,0,0,58
3,12,5,1,18,23,1,25,0,88
3,12,5,1,18,23,5,5,4,76
3,12,5,1,18,23,9,14,7,92
3,12,5,1,20,0,0,0,0,41
3,12,5,1,20,5,4,0,0,50
3,12,5,1,20,9,14,7,0,71
3,12,5,1,20,19,0,0,0,60
3,12,5,1,22,1,2,12,5,63
3,12,5,1,22,1,7,5,0,56
3,12,5,1,22,1,7,5,19,75
3,12,5,1,22,5,4,0,0,52
3,12,5,1,22,5,6,21,12,87
3,12,5,1,22,5,18,0,0,66
3,12,5,1,22,5,18,19,0,85
3,12,5,1,22,9,14,7,0,73
3,12,5,3,8,5,0,0,0,36
3,12,5,3,8,5,5,0,0,41
3,12,5,3,8,25,0,0,0,56
3,12,5,3,11,0,0,0,0,34
3,12,5,4,0,0,0,0,0,24
3,12,5,4,4,5,0,0,0,33
3,12,5,4,7,5,0,0,0,36
3,12,5,4,7,25,0,0,0,56
3,12,5,4,15,14,9,19,13,94
3,12,5,5,0,0,0,0,0,25
3,12,5,5,3,8,0,0,0,36
3,12,5,5,11,0,0,0,0,36
3,12,5,5,11,5,4,0,0,45
3,12,5,5,11,25,0,0,0,61
3,12,5,5,11,9,14,7,0,66
3,12,5,5,11,19,0,0,0,55
3,12,5,6,19,0,0,0,0,45
3,12,5,6,20,0,0,0,0,46
3,12,5,6,20,5,4,0,0,55
3,12,5,6,20,9,14,7,0,76
3,12,5,6,20,19,0,0,0,65
3,12,5,7,0,0,0,0,0,27
3,12,5,9,4,1,7,18,1,60
3,12,5,9,4,15,9,3,0,60
3,12,5,9,20,8,18,1,12,88
3,12,5,9,20,8,18,21,13,109
3,12,5,13,1,20,9,20,5,88
3,12,5,13,5,14,20,12,25,109
3,12,5,13,13,5,4,0,0,55
3,12,5,13,13,9,14,7,0,76
3,12,5,14,3,8,0,0,0,45
3,12,5,14,3,8,5,4,0,54
3,12,5,14,3,8,5,18,0,68
3,12,5,14,3,8,5,18,19,87
3,12,5,14,3,8,5,19,0,69
3,12,5,14,3,8,9,14,7,75
3,12,5,15,9,4,0,0,0,48
3,12,5,15,13,5,19,0,0,72
3,12,5,16,0,0,0,0,0,36
3,12,5,16,5,0,0,0,0,41
3,12,5,16,5,4,0,0,0,45
3,12,5,16,5,19,0,0,0,60
3,12,5,16,9,14,7,0,0,66
3,12,5,16,19,25,4,18,1,103
3,12,5,16,20,0,0,0,0,56
3,12,5,18,5,20,5,0,0,68
3,12,5,18,7,5,19,19,0,88
3,12,5,18,7,25,0,0,0,70
3,12,5,18,7,9,5,19,0,78
3,12,5,18,7,25,13,1,14,98
3,12,5,18,7,25,13,5,14,102
3,12,5,18,7,9,15,14,0,83
3,12,5,18,9,3,0,0,0,50
3,12,5,18,9,3,1,12,0,63
3,12,5,18,9,3,1,12,19,82
3,12,5,18,9,3,1,20,5,76
3,12,5,18,9,3,9,19,13,91
3,12,5,18,9,3,9,20,25,104
3,12,5,18,9,3,19,0,0,69
3,12,5,18,9,3,21,13,0,84
3,12,5,18,9,4,0,0,0,51
3,12,5,18,9,4,19,0,0,70
3,12,5,18,9,8,5,23,0,83
3,12,5,18,9,8,5,23,19,102
3,12,5,18,9,19,25,0,0,91
3,12,5,18,9,19,9,5,19,99
3,12,5,18,11,1,7,5,0,62
3,12,5,18,11,4,15,13,0,81
3,12,5,18,11,4,15,13,19,100
3,12,5,18,11,5,4,0,0,58
3,12,5,18,11,5,18,25,0,97
3,12,5,18,11,5,19,19,0,92
3,12,5,18,11,8,15,15,4,91
3,12,5,18,11,9,14,7,0,79
3,12,5,18,11,9,19,8,0,85
3,12,5,18,11,12,5,19,19,104
3,12,5,18,11,12,25,0,0,86
3,12,5,18,11,12,9,5,18,93
3,12,5,18,11,12,9,11,5,86
3,12,5,18,11,19,0,0,0,68
3,12,5,18,11,19,8,9,16,101
3,12,5,18,14,12,25,0,0,89
3,12,5,18,15,14,15,13,25,120
3,12,5,18,19,20,15,18,25,135
3,12,5,18,21,3,8,0,0,70
3,12,5,18,21,3,8,25,0,95
3,12,5,18,21,3,8,9,3,82
3,12,5,18,21,13,0,0,0,72
3,12,5,20,3,8,0,0,0,51
3,12,5,21,3,8,0,0,0,52
3,12,5,21,11,0,0,0,0,52
3,12,5,21,11,19,0,0,0,71
3,12,5,22,5,9,20,5,0,81
3,12,5,22,5,9,20,5,19,100
3,12,5,22,5,18,0,0,0,65
3,12,5,22,5,18,5,18,0,88
3,12,5,22,5,18,5,19,20,109
3,12,5,22,5,18,9,19,8,101
3,12,5,22,5,18,12,25,0,102
3,12,5,22,9,19,0,0,0,70
3,12,5,22,9,19,5,19,0,94
3,12,5,23,0,0,0,0,0,43
3,12,5,23,5,4,0,0,0,52
3,12,5,23,9,14,7,0,0,73
3,12,5,23,19,0,0,0,0,62
3,12,9,1,3,11,0,0,0,39
3,12,9,1,14,20,8,21,19,107
3,12,9,3,8,0,0,0,0,35
3,12,9,3,8,5,0,0,0,40
3,12,9,3,8,5,4,0,0,44
3,12,9,3,8,5,19,0,0,59
3,12,9,3,11,0,0,0,0,38
3,12,9,3,11,5,4,0,0,47
3,12,9,3,11,5,18,0,0,61
3,12,9,3,11,5,18,19,0,80
3,12,9,3,11,5,20,0,0,63
3,12,9,3,11,25,0,0,0,63
3,12,9,3,11,9,14,7,0,68
3,12,9,3,11,12,5,19,19,93
3,12,9,3,11,19,0,0,0,57
3,12,9,5,14,3,25,0,0,71
3,12,9,5,14,20,0,0,0,63
3,12,9,5,14,20,1,7,5,76
3,12,9,5,14,20,1,12,0,76
3,12,9,5,14,20,5,4,0,72
3,12,9,5,14,20,5,12,5,85
3,12,9,5,14,20,18,25,0,106
3,12,9,5,14,20,19,0,0,82
3,12,25,5,18,0,0,0,0,63
3,12,25,5,18,19,0,0,0,82
3,12,25,6,1,11,5,18,0,81
3,12,25,6,1,11,9,14,7,88
3,12,9,6,6,5,4,0,0,45
3,12,9,6,6,8,1,14,7,66
3,12,9,6,6,25,0,0,0,61
3,12,9,6,6,9,5,18,0,68
3,12,9,6,6,9,5,19,20,89
3,12,9,6,6,9,14,7,0,66
3,12,9,6,6,12,5,19,19,91
3,12,9,6,6,12,5,20,0,73
3,12,9,6,6,12,9,11,5,73
3,12,9,6,6,19,0,0,0,55
3,12,9,6,6,19,9,4,5,73
3,12,9,6,6,19,13,1,14,83
3,12,9,6,6,23,5,5,4,73
3,12,9,6,20,19,0,0,0,69
3,12,9,13,1,0,0,0,0,38
3,12,9,13,1,3,20,5,18,84
3,12,9,13,1,3,20,9,3,73
3,12,9,13,1,3,21,19,0,81
3,12,9,13,1,14,20,0,0,72
3,12,9,13,1,20,1,0,0,59
3,12,9,13,1,20,1,12,0,71
3,12,9,13,1,20,5,0,0,63
3,12,9,13,1,20,5,19,0,82
3,12,9,13,1,20,8,0,0,66
3,12,9,13,1,20,9,3,0,70
3,12,9,13,1,20,9,26,5,98
3,12,9,13,1,20,21,18,5,102
3,12,9,13,1,24,0,0,0,62
3,12,9,13,1,24,5,4,0,71
3,12,9,13,1,24,5,19,0,86
3,12,9,13,1,24,9,14,7,92
3,12,9,13,2,0,0,0,0,39
3,12,9,13,2,1,2,12,5,59
3,12,9,13,2,5,4,0,0,48
3,12,9,13,2,5,18,0,0,62
3,12,9,13,2,5,18,19,0,81
3,12,9,13,2,9,14,7,0,69
3,12,9,13,2,19,0,0,0,58
3,12,9,13,5,0,0,0,0,42
3,12,9,13,5,19,0,0,0,61
3,12,9,14,0,0,0,0,0,38
3,12,9,14,1,8,0,0,0,47
3,12,9,14,1,12,0,0,0,51
3,12,9,14,1,12,12,25,0,88
3,12,9,14,1,13,5,14,0,71
3,12,9,14,1,13,9,14,1,76
3,12,9,14,3,8,0,0,0,49
3,12,9,14,3,8,5,4,0,58
3,12,9,14,3,8,5,18,0,72
3,12,9,14,3,8,5,18,19,91
3,12,9,14,3,8,5,19,0,73
3,12,9,14,3,8,9,14,7,79
3,12,9,14,5,0,0,0,0,43
3,12,9,14,5,19,0,0,0,62
3,12,9,14,7,0,0,0,0,45
3,12,9,14,7,5,4,0,0,54
3,12,9,14,7,5,18,0,0,68
3,12,9,14,7,5,18,19,0,87
3,12,9,14,7,6,9,19,8,87
3,12,9,14,7,25,0,0,0,70
3,12,9,14,7,9,5,18,0,77
3,12,9,14,7,9,5,19,20,98
3,12,9,14,7,9,14,7,0,75
3,12,9,14,7,19,0,0,0,64
3,12,9,14,9,1,0,0,0,48
3,12,9,14,9,3,0,0,0,50
3,12,9,14,9,3,1,12,0,63
3,12,9,14,9,3,9,1,14,74
3,12,9,14,9,3,9,19,20,98
3,12,9,14,9,3,19,0,0,69
3,12,9,14,9,4,0,0,0,51
3,12,9,14,9,21,13,0,0,81
3,12,9,14,11,0,0,0,0,49
3,12,9,14,11,1,14,20,0,84
3,12,9,14,11,5,4,0,0,58
3,12,9,14,11,5,18,0,0,72
3,12,9,14,11,5,18,5,4,81
3,12,9,14,11,5,18,5,18,95
3,12,9,14,11,5,18,25,0,97
3,12,9,14,11,5,18,19,0,91
3,12,9,14,11,9,14,7,0,79
3,12,9,14,11,19,0,0,0,68
3,12,9,14,11,21,13,0,0,83
3,12,9,14,15,1,24,9,19,106
3,12,9,14,15,4,15,13,5,90
3,12,9,14,15,9,4,0,0,66
3,12,9,14,15,12,15,7,25,112
3,12,9,14,15,19,20,1,20,113
3,12,9,14,15,21,19,0,0,93
3,12,9,14,17,21,1,14,20,111
3,12,9,14,20,25,0,0,0,83
3,12,9,14,20,9,14,7,0,88
3,12,9,14,20,19,0,0,0,77
3,12,9,16,0,0,0,0,0,40
3,12,9,16,2,15,1,18,4,80
3,12,25,16,5,0,0,0,0,61
3,12,25,16,5,1,12,0,0,74
3,12,25,16,5,1,20,5,0,87
3,12,25,16,5,1,20,5,4,91
3,12,9,16,5,9,0,0,0,54
3,12,25,16,5,9,0,0,0,70
3,12,25,16,5,15,12,1,0,89
3,12,25,16,5,15,12,1,18,107
3,12,25,16,5,15,12,5,0,93
3,12,9,16,5,21,19,0,0,85
3,12,25,16,5,21,19,0,0,101
3,12,9,16,16,1,2,12,5,76
3,12,9,16,16,5,4,0,0,65
3,12,9,16,16,5,18,0,0,79
3,12,9,16,16,5,18,19,0,98
3,12,9,16,16,9,5,0,0,70
3,12,9,16,16,9,14,7,0,86
3,12,9,16,16,9,14,7,19,105
3,12,9,16,19,0,0,0,0,59
3,12,9,16,19,5,0,0,0,64
3,12,9,16,19,8,5,5,20,97
3,12,9,16,19,15,13,5,0,92
3,12,9,16,20,0,0,0,0,60
3,12,9,17,21,5,0,0,0,67
3,12,9,17,21,5,4,0,0,71
3,12,9,17,21,5,4,15,13,99
3,12,9,17,21,5,25,0,0,92
3,12,9,17,21,5,9,5,18,99
3,12,9,17,21,5,19,0,0,86
3,12,9,17,21,25,0,0,0,87
3,12,9,17,21,9,5,18,0,94
3,12,9,17,21,9,5,19,20,115
3,12,9,17,21,9,14,7,0,92
3,12,9,17,21,9,19,8,0,98
3,12,9,17,21,9,19,13,0,103
3,12,9,19,5,18,5,0,0,71
3,12,25,19,5,19,0,0,0,83
3,12,25,19,9,19,0,0,0,87
3,12,25,19,13,1,0,0,0,73
3,12,25,19,13,9,1,14,0,96
3,12,25,19,13,9,3,0,0,84
3,12,25,19,19,21,19,0,0,118
3,12,25,19,20,5,18,0,0,102
3,12,25,19,20,5,18,19,0,121
3,12,9,20,0,0,0,0,0,44
3,12,9,20,3,8,0,0,0,55
3,12,9,20,5,12,12,1,0,74
3,12,9,20,5,12,12,1,18,92
3,12,9,20,5,12,12,21,13,107
3,12,9,20,5,12,12,21,19,113
3,12,9,20,5,19,0,0,0,68
3,12,9,20,8,5,0,0,0,57
3,12,9,20,8,18,1,12,0,83
3,12,9,20,9,1,0,0,0,54
3,12,9,20,9,3,0,0,0,56
3,12,9,20,9,15,14,0,0,82
3,12,9,20,15,18,1,12,0,90
3,12,9,20,15,18,9,3,0,89
3,12,9,20,15,18,9,19,0,105
3,12,9,20,15,18,9,19,13,118
3,12,9,20,20,5,18,0,0,87
3,12,9,22,0,0,0,0,0,46
3,12,9,22,1,12,0,0,0,59
3,12,9,22,5,18,0,0,0,69
3,12,9,22,5,18,19,0,0,88
3,12,9,22,9,1,19,0,0,75
3,12,9,22,9,19,0,0,0,74
3,12,9,22,9,19,5,19,0,98
3,12,9,22,21,19,0,0,0,86
3,12,11,0,0,0,0,0,0,26
3,12,15,1,3,1,0,0,0,35
3,12,15,1,3,1,5,0,0,40
3,12,15,1,3,1,12,0,0,47
3,12,15,1,3,1,19,0,0,54
3,12,15,1,3,5,1,14,0,54
3,12,15,1,3,9,14,1,12,70
3,12,15,1,3,9,20,9,19,91
3,12,15,1,11,0,0,0,0,42
3,12,15,1,11,1,7,5,0,55
3,12,15,1,11,5,4,0,0,51
3,12,15,1,11,5,4,12,25,88
3,12,15,1,11,9,14,7,0,72
3,12,15,1,11,12,5,19,19,97
3,12,15,1,11,12,5,20,0,79
3,12,15,1,11,18,15,15,13,103
3,12,15,1,11,19,0,0,0,61
3,12,15,1,11,23,9,19,5,98
3,12,15,1,13,0,0,0,0,44
3,12,15,1,13,5,14,0,0,63
3,12,15,1,13,5,18,0,0,67
3,12,15,2,2,5,18,0,0,57
3,12,15,2,2,5,18,5,4,66
3,12,15,2,2,5,18,5,18,80
3,12,15,2,2,5,18,19,0,76
3,12,15,3,8,1,14,0,0,56
3,12,15,3,8,1,18,4,0,64
3,12,15,3,8,1,18,4,19,83
3,12,15,3,8,5,0,0,0,46
3,12,15,3,8,5,18,0,0,64
3,12,15,3,8,5,19,0,0,65
3,12,15,3,8,5,20,20,5,91
3,12,15,3,11,0,0,0,0,44
3,12,15,3,11,2,9,18,4,77
3,12,15,3,11,3,1,19,5,72
3,12,15,3,11,5,4,0,0,53
3,12,15,3,11,5,18,0,0,67
3,12,15,3,11,5,18,19,0,86
3,12,15,3,11,6,1,3,5,59
3,12,15,3,11,9,14,7,0,74
3,12,15,3,11,9,14,7,19,93
3,12,15,3,11,12,5,19,19,99
3,12,15,3,11,12,9,11,5,81
3,12,15,3,11,18,15,15,13,105
3,12,15,3,11,19,0,0,0,63
3,12,15,3,11,23,9,19,5,100
3,12,15,3,11,23,15,18,11,111
3,12,15,4,0,0,0,0,0,34
3,12,15,4,4,5,4,0,0,47
3,12,15,4,4,5,18,0,0,61
3,12,15,4,4,25,0,0,0,63
3,12,15,4,4,9,5,18,0,70
3,12,15,4,4,9,5,19,20,91
3,12,15,4,4,9,12,25,0,84
3,12,15,4,4,9,14,7,0,68
3,12,15,4,4,9,19,8,0,74
3,12,15,4,8,5,1,4,0,52
3,12,15,4,12,5,20,0,0,71
3,12,15,4,12,9,11,5,0,71
3,12,15,4,16,1,20,5,0,76
3,12,15,4,16,1,20,5,4,80
3,12,15,4,16,1,20,5,19,95
3,12,15,4,16,15,12,5,0,82
3,12,15,4,16,15,12,5,19,101
3,12,15,4,16,15,12,12,0,89
3,12,15,4,16,15,12,12,19,108
3,12,15,4,19,0,0,0,0,53
3,12,15,5,19,0,0,0,0,54
3,12,15,6,0,0,0,0,0,36
3,12,15,6,6,0,0,0,0,42
3,12,15,7,0,0,0,0,0,37
3,12,15,7,4,15,7,4,15,82
3,12,15,7,7,5,4,0,0,53
3,12,15,7,7,5,18,0,0,67
3,12,15,7,7,25,0,0,0,69
3,12,15,7,7,9,5,18,0,76
3,12,15,7,7,9,5,19,20,97
3,12,15,7,7,9,12,25,0,90
3,12,15,7,7,9,14,7,0,74
3,12,15,7,8,1,4,0,0,50
3,12,15,7,8,1,21,14,0,81
3,12,15,7,8,5,1,4,0,55
3,12,15,7,12,9,11,5,0,74
3,12,15,7,13,1,11,5,18,85
3,12,15,7,19,0,0,0,0,56
3,12,15,7,23,8,5,5,12,90
3,12,15,7,23,25,14,0,0,99
3,12,15,7,23,15,15,4,0,94
3,12,15,25,0,0,0,0,0,55
3,12,15,25,5,4,0,0,0,64
3,12,15,25,5,18,0,0,0,78
3,12,15,25,9,14,7,0,0,85
3,12,15,25,9,14,7,12,25,122
3,12,15,25,12,5,19,19,0,110
3,12,15,25,13,5,14,20,0,107
3,12,15,9,14,5,0,0,0,58
3,12,15,25,14,5,0,0,0,74
3,12,15,25,19,0,0,0,0,74
3,12,15,25,19,15,13,5,0,107
3,12,15,9,19,15,14,0,0,87
3,12,15,9,19,15,14,14,0,101
3,12,15,9,19,15,14,14,5,106
3,12,15,9,19,20,5,18,0,101
3,12,15,9,19,20,5,18,19,120
3,12,15,9,19,20,18,1,12,109
3,12,15,9,20,0,0,0,0,59
3,12,15,11,5,0,0,0,0,46
3,12,15,11,25,0,0,0,0,66
3,12,15,11,9,5,19,0,0,74
3,12,15,13,2,0,0,0,0,45
3,12,15,13,2,5,14,0,0,64
3,12,15,13,16,0,0,0,0,59
3,12,15,13,16,5,4,0,0,68
3,12,15,13,16,9,14,7,0,89
3,12,15,13,16,19,0,0,0,78
3,12,15,14,0,0,0,0,0,44
3,12,15,14,1,12,0,0,0,57
3,12,15,14,1,12,12,25,0,94
3,12,15,14,5,0,0,0,0,49
3,12,15,14,5,4,0,0,0,53
3,12,15,14,5,18,0,0,0,67
3,12,15,14,5,18,19,0,0,86
3,12,15,14,5,19,0,0,0,68
3,12,15,14,7,0,0,0,0,51
3,12,15,14,9,3,0,0,0,56
3,12,15,14,9,3,9,20,25,110
3,12,15,14,9,14,7,0,0,74
3,12,15,14,9,14,7,19,0,93
3,12,15,14,9,19,13,0,0,85
3,12,15,14,9,19,13,19,0,104
3,12,15,14,11,0,0,0,0,55
3,12,15,14,11,5,4,0,0,64
3,12,15,14,11,9,14,7,0,85
3,12,15,14,11,19,0,0,0,74
3,12,15,14,15,19,0,0,0,78
3,12,15,14,19,0,0,0,0,63
3,12,15,14,21,19,0,0,0,84
3,12,15,14,21,19,5,19,0,108
3,12,15,15,6,0,0,0,0,51
3,12,15,15,16,0,0,0,0,61
3,12,15,15,20,0,0,0,0,65
3,12,15,15,20,9,5,0,0,79
3,12,15,16,0,0,0,0,0,46
3,12,15,16,16,5,4,0,0,71
3,12,15,16,16,9,14,7,0,92
3,12,15,16,19,0,0,0,0,65
3,12,15,17,21,5,0,0,0,73
3,12,15,17,21,5,19,0,0,92
3,12,15,18,1,7,5,14,0,75
3,12,15,18,9,15,4,9,4,89
3,12,15,19,1,2,12,5,0,69
3,12,15,19,5,1,2,12,5,74
3,12,15,19,5,4,0,0,0,58
3,12,15,19,5,4,15,23,14,110
3,12,15,19,5,12,25,0,0,91
3,12,15,19,5,14,0,0,0,68
3,12,15,19,5,14,5,19,19,111
3,12,15,19,5,15,21,20,0,110
3,12,15,19,5,15,21,20,19,129
3,12,15,19,5,18,0,0,0,72
3,12,15,19,5,18,19,0,0,91
3,12,15,19,5,19,0,0,0,73
3,12,15,19,5,19,20,0,0,93
3,12,15,19,5,20,0,0,0,74
3,12,15,19,5,20,5,4,0,83
3,12,15,19,5,20,6,21,12,113
3,12,15,19,5,20,9,14,7,104
3,12,15,19,5,20,19,0,0,93
3,12,15,19,5,21,16,0,0,91
3,12,15,19,5,21,16,19,0,110
3,12,15,19,5,23,9,14,7,107
3,12,15,19,8,0,0,0,0,57
3,12,15,19,9,14,7,0,0,79
3,12,15,19,9,14,7,19,0,98
3,12,15,19,9,19,8,0,0,85
3,12,15,19,11,5,25,0,0,90
3,12,15,19,11,25,0,0,0,85
3,12,15,19,21,18,5,0,0,93
3,12,15,19,21,18,5,4,0,97
3,12,15,19,21,18,5,19,0,112
3,12,15,19,21,18,9,14,7,118
3,12,15,20,0,0,0,0,0,50
3,12,15,20,2,21,18,0,0,91
3,12,15,20,5,0,0,0,0,55
3,12,15,20,8,0,0,0,0,58
3,12,15,20,8,5,0,0,0,63
3,12,15,20,8,5,4,0,0,67
3,12,15,20,8,5,19,0,0,82
3,12,15,20,8,25,0,0,0,83
3,12,15,20,8,9,5,18,0,90
3,12,15,20,8,9,5,18,19,109
3,12,15,20,8,9,6,25,0,98
3,12,15,20,8,9,14,7,0,88
3,12,15,20,8,9,14,7,19,107
3,12,15,20,8,12,9,11,5,95
3,12,15,20,8,19,0,0,0,77
3,12,15,20,19,0,0,0,0,69
3,12,15,20,20,1,7,5,0,83
3,12,15,20,20,5,4,0,0,79
3,12,15,20,20,5,18,0,0,93
3,12,15,20,20,25,0,0,0,95
3,12,15,20,20,9,14,7,0,100
3,12,15,20,21,18,5,0,0,94
3,12,15,20,21,18,5,4,0,98
3,12,15,20,21,18,5,19,0,113
3,12,15,20,21,18,9,14,7,119
3,12,15,20,23,5,5,4,0,87
3,12,15,21,0,0,0,0,0,51
3,12,15,21,4,1,7,5,0,68
3,12,15,21,4,3,1,16,0,75
3,12,15,21,4,5,4,0,0,64
3,12,15,21,4,6,21,12,0,94
3,12,15,21,4,25,0,0,0,80
3,12,15,21,4,9,5,18,0,87
3,12,15,21,4,9,5,19,20,108
3,12,15,21,4,9,12,25,0,101
3,12,15,21,4,9,14,7,0,85
3,12,15,21,4,12,1,14,4,86
3,12,15,21,4,12,5,19,19,110
3,12,15,21,4,12,5,20,0,92
3,12,15,21,4,12,5,20,19,111
3,12,15,21,4,12,9,11,5,92
3,12,15,21,4,12,9,14,7,97
3,12,15,21,4,19,8,9,16,107
3,12,15,21,4,23,1,18,4,101
3,12,15,21,5,5,0,0,0,61
3,12,15,21,7,8,19,0,0,85
3,12,15,21,18,0,0,0,0,69
3,12,15,21,18,5,4,0,0,78
3,12,15,21,18,9,14,7,0,99
3,12,15,21,18,19,0,0,0,88
3,12,15,21,20,0,0,0,0,71
3,12,15,21,20,5,4,0,0,80
3,12,15,21,20,5,18,0,0,94
3,12,15,21,20,5,18,12,25,131
3,12,15,21,20,5,18,19,0,113
3,12,15,21,20,25,0,0,0,96
3,12,15,21,20,9,14,7,0,101
3,12,15,21,20,19,0,0,0,90
3,12,15,22,5,0,0,0,0,57
3,12,15,22,5,14,0,0,0,71
3,12,15,22,5,14,5,0,0,76
3,12,15,22,5,18,5,4,0,84
3,12,15,22,5,18,25,0,0,100
3,12,15,22,5,18,12,1,25,113
3,12,15,22,5,18,12,5,25,117
3,12,15,22,5,18,15,15,20,125
3,12,15,22,5,18,19,0,0,94
3,12,15,22,5,19,0,0,0,76
3,12,15,22,5,23,15,18,20,133
3,12,15,23,0,0,0,0,0,53
3,12,15,23,4,5,18,0,0,80
3,12,15,23,4,5,18,19,0,99
3,12,15,23,14,0,0,0,0,67
3,12,15,23,14,1,4,5,0,77
3,12,15,23,14,1,7,5,0,80
3,12,15,23,14,5,4,0,0,76
3,12,15,23,14,5,18,25,0,115
3,12,15,23,14,8,5,1,12,93
3,12,15,23,14,9,14,7,0,97
3,12,15,23,14,9,19,8,0,103
3,12,15,23,14,19,0,0,0,86
3,12,15,23,14,19,8,9,16,119
3,12,15,23,18,5,0,0,0,76
3,12,15,23,18,9,14,7,0,101
3,12,15,26,5,0,0,0,0,61
3,12,15,26,5,19,0,0,0,80
3,12,21,2,0,0,0,0,0,38
3,12,21,2,1,2,12,5,0,58
3,12,21,2,2,1,2,12,5,60
3,12,21,2,2,5,4,0,0,49
3,12,21,2,2,5,18,0,0,63
3,12,21,2,2,5,18,19,0,82
3,12,21,2,2,25,0,0,0,65
3,12,21,2,2,9,5,18,0,72
3,12,21,2,2,9,5,19,20,93
3,12,21,2,2,9,12,25,0,86
3,12,21,2,2,9,14,7,0,70
3,12,21,2,2,9,19,8,0,76
3,12,21,2,2,9,19,13,0,81
3,12,21,2,2,9,19,20,0,88
3,12,21,2,4,15,13,0,0,70
3,12,21,2,6,5,5,20,0,74
3,12,21,2,6,9,19,20,0,92
3,12,21,2,6,15,15,20,0,94
3,12,21,2,8,1,14,4,0,65
3,12,21,2,8,1,14,4,19,84
3,12,21,2,8,1,21,12,0,80
3,12,21,2,8,1,21,12,19,99
3,12,21,2,8,15,21,19,5,106
3,12,21,2,9,15,14,9,4,89
3,12,21,2,12,1,14,4,0,69
3,12,21,2,13,1,14,0,0,66
3,12,21,2,13,1,20,5,0,77
3,12,21,2,13,5,14,0,0,70
3,12,21,2,18,15,15,13,0,99
3,12,21,2,18,15,15,13,19,118
3,12,21,2,18,15,15,20,0,106
3,12,21,2,18,15,15,20,19,125
3,12,21,2,19,0,0,0,0,57
3,12,21,2,19,20,1,18,20,116
3,12,21,2,19,20,5,18,0,100
3,12,21,2,23,5,5,4,0,75
3,12,21,2,23,15,13,1,14,104
3,12,21,2,23,15,13,5,14,108
3,12,21,2,23,15,15,4,0,95
3,12,21,3,11,0,0,0,0,50
3,12,21,3,11,5,4,0,0,59
3,12,21,3,11,25,0,0,0,75
3,12,21,3,11,9,14,7,0,80
3,12,21,3,11,19,0,0,0,69
3,12,21,4,4,5,18,0,0,67
3,12,21,5,0,0,0,0,0,41
3,12,21,5,4,0,0,0,0,45
3,12,21,5,9,14,7,0,0,71
3,12,21,5,12,5,19,19,0,96
3,12,21,5,19,0,0,0,0,60
3,12,21,6,6,0,0,0,0,48
3,12,21,9,14,7,0,0,0,66
3,12,21,13,0,0,0,0,0,49
3,12,21,13,2,5,18,0,0,74
3,12,21,13,2,5,18,19,0,93
3,12,21,13,16,0,0,0,0,65
3,12,21,13,16,5,4,0,0,74
3,12,21,13,16,5,18,0,0,88
3,12,21,13,16,25,0,0,0,90
3,12,21,13,16,9,5,18,0,97
3,12,21,13,16,9,5,19,20,118
3,12,21,13,16,9,14,7,0,95
3,12,21,13,16,9,19,8,0,101
3,12,21,13,16,12,9,11,5,102
3,12,21,13,16,18,15,15,20,133
3,12,21,13,16,19,0,0,0,84
3,12,21,13,16,19,20,0,0,104
3,12,21,13,19,5,0,0,0,73
3,12,21,13,19,25,0,0,0,93
3,12,21,13,19,9,5,18,0,100
3,12,21,13,19,9,5,19,20,121
3,12,21,13,19,9,12,25,0,114
3,12,21,14,3,8,0,0,0,61
3,12,21,14,7,0,0,0,0,57
3,12,21,14,11,0,0,0,0,61
3,12,21,14,11,5,4,0,0,70
3,12,21,14,11,5,18,0,0,84
3,12,21,14,11,5,18,19,0,103
3,12,21,14,11,25,0,0,0,86
3,12,21,14,11,9,5,18,0,93
3,12,21,14,11,9,14,7,0,91
3,12,21,14,11,19,0,0,0,80
3,12,21,14,20,5,18,0,0,93
3,12,21,16,5,9,4,0,0,70
3,12,21,16,5,9,4,19,0,89
3,12,21,16,5,9,14,0,0,80
3,12,21,16,5,9,14,5,0,85
3,12,21,16,5,9,15,4,0,85
3,12,21,16,5,15,9,4,0,85
3,12,21,16,5,15,9,4,19,104
3,12,21,16,9,5,14,0,0,80
3,12,21,16,16,5,0,0,0,73
3,12,21,19,20,5,18,0,0,98
3,12,21,19,20,5,18,5,4,107
3,12,21,19,20,5,18,25,0,123
3,12,21,19,20,5,18,19,0,117
3,12,21,20,3,8,0,0,0,67
3,12,21,20,3,8,5,4,0,76
3,12,21,20,3,8,5,18,0,90
3,12,21,20,3,8,5,19,0,91
3,12,21,20,3,8,25,0,0,92
3,12,21,20,3,8,9,14,7,97
3,12,21,20,3,8,13,1,14,95
3,12,21,20,8,5,18,0,0,87
3,12,21,20,20,5,18,0,0,99
3,12,21,20,20,5,18,5,4,108
3,12,21,20,20,5,18,5,18,122
3,12,21,20,20,5,18,25,0,124
3,12,21,20,20,5,18,19,0,118
3,13,4,7,0,0,0,0,0,27
3,14,5,13,9,1,12,0,0,57
3,14,5,13,9,3,0,0,0,47
3,14,5,13,9,4,5,19,0,72
3,14,5,13,9,4,9,21,13,91
3,14,5,13,9,19,0,0,0,63
3,14,9,3,9,14,0,0,0,52
3,14,9,4,1,0,0,0,0,31
3,14,9,4,1,5,0,0,0,36
3,14,9,4,1,18,9,1,14,73
3,14,9,4,15,3,5,12,12,77
3,14,9,4,15,3,9,12,0,69
3,14,9,4,15,3,25,19,20,112
3,14,9,4,15,16,15,4,0,80
3,14,9,4,15,19,1,3,0,68
3,14,9,4,15,19,9,19,0,92
3,15,2,1,5,1,0,0,0,27
3,15,2,1,12,1,13,9,14,70
3,15,2,1,12,20,0,0,0,53
3,15,2,1,12,20,9,3,0,65
3,15,2,1,12,20,9,14,5,81
3,15,2,1,12,20,9,20,5,87
3,15,2,1,12,20,15,21,19,108
3,15,2,1,12,20,19,0,0,72
3,15,2,1,14,7,0,0,0,42
3,15,2,2,5,4,0,0,0,31
3,15,2,2,5,18,0,0,0,45
3,15,2,2,5,18,5,18,0,68
3,15,2,2,5,18,19,0,0,64
3,15,2,2,9,5,18,0,0,54
3,15,2,2,9,5,19,20,0,75
3,15,2,2,9,14,0,0,0,45
3,15,2,2,9,14,7,0,0,52
3,15,2,2,12,5,0,0,0,39
3,15,2,2,12,5,4,0,0,43
3,15,2,2,12,5,18,0,0,57
3,15,2,2,12,5,18,25,0,82
3,15,2,2,12,5,18,19,0,76
3,15,2,2,12,5,19,0,0,58
3,15,2,2,12,25,0,0,0,59
3,15,2,2,12,9,14,7,0,64
3,15,2,2,18,1,0,0,0,41
3,15,2,2,19,0,0,0,0,41
3,15,2,3,1,2,0,0,0,26
3,15,2,5,7,15,0,0,0,47
3,15,2,5,12,9,5,6,0,57
3,15,2,5,18,7,5,18,0,73
3,15,2,5,23,1,9,12,0,70
3,15,2,8,5,1,4,0,0,38
3,15,2,8,15,21,19,5,0,88
3,15,2,9,1,0,0,0,0,30
3,15,2,9,1,19,0,0,0,49
3,15,2,9,18,15,14,0,0,76
3,15,2,9,19,8,15,16,0,87
3,15,2,12,5,0,0,0,0,37
3,15,2,12,5,13,1,14,0,65
3,15,2,12,5,19,0,0,0,56
3,15,2,12,5,19,19,0,0,75
3,15,2,12,15,1,6,0,0,54
3,15,2,14,21,20,0,0,0,75
3,15,2,14,21,20,19,0,0,94
3,15,2,15,12,1,0,0,0,48
3,15,2,15,19,19,0,0,0,73
3,15,2,15,21,18,7,0,0,81
3,15,2,18,1,19,0,0,0,58
3,15,2,18,5,1,20,8,5,77
3,15,2,18,9,6,15,18,13,99
3,15,2,18,15,20,8,5,18,104
3,15,2,19,0,0,0,0,0,39
3,15,2,19,20,15,14,5,0,93
3,15,2,21,18,7,5,19,19,109
3,15,2,21,18,7,8,5,18,97
3,15,2,23,5,2,0,0,0,50
3,15,2,23,5,2,2,5,4,61
3,15,2,23,5,2,2,25,0,77
3,15,2,23,5,2,19,0,0,69
3,15,2,23,15,18,11,0,0,87
3,15,3,1,0,0,0,0,0,22
3,15,3,1,3,5,15,21,19,85
3,15,3,1,9,7,14,5,0,57
3,15,3,1,9,14,0,0,0,45
3,15,3,1,9,14,5,0,0,50
3,15,3,1,9,14,5,19,0,69
3,15,3,1,9,14,9,19,5,78
3,15,3,1,9,14,9,19,13,86
3,15,3,1,9,14,9,19,20,93
3,15,3,1,9,14,9,26,5,85
3,15,3,1,9,14,19,0,0,64
3,15,3,1,13,9,14,5,0,63
3,15,3,1,15,0,0,0,0,37
3,15,3,1,16,20,1,9,14,82
3,15,3,1,18,4,5,0,0,49
3,15,3,1,19,0,0,0,0,41
3,15,3,1,19,8,0,0,0,49
3,15,3,1,21,19,5,0,0,67
3,15,3,3,1,7,5,5,0,42
3,15,3,3,1,12,0,0,0,37
3,15,3,3,5,18,9,14,0,70
3,15,3,3,9,0,0,0,0,33
3,15,3,3,9,3,0,0,0,36
3,15,3,3,9,4,0,0,0,37
3,15,3,3,9,4,9,1,0,47
3,15,3,3,9,4,9,1,12,59
3,15,3,3,9,4,9,1,14,61
3,15,3,3,9,4,9,21,13,80
3,15,3,3,9,4,19,0,0,56
3,15,3,3,9,6,15,18,13,85
3,15,3,3,25,7,5,1,12,74
3,15,3,3,25,7,5,1,14,76
3,15,3,3,25,7,5,19,0,80
3,15,3,3,25,7,5,21,19,101
3,15,3,3,25,7,9,14,5,84
3,15,3,3,9,14,0,0,0,47
3,15,3,3,25,24,0,0,0,73
3,15,3,3,25,24,5,19,0,97
3,15,3,3,15,0,0,0,0,39
3,15,3,3,15,7,15,14,5,80
3,15,3,3,15,9,4,0,0,52
3,15,3,3,15,9,4,1,12,65
3,15,3,3,15,9,4,19,0,71
3,15,3,3,15,12,9,20,5,85
3,15,3,3,15,12,9,20,8,88
3,15,3,3,15,21,19,0,0,79
3,15,3,3,21,12,5,0,0,62
3,15,3,3,21,19,0,0,0,64
3,15,3,5,14,20,18,9,3,90
3,15,3,8,0,0,0,0,0,29
3,15,3,8,1,9,18,0,0,57
3,15,3,8,1,9,18,5,4,66
3,15,3,8,1,9,18,19,0,76
3,15,3,8,1,12,0,0,0,42
3,15,3,8,5,18,0,0,0,52
3,15,3,8,5,18,15,0,0,67
3,15,3,8,9,5,6,0,0,49
3,15,3,8,25,12,9,19,0,94
3,15,3,8,9,14,5,1,12,70
3,15,3,8,9,14,19,0,0,71
3,15,3,8,12,5,1,0,0,47
3,15,3,8,12,5,1,5,0,52
3,15,3,8,12,5,1,18,0,65
3,15,3,8,12,5,1,18,5,70
3,15,3,8,12,5,1,18,25,90
3,15,3,8,12,5,1,19,0,66
3,15,3,8,12,5,1,20,5,72
3,15,3,8,12,5,15,21,19,101
3,15,3,8,12,9,20,5,0,75
3,15,3,8,12,9,20,9,19,98
3,15,3,8,15,14,0,0,0,58
3,15,3,9,12,12,1,14,1,70
3,15,3,9,14,0,0,0,0,44
3,15,3,9,14,5,18,1,0,68
3,15,3,9,14,5,18,1,19,87
3,15,3,9,14,5,18,15,0,82
3,15,3,9,20,9,26,5,14,104
3,15,3,11,1,4,5,0,0,42
3,15,3,11,1,4,5,4,0,46
3,15,3,11,1,4,5,19,0,61
3,15,3,11,1,12,0,0,0,45
3,15,3,11,1,12,1,14,0,60
3,15,3,11,1,13,1,13,25,85
3,15,3,11,1,14,4,25,0,76
3,15,3,11,1,16,15,15,0,79
3,15,3,11,1,16,15,15,19,98
3,15,3,11,1,18,4,0,0,55
3,15,3,11,1,20,5,5,12,75
3,15,3,11,1,20,9,5,12,79
3,15,3,11,1,20,15,15,0,83
3,15,3,11,1,20,15,15,19,102
3,15,3,11,1,23,5,5,0,66
3,15,3,11,2,5,12,12,0,63
3,15,3,11,2,9,12,12,0,67
3,15,3,11,2,9,12,12,19,86
3,15,3,11,2,9,18,4,0,65
3,15,3,11,2,15,1,20,0,70
3,15,3,11,2,15,1,20,19,89
3,15,3,11,2,18,1,9,14,76
3,15,3,11,3,18,15,23,0,91
3,15,3,11,3,18,15,23,19,110
3,15,3,11,5,4,0,0,0,41
3,15,3,11,5,25,5,0,0,67
3,15,3,11,5,25,5,4,0,71
3,15,3,11,5,25,5,19,0,86
3,15,3,11,5,18,5,4,0,64
3,15,3,11,5,18,5,12,0,72
3,15,3,11,5,18,5,12,19,91
3,15,3,11,5,18,9,5,0,69
3,15,3,11,5,18,9,14,7,85
3,15,3,11,5,18,13,5,7,80
3,15,3,11,5,18,19,0,0,74
3,15,3,11,5,20,0,0,0,57
3,15,3,11,5,20,5,4,0,66
3,15,3,11,5,20,9,14,7,87
3,15,3,11,6,9,7,8,20,82
3,15,3,11,8,5,1,4,0,50
3,15,3,11,8,15,18,19,5,97
3,15,3,11,25,0,0,0,0,57
3,15,3,11,9,5,0,0,0,46
3,15,3,11,9,5,18,0,0,64
3,15,3,11,9,5,19,0,0,65
3,15,3,11,9,5,19,20,0,85
3,15,3,11,9,12,25,0,0,78
3,15,3,11,9,14,5,19,19,98
3,15,3,11,9,14,7,0,0,62
3,15,3,11,25,15,12,12,25,121
3,15,3,11,9,19,8,0,0,68
3,15,3,11,9,19,8,12,25,105
3,15,3,11,12,5,0,0,0,49
3,15,3,11,12,5,2,21,18,90
3,15,3,11,12,5,4,0,0,53
3,15,3,11,12,5,18,0,0,67
3,15,3,11,12,5,19,0,0,68
3,15,3,11,12,5,20,0,0,69
3,15,3,11,12,25,0,0,0,69
3,15,3,11,12,9,7,8,20,88
3,15,3,11,12,9,11,5,0,69
3,15,3,11,12,9,14,7,0,74
3,15,3,11,12,15,3,8,5,75
3,15,3,11,12,15,6,20,0,85
3,15,3,11,12,15,6,20,19,104
3,15,3,11,13,1,20,3,8,77
3,15,3,11,13,1,20,5,0,71
3,15,3,11,14,5,9,1,14,75
3,15,3,11,14,5,25,6,25,107
3,15,3,11,14,5,25,19,0,95
3,15,3,11,14,5,9,20,25,105
3,15,3,11,16,9,20,0,0,77
3,15,3,11,16,9,20,19,0,96
3,15,3,11,18,15,1,3,8,77
3,15,3,11,19,3,15,13,2,84
3,15,3,11,19,6,15,15,20,107
3,15,3,11,19,8,5,1,4,69
3,15,3,11,19,8,25,0,0,84
3,15,3,11,19,8,9,5,19,92
3,15,3,11,19,8,15,15,20,109
3,15,3,11,19,8,15,20,0,94
3,15,3,11,19,8,21,20,0,100
3,15,3,11,19,8,21,20,19,119
3,15,3,11,19,25,0,0,0,76
3,15,3,11,19,16,21,18,0,106
3,15,3,11,19,16,21,18,19,125
3,15,3,11,19,20,15,14,5,105
3,15,3,11,19,21,18,5,0,95
3,15,3,11,19,23,1,9,14,98
3,15,3,11,20,1,9,12,0,74
3,15,3,11,20,1,9,12,19,93
3,15,3,11,21,16,0,0,0,69
3,15,3,11,21,16,19,0,0,88
3,15,3,11,23,5,5,4,0,69
3,15,3,12,5,1,0,0,0,39
3,15,3,15,1,0,0,0,0,37
3,15,3,15,1,3,8,0,0,48
3,15,3,15,1,14,21,20,0,92
3,15,3,15,1,14,21,20,19,111
3,15,3,15,1,19,0,0,0,56
3,15,3,15,1,23,15,15,4,94
3,15,3,15,2,15,12,1,0,66
3,15,3,15,2,15,12,1,19,85
3,15,3,15,2,15,12,15,0,80
3,15,3,15,2,15,12,15,19,99
3,15,3,15,4,5,20,20,5,90
3,15,3,15,25,1,13,0,0,75
3,15,3,15,13,1,20,0,0,70
3,15,3,15,13,1,20,19,0,89
3,15,3,15,14,1,0,0,0,51
3,15,3,15,14,21,20,0,0,91
3,15,3,15,14,21,20,19,0,110
3,15,3,15,15,14,0,0,0,65
3,15,3,15,15,14,5,4,0,74
3,15,3,15,15,14,5,18,25,113
3,15,3,15,15,14,9,14,7,95
3,15,3,15,15,14,19,0,0,84
3,15,3,15,16,1,14,0,0,67
3,15,3,15,16,1,14,19,0,86
3,15,3,15,18,9,3,15,0,81
3,15,3,15,18,15,15,20,0,104
3,15,3,15,20,20,5,0,0,81
3,15,3,15,20,20,5,19,0,100
3,15,3,15,23,15,15,4,0,93
3,15,3,15,23,15,18,20,0,112
3,15,3,15,26,5,12,12,5,96
3,15,3,18,5,1,20,5,0,70
3,15,3,18,5,1,20,5,4,74
3,15,3,18,5,1,20,5,19,89
3,15,3,18,5,1,20,15,18,98
3,15,3,18,21,3,9,6,25,103
3,15,3,20,0,0,0,0,0,41
3,15,3,20,9,12,5,0,0,67
3,15,3,20,9,15,14,0,0,79
3,15,3,21,25,15,0,0,0,82
3,15,3,21,9,19,1,0,0,71
3,15,3,21,9,26,1,0,0,78
3,15,3,21,12,12,15,0,0,81
3,15,3,21,18,1,20,15,18,114
3,15,3,21,18,18,5,14,20,117
3,15,3,21,19,0,0,0,0,61
3,15,3,21,19,23,15,15,4,118
3,15,4,1,0,0,0,0,0,23
3,15,4,1,2,12,5,0,0,42
3,15,4,1,12,0,0,0,0,35
3,15,4,1,13,9,14,0,0,59
3,15,4,1,13,9,14,5,0,64
3,15,4,1,19,0,0,0,0,42
3,15,4,2,1,14,11,0,0,50
3,15,4,4,5,4,0,0,0,35
3,15,4,4,5,18,0,0,0,49
3,15,4,4,5,18,19,0,0,68
3,15,4,4,25,0,0,0,0,51
3,15,4,4,12,5,0,0,0,43
3,15,4,4,12,5,4,0,0,47
3,15,4,4,12,5,18,0,0,61
3,15,4,4,12,5,18,19,0,80
3,15,4,4,12,5,19,0,0,62
3,15,4,4,12,9,14,7,0,68
3,15,4,5,0,0,0,0,0,27
3,15,4,5,2,15,15,11,0,70
3,15,4,5,2,15,15,11,19,89
3,15,4,5,2,18,5,1,11,64
3,15,4,5,2,20,15,18,0,82
3,15,4,5,2,20,15,18,19,101
3,15,4,5,3,18,5,5,0,58
3,15,4,5,3,19,0,0,0,49
3,15,4,5,4,0,0,0,0,31
3,15,4,5,9,1,0,0,0,37
3,15,4,5,9,1,19,0,0,56
3,15,4,5,9,14,0,0,0,50
3,15,4,5,9,14,1,0,0,51
3,15,4,5,9,14,1,19,0,70
3,15,4,5,9,14,5,0,0,55
3,15,4,5,9,14,5,19,0,74
3,15,4,5,9,14,19,0,0,69
3,15,4,5,12,5,19,19,0,82
3,15,4,5,12,9,7,8,20,83
3,15,4,5,14,19,0,0,0,60
3,15,4,5,16,15,19,9,20,106
3,15,4,5,18,0,0,0,0,45
3,15,4,5,18,9,22,5,0,81
3,15,4,5,18,9,22,5,4,85
3,15,4,5,18,9,22,5,19,100
3,15,4,5,18,19,0,0,0,64
3,15,4,5,19,0,0,0,0,46
3,15,4,5,19,9,7,14,0,76
3,15,4,5,19,9,7,14,19,95
3,15,4,5,20,20,1,0,0,68
3,15,4,5,20,20,1,19,0,87
3,15,4,5,20,20,5,0,0,72
3,15,4,5,22,5,12,15,16,97
3,15,4,5,23,15,18,4,0,87
3,15,4,5,23,15,18,4,19,106
3,15,4,5,24,0,0,0,0,51
3,15,4,6,9,19,8,0,0,64
3,15,4,6,9,19,8,5,18,87
3,15,4,6,9,19,8,5,19,88
3,15,4,7,5,18,0,0,0,52
3,15,4,7,5,18,19,0,0,71
3,15,4,8,5,1,4,0,0,40
3,15,4,8,5,1,4,5,4,49
3,15,4,9,3,1,12,0,0,47
3,15,4,9,3,5,19,0,0,58
3,15,4,9,3,9,12,0,0,55
3,15,4,9,3,9,12,9,3,67
3,15,4,9,3,9,12,19,0,74
3,15,4,9,6,25,0,0,0,62
3,15,4,9,6,9,5,4,0,55
3,15,4,9,6,9,5,18,0,69
3,15,4,9,6,9,5,18,19,88
3,15,4,9,6,9,5,19,0,70
3,15,4,9,6,25,9,14,7,92
3,15,4,9,12,12,1,0,0,56
3,15,4,9,12,12,5,0,0,60
3,15,4,9,14,7,0,0,0,52
3,15,4,9,14,7,19,0,0,71
3,15,4,9,14,9,1,3,0,58
3,15,4,9,18,5,3,20,0,77
3,15,4,9,18,5,3,20,19,96
3,15,4,9,19,20,0,0,0,70
3,15,4,9,22,9,14,5,0,81
3,15,4,12,9,14,0,0,0,57
3,15,4,12,9,14,5,0,0,62
3,15,4,12,9,14,7,0,0,64
3,15,4,12,9,14,7,19,0,83
3,15,4,12,9,14,19,0,0,76
3,15,4,13,1,14,0,0,0,50
3,15,4,15,0,0,0,0,0,37
3,15,4,15,12,0,0,0,0,49
3,15,4,15,13,1,9,14,0,74
3,15,4,15,14,0,0,0,0,51
3,15,4,15,14,19,0,0,0,70
3,15,4,16,9,5,3,5,0,60
3,15,4,16,9,5,3,5,19,79
3,15,4,18,9,22,5,0,0,76
3,15,4,18,9,22,5,14,0,90
3,15,4,18,9,22,5,18,0,94
3,15,4,18,9,22,5,19,0,95
3,15,4,18,15,22,5,0,0,82
3,15,4,19,0,0,0,0,0,41
3,15,4,19,8,5,1,4,0,59
3,15,4,23,15,18,13,0,0,91
3,15,5,3,1,12,0,0,0,39
3,15,5,3,21,13,0,0,0,60
3,15,5,4,0,0,0,0,0,27
3,15,5,4,9,20,0,0,0,56
3,15,5,4,9,20,5,4,0,65
3,15,5,4,9,20,9,14,7,86
3,15,5,4,9,20,15,18,0,89
3,15,5,4,9,20,15,18,19,108
3,15,5,4,9,20,19,0,0,75
3,15,5,4,19,0,0,0,0,46
3,15,5,4,21,3,1,20,5,77
3,15,5,6,0,0,0,0,0,29
3,15,5,6,6,0,0,0,0,35
3,15,5,6,6,5,3,20,0,63
3,15,5,6,6,5,3,20,19,82
3,15,5,8,15,18,14,0,0,78
3,15,5,12,1,18,0,0,0,54
3,15,5,12,1,18,9,21,13,97
3,15,5,12,4,5,18,0,0,62
3,15,5,12,5,0,0,0,0,40
3,15,5,12,5,3,20,0,0,63
3,15,5,12,5,3,20,15,18,96
3,15,5,12,5,22,1,20,5,88
3,15,5,12,8,15,0,0,0,58
3,15,5,12,9,1,0,0,0,45
3,15,5,12,9,1,3,0,0,48
3,15,5,12,9,1,14,0,0,59
3,15,5,12,9,14,0,0,0,58
3,15,5,12,9,14,5,0,0,63
3,15,5,12,15,4,15,14,20,103
3,15,5,12,15,13,0,0,0,63
3,15,5,12,15,13,1,0,0,64
3,15,5,12,15,13,1,20,5,89
3,15,5,12,15,13,5,0,0,68
3,15,5,12,15,13,5,19,0,87
3,15,5,12,15,13,9,3,0,75
3,15,5,12,15,13,19,0,0,82
3,15,5,12,15,19,20,1,20,110
3,15,5,12,15,26,15,9,3,103
3,15,5,12,20,5,18,1,0,79
3,15,5,13,1,14,1,20,5,77
3,15,5,13,2,15,4,25,0,82
3,15,5,13,2,18,1,3,5,65
3,15,5,13,16,5,18,15,18,108
3,15,5,13,16,12,15,25,0,104
3,15,5,13,16,12,15,25,19,123
3,15,5,13,16,20,0,0,0,72
3,15,5,13,16,20,5,4,0,81
3,15,5,13,16,20,9,14,7,102
3,15,5,13,16,20,9,15,0,96
3,15,5,13,16,20,9,15,14,110
3,15,5,13,16,20,9,22,5,108
3,15,5,13,16,20,15,18,0,105
3,15,5,13,16,20,19,0,0,91
3,15,5,14,1,3,12,5,0,58
3,15,5,14,1,3,20,0,0,61
3,15,5,14,1,3,20,5,4,70
3,15,5,14,1,3,20,15,18,94
3,15,5,14,1,3,20,19,0,80
3,15,5,14,1,3,21,12,1,75
3,15,5,14,1,13,15,18,0,84
3,15,5,14,1,13,15,18,19,103
3,15,5,14,4,5,1,18,0,65
3,15,5,14,4,21,18,5,0,85
3,15,5,14,4,21,18,5,4,89
3,15,5,14,4,21,18,5,19,104
3,15,5,14,6,12,1,13,5,74
3,15,5,14,7,1,7,5,0,57
3,15,5,14,7,1,7,5,18,75
3,15,5,14,10,15,25,0,0,87
3,15,5,14,12,1,0,0,0,50
3,15,5,14,15,0,0,0,0,52
3,15,5,14,15,2,5,0,0,59
3,15,5,14,15,2,25,0,0,79
3,15,5,14,15,2,9,1,18,82
3,15,5,14,15,2,9,3,0,66
3,15,5,14,15,2,9,15,4,82
3,15,5,14,15,2,9,20,5,88
3,15,5,14,15,2,9,21,13,97
3,15,5,14,15,3,25,20,5,105
3,15,5,14,15,5,3,9,3,72
3,15,5,14,15,19,1,18,3,93
3,15,5,14,15,19,9,20,5,105
3,15,5,14,15,20,25,16,5,118
3,15,5,14,21,14,21,18,9,120
3,15,5,14,21,18,5,0,0,81
3,15,5,14,21,18,5,19,0,100
3,15,5,14,21,18,9,0,0,85
3,15,5,14,21,18,21,19,0,116
3,15,5,14,26,25,13,5,0,106
3,15,5,14,26,25,13,5,19,125
3,15,5,17,21,1,12,0,0,74
3,15,5,17,21,1,12,12,25,111
3,15,5,17,21,1,12,19,0,93
3,15,5,17,21,1,20,5,0,87
3,15,5,17,21,1,20,5,4,91
3,15,5,17,21,1,20,5,19,106
3,15,5,18,3,5,0,0,0,49
3,15,5,18,3,5,4,0,0,53
3,15,5,18,3,5,14,4,0,67
3,15,5,18,3,5,14,4,19,86
3,15,5,18,3,5,18,0,0,67
3,15,5,18,3,5,18,19,0,86
3,15,5,18,3,5,19,0,0,68
3,15,5,18,3,9,2,12,5,72
3,15,5,18,3,9,2,12,25,92
3,15,5,18,3,9,14,7,0,74
3,15,5,18,3,9,15,14,0,82
3,15,5,18,3,9,15,14,19,101
3,15,5,18,3,9,22,5,0,80
3,15,5,18,5,3,20,0,0,69
3,15,5,18,5,3,20,5,4,78
3,15,5,18,5,3,20,19,0,88
3,15,5,19,0,0,0,0,0,42
3,15,5,19,9,20,5,0,0,76
3,15,5,19,9,20,5,19,0,95
3,15,5,19,20,1,20,5,0,88
3,15,5,20,1,14,5,1,14,78
3,15,5,20,5,18,14,1,12,93
3,15,5,20,21,19,0,0,0,83
3,15,5,22,1,12,0,0,0,58
3,15,5,22,1,12,9,20,25,112
3,15,5,22,1,12,12,25,0,95
3,15,5,22,1,12,19,0,0,77
3,15,5,22,15,12,22,5,0,99
3,15,5,22,15,12,22,5,4,103
3,15,5,22,15,12,22,5,19,118
3,15,5,24,5,18,20,0,0,90
3,15,5,24,5,18,20,5,4,99
3,15,5,24,5,18,20,19,0,109
3,15,5,24,9,19,20,0,0,95
3,15,5,24,9,19,20,5,4,104
3,15,5,24,9,19,20,19,0,114
3,15,5,24,16,1,14,4,0,82
3,15,5,24,16,9,18,5,0,95
3,15,5,24,20,5,14,4,0,90
3,15,5,24,20,5,14,4,19,109
3,15,5,24,20,5,14,20,0,106
3,15,6,1,3,20,15,18,0,81
3,15,6,1,3,20,15,18,19,100
3,15,6,1,19,20,5,18,0,87
3,15,6,1,20,8,5,18,0,76
3,15,6,5,1,20,21,18,5,94
3,15,6,5,15,6,6,5,5,66
3,15,6,5,18,13,5,14,20,99
3,15,6,6,5,5,3,21,16,80
3,15,6,6,5,5,13,1,14,68
3,15,6,6,5,5,16,15,20,91
3,15,6,6,5,5,19,0,0,59
3,15,6,6,5,18,0,0,0,53
3,15,6,6,5,18,4,1,13,71
3,15,6,6,5,18,5,4,0,62
3,15,6,6,5,18,5,18,0,76
3,15,6,6,5,18,9,14,7,83
3,15,6,6,5,18,19,0,0,72
3,15,6,6,9,14,5,4,0,62
3,15,6,6,9,14,7,0,0,60
3,15,6,6,9,14,9,14,7,83
3,15,6,6,9,14,9,20,5,87
3,15,6,6,9,14,19,0,0,72
3,15,6,6,12,5,0,0,0,47
3,15,6,6,12,5,4,0,0,51
3,15,6,6,12,5,19,0,0,66
3,15,6,6,12,9,14,7,0,72
3,15,6,6,18,5,20,0,0,73
3,15,6,6,18,5,20,19,0,92
3,15,6,6,19,0,0,0,0,49
3,15,6,9,7,8,20,5,18,91
3,15,6,9,14,1,12,0,0,60
3,15,6,9,14,1,14,3,5,70
3,15,6,15,21,14,4,0,0,78
3,15,6,15,21,14,4,5,4,87
3,15,6,15,21,14,4,5,18,101
3,15,6,15,21,14,4,19,0,97
3,15,6,20,0,0,0,0,0,44
3,15,7,0,0,0,0,0,0,25
3,15,7,2,15,1,20,0,0,63
3,15,7,5,14,3,5,0,0,52
3,15,7,5,14,3,5,19,0,71
3,15,7,5,14,3,25,0,0,72
3,15,7,5,14,3,9,5,19,80
3,15,7,5,14,5,18,0,0,67
3,15,7,5,14,5,18,9,3,79
3,15,7,5,14,9,1,12,0,66
3,15,7,5,14,20,0,0,0,64
3,15,7,5,14,20,12,25,0,101
3,15,7,7,5,4,0,0,0,41
3,15,7,7,5,18,0,0,0,55
3,15,7,7,5,18,19,0,0,74
3,15,7,7,9,5,0,0,0,46
3,15,7,7,9,14,7,0,0,62
3,15,7,7,12,5,0,0,0,49
3,15,7,7,12,5,4,25,0,78
3,15,7,7,12,5,20,25,0,94
3,15,7,7,12,25,0,0,0,69
3,15,7,8,12,5,0,0,0,50
3,15,7,9,4,1,0,0,0,39
3,15,7,9,5,0,0,0,0,39
3,15,7,9,20,0,0,0,0,54
3,15,7,9,20,1,2,12,5,74
3,15,7,9,20,1,14,20,0,89
3,15,7,9,20,1,20,5,0,80
3,15,7,9,20,1,20,5,4,84
3,15,7,9,20,1,20,5,19,99
3,15,7,9,20,1,20,15,18,108
3,15,7,9,20,15,0,0,0,69
3,15,7,9,20,15,19,0,0,88
3,15,7,12,15,18,9,6,25,110
3,15,7,13,1,14,0,0,0,53
3,15,7,13,5,14,0,0,0,57
3,15,7,14,1,3,19,0,0,62
3,15,7,14,1,20,5,0,0,65
3,15,7,14,1,20,5,12,25,102
3,15,7,14,1,20,5,19,0,84
3,15,7,14,1,20,9,0,0,69
3,15,7,14,1,20,9,3,0,72
3,15,7,14,1,20,9,15,14,98
3,15,7,14,1,20,21,19,0,100
3,15,7,14,9,19,1,14,20,102
3,15,7,14,9,19,5,0,0,72
3,15,7,14,9,19,5,4,0,76
3,15,7,14,9,19,5,18,0,90
3,15,7,14,9,19,5,19,0,91
3,15,7,14,9,19,9,14,7,97
3,15,7,14,9,20,9,15,14,106
3,15,7,14,9,20,9,22,5,104
3,15,7,14,9,26,1,14,20,109
3,15,7,14,9,26,5,0,0,79
3,15,7,14,9,26,5,4,0,83
3,15,7,14,9,26,5,5,0,84
3,15,7,14,9,26,5,18,0,97
3,15,7,14,9,26,5,18,19,116
3,15,7,14,9,26,5,19,0,98
3,15,7,14,9,26,9,14,7,104
3,15,7,14,9,26,15,18,0,107
3,15,7,14,15,13,5,14,0,86
3,15,7,14,15,13,5,14,19,105
3,15,7,14,15,13,9,14,1,91
3,15,7,14,15,19,3,5,0,81
3,15,7,14,15,22,9,20,0,105
3,15,7,14,15,22,9,20,19,124
3,15,7,15,14,0,0,0,0,54
3,15,7,15,14,1,12,0,0,67
3,15,7,15,14,19,0,0,0,73
3,15,7,18,1,9,12,0,0,65
3,15,7,18,15,1,4,0,0,63
3,15,7,19,0,0,0,0,0,44
3,15,7,21,5,0,0,0,0,51
3,15,7,23,1,25,0,0,0,74
3,15,7,23,1,25,19,0,0,93
3,15,7,23,1,18,5,0,0,72
3,15,7,23,5,5,12,0,0,70
3,15,7,23,5,5,12,19,0,89
3,15,7,23,8,5,5,12,0,78
3,15,7,23,8,5,5,12,19,97
3,15,7,23,15,15,4,0,0,82
3,15,8,1,2,9,20,0,0,58
3,15,8,1,2,9,20,5,4,67
3,15,8,1,2,9,20,5,18,81
3,15,8,1,2,9,20,19,0,77
3,15,8,1,14,9,13,19,0,82
3,15,8,5,1,4,0,0,0,36
3,15,8,5,1,4,5,4,0,45
3,15,8,5,1,4,9,14,7,66
3,15,8,5,1,4,19,0,0,55
3,15,8,5,9,18,0,0,0,58
3,15,8,5,9,18,5,19,19,101
3,15,8,5,9,18,19,0,0,77
3,15,8,5,12,16,5,18,0,82
3,15,8,5,14,9,20,5,0,79
3,15,8,5,18,1,12,4,0,66
3,15,8,5,18,5,0,0,0,54
3,15,8,5,18,5,4,0,0,58
3,15,8,5,18,5,14,3,5,76
3,15,8,5,18,5,14,3,25,96
3,15,8,5,18,5,14,20,0,88
3,15,8,5,18,5,18,0,0,72
3,15,8,5,18,5,18,19,0,91
3,15,8,5,18,5,19,0,0,73
3,15,8,5,18,5,20,9,3,86
3,15,8,5,18,9,14,7,0,79
3,15,8,5,18,9,20,15,18,111
3,15,8,5,18,20,0,0,0,69
3,15,8,5,19,9,2,12,5,78
3,15,8,5,19,9,15,14,0,88
3,15,8,5,19,9,15,14,19,107
3,15,8,5,19,9,22,5,0,86
3,15,8,9,2,9,20,0,0,66
3,15,8,9,2,9,20,15,18,99
3,15,8,9,20,18,5,0,0,78
3,15,8,15,0,0,0,0,0,41
3,15,8,15,2,0,0,0,0,43
3,15,8,15,2,1,0,0,0,44
3,15,8,15,2,1,20,5,0,69
3,15,8,15,2,1,20,5,4,73
3,15,8,15,2,1,20,5,19,88
3,15,8,15,2,1,20,15,18,97
3,15,8,15,7,0,0,0,0,48
3,15,8,15,7,19,0,0,0,67
3,15,8,15,12,0,0,0,0,53
3,15,8,15,12,4,5,18,0,80
3,15,8,15,12,4,5,18,19,99
3,15,8,15,18,14,0,0,0,73
3,15,8,15,18,20,0,0,0,79
3,15,8,15,18,20,19,0,0,98
3,15,8,15,19,0,0,0,0,60
3,15,8,15,19,8,0,0,0,68
3,15,8,15,19,8,5,19,0,92
3,15,8,15,19,20,0,0,0,80
3,15,8,15,19,20,5,4,0,89
3,15,8,15,19,20,5,19,19,123
3,15,8,15,19,20,9,14,7,110
3,15,8,15,19,20,19,0,0,99
3,15,8,15,23,0,0,0,0,64
3,15,8,21,5,0,0,0,0,52
3,15,8,21,14,5,0,0,0,66
3,15,8,21,14,5,19,0,0,85
3,15,8,21,19,2,1,14,4,87
3,15,25,1,14,0,0,0,0,58
3,15,25,4,15,7,0,0,0,69
3,15,25,4,15,7,19,0,0,88
3,15,25,5,4,0,0,0,0,52
3,15,25,5,18,0,0,0,0,66
3,15,25,5,19,20,0,0,0,87
3,15,9,6,0,0,0,0,0,33
3,15,9,6,5,4,0,0,0,42
3,15,9,6,6,5,0,0,0,44
3,15,9,6,6,5,4,0,0,48
3,15,9,6,6,5,19,0,0,63
3,15,9,6,6,5,21,18,0,83
3,15,9,6,6,5,21,18,19,102
3,15,9,6,6,5,21,19,5,89
3,15,9,6,6,9,14,7,0,69
3,15,9,6,6,21,18,5,0,83
3,15,9,6,6,21,18,5,4,87
3,15,9,6,6,21,18,5,19,102
3,15,9,6,9,14,7,0,0,63
3,15,9,6,19,0,0,0,0,52
3,15,9,7,14,0,0,0,0,48
3,15,9,7,14,5,0,0,0,53
3,15,9,7,14,5,4,0,0,57
3,15,9,7,14,5,19,0,0,72
3,15,9,7,14,25,0,0,0,73
3,15,9,7,14,9,14,7,0,78
3,15,9,7,14,19,0,0,0,67
3,15,9,7,21,5,0,0,0,60
3,15,25,9,14,7,0,0,0,73
3,15,25,9,19,8,0,0,0,79
3,15,9,12,0,0,0,0,0,39
3,15,9,12,5,4,0,0,0,48
3,15,9,12,5,18,0,0,0,62
3,15,9,12,5,18,19,0,0,81
3,15,25,12,25,0,0,0,0,80
3,15,9,12,25,5,1,18,0,88
3,15,9,12,9,14,7,0,0,69
3,15,9,12,12,5,14,0,0,70
3,15,9,12,19,0,0,0,0,58
3,15,9,12,19,13,9,20,8,108
3,15,9,13,13,5,14,19,5,96
3,15,9,13,16,12,15,18,5,106
3,15,9,14,0,0,0,0,0,41
3,15,25,14,0,0,0,0,0,57
3,15,9,14,1,2,12,5,0,61
3,15,9,14,1,7,5,0,0,54
3,15,9,14,1,7,5,19,0,73
3,15,9,14,3,9,4,5,0,62
3,15,9,14,3,9,4,5,4,66
3,15,9,14,3,9,4,5,18,80
3,15,9,14,3,9,4,5,19,81
3,15,9,14,3,12,9,14,5,84
3,15,9,14,3,12,21,4,5,86
3,15,9,14,5,4,0,0,0,50
3,15,9,14,5,18,0,0,0,64
3,15,9,14,5,18,19,0,0,83
3,15,25,14,5,19,19,0,0,100
3,15,25,14,5,19,19,5,19,124
3,15,9,14,6,5,18,0,0,70
3,15,9,14,6,5,18,19,0,89
3,15,9,14,7,0,0,0,0,48
3,15,9,14,8,1,2,9,20,81
3,15,9,14,8,5,18,5,0,77
3,15,9,14,8,5,18,5,4,81
3,15,9,14,8,5,18,5,19,96
3,15,9,14,25,0,0,0,0,66
3,15,25,14,25,5,0,0,0,87
3,15,9,14,9,14,7,0,0,71
3,15,9,14,9,20,9,1,12,92
3,15,9,14,13,1,11,5,18,89
3,15,9,14,13,1,20,5,0,80
3,15,9,14,13,1,20,5,19,99
3,15,9,14,19,0,0,0,0,60
3,15,9,14,19,16,9,18,5,108
3,15,9,14,19,21,18,5,0,104
3,15,9,14,19,21,18,5,4,108
3,15,9,14,19,21,18,5,18,122
3,15,9,14,19,21,18,5,19,123
3,15,9,14,20,5,14,19,5,104
3,15,9,14,20,5,18,0,0,84
3,15,9,14,20,5,18,19,0,103
3,15,9,14,20,9,19,5,0,94
3,15,9,14,22,5,14,20,0,102
3,15,9,14,22,15,12,22,5,117
3,15,25,15,0,0,0,0,0,58
3,15,25,15,12,0,0,0,0,70
3,15,25,15,19,0,0,0,0,77
3,15,25,15,20,5,0,0,0,83
3,15,25,15,20,5,19,0,0,102
3,15,25,15,20,9,12,12,15,126
3,15,25,15,20,9,14,7,0,108
3,15,25,16,15,21,0,0,0,95
3,15,25,16,15,21,19,0,0,114
3,15,25,16,21,0,0,0,0,80
3,15,25,16,21,19,0,0,0,99
3,15,9,18,0,0,0,0,0,45
3,15,9,18,19,0,0,0,0,64
3,15,25,19,0,0,0,0,0,62
3,15,9,19,14,19,0,0,0,79
3,15,9,19,20,18,5,12,0,101
3,15,25,19,20,18,5,12,0,117
3,15,9,19,20,18,5,12,19,120
3,15,9,19,20,18,9,12,0,105
3,15,9,19,20,18,9,12,19,124
3,15,9,20,1,12,0,0,0,60
3,15,9,20,1,12,12,25,0,97
3,15,9,20,9,15,14,0,0,85
3,15,9,20,9,15,14,1,12,98
3,15,9,20,9,15,14,19,0,104
3,15,9,20,21,18,5,0,0,91
3,15,9,20,21,19,0,0,0,87
3,15,9,20,21,19,5,19,0,111
3,15,25,21,18,5,0,0,0,87
3,15,10,15,9,14,0,0,0,66
3,15,10,15,9,14,5,4,0,75
3,15,10,15,9,14,19,0,0,85
3,15,10,15,14,5,19,0,0,81
3,15,10,21,4,7,5,0,0,65
3,15,10,21,4,9,3,5,19,89
3,15,10,21,18,15,18,0,0,100
3,15,11,5,4,0,0,0,0,38
3,15,11,5,25,0,0,0,0,59
3,15,11,5,12,9,11,5,0,71
3,15,11,5,13,1,14,0,0,62
3,15,11,5,14,5,25,0,0,78
3,15,11,5,18,25,0,0,0,77
3,15,11,5,18,14,21,20,0,107
3,15,11,5,18,19,0,0,0,71
3,15,11,5,19,0,0,0,0,53
3,15,11,5,23,15,12,4,0,88
3,15,11,25,0,0,0,0,0,54
3,15,11,9,5,0,0,0,0,43
3,15,11,9,14,7,0,0,0,59
3,15,11,14,5,25,6,25,0,104
3,15,11,21,12,15,18,9,19,123
3,15,12,1,2,15,18,5,18,89
3,15,12,1,7,5,0,0,0,43
3,15,12,1,12,7,9,1,0,60
3,15,12,1,13,5,14,20,0,83
3,15,12,1,14,4,5,18,0,72
3,15,12,1,14,4,5,18,19,91
3,15,12,1,14,5,0,0,0,50
3,15,12,1,16,8,9,26,5,95
3,15,12,1,18,9,14,0,0,72
3,15,12,1,20,0,0,0,0,51
3,15,12,1,20,5,0,0,0,56
3,15,12,1,20,9,15,14,0,89
3,15,12,1,20,21,18,5,0,95
3,15,12,1,21,24,5,0,0,81
3,15,12,1,26,9,15,14,5,100
3,15,12,2,1,3,11,0,0,47
3,15,12,2,5,18,20,5,18,98
3,15,12,3,1,14,14,15,14,91
3,15,12,3,8,9,3,9,1,63
3,15,12,3,8,9,3,9,14,76
3,15,12,3,8,25,20,5,0,91
3,15,12,3,15,20,8,1,18,95
3,15,12,4,2,12,15,15,4,82
3,15,12,4,3,15,3,11,0,66
3,15,12,4,5,18,0,0,0,57
3,15,12,4,5,19,20,0,0,78
3,15,12,4,6,9,14,3,8,74
3,15,12,4,9,19,8,0,0,70
3,15,12,4,12,25,0,0,0,71
3,15,12,4,14,5,19,19,0,91
3,15,12,4,15,14,7,0,0,70
3,15,12,4,16,18,15,15,6,104
3,15,12,4,19,0,0,0,0,53
3,15,12,4,19,12,1,23,0,89
3,15,12,5,1,4,0,0,0,40
3,15,12,5,1,4,5,18,0,63
3,15,12,5,1,4,19,0,0,59
3,15,12,5,3,20,15,13,25,111
3,15,12,5,4,0,0,0,0,39
3,15,12,5,7,1,20,5,5,73
3,15,12,5,25,0,0,0,0,60
3,15,12,5,13,15,21,19,5,108
3,15,12,5,14,20,0,0,0,69
3,15,12,5,15,16,20,5,18,109
3,15,12,5,16,12,1,14,20,98
3,15,12,5,18,1,0,0,0,54
3,15,12,5,19,5,5,4,0,68
3,15,12,5,19,5,5,4,19,87
3,15,12,5,19,12,1,23,0,90
3,15,12,5,19,12,1,23,19,109
3,15,12,5,19,19,5,5,0,83
3,15,12,5,19,19,5,5,19,102
3,15,12,5,19,19,15,18,0,106
3,15,12,5,19,19,15,18,19,125
3,15,12,5,20,9,20,0,0,84
3,15,12,5,21,18,0,0,0,74
3,15,12,5,21,19,5,19,0,99
3,15,12,5,23,15,18,20,0,111
3,15,12,5,23,15,18,20,19,130
3,15,12,6,15,24,0,0,0,75
3,15,12,9,0,0,0,0,0,39
3,15,12,25,0,0,0,0,0,55
3,15,12,9,1,14,4,5,18,81
3,15,12,25,2,1,0,0,0,58
3,15,12,9,2,5,18,20,0,84
3,15,12,9,2,18,9,0,0,68
3,15,12,9,3,0,0,0,0,42
3,15,12,9,3,1,12,0,0,55
3,15,12,9,3,9,14,0,0,65
3,15,12,9,3,9,14,5,0,70
3,15,12,9,3,9,14,5,19,89
3,15,12,9,3,9,14,19,0,84
3,15,12,9,3,11,5,18,0,76
3,15,12,9,3,11,25,0,0,78
3,15,12,9,3,18,15,15,20,110
3,15,12,9,3,19,0,0,0,61
3,15,12,9,3,23,5,5,4,79
3,15,12,9,3,23,15,18,20,118
3,15,12,9,5,19,0,0,0,63
3,15,12,9,6,15,18,13,0,91
3,15,12,9,6,15,18,13,19,110
3,15,12,9,12,25,19,9,14,118
3,15,12,25,13,2,9,15,14,108
3,15,12,9,14,5,1,18,0,77
3,15,12,9,14,7,0,0,0,60
3,15,12,9,14,19,0,0,0,72
3,15,12,25,15,14,5,0,0,89
3,15,12,25,15,14,9,3,0,96
3,15,12,9,16,8,1,7,5,76
3,15,12,9,19,5,21,13,19,116
3,15,12,9,19,20,9,14,0,101
3,15,12,9,19,20,9,14,19,120
3,15,12,9,20,9,3,0,0,71
3,15,12,25,20,9,3,0,0,87
3,15,12,9,20,9,19,0,0,87
3,15,12,9,20,9,19,5,19,111
3,15,12,25,21,13,0,0,0,89
3,15,12,25,21,13,9,19,20,137
3,15,12,9,21,18,9,1,0,88
3,15,12,11,0,0,0,0,0,41
3,15,12,12,0,0,0,0,0,42
3,15,12,12,1,2,0,0,0,45
3,15,12,12,1,2,5,14,20,84
3,15,12,12,1,4,1,0,0,48
3,15,12,12,1,4,1,19,0,67
3,15,12,12,1,7,5,0,0,55
3,15,12,12,1,7,5,4,0,59
3,15,12,12,1,7,5,14,0,69
3,15,12,12,1,7,5,14,19,88
3,15,12,12,1,7,5,19,0,74
3,15,12,12,1,7,9,19,20,98
3,15,12,12,1,16,19,1,18,97
3,15,12,12,1,16,19,5,0,83
3,15,12,12,1,16,19,5,4,87
3,15,12,12,1,16,19,5,19,102
3,15,12,12,1,18,4,0,0,65
3,15,12,12,1,18,4,19,0,84
3,15,12,12,1,18,5,0,0,66
3,15,12,12,1,18,5,4,0,70
3,15,12,12,1,18,5,20,0,86
3,15,12,12,1,18,5,20,19,105
3,15,12,12,1,18,9,14,7,91
3,15,12,12,1,18,9,14,15,99
3,15,12,12,1,18,13,1,14,89
3,15,12,12,1,18,19,0,0,80
3,15,12,12,1,20,0,0,0,63
3,15,12,12,1,20,5,0,0,68
3,15,12,12,1,20,5,4,0,72
3,15,12,12,1,20,5,5,0,73
3,15,12,12,1,20,5,19,0,87
3,15,12,12,1,20,9,14,7,93
3,15,12,12,1,20,9,15,14,101
3,15,12,12,1,20,9,22,5,99
3,15,12,12,1,20,15,18,0,96
3,15,12,12,1,20,15,18,19,115
3,15,12,12,1,21,4,0,0,68
3,15,12,12,5,1,7,21,5,81
3,15,12,12,5,3,20,5,4,79
3,15,12,12,5,3,20,15,18,103
3,15,12,12,5,3,20,19,0,89
3,15,12,12,5,5,14,19,0,85
3,15,12,12,5,7,5,0,0,59
3,15,12,12,5,7,5,18,0,77
3,15,12,12,5,7,5,18,19,96
3,15,12,12,5,7,5,19,0,78
3,15,12,12,5,7,5,19,5,83
3,15,12,12,5,7,9,1,0,64
3,15,12,12,5,7,9,1,12,76
3,15,12,12,5,7,9,1,14,78
3,15,12,12,5,7,9,21,13,97
3,15,12,12,5,20,0,0,0,67
3,15,12,12,5,20,5,4,0,76
3,15,12,12,5,20,5,18,0,90
3,15,12,12,5,20,9,3,0,79
3,15,12,12,5,20,9,14,0,90
3,15,12,12,5,20,9,14,7,97
3,15,12,12,5,20,19,0,0,86
3,15,12,12,25,2,1,0,0,70
3,15,12,12,9,2,5,18,20,96
3,15,12,12,25,2,9,19,20,117
3,15,12,12,9,3,12,5,0,71
3,15,12,12,9,4,5,0,0,60
3,15,12,12,9,4,5,4,0,64
3,15,12,12,9,4,5,19,0,79
3,15,12,12,9,4,9,14,0,78
3,15,12,12,9,4,9,14,5,83
3,15,12,12,9,4,9,14,7,85
3,15,12,12,9,5,4,0,0,60
3,15,12,12,9,5,18,25,0,99
3,15,12,12,9,5,19,0,0,75
3,15,12,12,9,6,15,18,13,103
3,15,12,12,9,7,1,20,5,84
3,15,12,12,25,9,14,7,0,97
3,15,12,12,9,13,1,20,5,90
3,15,12,12,9,14,1,12,0,78
3,15,12,12,9,14,5,1,18,89
3,15,12,12,9,14,7,0,0,72
3,15,12,12,9,14,7,12,25,109
3,15,12,12,9,14,19,5,19,108
3,15,12,12,25,18,0,0,0,85
3,15,12,12,25,18,9,1,0,95
3,15,12,12,25,18,9,5,0,99
3,15,12,12,25,18,9,20,5,119
3,15,12,12,25,18,9,21,13,128
3,15,12,12,9,19,9,15,14,108
3,15,12,12,9,19,9,22,5,106
3,15,12,12,25,23,5,19,20,134
3,15,12,12,15,3,1,12,0,73
3,15,12,12,15,3,1,20,5,86
3,15,12,12,15,3,11,0,0,71
3,15,12,12,15,4,9,15,14,99
3,15,12,12,15,4,9,21,13,104
3,15,12,12,15,7,5,14,0,83
3,15,12,12,15,7,21,5,0,90
3,15,12,12,15,7,21,5,4,94
3,15,12,12,15,7,21,5,19,109
3,15,12,12,15,9,4,0,0,70
3,15,12,12,15,9,4,1,12,83
3,15,12,12,15,9,4,5,18,93
3,15,12,12,15,9,4,19,0,89
3,15,12,12,15,16,0,0,0,73
3,15,12,12,15,16,5,4,0,82
3,15,12,12,15,16,19,0,0,92
3,15,12,12,15,17,21,5,0,100
3,15,12,12,15,17,21,25,0,120
3,15,12,12,15,17,21,9,1,105
3,15,12,12,15,20,8,21,14,120
3,15,12,12,15,20,25,16,5,123
3,15,12,12,15,20,25,16,25,143
3,15,12,12,15,23,0,0,0,80
3,15,12,12,21,4,5,0,0,72
3,15,12,12,21,4,5,4,0,76
3,15,12,12,21,4,5,18,0,90
3,15,12,12,21,4,5,18,19,109
3,15,12,12,21,4,5,19,0,91
3,15,12,12,21,4,9,14,7,97
3,15,12,12,21,14,0,0,0,77
3,15,12,12,21,19,9,15,14,120
3,15,12,12,21,19,9,22,5,118
3,15,12,12,21,19,15,18,25,140
3,15,12,12,21,20,0,0,0,83
3,15,12,12,21,20,9,15,14,121
3,15,12,12,21,20,15,18,25,141
3,15,12,12,21,22,9,1,0,95
3,15,12,12,21,22,9,1,12,107
3,15,12,12,21,22,9,5,19,118
3,15,12,12,21,22,9,21,13,128
3,15,12,13,1,18,19,0,0,81
3,15,12,13,15,19,5,0,0,82
3,15,12,14,1,18,9,1,0,73
3,15,12,15,2,0,0,0,0,47
3,15,12,15,2,9,0,0,0,56
3,15,12,15,2,9,14,0,0,70
3,15,12,15,2,9,21,13,0,90
3,15,12,15,2,15,13,1,0,76
3,15,12,15,3,1,20,5,0,74
3,15,12,15,3,1,20,5,4,78
3,15,12,15,3,1,20,5,19,93
3,15,12,15,3,25,14,20,8,115
3,15,12,15,3,15,12,1,0,76
3,15,12,15,3,15,12,9,3,87
3,15,12,15,3,15,12,15,0,90
3,15,12,15,7,0,0,0,0,52
3,15,12,15,7,14,5,4,0,75
3,15,12,15,7,14,5,19,0,90
3,15,12,15,7,19,0,0,0,71
3,15,12,15,12,1,0,0,0,58
3,15,12,15,12,9,20,5,0,91
3,15,12,15,13,2,0,0,0,60
3,15,12,15,13,2,9,5,18,92
3,15,12,15,13,2,9,14,0,83
3,15,12,15,13,5,20,18,25,126
3,15,12,15,14,1,4,5,4,73
3,15,12,15,14,1,20,5,0,85
3,15,12,15,14,5,0,0,0,64
3,15,12,15,14,5,12,0,0,76
3,15,12,15,14,5,12,3,25,104
3,15,12,15,14,5,12,19,0,95
3,15,12,15,14,5,18,0,0,82
3,15,12,15,14,5,19,0,0,83
3,15,12,15,14,5,20,20,5,109
3,15,12,15,14,9,0,0,0,68
3,15,12,15,14,25,0,0,0,84
3,15,12,15,14,9,1,12,0,81
3,15,12,15,14,9,1,12,19,100
3,15,12,15,14,9,3,0,0,71
3,15,12,15,14,9,3,1,12,84
3,15,12,15,14,9,3,19,0,90
3,15,12,15,14,9,19,5,0,92
3,15,12,15,14,9,19,5,4,96
3,15,12,15,14,9,19,5,18,110
3,15,12,15,14,9,19,5,19,111
3,15,12,15,14,9,19,20,0,107
3,15,12,15,14,9,19,20,19,126
3,15,12,15,14,9,20,9,19,116
3,15,12,15,14,9,26,5,0,99
3,15,12,15,14,9,26,5,4,103
3,15,12,15,14,9,26,5,18,117
3,15,12,15,14,9,26,5,19,118
3,15,12,15,14,14,1,4,5,83
3,15,12,15,14,19,0,0,0,78
3,15,12,15,14,21,19,0,0,99
3,15,12,15,16,5,24,25,0,115
3,15,12,15,16,5,24,9,1,100
3,15,12,15,16,8,1,14,0,84
3,15,12,15,16,8,1,14,5,89
3,15,12,15,16,8,1,14,25,109
3,15,12,15,16,8,5,14,5,93
3,15,12,15,16,8,15,14,25,123
3,15,12,15,16,8,15,14,19,117
3,15,12,15,16,16,5,0,0,82
3,15,12,15,17,21,9,5,19,116
3,15,12,15,18,0,0,0,0,63
3,15,12,15,18,1,2,12,5,83
3,15,12,15,18,1,2,12,25,103
3,15,12,15,18,1,14,20,0,98
3,15,12,15,18,1,14,20,19,117
3,15,12,15,18,1,20,5,0,89
3,15,12,15,18,3,1,19,20,106
3,15,12,15,18,5,4,0,0,72
3,15,12,15,18,5,4,19,0,91
3,15,12,15,18,5,18,0,0,86
3,15,12,15,18,5,18,19,0,105
3,15,12,15,18,6,1,19,20,109
3,15,12,15,18,6,21,12,0,102
3,15,12,15,18,25,0,0,0,88
3,15,12,15,18,9,6,9,3,90
3,15,12,15,18,9,14,0,0,86
3,15,12,15,18,9,14,7,0,93
3,15,12,15,18,9,14,7,19,112
3,15,12,15,18,9,19,13,0,104
3,15,12,15,18,9,19,13,19,123
3,15,12,15,18,9,19,20,0,111
3,15,12,15,18,9,19,20,19,130
3,15,12,15,18,9,26,5,0,103
3,15,12,15,18,12,5,19,19,118
3,15,12,15,18,13,1,14,0,91
3,15,12,15,18,15,20,15,0,113
3,15,12,15,18,19,0,0,0,82
3,15,12,15,18,20,25,16,5,129
3,15,12,15,19,19,0,0,0,83
3,15,12,15,19,19,1,12,0,96
3,15,12,15,19,19,5,1,14,103
3,15,12,15,19,19,9,0,0,92
3,15,12,15,19,19,15,0,0,98
3,15,12,15,19,19,21,19,0,123
3,15,12,15,19,20,15,13,25,137
3,15,12,15,19,20,18,1,12,115
3,15,12,15,19,20,18,9,3,114
3,15,12,15,19,20,18,21,13,136
3,15,12,15,20,15,13,25,0,118
3,15,12,15,21,18,0,0,0,84
3,15,12,15,21,18,5,18,0,107
3,15,12,15,21,18,5,18,19,126
3,15,12,15,21,18,6,21,12,123
3,15,12,15,21,18,25,0,0,109
3,15,12,15,21,18,9,14,7,114
3,15,12,15,21,18,9,19,20,132
3,15,12,15,21,18,9,26,5,124
3,15,12,15,21,18,13,1,14,112
3,15,12,15,21,18,19,0,0,103
3,15,12,15,21,19,0,0,0,85
3,15,12,15,22,5,0,0,0,72
3,15,12,16,5,15,0,0,0,66
3,15,12,16,8,5,7,0,0,66
3,15,12,16,9,20,9,19,0,103
3,15,12,16,15,3,5,12,5,86
3,15,12,16,15,18,20,0,0,99
3,15,12,16,15,18,20,5,18,122
3,15,12,16,15,19,20,1,20,121
3,15,12,16,15,20,15,13,25,134
3,15,12,16,21,19,0,0,0,86
3,15,12,19,0,0,0,0,0,49
3,15,12,19,20,1,6,6,0,82
3,15,12,20,5,18,0,0,0,73
3,15,12,20,5,18,19,0,0,92
3,15,12,20,8,15,15,4,0,92
3,15,12,20,9,19,8,0,0,86
3,15,12,20,9,19,8,12,25,123
3,15,12,20,12,9,11,5,0,87
3,15,12,20,15,18,9,1,0,93
3,15,12,20,16,9,24,25,0,124
3,15,12,20,16,9,24,9,5,113
3,15,12,20,19,0,0,0,0,69
3,15,12,20,19,6,15,15,20,125
3,15,12,20,19,11,9,14,0,103
3,15,12,21,2,1,18,9,1,82
3,15,12,21,2,18,9,4,0,84
3,15,12,21,2,18,9,4,19,103
3,15,12,21,2,18,9,14,5,99
3,15,12,21,2,18,15,9,4,99
3,15,12,21,7,15,0,0,0,73
3,15,12,21,7,15,19,0,0,92
3,15,12,21,13,2,1,18,25,110
3,15,12,21,13,2,1,20,5,92
3,15,12,21,13,2,5,9,1,81
3,15,12,21,13,2,9,1,4,80
3,15,12,21,13,2,9,3,0,78
3,15,12,21,13,2,9,5,18,98
3,15,12,21,13,2,9,14,0,89
3,15,12,21,13,2,9,20,5,100
3,15,12,21,13,2,9,21,13,109
3,15,12,21,13,2,15,0,0,81
3,15,12,21,13,2,15,9,4,94
3,15,12,21,13,2,15,21,19,121
3,15,12,21,13,5,12,0,0,81
3,15,12,21,13,5,12,12,1,94
3,15,12,21,13,5,12,19,0,100
3,15,12,21,13,14,0,0,0,78
3,15,12,21,13,14,1,0,0,79
3,15,12,21,13,14,1,12,0,91
3,15,12,21,13,14,1,18,0,97
3,15,12,21,13,14,1,20,5,104
3,15,12,21,13,14,5,1,0,84
3,15,12,21,13,14,5,4,0,87
3,15,12,21,13,14,5,18,0,101
3,15,12,21,13,14,9,14,7,108
3,15,12,21,13,14,9,19,20,126
3,15,12,21,13,14,9,26,5,118
3,15,12,21,13,14,19,0,0,97
3,15,12,21,14,1,18,0,0,84
3,15,12,21,18,5,0,0,0,74
3,15,12,21,18,5,19,0,0,93
3,15,12,21,19,9,20,5,0,104
3,15,12,26,1,0,0,0,0,57
3,15,12,26,1,19,0,0,0,76
3,15,13,1,0,0,0,0,0,32
3,15,13,1,3,9,14,5,0,63
3,15,13,1,4,5,0,0,0,41
3,15,13,1,5,0,0,0,0,37
3,15,13,1,11,5,0,0,0,48
3,15,13,1,11,5,18,0,0,66
3,15,13,1,11,5,18,19,0,85
3,15,13,1,11,5,19,0,0,67
3,15,13,1,11,9,14,7,0,73
3,15,13,1,12,0,0,0,0,44
3,15,13,1,12,5,19,0,0,68
3,15,13,1,12,19,0,0,0,63
3,15,13,1,13,9,5,0,0,59
3,15,13,1,14,1,7,5,0,59
3,15,13,1,14,1,7,5,18,77
3,15,13,1,14,9,3,0,0,58
3,15,13,1,18,3,1,0,0,54
3,15,13,1,18,20,0,0,0,70
3,15,13,1,20,5,0,0,0,57
3,15,13,1,20,5,19,0,0,76
3,15,13,1,20,9,3,0,0,64
3,15,13,1,20,9,11,0,0,72
3,15,13,1,20,9,11,19,0,91
3,15,13,1,20,15,19,5,0,91
3,15,13,1,20,15,21,19,0,107
3,15,13,1,20,21,12,1,0,86
3,15,13,1,20,21,12,1,5,91
3,15,13,1,20,21,12,9,4,98
3,15,13,2,0,0,0,0,0,33
3,15,13,2,1,18,15,14,0,81
3,15,13,2,1,19,15,21,0,89
3,15,13,2,1,20,0,0,0,54
3,15,13,2,1,20,1,14,20,89
3,15,13,2,1,20,5,4,0,63
3,15,13,2,1,20,5,18,0,77
3,15,13,2,1,20,5,18,19,96
3,15,13,2,1,20,9,14,7,84
3,15,13,2,1,20,9,22,5,90
3,15,13,2,1,20,19,0,0,73
3,15,13,2,1,20,20,5,4,83
3,15,13,2,1,20,20,5,18,97
3,15,13,2,5,4,0,0,0,42
3,15,13,2,5,18,0,0,0,56
3,15,13,2,5,18,19,0,0,75
3,15,13,2,6,9,19,8,0,75
3,15,13,2,25,0,0,0,0,58
3,15,13,2,9,14,1,14,20,91
3,15,13,2,9,14,1,20,5,82
3,15,13,2,9,14,4,0,0,60
3,15,13,2,9,14,5,0,0,61
3,15,13,2,9,14,5,4,0,65
3,15,13,2,9,14,5,18,0,79
3,15,13,2,9,14,5,18,19,98
3,15,13,2,9,14,5,19,0,80
3,15,13,2,9,14,7,0,0,63
3,15,13,2,9,14,7,19,0,82
3,15,13,2,9,14,9,14,7,86
3,15,13,2,9,20,5,0,0,67
3,15,13,2,12,5,0,0,0,50
3,15,13,2,12,5,19,19,0,88
3,15,13,2,12,9,11,5,0,70
3,15,13,2,13,1,11,5,18,81
3,15,13,2,15,0,0,0,0,48
3,15,13,2,15,25,0,0,0,73
3,15,13,2,15,12,15,9,15,99
3,15,13,2,15,19,0,0,0,67
3,15,13,2,18,5,0,0,0,56
3,15,13,2,21,18,5,0,0,77
3,15,13,2,21,18,5,14,20,111
3,15,13,2,21,19,20,0,0,93
3,15,13,2,21,19,20,5,4,102
3,15,13,2,21,19,20,15,18,126
3,15,13,2,21,19,20,19,0,112
3,15,13,2,23,9,19,5,0,89
3,15,13,4,0,0,0,0,0,35
3,15,13,4,7,0,0,0,0,42
3,15,13,4,9,1,0,0,0,45
3,15,13,5,0,0,0,0,0,36
3,15,13,5,2,1,3,11,0,53
3,15,13,5,2,1,3,11,19,72
3,15,13,5,4,4,12,5,0,61
3,15,13,5,4,25,0,0,0,65
3,15,13,5,4,9,1,0,0,50
3,15,13,5,4,9,1,12,0,62
3,15,13,5,4,9,1,14,0,64
3,15,13,5,4,9,1,14,19,83
3,15,13,5,4,9,1,14,20,84
3,15,13,5,4,9,3,0,0,52
3,15,13,5,4,9,3,1,12,65
3,15,13,5,4,9,5,19,0,73
3,15,13,5,4,9,19,20,0,88
3,15,13,5,4,15,0,0,0,55
3,15,13,5,4,15,14,5,19,93
3,15,13,5,4,15,19,0,0,74
3,15,13,5,4,15,23,14,0,92
3,15,13,5,4,15,23,14,19,111
3,15,13,5,12,25,0,0,0,73
3,15,13,5,12,9,5,18,0,80
3,15,13,5,12,9,5,19,20,101
3,15,13,5,12,9,12,25,0,94
3,15,13,5,12,9,14,7,0,78
3,15,13,5,14,4,9,20,5,88
3,15,13,5,14,9,3,0,0,62
3,15,13,5,18,19,0,0,0,73
3,15,13,5,19,0,0,0,0,55
3,15,13,5,19,20,9,15,14,113
3,15,13,5,20,0,0,0,0,56
3,15,13,5,20,1,18,25,0,100
3,15,13,5,20,1,18,9,1,85
3,15,13,5,20,8,0,0,0,64
3,15,13,5,20,8,5,18,0,87
3,15,13,5,20,8,5,18,19,106
3,15,13,5,20,9,3,0,0,68
3,15,13,5,20,9,3,1,12,81
3,15,13,5,20,12,9,11,5,93
3,15,13,5,20,15,9,4,0,84
3,15,13,5,20,19,0,0,0,75
3,15,13,5,20,23,9,19,5,112
3,15,13,6,25,0,0,0,0,62
3,15,13,6,9,5,18,0,0,69
3,15,13,6,9,5,19,20,0,90
3,15,13,6,9,12,25,0,0,83
3,15,13,6,9,14,5,19,19,103
3,15,13,6,9,20,0,0,0,66
3,15,13,6,9,20,19,0,0,85
3,15,13,6,9,20,21,18,5,110
3,15,13,6,15,18,20,5,4,99
3,15,13,6,15,18,20,19,0,109
3,15,13,6,18,5,25,19,0,104
3,15,13,9,3,0,0,0,0,43
3,15,13,9,3,1,12,0,0,56
3,15,13,9,3,1,12,12,25,93
3,15,13,9,3,5,19,0,0,67
3,15,13,9,3,18,25,0,0,86
3,15,13,9,3,19,0,0,0,62
3,15,13,9,4,1,0,0,0,45
3,15,13,9,14,7,0,0,0,61
3,15,13,9,14,7,12,5,0,78
3,15,13,9,14,7,19,0,0,80
3,15,13,9,14,15,0,0,0,69
3,15,13,9,17,21,5,0,0,83
3,15,13,9,19,13,0,0,0,72
3,15,13,9,20,1,12,0,0,73
3,15,13,9,20,1,14,20,0,95
3,15,13,9,20,1,20,21,19,121
3,15,13,9,20,5,0,0,0,65
3,15,13,9,20,5,19,0,0,84
3,15,13,9,20,25,0,0,0,85
3,15,13,9,20,9,1,0,0,70
3,15,13,9,20,9,1,12,0,82
3,15,13,9,20,9,5,19,0,93
3,15,13,9,20,9,22,1,0,92
3,15,13,9,20,10,5,0,0,75
3,15,13,9,24,0,0,0,0,64
3,15,13,12,0,0,0,0,0,43
3,15,13,13,1,0,0,0,0,45
3,15,13,13,1,5,19,0,0,69
3,15,13,13,1,9,14,7,0,75
3,15,13,13,1,14,4,0,0,63
3,15,13,13,1,14,4,5,4,72
3,15,13,13,1,14,4,5,18,86
3,15,13,13,1,14,4,15,0,78
3,15,13,13,1,14,4,15,19,97
3,15,13,13,1,14,4,18,25,106
3,15,13,13,1,14,4,19,0,82
3,15,13,13,1,18,11,0,0,74
3,15,13,13,1,19,0,0,0,64
3,15,13,13,1,19,19,5,5,93
3,15,13,13,1,20,1,0,0,66
3,15,13,13,1,20,9,3,0,77
3,15,13,13,1,20,9,15,14,103
3,15,13,13,1,20,9,19,13,106
3,15,13,13,5,0,0,0,0,49
3,15,13,13,5,4,4,12,5,74
3,15,13,13,5,13,0,0,0,62
3,15,13,13,5,14,3,5,0,71
3,15,13,13,5,14,3,5,4,75
3,15,13,13,5,14,3,5,18,89
3,15,13,13,5,14,3,5,19,90
3,15,13,13,5,14,4,0,0,67
3,15,13,13,5,14,4,1,0,68
3,15,13,13,5,14,4,1,13,81
3,15,13,13,5,14,4,5,4,76
3,15,13,13,5,14,4,5,18,90
3,15,13,13,5,14,4,19,0,86
3,15,13,13,5,14,19,1,12,95
3,15,13,13,5,14,20,0,0,83
3,15,13,13,5,14,20,5,4,92
3,15,13,13,5,14,20,5,18,106
3,15,13,13,5,14,20,19,0,102
3,15,13,13,5,18,3,5,4,79
3,15,13,13,5,18,3,5,18,93
3,15,13,13,5,18,3,5,19,94
3,15,13,13,5,18,3,9,1,80
3,15,13,13,5,18,7,5,0,79
3,15,13,13,5,18,19,0,0,86
3,15,13,13,5,19,19,15,0,102
3,15,13,13,25,0,0,0,0,69
3,15,13,13,9,5,0,0,0,58
3,15,13,13,9,5,19,0,0,77
3,15,13,13,9,14,1,20,5,93
3,15,13,13,9,14,7,12,5,91
3,15,13,13,9,14,21,20,5,113
3,15,13,13,9,19,0,0,0,72
3,15,13,13,9,19,3,5,0,80
3,15,13,13,9,19,5,0,0,77
3,15,13,13,9,19,19,1,18,110
3,15,13,13,9,20,0,0,0,73
3,15,13,13,9,20,19,0,0,92
3,15,13,13,9,20,20,1,12,106
3,15,13,13,9,20,20,5,4,102
3,15,13,13,9,20,20,5,5,103
3,15,13,13,9,20,20,5,18,116
3,15,13,13,9,20,20,15,18,126
3,15,13,13,9,24,0,0,0,77
3,15,13,13,9,24,5,4,0,86
3,15,13,13,9,24,5,19,0,101
3,15,13,13,9,24,9,14,7,107
3,15,13,13,9,24,20,0,0,97
3,15,13,13,15,0,0,0,0,59
3,15,13,13,15,4,1,20,1,85
3,15,13,13,15,4,1,20,5,89
3,15,13,13,15,4,5,0,0,68
3,15,13,13,15,4,5,19,0,87
3,15,13,13,15,4,9,20,25,117
3,15,13,13,15,4,15,18,5,101
3,15,13,13,15,9,7,14,5,94
3,15,13,13,15,14,0,0,0,73
3,15,13,13,15,14,1,7,5,86
3,15,13,13,15,14,5,4,0,82
3,15,13,13,15,14,5,25,0,103
3,15,13,13,15,14,5,18,0,96
3,15,13,13,15,14,5,18,19,115
3,15,13,13,15,14,5,19,20,117
3,15,13,13,15,14,9,14,7,103
3,15,13,13,15,14,9,19,8,109
3,15,13,13,15,14,9,26,5,113
3,15,13,13,15,14,12,25,0,110
3,15,13,13,15,14,20,25,0,118
3,15,13,13,15,18,1,14,20,112
3,15,13,13,15,18,19,5,0,101
3,15,13,13,15,18,20,8,0,105
3,15,13,13,15,19,0,0,0,78
3,15,13,13,15,20,0,0,0,79
3,15,13,13,15,20,5,0,0,84
3,15,13,13,15,20,9,15,14,117
3,15,13,13,15,20,9,22,5,115
3,15,13,13,15,22,5,0,0,86
3,15,13,13,15,22,5,4,0,90
3,15,13,13,15,22,5,19,0,105
3,15,13,13,15,22,9,14,7,111
3,15,13,13,21,14,1,0,0,80
3,15,13,13,21,14,1,12,0,92
3,15,13,13,21,14,2,21,19,121
3,15,13,13,21,14,5,4,0,88
3,15,13,13,21,14,5,18,0,102
3,15,13,13,21,14,5,19,0,103
3,15,13,13,21,14,9,14,7,109
3,15,13,13,21,14,9,17,21,126
3,15,13,13,21,14,9,19,0,107
3,15,13,13,21,14,9,19,5,112
3,15,13,13,21,14,9,19,13,120
3,15,13,13,21,14,9,20,25,133
3,15,13,13,21,14,9,26,5,119
3,15,13,13,21,20,1,14,20,120
3,15,13,13,21,20,1,20,5,111
3,15,13,13,21,20,5,0,0,90
3,15,13,13,21,20,5,4,0,94
3,15,13,13,21,20,5,18,0,108
3,15,13,13,21,20,5,18,19,127
3,15,13,13,21,20,5,19,0,109
3,15,13,13,21,20,9,14,7,115
3,15,13,13,21,20,21,1,12,119
3,15,13,15,4,1,20,15,0,86
3,15,13,15,4,15,0,0,0,65
3,15,13,15,5,4,9,1,0,65
3,15,13,15,5,4,21,19,0,95
3,15,13,15,9,4,0,0,0,59
3,15,13,15,14,15,13,5,18,111
3,15,13,15,14,20,5,0,0,85
3,15,13,15,17,21,5,18,0,107
3,15,13,15,18,1,4,15,0,84
3,15,13,15,19,5,0,0,0,70
3,15,13,15,21,18,14,0,0,99
3,15,13,15,21,18,14,5,18,122
3,15,13,15,21,19,0,0,0,86
3,15,13,16,0,0,0,0,0,47
3,15,13,16,1,1,0,0,0,49
3,15,13,16,1,3,20,5,4,80
3,15,13,16,1,3,20,5,18,94
3,15,13,16,1,3,20,12,25,108
3,15,13,16,1,3,20,15,18,104
3,15,13,16,1,3,20,19,0,90
3,15,13,16,1,4,18,5,0,75
3,15,13,16,1,4,18,5,19,94
3,15,13,16,1,7,5,0,0,60
3,15,13,16,1,7,5,19,0,79
3,15,13,16,1,14,1,7,5,75
3,15,13,16,1,14,4,5,18,89
3,15,13,16,1,14,5,18,15,100
3,15,13,16,1,14,25,0,0,87
3,15,13,16,1,14,9,1,0,72
3,15,13,16,1,14,9,1,19,91
3,15,13,16,1,14,9,5,4,80
3,15,13,16,1,14,9,5,19,95
3,15,13,16,1,14,9,15,14,100
3,15,13,16,1,18,0,0,0,66
3,15,13,16,1,18,1,20,5,92
3,15,13,16,1,18,5,0,0,71
3,15,13,16,1,18,5,4,0,75
3,15,13,16,1,18,5,18,0,89
3,15,13,16,1,18,5,18,19,108
3,15,13,16,1,18,5,19,0,90
3,15,13,16,1,18,9,14,7,96
3,15,13,16,1,18,19,1,0,86
3,15,13,16,1,18,20,0,0,86
3,15,13,16,1,18,20,5,4,95
3,15,13,16,1,18,20,19,0,105
3,15,13,16,1,19,19,0,0,86
3,15,13,16,1,19,19,5,4,95
3,15,13,16,1,19,19,5,18,109
3,15,13,16,1,20,8,25,0,101
3,15,13,16,4,0,0,0,0,51
3,15,13,16,5,1,18,0,0,71
3,15,13,16,5,4,0,0,0,56
3,15,13,16,5,5,18,0,0,75
3,15,13,16,5,5,18,5,4,84
3,15,13,16,5,5,18,19,0,94
3,15,13,16,5,12,0,0,0,64
3,15,13,16,5,12,12,5,4,85
3,15,13,16,5,12,12,5,18,99
3,15,13,16,5,12,19,0,0,83
3,15,13,16,5,14,4,0,0,70
3,15,13,16,5,14,4,9,1,80
3,15,13,16,5,14,4,19,0,89
3,15,13,16,5,14,19,5,0,90
3,15,13,16,5,14,19,5,18,108
3,15,13,16,5,18,5,0,0,75
3,15,13,16,5,18,5,4,0,79
3,15,13,16,5,18,5,19,0,94
3,15,13,16,5,18,9,14,7,100
3,15,13,16,5,18,20,0,0,90
3,15,13,16,5,19,3,5,0,79
3,15,13,16,5,19,20,5,18,114
3,15,13,16,5,20,5,0,0,77
3,15,13,16,5,20,5,4,0,81
3,15,13,16,5,20,5,14,20,111
3,15,13,16,5,20,5,18,0,95
3,15,13,16,5,20,5,19,0,96
3,15,13,16,5,20,9,14,7,102
3,15,13,16,9,12,5,0,0,73
3,15,13,16,9,12,5,4,0,77
3,15,13,16,9,12,5,18,0,91
3,15,13,16,9,12,5,18,19,110
3,15,13,16,9,12,5,19,0,92
3,15,13,16,9,12,9,14,7,98
3,15,13,16,9,14,7,0,0,77
3,15,13,16,9,14,7,5,0,82
3,15,13,16,9,20,1,12,0,89
3,15,13,16,9,20,21,13,0,110
3,15,13,16,12,1,9,14,0,83
3,15,13,16,12,1,9,14,19,102
3,15,13,16,12,1,9,14,20,103
3,15,13,16,12,1,14,1,18,93
3,15,13,16,12,1,14,20,0,94
3,15,13,16,12,5,1,20,0,85
3,15,13,16,12,5,3,20,0,87
3,15,13,16,12,5,3,20,19,106
3,15,13,16,12,5,20,5,0,89
3,15,13,16,12,5,20,5,4,93
3,15,13,16,12,5,20,5,18,107
3,15,13,16,12,5,20,5,19,108
3,15,13,16,12,5,24,0,0,88
3,15,13,16,12,5,24,5,4,97
3,15,13,16,12,5,24,5,18,111
3,15,13,16,12,5,24,5,19,112
3,15,13,16,12,5,24,12,25,125
3,15,13,16,12,5,24,21,19,128
3,15,13,16,12,25,0,0,0,84
3,15,13,16,12,9,1,14,20,103
3,15,13,16,12,9,3,5,0,76
3,15,13,16,12,9,3,5,19,95
3,15,13,16,12,9,5,4,0,77
3,15,13,16,12,9,5,18,0,91
3,15,13,16,12,9,5,18,19,110
3,15,13,16,12,9,5,19,0,92
3,15,13,16,12,25,9,14,7,114
3,15,13,16,12,9,14,0,0,82
3,15,13,16,12,9,14,5,0,87
3,15,13,16,12,9,14,5,19,106
3,15,13,16,12,9,14,19,0,101
3,15,13,16,12,9,19,8,0,95
3,15,13,16,12,15,20,0,0,94
3,15,13,16,12,15,20,19,0,113
3,15,13,16,12,21,22,9,1,112
3,15,13,16,15,0,0,0,0,62
3,15,13,16,15,5,4,0,0,71
3,15,13,16,15,5,18,0,0,85
3,15,13,16,15,9,14,7,0,92
3,15,13,16,15,12,5,0,0,79
3,15,13,16,15,14,5,0,0,81
3,15,13,16,15,14,5,4,0,85
3,15,13,16,15,14,5,14,20,115
3,15,13,16,15,14,25,0,0,101
3,15,13,16,15,18,20,0,0,100
3,15,13,16,15,18,20,5,4,109
3,15,13,16,15,18,20,19,0,119
3,15,13,16,15,19,0,0,0,81
3,15,13,16,15,19,1,12,0,94
3,15,13,16,15,19,1,14,20,116
3,15,13,16,15,19,5,0,0,86
3,15,13,16,15,19,5,4,0,90
3,15,13,16,15,19,5,18,0,104
3,15,13,16,15,19,5,18,19,123
3,15,13,16,15,19,5,19,0,105
3,15,13,16,15,19,9,14,7,111
3,15,13,16,15,19,9,20,0,110
3,15,13,16,15,19,9,20,1,111
3,15,13,16,15,19,9,20,5,115
3,15,13,16,15,19,20,0,0,101
3,15,13,16,15,19,20,5,4,110
3,15,13,16,15,19,20,19,0,120
3,15,13,16,15,19,21,18,5,125
3,15,13,16,15,20,0,0,0,82
3,15,13,16,15,20,5,0,0,87
3,15,13,16,15,20,5,19,0,106
3,15,13,16,15,20,9,5,18,114
3,15,13,16,15,20,15,18,0,115
3,15,13,16,15,21,14,4,0,101
3,15,13,16,15,21,14,4,19,120
3,15,13,16,18,1,4,15,18,103
3,15,13,16,18,5,7,0,0,77
3,15,13,16,18,5,14,4,0,88
3,15,13,16,18,5,19,19,0,108
3,15,13,16,18,5,19,20,0,109
3,15,13,16,18,9,5,19,20,118
3,15,13,16,18,9,14,20,0,108
3,15,13,16,18,9,19,1,12,106
3,15,13,16,18,9,19,5,0,98
3,15,13,16,18,9,19,5,4,102
3,15,13,16,18,9,19,5,19,117
3,15,13,16,18,9,26,1,12,113
3,15,13,16,18,9,26,5,0,105
3,15,13,16,18,9,26,5,4,109
3,15,13,16,18,9,26,5,19,124
3,15,13,16,18,15,13,9,19,121
3,15,13,16,18,15,13,9,20,122
3,15,13,16,19,0,0,0,0,66
3,15,13,16,20,0,0,0,0,67
3,15,13,16,20,5,4,0,0,76
3,15,13,16,20,5,18,0,0,90
3,15,13,16,20,9,2,12,5,95
3,15,13,16,20,9,5,0,0,81
3,15,13,16,20,9,14,7,0,97
3,15,13,16,20,12,25,0,0,104
3,15,13,16,20,14,5,19,19,124
3,15,13,16,20,15,9,18,0,109
3,15,13,16,20,18,15,12,0,112
3,15,13,16,20,19,0,0,0,86
3,15,13,16,21,12,19,5,0,104
3,15,13,16,21,12,19,5,4,108
3,15,13,16,21,14,3,20,0,105
3,15,13,16,21,16,9,12,0,105
3,15,13,16,21,20,1,20,5,114
3,15,13,16,21,20,5,0,0,93
3,15,13,16,21,20,5,4,0,97
3,15,13,16,21,20,5,18,0,111
3,15,13,16,21,20,5,18,19,130
3,15,13,16,21,20,5,19,0,112
3,15,13,16,21,20,9,14,7,118
3,15,13,16,21,20,9,19,20,136
3,15,13,16,21,20,21,19,0,128
3,15,13,18,1,4,5,0,0,59
3,15,13,18,1,4,5,12,25,96
3,15,13,18,1,4,5,18,25,102
3,15,13,18,1,4,5,19,0,78
3,15,13,18,1,4,15,0,0,69
3,15,13,18,15,7,21,5,0,97
3,15,13,19,25,13,16,0,0,104
3,15,13,19,25,13,16,19,0,123
3,15,13,20,5,19,0,0,0,75
3,15,13,20,5,19,19,5,19,118
3,15,13,21,14,9,4,1,4,84
3,15,13,22,9,1,0,0,0,63
3,15,14,1,2,12,5,0,0,52
3,15,14,1,3,1,19,20,5,81
3,15,14,1,3,18,5,0,0,59
3,15,14,1,13,1,18,9,14,88
3,15,14,1,13,5,4,0,0,55
3,15,14,1,14,4,0,0,0,51
3,15,14,1,18,9,1,12,0,73
3,15,14,1,18,9,21,13,0,94
3,15,14,1,20,9,15,14,0,91
3,15,14,1,20,9,15,14,19,110
3,15,14,1,20,9,22,5,0,89
3,15,14,1,20,21,18,1,12,105
3,15,14,1,20,21,19,0,0,93
3,15,14,1,24,9,1,12,0,79
3,15,14,2,9,14,1,19,0,77
3,15,14,3,0,0,0,0,0,35
3,15,14,3,1,14,14,15,14,93
3,15,14,3,1,21,19,1,12,89
3,15,14,3,1,21,19,5,0,81
3,15,14,3,1,22,5,0,0,63
3,15,14,3,1,22,5,4,0,67
3,15,14,3,1,22,5,12,25,100
3,15,14,3,1,22,5,18,0,81
3,15,14,3,1,22,5,19,0,82
3,15,14,3,1,22,9,14,7,88
3,15,14,3,1,22,9,20,25,112
3,15,14,3,1,22,15,0,0,73
3,15,14,3,5,1,12,0,0,53
3,15,14,3,5,1,12,5,4,62
3,15,14,3,5,1,12,5,18,76
3,15,14,3,5,1,12,19,0,72
3,15,14,3,5,4,5,0,0,49
3,15,14,3,5,4,5,4,0,53
3,15,14,3,5,4,5,18,0,67
3,15,14,3,5,4,5,18,19,86
3,15,14,3,5,4,5,19,0,68
3,15,14,3,5,4,9,14,7,74
3,15,14,3,5,9,20,0,0,69
3,15,14,3,5,9,20,5,4,78
3,15,14,3,5,9,20,25,0,94
3,15,14,3,5,9,20,19,0,88
3,15,14,3,5,9,22,5,0,76
3,15,14,3,5,9,22,5,4,80
3,15,14,3,5,9,22,5,18,94
3,15,14,3,5,9,22,5,19,95
3,15,14,3,5,14,20,0,0,74
3,15,14,3,5,14,20,5,18,97
3,15,14,3,5,14,20,15,0,89
3,15,14,3,5,14,20,18,5,97
3,15,14,3,5,14,20,19,0,93
3,15,14,3,5,14,20,21,19,114
3,15,14,3,5,16,20,0,0,76
3,15,14,3,5,16,20,19,0,95
3,15,14,3,5,16,20,21,19,116
3,15,14,3,5,18,14,0,0,72
3,15,14,3,5,18,14,5,4,81
3,15,14,3,5,18,14,19,0,91
3,15,14,3,5,18,20,0,0,78
3,15,14,3,5,18,20,5,4,87
3,15,14,3,5,18,20,9,0,87
3,15,14,3,5,18,20,15,0,93
3,15,14,3,5,18,20,15,19,112
3,15,14,3,5,18,20,19,0,97
3,15,14,3,5,19,19,9,20,107
3,15,14,3,5,19,19,15,18,111
3,15,14,3,5,20,20,9,0,89
3,15,14,3,5,20,20,15,0,95
3,15,14,3,8,0,0,0,0,43
3,15,14,3,8,1,5,0,0,49
3,15,14,3,8,1,12,0,0,56
3,15,14,3,8,1,20,5,0,69
3,15,14,3,8,5,0,0,0,48
3,15,14,3,8,5,4,0,0,52
3,15,14,3,8,5,18,0,0,66
3,15,14,3,8,5,19,0,0,67
3,15,14,3,8,6,9,19,8,85
3,15,14,3,8,25,0,0,0,68
3,15,14,3,8,9,5,0,0,57
3,15,14,3,8,9,5,19,0,76
3,15,14,3,8,25,12,5,0,85
3,15,14,3,8,25,12,9,1,90
3,15,14,3,8,9,14,9,14,89
3,15,14,3,8,9,20,5,0,77
3,15,14,3,8,9,20,9,3,84
3,15,14,3,8,9,20,9,19,100
3,15,14,3,8,15,9,4,0,71
3,15,14,3,8,15,9,4,19,90
3,15,14,3,8,15,12,0,0,70
3,15,14,3,8,19,0,0,0,62
3,15,14,3,8,21,5,12,1,82
3,15,14,3,9,1,20,15,18,98
3,15,14,3,25,3,12,9,3,87
3,15,14,3,9,5,18,7,5,79
3,15,14,3,9,12,5,0,0,61
3,15,14,3,9,12,9,1,18,84
3,15,14,3,9,12,9,21,13,99
3,15,14,3,9,15,0,0,0,59
3,15,14,3,9,15,14,0,0,73
3,15,14,3,9,15,14,1,12,86
3,15,14,3,9,19,5,0,0,68
3,15,14,3,9,19,5,12,25,105
3,15,14,3,9,19,5,18,0,86
3,15,14,3,9,19,5,19,20,107
3,15,14,3,9,19,9,15,14,101
3,15,14,3,9,20,5,0,0,69
3,15,14,3,12,1,22,5,0,75
3,15,14,3,12,1,22,5,19,94
3,15,14,3,12,21,4,5,0,77
3,15,14,3,12,21,4,5,4,81
3,15,14,3,12,21,4,5,18,95
3,15,14,3,12,21,4,5,19,96
3,15,14,3,12,21,19,21,13,121
3,15,14,3,14,0,0,0,0,49
3,15,14,3,15,3,20,0,0,73
3,15,14,3,15,3,20,5,4,82
3,15,14,3,15,3,20,5,18,96
3,15,14,3,15,3,20,15,18,106
3,15,14,3,15,3,20,19,0,92
3,15,14,3,15,12,15,18,0,95
3,15,14,3,15,12,15,21,18,116
3,15,14,3,15,18,4,1,12,85
3,15,14,3,15,18,4,1,20,93
3,15,14,3,15,18,4,5,18,95
3,15,14,3,15,18,4,12,25,109
3,15,14,3,15,18,4,19,0,91
3,15,14,3,15,21,18,19,0,108
3,15,14,3,15,21,18,19,5,113
3,15,14,3,18,5,1,20,5,84
3,15,14,3,18,5,4,9,20,91
3,15,14,3,18,5,19,3,5,85
3,15,14,3,18,5,20,5,0,83
3,15,14,3,18,5,20,5,4,87
3,15,14,3,18,5,20,5,18,101
3,15,14,3,18,5,20,5,19,102
3,15,14,3,18,5,20,15,18,111
3,15,14,3,18,5,23,0,0,81
3,15,14,3,18,6,19,3,5,86
3,15,14,3,21,2,9,14,5,86
3,15,14,3,21,16,25,0,0,97
3,15,14,3,21,18,0,0,0,74
3,15,14,3,21,18,2,9,20,105
3,15,14,3,21,18,18,5,4,101
3,15,14,3,21,18,19,0,0,93
3,15,14,3,21,18,19,15,0,108
3,15,14,3,21,18,19,21,19,133
3,15,14,3,21,19,19,0,0,94
3,15,14,3,21,19,19,5,4,103
3,15,14,3,21,19,19,5,19,118
3,15,14,4,5,3,5,14,20,83
3,15,14,4,5,13,14,0,0,68
3,15,14,4,5,13,14,5,4,77
3,15,14,4,5,13,14,5,18,91
3,15,14,4,5,13,14,15,18,101
3,15,14,4,5,13,14,19,0,87
3,15,14,4,5,14,19,5,0,79
3,15,14,4,5,14,19,5,4,83
3,15,14,4,5,14,19,5,18,97
3,15,14,4,5,14,19,5,19,98
3,15,14,4,5,18,0,0,0,59
3,15,14,4,9,4,4,12,5,70
3,15,14,4,9,7,14,0,0,66
3,15,14,4,9,7,14,12,25,103
3,15,14,4,25,12,1,18,0,92
3,15,14,4,25,12,5,0,0,78
3,15,14,4,25,12,5,19,0,97
3,15,14,4,25,12,9,15,14,111
3,15,14,4,25,12,15,9,4,101
3,15,14,4,25,12,15,13,1,102
3,15,14,4,25,12,15,13,5,106
3,15,14,4,25,12,15,19,0,107
3,15,14,4,25,12,21,18,5,117
3,15,14,4,9,13,5,14,20,97
3,15,14,4,9,20,5,0,0,70
3,15,14,4,9,20,9,15,14,103
3,15,14,4,9,20,15,18,25,123
3,15,14,4,15,0,0,0,0,51
3,15,14,4,15,5,19,0,0,75
3,15,14,4,15,7,0,0,0,58
3,15,14,4,15,12,5,0,0,68
3,15,14,4,15,12,5,4,0,72
3,15,14,4,15,12,5,14,20,102
3,15,14,4,15,12,5,18,0,86
3,15,14,4,15,12,5,18,19,105
3,15,14,4,15,12,5,19,0,87
3,15,14,4,15,12,9,14,7,93
3,15,14,4,15,13,0,0,0,64
3,15,14,4,15,13,19,0,0,83
3,15,14,4,15,14,5,0,0,70
3,15,14,4,15,14,5,4,0,74
3,15,14,4,15,14,5,18,0,88
3,15,14,4,15,14,5,18,19,107
3,15,14,4,15,14,5,19,0,89
3,15,14,4,15,14,9,14,7,95
3,15,14,4,15,18,0,0,0,69
3,15,14,4,15,18,5,19,0,93
3,15,14,4,15,18,19,0,0,88
3,15,14,4,15,19,0,0,0,70
3,15,14,4,21,3,5,0,0,65
3,15,14,4,21,3,5,4,0,69
3,15,14,4,21,3,5,14,20,99
3,15,14,4,21,3,5,18,0,83
3,15,14,4,21,3,5,18,19,102
3,15,14,4,21,3,5,19,0,84
3,15,14,4,21,3,9,14,7,90
3,15,14,4,21,3,9,22,5,96
3,15,14,4,21,3,20,0,0,80
3,15,14,4,21,3,20,1,0,81
3,15,14,4,21,3,20,5,4,89
3,15,14,4,21,3,20,9,15,104
3,15,14,4,21,3,20,15,18,113
3,15,14,4,21,3,20,19,0,99
3,15,14,4,21,3,20,21,19,120
3,15,14,4,21,5,0,0,0,62
3,15,14,4,21,9,20,0,0,86
3,15,14,4,21,9,20,19,0,105
3,15,14,5,0,0,0,0,0,37
3,15,14,5,4,0,0,0,0,41
3,15,14,5,5,14,0,0,0,56
3,15,14,5,8,5,1,4,0,55
3,15,14,5,9,14,5,0,0,65
3,15,14,5,25,19,0,0,0,81
3,15,14,5,12,5,20,0,0,74
3,15,14,5,12,9,11,5,0,74
3,15,14,5,12,18,1,4,19,91
3,15,14,5,13,1,11,5,18,85
3,15,14,5,14,15,19,5,0,90
3,15,14,5,14,15,19,5,19,109
3,15,14,5,16,1,20,5,0,79
3,15,14,5,16,1,20,5,19,98
3,15,14,5,16,1,20,12,0,86
3,15,14,5,16,1,20,12,19,105
3,15,14,5,18,0,0,0,0,55
3,15,14,5,19,0,0,0,0,56
3,15,14,5,19,19,9,14,5,103
3,15,14,6,0,0,0,0,0,38
3,15,14,6,1,2,0,0,0,41
3,15,14,6,1,2,2,5,4,52
3,15,14,6,1,2,19,0,0,60
3,15,14,6,1,3,20,0,0,62
3,15,14,6,1,20,5,4,0,68
3,15,14,6,5,3,20,0,0,66
3,15,14,6,5,3,20,5,4,75
3,15,14,6,5,3,20,19,0,85
3,15,14,6,5,4,5,18,0,70
3,15,14,6,5,18,0,0,0,61
3,15,14,6,5,18,5,5,0,71
3,15,14,6,5,18,5,5,19,90
3,15,14,6,5,18,18,1,12,92
3,15,14,6,5,18,18,5,4,88
3,15,14,6,5,18,18,5,5,89
3,15,14,6,5,18,18,5,18,102
3,15,14,6,5,18,19,0,0,80
3,15,14,6,5,18,20,5,4,90
3,15,14,6,5,18,22,1,5,89
3,15,14,6,5,18,22,1,12,96
3,15,14,6,5,18,22,1,19,103
3,15,14,6,5,19,19,0,0,81
3,15,14,6,5,19,19,5,4,90
3,15,14,6,5,19,19,5,18,104
3,15,14,6,5,19,19,5,19,105
3,15,14,6,5,19,19,15,18,114
3,15,14,6,5,19,20,0,0,82
3,15,14,6,5,20,20,9,0,92
3,15,14,6,5,20,20,15,0,98
3,15,14,6,9,4,1,14,20,86
3,15,14,6,9,4,5,0,0,56
3,15,14,6,9,4,5,4,0,60
3,15,14,6,9,4,5,14,20,90
3,15,14,6,9,4,5,18,0,74
3,15,14,6,9,4,5,18,19,93
3,15,14,6,9,4,5,19,0,75
3,15,14,6,9,4,9,14,7,81
3,15,14,6,9,7,21,18,5,98
3,15,14,6,9,14,5,0,0,66
3,15,14,6,9,14,5,4,0,70
3,15,14,6,9,14,5,18,0,84
3,15,14,6,9,14,5,18,19,103
3,15,14,6,9,14,5,19,0,85
3,15,14,6,9,14,9,14,7,91
3,15,14,6,9,14,9,20,25,115
3,15,14,6,9,18,13,0,0,78
3,15,14,6,9,18,13,5,4,87
3,15,14,6,9,18,13,5,5,88
3,15,14,6,9,18,13,5,18,101
3,15,14,6,9,18,13,15,18,111
3,15,14,6,9,18,13,19,0,97
3,15,14,6,9,19,11,0,0,77
3,15,14,6,9,20,0,0,0,67
3,15,14,6,9,20,5,14,20,106
3,15,14,6,9,20,21,18,5,111
3,15,14,6,9,24,0,0,0,71
3,15,14,6,9,24,5,4,0,80
3,15,14,6,9,24,9,14,7,101
3,15,14,6,12,1,2,0,0,53
3,15,14,6,12,1,20,5,0,76
3,15,14,6,12,1,20,5,4,80
3,15,14,6,12,1,20,5,19,95
3,15,14,6,12,9,3,20,0,82
3,15,14,6,12,9,3,20,19,101
3,15,14,6,12,15,23,0,0,88
3,15,14,6,12,21,5,14,20,110
3,15,14,6,12,21,24,0,0,95
3,15,14,6,12,21,24,5,19,119
3,15,14,6,15,3,1,12,0,69
3,15,14,6,15,18,13,0,0,84
3,15,14,6,15,18,13,1,12,97
3,15,14,6,15,18,13,5,4,93
3,15,14,6,15,18,13,5,18,107
3,15,14,6,15,18,13,19,0,103
3,15,14,6,15,18,20,0,0,91
3,15,14,6,15,21,14,4,0,92
3,15,14,6,15,21,14,4,19,111
3,15,14,6,18,0,0,0,0,56
3,15,14,6,18,1,3,20,0,80
3,15,14,6,18,1,20,5,18,100
3,15,14,6,18,5,18,5,0,84
3,15,14,6,18,5,18,5,19,103
3,15,14,6,18,5,18,9,5,93
3,15,14,6,18,9,1,18,0,84
3,15,14,6,18,15,14,20,0,105
3,15,14,6,18,15,14,20,5,110
3,15,14,6,18,15,14,20,19,124
3,15,14,6,21,19,5,0,0,83
3,15,14,6,21,19,5,4,0,87
3,15,14,6,21,19,5,18,0,101
3,15,14,6,21,19,5,18,19,120
3,15,14,6,21,19,5,19,0,102
3,15,14,6,21,19,9,14,7,108
3,15,14,6,21,19,9,15,14,116
3,15,14,6,21,19,9,22,5,114
3,15,14,6,21,20,5,0,0,84
3,15,14,6,21,20,5,4,0,88
3,15,14,6,21,20,5,18,0,102
3,15,14,6,21,20,5,18,19,121
3,15,14,6,21,20,5,19,0,103
3,15,14,6,21,20,9,14,7,109
3,15,14,7,1,0,0,0,0,40
3,15,14,7,1,5,4,0,0,49
3,15,14,7,1,9,14,7,0,70
3,15,14,7,1,19,0,0,0,59
3,15,14,7,5,0,0,0,0,44
3,15,14,7,5,1,2,12,5,64
3,15,14,7,5,1,12,0,0,57
3,15,14,7,5,1,12,5,4,66
3,15,14,7,5,1,12,5,18,80
3,15,14,7,5,1,12,19,0,76
3,15,14,7,5,4,0,0,0,48
3,15,14,7,5,5,0,0,0,49
3,15,14,7,5,5,4,0,0,53
3,15,14,7,5,5,9,14,7,79
3,15,14,7,5,5,19,0,0,68
3,15,14,7,5,9,14,7,0,74
3,15,14,7,5,14,5,18,0,81
3,15,14,7,5,14,5,18,19,100
3,15,14,7,5,14,9,1,12,80
3,15,14,7,5,14,9,20,5,92
3,15,14,7,5,15,14,0,0,73
3,15,14,7,5,18,5,5,0,72
3,15,14,7,5,18,25,0,0,87
3,15,14,7,5,18,9,5,0,76
3,15,14,7,5,18,9,5,19,95
3,15,14,7,5,19,0,0,0,63
3,15,14,7,5,19,20,0,0,83
3,15,14,7,5,19,20,5,4,92
3,15,14,7,5,19,20,19,0,102
3,15,14,7,5,19,20,21,19,123
3,15,14,7,9,1,18,25,0,92
3,15,14,7,9,9,0,0,0,57
3,15,14,7,9,21,19,0,0,88
3,15,14,7,12,15,2,5,0,73
3,15,14,7,12,15,2,5,4,77
3,15,14,7,12,15,2,5,19,92
3,15,14,7,12,21,20,9,14,115
3,15,14,7,15,5,19,0,0,78
3,15,14,7,15,14,9,0,0,77
3,15,14,7,15,19,0,0,0,73
3,15,14,7,15,21,0,0,0,75
3,15,14,7,15,21,19,0,0,94
3,15,14,7,18,1,20,19,0,97
3,15,14,7,18,5,5,0,0,67
3,15,14,7,18,5,5,20,0,87
3,15,14,7,18,9,4,0,0,70
3,15,14,7,18,9,15,0,0,81
3,15,14,7,18,15,9,4,0,85
3,15,14,7,18,21,5,0,0,83
3,15,14,7,18,21,5,14,20,117
3,15,14,7,18,21,9,19,13,119
3,15,14,7,18,21,9,19,20,126
3,15,14,7,18,21,9,20,25,132
3,15,14,7,18,21,15,21,19,133
3,15,14,8,25,4,18,9,14,110
3,15,14,9,0,0,0,0,0,41
3,15,14,9,1,0,0,0,0,42
3,15,14,9,3,0,0,0,0,44
3,15,14,9,3,1,12,0,0,57
3,15,14,9,3,1,12,12,25,94
3,15,14,9,3,5,9,14,0,72
3,15,14,9,3,5,9,14,5,77
3,15,14,9,3,9,14,5,0,72
3,15,14,9,3,9,20,25,0,98
3,15,14,9,3,12,5,0,0,61
3,15,14,9,3,15,9,4,0,72
3,15,14,9,3,19,0,0,0,63
3,15,14,9,4,9,1,0,0,55
3,15,14,9,4,9,1,12,0,67
3,15,14,9,4,9,1,14,0,69
3,15,14,9,4,9,15,9,4,82
3,15,14,9,4,9,21,13,0,88
3,15,14,9,5,19,0,0,0,65
3,15,14,9,6,5,18,0,0,70
3,15,14,9,6,5,18,9,14,93
3,15,14,9,6,5,18,19,0,89
3,15,14,9,6,15,18,13,0,93
3,15,14,25,7,5,18,0,0,87
3,15,14,9,9,14,5,0,0,69
3,15,14,9,9,14,5,19,0,88
3,15,14,25,12,5,14,5,0,93
3,15,14,9,13,1,0,0,0,55
3,15,14,9,13,5,14,5,0,78
3,15,14,9,14,0,0,0,0,55
3,15,14,9,14,5,0,0,0,60
3,15,14,9,14,5,19,0,0,79
3,15,14,9,14,7,0,0,0,62
3,15,14,25,14,7,5,0,0,83
3,15,14,9,14,9,4,9,1,78
3,15,14,9,14,19,0,0,0,74
3,15,14,9,15,12,15,7,25,115
3,15,14,9,15,19,5,19,0,99
3,15,14,9,15,19,9,19,0,103
3,15,14,25,18,9,14,0,0,98
3,15,14,25,18,9,14,5,0,103
3,15,14,9,19,1,14,3,5,83
3,15,14,9,20,5,0,0,0,66
3,15,14,9,21,13,19,0,0,94
3,15,14,25,26,1,0,0,0,84
3,15,14,10,0,0,0,0,0,42
3,15,14,10,5,3,20,0,0,70
3,15,14,10,5,5,0,0,0,52
3,15,14,10,15,2,2,12,5,78
3,15,14,10,15,9,14,0,0,80
3,15,14,10,15,9,14,5,4,89
3,15,14,10,15,9,14,5,18,103
3,15,14,10,15,9,14,19,0,99
3,15,14,10,15,9,14,20,0,100
3,15,14,10,15,9,14,20,19,119
3,15,14,10,15,14,0,0,0,71
3,15,14,10,21,7,1,3,25,99
3,15,14,10,21,7,1,12,0,83
3,15,14,10,21,7,1,14,20,105
3,15,14,10,21,7,1,20,1,92
3,15,14,10,21,7,1,20,5,96
3,15,14,10,21,7,9,1,12,92
3,15,14,10,21,7,9,21,13,113
3,15,14,10,21,14,3,20,0,100
3,15,14,10,21,14,3,20,19,119
3,15,14,10,21,18,5,0,0,86
3,15,14,10,21,18,5,4,0,90
3,15,14,10,21,18,5,18,0,104
3,15,14,10,21,18,5,18,19,123
3,15,14,10,21,18,5,19,0,105
3,15,14,10,21,18,25,0,0,106
3,15,14,10,21,18,9,14,7,111
3,15,14,10,21,18,15,18,0,114
3,15,14,10,21,18,15,18,19,133
3,15,14,11,0,0,0,0,0,43
3,15,14,11,1,14,5,5,0,68
3,15,14,11,5,4,0,0,0,52
3,15,14,11,5,18,0,0,0,66
3,15,14,11,5,18,19,0,0,85
3,15,14,11,25,0,0,0,0,68
3,15,14,11,9,14,7,0,0,73
3,15,14,11,19,0,0,0,0,62
3,15,14,12,9,0,0,0,0,53
3,15,14,14,1,3,8,0,0,58
3,15,14,14,1,18,9,20,5,99
3,15,14,14,1,20,1,12,0,80
3,15,14,14,1,20,5,0,0,72
3,15,14,14,1,20,5,12,25,109
3,15,14,14,1,20,9,15,14,105
3,15,14,14,1,20,21,18,5,111
3,15,14,14,5,3,20,0,0,74
3,15,14,14,5,3,20,5,4,83
3,15,14,14,5,3,20,5,18,97
3,15,14,14,5,3,20,15,18,107
3,15,14,14,5,3,20,19,0,93
3,15,14,14,5,4,0,0,0,55
3,15,14,14,5,24,0,0,0,75
3,15,14,14,5,24,5,19,0,99
3,15,14,14,5,24,9,15,14,113
3,15,14,14,5,24,9,20,25,129
3,15,14,14,5,24,9,22,1,107
3,15,14,14,5,24,9,22,5,111
3,15,14,14,5,24,21,18,5,119
3,15,14,14,5,24,21,19,0,115
3,15,14,14,9,5,19,0,0,79
3,15,14,14,9,14,7,0,0,76
3,15,14,14,9,22,1,14,20,112
3,15,14,14,9,22,5,0,0,82
3,15,14,14,9,22,5,4,0,86
3,15,14,14,9,22,5,14,20,116
3,15,14,14,9,22,5,18,0,100
3,15,14,14,9,22,5,18,25,125
3,15,14,14,9,22,5,18,19,119
3,15,14,14,9,22,5,19,0,101
3,15,14,14,9,22,9,14,7,107
3,15,14,14,15,20,1,20,5,107
3,15,14,14,15,20,5,0,0,86
3,15,14,14,15,20,5,4,0,90
3,15,14,14,15,20,5,19,0,105
3,15,14,14,15,20,9,14,7,111
3,15,14,14,15,20,9,22,5,117
3,15,14,14,19,0,0,0,0,65
3,15,14,14,21,0,0,0,0,67
3,15,14,14,21,2,9,1,12,91
3,15,14,14,21,2,9,21,13,112
3,15,14,15,3,1,18,16,0,85
3,15,14,15,4,15,14,20,0,100
3,15,14,15,4,15,14,20,19,119
3,15,14,15,9,4,0,0,0,60
3,15,14,15,9,4,1,12,0,73
3,15,14,15,9,4,9,3,0,72
3,15,14,15,9,4,19,0,0,79
3,15,14,15,13,9,14,5,5,93
3,15,14,15,16,9,4,0,0,76
3,15,14,15,16,12,1,9,14,99
3,15,14,15,18,13,1,12,0,91
3,15,14,15,19,3,15,16,5,105
3,15,14,15,21,18,9,19,8,122
3,15,14,16,12,1,14,5,0,80
3,15,14,17,21,5,4,12,5,96
3,15,14,17,21,5,18,0,0,93
3,15,14,17,21,5,18,5,4,102
3,15,14,17,21,5,18,5,18,116
3,15,14,17,21,5,18,19,0,112
3,15,14,17,21,5,19,20,19,133
3,15,14,17,21,9,1,14,0,94
3,15,14,17,21,9,1,14,19,113
3,15,14,18,5,3,20,15,18,111
3,15,14,18,5,4,0,0,0,59
3,15,14,18,5,25,0,0,0,80
3,15,14,19,1,3,18,5,0,78
3,15,14,19,1,18,14,0,0,84
3,15,14,19,1,18,14,5,4,93
3,15,14,19,3,9,5,14,20,102
3,15,14,19,3,9,15,21,19,118
3,15,14,19,3,9,22,5,0,90
3,15,14,19,3,18,9,2,5,88
3,15,14,19,3,18,9,16,20,117
3,15,14,19,5,3,21,20,5,105
3,15,14,19,5,14,3,5,0,78
3,15,14,19,5,14,19,21,19,129
3,15,14,19,5,14,20,0,0,90
3,15,14,19,5,14,20,5,4,99
3,15,14,19,5,14,20,5,18,113
3,15,14,19,5,14,20,19,0,109
3,15,14,19,5,18,20,1,12,107
3,15,14,19,5,18,22,5,0,101
3,15,14,19,5,18,22,5,4,105
3,15,14,19,5,18,22,5,18,119
3,15,14,19,5,18,22,5,19,120
3,15,14,19,25,0,0,0,0,76
3,15,14,19,9,4,5,18,0,87
3,15,14,19,9,4,5,18,19,106
3,15,14,19,9,7,14,0,0,81
3,15,14,19,9,7,14,5,0,86
3,15,14,19,9,7,14,5,4,90
3,15,14,19,9,7,14,5,5,91
3,15,14,19,9,7,14,5,18,104
3,15,14,19,9,7,14,15,18,114
3,15,14,19,9,7,14,19,0,100
3,15,14,19,9,13,9,12,5,99
3,15,14,19,9,19,20,0,0,99
3,15,14,19,9,19,20,5,4,108
3,15,14,19,9,19,20,19,0,118
3,15,14,19,9,20,9,15,14,118
3,15,14,19,15,3,9,5,19,102
3,15,14,19,15,12,0,0,0,78
3,15,14,19,15,12,1,14,0,93
3,15,14,19,15,12,1,20,5,104
3,15,14,19,15,12,5,0,0,83
3,15,14,19,15,12,5,4,0,87
3,15,14,19,15,12,5,18,0,101
3,15,14,19,15,12,5,18,19,120
3,15,14,19,15,12,5,19,0,102
3,15,14,19,15,12,9,14,7,108
3,15,14,19,15,12,19,0,0,97
3,15,14,19,15,12,21,20,5,124
3,15,14,19,15,13,13,0,0,92
3,15,14,19,15,13,13,5,0,97
3,15,14,19,15,13,13,5,19,116
3,15,14,19,15,14,1,14,20,115
3,15,14,19,15,14,1,20,5,106
3,15,14,19,15,14,15,21,19,135
3,15,14,19,15,16,9,20,5,116
3,15,14,19,15,18,20,0,0,104
3,15,14,19,15,18,20,5,4,113
3,15,14,19,15,18,20,5,18,127
3,15,14,19,15,18,20,9,1,114
3,15,14,19,15,18,20,19,0,123
3,15,14,19,15,21,4,5,0,96
3,15,14,19,15,21,14,4,0,105
3,15,14,19,16,5,3,20,0,95
3,15,14,19,16,5,18,7,0,97
3,15,14,19,16,5,18,19,5,114
3,15,14,19,16,9,18,5,0,99
3,15,14,19,16,9,18,5,4,103
3,15,14,19,16,9,18,5,18,117
3,15,14,19,16,9,18,5,19,118
3,15,14,19,16,21,5,0,0,93
3,15,14,19,20,1,14,20,19,125
3,15,14,19,20,1,20,0,0,92
3,15,14,19,20,1,20,5,0,97
3,15,14,19,20,5,18,0,0,94
3,15,14,19,20,18,0,0,0,89
3,15,14,19,20,18,1,9,14,113
3,15,14,19,20,18,9,3,20,121
3,15,14,19,20,18,21,1,12,123
3,15,14,19,20,18,21,3,20,133
3,15,14,19,20,18,21,5,0,115
3,15,14,19,20,18,21,5,4,119
3,15,14,19,20,18,21,5,18,133
3,15,14,19,20,18,21,5,19,134
3,15,14,19,21,5,20,5,0,102
3,15,14,19,21,12,0,0,0,84
3,15,14,19,21,12,1,7,5,97
3,15,14,19,21,12,1,18,0,103
3,15,14,19,21,12,1,18,25,128
3,15,14,19,21,12,1,20,5,110
3,15,14,19,21,12,19,0,0,103
3,15,14,19,21,12,20,0,0,104
3,15,14,19,21,12,20,1,0,105
3,15,14,19,21,12,20,5,4,113
3,15,14,19,21,12,20,5,5,114
3,15,14,19,21,12,20,5,18,127
3,15,14,19,21,12,20,15,0,119
3,15,14,19,21,12,20,15,18,137
3,15,14,19,21,12,20,19,0,123
3,15,14,19,21,13,1,20,5,111
3,15,14,19,21,13,5,0,0,90
3,15,14,19,21,13,5,4,0,94
3,15,14,19,21,13,5,18,0,108
3,15,14,19,21,13,5,18,19,127
3,15,14,19,21,13,5,19,0,109
3,15,14,19,21,13,9,14,7,115
3,15,14,19,21,13,15,0,0,100
3,15,14,19,21,13,16,20,0,121
3,15,14,19,21,20,5,0,0,97
3,15,14,20,1,3,20,0,0,76
3,15,14,20,1,3,20,5,4,85
3,15,14,20,1,3,20,15,18,109
3,15,14,20,1,3,20,19,0,95
3,15,14,20,1,4,9,14,15,95
3,15,14,20,1,7,7,9,1,77
3,15,14,20,1,7,9,1,0,70
3,15,14,20,1,7,9,15,14,98
3,15,14,20,1,7,9,21,13,103
3,15,14,20,1,9,14,0,0,76
3,15,14,20,1,9,14,5,4,85
3,15,14,20,1,9,14,5,18,99
3,15,14,20,1,9,14,19,0,95
3,15,14,20,1,11,9,1,0,74
3,15,14,20,1,11,9,15,14,102
3,15,14,20,1,13,0,0,0,66
3,15,14,20,1,14,7,15,0,89
3,15,14,20,1,14,7,15,19,108
3,15,14,20,3,8,1,18,0,82
3,15,14,20,4,0,0,0,0,56
3,15,14,20,5,3,11,0,0,71
3,15,14,20,5,3,20,0,0,80
3,15,14,20,5,11,0,0,0,68
3,15,14,20,5,11,5,0,0,73
3,15,14,20,5,13,14,0,0,84
3,15,14,20,5,13,14,5,4,93
3,15,14,20,5,13,14,5,18,107
3,15,14,20,5,13,14,15,18,117
3,15,14,20,5,13,14,19,0,103
3,15,14,20,5,13,16,0,0,86
3,15,14,20,5,13,16,5,18,109
3,15,14,20,5,13,16,12,5,103
3,15,14,20,5,13,16,20,0,106
3,15,14,20,5,13,16,20,19,125
3,15,14,20,5,14,4,0,0,75
3,15,14,20,5,14,4,5,4,84
3,15,14,20,5,14,4,5,18,98
3,15,14,20,5,14,4,19,0,94
3,15,14,20,5,14,20,0,0,91
3,15,14,20,5,14,20,5,4,100
3,15,14,20,5,14,20,12,25,128
3,15,14,20,5,14,20,19,0,110
3,15,14,20,5,14,21,0,0,92
3,15,14,20,5,18,0,0,0,75
3,15,14,20,5,19,0,0,0,76
3,15,14,20,5,19,19,1,0,96
3,15,14,20,5,19,20,0,0,96
3,15,14,20,5,19,20,5,4,105
3,15,14,20,5,19,20,5,5,106
3,15,14,20,5,19,20,5,18,119
3,15,14,20,5,19,20,19,0,115
3,15,14,20,5,21,18,0,0,96
3,15,14,20,5,24,0,0,0,81
3,15,14,20,5,24,20,0,0,101
3,15,14,20,5,24,20,19,0,120
3,15,14,20,7,0,0,0,0,59
3,15,14,20,9,3,5,14,20,103
3,15,14,20,9,14,0,0,0,75
3,15,14,20,9,14,5,21,0,101
3,15,14,20,9,14,21,1,0,97
3,15,14,20,9,14,21,1,12,109
3,15,14,20,9,14,21,5,0,101
3,15,14,20,9,14,21,5,4,105
3,15,14,20,9,14,21,5,18,119
3,15,14,20,9,14,21,5,19,120
3,15,14,20,9,14,21,15,0,111
3,15,14,20,9,14,21,15,19,130
3,15,14,20,9,14,21,21,1,118
3,15,14,20,9,14,21,21,13,130
3,15,14,20,9,19,5,0,0,85
3,15,14,20,12,9,14,5,0,92
3,15,14,20,15,0,0,0,0,67
3,15,14,20,15,9,4,0,0,80
3,15,14,20,15,9,19,5,0,100
3,15,14,20,15,18,14,15,0,114
3,15,14,20,15,18,20,0,0,105
3,15,14,20,15,18,20,1,0,106
3,15,14,20,15,18,20,5,4,114
3,15,14,20,15,18,20,19,0,124
3,15,14,20,15,19,0,0,0,86
3,15,14,20,15,21,18,0,0,106
3,15,14,20,15,21,18,5,4,115
3,15,14,20,15,21,18,14,5,125
3,15,14,20,15,21,18,19,0,125
3,15,14,20,18,0,0,0,0,70
3,15,14,20,18,1,0,0,0,71
3,15,14,20,18,1,3,20,0,94
3,15,14,20,18,1,3,20,19,113
3,15,14,20,18,1,3,20,21,115
3,15,14,20,18,1,4,1,0,76
3,15,14,20,18,1,4,5,0,80
3,15,14,20,18,1,9,12,0,92
3,15,14,20,18,1,9,12,19,111
3,15,14,20,18,1,9,18,0,98
3,15,14,20,18,1,9,18,5,103
3,15,14,20,18,1,12,20,9,112
3,15,14,20,18,1,12,20,15,118
3,15,14,20,18,1,18,25,0,114
3,15,14,20,18,1,19,0,0,90
3,15,14,20,18,1,19,20,0,110
3,15,14,20,18,1,19,20,5,115
3,15,14,20,18,1,19,20,25,135
3,15,14,20,18,1,19,20,19,129
3,15,14,20,18,1,20,5,0,96
3,15,14,20,18,9,2,0,0,81
3,15,14,20,18,9,19,20,0,118
3,15,14,20,18,9,20,5,0,104
3,15,14,20,18,9,22,5,0,106
3,15,14,20,18,9,22,5,4,110
3,15,14,20,18,9,22,5,18,124
3,15,14,20,18,9,22,5,19,125
3,15,14,20,18,15,12,0,0,97
3,15,14,20,18,15,12,5,4,106
3,15,14,20,18,15,12,19,0,116
3,15,14,20,18,21,4,5,0,100
3,15,14,20,20,9,14,21,1,117
3,15,14,20,21,13,1,3,25,115
3,15,14,20,21,13,1,24,0,111
3,15,14,20,21,13,5,12,25,128
3,15,14,20,21,14,4,0,0,91
3,15,14,20,21,14,5,0,0,92
3,15,14,20,21,18,2,0,0,93
3,15,14,20,21,19,5,0,0,97
3,15,14,20,21,19,5,4,0,101
3,15,14,20,21,19,5,19,0,116
3,15,14,20,21,19,9,14,7,122
3,15,14,20,21,19,9,15,14,130
3,15,14,20,21,19,9,22,5,128
3,15,14,21,2,9,21,13,0,98
3,15,14,21,12,5,0,0,0,70
3,15,14,21,14,4,18,21,13,123
3,15,14,21,18,5,0,0,0,76
3,15,14,21,19,1,2,12,5,92
3,15,14,21,19,1,14,3,5,95
3,15,14,21,19,1,14,20,0,107
3,15,14,21,19,5,5,0,0,82
3,15,14,21,19,5,19,0,0,96
3,15,14,21,19,15,18,0,0,105
3,15,14,21,26,5,5,0,0,89
3,15,14,21,26,15,18,0,0,112
3,15,14,22,0,0,0,0,0,54
3,15,14,22,1,12,12,25,0,104
3,15,14,22,5,3,20,0,0,82
3,15,14,22,5,3,20,5,4,91
3,15,14,22,5,3,20,15,18,115
3,15,14,22,5,3,20,19,0,101
3,15,14,22,5,25,0,0,0,84
3,15,14,22,5,25,1,12,0,97
3,15,14,22,5,25,5,4,0,93
3,15,14,22,5,25,5,18,0,107
3,15,14,22,5,25,5,18,19,126
3,15,14,22,5,25,9,14,7,114
3,15,14,22,5,25,15,18,0,117
3,15,14,22,5,25,15,18,19,136
3,15,14,22,5,25,19,0,0,103
3,15,14,22,5,12,12,0,0,83
3,15,14,22,5,14,5,0,0,78
3,15,14,22,5,14,5,4,0,82
3,15,14,22,5,14,5,5,0,83
3,15,14,22,5,14,5,18,0,96
3,15,14,22,5,14,5,18,25,121
3,15,14,22,5,14,5,18,19,115
3,15,14,22,5,14,5,19,0,97
3,15,14,22,5,14,9,14,7,103
3,15,14,22,5,14,15,18,0,106
3,15,14,22,5,14,20,0,0,93
3,15,14,22,5,14,20,5,4,102
3,15,14,22,5,14,20,15,0,108
3,15,14,22,5,14,20,19,0,112
3,15,14,22,5,18,7,5,0,89
3,15,14,22,5,18,7,5,4,93
3,15,14,22,5,18,7,5,19,108
3,15,14,22,5,18,19,5,4,105
3,15,14,22,5,18,19,5,18,119
3,15,14,22,5,18,19,5,19,120
3,15,14,22,5,18,19,9,0,105
3,15,14,22,5,18,19,15,0,111
3,15,14,22,5,18,19,21,19,136
3,15,14,22,5,18,20,0,0,97
3,15,14,22,5,18,20,5,4,106
3,15,14,22,5,18,20,5,18,120
3,15,14,22,5,18,20,15,18,130
3,15,14,22,5,18,20,19,0,116
3,15,14,22,5,20,8,0,0,87
3,15,14,22,5,24,0,0,0,83
3,15,14,22,5,24,5,4,0,92
3,15,14,22,5,24,5,19,0,107
3,15,14,22,5,24,9,20,25,137
3,15,14,22,5,24,12,25,0,120
3,15,14,22,5,24,15,0,0,98
3,15,14,22,9,3,20,0,0,86
3,15,14,22,9,3,20,5,4,95
3,15,14,22,9,3,20,15,18,119
3,15,14,22,9,3,20,19,0,105
3,15,14,22,9,14,3,5,0,85
3,15,14,22,9,14,3,5,4,89
3,15,14,22,9,14,3,5,18,103
3,15,14,22,9,14,3,5,19,104
3,15,14,22,9,20,5,0,0,88
3,15,14,22,9,20,15,0,0,98
3,15,14,22,9,22,1,12,0,98
3,15,14,22,9,22,5,0,0,90
3,15,14,22,9,22,5,19,0,109
3,15,14,22,9,22,9,1,12,107
3,15,14,22,9,22,9,15,0,109
3,15,14,22,15,3,1,14,20,107
3,15,14,22,15,3,1,20,5,98
3,15,14,22,15,25,0,0,0,94
3,15,14,22,15,25,5,4,0,103
3,15,14,22,15,25,9,14,7,124
3,15,14,22,15,25,19,0,0,113
3,15,14,22,15,11,5,0,0,85
3,15,14,22,15,11,5,4,0,89
3,15,14,22,15,11,5,18,0,103
3,15,14,22,15,11,5,18,19,122
3,15,14,22,15,11,5,19,0,104
3,15,14,22,15,11,9,14,7,110
3,15,14,22,15,12,21,20,5,127
3,15,14,22,15,12,22,5,0,108
3,15,14,22,15,12,22,5,4,112
3,15,14,22,15,12,22,5,19,127
3,15,14,22,21,12,19,5,0,111
3,15,14,22,21,12,19,5,4,115
3,15,14,22,21,12,19,5,19,130
3,15,15,2,1,0,0,0,0,36
3,15,15,2,1,8,0,0,0,44
3,15,15,2,15,15,0,0,0,65
3,15,15,2,15,15,19,0,0,84
3,15,15,3,8,0,0,0,0,44
3,15,15,3,8,5,19,0,0,68
3,15,15,3,15,15,0,0,0,66
3,15,15,4,12,5,0,0,0,54
3,15,15,5,4,0,0,0,0,42
3,15,15,5,5,0,0,0,0,43
3,15,15,5,5,4,0,0,0,47
3,15,15,5,5,9,14,7,0,73
3,15,15,5,5,19,0,0,0,62
3,15,15,5,25,0,0,0,0,63
3,15,15,5,25,5,4,0,0,72
3,15,15,5,25,9,14,7,0,93
3,15,15,5,25,19,0,0,0,82
3,15,15,5,18,0,0,0,0,56
3,15,15,5,18,19,0,0,0,75
3,15,15,6,0,0,0,0,0,39
3,15,15,6,19,0,0,0,0,58
3,15,15,9,14,7,0,0,0,63
3,15,15,9,14,7,12,25,0,100
3,15,15,10,1,0,0,0,0,44
3,15,15,11,1,2,12,5,0,64
3,15,15,11,2,15,15,11,0,87
3,15,15,11,2,15,15,11,19,106
3,15,15,11,4,15,13,0,0,76
3,15,15,11,5,4,0,0,0,53
3,15,15,11,5,5,0,0,0,54
3,15,15,11,5,25,0,0,0,74
3,15,15,11,5,25,19,0,0,93
3,15,15,11,5,9,20,5,0,83
3,15,15,11,5,18,0,0,0,67
3,15,15,11,5,18,25,0,0,92
3,15,15,11,5,18,9,5,19,100
3,15,15,11,5,18,19,0,0,86
3,15,15,11,8,15,21,19,5,112
3,15,15,11,9,5,19,0,0,77
3,15,15,11,9,14,7,0,0,74
3,15,15,11,9,14,7,19,0,93
3,15,15,11,9,19,8,0,0,80
3,15,15,11,9,19,8,12,25,117
3,15,15,11,12,5,19,19,0,99
3,15,15,11,13,1,9,4,0,71
3,15,15,11,15,21,20,0,0,100
3,15,15,11,15,21,20,19,0,119
3,15,15,11,18,15,15,13,0,105
3,15,15,11,19,8,1,3,11,86
3,15,15,11,19,8,15,16,0,102
3,15,15,11,19,8,15,16,19,121
3,15,15,11,19,20,15,22,5,125
3,15,15,11,23,1,18,5,0,91
3,15,15,11,23,1,18,5,19,110
3,15,15,12,0,0,0,0,0,45
3,15,15,12,1,2,1,8,0,57
3,15,15,12,1,13,1,14,0,74
3,15,15,12,1,13,15,14,0,88
3,15,15,12,1,14,20,0,0,80
3,15,15,12,1,14,20,19,0,99
3,15,15,12,5,4,0,0,0,54
3,15,15,12,5,14,0,0,0,64
3,15,15,12,5,18,0,0,0,68
3,15,15,12,5,18,13,1,14,96
3,15,15,12,5,18,19,0,0,87
3,15,15,12,5,19,20,0,0,89
3,15,15,12,8,15,21,19,5,113
3,15,15,12,25,0,0,0,0,70
3,15,15,12,9,2,1,8,0,65
3,15,15,12,9,5,0,0,0,59
3,15,15,12,9,5,19,0,0,78
3,15,15,12,9,13,1,14,0,82
3,15,15,12,9,14,7,0,0,75
3,15,15,12,9,14,7,12,25,112
3,15,15,12,9,19,8,0,0,81
3,15,15,12,12,25,0,0,0,82
3,15,15,12,14,5,19,19,0,102
3,15,15,12,19,0,0,0,0,64
3,15,15,12,20,8,0,0,0,73
3,15,15,12,20,8,19,0,0,92
3,15,15,12,21,14,7,0,0,87
3,15,15,12,23,5,5,4,0,82
3,15,15,12,23,15,18,20,0,121
3,15,15,13,0,0,0,0,0,46
3,15,15,13,2,0,0,0,0,48
3,15,15,13,2,5,0,0,0,53
3,15,15,13,2,5,19,0,0,72
3,15,15,13,25,0,0,0,0,71
3,15,15,14,0,0,0,0,0,47
3,15,15,14,3,1,14,0,0,65
3,15,15,14,3,1,14,19,0,84
3,15,15,14,5,18,0,0,0,70
3,15,15,14,8,15,21,14,4,109
3,15,15,14,25,0,0,0,0,72
3,15,15,14,9,5,18,0,0,79
3,15,15,14,9,5,19,20,0,100
3,15,15,14,9,12,25,0,0,93
3,15,15,14,9,14,5,19,19,113
3,15,15,14,10,9,14,5,0,85
3,15,15,14,18,15,15,20,0,115
3,15,15,14,19,0,0,0,0,66
3,15,15,14,19,11,9,14,0,100
3,15,15,14,19,11,9,14,19,119
3,15,15,14,20,1,8,0,0,76
3,15,15,14,20,1,9,12,0,89
3,15,15,14,20,9,5,0,0,81
3,15,15,14,20,9,5,19,0,100
3,15,15,16,5,4,0,0,0,58
3,15,15,16,5,5,0,0,0,59
3,15,15,16,5,18,1,7,5,85
3,15,15,16,5,18,1,14,20,107
3,15,15,16,5,18,1,20,5,98
3,15,15,16,5,18,5,4,0,81
3,15,15,16,5,18,25,0,0,97
3,15,15,16,5,18,9,5,19,105
3,15,15,16,5,18,9,14,7,102
3,15,15,16,5,18,9,20,5,106
3,15,15,16,5,18,19,0,0,91
3,15,15,16,9,14,7,0,0,79
3,15,15,16,19,0,0,0,0,68
3,15,15,16,20,0,0,0,0,69
3,15,15,16,20,1,20,5,0,95
3,15,15,16,20,5,4,0,0,78
3,15,15,16,20,9,14,7,0,99
3,15,15,16,20,9,15,14,0,107
3,15,15,16,20,9,15,14,19,126
3,15,15,16,20,9,22,5,0,105
3,15,15,16,20,19,0,0,0,88
3,15,15,18,4,1,9,14,0,79
3,15,15,18,4,9,14,1,12,91
3,15,15,18,5,5,0,0,0,61
3,15,15,18,9,5,0,0,0,65
3,15,15,18,9,5,4,0,0,69
3,15,15,18,9,5,9,14,7,95
3,15,15,18,9,5,19,0,0,84
3,15,15,19,5,18,0,0,0,75
3,15,15,19,5,18,19,0,0,94
3,15,15,19,9,6,25,0,0,92
3,15,15,19,20,0,0,0,0,72
3,15,15,20,0,0,0,0,0,53
3,15,15,20,3,8,0,0,0,64
3,15,15,20,6,15,15,20,0,109
3,15,15,20,8,0,0,0,0,61
3,15,15,20,8,1,25,0,0,87
3,15,15,20,25,0,0,0,0,78
3,15,15,20,9,5,0,0,0,67
3,15,15,20,9,5,19,0,0,86
3,15,15,20,19,0,0,0,0,72
3,15,16,1,0,0,0,0,0,35
3,15,16,1,2,12,5,0,0,54
3,15,16,1,3,5,20,9,3,75
3,15,16,1,5,14,5,0,0,59
3,15,16,1,9,2,1,0,0,47
3,15,16,1,9,2,1,19,0,66
3,15,16,1,9,2,9,3,0,58
3,15,16,1,9,25,5,0,0,74
3,15,16,1,9,14,0,0,0,58
3,15,16,1,9,22,9,3,0,78
3,15,16,1,12,0,0,0,0,47
3,15,16,1,12,3,8,5,0,63
3,15,16,1,12,3,8,9,0,67
3,15,16,1,12,9,14,5,0,75
3,15,16,1,12,9,20,5,0,81
3,15,16,1,12,13,0,0,0,60
3,15,16,1,12,13,19,0,0,79
3,15,16,1,12,19,0,0,0,66
3,15,16,1,18,3,5,14,25,100
3,15,16,1,18,5,14,20,0,92
3,15,16,1,18,5,14,20,19,111
3,15,16,1,18,20,0,0,0,73
3,15,16,1,18,20,25,0,0,98
3,15,16,1,18,20,14,5,18,110
3,15,16,1,19,5,20,9,3,91
3,15,16,1,19,20,15,18,0,107
3,15,16,1,19,20,15,18,19,126
3,15,16,1,20,1,9,14,0,79
3,15,16,1,20,1,9,14,5,84
3,15,16,1,20,18,9,15,20,117
3,15,16,1,20,18,15,14,0,102
3,15,16,1,20,18,15,14,19,121
3,15,16,5,3,11,0,0,0,53
3,15,16,5,3,11,19,0,0,72
3,15,16,5,4,0,0,0,0,43
3,15,16,5,9,0,0,0,0,48
3,15,16,5,9,1,0,0,0,49
3,15,16,5,12,1,20,5,0,77
3,15,16,5,13,1,14,0,0,67
3,15,16,5,13,1,20,5,0,78
3,15,16,5,13,1,20,5,19,97
3,15,16,5,14,0,0,0,0,53
3,15,16,5,14,4,9,14,7,87
3,15,16,5,14,19,0,0,0,72
3,15,16,5,16,15,4,0,0,74
3,15,16,5,16,15,4,1,14,89
3,15,16,5,16,15,4,19,0,93
3,15,16,5,18,0,0,0,0,57
3,15,16,5,18,15,19,5,0,96
3,15,16,5,18,19,0,0,0,76
3,15,16,5,18,20,1,0,0,78
3,15,16,5,19,0,0,0,0,58
3,15,16,5,19,5,20,9,3,95
3,15,16,5,19,13,1,14,0,86
3,15,16,5,19,13,1,20,5,97
3,15,16,5,19,20,15,14,5,112
3,15,16,8,1,19,1,12,0,75
3,15,16,8,15,19,9,19,0,104
3,15,16,8,15,21,19,5,0,102
3,15,16,25,0,0,0,0,0,59
3,15,16,9,1,0,0,0,0,44
3,15,16,9,1,2,12,5,0,63
3,15,16,9,1,16,9,20,5,94
3,15,16,25,2,15,25,0,0,101
3,15,16,25,2,15,25,19,0,120
3,15,16,25,2,15,15,11,0,102
3,15,16,25,2,15,15,11,19,121
3,15,16,25,3,1,20,0,0,83
3,15,16,25,3,1,20,19,0,102
3,15,16,25,4,5,19,11,0,98
3,15,16,25,4,5,19,11,19,117
3,15,16,9,5,4,0,0,0,52
3,15,16,25,5,4,9,20,0,97
3,15,16,9,5,18,0,0,0,66
3,15,16,9,5,18,19,0,0,85
3,15,16,9,5,19,0,0,0,67
3,15,16,25,7,18,1,16,8,109
3,15,16,25,8,15,12,4,0,98
3,15,16,25,8,15,12,4,19,117
3,15,16,9,8,21,5,0,0,77
3,15,16,9,8,21,5,19,0,96
3,15,16,25,9,14,7,0,0,89
3,15,16,25,9,19,13,0,0,100
3,15,16,25,9,19,20,0,0,107
3,15,16,25,9,19,20,19,0,126
3,15,16,9,12,15,20,0,0,90
3,15,16,9,12,15,20,19,0,109
3,15,16,25,13,1,14,0,0,87
3,15,16,9,14,7,0,0,0,64
3,15,16,9,14,7,19,0,0,83
3,15,16,9,14,20,1,14,11,103
3,15,16,9,15,16,9,1,0,84
3,15,16,9,15,16,19,9,1,103
3,15,16,9,15,19,9,20,25,131
3,15,16,9,15,21,19,0,0,98
3,15,16,9,15,21,19,12,25,135
3,15,16,25,18,5,1,4,0,87
3,15,16,25,18,9,7,8,20,121
3,15,16,9,19,0,0,0,0,62
3,15,16,9,19,20,0,0,0,82
3,15,16,9,20,1,0,0,0,64
3,15,16,25,23,9,19,5,0,115
3,15,16,12,1,14,1,18,0,80
3,15,16,12,5,1,19,5,4,80
3,15,16,12,15,20,0,0,0,81
3,15,16,12,15,20,19,0,0,100
3,15,16,12,15,20,20,5,4,110
3,15,16,12,15,20,20,5,18,124
3,15,16,12,15,23,9,14,7,114
3,15,16,15,12,1,18,0,0,80
3,15,16,15,12,25,13,5,18,122
3,15,16,15,16,15,4,1,0,85
3,15,16,15,16,19,9,1,0,94
3,15,16,15,18,20,9,15,14,125
3,15,16,15,21,20,0,0,0,90
3,15,16,15,21,20,19,0,0,109
3,15,16,16,1,0,0,0,0,51
3,15,16,16,1,19,0,0,0,70
3,15,16,16,5,4,0,0,0,59
3,15,16,16,5,18,0,0,0,73
3,15,16,16,5,18,1,8,0,82
3,15,16,16,5,18,1,8,19,101
3,15,16,16,5,18,1,19,0,93
3,15,16,16,5,18,5,4,0,82
3,15,16,16,5,18,5,18,0,96
3,15,16,16,5,18,25,0,0,98
3,15,16,16,5,18,9,14,7,103
3,15,16,16,5,18,9,19,8,109
3,15,16,16,5,18,9,26,5,113
3,15,16,16,5,18,19,0,0,92
3,15,16,16,5,20,0,0,0,75
3,15,16,16,25,0,0,0,0,75
3,15,16,16,9,3,5,0,0,67
3,15,16,16,9,3,5,4,0,71
3,15,16,16,9,3,5,19,0,86
3,15,16,16,9,3,9,14,7,92
3,15,16,16,9,14,0,0,0,73
3,15,16,16,9,14,7,0,0,80
3,15,16,16,12,5,0,0,0,67
3,15,16,16,12,5,4,0,0,71
3,15,16,16,12,9,14,7,0,92
3,15,16,16,18,1,0,0,0,69
3,15,16,16,18,1,19,0,0,88
3,15,16,16,19,0,0,0,0,69
3,15,16,18,0,0,0,0,0,52
3,15,16,18,1,0,0,0,0,53
3,15,16,18,1,5,13,9,1,81
3,15,16,18,1,5,13,9,3,83
3,15,16,18,1,8,0,0,0,61
3,15,16,18,1,8,19,0,0,80
3,15,16,18,1,19,0,0,0,72
3,15,16,18,5,13,9,1,0,80
3,15,16,18,5,13,9,1,19,99
3,15,16,18,5,13,9,3,0,82
3,15,16,18,5,19,5,14,20,115
3,15,16,18,9,14,3,5,0,83
3,15,16,18,15,4,21,3,5,100
3,15,16,18,15,4,21,3,20,115
3,15,16,18,15,9,20,5,0,101
3,15,16,18,15,12,9,20,5,113
3,15,16,18,15,12,9,20,8,116
3,15,16,18,15,12,15,7,25,126
3,15,16,18,15,13,15,20,5,120
3,15,16,18,15,19,5,0,0,91
3,15,16,18,15,26,15,9,3,120
3,15,16,19,5,0,0,0,0,58
3,15,16,19,5,19,0,0,0,77
3,15,16,19,5,23,15,15,4,115
3,15,16,19,25,0,0,0,0,78
3,15,16,19,9,14,7,0,0,83
3,15,16,19,15,12,5,0,0,85
3,15,16,20,5,18,0,0,0,77
3,15,16,20,5,18,19,0,0,96
3,15,16,20,9,14,5,0,0,82
3,15,16,21,2,12,9,19,8,105
3,15,16,21,12,1,0,0,0,68
3,15,16,21,12,1,2,12,5,87
3,15,16,21,12,1,5,0,0,73
3,15,16,21,12,1,18,0,0,86
3,15,16,21,12,1,19,0,0,87
3,15,16,21,12,1,20,5,0,93
3,15,16,21,12,1,20,5,4,97
3,15,16,21,12,1,20,5,19,112
3,15,16,21,14,3,20,1,12,105
3,15,16,21,18,9,6,25,0,113
3,15,16,21,19,0,0,0,0,74
3,15,17,21,5,0,0,0,0,61
3,15,17,21,5,20,0,0,0,81
3,15,17,21,5,20,15,15,14,125
3,15,17,21,5,20,18,25,0,124
3,15,17,21,5,20,19,0,0,100
3,15,17,21,5,20,20,5,0,106
3,15,17,21,5,20,20,5,4,110
3,15,17,21,5,20,20,5,19,125
3,15,17,21,9,3,11,5,14,98
3,15,17,21,9,12,12,1,0,90
3,15,17,21,9,12,12,5,19,113
3,15,17,21,9,14,0,0,0,79
3,15,17,21,9,14,1,0,0,80
3,15,17,21,9,14,1,19,0,99
3,15,17,21,9,20,1,0,0,86
3,15,17,21,9,20,15,0,0,100
3,15,17,21,9,20,15,19,0,119
3,15,18,1,3,8,0,0,0,48
3,15,18,1,3,9,1,12,0,62
3,15,18,1,3,9,14,5,0,68
3,15,18,1,3,12,5,0,0,57
3,15,18,1,3,12,5,18,0,75
3,15,18,1,3,12,5,19,0,76
3,15,18,1,3,15,9,4,0,68
3,15,18,1,3,15,9,4,19,87
3,15,18,1,4,9,3,1,12,66
3,15,18,1,7,5,0,0,0,49
3,15,18,1,7,7,9,15,0,75
3,15,18,1,7,9,15,0,0,68
3,15,18,1,8,0,0,0,0,45
3,15,18,1,9,19,5,0,0,70
3,15,18,1,10,9,0,0,0,56
3,15,18,1,12,2,21,19,8,99
3,15,18,1,12,5,4,0,0,58
3,15,18,1,12,5,14,5,0,73
3,15,18,1,12,9,19,20,0,97
3,15,18,1,12,9,20,1,0,79
3,15,18,1,12,12,1,0,0,62
3,15,18,1,12,12,5,20,0,86
3,15,18,1,12,12,9,3,0,73
3,15,18,1,12,12,9,11,5,86
3,15,18,1,12,12,9,14,0,84
3,15,18,1,12,12,9,14,5,89
3,15,18,1,12,12,9,20,1,91
3,15,18,1,12,12,9,20,5,95
3,15,18,1,12,12,15,9,4,89
3,15,18,1,12,12,21,13,0,95
3,15,18,1,12,18,15,15,20,117
3,15,18,1,12,19,0,0,0,68
3,15,18,1,12,23,15,18,20,125
3,15,18,1,14,0,0,0,0,51
3,15,18,1,14,3,5,0,0,59
3,15,18,1,14,15,3,8,0,77
3,15,18,1,14,20,15,0,0,86
3,15,18,1,14,20,15,5,19,110
3,15,18,1,14,20,15,19,0,105
3,15,18,1,22,5,3,1,0,68
3,15,18,2,1,14,0,0,0,53
3,15,18,2,1,14,19,0,0,72
3,15,18,2,5,0,0,0,0,43
3,15,18,2,5,1,21,0,0,65
3,15,18,2,5,4,0,0,0,47
3,15,18,2,5,9,12,12,5,81
3,15,18,2,5,9,12,19,0,83
3,15,18,2,5,12,0,0,0,55
3,15,18,2,5,12,5,4,0,64
3,15,18,2,5,12,9,14,7,85
3,15,18,2,5,12,12,5,4,76
3,15,18,2,5,12,19,0,0,74
3,15,18,2,9,3,21,12,1,84
3,15,18,2,9,5,19,0,0,71
3,15,18,2,9,14,1,0,0,62
3,15,18,2,9,14,1,19,0,81
3,15,18,2,12,5,21,0,0,76
3,15,18,2,12,9,13,5,25,102
3,15,18,2,12,9,13,25,0,97
3,15,18,2,21,12,1,0,0,72
3,15,18,3,1,19,19,0,0,78
3,15,18,3,8,1,20,0,0,68
3,15,18,3,9,18,0,0,0,66
3,15,18,3,12,5,0,0,0,56
3,15,18,3,15,16,1,12,9,92
3,15,18,4,1,7,5,0,0,53
3,15,18,4,1,7,5,19,0,72
3,15,18,4,1,12,0,0,0,53
3,15,18,4,1,14,20,0,0,75
3,15,18,4,1,20,5,0,0,66
3,15,18,4,1,20,5,12,25,103
3,15,18,4,1,24,0,0,0,65
3,15,18,4,5,4,0,0,0,49
3,15,18,4,5,12,0,0,0,57
3,15,18,4,5,12,12,5,0,74
3,15,18,4,5,12,12,5,4,78
3,15,18,4,5,18,19,0,0,82
3,15,18,4,5,23,1,14,5,88
3,15,18,4,9,1,12,0,0,62
3,15,18,4,9,1,12,12,25,99
3,15,18,4,9,1,12,19,0,81
3,15,18,4,9,3,5,16,19,92
3,15,18,4,9,3,15,12,5,84
3,15,18,4,9,5,19,0,0,73
3,15,18,4,9,6,15,18,13,101
3,15,18,4,9,7,5,18,9,88
3,15,18,4,25,12,0,0,0,77
3,15,18,4,9,14,1,18,0,82
3,15,18,4,9,14,5,18,0,86
3,15,18,4,9,14,7,0,0,70
3,15,18,4,9,14,7,19,0,89
3,15,18,4,9,19,0,0,0,68
3,15,18,4,9,20,5,0,0,74
3,15,18,4,9,20,5,19,0,93
3,15,18,4,9,20,9,19,0,97
3,15,18,4,12,5,1,6,0,64
3,15,18,4,12,5,19,19,0,95
3,15,18,4,12,9,11,5,0,77
3,15,18,4,13,1,11,5,18,88
3,15,18,4,15,2,1,14,0,72
3,15,18,4,15,2,1,19,0,77
3,15,18,4,15,14,0,0,0,69
3,15,18,4,15,14,1,26,15,111
3,15,18,4,15,14,5,4,0,78
3,15,18,4,15,14,9,14,7,99
3,15,18,4,15,14,14,5,20,108
3,15,18,4,15,14,19,0,0,88
3,15,18,4,15,22,1,14,19,111
3,15,18,4,19,0,0,0,0,59
3,15,18,4,21,18,15,25,0,119
3,15,18,4,21,18,15,25,19,138
3,15,18,4,23,1,9,14,0,87
3,15,18,4,23,1,9,14,19,106
3,15,18,4,23,15,15,4,0,97
3,15,18,4,23,15,15,4,19,116
3,15,18,5,2,5,12,0,0,60
3,15,18,5,2,15,24,0,0,82
3,15,18,5,3,20,15,13,5,97
3,15,18,5,3,20,15,13,25,117
3,15,18,5,3,20,15,18,0,97
3,15,18,5,4,0,0,0,0,45
3,15,18,5,4,5,5,13,0,68
3,15,18,5,4,5,5,13,19,87
3,15,18,5,7,5,14,3,5,75
3,15,18,5,7,5,14,3,25,95
3,15,18,5,7,5,14,20,0,87
3,15,18,5,7,14,1,14,20,97
3,15,18,5,7,15,14,9,4,90
3,15,18,5,9,4,0,0,0,54
3,15,18,5,9,7,14,0,0,71
3,15,18,5,9,7,14,5,18,94
3,15,18,5,9,7,14,19,0,90
3,15,18,5,10,15,9,3,5,83
3,15,18,5,12,1,20,5,0,79
3,15,18,5,12,1,20,5,4,83
3,15,18,5,12,1,20,5,19,98
3,15,18,5,12,5,19,19,0,96
3,15,18,5,12,25,19,9,19,125
3,15,18,5,13,1,11,5,18,89
3,15,18,5,13,9,1,0,0,64
3,15,18,5,13,9,21,13,0,97
3,15,18,5,18,0,0,0,0,59
3,15,18,5,18,19,0,0,0,78
3,15,18,5,19,0,0,0,0,60
3,15,18,5,19,9,7,14,0,90
3,15,18,5,19,15,18,20,0,113
3,15,18,5,19,16,5,3,20,104
3,15,18,5,20,15,13,25,0,114
3,15,18,5,22,5,12,5,18,103
3,15,18,5,22,15,12,22,5,117
3,15,18,6,0,0,0,0,0,42
3,15,18,7,5,0,0,0,0,48
3,15,18,7,9,0,0,0,0,52
3,15,18,7,9,19,0,0,0,71
3,15,18,9,1,0,0,0,0,46
3,15,18,9,1,12,0,0,0,58
3,15,18,9,1,14,4,5,18,87
3,15,18,9,1,21,19,0,0,86
3,15,18,25,4,1,12,9,14,101
3,15,18,25,4,9,14,5,0,93
3,15,18,25,4,15,18,1,0,99
3,15,18,9,9,14,0,0,0,68
3,15,18,25,12,0,0,0,0,73
3,15,18,25,12,5,20,0,0,98
3,15,18,25,12,9,14,0,0,96
3,15,18,25,13,2,0,0,0,76
3,15,18,25,13,2,5,4,0,85
3,15,18,25,13,2,15,19,5,115
3,15,18,25,13,2,15,21,19,131
3,15,18,25,13,2,19,0,0,95
3,15,18,9,14,4,15,14,0,92
3,15,18,9,14,7,0,0,0,66
3,15,18,25,14,9,4,0,0,88
3,15,18,25,14,9,14,5,0,103
3,15,18,25,14,9,20,5,0,109
3,15,18,9,14,20,8,5,19,111
3,15,18,25,16,8,0,0,0,85
3,15,18,25,16,8,1,5,9,100
3,15,18,25,16,8,5,5,0,95
3,15,18,25,16,8,5,5,19,114
3,15,18,25,16,8,5,14,5,109
3,15,18,25,19,20,15,9,4,128
3,15,18,9,20,1,0,0,0,66
3,15,18,9,21,13,0,0,0,79
3,15,18,25,26,1,0,0,0,88
3,15,18,25,26,1,12,0,0,100
3,15,18,25,26,1,19,0,0,107
3,15,18,11,1,7,5,0,0,60
3,15,18,11,1,7,5,19,0,79
3,15,18,11,2,15,1,18,4,87
3,15,18,11,5,0,0,0,0,52
3,15,18,11,5,4,0,0,0,56
3,15,18,11,5,18,0,0,0,70
3,15,18,11,5,18,19,0,0,89
3,15,18,11,25,0,0,0,0,72
3,15,18,11,9,5,18,0,0,79
3,15,18,11,9,5,19,20,0,100
3,15,18,11,9,14,5,19,19,113
3,15,18,11,9,14,7,0,0,77
3,15,18,11,9,18,0,0,0,74
3,15,18,11,9,19,8,0,0,83
3,15,18,11,9,20,5,0,0,81
3,15,18,11,12,9,11,5,0,84
3,15,18,11,12,9,14,5,0,87
3,15,18,11,13,1,11,5,18,95
3,15,18,11,19,0,0,0,0,66
3,15,18,11,19,3,18,5,23,115
3,15,18,11,23,9,14,7,0,100
3,15,18,11,23,15,15,4,0,104
3,15,18,11,23,15,15,4,19,123
3,15,18,13,0,0,0,0,0,49
3,15,18,13,5,12,0,0,0,66
3,15,18,13,5,12,19,0,0,85
3,15,18,13,9,4,9,21,13,105
3,15,18,13,12,9,11,5,0,86
3,15,18,13,15,7,5,14,0,90
3,15,18,13,15,9,4,0,0,77
3,15,18,13,15,18,1,14,20,117
3,15,18,13,15,21,19,0,0,104
3,15,18,13,19,0,0,0,0,68
3,15,18,13,21,19,0,0,0,89
3,15,18,14,1,4,1,0,0,56
3,15,18,14,1,7,5,0,0,63
3,15,18,14,1,13,21,20,5,110
3,15,18,14,2,1,12,12,0,77
3,15,18,14,2,1,12,12,19,96
3,15,18,14,2,5,12,12,0,81
3,15,18,14,2,5,18,18,25,118
3,15,18,14,2,9,14,0,0,75
3,15,18,14,2,9,14,4,0,79
3,15,18,14,2,9,14,11,19,105
3,15,18,14,2,9,18,4,0,83
3,15,18,14,2,15,12,5,0,84
3,15,18,14,2,18,1,19,8,98
3,15,18,14,2,18,5,1,4,80
3,15,18,14,3,1,11,5,0,70
3,15,18,14,3,1,11,5,19,89
3,15,18,14,3,15,2,0,0,70
3,15,18,14,3,15,2,19,0,89
3,15,18,14,3,18,1,11,5,88
3,15,18,14,3,18,9,2,0,82
3,15,18,14,3,18,9,2,19,101
3,15,18,14,5,1,0,0,0,56
3,15,18,14,5,1,7,5,14,82
3,15,18,14,5,1,12,0,0,68
3,15,18,14,5,1,19,0,0,75
3,15,18,14,5,4,0,0,0,59
3,15,18,14,5,9,14,0,0,78
3,15,18,14,5,9,14,5,0,83
3,15,18,14,5,9,20,9,19,112
3,15,18,14,5,12,9,1,14,91
3,15,18,14,5,12,19,0,0,86
3,15,18,14,5,13,21,19,5,113
3,15,18,14,5,15,21,19,0,110
3,15,18,14,5,18,3,1,16,93
3,15,18,14,5,18,5,4,0,82
3,15,18,14,5,18,5,18,0,96
3,15,18,14,5,18,9,14,7,103
3,15,18,14,5,18,13,1,14,101
3,15,18,14,5,18,19,0,0,92
3,15,18,14,5,20,3,25,0,103
3,15,18,14,5,20,5,18,0,98
3,15,18,14,5,20,9,19,20,123
3,15,18,14,5,20,19,0,0,94
3,15,18,14,5,20,20,0,0,95
3,15,18,14,5,20,20,5,0,100
3,15,18,14,5,20,20,5,18,118
3,15,18,14,5,20,20,9,0,104
3,15,18,14,5,20,20,15,0,110
3,15,18,14,5,21,12,5,0,93
3,15,18,14,5,21,13,0,0,89
3,15,18,14,6,5,4,0,0,65
3,15,18,14,6,9,5,12,4,86
3,15,18,14,6,12,1,7,0,76
3,15,18,14,6,12,15,15,18,116
3,15,18,14,6,12,15,21,18,122
3,15,18,14,8,15,12,5,0,90
3,15,18,14,8,15,21,19,5,118
3,15,18,14,8,21,19,11,0,109
3,15,18,14,8,21,19,11,19,128
3,15,18,14,9,3,0,0,0,62
3,15,18,14,9,3,5,0,0,67
3,15,18,14,9,3,5,4,0,71
3,15,18,14,9,3,5,19,0,86
3,15,18,14,9,3,8,5,0,75
3,15,18,14,9,3,8,5,19,94
3,15,18,14,9,3,9,14,7,92
3,15,18,14,9,3,12,5,0,79
3,15,18,14,9,3,12,5,19,98
3,15,18,14,9,5,18,0,0,82
3,15,18,14,9,5,19,20,0,103
3,15,18,14,9,6,25,0,0,90
3,15,18,14,9,6,9,3,0,77
3,15,18,14,9,6,9,5,4,83
3,15,18,14,9,6,15,18,13,111
3,15,18,14,9,12,25,0,0,96
3,15,18,14,9,14,0,0,0,73
3,15,18,14,9,14,5,19,19,116
3,15,18,14,9,24,0,0,0,83
3,15,18,14,12,5,19,19,0,105
3,15,18,14,12,15,6,20,0,103
3,15,18,14,13,5,1,12,0,81
3,15,18,14,13,5,1,12,19,100
3,15,18,14,13,21,19,5,0,108
3,15,18,14,15,16,5,1,14,101
3,15,18,14,16,9,16,5,0,96
3,15,18,14,18,9,3,11,0,91
3,15,18,14,18,15,15,20,0,118
3,15,18,14,18,15,23,0,0,106
3,15,18,14,18,15,23,19,0,125
3,15,18,14,19,0,0,0,0,69
3,15,18,14,19,1,3,11,0,84
3,15,18,14,19,20,15,14,5,123
3,15,18,14,19,20,15,15,11,130
3,15,18,14,21,0,0,0,0,71
3,15,18,14,21,1,0,0,0,72
3,15,18,14,21,1,12,0,0,84
3,15,18,14,21,1,20,5,0,97
3,15,18,14,21,1,20,5,4,101
3,15,18,14,21,12,5,0,0,88
3,15,18,14,21,12,9,20,5,117
3,15,18,14,21,16,5,20,5,117
3,15,18,14,21,19,5,19,0,114
3,15,18,14,21,20,5,0,0,96
3,15,18,14,21,20,5,4,0,100
3,15,18,14,21,20,9,14,0,114
3,15,18,14,21,20,9,14,5,119
3,15,18,14,21,20,9,14,7,121
3,15,18,14,21,20,15,0,0,106
3,15,18,14,21,20,15,19,0,125
3,15,18,14,21,20,21,19,0,131
3,15,18,15,1,0,0,0,0,52
3,15,18,15,4,25,0,0,0,80
3,15,18,15,4,9,1,18,25,108
3,15,18,15,4,9,5,19,0,88
3,15,18,15,10,15,0,0,0,76
3,15,18,15,12,0,0,0,0,63
3,15,18,15,12,9,20,9,3,104
3,15,18,15,12,12,0,0,0,75
3,15,18,15,12,12,1,18,25,119
3,15,18,15,12,12,1,19,0,95
3,15,18,15,12,12,1,20,5,101
3,15,18,15,12,12,5,20,0,100
3,15,18,15,12,12,9,11,5,100
3,15,18,15,12,12,9,14,5,103
3,15,18,15,13,5,12,12,0,93
3,15,18,15,13,5,20,5,18,112
3,15,18,15,14,1,0,0,0,66
3,15,18,15,14,1,3,8,0,77
3,15,18,15,14,1,3,8,19,96
3,15,18,15,14,1,4,0,0,70
3,15,18,15,14,1,4,15,19,104
3,15,18,15,14,1,5,0,0,71
3,15,18,15,14,1,12,0,0,78
3,15,18,15,14,1,12,5,0,83
3,15,18,15,14,1,12,5,4,87
3,15,18,15,14,1,12,12,25,115
3,15,18,15,14,1,12,19,0,97
3,15,18,15,14,1,13,5,14,98
3,15,18,15,14,1,18,25,0,109
3,15,18,15,14,1,19,0,0,85
3,15,18,15,14,1,20,5,0,91
3,15,18,15,14,1,20,5,4,95
3,15,18,15,14,5,0,0,0,70
3,15,18,15,14,5,12,19,0,101
3,15,18,15,14,5,14,5,0,89
3,15,18,15,14,5,18,0,0,88
3,15,18,15,14,5,18,19,0,107
3,15,18,15,14,5,20,0,0,90
3,15,18,15,14,5,20,5,4,99
3,15,18,15,14,5,20,19,0,109
3,15,18,15,14,5,20,20,25,135
3,15,18,15,14,9,12,12,15,113
3,15,18,15,14,9,15,14,0,103
3,15,18,15,14,9,20,9,19,122
3,15,18,15,14,9,21,13,0,108
3,15,18,15,14,9,26,5,0,105
3,15,18,15,14,15,9,4,0,93
3,15,18,15,14,21,12,5,0,103
3,15,18,15,16,12,1,19,20,119
3,15,18,15,19,3,15,16,25,129
3,15,18,15,19,9,6,0,0,85
3,15,18,15,20,1,20,5,0,97
3,15,18,15,20,1,20,5,4,101
3,15,18,15,20,1,20,5,19,116
3,15,18,15,20,15,13,25,0,124
3,15,18,15,21,14,0,0,0,86
3,15,18,15,21,20,9,14,5,120
3,15,18,15,26,15,0,0,0,92
3,15,18,15,26,15,19,0,0,111
3,15,18,16,14,0,0,0,0,66
3,15,18,16,15,18,1,0,0,86
3,15,18,16,15,18,1,3,25,114
3,15,18,16,15,18,1,12,5,103
3,15,18,16,15,18,1,12,19,117
3,15,18,16,15,18,1,19,0,105
3,15,18,16,15,18,1,20,5,111
3,15,18,16,15,18,5,0,0,90
3,15,18,16,15,18,5,1,12,103
3,15,18,16,15,18,9,6,25,125
3,15,18,16,15,19,1,14,20,121
3,15,18,16,19,0,0,0,0,71
3,15,18,16,19,5,0,0,0,76
3,15,18,16,19,5,19,0,0,95
3,15,18,16,19,25,0,0,0,96
3,15,18,16,19,13,1,14,0,99
3,15,18,16,19,13,5,14,0,103
3,15,18,16,21,12,5,14,20,124
3,15,18,16,21,19,0,0,0,92
3,15,18,16,21,19,3,12,5,112
3,15,18,18,1,4,5,0,0,64
3,15,18,18,1,4,5,4,0,68
3,15,18,18,1,4,5,19,0,83
3,15,18,18,1,4,9,1,12,81
3,15,18,18,1,4,9,14,7,89
3,15,18,18,1,12,0,0,0,67
3,15,18,18,1,12,12,5,4,88
3,15,18,18,1,12,19,0,0,86
3,15,18,18,1,19,9,15,14,112
3,15,18,18,1,19,9,22,5,110
3,15,18,18,5,1,12,0,0,72
3,15,18,18,5,3,20,0,0,82
3,15,18,18,5,3,20,5,4,91
3,15,18,18,5,3,20,5,18,105
3,15,18,18,5,3,20,12,25,119
3,15,18,18,5,3,20,15,18,115
3,15,18,18,5,3,20,19,0,101
3,15,18,18,5,12,0,0,0,71
3,15,18,18,5,12,1,20,5,97
3,15,18,18,5,14,20,5,0,98
3,15,18,18,5,15,0,0,0,74
3,15,18,18,5,19,15,12,0,105
3,15,18,18,5,19,16,0,0,94
3,15,18,18,9,4,1,0,0,68
3,15,18,18,9,4,1,19,0,87
3,15,18,18,9,4,15,0,0,82
3,15,18,18,9,4,15,18,0,100
3,15,18,18,9,4,15,18,19,119
3,15,18,18,9,5,19,0,0,87
3,15,18,18,9,7,5,0,0,75
3,15,18,18,9,7,5,14,20,109
3,15,18,18,9,22,1,12,0,98
3,15,18,18,9,22,1,12,19,117
3,15,18,18,9,22,1,20,5,111
3,15,18,18,9,22,5,0,0,90
3,15,18,18,15,2,5,18,0,94
3,15,18,18,15,2,15,18,9,113
3,15,18,18,15,4,1,14,20,108
3,15,18,18,15,4,5,0,0,78
3,15,18,18,15,4,5,4,0,82
3,15,18,18,15,4,5,14,20,112
3,15,18,18,15,4,5,18,0,96
3,15,18,18,15,4,5,18,19,115
3,15,18,18,15,4,5,19,0,97
3,15,18,18,15,4,25,0,0,98
3,15,18,18,15,4,9,5,18,105
3,15,18,18,15,4,9,5,19,106
3,15,18,18,15,4,9,14,7,103
3,15,18,18,15,19,9,15,14,126
3,15,18,18,15,19,9,22,5,124
3,15,18,18,21,7,1,14,20,117
3,15,18,18,21,7,1,20,5,108
3,15,18,18,21,7,5,14,20,121
3,15,18,18,21,13,16,0,0,104
3,15,18,18,21,16,0,0,0,91
3,15,18,18,21,16,20,0,0,111
3,15,18,18,21,16,20,5,4,120
3,15,18,18,21,16,20,5,18,134
3,15,18,18,21,16,20,12,25,148
3,15,18,18,21,16,20,15,18,144
3,15,18,18,21,16,20,19,0,130
3,15,18,19,1,3,0,0,0,59
3,15,18,19,1,3,19,0,0,78
3,15,18,19,1,7,5,0,0,68
3,15,18,19,1,7,5,19,0,87
3,15,18,19,1,9,14,20,0,99
3,15,18,19,1,9,18,0,0,83
3,15,18,19,1,9,18,19,0,102
3,15,18,19,1,11,0,0,0,67
3,15,18,19,5,12,5,20,0,97
3,15,18,19,5,12,5,20,19,116
3,15,18,19,5,17,21,5,0,103
3,15,18,19,5,18,0,0,0,78
3,15,18,19,5,19,0,0,0,79
3,15,18,19,5,19,17,21,5,122
3,15,18,19,5,20,0,0,0,80
3,15,18,19,5,20,5,4,0,89
3,15,18,19,5,20,9,5,18,112
3,15,18,19,5,20,9,14,7,110
3,15,18,19,5,20,18,25,0,123
3,15,18,19,5,20,19,0,0,99
3,15,18,19,25,0,0,0,0,80
3,15,18,19,9,5,0,0,0,69
3,15,18,19,9,20,5,0,0,89
3,15,18,19,12,5,20,0,0,92
3,15,18,19,12,5,20,19,0,111
3,15,18,19,14,5,4,0,0,78
3,15,18,19,15,19,0,0,0,89
3,15,18,20,1,0,0,0,0,57
3,15,18,20,5,7,5,0,0,73
3,15,18,20,5,7,5,19,0,92
3,15,18,20,5,9,19,5,0,94
3,15,18,20,5,24,0,0,0,85
3,15,18,20,5,24,5,19,0,109
3,15,18,20,9,1,14,0,0,80
3,15,18,20,9,3,1,12,0,81
3,15,18,20,9,3,1,20,5,94
3,15,18,20,9,3,5,19,0,92
3,15,18,20,9,3,9,14,0,91
3,15,18,20,9,3,9,14,5,96
3,15,18,20,9,3,15,9,4,96
3,15,18,20,9,3,15,12,5,100
3,15,18,20,9,3,15,19,5,107
3,15,18,20,9,3,15,21,19,123
3,15,18,20,9,12,5,0,0,82
3,15,18,20,9,14,0,0,0,79
3,15,18,20,9,14,1,0,0,80
3,15,18,20,9,14,1,5,0,85
3,15,18,20,9,14,1,20,5,105
3,15,18,20,9,14,5,0,0,84
3,15,18,20,9,14,19,0,0,98
3,15,18,20,9,19,15,12,0,111
3,15,18,20,9,19,15,12,19,130
3,15,18,20,9,19,15,14,5,118
3,15,18,21,3,15,0,0,0,75
3,15,18,21,12,5,18,0,0,92
3,15,18,21,14,4,21,13,0,109
3,15,18,21,14,4,21,13,19,128
3,15,18,21,16,1,25,0,0,99
3,15,18,21,19,3,1,14,20,114
3,15,18,21,19,3,1,20,5,105
3,15,18,22,0,0,0,0,0,58
3,15,18,22,5,0,0,0,0,63
3,15,18,22,5,4,0,0,0,67
3,15,18,22,5,5,0,0,0,68
3,15,18,22,5,5,19,0,0,87
3,15,18,22,5,14,0,0,0,77
3,15,18,22,5,18,0,0,0,81
3,15,18,22,5,19,0,0,0,82
3,15,18,22,5,20,0,0,0,83
3,15,18,22,5,20,19,0,0,102
3,15,18,22,5,20,20,5,0,108
3,15,18,22,5,20,20,5,19,127
3,15,18,22,5,20,20,15,0,118
3,15,18,22,9,6,15,18,13,119
3,15,18,22,9,14,1,0,0,82
3,15,18,22,9,14,1,19,0,101
3,15,18,22,9,14,5,0,0,86
3,15,18,22,9,19,5,18,0,109
3,15,18,22,9,19,15,18,0,119
3,15,18,22,11,20,20,5,0,114
3,15,18,22,15,9,4,0,0,86
3,15,18,22,15,18,1,14,20,126
3,15,19,1,12,9,20,5,0,84
3,15,19,1,17,21,5,0,0,81
3,15,19,1,22,9,15,18,0,102
3,15,19,3,5,20,0,0,0,65
3,15,19,3,15,18,15,2,1,91
3,15,19,3,18,9,16,20,0,103
3,15,19,5,0,0,0,0,0,42
3,15,19,5,1,20,0,0,0,63
3,15,19,5,3,0,0,0,0,45
3,15,19,5,3,1,14,20,0,80
3,15,19,5,3,1,14,20,19,99
3,15,19,5,3,8,0,0,0,53
3,15,19,5,3,19,0,0,0,64
3,15,19,5,4,0,0,0,0,46
3,15,19,5,7,13,5,14,20,101
3,15,19,5,25,0,0,0,0,67
3,15,19,5,9,5,18,0,0,74
3,15,19,5,9,5,19,20,0,95
3,15,19,5,25,19,0,0,0,86
3,15,19,5,9,19,13,0,0,83
3,15,19,5,9,19,13,1,12,96
3,15,19,5,9,19,13,9,3,95
3,15,19,5,14,0,0,0,0,56
3,15,19,5,14,1,20,15,18,110
3,15,19,5,18,22,1,14,20,117
3,15,19,5,19,0,0,0,0,61
3,15,19,5,19,19,9,15,14,118
3,15,19,5,20,0,0,0,0,62
3,15,19,5,20,19,0,0,0,81
3,15,19,5,20,20,12,5,18,117
3,15,19,8,0,0,0,0,0,45
3,15,19,8,1,18,5,18,0,87
3,15,19,8,5,1,20,8,0,79
3,15,19,8,5,4,0,0,0,54
3,15,19,8,5,18,0,0,0,68
3,15,19,8,5,18,5,4,0,77
3,15,19,8,5,18,5,18,0,91
3,15,19,8,5,18,25,0,0,93
3,15,19,8,5,18,9,5,19,101
3,15,19,8,5,18,9,14,7,98
3,15,19,8,5,18,19,0,0,87
3,15,19,8,5,19,0,0,0,69
3,15,19,8,9,14,7,0,0,75
3,15,19,25,0,0,0,0,0,62
3,15,19,9,5,0,0,0,0,51
3,15,19,9,5,4,0,0,0,55
3,15,19,9,5,18,0,0,0,69
3,15,19,9,5,19,0,0,0,70
3,15,19,9,5,19,20,0,0,90
3,15,19,9,7,14,0,0,0,67
3,15,19,9,7,14,5,4,0,76
3,15,19,9,7,14,5,18,0,90
3,15,19,9,7,14,5,18,19,109
3,15,19,9,7,14,9,14,7,97
3,15,19,9,7,14,19,0,0,86
3,15,19,25,9,14,7,0,0,92
3,15,19,9,12,25,0,0,0,83
3,15,19,9,14,0,0,0,0,60
3,15,19,9,14,1,7,5,0,73
3,15,19,9,14,5,19,0,0,84
3,15,19,9,14,5,19,19,0,103
3,15,19,9,14,7,0,0,0,67
3,15,19,9,14,19,0,0,0,79
3,15,19,13,5,19,9,19,0,102
3,15,19,13,5,20,5,0,0,80
3,15,19,13,5,20,9,3,0,87
3,15,19,13,5,20,9,3,19,106
3,15,19,13,9,3,1,12,0,75
3,15,19,13,9,14,5,0,0,78
3,15,19,13,9,19,13,0,0,91
3,15,19,13,9,19,13,19,0,110
3,15,19,13,9,19,20,0,0,98
3,15,19,13,9,19,20,19,0,117
3,15,19,13,15,3,18,1,20,107
3,15,19,13,15,7,5,14,25,116
3,15,19,13,15,7,15,14,25,126
3,15,19,13,15,9,4,0,0,78
3,15,19,13,15,12,1,2,5,85
3,15,19,13,15,12,9,14,5,105
3,15,19,13,15,12,15,7,25,124
3,15,19,13,15,14,1,21,20,121
3,15,19,13,15,18,1,13,1,98
3,15,19,13,15,19,5,19,0,108
3,15,19,13,15,26,15,1,14,121
3,15,19,13,15,26,15,9,3,118
3,15,19,15,14,1,14,20,0,101
3,15,19,16,5,3,9,5,19,94
3,15,19,16,8,5,18,5,4,93
3,15,19,16,15,14,19,15,18,134
3,15,19,19,0,0,0,0,0,56
3,15,19,19,1,3,11,19,0,90
3,15,19,19,1,19,0,0,0,76
3,15,19,19,5,0,0,0,0,61
3,15,19,19,5,20,0,0,0,81
3,15,19,19,5,20,5,4,0,90
3,15,19,19,5,20,9,14,7,111
3,15,19,19,5,20,19,0,0,100
3,15,19,19,5,20,20,5,0,106
3,15,19,19,5,20,20,5,4,110
3,15,19,19,8,5,14,0,0,83
3,15,19,19,9,3,0,0,0,68
3,15,19,19,9,4,0,0,0,69
3,15,19,19,9,5,0,0,0,70
3,15,19,19,25,18,9,20,5,133
3,15,19,19,14,5,14,20,0,109
3,15,19,20,1,5,0,0,0,63
3,15,19,20,1,7,5,0,0,70
3,15,19,20,1,12,0,0,0,70
3,15,19,20,1,12,7,9,1,87
3,15,19,20,1,12,12,25,0,107
3,15,19,20,1,14,4,5,18,99
3,15,19,20,1,18,4,0,0,80
3,15,19,20,1,18,4,19,0,99
3,15,19,20,1,18,18,5,4,103
3,15,19,20,1,18,19,0,0,95
3,15,19,20,1,20,5,0,0,83
3,15,19,20,1,20,5,4,0,87
3,15,19,20,5,1,14,0,0,77
3,15,19,20,5,4,0,0,0,66
3,15,19,20,5,5,14,0,0,81
3,15,19,20,5,18,4,15,13,112
3,15,19,20,5,18,19,0,0,99
3,15,19,20,6,21,12,0,0,96
3,15,19,20,9,6,15,18,13,118
3,15,19,20,9,14,7,0,0,87
3,15,19,20,9,15,21,19,0,121
3,15,19,20,9,22,5,0,0,93
3,15,19,20,9,22,5,12,25,130
3,15,19,20,12,5,19,19,0,112
3,15,19,20,12,5,23,0,0,97
3,15,19,20,12,25,0,0,0,94
3,15,19,20,12,9,5,18,0,101
3,15,19,20,12,9,5,19,20,122
3,15,19,20,13,1,18,25,0,114
3,15,19,20,15,20,15,13,5,125
3,15,19,20,15,20,15,13,25,145
3,15,19,20,18,5,12,0,0,92
3,15,19,20,18,5,12,19,0,111
3,15,19,20,19,0,0,0,0,76
3,15,19,20,21,12,1,0,0,91
3,15,19,20,21,13,5,0,0,96
3,15,19,20,21,13,5,4,0,100
3,15,19,20,21,13,5,25,0,121
3,15,19,20,21,13,5,18,0,114
3,15,19,20,21,13,5,18,25,139
3,15,19,20,21,13,5,18,19,133
3,15,19,20,21,13,5,19,0,115
3,15,19,20,21,13,9,3,0,103
3,15,19,20,21,13,9,5,18,123
3,15,19,20,21,13,9,14,7,121
3,15,19,20,21,13,9,18,5,123
3,15,19,20,21,13,9,19,20,139
3,15,19,21,2,10,5,3,20,98
3,15,19,21,6,6,5,18,0,93
3,15,19,21,9,20,15,18,0,120
3,15,19,21,18,5,20,25,0,126
3,15,19,21,19,20,1,9,14,121
3,15,19,23,5,1,18,5,18,107
3,15,20,1,14,0,0,0,0,53
3,15,20,1,14,7,5,14,20,99
3,15,20,1,14,19,0,0,0,72
3,15,20,1,18,9,21,19,0,106
3,15,20,1,18,14,9,14,0,94
3,15,20,1,18,14,9,14,5,99
3,15,20,2,5,20,20,25,0,110
3,15,20,3,8,0,0,0,0,49
3,15,20,5,1,21,24,0,0,89
3,15,20,5,4,0,0,0,0,47
3,15,20,5,5,14,0,0,0,62
3,15,20,5,6,21,12,0,0,82
3,15,20,5,12,5,0,0,0,60
3,15,20,5,12,9,14,5,0,83
3,15,20,5,12,12,5,18,0,90
3,15,20,5,14,1,14,3,25,100
3,15,20,5,14,1,14,20,0,92
3,15,20,5,14,1,14,20,19,111
3,15,20,5,14,21,18,5,0,101
3,15,20,5,18,5,12,12,0,90
3,15,20,5,18,25,0,0,0,86
3,15,20,5,18,9,5,0,0,75
3,15,20,5,18,9,5,19,0,94
3,15,20,5,19,0,0,0,0,62
3,15,20,8,0,0,0,0,0,46
3,15,20,8,1,13,0,0,0,60
3,15,20,8,1,13,15,18,5,98
3,15,20,8,5,0,0,0,0,51
3,15,20,8,25,0,0,0,0,71
3,15,20,8,9,19,8,0,0,82
3,15,20,8,15,14,0,0,0,75
3,15,20,8,15,21,19,5,0,106
3,15,20,8,21,18,14,0,0,99
3,15,20,8,21,18,14,1,12,112
3,15,20,8,21,18,14,5,4,108
3,15,20,8,21,18,14,9,0,108
3,15,20,8,21,18,14,14,9,122
3,15,20,8,21,18,14,19,0,118
3,15,20,8,21,18,14,21,19,139
3,15,20,9,3,5,0,0,0,55
3,15,20,9,3,5,4,0,0,59
3,15,20,9,3,9,14,7,0,80
3,15,20,9,3,21,12,1,18,102
3,15,20,9,4,1,12,0,0,64
3,15,20,25,12,0,0,0,0,75
3,15,20,25,12,1,0,0,0,76
3,15,20,25,12,1,18,0,0,94
3,15,20,25,12,5,0,0,0,80
3,15,20,25,12,5,4,15,14,113
3,15,20,9,12,12,1,7,5,84
3,15,20,9,12,12,9,15,14,109
3,15,20,9,12,12,15,14,0,100
3,15,20,9,12,12,15,14,19,119
3,15,20,25,12,15,9,4,0,103
3,15,20,9,14,7,0,0,0,68
3,15,20,9,14,7,9,4,0,81
3,15,20,9,14,7,15,9,4,96
3,15,20,25,16,5,0,0,0,84
3,15,20,25,16,5,19,0,0,103
3,15,20,9,19,5,0,0,0,71
3,15,20,9,19,5,4,0,0,75
3,15,20,9,19,9,14,7,0,96
3,15,20,9,20,21,12,1,18,119
3,15,20,12,1,14,4,0,0,69
3,15,20,15,0,0,0,0,0,53
3,15,20,15,9,14,0,0,0,76
3,15,20,15,14,9,1,0,0,77
3,15,20,15,14,9,5,18,0,99
3,15,20,15,18,13,5,14,20,123
3,15,20,15,18,15,0,0,0,86
3,15,20,15,18,15,19,0,0,105
3,15,20,15,18,20,21,18,5,135
3,15,20,17,21,5,1,14,0,96
3,15,20,17,21,5,1,14,19,115
3,15,20,18,1,9,20,15,18,119
3,15,20,18,9,14,5,0,0,84
3,15,20,18,9,16,16,5,18,120
3,15,20,18,21,19,20,5,5,126
3,15,20,19,5,20,0,0,0,82
3,15,20,19,5,20,12,1,0,95
3,15,20,19,5,20,12,5,0,99
3,15,20,20,1,0,0,0,0,59
3,15,20,20,1,2,21,19,0,101
3,15,20,20,1,5,0,0,0,64
3,15,20,20,1,7,5,0,0,71
3,15,20,20,1,7,5,4,0,75
3,15,20,20,1,7,5,25,0,96
3,15,20,20,1,7,5,18,0,89
3,15,20,20,1,7,5,18,19,108
3,15,20,20,1,7,5,19,0,90
3,15,20,20,1,18,0,0,0,77
3,15,20,20,1,18,19,0,0,96
3,15,20,20,1,19,0,0,0,78
3,15,20,20,5,0,0,0,0,63
3,15,20,20,5,4,0,0,0,67
3,15,20,20,5,18,5,4,0,90
3,15,20,20,5,18,5,12,0,98
3,15,20,20,5,18,9,14,7,111
3,15,20,20,5,18,9,20,5,115
3,15,20,20,5,18,19,0,0,100
3,15,20,20,5,18,23,1,25,130
3,15,20,20,25,0,0,0,0,83
3,15,20,20,9,4,0,0,0,71
3,15,20,20,9,5,18,0,0,90
3,15,20,20,9,5,18,19,0,109
3,15,20,20,9,5,19,20,0,111
3,15,20,20,9,6,15,18,13,119
3,15,20,20,9,19,5,0,0,91
3,15,20,20,15,9,4,0,0,86
3,15,20,20,15,14,1,4,5,97
3,15,20,20,15,14,5,4,0,96
3,15,20,20,15,14,5,5,0,97
3,15,20,20,15,14,5,5,18,115
3,15,20,20,15,14,5,18,0,110
3,15,20,20,15,14,25,0,0,112
3,15,20,20,15,14,9,14,7,117
3,15,20,20,15,14,9,26,5,127
3,15,20,20,15,14,19,0,0,106
3,15,20,20,15,14,20,15,16,138
3,15,20,20,18,5,12,0,0,93
3,15,20,21,12,1,0,0,0,72
3,15,20,21,14,14,9,20,5,121
3,15,20,21,20,15,18,0,0,112
3,15,20,23,1,12,0,0,0,74
3,15,20,23,9,14,0,0,0,84
3,15,20,23,9,14,14,5,4,107
3,15,20,23,9,19,20,0,0,109
3,15,21,1,3,0,0,0,0,43
3,15,21,3,1,12,0,0,0,55
3,15,21,3,8,0,0,0,0,50
3,15,21,3,8,1,14,3,25,93
3,15,21,3,8,1,14,20,0,85
3,15,21,3,8,5,0,0,0,55
3,15,21,3,8,5,4,0,0,59
3,15,21,3,8,5,5,0,0,60
3,15,21,3,8,5,18,19,0,92
3,15,21,3,8,5,19,0,0,74
3,15,21,3,8,5,20,20,5,100
3,15,21,3,8,25,0,0,0,75
3,15,21,3,8,9,14,7,0,80
3,15,21,3,8,9,14,7,19,99
3,15,21,3,8,13,1,20,5,89
3,15,21,4,0,0,0,0,0,43
3,15,21,4,5,0,0,0,0,48
3,15,21,4,5,5,0,0,0,53
3,15,21,7,1,18,0,0,0,65
3,15,21,7,1,18,19,0,0,84
3,15,21,7,8,0,0,0,0,54
3,15,21,7,8,5,4,0,0,63
3,15,21,7,8,5,18,0,0,77
3,15,21,7,8,5,18,19,0,96
3,15,21,7,8,9,14,7,0,84
3,15,21,7,8,18,15,15,20,122
3,15,21,7,8,19,0,0,0,73
3,15,21,7,8,23,5,5,4,91
3,15,21,7,8,23,15,18,20,130
3,15,21,7,14,1,18,0,0,79
3,15,21,8,1,7,5,0,0,60
3,15,21,12,0,0,0,0,0,51
3,15,21,12,1,7,5,0,0,64
3,15,21,12,4,0,0,0,0,55
3,15,21,12,4,5,19,20,0,99
3,15,21,12,4,14,0,0,0,69
3,15,21,12,4,14,1,0,0,70
3,15,21,12,4,14,20,0,0,89
3,15,21,12,4,18,15,14,0,102
3,15,21,12,4,19,20,0,0,94
3,15,21,12,5,5,0,0,0,61
3,15,21,12,5,5,19,0,0,80
3,15,21,12,5,21,18,0,0,95
3,15,21,12,9,5,0,0,0,65
3,15,21,12,9,5,18,0,0,83
3,15,21,12,9,19,0,0,0,79
3,15,21,12,9,19,19,5,0,103
3,15,21,12,9,19,19,5,19,122
3,15,21,12,15,9,18,0,0,93
3,15,21,12,15,9,18,19,0,112
3,15,21,12,15,13,2,9,3,93
3,15,21,12,15,13,2,19,0,100
3,15,21,12,20,8,1,18,4,102
3,15,21,12,21,18,5,0,0,95
3,15,21,13,1,0,0,0,0,53
3,15,21,13,1,12,9,3,0,77
3,15,21,13,1,12,9,14,0,88
3,15,21,13,1,16,8,15,19,111
3,15,21,13,1,18,1,0,0,72
3,15,21,13,1,18,1,14,0,86
3,15,21,13,1,18,1,14,5,91
3,15,21,13,1,18,1,20,5,97
3,15,21,13,1,18,9,3,0,83
3,15,21,13,1,18,9,14,0,94
3,15,21,13,1,18,9,14,19,113
3,15,21,13,1,18,15,14,5,105
3,15,21,13,1,18,15,21,0,107
3,15,21,13,1,18,15,21,19,126
3,15,21,13,2,9,20,5,0,88
3,15,21,14,3,9,12,0,0,77
3,15,21,14,3,9,12,15,18,110
3,15,21,14,3,9,12,19,0,96
3,15,21,14,9,20,5,0,0,87
3,15,21,14,19,5,12,0,0,89
3,15,21,14,19,5,12,5,4,98
3,15,21,14,19,5,12,5,5,99
3,15,21,14,19,5,12,15,18,122
3,15,21,14,19,5,12,19,0,108
3,15,21,14,20,1,2,12,5,93
3,15,21,14,20,1,2,12,25,113
3,15,21,14,20,4,15,13,0,105
3,15,21,14,20,4,15,23,14,129
3,15,21,14,20,5,4,0,0,82
3,15,21,14,20,5,18,0,0,96
3,15,21,14,20,5,18,5,4,105
3,15,21,14,20,5,18,12,25,133
3,15,21,14,20,5,18,19,0,115
3,15,21,14,20,6,9,19,8,115
3,15,21,14,20,25,0,0,0,98
3,15,21,14,20,9,1,14,0,97
3,15,21,14,20,9,1,14,19,116
3,15,21,14,20,9,5,19,0,106
3,15,21,14,20,9,14,7,0,103
3,15,21,14,20,25,19,0,0,117
3,15,21,14,20,12,5,19,19,128
3,15,21,14,20,15,18,0,0,106
3,15,21,14,20,15,21,18,0,127
3,15,21,14,20,18,5,5,0,101
3,15,21,14,20,18,25,0,0,116
3,15,21,14,20,18,9,5,0,105
3,15,21,14,20,18,9,5,19,124
3,15,21,14,20,18,9,6,25,131
3,15,21,14,20,19,0,0,0,92
3,15,21,14,20,19,8,9,16,125
3,15,21,16,0,0,0,0,0,55
3,15,21,16,1,7,5,0,0,68
3,15,21,16,5,0,0,0,0,60
3,15,21,16,5,4,0,0,0,64
3,15,21,16,5,5,0,0,0,65
3,15,21,16,5,12,5,20,0,97
3,15,21,16,5,18,0,0,0,78
3,15,21,16,5,19,0,0,0,79
3,15,21,16,9,14,7,0,0,85
3,15,21,16,12,5,0,0,0,72
3,15,21,16,12,5,4,0,0,76
3,15,21,16,12,5,18,0,0,90
3,15,21,16,12,5,18,19,0,109
3,15,21,16,12,5,19,0,0,91
3,15,21,16,12,5,20,0,0,92
3,15,21,16,12,5,20,19,0,111
3,15,21,16,12,9,14,7,0,97
3,15,21,16,12,9,14,7,19,116
3,15,21,16,15,14,0,0,0,84
3,15,21,16,15,14,5,4,0,93
3,15,21,16,15,14,19,0,0,103
3,15,21,16,19,0,0,0,0,74
3,15,21,16,19,20,9,3,11,117
3,15,21,16,21,18,5,0,0,99
3,15,21,18,1,7,5,0,0,70
3,15,21,18,1,7,5,18,0,88
3,15,21,18,1,7,5,19,0,89
3,15,21,18,1,14,20,0,0,92
3,15,21,18,1,14,20,5,0,97
3,15,21,18,1,14,20,5,19,116
3,15,21,18,1,14,20,15,0,107
3,15,21,18,1,14,20,15,19,126
3,15,21,18,1,14,20,19,0,111
3,15,21,18,1,16,0,0,0,74
3,15,21,18,1,20,1,18,9,106
3,15,21,18,2,0,0,0,0,59
3,15,21,18,2,1,3,8,5,76
3,15,21,18,2,1,18,9,12,99
3,15,21,18,2,1,19,8,0,87
3,15,21,18,2,5,0,0,0,64
3,15,21,18,2,5,20,20,5,109
3,15,21,18,3,8,5,0,0,73
3,15,21,18,7,5,0,0,0,69
3,15,21,18,7,5,20,20,5,114
3,15,21,18,9,4,1,0,0,71
3,15,21,18,9,5,0,0,0,71
3,15,21,18,9,5,18,19,0,108
3,15,21,18,9,12,0,0,0,78
3,15,21,18,12,1,14,0,0,84
3,15,21,18,12,1,14,19,0,103
3,15,21,18,15,14,14,5,0,105
3,15,21,18,19,5,0,0,0,81
3,15,21,18,19,5,4,0,0,85
3,15,21,18,19,5,25,0,0,106
3,15,21,18,19,5,18,0,0,99
3,15,21,18,19,5,18,19,0,118
3,15,21,18,19,5,19,0,0,100
3,15,21,18,19,25,0,0,0,101
3,15,21,18,19,9,14,7,0,106
3,15,21,18,19,9,14,7,19,125
3,15,21,18,20,1,7,5,0,90
3,15,21,18,20,1,12,0,0,90
3,15,21,18,20,2,25,0,0,104
3,15,21,18,20,2,18,5,4,106
3,15,21,18,20,5,4,0,0,86
3,15,21,18,20,5,15,21,19,137
3,15,21,18,20,5,16,25,0,123
3,15,21,18,20,5,18,0,0,100
3,15,21,18,20,5,18,19,0,119
3,15,21,18,20,5,19,1,14,116
3,15,21,18,20,5,19,25,0,126
3,15,21,18,20,5,26,1,14,123
3,15,21,18,20,25,0,0,0,102
3,15,21,18,20,25,1,18,4,125
3,15,21,18,20,9,5,18,0,109
3,15,21,18,20,9,5,18,25,134
3,15,21,18,20,9,5,18,19,128
3,15,21,18,20,9,14,0,0,100
3,15,21,18,20,9,14,7,0,107
3,15,21,18,20,12,5,19,19,132
3,15,21,18,20,12,5,20,0,114
3,15,21,18,20,12,25,0,0,114
3,15,21,18,20,12,9,5,18,121
3,15,21,18,20,12,9,11,5,114
3,15,21,18,20,12,9,14,7,119
3,15,21,18,20,13,1,14,0,105
3,15,21,18,20,14,15,12,12,130
3,15,21,18,20,18,15,12,12,134
3,15,21,18,20,18,15,15,13,138
3,15,21,18,20,19,0,0,0,96
3,15,21,18,20,19,8,9,16,129
3,15,21,18,20,19,9,4,5,114
3,15,21,19,3,15,21,19,0,116
3,15,21,19,9,14,1,7,5,94
3,15,21,19,9,14,5,19,19,124
3,15,21,19,9,14,25,0,0,106
3,15,21,19,9,14,12,25,0,118
3,15,21,19,9,14,18,25,0,124
3,15,21,19,19,9,14,5,20,125
3,15,21,20,5,1,21,0,0,86
3,15,21,20,5,1,21,24,0,110
3,15,21,20,5,12,0,0,0,76
3,15,21,20,5,12,12,5,0,93
3,15,21,20,5,18,0,0,0,82
3,15,21,20,5,18,19,0,0,101
3,15,21,20,8,0,0,0,0,67
3,15,21,20,8,5,0,0,0,72
3,15,21,20,8,5,18,0,0,90
3,15,21,20,8,5,19,20,0,111
3,15,21,20,8,25,0,0,0,92
3,15,21,20,8,9,5,0,0,81
3,15,21,20,8,9,5,18,0,99
3,15,21,20,8,9,5,19,20,120
3,15,21,20,8,9,12,25,0,113
3,15,21,20,8,12,5,19,19,122
3,15,21,20,8,12,25,0,0,104
3,15,21,20,8,19,0,0,0,86
3,15,21,20,9,12,0,0,0,80
3,15,21,20,9,12,12,5,0,97
3,15,21,20,21,13,9,5,18,125
3,15,21,20,21,18,5,19,0,122
3,15,21,20,21,18,9,5,18,130
3,15,21,20,21,18,9,18,5,130
3,15,21,22,1,4,5,0,0,71
3,15,21,22,1,4,5,19,0,90
3,15,21,22,5,0,0,0,0,66
3,15,21,22,5,18,20,0,0,104
3,15,21,22,5,18,20,5,0,109
3,15,21,22,5,21,19,5,0,111
3,15,21,24,9,1,0,0,0,73
3,15,21,24,9,15,0,0,0,87
3,15,22,1,4,15,0,0,0,60
3,15,22,1,12,5,14,3,5,80
3,15,22,1,12,5,14,3,25,100
3,15,22,1,12,5,14,20,0,92
3,15,22,1,18,25,0,0,0,84
3,15,22,1,18,9,1,14,20,103
3,15,22,1,18,9,1,20,5,94
3,15,22,1,19,19,1,12,0,92
3,15,22,5,0,0,0,0,0,45
3,15,22,5,4,0,0,0,0,49
3,15,22,5,25,0,0,0,0,70
3,15,22,5,25,19,0,0,0,89
3,15,22,5,12,12,9,14,5,97
3,15,22,5,12,12,9,20,5,103
3,15,22,5,14,0,0,0,0,59
3,15,22,5,14,1,2,12,5,79
3,15,22,5,14,1,2,12,25,99
3,15,22,5,14,1,14,3,5,82
3,15,22,5,14,1,14,20,19,113
3,15,22,5,14,19,0,0,0,78
3,15,22,5,14,20,0,0,0,79
3,15,22,5,18,0,0,0,0,63
3,15,22,5,18,1,2,12,5,83
3,15,22,5,18,1,7,5,0,76
3,15,22,5,18,1,7,5,19,95
3,15,22,5,18,1,12,12,0,88
3,15,22,5,18,1,12,12,19,107
3,15,22,5,18,3,12,5,0,83
3,15,22,5,18,5,4,0,0,72
3,15,22,5,18,5,18,0,0,86
3,15,22,5,18,5,18,19,0,105
3,15,22,5,18,9,14,7,0,93
3,15,22,5,18,9,14,7,19,112
3,15,22,5,18,12,5,19,19,118
3,15,22,5,18,12,5,20,0,100
3,15,22,5,18,12,5,20,19,119
3,15,22,5,18,12,9,4,0,88
3,15,22,5,18,12,9,4,19,107
3,15,22,5,18,19,0,0,0,82
3,15,22,5,18,19,5,4,0,91
3,15,22,5,18,19,9,4,5,100
3,15,22,5,18,19,9,14,5,110
3,15,22,5,18,19,12,9,16,119
3,15,22,5,18,19,12,21,20,135
3,15,22,5,18,20,0,0,0,83
3,15,22,5,18,20,12,25,0,120
3,15,22,5,18,20,19,0,0,102
3,15,22,5,18,20,21,18,5,127
3,15,22,5,18,21,16,0,0,100
3,15,22,5,18,21,16,19,0,119
3,15,22,5,19,0,0,0,0,64
3,15,22,5,20,0,0,0,0,65
3,15,22,5,20,1,2,12,5,85
3,15,22,5,20,5,4,0,0,74
3,15,22,5,20,5,18,0,0,88
3,15,22,5,20,5,18,19,0,107
3,15,22,5,20,9,14,7,0,95
3,15,22,5,20,9,19,5,0,98
3,15,22,5,20,15,21,19,0,120
3,15,22,5,20,19,0,0,0,84
3,15,22,9,2,18,1,20,5,95
3,15,22,9,4,0,0,0,0,53
3,15,22,9,4,15,0,0,0,68
3,15,22,9,14,0,0,0,0,63
3,15,22,9,14,5,0,0,0,68
3,15,22,9,14,7,0,0,0,70
3,15,22,9,14,7,19,0,0,89
3,15,22,9,14,15,21,19,0,118
3,15,22,9,14,19,0,0,0,82
3,15,22,9,19,9,20,0,0,97
3,15,22,9,19,9,20,15,18,130
3,15,22,9,20,5,0,0,0,74
3,15,22,15,12,21,13,5,0,106
3,15,22,15,20,1,18,25,0,119
3,15,23,0,0,0,0,0,0,41
3,15,23,1,7,5,0,0,0,54
3,15,23,1,7,5,19,0,0,73
3,15,23,1,12,0,0,0,0,54
3,15,23,1,18,4,25,0,0,89
3,15,23,1,18,4,9,3,5,81
3,15,23,1,18,4,9,19,8,100
3,15,23,1,18,4,12,25,0,101
3,15,23,1,18,4,19,0,0,83
3,15,23,2,1,14,5,0,0,63
3,15,23,2,1,14,5,19,0,82
3,15,23,2,1,18,14,0,0,76
3,15,23,2,5,12,12,0,0,72
3,15,23,2,5,12,12,19,0,91
3,15,23,2,5,18,18,25,0,109
3,15,23,2,9,14,4,0,0,70
3,15,23,2,9,14,4,19,0,89
3,15,23,2,9,18,4,0,0,74
3,15,23,2,9,18,4,19,0,93
3,15,23,2,25,18,5,0,0,91
3,15,23,2,15,25,0,0,0,83
3,15,23,2,15,25,19,0,0,102
3,15,23,2,18,21,20,5,0,107
3,15,23,4,9,5,0,0,0,59
3,15,23,5,4,0,0,0,0,50
3,15,23,5,4,12,25,0,0,87
3,15,23,5,5,14,0,0,0,65
3,15,23,5,18,5,4,0,0,73
3,15,23,5,18,5,18,0,0,87
3,15,23,5,18,5,18,19,0,106
3,15,23,5,18,9,14,7,0,94
3,15,23,5,18,19,0,0,0,83
3,15,23,6,9,19,8,0,0,83
3,15,23,6,9,19,8,5,19,107
3,15,23,6,12,1,16,0,0,76
3,15,23,6,12,1,16,19,0,95
3,15,23,6,12,15,16,0,0,90
3,15,23,6,12,15,16,19,0,109
3,15,23,7,1,20,5,0,0,74
3,15,23,7,9,18,12,0,0,87
3,15,23,7,9,18,12,19,0,106
3,15,23,7,18,1,13,0,0,80
3,15,23,7,18,1,19,19,0,105
3,15,23,8,1,7,5,0,0,62
3,15,23,8,1,7,5,19,0,81
3,15,23,8,1,14,4,0,0,68
3,15,23,8,1,14,4,19,0,87
3,15,23,8,5,1,18,20,0,93
3,15,23,8,5,5,12,0,0,71
3,15,23,8,5,18,2,0,0,74
3,15,23,8,5,18,2,19,0,93
3,15,23,8,5,18,4,0,0,76
3,15,23,8,5,18,4,19,0,95
3,15,23,8,9,4,5,0,0,67
3,15,23,8,9,4,5,4,0,71
3,15,23,8,9,4,5,19,0,86
3,15,23,8,9,4,9,14,7,92
3,15,23,8,15,18,14,0,0,96
3,15,23,8,15,21,19,5,0,109
3,15,23,25,0,0,0,0,0,66
3,15,23,25,1,18,4,0,0,89
3,15,23,9,5,18,0,0,0,73
3,15,23,9,5,19,20,0,0,94
3,15,23,9,14,7,0,0,0,71
3,15,23,9,14,14,5,18,0,101
3,15,23,9,14,14,5,18,19,120
3,15,23,9,19,8,0,0,0,77
3,15,23,9,20,3,8,0,0,81
3,15,23,11,0,0,0,0,0,52
3,15,23,11,5,5,16,5,18,101
3,15,23,11,9,14,5,0,0,80
3,15,23,12,5,0,0,0,0,58
3,15,23,12,5,4,0,0,0,62
3,15,23,12,5,5,3,8,0,74
3,15,23,12,9,3,11,0,0,76
3,15,23,12,9,3,11,19,0,95
3,15,23,12,9,11,5,0,0,78
3,15,23,12,9,14,7,0,0,83
3,15,23,12,9,14,7,19,0,102
3,15,23,12,19,0,0,0,0,72
3,15,23,12,19,20,1,6,6,105
3,15,23,13,1,14,0,0,0,69
3,15,23,13,5,14,0,0,0,73
3,15,23,15,18,11,5,18,0,108
3,15,23,15,18,11,5,18,19,127
3,15,23,15,18,11,9,14,7,115
3,15,23,16,1,20,0,0,0,78
3,15,23,16,1,20,8,0,0,86
3,15,23,16,1,20,19,0,0,97
3,15,23,16,5,1,0,0,0,63
3,15,23,16,5,1,19,0,0,82
3,15,23,16,5,14,0,0,0,76
3,15,23,16,9,5,0,0,0,71
3,15,23,16,9,5,19,0,0,90
3,15,23,16,12,15,16,0,0,100
3,15,23,16,12,15,16,19,0,119
3,15,23,16,15,3,11,0,0,86
3,15,23,16,15,11,5,0,0,88
3,15,23,16,15,11,5,19,0,107
3,15,23,16,15,14,25,0,0,111
3,15,23,16,15,24,0,0,0,96
3,15,23,16,15,24,5,19,0,120
3,15,23,16,21,14,3,8,0,103
3,15,23,17,21,1,11,5,0,96
3,15,23,18,25,0,0,0,0,84
3,15,23,18,9,5,0,0,0,73
3,15,23,18,9,5,19,0,0,92
3,15,23,18,9,20,5,0,0,93
3,15,23,18,9,20,5,19,0,112
3,15,23,18,15,9,4,0,0,87
3,15,23,18,15,20,5,0,0,99
3,15,23,19,0,0,0,0,0,60
3,15,23,19,8,1,18,4,0,91
3,15,23,19,8,1,18,14,0,101
3,15,23,19,8,5,4,0,0,77
3,15,23,19,8,5,4,19,0,96
3,15,23,19,8,15,20,0,0,103
3,15,23,19,8,21,20,0,0,109
3,15,23,19,11,9,14,0,0,94
3,15,23,19,11,9,14,19,0,113
3,15,23,19,12,9,16,0,0,97
3,15,23,19,12,9,16,19,0,116
3,15,23,19,15,14,0,0,0,89
3,15,23,19,21,3,11,5,18,118
3,15,23,20,1,9,12,0,0,83
3,15,23,20,8,23,15,18,20,145
3,15,23,20,15,14,7,21,5,123
3,15,23,20,15,23,14,0,0,113
3,15,23,23,5,5,4,0,0,78
3,15,23,23,8,5,1,20,0,98
3,15,24,1,0,0,0,0,0,43
3,15,24,1,5,0,0,0,0,48
3,15,24,1,12,0,0,0,0,55
3,15,24,1,12,7,25,0,0,87
3,15,24,1,12,7,9,1,0,72
3,15,24,1,12,7,9,1,19,91
3,15,24,1,12,7,9,3,0,74
3,15,24,1,12,7,9,5,19,95
3,15,24,2,15,14,5,19,0,97
3,15,24,3,15,13,2,0,0,75
3,15,24,3,15,13,2,25,0,100
3,15,24,3,15,13,2,9,3,87
3,15,24,3,15,13,2,18,25,118
3,15,24,3,15,13,2,19,0,94
3,15,24,5,4,0,0,0,0,51
3,15,24,5,14,4,9,24,0,98
3,15,24,5,19,0,0,0,0,66
3,15,24,25,0,0,0,0,0,67
3,15,24,9,5,18,0,0,0,74
3,15,24,9,5,19,20,0,0,95
3,15,24,9,14,7,0,0,0,72
3,15,24,9,20,5,0,0,0,76
3,15,24,9,20,9,19,0,0,99
3,15,24,15,4,25,14,9,1,110
3,15,24,19,23,1,9,14,0,108
3,15,24,19,23,1,9,14,19,127
3,15,24,23,1,9,14,0,0,89
3,15,24,23,1,9,14,19,0,108
3,15,26,0,0,0,0,0,0,44
3,15,26,5,0,0,0,0,0,49
3,15,26,5,4,0,0,0,0,53
3,15,26,5,25,0,0,0,0,74
3,15,26,5,9,5,18,0,0,81
3,15,26,5,9,5,19,20,0,102
3,15,26,5,25,19,0,0,0,93
3,15,26,5,14,0,0,0,0,63
3,15,26,5,14,1,7,5,0,76
3,15,26,5,14,1,7,5,19,95
3,15,26,5,14,5,4,0,0,72
3,15,26,5,14,5,18,0,0,86
3,15,26,5,14,5,18,19,0,105
3,15,26,5,14,9,14,7,0,93
3,15,26,5,19,0,0,0,0,68
3,15,26,25,0,0,0,0,0,69
3,15,26,9,5,0,0,0,0,58
3,15,26,9,5,4,0,0,0,62
3,15,26,9,5,18,0,0,0,76
3,15,26,9,5,19,0,0,0,77
3,15,26,9,5,19,20,0,0,97
3,15,26,25,9,14,7,0,0,99
3,15,26,9,12,25,0,0,0,90
3,15,26,9,14,5,19,19,0,110
3,15,26,9,14,7,0,0,0,74
3,15,26,26,5,19,0,0,0,94
3,16,21,19,0,0,0,0,0,59
3,16,21,20,9,13,5,0,0,87
3,18,3,1,15,0,0,0,0,40
3,18,3,8,5,0,0,0,0,37
3,18,5,0,0,0,0,0,0,26
3,18,5,1,0,0,0,0,0,27
3,18,5,1,3,8,0,0,0,38
3,18,5,1,3,8,25,0,0,63
3,18,5,1,4,0,0,0,0,31
3,18,5,1,7,8,0,0,0,42
3,18,5,1,7,8,20,0,0,62
3,18,5,1,11,0,0,0,0,38
3,18,5,1,11,5,4,0,0,47
3,18,5,1,11,5,18,0,0,61
3,18,5,1,11,25,0,0,0,63
3,18,5,1,11,9,5,18,0,70
3,18,5,1,11,9,5,19,20,91
3,18,5,1,11,9,12,25,0,84
3,18,5,1,11,9,14,7,0,68
3,18,5,1,11,19,0,0,0,57
3,18,5,1,13,0,0,0,0,40
3,18,5,1,13,2,21,19,8,90
3,18,5,1,13,3,1,11,5,60
3,18,5,1,13,3,21,16,0,80
3,18,5,1,13,3,21,16,19,99
3,18,5,1,13,5,4,0,0,49
3,18,5,1,13,5,18,25,0,88
3,18,5,1,13,5,18,19,0,82
3,18,5,1,13,25,0,0,0,65
3,18,5,1,13,9,5,18,0,72
3,18,5,1,13,9,5,19,20,93
3,18,5,1,13,9,12,25,0,86
3,18,5,1,13,9,14,7,0,70
3,18,5,1,13,12,1,9,4,66
3,18,5,1,13,12,5,19,19,95
3,18,5,1,13,12,9,11,5,77
3,18,5,1,13,19,0,0,0,59
3,18,5,1,13,19,1,3,19,82
3,18,5,1,13,23,1,18,5,87
3,18,5,1,14,3,5,0,0,49
3,18,5,1,14,3,5,18,0,67
3,18,5,1,14,20,0,0,0,61
3,18,5,1,19,5,0,0,0,51
3,18,5,1,19,5,4,0,0,55
3,18,5,1,19,5,18,0,0,69
3,18,5,1,19,5,18,19,0,88
3,18,5,1,19,5,19,0,0,70
3,18,5,1,19,8,1,11,19,85
3,18,5,1,19,25,0,0,0,71
3,18,5,1,19,9,5,18,0,78
3,18,5,1,19,9,5,19,20,99
3,18,5,1,19,9,14,7,0,76
3,18,5,1,19,15,12,0,0,73
3,18,5,1,19,15,20,0,0,81
3,18,5,1,20,0,0,0,0,47
3,18,5,1,20,1,2,12,5,67
3,18,5,1,20,5,0,0,0,52
3,18,5,1,20,5,4,0,0,56
3,18,5,1,20,5,19,0,0,71
3,18,5,1,20,9,3,0,0,59
3,18,5,1,20,9,14,0,0,70
3,18,5,1,20,9,14,5,0,75
3,18,5,1,20,9,14,5,19,94
3,18,5,1,20,9,14,7,0,77
3,18,5,1,20,9,14,9,14,93
3,18,5,1,20,9,14,19,0,89
3,18,5,1,20,9,15,14,19,104
3,18,5,1,20,9,22,5,0,83
3,18,5,1,20,15,18,19,0,99
3,18,5,1,20,18,5,19,19,108
3,18,5,1,20,18,9,24,0,98
3,18,5,1,20,21,18,1,12,99
3,18,5,1,20,21,18,5,0,91
3,18,5,1,20,21,18,5,19,110
3,18,5,1,26,5,0,0,0,58
3,18,5,2,18,9,20,25,0,100
3,18,5,2,18,15,21,19,0,101
3,18,5,3,8,5,0,0,0,42
3,18,5,3,8,5,19,0,0,61
3,18,5,4,1,0,0,0,0,31
3,18,5,4,1,12,0,0,0,43
3,18,5,4,4,15,3,11,0,63
3,18,5,4,5,14,3,5,0,57
3,18,5,4,5,14,3,5,19,76
3,18,5,4,5,14,4,1,0,54
3,18,5,4,5,14,4,21,13,87
3,18,5,4,5,14,19,0,0,68
3,18,5,4,5,14,20,0,0,69
3,18,5,4,5,14,20,12,25,106
3,18,5,4,5,14,26,1,0,76
3,18,5,4,5,14,26,1,19,95
3,18,5,4,5,18,5,0,0,58
3,18,5,4,9,2,12,5,0,58
3,18,5,4,9,2,12,25,0,78
3,18,5,4,9,20,0,0,0,59
3,18,5,4,9,20,5,4,0,68
3,18,5,4,9,20,9,14,7,89
3,18,5,4,9,20,9,22,5,95
3,18,5,4,9,20,15,18,0,92
3,18,5,4,9,20,15,18,19,111
3,18,5,4,9,20,18,9,24,110
3,18,5,4,9,20,19,0,0,78
3,18,5,4,15,19,0,0,0,64
3,18,5,4,21,12,9,20,25,117
3,18,5,4,21,12,15,21,19,118
3,18,5,5,4,0,0,0,0,35
3,18,5,5,4,1,12,0,0,48
3,18,5,5,4,5,4,0,0,44
3,18,5,5,4,9,19,20,0,83
3,18,5,5,4,9,20,5,0,69
3,18,5,5,4,12,5,19,19,90
3,18,5,5,4,13,15,18,5,86
3,18,5,5,4,19,0,0,0,54
3,18,5,5,4,19,13,1,14,82
3,18,5,5,11,5,18,0,0,65
3,18,5,5,11,6,9,19,8,84
3,18,5,5,11,25,0,0,0,67
3,18,5,5,11,19,9,4,5,79
3,18,5,5,12,5,4,0,0,52
3,18,5,5,12,5,18,0,0,66
3,18,5,5,12,9,14,7,0,73
3,18,5,5,12,19,0,0,0,62
3,18,5,5,13,0,0,0,0,44
3,18,5,5,14,0,0,0,0,45
3,18,5,5,16,0,0,0,0,47
3,18,5,5,16,1,7,5,0,60
3,18,5,5,16,1,7,5,19,79
3,18,5,5,16,5,18,0,0,70
3,18,5,5,16,5,18,5,4,79
3,18,5,5,16,5,18,19,0,89
3,18,5,5,16,8,15,12,5,87
3,18,5,5,16,25,0,0,0,72
3,18,5,5,16,9,5,0,0,61
3,18,5,5,16,9,5,18,0,79
3,18,5,5,16,9,5,19,0,80
3,18,5,5,16,9,5,19,20,100
3,18,5,5,16,9,12,25,0,93
3,18,5,5,16,9,14,7,0,77
3,18,5,5,16,19,0,0,0,66
3,18,5,5,19,5,0,0,0,55
3,18,5,5,19,5,19,0,0,74
3,18,5,5,19,8,0,0,0,58
3,18,5,5,19,8,5,4,0,67
3,18,5,5,19,8,5,19,0,82
3,18,5,5,19,8,25,0,0,83
3,18,5,5,19,8,9,5,0,72
3,18,5,5,19,8,9,14,7,88
3,18,5,9,18,7,9,19,20,108
3,18,5,13,1,9,14,19,0,82
3,18,5,13,1,14,20,0,0,74
3,18,5,13,1,19,20,5,18,102
3,18,5,13,1,20,5,0,0,65
3,18,5,13,1,20,5,4,0,69
3,18,5,13,1,20,5,19,0,84
3,18,5,13,1,20,9,14,7,90
3,18,5,13,1,20,9,15,14,98
3,18,5,13,1,20,15,18,0,93
3,18,5,13,1,20,15,18,25,118
3,18,5,13,1,20,15,18,19,112
3,18,5,13,2,1,12,21,13,88
3,18,5,13,5,0,0,0,0,44
3,18,5,13,5,18,9,5,0,76
3,18,5,13,5,19,0,0,0,63
3,18,5,13,15,3,1,18,16,92
3,18,5,13,15,14,5,0,0,73
3,18,5,13,15,18,0,0,0,72
3,18,5,13,15,18,14,5,0,91
3,18,5,13,15,19,9,14,0,96
3,18,5,13,21,12,5,0,0,77
3,18,5,14,1,0,0,0,0,41
3,18,5,14,1,5,0,0,0,46
3,18,5,14,1,20,5,0,0,66
3,18,5,14,1,20,5,4,0,70
3,18,5,14,1,20,5,12,25,103
3,18,5,14,1,20,9,15,14,99
3,18,5,14,1,20,21,18,5,105
3,18,5,14,5,12,0,0,0,57
3,18,5,14,5,12,1,20,5,83
3,18,5,14,5,12,5,0,0,62
3,18,5,14,5,12,5,4,0,66
3,18,5,14,5,12,5,5,0,67
3,18,5,14,5,12,5,20,0,82
3,18,5,14,5,12,9,14,7,87
3,18,5,14,5,12,12,5,0,74
3,18,5,14,5,12,12,5,4,78
3,18,5,14,5,12,12,5,19,93
3,18,5,14,5,12,19,0,0,76
3,18,5,14,7,12,5,0,0,64
3,18,5,14,9,3,0,0,0,52
3,18,5,14,9,20,9,3,0,81
3,18,5,14,15,12,15,7,25,114
3,18,5,14,21,12,1,0,0,74
3,18,5,14,21,12,1,20,5,99
3,18,5,15,4,15,14,20,0,94
3,18,5,15,4,15,14,20,19,113
3,18,5,15,12,5,9,26,5,98
3,18,5,15,12,5,19,0,0,77
3,18,5,15,12,9,1,14,0,77
3,18,5,15,12,9,19,13,0,94
3,18,5,15,12,9,20,5,0,87
3,18,5,15,12,9,26,5,0,93
3,18,5,15,12,9,26,5,4,97
3,18,5,15,16,8,1,7,25,98
3,18,5,15,19,15,12,0,0,87
3,18,5,15,19,15,12,19,0,106
3,18,5,15,19,15,20,5,0,100
3,18,5,15,19,15,20,5,4,104
3,18,5,15,19,15,20,5,18,118
3,18,5,15,19,15,20,5,19,119
3,18,5,15,19,15,20,9,3,107
3,18,5,16,1,14,3,5,0,65
3,18,5,16,5,0,0,0,0,47
3,18,5,16,5,4,0,0,0,51
3,18,5,16,5,25,0,0,0,72
3,18,5,16,5,9,5,18,0,79
3,18,5,16,5,9,5,19,20,100
3,18,5,16,5,19,0,0,0,66
3,18,5,16,9,4,15,13,1,84
3,18,5,16,9,5,18,0,0,74
3,18,5,16,9,5,19,20,0,95
3,18,5,16,9,14,5,0,0,70
3,18,5,16,9,14,5,19,19,108
3,18,5,16,9,14,7,0,0,72
3,18,5,16,9,20,1,14,20,106
3,18,5,16,9,20,1,20,5,97
3,18,5,16,9,20,15,21,19,126
3,18,5,16,9,20,21,19,0,111
3,18,5,16,12,25,0,0,0,79
3,18,5,16,15,14,0,0,0,71
3,18,5,16,15,14,19,0,0,90
3,18,5,16,20,0,0,0,0,62
3,18,5,16,21,19,3,12,5,102
3,18,5,19,1,13,9,14,5,87
3,18,5,19,3,0,0,0,0,48
3,18,5,19,3,5,14,3,5,75
3,18,5,19,3,5,14,4,9,80
3,18,5,19,3,5,14,20,19,106
3,18,5,19,3,9,22,5,0,84
3,18,5,19,5,7,15,12,0,84
3,18,5,19,25,12,0,0,0,82
3,18,5,19,25,12,1,20,5,108
3,18,5,19,25,12,5,14,5,106
3,18,5,19,25,12,9,3,0,94
3,18,5,19,25,12,9,20,5,116
3,18,5,19,25,12,19,0,0,101
3,18,5,19,9,22,5,0,0,81
3,18,5,19,15,12,0,0,0,72
3,18,5,19,15,12,9,14,0,95
3,18,5,19,15,12,9,14,5,100
3,18,5,19,15,12,19,0,0,91
3,18,5,19,15,18,3,9,14,104
3,18,5,19,15,20,1,20,5,106
3,18,5,19,15,20,9,3,0,92
3,18,5,19,15,24,25,0,0,109
3,18,5,19,15,24,9,4,0,97
3,18,5,19,15,24,9,4,5,102
3,18,5,19,19,0,0,0,0,64
3,18,5,19,19,5,4,0,0,73
3,18,5,19,19,5,12,12,5,98
3,18,5,19,19,5,19,0,0,88
3,18,5,19,19,5,20,0,0,89
3,18,5,19,19,5,20,19,0,108
3,18,5,19,19,9,5,18,0,96
3,18,5,19,19,9,5,19,20,117
3,18,5,19,19,23,5,5,4,101
3,18,5,19,19,23,15,18,20,140
3,18,5,19,20,0,0,0,0,65
3,18,5,19,20,1,12,0,0,78
3,18,5,19,20,5,4,0,0,74
3,18,5,19,20,6,9,19,8,107
3,18,5,19,20,9,14,7,0,95
3,18,5,19,20,9,14,7,19,114
3,18,5,19,20,12,5,19,19,120
3,18,5,19,20,19,0,0,0,84
3,18,5,20,9,3,9,19,13,99
3,18,5,20,9,3,19,0,0,77
3,18,5,20,9,6,25,0,0,86
3,18,5,20,9,14,0,0,0,69
3,18,5,20,9,14,9,3,0,81
3,18,5,20,9,14,9,19,13,110
3,18,5,20,9,14,9,26,5,109
3,18,5,20,9,14,15,9,4,97
3,18,5,20,9,14,15,21,19,124
3,18,5,20,9,14,19,0,0,88
3,18,5,20,9,15,14,0,0,84
3,18,5,20,9,26,5,0,0,86
3,18,5,20,15,14,14,5,0,94
3,18,5,20,15,14,14,5,19,113
3,18,5,20,15,18,9,1,0,89
3,18,5,21,20,26,5,18,0,116
3,18,5,22,1,12,12,5,0,78
3,18,5,22,1,12,12,5,19,97
3,18,5,22,1,19,19,0,0,87
3,18,5,22,1,19,19,5,0,92
3,18,5,22,1,19,19,5,4,96
3,18,5,22,1,19,19,5,19,111
3,18,5,22,5,20,0,0,0,73
3,18,5,22,5,20,20,5,0,98
3,18,5,22,9,3,5,0,0,65
3,18,5,22,9,3,5,4,0,69
3,18,5,22,9,3,5,19,0,84
3,18,5,22,9,19,0,0,0,76
3,18,5,23,0,0,0,0,0,49
3,18,5,23,3,21,20,0,0,93
3,18,5,23,5,4,0,0,0,58
3,18,5,23,5,12,0,0,0,66
3,18,5,23,5,12,9,19,20,114
3,18,5,23,5,12,19,0,0,85
3,18,5,23,5,18,0,0,0,72
3,18,5,23,5,20,0,0,0,74
3,18,5,23,9,14,7,0,0,79
3,18,5,23,12,5,19,19,0,104
3,18,5,23,13,1,14,0,0,77
3,18,5,23,13,5,14,0,0,81
3,18,5,23,14,5,3,11,0,82
3,18,5,23,19,0,0,0,0,68
3,18,25,1,2,12,5,0,0,66
3,18,25,1,12,0,0,0,0,59
3,18,9,1,14,3,5,0,0,53
3,18,9,1,14,20,0,0,0,65
3,18,9,2,0,0,0,0,0,32
3,18,25,2,1,2,25,0,0,76
3,18,25,2,1,2,9,5,19,84
3,18,9,2,2,1,7,5,0,47
3,18,9,2,2,1,7,5,19,66
3,18,9,2,2,5,4,0,0,43
3,18,9,2,2,5,18,0,0,57
3,18,9,2,2,5,18,19,0,76
3,18,9,2,2,9,14,7,0,64
3,18,9,2,2,9,14,7,19,83
3,18,9,2,2,9,20,5,18,86
3,18,9,2,2,12,5,0,0,51
3,18,9,2,2,12,5,4,0,55
3,18,9,2,2,12,9,14,7,76
3,18,9,2,5,12,12,1,0,62
3,18,9,2,5,12,12,21,13,95
3,18,9,2,12,5,0,0,0,49
3,18,9,2,15,0,0,0,0,47
3,18,9,2,15,19,5,0,0,71
3,18,9,2,18,1,12,0,0,63
3,18,9,2,18,1,20,5,0,76
3,18,9,2,18,15,19,5,0,89
3,18,9,2,18,15,21,19,0,105
3,18,9,2,19,0,0,0,0,51
3,18,9,2,23,15,18,11,0,99
3,18,9,2,23,15,18,11,19,118
3,18,9,3,0,0,0,0,0,33
3,18,9,3,5,20,9,4,0,71
3,18,9,3,5,20,9,4,19,90
3,18,9,3,5,20,9,14,5,86
3,18,9,3,11,5,0,0,0,49
3,18,9,3,11,5,4,0,0,53
3,18,9,3,11,5,25,0,0,74
3,18,9,3,11,5,20,0,0,69
3,18,9,3,11,5,20,5,4,78
3,18,9,3,11,5,20,5,18,92
3,18,9,3,11,5,20,25,0,94
3,18,9,3,11,5,20,19,0,88
3,18,9,3,11,9,14,7,0,74
3,18,9,3,11,12,5,0,0,61
3,18,9,3,11,19,0,0,0,63
3,18,9,3,15,9,4,0,0,61
3,18,9,3,15,9,4,19,0,80
3,18,9,3,15,20,15,13,25,121
3,18,9,4,4,12,5,0,0,55
3,18,9,5,4,0,0,0,0,39
3,18,9,5,25,0,0,0,0,60
3,18,9,5,18,0,0,0,0,53
3,18,9,5,18,19,0,0,0,72
3,18,9,5,19,0,0,0,0,54
3,18,9,7,0,0,0,0,0,37
3,18,25,9,14,7,0,0,0,76
3,18,25,9,14,7,12,25,0,113
3,18,9,11,5,25,0,0,0,71
3,18,9,13,2,12,5,0,0,62
3,18,9,13,5,0,0,0,0,48
3,18,9,13,5,6,21,12,0,87
3,18,9,13,5,12,5,19,19,103
3,18,9,13,5,19,0,0,0,67
3,18,9,13,9,14,1,12,0,79
3,18,9,13,9,14,1,12,19,98
3,18,9,13,9,14,1,20,5,92
3,18,9,13,9,14,5,0,0,71
3,18,9,13,9,14,9,0,0,75
3,18,9,13,9,14,9,19,0,94
3,18,9,13,9,14,15,12,0,93
3,18,9,13,9,14,15,21,19,121
3,18,9,13,9,19,15,14,0,100
3,18,9,13,13,5,18,0,0,79
3,18,9,13,13,5,18,19,0,98
3,18,9,13,13,25,0,0,0,81
3,18,9,13,16,0,0,0,0,59
3,18,9,13,16,1,7,5,0,72
3,18,9,13,16,5,4,0,0,68
3,18,9,13,16,5,18,0,0,82
3,18,9,13,16,5,18,19,0,101
3,18,9,13,16,25,0,0,0,84
3,18,9,13,16,9,5,18,0,91
3,18,9,13,16,9,5,19,20,112
3,18,9,13,16,9,14,7,0,89
3,18,9,13,16,12,5,0,0,76
3,18,9,13,16,12,5,4,0,80
3,18,9,13,16,12,5,19,0,95
3,18,9,13,16,12,9,14,7,101
3,18,9,13,16,14,5,19,19,116
3,18,9,13,16,19,0,0,0,78
3,18,9,13,19,15,14,0,0,91
3,18,9,13,19,15,14,5,4,100
3,18,9,13,19,15,14,25,0,116
3,18,9,13,19,15,14,12,25,128
3,18,9,13,19,15,14,19,0,110
3,18,9,14,1,12,0,0,0,57
3,18,9,14,1,14,9,20,5,93
3,18,9,14,1,20,5,0,0,70
3,18,9,14,1,20,5,4,0,74
3,18,9,14,1,20,15,18,25,123
3,18,9,14,3,8,0,0,0,55
3,18,9,14,5,0,0,0,0,49
3,18,9,14,5,4,0,0,0,53
3,18,9,14,5,12,0,0,0,61
3,18,9,14,5,20,0,0,0,69
3,18,9,14,7,5,0,0,0,56
3,18,9,14,7,5,4,0,0,60
3,18,9,14,7,5,18,0,0,74
3,18,9,14,7,5,18,19,0,93
3,18,9,14,7,5,19,0,0,75
3,18,9,14,7,9,14,7,0,81
3,18,9,14,7,12,5,0,0,68
3,18,9,14,7,12,5,19,0,87
3,18,9,14,9,4,0,0,0,57
3,18,9,14,9,5,18,5,0,81
3,18,9,14,9,15,14,0,0,82
3,18,9,14,9,20,1,12,0,86
3,18,9,14,9,20,5,0,0,78
3,18,9,14,9,20,5,19,0,97
3,18,9,14,9,20,15,18,25,131
3,18,9,14,11,0,0,0,0,55
3,18,9,14,11,12,5,0,0,72
3,18,9,14,11,12,5,4,0,76
3,18,9,14,11,12,5,19,0,91
3,18,9,14,11,12,25,0,0,92
3,18,9,14,11,12,9,5,18,99
3,18,9,14,11,12,9,14,7,97
3,18,9,14,11,21,13,0,0,89
3,18,9,14,15,9,4,0,0,72
3,18,9,14,15,9,4,1,12,85
3,18,9,14,15,9,4,19,0,91
3,18,9,14,15,12,9,14,5,99
3,18,9,14,15,19,5,0,0,83
3,18,9,14,15,19,9,20,25,132
3,18,9,14,21,12,1,0,0,78
3,18,9,14,21,13,19,0,0,97
3,18,9,15,2,15,12,25,0,99
3,18,25,15,3,8,15,18,5,110
3,18,25,15,7,5,14,0,0,87
3,18,25,15,7,5,14,25,0,112
3,18,25,15,7,5,14,9,3,99
3,18,25,15,7,5,14,19,0,106
3,18,25,15,12,9,20,5,0,107
3,18,25,15,12,9,20,5,19,126
3,18,9,15,12,12,1,0,0,70
3,18,9,15,12,12,1,19,0,89
3,18,9,15,12,12,15,0,0,84
3,18,9,15,12,12,15,19,0,103
3,18,25,15,12,15,7,25,0,120
3,18,25,15,13,5,20,5,18,122
3,18,25,15,13,5,20,18,25,142
3,18,25,15,14,9,3,0,0,87
3,18,25,15,14,9,3,19,0,106
3,18,25,15,16,1,20,8,25,131
3,18,25,15,16,8,9,12,5,111
3,18,25,15,16,8,25,20,5,135
3,18,9,15,16,8,15,18,5,107
3,18,25,15,16,18,15,2,5,117
3,18,25,15,19,3,15,16,5,119
3,18,25,15,19,3,15,16,25,139
3,18,25,15,19,5,12,0,0,97
3,18,25,15,19,20,1,19,5,125
3,18,25,15,19,20,1,20,0,121
3,18,25,15,19,20,1,20,19,140
3,18,25,15,20,18,15,14,0,128
3,18,25,15,20,18,15,14,19,147
3,18,9,16,0,0,0,0,0,46
3,18,9,16,5,0,0,0,0,51
3,18,9,16,5,19,0,0,0,70
3,18,9,16,16,9,5,4,0,80
3,18,9,16,16,12,5,0,0,79
3,18,9,16,16,12,5,4,0,83
3,18,9,16,16,12,5,18,0,97
3,18,9,16,16,12,5,18,19,116
3,18,9,16,16,12,5,19,0,98
3,18,9,16,16,12,25,0,0,99
3,18,9,16,16,12,9,14,7,104
3,18,9,16,19,0,0,0,0,65
3,18,25,16,20,0,0,0,0,82
3,18,25,16,20,1,0,0,0,83
3,18,25,16,20,1,12,0,0,95
3,18,25,16,20,1,18,3,8,112
3,18,25,16,20,5,4,0,0,91
3,18,25,16,20,9,3,0,0,94
3,18,25,16,20,9,3,1,12,107
3,18,25,16,20,15,0,0,0,97
3,18,25,16,20,15,7,1,13,118
3,18,25,16,20,15,14,25,13,149
3,18,25,16,20,15,16,9,14,136
3,18,25,16,20,15,19,0,0,116
3,18,25,16,20,15,21,19,0,137
3,18,25,16,20,19,0,0,0,101
3,18,9,19,9,3,0,0,0,61
3,18,9,19,9,19,0,0,0,77
3,18,9,19,12,5,0,0,0,66
3,18,9,19,16,1,20,5,0,91
3,18,9,19,16,1,20,5,4,95
3,18,9,19,16,5,4,0,0,74
3,18,9,19,16,5,14,5,4,93
3,18,9,19,16,5,14,19,0,103
3,18,9,19,16,5,18,0,0,88
3,18,9,19,16,5,18,19,0,107
3,18,9,19,16,5,19,20,0,109
3,18,9,19,16,25,0,0,0,90
3,18,9,19,16,9,5,18,0,97
3,18,9,19,16,9,5,19,20,118
3,18,9,19,16,9,12,25,0,111
3,18,9,19,16,9,14,5,0,93
3,18,9,19,16,9,14,7,0,95
3,18,9,19,16,9,14,19,0,107
3,18,9,19,16,12,25,0,0,102
3,18,9,19,16,14,5,19,19,122
3,18,9,19,16,19,0,0,0,84
3,18,9,19,19,0,0,0,0,68
3,18,9,19,19,1,0,0,0,69
3,18,9,19,19,1,12,0,0,81
3,18,9,19,19,5,20,0,0,93
3,18,9,19,19,21,13,0,0,102
3,18,25,19,20,0,0,0,0,85
3,18,9,19,20,1,5,0,0,75
3,18,25,19,20,1,12,5,4,107
3,18,25,19,20,1,12,12,0,110
3,18,25,19,20,1,12,19,0,117
3,18,9,19,20,1,20,5,0,95
3,18,9,19,20,1,20,5,4,99
3,18,25,19,20,5,0,0,0,90
3,18,25,19,20,9,3,0,0,97
3,18,9,20,0,0,0,0,0,50
3,18,9,20,3,8,0,0,0,61
3,18,9,20,5,18,9,1,0,83
3,18,9,20,5,18,9,9,1,92
3,18,9,20,5,18,9,15,14,111
3,18,9,20,5,18,9,21,13,116
3,18,9,20,8,0,0,0,0,58
3,18,9,20,8,13,5,14,5,95
3,18,9,20,9,3,0,0,0,62
3,18,9,20,9,3,1,12,0,75
3,18,9,20,9,3,9,19,5,95
3,18,9,20,9,3,9,19,13,103
3,18,9,20,9,3,9,19,20,110
3,18,9,20,9,3,9,26,5,102
3,18,9,20,9,3,11,9,14,96
3,18,9,20,9,3,19,0,0,81
3,18,9,20,9,3,19,13,0,94
3,18,9,20,9,3,21,12,5,100
3,18,9,20,9,17,21,5,0,102
3,18,9,20,9,17,21,5,4,106
3,18,9,20,9,17,21,5,19,121
3,18,9,20,9,19,13,0,0,91
3,18,9,20,9,26,5,0,0,90
3,18,9,20,12,9,14,7,0,92
3,18,9,20,20,5,18,0,0,93
3,18,9,20,20,5,18,9,1,103
3,18,9,20,20,5,18,19,0,112
3,18,9,20,20,21,18,0,0,109
3,18,9,20,20,21,18,19,0,128
3,18,9,22,5,20,26,0,0,103
3,18,9,26,26,5,12,0,0,99
3,18,9,26,26,12,5,0,0,99
3,18,9,26,26,12,5,4,0,103
3,18,9,26,26,12,9,14,7,124
3,18,15,0,0,0,0,0,0,36
3,18,15,1,11,0,0,0,0,48
3,18,15,1,11,5,4,0,0,57
3,18,15,1,11,5,18,19,0,90
3,18,15,1,11,25,0,0,0,73
3,18,15,1,11,9,5,18,0,80
3,18,15,1,11,9,5,19,20,101
3,18,15,1,11,9,12,25,0,94
3,18,15,1,11,9,14,7,0,78
3,18,15,1,11,19,0,0,0,67
3,18,15,1,16,5,0,0,0,58
3,18,15,3,0,0,0,0,0,39
3,18,15,3,1,18,4,0,0,62
3,18,15,3,5,9,3,0,0,56
3,18,15,3,5,9,14,0,0,67
3,18,15,3,5,9,14,5,0,72
3,18,15,3,5,9,14,5,19,91
3,18,15,3,5,9,14,19,0,86
3,18,15,3,5,15,21,19,0,99
3,18,15,3,5,20,9,14,0,87
3,18,15,3,5,21,19,0,0,84
3,18,15,3,8,5,0,0,0,52
3,18,15,3,8,5,20,0,0,72
3,18,15,3,8,5,20,5,4,81
3,18,15,3,8,5,20,5,18,95
3,18,15,3,8,5,20,19,0,91
3,18,15,3,9,0,0,0,0,48
3,18,15,3,9,1,18,25,0,92
3,18,15,3,9,1,20,5,0,74
3,18,15,3,9,14,0,0,0,62
3,18,15,3,9,14,5,0,0,67
3,18,15,3,11,0,0,0,0,50
3,18,15,3,11,1,18,4,0,73
3,18,15,3,11,5,4,0,0,59
3,18,15,3,11,5,18,25,0,98
3,18,15,3,11,5,20,0,0,75
3,18,15,3,11,5,20,5,4,84
3,18,15,3,11,5,20,19,0,94
3,18,15,3,11,25,0,0,0,75
3,18,15,3,11,9,14,7,0,80
3,18,15,3,11,15,0,0,0,65
3,18,15,3,11,19,0,0,0,69
3,18,15,3,15,4,9,12,5,84
3,18,15,3,15,9,20,5,0,88
3,18,15,3,15,9,20,5,19,107
3,18,15,3,15,14,1,20,5,94
3,18,15,3,15,14,9,3,0,80
3,18,15,3,19,0,0,0,0,58
3,18,15,3,21,19,5,4,0,88
3,18,15,3,21,19,5,19,0,103
3,18,15,3,21,20,1,0,0,81
3,18,15,6,20,5,18,0,0,85
3,18,15,6,20,5,18,19,0,104
3,18,15,6,20,9,14,7,0,92
3,18,15,6,20,12,1,14,4,93
3,18,15,6,20,19,0,0,0,81
3,18,15,8,0,0,0,0,0,44
3,18,15,25,0,0,0,0,0,61
3,18,15,25,4,5,14,0,0,84
3,18,15,9,7,8,12,5,0,77
3,18,15,9,9,11,0,0,0,65
3,18,15,25,12,0,0,0,0,73
3,18,15,9,19,0,0,0,0,64
3,18,15,9,19,1,4,0,0,69
3,18,15,9,19,1,4,5,0,74
3,18,15,9,19,1,18,4,0,87
3,18,15,9,19,5,0,0,0,69
3,18,15,9,19,5,5,0,0,74
3,18,15,9,19,5,19,0,0,88
3,18,15,9,19,5,20,20,5,114
3,18,15,9,19,19,1,14,20,118
3,18,15,10,1,3,11,0,0,61
3,18,15,10,9,11,0,0,0,66
3,18,15,10,9,11,19,0,0,85
3,18,15,11,5,18,0,0,0,70
3,18,15,13,2,5,3,0,0,59
3,18,15,13,5,0,0,0,0,54
3,18,15,13,12,5,3,8,0,77
3,18,15,13,12,5,3,8,19,96
3,18,15,13,13,5,0,0,0,67
3,18,15,13,13,5,12,0,0,79
3,18,15,13,15,18,14,1,0,97
3,18,15,13,15,18,14,5,0,101
3,18,15,13,19,20,5,18,0,111
3,18,15,14,5,0,0,0,0,55
3,18,15,14,5,12,0,0,0,67
3,18,15,14,5,19,0,0,0,74
3,18,15,14,5,20,0,0,0,75
3,18,15,14,25,0,0,0,0,75
3,18,15,14,9,5,0,0,0,64
3,18,15,14,9,5,4,0,0,68
3,18,15,14,9,5,19,0,0,83
3,18,15,14,25,9,14,7,0,105
3,18,15,14,25,9,19,13,0,116
3,18,15,14,25,9,19,13,19,135
3,18,15,14,9,19,8,0,0,86
3,18,15,14,11,0,0,0,0,61
3,18,15,14,11,14,5,19,19,118
3,18,15,15,3,8,0,0,0,62
3,18,15,15,4,0,0,0,0,55
3,18,15,15,4,12,5,0,0,72
3,18,15,15,9,19,9,20,5,113
3,18,15,15,11,0,0,0,0,62
3,18,15,15,11,2,1,3,11,79
3,18,15,15,11,2,9,12,12,97
3,18,15,15,11,5,4,0,0,71
3,18,15,15,11,5,4,5,18,94
3,18,15,15,11,5,4,12,25,108
3,18,15,15,11,5,14,0,0,81
3,18,15,15,11,5,18,25,0,110
3,18,15,15,11,9,14,7,0,92
3,18,15,15,11,12,5,0,0,79
3,18,15,15,11,14,5,3,11,95
3,18,15,15,12,0,0,0,0,63
3,18,15,15,14,0,0,0,0,65
3,18,15,15,14,5,4,0,0,74
3,18,15,15,14,5,18,0,0,88
3,18,15,15,14,5,18,19,0,107
3,18,15,15,14,9,14,7,0,95
3,18,15,15,14,19,0,0,0,84
3,18,15,15,19,5,0,0,0,75
3,18,15,16,0,0,0,0,0,52
3,18,15,16,8,5,1,4,0,70
3,18,15,16,12,1,14,4,0,83
3,18,15,16,12,1,14,4,19,102
3,18,15,16,12,5,19,19,0,107
3,18,15,16,13,1,14,0,0,80
3,18,15,16,16,1,0,0,0,69
3,18,15,16,16,5,4,0,0,77
3,18,15,16,16,5,18,0,0,91
3,18,15,16,16,5,18,19,0,110
3,18,15,16,16,25,0,0,0,93
3,18,15,16,16,9,5,0,0,82
3,18,15,16,16,9,5,19,0,101
3,18,15,16,16,9,14,7,0,98
3,18,15,16,19,0,0,0,0,71
3,18,15,16,19,8,9,14,0,102
3,18,15,16,19,9,3,11,0,94
3,18,15,16,23,5,5,4,0,89
3,18,15,17,21,5,20,0,0,99
3,18,15,17,21,5,20,5,4,108
3,18,15,17,21,5,20,19,0,118
3,18,15,17,21,5,20,20,5,124
3,18,15,17,21,9,19,0,0,102
3,18,15,18,5,0,0,0,0,59
3,18,15,18,5,19,0,0,0,78
3,18,15,19,1,0,0,0,0,56
3,18,15,19,5,0,0,0,0,60
3,18,15,19,5,20,0,0,0,80
3,18,15,19,5,20,20,5,0,105
3,18,15,19,9,5,18,0,0,87
3,18,15,19,9,5,18,5,4,96
3,18,15,19,9,5,18,19,0,106
3,18,15,19,12,5,20,0,0,92
3,18,15,19,14,5,0,0,0,74
3,18,15,19,14,5,19,0,0,93
3,18,15,19,19,1,2,12,5,94
3,18,15,19,19,1,18,13,0,106
3,18,15,19,19,1,18,13,19,125
3,18,15,19,19,2,1,14,4,95
3,18,15,19,19,2,1,18,0,95
3,18,15,19,19,2,1,18,19,114
3,18,15,19,19,2,5,1,11,93
3,18,15,19,19,2,5,1,13,95
3,18,15,19,19,2,5,12,20,113
3,18,15,19,19,2,9,12,12,109
3,18,15,19,19,2,9,20,5,110
3,18,15,19,19,2,15,12,20,123
3,18,15,19,19,2,15,23,19,133
3,18,15,19,19,2,18,5,4,103
3,18,15,19,19,3,21,20,0,118
3,18,15,19,19,3,21,20,19,137
3,18,15,19,19,5,4,0,0,83
3,18,15,19,19,5,18,0,0,97
3,18,15,19,19,5,18,19,0,116
3,18,15,19,19,5,19,0,0,98
3,18,15,19,19,5,19,20,0,118
3,18,15,19,19,5,20,20,5,124
3,18,15,19,19,6,1,12,12,105
3,18,15,19,19,6,9,18,5,112
3,18,15,19,19,6,9,19,8,116
3,18,15,19,19,6,12,15,23,130
3,18,15,19,19,6,15,15,20,130
3,18,15,19,19,8,1,9,18,110
3,18,15,19,19,8,1,14,4,101
3,18,15,19,19,8,1,21,12,116
3,18,15,19,19,8,5,1,4,92
3,18,15,19,19,9,14,7,0,104
3,18,15,19,19,9,14,7,19,123
3,18,15,19,19,9,20,5,0,108
3,18,15,19,19,10,1,3,11,99
3,18,15,19,19,12,1,16,0,103
3,18,15,19,19,12,5,7,19,117
3,18,15,19,19,12,5,25,0,116
3,18,15,19,19,12,5,20,0,111
3,18,15,19,19,12,5,20,19,130
3,18,15,19,19,12,25,0,0,111
3,18,15,19,19,12,9,11,5,111
3,18,15,19,19,12,9,14,5,114
3,18,15,19,19,12,9,14,11,120
3,18,15,19,19,14,5,19,19,131
3,18,15,19,19,15,16,20,0,125
3,18,15,19,19,15,22,5,18,134
3,18,15,19,19,16,1,20,8,119
3,18,15,19,19,16,15,19,20,144
3,18,15,19,19,18,1,9,12,114
3,18,15,19,19,18,15,1,4,112
3,18,15,19,19,18,15,23,0,130
3,18,15,19,19,18,21,6,6,125
3,18,15,19,19,20,1,9,12,116
3,18,15,19,19,20,1,12,11,118
3,18,15,19,19,20,9,5,0,108
3,18,15,19,19,20,9,5,4,112
3,18,15,19,19,20,9,5,19,127
3,18,15,19,19,20,15,5,19,133
3,18,15,19,19,20,15,23,14,146
3,18,15,19,19,20,18,5,5,122
3,18,15,19,19,23,1,25,0,123
3,18,15,19,19,23,1,25,19,142
3,18,15,19,19,23,1,12,11,121
3,18,15,19,19,23,5,2,0,104
3,18,15,19,19,23,5,5,4,111
3,18,15,19,19,23,9,14,4,124
3,18,15,19,19,23,9,19,5,130
3,18,15,19,19,23,15,18,4,134
3,18,15,19,19,23,15,18,20,150
3,18,15,19,20,0,0,0,0,75
3,18,15,19,20,1,18,9,5,108
3,18,15,20,1,12,0,0,0,69
3,18,15,20,1,12,9,3,0,81
3,18,15,20,1,12,9,4,0,82
3,18,15,20,1,12,9,14,0,92
3,18,15,20,1,12,9,14,5,97
3,18,15,20,1,12,9,19,13,110
3,18,15,20,1,12,15,0,0,84
3,18,15,20,1,12,15,9,4,97
3,18,15,20,1,12,21,13,0,103
3,18,15,20,1,16,8,9,3,93
3,18,15,20,3,8,0,0,0,67
3,18,15,20,3,8,5,4,0,76
3,18,15,20,3,8,5,19,0,91
3,18,15,20,3,8,5,20,0,92
3,18,15,20,3,8,5,20,25,117
3,18,15,20,3,8,5,20,19,111
3,18,15,20,3,8,25,0,0,92
3,18,15,20,3,8,9,14,7,97
3,18,15,20,5,19,3,15,0,98
3,18,15,20,25,12,0,0,0,93
3,18,15,20,9,14,0,0,0,79
3,18,15,20,15,14,1,20,5,111
3,18,15,20,15,14,2,21,7,115
3,18,15,20,15,14,9,3,0,97
3,18,15,20,15,14,25,12,0,122
3,18,15,20,15,14,19,0,0,104
3,18,15,20,20,1,12,0,0,89
3,18,15,20,20,5,12,19,0,112
3,18,15,20,20,12,5,0,0,93
3,18,15,21,3,8,0,0,0,68
3,18,15,21,3,8,1,14,20,103
3,18,15,21,3,8,5,0,0,73
3,18,15,21,3,8,5,4,0,77
3,18,15,21,3,8,5,18,0,91
3,18,15,21,3,8,5,19,0,92
3,18,15,21,3,8,9,5,0,82
3,18,15,21,3,8,9,14,7,98
3,18,15,21,3,8,13,1,19,101
3,18,15,21,11,5,0,0,0,73
3,18,15,21,16,0,0,0,0,73
3,18,15,21,16,1,4,5,0,83
3,18,15,21,16,1,12,0,0,86
3,18,15,21,16,5,0,0,0,78
3,18,15,21,16,5,19,0,0,97
3,18,15,21,16,25,0,0,0,98
3,18,15,21,16,9,5,18,0,105
3,18,15,21,16,9,5,18,19,124
3,18,15,21,16,9,5,19,20,126
3,18,15,21,16,9,12,25,0,119
3,18,15,21,16,15,14,0,0,102
3,18,15,21,16,15,21,19,0,128
3,18,15,21,16,19,0,0,0,92
3,18,15,21,19,5,12,25,0,118
3,18,15,21,19,20,1,4,5,106
3,18,15,21,20,0,0,0,0,77
3,18,15,21,20,5,0,0,0,82
3,18,15,21,20,8,0,0,0,85
3,18,15,21,20,15,14,0,0,106
3,18,15,21,20,15,14,19,0,125
3,18,15,23,2,1,9,20,0,91
3,18,15,23,2,1,18,0,0,80
3,18,15,23,2,1,18,19,0,99
3,18,15,23,2,5,12,12,0,90
3,18,15,23,2,5,18,18,25,127
3,18,15,23,2,9,12,12,0,94
3,18,15,23,2,15,15,20,0,111
3,18,15,23,4,0,0,0,0,63
3,18,15,23,4,5,4,0,0,72
3,18,15,23,4,5,4,12,25,109
3,18,15,23,4,5,18,19,0,105
3,18,15,23,4,25,0,0,0,88
3,18,15,23,4,9,5,0,0,77
3,18,15,23,4,9,5,19,0,96
3,18,15,23,4,9,14,7,0,93
3,18,15,23,4,12,5,0,0,80
3,18,15,23,4,19,0,0,0,82
3,18,15,23,4,23,5,5,4,100
3,18,15,23,5,4,0,0,0,68
3,18,15,23,5,18,0,0,0,82
3,18,15,23,5,18,19,0,0,101
3,18,15,23,6,5,5,20,0,95
3,18,15,23,6,15,15,20,0,115
3,18,15,23,6,15,15,20,19,134
3,18,15,23,8,15,16,0,0,98
3,18,15,23,9,14,7,0,0,89
3,18,15,23,9,14,7,12,25,126
3,18,15,23,12,0,0,0,0,71
3,18,15,23,14,1,12,0,0,86
3,18,15,23,14,2,1,14,4,94
3,18,15,23,14,5,4,0,0,82
3,18,15,23,14,5,18,0,0,96
3,18,15,23,14,5,18,19,0,115
3,18,15,23,14,5,20,0,0,98
3,18,15,23,14,5,20,19,0,117
3,18,15,23,14,9,14,7,0,103
3,18,15,23,14,12,1,14,4,104
3,18,15,23,14,12,5,19,19,128
3,18,15,23,14,12,5,20,0,110
3,18,15,23,14,12,9,11,5,110
3,18,15,23,14,12,9,14,7,115
3,18,15,23,14,13,5,14,20,125
3,18,15,23,14,23,15,18,11,140
3,18,15,23,14,23,15,18,20,149
3,18,15,23,19,0,0,0,0,78
3,18,15,23,19,8,1,25,0,112
3,18,15,23,19,20,5,16,0,119
3,18,15,23,19,20,5,16,19,138
3,18,15,23,19,20,9,3,11,121
3,18,15,23,19,20,15,14,5,132
3,18,15,23,20,15,5,0,0,99
3,18,15,26,5,0,0,0,0,67
3,18,15,26,5,4,0,0,0,71
3,18,15,26,5,18,0,0,0,85
3,18,15,26,5,18,19,0,0,104
3,18,15,26,5,19,0,0,0,86
3,18,15,26,9,5,18,19,0,113
3,18,15,26,9,14,7,0,0,92
3,18,15,26,12,5,0,0,0,79
3,18,15,26,26,12,5,0,0,105
3,18,15,26,26,12,25,0,0,125
3,18,16,5,0,0,0,0,0,42
3,18,20,19,0,0,0,0,0,60
3,18,21,0,0,0,0,0,0,42
3,18,21,2,0,0,0,0,0,44
3,18,21,2,5,5,14,0,0,68
3,18,21,3,5,19,0,0,0,69
3,18,21,3,8,5,0,0,0,58
3,18,21,3,9,1,12,0,0,67
3,18,21,3,9,1,12,12,25,104
3,18,21,3,9,1,14,0,0,69
3,18,21,3,9,1,14,19,0,88
3,18,21,3,9,1,20,5,0,80
3,18,21,3,9,1,20,5,4,84
3,18,21,3,9,2,12,5,0,73
3,18,21,3,9,2,12,5,19,92
3,18,21,3,9,6,5,18,0,83
3,18,21,3,9,6,5,18,19,102
3,18,21,3,9,6,25,0,0,85
3,18,21,3,9,6,9,5,4,78
3,18,21,3,9,6,9,5,18,92
3,18,21,3,9,6,9,5,19,93
3,18,21,3,9,6,9,7,5,81
3,18,21,3,9,6,9,24,0,93
3,18,21,3,9,6,15,18,13,106
3,18,21,3,9,12,25,0,0,91
3,18,21,3,9,12,12,25,0,103
3,18,21,3,11,0,0,0,0,56
3,18,21,3,11,19,0,0,0,75
3,18,21,4,0,0,0,0,0,46
3,18,21,4,4,5,4,0,0,59
3,18,21,4,4,25,0,0,0,75
3,18,21,4,4,9,5,18,0,82
3,18,21,4,4,9,14,7,0,80
3,18,21,4,4,12,5,0,0,67
3,18,21,4,5,0,0,0,0,51
3,18,21,4,5,12,25,0,0,88
3,18,21,4,5,12,9,20,25,117
3,18,21,4,5,14,5,19,19,108
3,18,21,4,5,18,0,0,0,69
3,18,21,4,5,19,0,0,0,70
3,18,21,4,5,19,20,0,0,90
3,18,21,4,25,0,0,0,0,71
3,18,21,4,9,20,5,19,0,99
3,18,21,4,9,20,25,0,0,100
3,18,21,4,9,20,9,5,19,108
3,18,21,4,12,5,0,0,0,63
3,18,21,4,19,0,0,0,0,65
3,18,21,4,23,15,18,20,0,122
3,18,21,5,12,0,0,0,0,59
3,18,21,5,12,5,18,0,0,82
3,18,21,5,12,5,19,20,0,103
3,18,21,5,12,9,26,5,0,99
3,18,21,5,12,12,5,18,0,94
3,18,21,5,12,12,5,19,20,115
3,18,21,5,12,12,25,0,0,96
3,18,21,5,12,14,5,19,19,116
3,18,21,5,12,19,0,0,0,78
3,18,21,5,12,20,25,0,0,104
3,18,21,5,12,20,9,5,19,112
3,18,21,5,14,20,0,0,0,81
3,18,21,5,14,20,1,20,5,107
3,18,21,5,14,20,15,21,19,136
3,18,21,5,20,0,0,0,0,67
3,18,21,5,20,25,0,0,0,92
3,18,21,5,20,19,0,0,0,86
3,18,21,9,19,5,0,0,0,75
3,18,21,9,19,5,4,0,0,79
3,18,21,9,19,5,18,0,0,93
3,18,21,9,19,5,18,19,0,112
3,18,21,9,19,5,19,0,0,94
3,18,21,9,19,5,23,1,25,124
3,18,21,9,19,9,14,7,0,100
3,18,21,9,19,11,5,5,14,105
3,18,21,9,19,11,5,14,0,100
3,18,21,9,22,5,0,0,0,78
3,18,21,12,12,0,0,0,0,66
3,18,21,12,12,5,18,0,0,89
3,18,21,12,12,5,18,19,0,108
3,18,21,13,2,0,0,0,0,57
3,18,21,13,2,1,2,12,5,77
3,18,21,13,2,5,4,0,0,66
3,18,21,13,2,5,18,0,0,80
3,18,21,13,2,5,18,19,0,99
3,18,21,13,2,25,0,0,0,82
3,18,21,13,2,9,5,18,0,89
3,18,21,13,2,9,5,19,20,110
3,18,21,13,2,9,14,7,0,87
3,18,21,13,2,12,5,0,0,74
3,18,21,13,2,12,5,4,0,78
3,18,21,13,2,12,5,19,0,93
3,18,21,13,2,12,5,20,0,94
3,18,21,13,2,12,25,0,0,94
3,18,21,13,2,12,9,5,18,101
3,18,21,13,2,12,9,14,7,99
3,18,21,13,2,19,0,0,0,76
3,18,21,13,2,21,13,0,0,91
3,18,21,13,2,21,13,19,0,110
3,18,21,13,5,14,0,0,0,74
3,18,21,13,5,14,1,0,0,75
3,18,21,13,5,14,1,12,0,87
3,18,21,13,8,15,18,14,0,110
3,18,21,13,12,5,20,0,0,92
3,18,21,13,13,1,2,12,5,88
3,18,21,13,13,5,4,0,0,77
3,18,21,13,13,5,18,0,0,91
3,18,21,13,13,25,0,0,0,93
3,18,21,13,13,9,5,0,0,82
3,18,21,13,13,9,5,18,0,100
3,18,21,13,13,9,5,19,0,101
3,18,21,13,13,9,5,19,20,121
3,18,21,13,13,9,14,7,0,98
3,18,21,13,13,15,3,11,0,97
3,18,21,13,16,0,0,0,0,71
3,18,21,13,16,5,4,0,0,80
3,18,21,13,16,5,18,0,0,94
3,18,21,13,16,5,20,0,0,96
3,18,21,13,16,5,20,19,0,115
3,18,21,13,16,25,0,0,0,96
3,18,21,13,16,9,14,7,0,101
3,18,21,13,16,12,5,0,0,88
3,18,21,13,16,12,5,4,0,92
3,18,21,13,16,12,5,19,0,107
3,18,21,13,16,12,25,0,0,108
3,18,21,13,16,12,9,14,7,113
3,18,21,13,16,19,0,0,0,90
3,18,21,13,19,20,5,18,0,117
3,18,21,14,3,8,0,0,0,67
3,18,21,14,3,8,5,4,0,76
3,18,21,14,3,8,5,18,0,90
3,18,21,14,3,8,5,18,19,109
3,18,21,14,3,8,5,19,0,91
3,18,21,14,3,8,25,0,0,92
3,18,21,14,3,8,9,5,18,99
3,18,21,14,3,8,9,12,25,113
3,18,21,14,3,8,9,14,7,97
3,18,21,14,11,0,0,0,0,67
3,18,21,14,11,12,5,0,0,84
3,18,21,14,15,4,1,12,0,88
3,18,21,14,15,4,5,0,0,80
3,18,21,14,15,4,5,19,0,99
3,18,21,14,20,0,0,0,0,76
3,18,21,15,18,0,0,0,0,75
3,18,21,15,18,9,14,0,0,98
3,18,21,15,18,19,0,0,0,94
3,18,21,16,0,0,0,0,0,58
3,18,21,16,16,5,14,0,0,93
3,18,21,16,16,5,18,0,0,97
3,18,21,16,16,5,18,5,4,106
3,18,21,16,16,5,18,19,0,116
3,18,21,18,1,0,0,0,0,61
3,18,21,18,1,12,0,0,0,73
3,18,21,18,5,21,19,0,0,105
3,18,21,19,0,0,0,0,0,61
3,18,21,19,1,4,5,0,0,71
3,18,21,19,1,4,5,4,0,75
3,18,21,19,1,4,5,18,0,89
3,18,21,19,1,4,5,18,19,108
3,18,21,19,1,4,9,14,7,96
3,18,21,19,1,4,15,0,0,81
3,18,21,19,1,4,15,5,19,105
3,18,21,19,1,4,15,19,0,100
3,18,21,19,5,0,0,0,0,66
3,18,21,19,5,19,0,0,0,85
3,18,21,19,5,20,0,0,0,86
3,18,21,19,5,20,19,0,0,105
3,18,21,19,8,0,0,0,0,69
3,18,21,19,8,1,2,12,5,89
3,18,21,19,8,5,4,0,0,78
3,18,21,19,8,5,18,0,0,92
3,18,21,19,8,5,18,19,0,111
3,18,21,19,8,5,19,0,0,93
3,18,21,19,8,9,14,7,0,99
3,18,21,19,9,5,0,0,0,75
3,18,21,19,9,12,5,0,0,87
3,18,21,19,9,12,5,5,0,92
3,18,21,19,9,12,25,0,0,107
3,18,21,19,20,0,0,0,0,81
3,18,21,19,20,1,0,0,0,82
3,18,21,19,20,1,4,5,0,91
3,18,21,19,20,1,12,0,0,94
3,18,21,19,20,1,20,5,0,107
3,18,21,19,20,1,20,5,4,111
3,18,21,19,20,5,4,0,0,90
3,18,21,19,20,5,4,12,25,127
3,18,21,19,20,5,18,0,0,104
3,18,21,19,20,25,0,0,0,106
3,18,21,19,20,9,5,18,0,113
3,18,21,19,20,9,5,19,20,134
3,18,21,19,20,9,6,9,3,108
3,18,21,19,20,9,12,25,0,127
3,18,21,19,20,9,14,7,0,111
3,18,21,19,20,12,5,19,19,136
3,18,21,19,20,15,19,5,0,120
3,18,21,19,20,15,19,9,19,143
3,18,21,19,20,19,0,0,0,100
3,18,21,20,0,0,0,0,0,62
3,18,21,20,3,8,0,0,0,73
3,18,21,20,3,8,5,4,0,82
3,18,21,20,3,8,5,19,0,97
3,18,21,20,3,8,9,14,7,103
3,18,21,20,8,0,0,0,0,70
3,18,21,20,20,5,18,0,0,105
3,18,21,24,5,19,0,0,0,90
3,18,21,26,1,4,15,0,0,88
3,18,21,26,1,4,15,5,19,112
3,18,21,26,1,4,15,19,0,107
3,18,21,26,5,9,18,15,0,115
3,18,21,26,5,9,18,15,19,134
3,18,21,26,9,5,18,15,0,115
3,18,21,26,9,5,18,15,19,134
3,18,23,4,0,0,0,0,0,48
3,18,23,20,8,0,0,0,0,72
3,18,23,20,8,19,0,0,0,91
3,18,26,5,20,20,5,0,0,97
3,19,3,8,0,0,0,0,0,33
3,19,5,3,20,0,0,0,0,50
3,19,5,3,20,19,0,0,0,69
3,19,11,0,0,0,0,0,0,33
3,19,13,16,0,0,0,0,0,51
3,19,23,0,0,0,0,0,0,45
3,20,5,0,0,0,0,0,0,28
3,20,5,12,5,20,20,5,0,90
3,20,5,14,5,0,0,0,0,47
3,20,5,14,9,4,9,1,0,65
3,20,5,14,9,4,9,1,12,77
3,20,5,14,9,4,9,21,13,98
3,20,5,14,9,6,15,18,13,103
3,20,5,14,9,9,0,0,0,60
3,20,5,14,9,26,9,4,0,90
3,20,5,14,15,3,25,19,20,124
3,20,5,14,15,4,15,14,20,110
3,20,5,14,15,9,4,0,0,70
3,20,5,14,15,12,9,21,13,112
3,20,5,20,15,12,15,7,25,122
3,20,6,0,0,0,0,0,0,29
3,20,7,0,0,0,0,0,0,30
3,20,7,5,0,0,0,0,0,35
3,20,9,13,15,0,0,0,0,60
3,20,14,0,0,0,0,0,0,37
3,20,18,0,0,0,0,0,0,41
3,20,18,12,0,0,0,0,0,53
3,21,2,1,7,5,19,0,0,58
3,21,2,1,12,1,25,1,0,66
3,21,2,1,14,5,0,0,0,46
3,21,2,1,14,7,12,5,0,65
3,21,2,1,14,9,20,5,0,75
3,21,2,1,14,19,0,0,0,60
3,21,2,1,19,0,0,0,0,46
3,21,2,1,20,9,15,14,0,85
3,21,2,1,20,15,18,25,0,105
3,21,2,1,20,21,18,5,0,91
3,21,2,1,20,21,18,5,19,110
3,21,2,2,25,0,0,0,0,53
3,21,2,2,9,5,19,0,0,61
3,21,2,2,25,8,15,12,5,93
3,21,2,2,25,25,5,23,0,106
3,21,2,2,9,14,7,0,0,58
3,21,2,2,9,19,8,0,0,64
3,21,2,2,9,19,8,12,25,101
3,21,2,2,25,21,0,0,0,74
3,21,2,4,15,13,0,0,0,58
3,21,2,5,0,0,0,0,0,31
3,21,2,5,2,0,0,0,0,33
3,21,2,5,2,19,0,0,0,52
3,21,2,5,4,0,0,0,0,35
3,21,2,5,8,5,1,4,0,49
3,21,2,5,12,5,20,0,0,68
3,21,2,5,18,0,0,0,0,49
3,21,2,5,18,1,0,0,0,50
3,21,2,5,18,19,0,0,0,68
3,21,2,5,19,0,0,0,0,50
3,21,2,8,15,15,4,0,0,68
3,21,2,9,0,0,0,0,0,35
3,21,2,9,3,0,0,0,0,38
3,21,2,9,3,1,0,0,0,39
3,21,2,9,3,1,12,0,0,51
3,21,2,9,3,1,12,12,25,88
3,21,2,9,3,9,20,25,0,92
3,21,2,9,3,12,5,0,0,55
3,21,2,9,3,12,5,19,0,74
3,21,2,9,3,12,25,0,0,75
3,21,2,9,3,15,14,5,0,72
3,21,2,9,3,19,0,0,0,57
3,21,2,9,3,21,12,1,0,72
3,21,2,9,3,21,12,1,18,90
3,21,2,9,3,21,12,15,0,86
3,21,2,9,3,21,12,21,13,105
3,21,2,9,6,15,18,13,0,87
3,21,2,9,14,7,0,0,0,56
3,21,2,9,19,13,19,0,0,86
3,21,2,9,19,20,0,0,0,74
3,21,2,9,19,20,9,3,0,86
3,21,2,9,19,20,19,0,0,93
3,21,2,9,20,0,0,0,0,55
3,21,2,9,20,1,12,0,0,68
3,21,2,9,20,1,12,5,0,73
3,21,2,9,20,1,12,9,1,78
3,21,2,9,20,5,4,0,0,64
3,21,2,9,20,9,0,0,0,64
3,21,2,9,20,9,5,18,5,92
3,21,2,9,20,15,0,0,0,70
3,21,2,9,20,19,0,0,0,74
3,21,2,9,20,21,19,0,0,95
3,21,2,12,1,0,0,0,0,39
3,21,2,13,1,19,20,5,18,102
3,21,2,15,3,21,2,5,0,72
3,21,2,15,9,4,0,0,0,54
3,21,2,15,9,4,1,12,0,67
3,21,2,15,9,4,5,19,0,78
3,21,2,15,9,4,19,0,0,73
3,21,2,15,13,1,14,3,25,97
3,21,2,19,0,0,0,0,0,45
3,21,2,20,9,0,0,0,0,55
3,21,3,1,0,0,0,0,0,28
3,21,3,1,18,1,3,8,1,59
3,21,3,8,9,1,0,0,0,45
3,21,3,11,0,0,0,0,0,38
3,21,3,11,8,15,12,4,0,77
3,21,3,11,9,14,7,0,0,68
3,21,3,11,15,12,4,0,0,69
3,21,3,11,15,12,4,5,4,78
3,21,3,11,15,12,4,25,0,94
3,21,3,11,15,12,4,12,25,106
3,21,3,11,15,12,4,15,13,97
3,21,3,11,15,12,4,18,25,112
3,21,3,11,15,12,4,19,0,88
3,21,3,11,15,15,0,0,0,68
3,21,3,11,15,15,5,4,0,77
3,21,3,11,15,15,9,14,7,98
3,21,3,11,15,15,19,0,0,87
3,21,3,11,17,21,5,1,14,96
3,21,3,11,19,20,15,15,12,119
3,21,3,15,12,9,14,5,0,82
3,21,3,21,25,0,0,0,0,73
3,21,3,21,25,15,0,0,0,88
3,21,3,21,12,1,18,9,19,107
3,21,3,21,12,5,0,0,0,65
3,21,3,21,12,9,14,5,0,88
3,21,3,21,12,12,1,0,0,73
3,21,3,21,12,12,1,20,5,98
3,21,3,21,12,12,5,0,0,77
3,21,3,21,12,12,21,19,0,112
3,21,3,21,12,15,9,4,0,88
3,21,3,21,13,2,5,18,0,86
3,21,3,21,13,2,5,18,19,105
3,21,3,21,16,8,1,0,0,73
3,21,3,21,18,2,0,0,0,68
3,21,3,21,18,2,9,20,0,97
3,21,3,21,18,2,9,20,5,102
3,21,3,21,18,2,9,20,19,116
3,21,4,0,0,0,0,0,0,28
3,21,4,1,22,1,0,0,0,52
3,21,4,2,5,1,18,0,0,54
3,21,4,2,5,1,18,19,0,73
3,21,4,4,5,14,0,0,0,51
3,21,4,4,9,5,0,0,0,46
3,21,4,4,9,5,19,0,0,65
3,21,4,4,25,8,15,12,5,97
3,21,4,4,12,5,0,0,0,49
3,21,4,4,12,5,4,0,0,53
3,21,4,4,12,5,19,0,0,68
3,21,4,4,12,25,0,0,0,69
3,21,4,4,12,9,5,18,0,76
3,21,4,4,12,9,5,19,20,97
3,21,4,4,12,9,14,7,0,74
3,21,4,5,9,7,8,0,0,57
3,21,4,7,5,12,0,0,0,52
3,21,4,7,5,12,5,4,0,61
3,21,4,7,5,12,5,18,0,75
3,21,4,7,5,12,5,18,19,94
3,21,4,7,5,12,9,14,7,82
3,21,4,7,5,12,12,5,4,73
3,21,4,7,5,12,12,5,18,87
3,21,4,7,5,12,19,0,0,71
3,21,4,7,5,18,9,5,0,72
3,21,4,19,0,0,0,0,0,47
3,21,4,23,5,5,4,0,0,65
3,21,4,23,5,5,4,19,0,84
3,21,4,23,15,18,20,0,0,104
3,21,5,0,0,0,0,0,0,29
3,21,5,2,1,12,12,0,0,56
3,21,5,3,1,0,0,0,0,33
3,21,5,3,1,19,0,0,0,52
3,21,5,4,0,0,0,0,0,33
3,21,5,9,14,7,0,0,0,59
3,21,5,9,19,20,0,0,0,77
3,21,5,13,1,14,0,0,0,57
3,21,5,13,5,14,0,0,0,61
3,21,5,18,4,1,0,0,0,52
3,21,5,18,16,15,0,0,0,78
3,21,5,19,0,0,0,0,0,48
3,21,5,19,20,1,0,0,0,69
3,21,5,19,20,1,19,0,0,88
3,21,6,6,0,0,0,0,0,36
3,21,6,6,5,4,0,0,0,45
3,21,6,6,5,18,0,0,0,59
3,21,6,6,25,0,0,0,0,61
3,21,6,6,25,9,19,13,0,102
3,21,6,6,9,14,0,0,0,59
3,21,6,6,9,14,7,0,0,66
3,21,6,6,12,5,0,0,0,53
3,21,6,6,12,5,19,19,0,91
3,21,6,6,12,9,14,11,0,82
3,21,6,6,12,9,14,11,19,101
3,21,6,6,19,0,0,0,0,55
3,21,25,1,0,0,0,0,0,50
3,21,25,1,19,0,0,0,0,69
3,21,9,4,1,4,15,0,0,57
3,21,9,5,10,15,0,0,0,63
3,21,9,5,10,15,19,0,0,82
3,21,9,6,0,0,0,0,0,39
3,21,9,6,19,0,0,0,0,58
3,21,9,14,1,7,5,0,0,60
3,21,9,14,6,15,0,0,0,68
3,21,9,14,7,0,0,0,0,54
3,21,9,18,0,0,0,0,0,51
3,21,9,18,1,19,19,0,0,90
3,21,9,18,1,19,19,5,4,99
3,21,9,18,1,19,19,5,19,114
3,21,9,18,9,5,0,0,0,65
3,21,9,19,8,0,0,0,0,60
3,21,9,19,8,5,19,0,0,84
3,21,9,19,9,14,1,18,25,119
3,21,9,19,9,14,5,0,0,80
3,21,9,19,9,14,5,19,0,99
3,21,9,19,9,14,9,5,18,107
3,21,9,19,19,1,18,4,0,94
3,21,9,19,19,1,18,20,0,110
3,21,9,19,19,5,0,0,0,76
3,21,9,19,19,5,14,0,0,90
3,21,9,19,19,5,19,0,0,95
3,21,9,19,20,5,14,0,0,91
3,21,9,20,0,0,0,0,0,53
3,21,9,20,12,5,0,0,0,70
3,21,9,20,12,5,4,0,0,74
3,21,9,20,12,9,14,7,0,95
3,21,9,20,20,9,11,9,14,116
3,21,9,20,20,12,5,0,0,90
3,21,9,20,20,12,5,4,0,94
3,21,9,20,20,12,5,19,0,109
3,21,9,20,20,12,9,14,7,115
3,21,10,0,0,0,0,0,0,34
3,21,11,5,0,0,0,0,0,40
3,21,11,5,19,0,0,0,0,59
3,21,12,1,0,0,0,0,0,37
3,21,12,1,20,9,15,14,0,95
3,21,12,2,21,20,0,0,0,79
3,21,12,2,21,20,5,0,0,84
3,21,12,2,21,20,5,18,0,102
3,21,12,3,8,0,0,0,0,47
3,21,12,3,8,5,19,0,0,71
3,21,12,5,0,0,0,0,0,41
3,21,12,5,18,1,7,5,0,72
3,21,12,5,20,0,0,0,0,61
3,21,12,5,20,19,0,0,0,80
3,21,12,5,20,20,0,0,0,81
3,21,12,5,21,19,0,0,0,81
3,21,12,7,5,5,0,0,0,53
3,21,12,9,3,5,19,0,0,72
3,21,12,9,3,9,4,0,0,61
3,21,12,9,3,9,4,1,12,74
3,21,12,9,3,9,4,5,0,66
3,21,12,9,3,9,4,19,0,80
3,21,12,9,3,9,14,5,0,76
3,21,12,9,3,9,14,5,19,95
3,21,12,9,12,1,23,1,14,96
3,21,12,9,14,1,18,25,0,103
3,21,12,12,1,0,0,0,0,49
3,21,12,12,1,7,5,0,0,61
3,21,12,12,1,25,0,0,0,74
3,21,12,12,1,25,19,0,0,93
3,21,12,12,1,19,0,0,0,68
3,21,12,12,5,4,0,0,0,57
3,21,12,12,5,14,4,5,18,94
3,21,12,12,5,18,0,0,0,71
3,21,12,12,5,18,19,0,0,90
3,21,12,12,5,20,0,0,0,73
3,21,12,12,5,20,19,0,0,92
3,21,12,12,9,2,12,5,0,76
3,21,12,12,9,5,4,0,0,66
3,21,12,12,9,5,19,0,0,81
3,21,12,12,25,9,14,7,0,103
3,21,12,12,9,14,7,0,0,78
3,21,12,12,9,15,14,0,0,86
3,21,12,12,9,15,14,12,25,123
3,21,12,12,9,15,14,18,25,129
3,21,12,12,9,15,14,19,0,105
3,21,12,12,9,19,0,0,0,76
3,21,12,12,9,19,5,19,0,100
3,21,12,12,19,0,0,0,0,67
3,21,12,13,5,4,0,0,0,58
3,21,12,13,5,14,0,0,0,68
3,21,12,13,25,0,0,0,0,74
3,21,12,13,9,14,1,12,0,85
3,21,12,13,9,14,1,14,20,107
3,21,12,13,9,14,1,20,5,98
3,21,12,13,9,14,7,0,0,79
3,21,12,13,19,0,0,0,0,68
3,21,12,15,20,0,0,0,0,71
3,21,12,15,20,20,5,0,0,96
3,21,12,15,20,20,5,19,0,115
3,21,12,15,20,20,9,3,0,103
3,21,12,15,20,20,9,19,13,132
3,21,12,16,0,0,0,0,0,52
3,21,12,16,1,0,0,0,0,53
3,21,12,16,1,2,12,5,0,72
3,21,12,16,1,2,12,25,0,92
3,21,12,16,1,5,0,0,0,58
3,21,12,16,1,19,0,0,0,72
3,21,12,16,1,20,5,0,0,78
3,21,12,16,1,20,15,18,25,131
3,21,12,16,5,15,0,0,0,72
3,21,12,16,15,14,0,0,0,81
3,21,12,16,15,19,5,0,0,91
3,21,12,16,18,9,20,0,0,99
3,21,12,16,18,9,20,19,0,118
3,21,12,18,1,7,5,0,0,67
3,21,12,19,4,5,19,1,3,87
3,21,12,20,0,0,0,0,0,56
3,21,12,20,3,8,0,0,0,67
3,21,12,20,3,8,5,19,0,91
3,21,12,20,5,12,12,9,0,94
3,21,12,20,5,12,12,21,19,125
3,21,12,20,5,18,0,0,0,79
3,21,12,20,9,0,0,0,0,65
3,21,12,20,9,3,0,0,0,68
3,21,12,20,9,7,5,14,0,91
3,21,12,20,9,7,5,14,19,110
3,21,12,20,9,19,8,0,0,92
3,21,12,20,9,19,13,0,0,97
3,21,12,20,9,19,13,15,0,112
3,21,12,20,9,19,13,19,0,116
3,21,12,20,9,19,20,0,0,104
3,21,12,20,9,19,20,9,3,116
3,21,12,20,9,19,20,19,0,123
3,21,12,20,9,22,1,18,0,106
3,21,12,20,9,22,1,18,19,125
3,21,12,20,9,22,1,20,5,113
3,21,12,20,9,22,5,0,0,92
3,21,12,20,18,1,20,5,0,100
3,21,12,20,18,1,20,5,4,104
3,21,12,20,19,0,0,0,0,75
3,21,12,20,20,5,12,12,9,114
3,21,12,20,21,1,12,0,0,90
3,21,12,20,21,18,1,12,0,108
3,21,12,20,21,18,5,0,0,100
3,21,12,20,21,18,5,4,0,104
3,21,12,20,21,18,5,19,0,119
3,21,12,20,21,18,9,14,5,123
3,21,12,20,21,18,9,14,7,125
3,21,12,20,21,18,9,19,20,143
3,21,12,20,21,18,9,26,5,135
3,21,12,20,21,19,0,0,0,96
3,21,12,20,21,19,5,19,0,120
3,21,12,21,19,0,0,0,0,76
3,21,12,22,5,18,9,14,0,104
3,21,12,22,5,18,9,14,19,123
3,21,12,22,5,18,11,5,25,122
3,21,12,22,5,18,19,0,0,100
3,21,12,22,5,18,20,0,0,101
3,21,12,22,5,18,20,19,0,120
3,21,13,0,0,0,0,0,0,37
3,21,13,1,3,5,1,14,0,61
3,21,13,1,3,5,15,21,19,101
3,21,13,1,25,0,0,0,0,63
3,21,13,1,12,0,0,0,0,50
3,21,13,1,16,8,25,20,5,112
3,21,13,1,18,1,0,0,0,57
3,21,13,1,18,9,14,0,0,79
3,21,13,1,18,9,14,19,0,98
3,21,13,1,18,15,14,5,0,90
3,21,13,1,18,21,0,0,0,77
3,21,13,2,5,14,20,0,0,78
3,21,13,2,5,18,0,0,0,62
3,21,13,2,5,18,5,4,0,71
3,21,13,2,5,18,5,18,0,85
3,21,13,2,5,18,5,18,19,104
3,21,13,2,5,18,9,14,7,92
3,21,13,2,5,18,19,0,0,81
3,21,13,2,8,1,0,0,0,48
3,21,13,2,12,5,0,0,0,56
3,21,13,2,12,25,0,0,0,76
3,21,13,2,18,1,9,20,5,92
3,21,13,2,18,1,14,3,5,80
3,21,13,2,18,5,0,0,0,62
3,21,13,2,18,15,21,19,0,112
3,21,13,2,21,0,0,0,0,60
3,21,13,5,14,5,0,0,0,61
3,21,13,5,14,7,9,20,5,97
3,21,13,5,14,25,12,0,0,93
3,21,13,8,1,12,0,0,0,58
3,21,13,9,3,0,0,0,0,49
3,21,13,9,4,9,14,0,0,73
3,21,13,9,4,9,14,5,0,78
3,21,13,25,12,0,0,0,0,74
3,21,13,9,14,0,0,0,0,60
3,21,13,9,14,1,12,0,0,73
3,21,13,9,14,9,3,0,0,72
3,21,13,9,14,25,12,0,0,97
3,21,13,9,14,15,9,14,0,98
3,21,13,9,14,15,12,0,0,87
3,21,13,9,14,15,12,5,0,92
3,21,13,9,14,19,0,0,0,79
3,21,13,9,14,19,5,5,4,93
3,21,13,12,25,0,0,0,0,74
3,21,13,13,5,18,0,0,0,73
3,21,13,13,5,18,19,0,0,92
3,21,13,13,9,14,0,0,0,73
3,21,13,13,15,3,11,0,0,79
3,21,13,15,12,0,0,0,0,64
3,21,13,16,0,0,0,0,0,53
3,21,13,17,21,1,20,0,0,96
3,21,13,17,21,1,20,19,0,115
3,21,13,19,8,1,0,0,0,65
3,21,13,19,8,1,23,0,0,88
3,21,13,19,8,1,23,19,0,107
3,21,13,21,12,1,14,20,0,105
3,21,13,21,12,1,18,0,0,89
3,21,13,21,12,1,20,5,0,96
3,21,13,21,12,1,20,5,4,100
3,21,13,21,12,1,20,5,19,115
3,21,13,21,12,5,14,5,0,94
3,21,13,21,12,5,20,0,0,95
3,21,13,21,12,9,0,0,0,79
3,21,13,21,12,9,20,5,0,104
3,21,13,21,12,15,19,5,0,109
3,21,13,21,12,15,21,19,0,125
3,21,13,21,12,21,19,0,0,110
3,21,14,0,0,0,0,0,0,38
3,21,14,1,2,21,12,1,0,75
3,21,14,1,2,21,12,1,18,93
3,21,14,3,20,1,20,15,18,115
3,21,14,4,0,0,0,0,0,42
3,21,14,4,5,1,13,15,18,94
3,21,14,4,25,0,0,0,0,67
3,21,14,4,9,20,5,0,0,76
3,21,14,4,21,13,0,0,0,76
3,21,14,4,21,13,19,0,0,95
3,21,14,5,1,0,0,0,0,44
3,21,14,5,1,12,0,0,0,56
3,21,14,5,1,20,5,0,0,69
3,21,14,5,1,20,5,4,0,73
3,21,14,5,1,20,5,12,25,106
3,21,14,5,1,20,9,3,0,76
3,21,14,5,1,20,15,18,0,97
3,21,14,5,9,0,0,0,0,52
3,21,14,5,9,6,15,18,13,104
3,21,14,5,14,5,9,0,0,71
3,21,14,5,20,20,5,0,0,88
3,21,14,5,21,19,0,0,0,83
3,21,14,7,5,2,15,9,0,76
3,21,14,7,5,22,15,9,0,96
3,21,14,9,3,21,12,1,18,102
3,21,14,9,3,21,12,9,0,92
3,21,14,9,3,21,12,21,19,123
3,21,14,25,5,0,0,0,0,68
3,21,14,9,6,15,18,13,0,99
3,21,14,9,6,15,18,13,19,118
3,21,14,25,9,5,0,0,0,77
3,21,14,9,12,1,0,0,0,60
3,21,14,9,12,9,0,0,0,68
3,21,14,9,20,0,0,0,0,67
3,21,14,10,1,8,0,0,0,57
3,21,14,10,5,18,0,0,0,71
3,21,14,10,5,22,15,9,0,99
3,21,14,14,5,18,0,0,0,75
3,21,14,14,5,18,19,0,0,94
3,21,14,14,9,0,0,0,0,61
3,21,14,14,25,0,0,0,0,77
3,21,14,14,9,14,7,0,0,82
3,21,14,14,9,14,7,5,18,105
3,21,14,14,9,14,7,12,25,119
3,21,14,14,9,14,7,19,0,101
3,21,14,20,0,0,0,0,0,58
3,21,14,20,19,0,0,0,0,77
3,21,14,26,9,5,0,0,0,78
3,21,15,18,9,14,0,0,0,80
3,21,16,0,0,0,0,0,0,40
3,21,16,1,25,0,0,0,0,66
3,21,16,2,5,1,18,5,18,89
3,21,16,2,15,1,18,4,0,80
3,21,16,2,15,1,18,4,19,99
3,21,16,3,1,11,5,0,0,60
3,21,16,3,1,11,5,19,0,79
3,21,16,5,12,0,0,0,0,57
3,21,16,5,12,5,4,0,0,66
3,21,16,5,12,5,18,0,0,80
3,21,16,5,12,5,18,19,0,99
3,21,16,5,12,9,14,7,0,87
3,21,16,5,12,12,5,4,0,78
3,21,16,5,12,12,5,18,0,92
3,21,16,5,12,12,5,18,19,111
3,21,16,5,12,12,9,14,7,99
3,21,16,5,12,19,0,0,0,76
3,21,16,6,12,15,23,5,18,119
3,21,16,6,21,12,0,0,0,79
3,21,16,6,21,12,19,0,0,98
3,21,16,8,5,1,4,0,0,58
3,21,16,8,15,12,4,5,18,102
3,21,16,9,4,9,20,25,0,107
3,21,16,9,4,15,14,0,0,82
3,21,16,9,4,15,14,5,0,87
3,21,16,9,4,19,0,0,0,72
3,21,16,9,21,2,1,0,0,73
3,21,16,12,5,19,19,0,0,95
3,21,16,12,9,11,5,0,0,77
3,21,16,13,1,11,5,18,0,88
3,21,16,13,1,11,9,14,7,95
3,21,16,13,1,14,0,0,0,68
3,21,16,13,1,20,5,0,0,79
3,21,16,15,12,1,0,0,0,68
3,21,16,15,12,1,5,4,0,77
3,21,16,15,12,1,9,14,7,98
3,21,16,15,12,1,13,1,14,96
3,21,16,15,12,1,18,0,0,86
3,21,16,15,12,1,19,0,0,87
3,21,16,15,12,1,20,5,4,97
3,21,16,16,1,0,0,0,0,57
3,21,16,16,1,19,0,0,0,76
3,21,16,16,5,4,0,0,0,65
3,21,16,16,5,14,0,0,0,75
3,21,16,16,5,18,0,0,0,79
3,21,16,16,5,18,19,0,0,98
3,21,16,16,25,0,0,0,0,81
3,21,16,16,9,5,18,0,0,88
3,21,16,16,9,5,19,20,0,109
3,21,16,16,9,14,0,0,0,79
3,21,16,16,9,14,7,0,0,86
3,21,16,16,9,14,7,19,0,105
3,21,16,18,1,20,5,0,0,84
3,21,16,18,5,9,14,0,0,86
3,21,16,18,5,9,14,5,0,91
3,21,16,18,5,14,5,0,0,82
3,21,16,18,5,15,21,19,0,118
3,21,16,18,9,3,0,0,0,70
3,21,16,18,9,4,5,0,0,76
3,21,16,18,9,20,5,0,0,92
3,21,16,18,9,20,5,19,0,111
3,21,16,18,15,9,4,0,0,86
3,21,16,18,15,19,5,0,0,97
3,21,16,18,15,21,19,0,0,113
3,21,16,18,21,13,0,0,0,92
3,21,16,18,21,13,19,0,0,111
3,21,16,19,0,0,0,0,0,59
3,21,16,19,5,5,4,0,0,73
3,21,16,19,6,21,12,0,0,98
3,21,16,19,20,15,14,5,0,113
3,21,16,21,12,1,0,0,0,74
3,21,16,21,12,1,5,0,0,79
3,21,16,21,12,1,18,0,0,92
3,21,16,21,12,1,20,5,0,99
3,21,16,21,12,5,0,0,0,78
3,21,16,21,12,5,19,0,0,97
3,21,18,0,0,0,0,0,0,42
3,21,18,1,0,0,0,0,0,43
3,21,18,1,2,12,5,0,0,62
3,21,18,1,2,12,25,0,0,82
3,21,18,1,3,1,15,19,0,81
3,21,18,1,3,5,0,0,0,51
3,21,18,1,3,25,0,0,0,71
3,21,18,1,3,9,5,19,0,79
3,21,18,1,3,15,1,0,0,62
3,21,18,1,3,15,1,19,0,81
3,21,18,1,7,5,0,0,0,55
3,21,18,1,7,8,0,0,0,58
3,21,18,1,7,8,19,0,0,77
3,21,18,1,18,1,0,0,0,62
3,21,18,1,18,1,19,0,0,81
3,21,18,1,18,5,19,0,0,85
3,21,18,1,18,9,0,0,0,70
3,21,18,1,18,9,14,5,0,89
3,21,18,1,18,9,14,5,19,108
3,21,18,1,18,9,19,0,0,89
3,21,18,1,18,9,26,5,0,101
3,21,18,1,18,9,26,5,4,105
3,21,18,1,18,9,26,5,19,120
3,21,18,1,19,19,15,23,0,119
3,21,18,1,19,19,15,23,19,138
3,21,18,1,20,0,0,0,0,63
3,21,18,1,20,1,7,5,0,76
3,21,18,1,20,5,0,0,0,68
3,21,18,1,20,5,12,0,0,80
3,21,18,1,20,5,19,0,0,87
3,21,18,1,20,5,19,19,0,106
3,21,18,1,20,9,1,12,0,85
3,21,18,1,20,9,3,0,0,75
3,21,18,1,20,9,3,1,12,88
3,21,18,1,20,9,15,14,0,101
3,21,18,1,20,9,22,5,0,99
3,21,18,1,20,9,22,5,19,118
3,21,18,1,20,9,26,5,0,103
3,21,18,1,20,15,18,0,0,96
3,21,18,1,20,15,18,25,0,121
3,21,18,1,20,15,18,19,0,115
3,21,18,1,20,18,9,24,0,114
3,21,18,2,0,0,0,0,0,44
3,21,18,2,1,2,12,5,0,64
3,21,18,2,1,19,8,0,0,72
3,21,18,2,5,4,0,0,0,53
3,21,18,2,5,18,0,0,0,67
3,21,18,2,5,18,19,0,0,86
3,21,18,2,25,0,0,0,0,69
3,21,18,2,9,14,7,0,0,74
3,21,18,2,9,14,7,19,0,93
3,21,18,2,12,5,19,19,0,99
3,21,18,2,12,9,11,5,0,81
3,21,18,2,12,9,14,5,0,84
3,21,18,2,19,0,0,0,0,63
3,21,18,2,19,9,4,5,0,81
3,21,18,2,19,20,15,14,5,117
3,21,18,3,1,19,0,0,0,65
3,21,18,3,8,0,0,0,0,53
3,21,18,3,8,5,6,0,0,64
3,21,18,3,8,5,19,0,0,77
3,21,18,3,8,25,0,0,0,78
3,21,18,3,21,12,9,15,19,121
3,21,18,3,21,13,1,19,0,99
3,21,18,3,21,13,9,14,0,102
3,21,18,4,0,0,0,0,0,46
3,21,18,4,5,4,0,0,0,55
3,21,18,4,25,0,0,0,0,71
3,21,18,4,9,5,18,0,0,78
3,21,18,4,9,5,19,20,0,99
3,21,18,4,9,14,5,19,19,112
3,21,18,4,9,14,7,0,0,76
3,21,18,4,12,5,0,0,0,63
3,21,18,4,12,5,4,0,0,67
3,21,18,4,12,5,18,0,0,81
3,21,18,4,12,5,18,19,0,100
3,21,18,4,12,5,19,0,0,82
3,21,18,4,12,25,0,0,0,83
3,21,18,4,12,9,14,7,0,88
3,21,18,4,15,15,0,0,0,76
3,21,18,4,19,0,0,0,0,65
3,21,18,4,23,15,18,20,0,122
3,21,18,5,0,0,0,0,0,47
3,21,18,5,4,0,0,0,0,51
3,21,18,5,12,5,19,19,0,102
3,21,18,5,18,0,0,0,0,65
3,21,18,5,18,19,0,0,0,84
3,21,18,5,19,0,0,0,0,66
3,21,18,5,20,0,0,0,0,67
3,21,18,5,20,19,0,0,0,86
3,21,18,5,20,20,1,7,5,100
3,21,18,5,20,20,5,0,0,92
3,21,18,5,20,20,5,4,0,96
3,21,18,5,20,20,5,19,0,111
3,21,18,5,20,20,9,14,7,117
3,21,18,6,0,0,0,0,0,48
3,21,18,6,5,23,0,0,0,76
3,21,18,6,5,23,5,4,0,85
3,21,18,6,5,23,9,14,7,106
3,21,18,6,5,23,19,0,0,95
3,21,18,6,19,0,0,0,0,67
3,21,18,25,0,0,0,0,0,67
3,21,18,9,1,5,0,0,0,57
3,21,18,9,1,7,5,0,0,64
3,21,18,9,1,12,0,0,0,64
3,21,18,9,1,12,9,19,13,105
3,21,18,9,1,12,9,19,20,112
3,21,18,9,1,12,9,20,25,118
3,21,18,9,1,13,0,0,0,65
3,21,18,9,1,18,1,0,0,71
3,21,18,9,1,20,5,0,0,77
3,21,18,9,2,15,3,1,0,72
3,21,18,9,5,7,18,1,13,95
3,21,18,9,5,19,0,0,0,75
3,21,18,9,5,20,0,0,0,76
3,21,18,25,9,14,7,0,0,97
3,21,18,9,14,0,0,0,0,65
3,21,18,9,14,5,0,0,0,70
3,21,18,9,14,7,0,0,0,72
3,21,18,9,15,0,0,0,0,66
3,21,18,9,15,12,15,7,25,125
3,21,18,9,15,19,0,0,0,85
3,21,18,9,15,19,1,0,0,86
3,21,18,9,15,19,9,0,0,94
3,21,18,9,15,19,9,20,25,139
3,21,18,9,15,19,15,0,0,100
3,21,18,9,15,19,15,19,0,119
3,21,18,9,15,21,19,0,0,106
3,21,18,9,15,21,19,5,18,129
3,21,18,9,15,21,19,12,25,143
3,21,18,9,20,5,0,0,0,76
3,21,18,9,20,5,19,0,0,95
3,21,18,9,21,13,0,0,0,85
3,21,18,9,21,13,19,0,0,104
3,21,18,12,0,0,0,0,0,54
3,21,18,12,5,4,0,0,0,63
3,21,18,12,5,4,12,25,0,100
3,21,18,12,5,18,0,0,0,77
3,21,18,12,5,18,19,0,0,96
3,21,18,12,5,23,0,0,0,82
3,21,18,12,5,23,19,0,0,101
3,21,18,12,25,0,0,0,0,79
3,21,18,12,9,3,21,5,0,92
3,21,18,12,25,3,21,5,0,108
3,21,18,12,9,3,21,5,4,96
3,21,18,12,9,3,21,5,19,111
3,21,18,12,25,3,21,5,19,127
3,21,18,12,9,5,18,0,0,86
3,21,18,12,9,5,19,20,0,107
3,21,18,12,25,8,5,1,4,97
3,21,18,12,9,11,5,0,0,79
3,21,18,12,9,12,25,0,0,100
3,21,18,12,9,14,5,19,19,120
3,21,18,12,9,14,7,0,0,84
3,21,18,12,9,14,7,12,25,121
3,21,18,12,9,14,7,19,0,103
3,21,18,12,16,1,16,5,18,110
3,21,18,12,19,0,0,0,0,73
3,21,18,14,0,0,0,0,0,56
3,21,18,14,5,25,0,0,0,86
3,21,18,14,5,25,19,0,0,105
3,21,18,14,9,5,0,0,0,70
3,21,18,14,9,5,19,0,0,89
3,21,18,14,15,3,11,0,0,85
3,21,18,14,19,0,0,0,0,75
3,21,18,16,5,12,0,0,0,75
3,21,18,16,9,14,0,0,0,81
3,21,18,16,12,5,0,0,0,75
3,21,18,18,1,3,8,0,0,72
3,21,18,18,1,3,8,19,0,91
3,21,18,18,1,3,11,0,0,75
3,21,18,18,1,7,8,0,0,76
3,21,18,18,1,7,8,19,0,95
3,21,18,18,1,10,15,14,7,107
3,21,18,18,1,14,3,5,0,83
3,21,18,18,1,14,5,0,0,80
3,21,18,18,1,14,19,0,0,94
3,21,18,18,1,14,20,0,0,95
3,21,18,18,1,14,20,19,0,114
3,21,18,18,1,20,15,23,0,119
3,21,18,18,1,23,1,14,7,106
3,21,18,18,1,23,15,14,7,120
3,21,18,18,5,4,0,0,0,69
3,21,18,18,5,14,3,25,0,107
3,21,18,18,5,14,20,0,0,99
3,21,18,18,5,14,20,12,25,136
3,21,18,18,5,14,20,19,0,118
3,21,18,18,9,3,12,1,0,85
3,21,18,18,9,3,12,5,0,89
3,21,18,18,9,3,12,5,4,93
3,21,18,18,9,3,12,5,19,108
3,21,18,18,25,3,15,13,2,118
3,21,18,18,9,3,21,12,1,106
3,21,18,18,9,5,4,0,0,78
3,21,18,18,9,5,18,25,0,117
3,21,18,18,9,5,18,19,0,111
3,21,18,18,9,5,19,0,0,93
3,21,18,18,9,9,14,7,0,99
3,21,18,18,25,9,14,7,0,115
3,21,18,18,9,10,15,14,7,115
3,21,18,18,9,14,7,0,0,90
3,21,18,18,9,19,8,0,0,96
3,21,18,18,9,19,8,12,25,133
3,21,18,18,15,3,11,0,0,89
3,21,18,18,19,0,0,0,0,79
3,21,18,19,0,0,0,0,0,61
3,21,18,19,1,12,0,0,0,74
3,21,18,19,1,18,15,0,0,95
3,21,18,19,5,0,0,0,0,66
3,21,18,19,5,4,0,0,0,70
3,21,18,19,5,4,5,18,0,93
3,21,18,19,5,4,5,19,20,114
3,21,18,19,5,4,12,25,0,107
3,21,18,19,5,13,5,14,20,118
3,21,18,19,5,14,0,0,0,80
3,21,18,19,5,18,0,0,0,84
3,21,18,19,5,18,19,0,0,103
3,21,18,19,5,19,0,0,0,85
3,21,18,19,8,9,16,0,0,94
3,21,18,19,9,12,12,15,0,109
3,21,18,19,9,14,7,0,0,91
3,21,18,19,9,20,1,20,5,116
3,21,18,19,9,20,15,18,0,123
3,21,18,19,9,22,5,0,0,97
3,21,18,19,9,22,5,12,25,134
3,21,18,19,9,22,5,19,0,116
3,21,18,19,15,18,0,0,0,94
3,21,18,19,15,18,1,18,25,138
3,21,18,19,15,18,25,0,0,119
3,21,18,19,15,18,9,1,12,116
3,21,18,19,15,18,9,12,25,140
3,21,18,19,15,18,19,0,0,113
3,21,18,19,20,0,0,0,0,81
3,21,18,19,20,6,21,12,0,120
3,21,18,19,20,12,25,0,0,118
3,21,18,19,20,14,5,19,19,138
3,21,18,19,21,19,0,0,0,101
3,21,18,20,1,9,12,0,0,84
3,21,18,20,1,9,12,5,4,93
3,21,18,20,1,9,12,5,18,107
3,21,18,20,1,9,12,19,0,103
3,21,18,20,1,9,14,0,0,86
3,21,18,20,1,9,14,5,4,95
3,21,18,20,1,9,14,19,0,105
3,21,18,20,1,25,19,0,0,107
3,21,18,20,1,12,0,0,0,75
3,21,18,20,1,12,1,24,0,100
3,21,18,20,1,12,19,0,0,94
3,21,18,20,1,20,5,0,0,88
3,21,18,20,1,20,9,15,14,121
3,21,18,20,1,24,5,0,0,92
3,21,18,20,5,4,0,0,0,71
3,21,18,20,5,9,14,0,0,90
3,21,18,20,5,12,1,3,5,88
3,21,18,20,5,15,21,19,0,122
3,21,18,20,5,18,0,0,0,85
3,21,18,20,5,19,25,0,0,111
3,21,18,20,5,19,9,5,19,119
3,21,18,20,5,19,20,0,0,106
3,21,18,20,9,12,1,7,5,96
3,21,18,20,12,1,24,0,0,99
3,21,18,20,12,25,0,0,0,99
3,21,18,20,14,5,19,19,0,119
3,21,18,20,19,5,25,0,0,111
3,21,18,20,19,5,25,5,4,120
3,21,18,20,19,5,25,19,0,130
3,21,18,20,19,25,0,0,0,106
3,21,18,20,19,9,5,4,0,99
3,21,18,20,19,9,5,19,0,114
3,21,18,20,19,25,9,14,7,136
3,21,18,21,1,0,0,0,0,64
3,21,18,21,2,1,0,0,0,66
3,21,18,21,3,21,3,21,0,111
3,21,18,21,3,21,9,0,0,96
3,21,18,21,12,5,0,0,0,80
3,21,18,21,16,1,25,0,0,105
3,21,18,21,16,1,25,19,0,124
3,21,18,21,16,5,25,0,0,109
3,21,18,21,18,15,0,0,0,96
3,21,18,21,18,15,19,0,0,115
3,21,18,22,1,12,0,0,0,77
3,21,18,22,1,14,20,0,0,99
3,21,18,22,1,20,5,0,0,90
3,21,18,22,1,20,5,4,0,94
3,21,18,22,1,20,9,15,14,123
3,21,18,22,1,20,9,22,5,121
3,21,18,22,1,20,21,18,5,129
3,21,18,22,5,0,0,0,0,69
3,21,18,22,5,2,1,12,12,96
3,21,18,22,5,4,0,0,0,73
3,21,18,22,5,4,12,25,0,110
3,21,18,22,5,25,0,0,0,94
3,21,18,22,5,18,0,0,0,87
3,21,18,22,5,19,0,0,0,88
3,21,18,22,5,19,15,13,5,121
3,21,18,22,5,20,0,0,0,89
3,21,18,22,5,20,5,4,0,98
3,21,18,22,5,20,9,14,7,119
3,21,18,22,5,20,19,0,0,108
3,21,18,22,5,20,20,5,0,114
3,21,18,22,5,20,20,5,4,118
3,21,18,22,25,0,0,0,0,89
3,21,18,22,9,5,18,0,0,96
3,21,18,22,9,5,19,20,0,117
3,21,18,22,9,6,15,18,13,125
3,21,18,22,9,14,5,19,19,130
3,21,18,22,9,14,7,0,0,94
3,21,18,22,9,20,1,12,0,106
3,21,18,22,9,20,25,0,0,118
3,21,18,22,9,20,9,5,19,126
3,21,18,22,12,5,0,0,0,81
3,21,18,22,15,21,19,0,0,119
3,21,18,22,21,12,1,20,5,123
3,21,18,23,9,12,12,5,20,123
3,21,19,3,15,14,9,14,0,98
3,21,19,3,15,14,9,14,5,103
3,21,19,3,21,19,5,19,0,110
3,21,19,5,3,0,0,0,0,51
3,21,19,5,3,19,0,0,0,70
3,21,19,5,12,9,20,5,0,94
3,21,19,8,1,7,0,0,0,59
3,21,19,8,1,20,0,0,0,72
3,21,19,8,1,20,19,0,0,91
3,21,19,8,1,23,0,0,0,75
3,21,19,8,1,23,19,0,0,94
3,21,19,8,25,0,0,0,0,76
3,21,19,8,9,5,0,0,0,65
3,21,19,8,9,5,18,0,0,83
3,21,19,8,9,5,19,20,0,104
3,21,19,8,9,12,25,0,0,97
3,21,19,8,9,14,5,19,19,117
3,21,19,8,9,15,14,0,0,89
3,21,19,8,9,15,14,5,4,98
3,21,19,8,9,15,14,5,20,114
3,21,19,8,9,15,14,25,0,114
3,21,19,8,9,15,14,19,0,108
3,21,19,9,5,0,0,0,0,57
3,21,19,9,14,5,18,15,0,104
3,21,19,11,0,0,0,0,0,54
3,21,19,11,19,0,0,0,0,73
3,21,19,16,1,12,0,0,0,72
3,21,19,16,1,18,9,1,0,88
3,21,19,16,1,18,9,14,5,106
3,21,19,16,1,20,5,0,0,85
3,21,19,16,1,20,5,4,0,89
3,21,19,16,5,4,0,0,0,68
3,21,19,16,9,4,0,0,0,72
3,21,19,16,9,4,1,12,0,85
3,21,19,16,9,4,1,20,5,98
3,21,19,16,9,4,5,19,0,96
3,21,19,16,9,4,9,14,5,100
3,21,19,16,9,4,15,18,0,105
3,21,19,16,9,4,15,18,19,124
3,21,19,16,9,4,19,0,0,91
3,21,19,16,9,14,7,0,0,89
3,21,19,16,9,19,0,0,0,87
3,21,19,16,19,0,0,0,0,78
3,21,19,16,21,12,5,0,0,97
3,21,19,19,0,0,0,0,0,62
3,21,19,19,5,4,0,0,0,71
3,21,19,19,5,4,12,25,0,108
3,21,19,19,5,18,0,0,0,85
3,21,19,19,5,18,19,0,0,104
3,21,19,19,5,19,0,0,0,86
3,21,19,19,9,14,7,0,0,92
3,21,19,19,15,0,0,0,0,77
3,21,19,19,15,19,0,0,0,96
3,21,19,19,23,15,18,4,0,122
3,21,19,19,23,15,18,4,19,141
3,21,19,20,0,0,0,0,0,63
3,21,19,20,1,18,4,0,0,86
3,21,19,20,1,18,4,19,0,105
3,21,19,20,5,18,9,20,5,120
3,21,19,20,15,4,5,0,0,87
3,21,19,20,15,4,5,5,0,92
3,21,19,20,15,4,5,19,0,106
3,21,19,20,15,4,25,0,0,107
3,21,19,20,15,4,9,1,0,92
3,21,19,20,15,4,9,1,12,104
3,21,19,20,15,4,9,1,13,105
3,21,19,20,15,4,9,1,14,106
3,21,19,20,15,4,9,5,18,114
3,21,19,20,15,4,9,5,19,115
3,21,19,20,15,13,0,0,0,91
3,21,19,20,15,13,1,18,25,135
3,21,19,20,15,13,5,4,0,100
3,21,19,20,15,13,5,18,0,114
3,21,19,20,15,13,5,18,19,133
3,21,19,20,15,13,9,14,7,121
3,21,19,20,15,13,9,26,5,131
3,21,19,20,15,13,12,25,0,128
3,21,19,20,15,13,19,0,0,110
3,21,19,20,15,19,0,0,0,97
3,21,19,20,18,5,12,0,0,98
3,21,19,20,18,15,14,0,0,110
3,21,19,20,18,15,21,14,0,131
3,21,19,20,21,13,1,12,0,110
3,21,19,20,21,13,1,12,19,129
3,21,20,1,14,5,1,12,0,77
3,21,20,1,14,5,15,21,19,119
3,21,20,1,23,1,25,0,0,94
3,21,20,1,23,1,25,19,0,113
3,21,20,2,1,3,11,0,0,61
3,21,20,2,1,3,11,19,0,80
3,21,20,2,1,14,11,19,0,91
3,21,20,3,8,1,0,0,0,56
3,21,20,3,8,5,18,0,0,78
3,21,20,3,8,5,18,25,0,103
3,21,20,3,8,5,18,18,25,121
3,21,20,3,8,5,19,0,0,79
3,21,20,4,15,23,14,0,0,100
3,21,20,4,15,23,14,19,0,119
3,21,20,5,0,0,0,0,0,49
3,21,20,5,25,0,0,0,0,74
3,21,20,5,25,19,0,0,0,93
3,21,20,5,12,25,0,0,0,86
3,21,20,5,14,5,19,19,0,106
3,21,20,5,18,0,0,0,0,67
3,21,20,5,19,0,0,0,0,68
3,21,20,5,19,25,0,0,0,93
3,21,20,5,19,9,5,0,0,82
3,21,20,5,19,9,5,18,0,100
3,21,20,5,19,9,5,19,20,121
3,21,20,5,19,20,0,0,0,88
3,21,20,7,18,1,19,19,0,108
3,21,20,8,5,1,12,0,0,70
3,21,20,9,3,12,5,0,0,73
3,21,20,9,3,12,5,19,0,92
3,21,20,9,3,15,12,15,18,116
3,21,20,9,3,21,12,1,0,90
3,21,20,9,3,21,12,1,5,95
3,21,20,9,3,21,12,1,18,108
3,21,20,9,4,21,18,5,0,101
3,21,20,9,4,21,18,9,19,124
3,21,20,9,5,0,0,0,0,58
3,21,20,9,5,19,0,0,0,77
3,21,20,9,6,25,0,0,0,84
3,21,20,9,7,5,18,1,12,96
3,21,20,9,11,9,14,0,0,87
3,21,20,9,14,0,0,0,0,67
3,21,20,9,14,9,19,5,0,100
3,21,20,9,14,9,19,5,4,104
3,21,20,9,14,9,19,5,19,119
3,21,20,9,14,9,26,5,0,107
3,21,20,9,14,9,26,5,4,111
3,21,20,9,14,9,26,5,19,126
3,21,20,9,14,19,0,0,0,86
3,21,20,9,19,0,0,0,0,72
3,21,20,9,19,5,19,0,0,96
3,21,20,9,20,9,19,0,0,101
3,21,20,12,1,19,0,0,0,76
3,21,20,12,1,19,5,19,0,100
3,21,20,12,1,19,8,0,0,84
3,21,20,12,1,19,19,0,0,95
3,21,20,12,1,19,19,5,19,119
3,21,20,12,5,18,5,19,19,122
3,21,20,12,5,18,25,0,0,104
3,21,20,12,5,18,9,5,19,112
3,21,20,12,5,18,19,0,0,98
3,21,20,12,5,20,0,0,0,81
3,21,20,12,5,20,19,0,0,100
3,21,20,12,9,14,5,0,0,84
3,21,20,12,9,14,5,19,0,103
3,21,20,12,9,14,7,0,0,86
3,21,20,12,9,14,7,19,0,105
3,21,20,12,9,16,19,0,0,100
3,21,20,15,6,6,0,0,0,71
3,21,20,15,6,6,19,0,0,90
3,21,20,15,19,5,0,0,0,83
3,21,20,15,21,20,0,0,0,100
3,21,20,15,21,20,19,0,0,119
3,21,20,15,22,5,18,0,0,104
3,21,20,15,22,5,18,19,0,123
3,21,20,16,21,18,19,5,0,123
3,21,20,16,21,18,19,5,19,142
3,21,20,19,5,20,0,0,0,88
3,21,20,20,1,2,12,5,0,84
3,21,20,20,1,7,5,0,0,77
3,21,20,20,1,7,5,19,0,96
3,21,20,20,1,9,12,0,0,86
3,21,20,20,1,14,5,5,0,89
3,21,20,20,5,4,0,0,0,73
3,21,20,20,5,18,13,1,14,115
3,21,20,20,5,18,19,0,0,106
3,21,20,20,8,18,15,1,20,126
3,21,20,20,9,5,19,0,0,97
3,21,20,20,9,11,9,14,0,107
3,21,20,20,9,14,7,0,0,94
3,21,20,20,9,14,7,12,25,131
3,21,20,20,9,14,7,19,0,113
3,21,20,20,12,5,0,0,0,81
3,21,20,20,12,5,4,0,0,85
3,21,20,20,12,5,19,0,0,100
3,21,20,20,12,9,14,7,0,106
3,21,20,20,15,5,0,0,0,84
3,21,20,20,15,15,0,0,0,94
3,21,20,20,15,15,19,0,0,113
3,21,20,21,16,0,0,0,0,81
3,21,20,21,16,19,0,0,0,100
3,21,20,23,1,12,0,0,0,80
3,21,20,23,1,20,5,18,0,111
3,21,20,23,1,20,5,18,19,130
3,21,20,23,5,5,4,0,0,81
3,21,20,23,15,18,11,0,0,111
3,21,20,23,15,18,11,19,0,130
3,21,20,23,15,18,13,0,0,113
3,21,20,23,15,18,13,19,0,132
3,21,22,1,7,5,0,0,0,59
3,21,22,5,0,0,0,0,0,51
3,21,22,5,5,0,0,0,0,56
3,21,22,5,20,20,5,0,0,96
3,21,22,5,20,20,5,19,0,115
3,21,22,25,0,0,0,0,0,71
3,21,22,9,5,19,0,0,0,79
3,23,9,5,18,3,0,0,0,61
3,23,13,0,0,0,0,0,0,39
3,23,13,19,0,0,0,0,0,58
3,23,18,9,20,5,0,0,0,78
3,23,20,0,0,0,0,0,0,46
3,26,5,3,8,19,0,0,0,64
3,26,9,7,1,14,25,0,0,85
4,2,12,0,0,0,0,0,0,18
4,3,2,14,1,13,5,0,0,42
4,3,12,1,19,19,0,0,0,58
4,3,15,12,12,5,20,0,0,71
4,3,15,18,0,0,0,0,0,40
4,4,14,1,13,5,0,0,0,41
4,5,2,1,3,12,5,0,0,32
4,5,2,1,3,12,5,19,0,51
4,5,2,1,4,7,5,0,0,28
4,5,2,1,7,0,0,0,0,19
4,5,2,1,7,7,5,4,0,35
4,5,2,1,7,7,9,14,7,56
4,5,2,1,18,0,0,0,0,30
4,5,2,1,18,11,0,0,0,41
4,5,2,1,18,11,5,4,0,50
4,5,2,1,18,11,9,14,7,71
4,5,2,1,18,11,19,0,0,60
4,5,2,1,18,13,5,14,20,82
4,5,2,1,18,18,1,19,19,87
4,5,2,1,18,18,5,4,0,57
4,5,2,1,18,18,9,14,7,78
4,5,2,1,18,19,0,0,0,49
4,5,2,1,19,5,0,0,0,36
4,5,2,1,19,5,4,0,0,40
4,5,2,1,19,5,18,0,0,54
4,5,2,1,19,5,18,19,0,73
4,5,2,1,19,5,19,0,0,55
4,5,2,1,19,9,14,7,0,61
4,5,2,1,20,0,0,0,0,32
4,5,2,1,20,1,2,12,5,52
4,5,2,1,20,1,2,12,25,72
4,5,2,1,20,5,0,0,0,37
4,5,2,1,20,5,4,0,0,41
4,5,2,1,20,5,6,21,12,76
4,5,2,1,20,5,18,0,0,55
4,5,2,1,20,5,18,19,0,74
4,5,2,1,20,5,19,0,0,56
4,5,2,1,20,9,14,7,0,62
4,5,2,1,20,20,5,18,0,75
4,5,2,1,21,3,8,0,0,44
4,5,2,1,21,3,8,5,4,53
4,5,2,1,21,3,8,5,5,54
4,5,2,1,21,3,8,5,18,67
4,5,2,1,21,3,8,5,19,68
4,5,2,2,9,5,19,0,0,46
4,5,2,3,12,5,0,0,0,31
4,5,2,5,0,0,0,0,0,16
4,5,2,5,1,11,0,0,0,28
4,5,2,5,1,11,5,18,0,51
4,5,2,5,9,7,5,0,0,37
4,5,2,5,12,0,0,0,0,28
4,5,2,5,12,12,0,0,0,40
4,5,2,5,12,12,1,20,5,66
4,5,2,5,14,0,0,0,0,30
4,5,2,5,14,20,21,18,5,94
4,5,2,25,5,19,0,0,0,60
4,5,2,9,12,5,0,0,0,37
4,5,2,9,12,9,20,25,0,86
4,5,2,9,14,4,0,0,0,38
4,5,2,9,20,0,0,0,0,40
4,5,2,9,20,1,2,12,5,60
4,5,2,9,20,5,0,0,0,45
4,5,2,9,20,5,4,0,0,49
4,5,2,9,20,5,21,19,5,90
4,5,2,9,20,9,14,7,0,70
4,5,2,9,20,15,18,0,0,73
4,5,2,9,20,18,9,24,0,91
4,5,2,9,20,19,0,0,0,59
4,5,2,9,20,21,13,0,0,74
4,5,2,12,1,9,0,0,0,33
4,5,2,12,15,3,11,0,0,52
4,5,2,12,15,3,11,5,4,61
4,5,2,15,9,19,5,0,0,59
4,5,2,15,9,19,20,0,0,74
4,5,2,15,9,19,20,12,25,111
4,5,2,15,9,20,5,0,0,60
4,5,2,15,9,20,5,19,0,79
4,5,2,15,14,1,9,18,0,68
4,5,2,15,14,1,9,18,5,73
4,5,2,15,14,5,0,0,0,45
4,5,2,15,14,5,4,0,0,49
4,5,2,15,14,5,18,0,0,63
4,5,2,15,14,5,18,19,0,82
4,5,2,15,14,5,19,0,0,64
4,5,2,15,14,9,14,7,0,70
4,5,2,15,19,8,0,0,0,53
4,5,2,15,19,8,5,4,0,62
4,5,2,15,19,19,0,0,0,64
4,5,2,15,21,3,8,0,0,58
4,5,2,15,21,3,8,5,0,63
4,5,2,15,21,3,8,5,4,67
4,5,2,15,21,3,8,5,19,82
4,5,2,15,21,20,0,0,0,67
4,5,2,15,23,5,12,0,0,66
4,5,2,18,9,4,5,0,0,47
4,5,2,18,9,4,5,4,0,51
4,5,2,18,9,4,5,19,0,66
4,5,2,18,9,4,9,14,7,72
4,5,2,18,9,5,6,0,0,49
4,5,2,18,9,5,6,5,4,58
4,5,2,18,9,5,6,19,0,68
4,5,2,18,9,19,0,0,0,57
4,5,2,18,21,9,19,5,0,83
4,5,2,18,21,9,19,5,4,87
4,5,2,18,21,9,19,5,19,102
4,5,2,20,0,0,0,0,0,31
4,5,2,20,5,4,0,0,0,40
4,5,2,20,5,5,0,0,0,41
4,5,2,20,6,21,12,0,0,70
4,5,2,20,12,5,19,19,0,86
4,5,2,20,15,18,0,0,0,64
4,5,2,20,15,18,19,0,0,83
4,5,2,20,19,0,0,0,0,50
4,5,2,21,7,0,0,0,0,39
4,5,2,21,7,7,5,4,0,55
4,5,2,21,7,7,5,18,0,69
4,5,2,21,7,7,5,18,19,88
4,5,2,21,7,7,9,14,7,76
4,5,2,21,7,19,0,0,0,58
4,5,2,21,14,11,0,0,0,57
4,5,2,21,14,11,5,4,0,66
4,5,2,21,14,11,5,18,0,80
4,5,2,21,14,11,5,18,19,99
4,5,2,21,14,11,9,14,7,87
4,5,2,21,14,11,19,0,0,76
4,5,2,21,18,18,0,0,0,68
4,5,2,21,18,19,5,0,0,74
4,5,2,21,19,0,0,0,0,51
4,5,2,21,19,5,4,0,0,60
4,5,2,21,19,9,14,7,0,81
4,5,2,21,19,19,5,4,0,79
4,5,2,21,19,19,9,14,7,100
4,5,2,21,20,0,0,0,0,52
4,5,2,21,20,1,14,20,0,87
4,5,2,21,20,1,14,20,5,92
4,5,2,21,20,1,14,20,19,106
4,5,2,21,20,5,4,0,0,61
4,5,2,21,20,9,14,7,0,82
4,5,2,21,20,19,0,0,0,71
4,5,3,1,3,8,15,18,4,61
4,5,3,1,4,0,0,0,0,17
4,5,3,1,4,1,12,0,0,30
4,5,3,1,4,1,12,12,25,67
4,5,3,1,4,1,18,3,8,47
4,5,3,1,4,1,18,25,0,61
4,5,3,1,4,5,0,0,0,22
4,5,3,1,4,5,14,3,5,44
4,5,3,1,4,5,14,3,25,64
4,5,3,1,4,5,14,20,0,56
4,5,3,1,4,5,14,20,19,75
4,5,3,1,4,5,14,26,1,63
4,5,3,1,4,5,19,0,0,41
4,5,3,1,4,9,0,0,0,26
4,5,3,1,4,9,3,0,0,29
4,5,3,1,4,9,19,20,0,65
4,5,3,1,5,4,18,15,14,69
4,5,3,1,6,0,0,0,0,19
4,5,3,1,6,9,4,0,0,32
4,5,3,1,6,19,0,0,0,38
4,5,3,1,7,15,14,0,0,49
4,5,3,1,7,15,14,1,12,62
4,5,3,1,7,15,14,19,0,68
4,5,3,1,7,18,1,13,0,52
4,5,3,1,7,18,1,13,19,71
4,5,3,1,8,5,4,18,1,49
4,5,3,1,25,1,2,12,5,58
4,5,3,1,25,5,4,0,0,47
4,5,3,1,25,5,18,0,0,61
4,5,3,1,25,5,18,19,0,80
4,5,3,1,25,9,14,7,0,68
4,5,3,1,25,12,5,19,19,93
4,5,3,1,25,19,0,0,0,57
4,5,3,1,12,0,0,0,0,25
4,5,3,1,12,1,7,5,0,38
4,5,3,1,12,3,9,6,25,68
4,5,3,1,12,9,20,5,18,77
4,5,3,1,12,9,20,18,5,77
4,5,3,1,12,15,7,0,0,47
4,5,3,1,12,15,7,19,0,66
4,5,3,1,12,19,0,0,0,44
4,5,3,1,12,22,1,14,20,82
4,5,3,1,13,5,18,1,12,62
4,5,3,1,13,5,20,5,18,74
4,5,3,1,13,5,20,18,5,74
4,5,3,1,13,16,5,4,0,51
4,5,3,1,13,16,9,14,7,72
4,5,3,1,13,16,19,0,0,61
4,5,3,1,14,0,0,0,0,27
4,5,3,1,14,1,12,0,0,40
4,5,3,1,14,1,12,12,25,77
4,5,3,1,14,1,20,5,0,53
4,5,3,1,14,4,18,9,1,59
4,5,3,1,14,5,0,0,0,32
4,5,3,1,14,5,18,25,0,75
4,5,3,1,14,5,19,0,0,51
4,5,3,1,14,9,0,0,0,36
4,5,3,1,14,15,25,12,0,79
4,5,3,1,14,15,12,0,0,54
4,5,3,1,14,20,0,0,0,47
4,5,3,1,14,20,1,20,5,73
4,5,3,1,14,20,5,4,0,56
4,5,3,1,14,20,5,18,0,70
4,5,3,1,14,20,5,18,19,89
4,5,3,1,14,20,9,14,7,77
4,5,3,1,14,20,9,19,20,95
4,5,3,1,14,20,19,0,0,66
4,5,3,1,16,0,0,0,0,29
4,5,3,1,16,15,4,0,0,48
4,5,3,1,16,15,4,1,12,61
4,5,3,1,16,15,4,1,14,63
4,5,3,1,16,15,4,19,0,67
4,5,3,1,16,16,5,18,0,68
4,5,3,1,18,3,8,0,0,42
4,5,3,1,18,3,8,25,0,67
4,5,3,1,18,4,0,0,0,35
4,5,3,1,18,5,0,0,0,36
4,5,3,1,18,5,19,0,0,55
4,5,3,1,18,14,1,20,5,71
4,5,3,1,18,20,0,0,0,51
4,5,3,1,19,5,13,9,3,62
4,5,3,1,19,20,0,0,0,52
4,5,3,1,19,20,5,18,5,80
4,5,3,1,19,20,9,3,8,72
4,5,3,1,19,20,25,12,5,94
4,5,3,1,20,5,0,0,0,38
4,5,3,1,20,8,12,15,14,82
4,5,3,1,20,25,12,0,0,70
4,5,3,1,20,9,14,7,0,63
4,5,3,1,20,9,26,5,0,73
4,5,3,1,20,9,26,5,18,91
4,5,3,1,20,15,9,3,0,60
4,5,3,1,20,15,18,0,0,66
4,5,3,1,21,4,1,20,5,64
4,5,3,3,5,14,14,9,1,58
4,5,3,3,9,1,18,5,0,48
4,5,3,3,9,1,18,5,19,67
4,5,3,4,0,0,0,0,0,16
4,5,3,5,1,19,5,0,0,42
4,5,3,5,1,19,5,4,0,46
4,5,3,5,1,19,5,19,0,61
4,5,3,5,1,19,9,14,7,67
4,5,3,5,4,5,0,0,0,26
4,5,3,5,4,5,14,20,0,60
4,5,3,5,4,5,14,20,19,79
4,5,3,5,9,20,0,0,0,46
4,5,3,5,9,20,6,21,12,85
4,5,3,5,9,20,19,0,0,65
4,5,3,5,9,22,5,0,0,53
4,5,3,5,9,22,5,4,0,57
4,5,3,5,9,22,5,18,0,71
4,5,3,5,9,22,5,18,19,90
4,5,3,5,9,22,5,19,0,72
4,5,3,5,9,22,9,14,7,78
4,5,3,5,12,5,18,15,14,81
4,5,3,5,13,0,0,0,0,30
4,5,3,5,13,6,9,4,0,49
4,5,3,5,13,16,5,4,1,56
4,5,3,5,13,16,12,5,24,87
4,5,3,5,13,21,9,18,9,87
4,5,3,5,13,22,9,9,0,70
4,5,3,5,13,22,9,18,0,79
4,5,3,5,13,22,9,18,9,88
4,5,3,5,13,22,9,18,19,98
4,5,3,5,14,1,18,25,0,75
4,5,3,5,14,3,5,0,0,39
4,5,3,5,14,3,25,0,0,59
4,5,3,5,14,3,9,5,19,67
4,5,3,5,14,5,0,0,0,36
4,5,3,5,14,5,18,0,0,54
4,5,3,5,14,25,12,0,0,68
4,5,3,5,14,14,1,12,0,58
4,5,3,5,14,14,1,18,25,89
4,5,3,5,14,14,9,1,0,55
4,5,3,5,14,14,9,1,4,59
4,5,3,5,14,14,9,1,12,67
4,5,3,5,14,14,9,21,13,88
4,5,3,5,14,20,0,0,0,51
4,5,3,5,14,20,5,18,0,74
4,5,3,5,14,20,5,18,19,93
4,5,3,5,14,20,5,19,20,95
4,5,3,5,14,20,12,25,0,88
4,5,3,5,14,20,18,5,0,74
4,5,3,5,14,20,18,5,4,78
4,5,3,5,14,20,18,5,19,93
4,5,3,5,16,20,9,15,14,91
4,5,3,5,16,20,9,22,5,89
4,5,3,5,16,20,15,18,25,111
4,5,3,5,18,14,0,0,0,49
4,5,3,5,18,14,5,4,0,58
4,5,3,5,18,14,9,14,7,79
4,5,3,5,18,14,19,0,0,68
4,5,3,5,18,16,0,0,0,51
4,5,3,5,18,20,9,6,25,95
4,5,3,5,19,19,0,0,0,55
4,5,3,5,19,19,9,15,14,93
4,5,3,5,19,19,9,20,0,84
4,5,3,5,19,19,15,18,0,88
4,5,3,8,1,18,13,0,0,52
4,5,3,8,5,14,9,20,5,73
4,5,3,8,12,15,18,5,0,70
4,5,3,9,1,18,5,0,0,45
4,5,3,9,1,18,5,19,0,64
4,5,3,9,1,20,9,14,5,70
4,5,3,9,2,1,18,0,0,42
4,5,3,9,2,5,12,0,0,40
4,5,3,9,2,5,12,19,0,59
4,5,3,9,4,1,2,12,5,45
4,5,3,9,4,5,0,0,0,30
4,5,3,9,4,5,4,0,0,34
4,5,3,9,4,5,4,12,25,71
4,5,3,9,4,5,14,3,5,52
4,5,3,9,4,5,14,4,9,57
4,5,3,9,4,5,14,20,0,64
4,5,3,9,4,5,18,0,0,48
4,5,3,9,4,5,18,19,0,67
4,5,3,9,4,5,19,0,0,49
4,5,3,9,4,9,14,7,0,55
4,5,3,9,4,21,1,0,0,47
4,5,3,9,4,21,1,5,0,52
4,5,3,9,4,21,1,12,0,59
4,5,3,9,4,21,1,18,25,90
4,5,3,9,4,21,1,19,0,66
4,5,3,9,4,21,1,20,5,72
4,5,3,9,4,21,9,20,25,100
4,5,3,9,4,21,15,13,1,75
4,5,3,9,4,21,15,21,19,101
4,5,3,9,7,18,1,13,0,60
4,5,3,9,7,18,1,13,19,79
4,5,3,9,12,0,0,0,0,33
4,5,3,25,12,0,0,0,0,49
4,5,3,9,12,5,0,0,0,38
4,5,3,25,12,5,14,5,0,73
4,5,3,25,12,5,14,9,3,80
4,5,3,9,12,5,19,0,0,57
4,5,3,25,12,9,3,0,0,61
4,5,3,9,12,9,20,5,18,85
4,5,3,9,12,9,20,18,5,85
4,5,3,9,12,12,9,15,14,83
4,5,3,9,13,1,12,0,0,47
4,5,3,9,13,1,12,12,25,84
4,5,3,9,13,1,12,19,0,66
4,5,3,9,13,1,20,5,0,60
4,5,3,9,13,1,20,5,4,64
4,5,3,9,13,1,20,5,19,79
4,5,3,9,13,1,20,15,18,88
4,5,3,9,13,5,0,0,0,39
4,5,3,9,13,5,20,5,18,82
4,5,3,9,13,5,20,18,5,82
4,5,3,9,13,15,12,1,18,80
4,5,3,9,13,15,12,5,0,66
4,5,3,9,14,5,0,0,0,40
4,5,3,25,14,5,0,0,0,56
4,5,3,9,16,8,5,18,0,68
4,5,3,9,16,8,5,18,19,87
4,5,3,9,16,9,21,13,0,80
4,5,3,9,16,15,12,1,18,83
4,5,3,9,19,5,0,0,0,45
4,5,3,9,19,9,15,14,0,78
4,5,3,9,19,9,15,14,19,97
4,5,3,9,19,9,19,0,0,68
4,5,3,9,19,9,22,5,0,76
4,5,3,9,19,20,5,18,5,88
4,5,3,11,5,0,0,0,0,28
4,5,3,11,5,4,0,0,0,32
4,5,3,11,5,4,15,21,20,88
4,5,3,11,5,12,0,0,0,40
4,5,3,11,5,12,19,0,0,59
4,5,3,11,5,14,0,0,0,42
4,5,3,11,5,18,0,0,0,46
4,5,3,11,5,18,19,0,0,65
4,5,3,11,8,1,14,4,0,50
4,5,3,11,8,1,14,4,19,69
4,5,3,11,8,5,1,4,0,41
4,5,3,11,8,15,21,19,5,91
4,5,3,11,9,5,0,0,0,37
4,5,3,11,9,14,7,0,0,53
4,5,3,11,9,14,7,19,0,72
4,5,3,11,12,5,0,0,0,40
4,5,3,11,12,5,19,0,0,59
4,5,3,11,12,15,1,4,0,55
4,5,3,11,13,1,14,0,0,51
4,5,3,11,16,9,16,5,0,69
4,5,3,11,19,0,0,0,0,42
4,5,3,12,0,0,0,0,0,24
4,5,3,12,1,9,13,0,0,47
4,5,3,12,1,9,13,5,4,56
4,5,3,12,1,9,13,5,18,70
4,5,3,12,1,9,13,19,0,66
4,5,3,12,1,18,1,14,20,78
4,5,3,12,1,18,5,0,0,48
4,5,3,12,1,18,5,4,0,52
4,5,3,12,1,18,5,18,0,66
4,5,3,12,1,18,5,18,19,85
4,5,3,12,1,18,5,19,0,67
4,5,3,12,1,18,9,14,7,73
4,5,3,12,1,19,19,0,0,63
4,5,3,12,1,19,19,5,0,68
4,5,3,12,1,19,19,5,4,72
4,5,3,12,1,19,19,5,5,73
4,5,3,12,1,19,19,5,19,87
4,5,3,12,9,14,1,12,0,60
4,5,3,12,9,14,1,20,5,73
4,5,3,12,9,14,5,0,0,52
4,5,3,12,9,14,5,4,0,56
4,5,3,12,9,14,5,18,0,70
4,5,3,12,9,14,5,18,19,89
4,5,3,12,9,14,5,19,0,71
4,5,3,12,9,14,9,14,7,77
4,5,3,12,9,22,1,20,5,81
4,5,3,12,9,22,5,0,0,60
4,5,3,12,9,22,5,14,20,94
4,5,3,12,9,22,9,20,25,109
4,5,3,12,9,22,15,21,19,110
4,5,3,12,21,20,3,8,0,76
4,5,3,14,5,20,0,0,0,51
4,5,3,15,0,0,0,0,0,27
4,5,3,15,1,20,0,0,0,48
4,5,3,15,3,20,0,0,0,50
4,5,3,15,3,20,5,4,0,59
4,5,3,15,3,20,9,14,7,80
4,5,3,15,3,20,9,15,14,88
4,5,3,15,3,20,9,22,5,86
4,5,3,15,3,20,19,0,0,69
4,5,3,15,3,20,21,13,0,84
4,5,3,15,4,1,2,12,5,51
4,5,3,15,4,5,0,0,0,36
4,5,3,15,4,5,4,0,0,40
4,5,3,15,4,5,18,0,0,54
4,5,3,15,4,5,18,19,0,73
4,5,3,15,4,5,19,0,0,55
4,5,3,15,4,9,14,7,0,61
4,5,3,15,4,9,14,7,19,80
4,5,3,15,8,5,18,5,0,63
4,5,3,15,8,5,18,5,18,81
4,5,3,15,25,0,0,0,0,52
4,5,3,15,9,3,0,0,0,39
4,5,3,15,25,5,4,0,0,61
4,5,3,15,25,5,18,0,0,75
4,5,3,15,25,5,18,19,0,94
4,5,3,15,25,9,14,7,0,82
4,5,3,15,25,13,1,14,0,80
4,5,3,15,25,13,5,14,0,84
4,5,3,15,25,19,0,0,0,71
4,5,3,15,11,5,0,0,0,43
4,5,3,15,12,12,0,0,0,51
4,5,3,15,12,12,1,20,5,77
4,5,3,15,12,12,5,20,5,81
4,5,3,15,12,15,18,0,0,72
4,5,3,15,12,15,18,5,4,81
4,5,3,15,12,15,18,19,0,91
4,5,3,15,12,15,21,18,0,93
4,5,3,15,12,15,21,18,19,112
4,5,3,15,13,16,9,12,5,82
4,5,3,15,13,16,12,5,24,97
4,5,3,15,13,16,15,19,5,95
4,5,3,15,14,7,5,19,20,92
4,5,3,15,14,20,18,15,12,106
4,5,3,15,18,0,0,0,0,45
4,5,3,15,18,1,2,12,5,65
4,5,3,15,18,1,2,12,25,85
4,5,3,15,18,1,20,5,0,71
4,5,3,15,18,1,20,5,19,90
4,5,3,15,18,1,20,15,18,99
4,5,3,15,18,5,0,0,0,50
4,5,3,15,18,9,19,20,0,93
4,5,3,15,18,15,21,19,0,100
4,5,3,15,18,19,0,0,0,64
4,5,3,15,18,21,13,0,0,79
4,5,3,15,18,21,13,19,0,98
4,5,3,15,19,0,0,0,0,46
4,5,3,15,19,20,1,20,5,92
4,5,3,15,21,16,1,7,5,77
4,5,3,15,21,16,12,5,0,81
4,5,3,15,21,16,12,5,4,85
4,5,3,15,21,16,12,5,19,100
4,5,3,15,21,18,19,5,0,90
4,5,3,15,21,18,20,0,0,86
4,5,3,15,21,19,21,0,0,88
4,5,3,18,5,1,13,0,0,49
4,5,3,18,5,1,19,5,0,60
4,5,3,18,5,1,19,5,4,64
4,5,3,18,5,1,19,5,19,79
4,5,3,18,5,5,0,0,0,40
4,5,3,18,5,5,4,0,0,44
4,5,3,18,5,5,9,14,7,70
4,5,3,18,5,5,18,0,0,58
4,5,3,18,5,5,18,19,0,77
4,5,3,18,5,5,19,0,0,59
4,5,3,18,5,5,20,0,0,60
4,5,3,18,5,9,14,7,0,65
4,5,3,18,5,13,5,14,20,87
4,5,3,18,5,16,9,4,0,64
4,5,3,18,5,16,9,20,0,80
4,5,3,18,5,16,9,20,25,105
4,5,3,18,5,19,3,0,0,57
4,5,3,18,5,20,1,12,0,68
4,5,3,18,5,20,5,0,0,60
4,5,3,18,5,20,9,15,14,93
4,5,3,18,5,20,9,19,20,103
4,5,3,18,5,20,9,22,5,91
4,5,3,18,5,20,15,18,25,113
4,5,3,18,5,20,21,13,0,89
4,5,3,18,5,23,0,0,0,58
4,5,3,18,25,0,0,0,0,55
4,5,3,18,9,1,12,0,0,52
4,5,3,18,9,1,12,19,0,71
4,5,3,18,9,5,4,0,0,48
4,5,3,18,9,5,18,0,0,62
4,5,3,18,9,5,18,19,0,81
4,5,3,18,9,5,19,0,0,63
4,5,3,18,25,9,14,7,0,85
4,5,3,18,25,16,20,0,0,91
4,5,3,18,25,16,20,5,4,100
4,5,3,18,25,16,20,19,0,110
4,5,3,18,15,23,14,0,0,82
4,5,3,18,15,23,14,5,4,91
4,5,3,18,15,23,14,19,0,101
4,5,3,21,2,9,20,1,12,77
4,5,3,21,2,9,20,9,0,73
4,5,3,21,2,9,20,21,19,104
4,5,3,21,13,1,14,0,0,61
4,5,3,21,13,1,14,1,0,62
4,5,3,21,13,1,14,9,0,70
4,5,3,21,13,1,14,21,19,101
4,5,3,21,13,1,18,25,0,90
4,5,3,21,13,2,5,14,20,87
4,5,3,21,16,12,5,0,0,66
4,5,3,21,16,12,5,4,0,70
4,5,3,21,16,12,5,19,0,85
4,5,3,21,16,12,5,20,0,86
4,5,3,21,16,12,9,14,7,91
4,5,3,21,18,25,0,0,0,76
4,5,3,21,18,9,1,0,0,61
4,5,3,21,18,9,5,19,0,84
4,5,3,21,18,9,15,14,0,89
4,5,3,21,18,9,15,14,19,108
4,5,3,21,18,18,5,14,20,108
4,5,3,21,18,18,9,14,7,99
4,5,3,21,18,19,9,15,14,108
4,5,3,21,18,19,9,22,5,106
4,5,3,21,18,20,0,0,0,71
4,5,3,21,18,20,1,20,5,97
4,5,3,21,18,22,5,0,0,78
4,5,3,21,18,22,5,4,0,82
4,5,3,21,18,22,5,19,0,97
4,5,3,21,18,22,9,14,7,103
4,5,3,21,19,19,0,0,0,71
4,5,3,21,19,19,1,20,5,97
4,5,3,21,19,19,9,15,14,109
4,5,3,21,19,19,9,19,0,99
4,5,3,23,18,9,20,5,18,105
4,5,4,1,0,0,0,0,0,14
4,5,4,1,12,0,0,0,0,26
4,5,4,1,14,19,0,0,0,47
4,5,4,4,0,0,0,0,0,17
4,5,4,4,25,0,0,0,0,42
4,5,4,5,14,4,1,0,0,37
4,5,4,5,14,4,21,13,0,70
4,5,4,9,3,1,14,20,0,60
4,5,4,9,3,1,20,5,0,51
4,5,4,9,3,1,20,5,4,55
4,5,4,9,3,1,20,5,5,56
4,5,4,9,3,1,20,5,19,70
4,5,4,9,3,1,20,15,18,79
4,5,4,9,13,21,19,0,0,75
4,5,4,9,20,0,0,0,0,42
4,5,4,9,20,9,15,14,0,80
4,5,4,15,0,0,0,0,0,28
4,5,4,15,12,5,14,3,5,67
4,5,4,15,12,5,14,3,25,87
4,5,4,15,12,5,14,20,0,79
4,5,4,21,3,5,0,0,0,42
4,5,4,21,3,5,4,0,0,46
4,5,4,21,3,5,18,0,0,60
4,5,4,21,3,5,19,0,0,61
4,5,4,21,3,9,2,12,5,65
4,5,4,21,3,9,2,12,25,85
4,5,4,21,3,9,14,7,0,67
4,5,4,21,3,9,22,5,0,73
4,5,4,21,3,20,0,0,0,57
4,5,4,21,3,20,5,4,0,66
4,5,4,21,3,20,9,12,5,83
4,5,4,21,3,20,9,14,7,87
4,5,4,21,3,20,9,15,0,81
4,5,4,21,3,20,9,15,14,95
4,5,4,21,3,20,9,22,5,93
4,5,4,21,3,20,15,18,25,115
4,5,4,21,3,20,19,0,0,76
4,5,4,21,9,20,0,0,0,63
4,5,5,3,15,4,4,5,18,63
4,5,5,4,0,0,0,0,0,18
4,5,5,4,2,15,20,5,0,60
4,5,5,4,2,15,24,0,0,59
4,5,5,4,5,4,0,0,0,27
4,5,5,4,5,5,4,0,0,32
4,5,5,4,6,21,12,0,0,57
4,5,5,4,6,21,12,12,25,94
4,5,5,4,25,0,0,0,0,43
4,5,5,4,9,5,18,0,0,50
4,5,5,4,9,5,19,20,0,71
4,5,5,4,9,12,25,0,0,64
4,5,5,4,9,14,5,19,19,84
4,5,5,4,9,14,7,0,0,48
4,5,5,4,12,5,19,19,0,73
4,5,5,4,19,0,0,0,0,37
4,5,5,10,1,25,0,0,0,50
4,5,5,10,1,25,19,0,0,69
4,5,5,11,0,0,0,0,0,25
4,5,5,13,0,0,0,0,0,27
4,5,5,13,5,4,0,0,0,36
4,5,5,13,5,18,0,0,0,50
4,5,5,13,9,5,0,0,0,41
4,5,5,13,9,14,7,0,0,57
4,5,5,13,19,20,5,18,0,89
4,5,5,13,19,20,5,18,19,108
4,5,5,14,5,18,0,0,0,51
4,5,5,14,25,0,0,0,0,53
4,5,5,16,0,0,0,0,0,30
4,5,5,16,5,14,0,0,0,49
4,5,5,16,5,14,5,4,0,58
4,5,5,16,5,14,5,18,0,72
4,5,5,16,5,14,5,18,19,91
4,5,5,16,5,14,9,14,7,79
4,5,5,16,5,14,19,0,0,68
4,5,5,16,5,18,0,0,0,53
4,5,5,16,5,19,20,0,0,74
4,5,5,16,6,18,15,26,5,100
4,5,5,16,7,15,9,14,7,82
4,5,5,16,9,19,8,0,0,66
4,5,5,16,12,25,0,0,0,67
4,5,5,16,12,9,5,18,0,74
4,5,5,16,13,15,19,20,0,97
4,5,5,16,14,5,19,19,0,87
4,5,5,16,19,0,0,0,0,49
4,5,5,16,19,15,13,5,0,82
4,5,5,18,2,5,18,18,25,100
4,5,5,18,4,15,7,0,0,58
4,5,5,18,4,18,9,22,5,90
4,5,5,18,6,12,25,0,0,75
4,5,5,18,6,12,9,5,19,83
4,5,5,18,6,12,25,19,0,94
4,5,5,18,6,15,15,4,0,72
4,5,5,18,7,18,1,19,19,96
4,5,5,18,8,1,9,18,0,68
4,5,5,18,8,5,18,4,0,67
4,5,5,18,8,15,18,14,0,87
4,5,5,18,8,15,21,14,4,94
4,5,5,18,25,1,18,4,0,80
4,5,5,18,25,1,18,4,19,99
4,5,5,18,11,9,12,12,0,76
4,5,5,18,12,5,20,0,0,69
4,5,5,18,12,9,11,5,0,69
4,5,5,18,13,5,1,20,0,71
4,5,5,18,19,0,0,0,0,51
4,5,5,18,19,11,9,14,0,85
4,5,5,18,19,11,9,14,19,104
4,5,5,18,19,20,1,14,4,90
4,5,5,18,22,5,20,3,8,90
4,5,5,18,23,5,5,4,0,69
4,5,5,18,23,5,5,4,19,88
4,5,5,19,0,0,0,0,0,33
4,5,5,19,5,19,0,0,0,57
4,5,5,19,9,19,0,0,0,61
4,5,5,19,19,0,0,0,0,52
4,5,5,20,0,0,0,0,0,34
4,5,5,20,19,0,0,0,0,53
4,5,5,22,5,25,0,0,0,66
4,5,5,22,9,12,9,3,11,80
4,5,5,23,1,14,0,0,0,52
4,5,5,23,1,14,19,0,0,71
4,5,6,0,0,0,0,0,0,15
4,5,6,1,3,5,0,0,0,24
4,5,6,1,3,5,4,0,0,28
4,5,6,1,3,5,18,0,0,42
4,5,6,1,3,5,18,19,0,61
4,5,6,1,3,5,19,0,0,43
4,5,6,1,3,9,14,7,0,49
4,5,6,1,3,20,15,0,0,54
4,5,6,1,4,5,0,0,0,25
4,5,6,1,5,3,1,20,5,50
4,5,6,1,9,12,0,0,0,37
4,5,6,1,12,3,1,20,5,57
4,5,6,1,12,11,0,0,0,39
4,5,6,1,13,5,0,0,0,34
4,5,6,1,13,5,4,0,0,38
4,5,6,1,13,5,18,0,0,52
4,5,6,1,13,5,18,19,0,71
4,5,6,1,13,5,19,0,0,53
4,5,6,1,13,25,0,0,0,54
4,5,6,1,13,9,14,7,0,59
4,5,6,1,13,15,21,19,0,84
4,5,6,1,14,7,0,0,0,37
4,5,6,1,14,7,5,4,0,46
4,5,6,1,14,7,19,0,0,56
4,5,6,1,19,19,1,0,0,55
4,5,6,1,20,0,0,0,0,36
4,5,6,1,20,19,0,0,0,55
4,5,6,1,20,20,5,4,0,65
4,5,6,1,20,20,9,14,7,86
4,5,6,1,21,12,20,0,0,69
4,5,6,1,21,12,20,5,4,78
4,5,6,1,21,12,20,5,18,92
4,5,6,1,21,12,20,19,0,88
4,5,6,5,1,19,5,0,0,45
4,5,6,5,1,19,9,22,5,76
4,5,6,5,1,20,0,0,0,41
4,5,6,5,1,20,5,4,0,50
4,5,6,5,1,20,5,5,0,51
4,5,6,5,1,20,5,18,0,64
4,5,6,5,1,20,5,18,19,83
4,5,6,5,1,20,9,14,7,71
4,5,6,5,1,20,9,19,13,82
4,5,6,5,1,20,9,19,20,89
4,5,6,5,1,20,19,0,0,60
4,5,6,5,1,20,21,18,5,85
4,5,6,5,3,1,14,20,0,58
4,5,6,5,3,1,20,5,0,49
4,5,6,5,3,1,20,5,4,53
4,5,6,5,3,1,20,5,19,68
4,5,6,5,3,1,20,15,18,77
4,5,6,5,3,20,0,0,0,43
4,5,6,5,3,20,5,4,0,52
4,5,6,5,3,20,5,18,0,66
4,5,6,5,3,20,5,18,19,85
4,5,6,5,3,20,9,14,7,73
4,5,6,5,3,20,9,15,14,81
4,5,6,5,3,20,9,22,5,79
4,5,6,5,3,20,15,18,0,76
4,5,6,5,3,20,15,18,19,95
4,5,6,5,3,20,19,0,0,62
4,5,6,5,3,20,21,13,0,77
4,5,6,5,9,19,5,0,0,53
4,5,6,5,9,20,0,0,0,49
4,5,6,5,14,3,5,0,0,42
4,5,6,5,14,3,5,19,0,61
4,5,6,5,14,3,9,22,5,73
4,5,6,5,14,4,0,0,0,38
4,5,6,5,14,4,1,14,20,73
4,5,6,5,14,4,5,4,0,47
4,5,6,5,14,4,5,18,0,61
4,5,6,5,14,4,5,18,19,80
4,5,6,5,14,4,9,14,7,68
4,5,6,5,14,4,19,0,0,57
4,5,6,5,14,19,5,0,0,58
4,5,6,5,14,19,5,4,0,62
4,5,6,5,14,19,5,18,0,76
4,5,6,5,14,19,5,19,0,77
4,5,6,5,14,19,9,14,7,83
4,5,6,5,14,19,9,15,14,91
4,5,6,5,14,19,9,22,5,89
4,5,6,5,14,19,15,18,0,86
4,5,6,5,14,19,15,18,25,111
4,5,6,5,18,0,0,0,0,38
4,5,6,5,18,1,2,12,5,58
4,5,6,5,18,5,14,3,5,65
4,5,6,5,18,5,14,19,0,76
4,5,6,5,18,5,14,20,0,77
4,5,6,5,18,5,14,20,19,96
4,5,6,5,18,13,5,14,20,90
4,5,6,5,18,18,1,12,0,69
4,5,6,5,18,18,1,12,19,88
4,5,6,5,18,18,5,4,0,65
4,5,6,5,18,18,5,18,0,79
4,5,6,5,18,18,5,18,19,98
4,5,6,5,18,18,9,14,7,86
4,5,6,5,18,18,9,26,5,96
4,5,6,5,18,19,0,0,0,57
4,5,6,5,20,0,0,0,0,40
4,5,6,9,0,0,0,0,0,24
4,5,6,25,0,0,0,0,0,40
4,5,6,9,1,2,12,5,0,44
4,5,6,9,1,12,0,0,0,37
4,5,6,9,1,14,3,5,19,66
4,5,6,9,1,14,20,0,0,59
4,5,6,9,1,14,20,12,25,96
4,5,6,9,1,20,15,18,25,103
4,5,6,9,2,5,18,0,0,49
4,5,6,9,3,9,5,14,20,75
4,5,6,9,3,9,20,0,0,56
4,5,6,9,3,9,20,19,0,75
4,5,6,9,5,4,0,0,0,33
4,5,6,9,5,18,0,0,0,47
4,5,6,9,5,18,19,0,0,66
4,5,6,9,5,19,0,0,0,48
4,5,6,9,7,21,18,5,0,75
4,5,6,25,9,14,7,0,0,70
4,5,6,25,9,14,7,12,25,107
4,5,6,9,12,1,2,12,5,56
4,5,6,9,12,1,4,5,0,46
4,5,6,9,12,1,4,5,4,50
4,5,6,9,12,1,4,5,19,65
4,5,6,9,12,5,0,0,0,41
4,5,6,9,12,5,4,0,0,45
4,5,6,9,12,5,18,0,0,59
4,5,6,9,12,5,18,19,0,78
4,5,6,9,12,5,19,0,0,60
4,5,6,9,12,9,14,7,0,66
4,5,6,9,14,1,2,12,5,58
4,5,6,9,14,1,2,12,25,78
4,5,6,9,14,5,0,0,0,43
4,5,6,9,14,5,4,0,0,47
4,5,6,9,14,5,4,12,25,84
4,5,6,9,14,5,18,0,0,61
4,5,6,9,14,5,18,19,0,80
4,5,6,9,14,5,19,0,0,62
4,5,6,9,14,9,5,14,19,85
4,5,6,9,14,9,14,7,0,68
4,5,6,9,14,9,19,8,0,74
4,5,6,9,14,9,20,5,0,72
4,5,6,9,14,9,20,15,18,100
4,5,6,9,19,0,0,0,0,43
4,5,6,9,24,0,0,0,0,48
4,5,6,12,1,20,5,0,0,53
4,5,6,12,1,20,5,4,0,57
4,5,6,12,1,20,5,18,0,71
4,5,6,12,1,20,5,19,0,72
4,5,6,12,1,20,9,14,7,78
4,5,6,12,1,20,9,15,14,86
4,5,6,12,1,20,15,18,0,81
4,5,6,12,1,20,15,18,19,100
4,5,6,12,5,1,0,0,0,33
4,5,6,12,5,1,5,4,0,42
4,5,6,12,5,1,9,14,7,63
4,5,6,12,5,1,19,0,0,52
4,5,6,12,5,3,20,0,0,55
4,5,6,12,5,3,20,5,4,64
4,5,6,12,5,3,20,15,18,88
4,5,6,12,5,3,20,19,0,74
4,5,6,12,5,19,8,0,0,59
4,5,6,12,5,24,0,0,0,56
4,5,6,12,5,24,5,4,0,65
4,5,6,12,5,24,9,14,7,86
4,5,6,12,5,24,9,15,14,94
4,5,6,12,5,24,21,18,5,100
4,5,6,12,15,18,1,20,5,86
4,5,6,12,15,18,5,0,0,65
4,5,6,12,15,23,0,0,0,65
4,5,6,12,15,23,5,18,0,88
4,5,6,12,15,23,5,18,19,107
4,5,6,12,21,5,14,20,0,87
4,5,6,12,21,15,21,19,0,103
4,5,6,12,21,22,9,21,13,113
4,5,6,12,21,24,0,0,0,72
4,5,6,12,21,24,9,15,14,110
4,5,6,15,1,13,0,0,0,44
4,5,6,15,1,13,5,4,0,53
4,5,6,15,1,13,5,18,0,67
4,5,6,15,1,13,5,18,19,86
4,5,6,15,1,13,9,14,7,74
4,5,6,15,1,13,19,0,0,63
4,5,6,15,3,21,19,0,0,73
4,5,6,15,7,0,0,0,0,37
4,5,6,15,7,7,5,4,0,53
4,5,6,15,7,7,5,18,0,67
4,5,6,15,7,7,5,18,19,86
4,5,6,15,7,7,9,14,7,74
4,5,6,15,7,19,0,0,0,56
4,5,6,15,9,12,0,0,0,51
4,5,6,15,12,9,1,7,5,64
4,5,6,15,12,9,1,14,20,86
4,5,6,15,12,9,1,20,5,77
4,5,6,15,18,3,5,0,0,56
4,5,6,15,18,3,5,4,0,60
4,5,6,15,18,3,5,15,18,89
4,5,6,15,18,3,5,18,0,74
4,5,6,15,18,3,5,19,0,75
4,5,6,15,18,3,9,14,7,81
4,5,6,15,18,5,19,20,19,111
4,5,6,15,18,13,0,0,0,61
4,5,6,15,18,13,5,4,0,70
4,5,6,15,18,13,5,18,0,84
4,5,6,15,18,13,5,18,19,103
4,5,6,15,18,13,9,14,7,91
4,5,6,15,18,13,9,19,13,102
4,5,6,15,18,13,9,20,25,115
4,5,6,15,18,13,19,0,0,80
4,5,6,15,18,19,5,0,0,72
4,5,6,15,18,20,9,6,25,108
4,5,6,15,19,19,9,15,14,106
4,5,6,15,21,12,0,0,0,63
4,5,6,18,1,25,0,0,0,59
4,5,6,18,1,25,1,12,0,72
4,5,6,18,1,25,1,12,19,91
4,5,6,18,1,25,5,4,0,68
4,5,6,18,1,25,5,18,0,82
4,5,6,18,1,25,5,18,19,101
4,5,6,18,1,25,9,14,7,89
4,5,6,18,1,25,19,0,0,78
4,5,6,18,1,21,4,0,0,59
4,5,6,18,1,21,4,5,4,68
4,5,6,18,1,21,4,5,18,82
4,5,6,18,1,21,4,19,0,78
4,5,6,18,5,5,26,5,0,74
4,5,6,18,15,3,11,0,0,62
4,5,6,18,15,3,11,5,4,71
4,5,6,18,15,3,11,19,0,81
4,5,6,18,15,19,20,0,0,87
4,5,6,18,15,19,20,5,4,96
4,5,6,18,15,19,20,5,18,110
4,5,6,18,15,19,20,19,0,106
4,5,6,19,0,0,0,0,0,34
4,5,6,20,0,0,0,0,0,35
4,5,6,20,5,18,0,0,0,58
4,5,6,20,5,18,4,1,18,81
4,5,6,20,5,19,20,0,0,79
4,5,6,20,12,25,0,0,0,72
4,5,6,20,14,5,19,19,0,92
4,5,6,21,14,3,20,0,0,73
4,5,6,21,19,5,0,0,0,60
4,5,6,21,19,5,4,0,0,64
4,5,6,21,19,5,19,0,0,79
4,5,6,21,19,9,14,7,0,85
4,5,6,21,19,9,15,14,0,93
4,5,6,21,26,5,0,0,0,67
4,5,6,21,26,5,4,0,0,71
4,5,6,21,26,5,19,0,0,86
4,5,6,21,26,9,14,7,0,92
4,5,7,0,0,0,0,0,0,16
4,5,7,1,7,5,0,0,0,29
4,5,7,1,13,5,0,0,0,35
4,5,7,1,13,5,19,0,0,54
4,5,7,1,13,9,0,0,0,39
4,5,7,1,13,9,19,0,0,58
4,5,7,1,18,14,9,19,8,85
4,5,7,1,19,5,19,0,0,60
4,5,7,1,19,9,6,25,0,76
4,5,7,1,19,19,0,0,0,55
4,5,7,1,19,19,5,4,0,64
4,5,7,1,19,19,5,18,0,78
4,5,7,1,19,19,5,18,19,97
4,5,7,1,19,19,5,19,0,79
4,5,7,1,19,19,9,14,7,85
4,5,7,1,21,19,19,0,0,76
4,5,7,1,21,19,19,5,4,85
4,5,7,1,21,19,19,5,18,99
4,5,7,1,21,19,19,5,19,100
4,5,7,5,14,4,5,18,0,62
4,5,7,5,14,5,18,0,0,58
4,5,7,5,18,13,0,0,0,52
4,5,7,5,18,13,5,4,0,61
4,5,7,5,18,13,9,14,7,82
4,5,7,5,18,13,19,0,0,71
4,5,7,7,5,4,0,0,0,32
4,5,7,7,5,18,0,0,0,46
4,5,7,7,9,14,7,0,0,53
4,5,7,12,1,26,5,0,0,60
4,5,7,12,1,26,5,4,0,64
4,5,7,12,1,26,5,19,0,79
4,5,7,12,1,26,9,14,7,85
4,5,7,12,15,18,25,0,0,86
4,5,7,12,21,20,0,0,0,69
4,5,7,12,21,20,5,0,0,74
4,5,7,15,12,4,0,0,0,47
4,5,7,15,13,13,5,0,0,62
4,5,7,15,18,4,5,18,0,76
4,5,7,15,18,7,5,0,0,61
4,5,7,18,1,4,1,14,4,58
4,5,7,18,1,4,5,0,0,44
4,5,7,18,1,4,5,4,0,48
4,5,7,18,1,4,5,18,0,62
4,5,7,18,1,4,5,18,19,81
4,5,7,18,1,4,5,19,0,63
4,5,7,18,1,4,9,14,7,69
4,5,7,18,1,9,14,0,0,58
4,5,7,18,1,19,0,0,0,54
4,5,7,18,1,20,9,1,0,65
4,5,7,18,1,22,1,20,5,83
4,5,7,18,5,1,19,5,0,64
4,5,7,18,5,1,19,5,4,68
4,5,7,18,5,1,19,5,18,82
4,5,7,18,5,1,19,5,19,83
4,5,7,18,5,5,0,0,0,44
4,5,7,18,5,5,4,0,0,48
4,5,7,18,5,5,9,14,7,74
4,5,7,18,5,5,19,0,0,63
4,5,7,21,0,0,0,0,0,37
4,5,7,21,5,12,9,14,0,77
4,5,7,21,13,0,0,0,0,50
4,5,7,21,13,13,5,4,0,72
4,5,7,21,13,13,5,18,0,86
4,5,7,21,13,13,9,14,7,93
4,5,7,21,13,19,0,0,0,69
4,5,7,21,19,20,0,0,0,76
4,5,7,21,19,20,1,20,5,102
4,5,7,21,19,20,5,4,0,85
4,5,7,21,19,20,9,14,7,106
4,5,7,21,19,20,19,0,0,95
4,5,8,1,3,8,5,0,0,34
4,5,8,1,9,18,0,0,0,45
4,5,8,1,9,18,5,18,0,68
4,5,8,25,4,18,1,14,20,99
4,5,8,25,4,18,1,19,5,89
4,5,8,25,4,18,1,20,5,90
4,5,8,9,19,3,5,0,0,53
4,5,8,9,19,3,5,4,0,57
4,5,8,9,19,3,5,14,20,87
4,5,8,9,19,3,5,19,0,72
4,5,8,9,19,3,9,14,7,78
4,5,8,14,19,20,21,6,5,102
4,5,8,15,18,14,0,0,0,64
4,5,8,15,18,14,5,4,0,73
4,5,8,15,18,14,5,18,0,87
4,5,8,15,18,14,5,18,19,106
4,5,8,15,18,14,9,14,7,94
4,5,8,15,18,14,19,0,0,83
4,5,8,15,18,19,0,0,0,69
4,5,8,15,18,20,0,0,0,70
4,5,8,15,18,20,5,4,0,79
4,5,8,15,18,20,5,18,0,93
4,5,8,15,18,20,9,14,7,100
4,5,8,15,18,20,19,0,0,89
4,5,8,21,12,12,0,0,0,62
4,5,8,21,19,11,0,0,0,68
4,5,9,1,0,0,0,0,0,19
4,5,9,3,1,20,5,0,0,47
4,5,9,3,5,0,0,0,0,26
4,5,9,3,5,4,0,0,0,30
4,5,9,3,5,18,0,0,0,44
4,5,9,3,5,18,19,0,0,63
4,5,9,3,5,19,0,0,0,45
4,5,9,3,9,4,1,12,0,47
4,5,9,3,9,4,5,0,0,39
4,5,9,3,9,4,5,19,0,58
4,5,9,3,9,14,7,0,0,51
4,5,9,3,20,9,3,0,0,53
4,5,9,3,20,9,3,1,12,66
4,5,9,6,25,0,0,0,0,49
4,5,9,6,9,3,0,0,0,36
4,5,9,6,9,3,1,12,0,49
4,5,9,6,9,5,4,0,0,42
4,5,9,6,9,5,18,0,0,56
4,5,9,6,9,5,18,19,0,75
4,5,9,6,9,5,19,0,0,57
4,5,9,6,25,9,14,7,0,79
4,5,9,6,15,18,13,0,0,70
4,5,9,7,14,0,0,0,0,39
4,5,9,7,14,5,4,0,0,48
4,5,9,7,14,9,14,7,0,69
4,5,9,7,14,15,21,19,0,94
4,5,9,7,14,19,0,0,0,58
4,5,25,8,15,21,19,5,0,102
4,5,9,12,0,0,0,0,0,30
4,5,9,12,19,0,0,0,0,49
4,5,9,14,11,0,0,0,0,43
4,5,9,14,15,19,0,0,0,66
4,5,9,14,15,19,1,21,18,106
4,5,25,14,20,0,0,0,0,68
4,5,9,15,14,9,26,5,0,87
4,5,9,15,14,9,26,5,4,91
4,5,9,15,14,9,26,5,18,105
4,5,9,15,14,9,26,5,19,106
4,5,9,16,1,18,15,21,19,108
4,5,9,16,15,20,5,14,20,108
4,5,9,18,9,4,0,0,0,49
4,5,9,19,0,0,0,0,0,37
4,5,25,19,0,0,0,0,0,53
4,5,9,19,5,1,12,0,0,55
4,5,25,19,8,9,16,0,0,86
4,5,9,19,9,14,0,0,0,60
4,5,9,19,13,0,0,0,0,50
4,5,9,19,13,19,0,0,0,69
4,5,9,19,20,0,0,0,0,57
4,5,9,19,20,9,3,0,0,69
4,5,9,19,20,9,3,1,12,82
4,5,9,19,20,19,0,0,0,76
4,5,9,20,1,20,5,0,0,64
4,5,9,20,9,5,19,0,0,71
4,5,9,20,25,19,8,9,16,115
4,5,25,23,15,13,1,14,0,100
4,5,9,24,9,19,0,0,0,70
4,5,10,1,0,0,0,0,0,20
4,5,10,5,3,20,0,0,0,47
4,5,10,5,3,20,1,0,0,48
4,5,10,5,3,20,5,4,0,56
4,5,10,5,3,20,9,12,5,73
4,5,10,5,3,20,9,14,7,77
4,5,10,5,3,20,9,15,14,85
4,5,10,5,3,20,12,25,0,84
4,5,10,5,3,20,15,18,25,105
4,5,10,5,3,20,19,0,0,66
4,5,10,5,3,20,21,18,5,91
4,5,10,5,18,1,20,5,0,68
4,5,10,5,18,1,20,15,18,96
4,5,10,5,21,14,5,0,0,64
4,5,10,5,21,14,5,18,0,82
4,5,10,5,21,14,5,18,19,101
4,5,11,1,7,18,1,13,0,60
4,5,11,1,7,18,1,13,19,79
4,5,11,1,12,9,20,5,18,85
4,5,11,1,12,9,20,18,5,85
4,5,11,1,13,5,20,5,18,82
4,5,11,1,13,5,20,18,5,82
4,5,11,1,16,15,4,5,0,61
4,5,11,1,18,3,8,0,0,50
4,5,11,1,18,5,0,0,0,44
4,5,11,1,18,5,19,0,0,63
4,5,11,1,19,20,5,18,5,88
4,5,11,5,0,0,0,0,0,25
4,5,11,5,4,0,0,0,0,29
4,5,11,5,19,0,0,0,0,44
4,5,11,9,14,7,0,0,0,50
4,5,11,11,15,0,0,0,0,46
4,5,11,11,15,19,0,0,0,65
4,5,11,12,5,0,0,0,0,37
4,5,11,14,9,7,8,20,0,78
4,5,12,1,3,5,0,0,0,30
4,5,12,1,25,0,0,0,0,47
4,5,12,1,25,1,2,12,5,67
4,5,12,1,25,1,7,5,0,60
4,5,12,1,25,5,4,0,0,56
4,5,12,1,25,5,18,0,0,70
4,5,12,1,25,5,18,19,0,89
4,5,12,1,25,6,21,12,0,86
4,5,12,1,25,9,14,7,0,77
4,5,12,1,9,14,5,19,0,69
4,5,12,1,25,19,0,0,0,66
4,5,12,1,16,19,5,0,0,62
4,5,12,1,16,19,9,15,14,95
4,5,12,1,20,5,0,0,0,47
4,5,12,1,20,5,4,0,0,51
4,5,12,1,20,5,18,0,0,65
4,5,12,1,20,5,19,0,0,66
4,5,12,1,20,9,14,7,0,72
4,5,12,1,20,9,15,14,0,80
4,5,12,1,20,9,15,14,19,99
4,5,12,1,20,9,22,5,0,78
4,5,12,1,20,15,18,0,0,75
4,5,12,1,20,15,18,19,0,94
4,5,12,1,23,0,0,0,0,45
4,5,12,1,23,14,0,0,0,59
4,5,12,5,0,0,0,0,0,26
4,5,12,5,1,4,0,0,0,31
4,5,12,5,1,4,5,4,0,40
4,5,12,5,1,4,9,14,7,61
4,5,12,5,1,4,19,0,0,50
4,5,12,5,1,20,21,18,0,86
4,5,12,5,1,22,5,0,0,54
4,5,12,5,1,22,5,4,0,58
4,5,12,5,1,22,5,19,0,73
4,5,12,5,2,12,5,0,0,45
4,5,12,5,3,20,1,20,5,75
4,5,12,5,3,20,21,19,0,89
4,5,12,5,4,0,0,0,0,30
4,5,12,5,5,18,9,20,0,78
4,5,12,5,7,1,2,12,5,53
4,5,12,5,7,1,3,25,0,62
4,5,12,5,7,1,14,20,0,68
4,5,12,5,7,1,18,5,0,57
4,5,12,5,7,1,20,5,0,59
4,5,12,5,7,1,20,5,4,63
4,5,12,5,7,1,20,5,5,64
4,5,12,5,7,1,20,5,19,78
4,5,12,5,7,1,20,9,0,63
4,5,12,5,7,1,20,15,18,87
4,5,12,5,7,1,20,21,19,94
4,5,12,5,9,14,7,0,0,56
4,5,12,5,14,4,1,0,0,45
4,5,12,5,14,9,1,20,5,75
4,5,12,5,19,0,0,0,0,45
4,5,12,5,20,5,0,0,0,51
4,5,12,5,20,5,4,0,0,55
4,5,12,5,20,5,18,0,0,69
4,5,12,5,20,5,18,25,0,94
4,5,12,5,20,5,19,0,0,70
4,5,12,5,20,9,14,7,0,76
4,5,12,5,20,9,15,14,0,84
4,5,12,5,20,9,15,14,19,103
4,5,12,5,20,9,22,5,0,82
4,5,12,5,20,15,18,25,0,104
4,5,12,6,0,0,0,0,0,27
4,5,12,6,19,0,0,0,0,46
4,5,12,6,20,19,0,0,0,66
4,5,12,6,20,23,1,18,5,94
4,5,12,9,0,0,0,0,0,30
4,5,12,25,0,0,0,0,0,46
4,5,12,9,2,1,20,5,0,58
4,5,12,9,2,5,18,0,0,55
4,5,12,9,2,12,5,0,0,49
4,5,12,9,3,1,3,25,0,62
4,5,12,9,3,1,20,0,0,54
4,5,12,9,3,1,20,5,0,59
4,5,12,9,3,1,20,5,19,78
4,5,12,9,3,5,0,0,0,38
4,5,12,9,3,5,14,19,5,76
4,5,12,9,3,9,1,5,0,48
4,5,12,9,3,9,1,20,5,68
4,5,12,9,3,9,15,19,15,91
4,5,12,9,3,20,0,0,0,53
4,5,12,9,3,20,9,0,0,62
4,5,12,9,3,20,15,0,0,68
4,5,12,9,3,20,19,0,0,72
4,5,12,9,3,20,21,1,12,87
4,5,12,9,3,20,21,13,0,87
4,5,12,9,3,20,21,19,0,93
4,5,12,9,5,18,5,20,0,78
4,5,12,9,5,19,0,0,0,54
4,5,12,9,7,1,20,5,4,67
4,5,12,9,7,8,20,5,4,74
4,5,12,9,7,8,20,5,18,88
4,5,12,9,7,8,20,19,0,84
4,5,12,9,7,14,1,20,5,77
4,5,12,9,12,9,18,9,1,79
4,5,12,9,13,0,0,0,0,43
4,5,12,9,13,5,0,0,0,48
4,5,12,9,13,5,4,0,0,52
4,5,12,9,13,5,18,0,0,66
4,5,12,9,13,5,19,0,0,67
4,5,12,9,13,9,14,7,0,73
4,5,12,9,13,9,20,0,0,72
4,5,12,9,13,9,20,5,4,81
4,5,12,9,13,9,20,5,18,95
4,5,12,9,13,9,20,19,0,91
4,5,12,9,14,5,0,0,0,49
4,5,12,9,14,5,1,20,5,75
4,5,12,9,14,20,0,0,0,64
4,5,12,9,14,20,5,18,0,87
4,5,12,9,17,21,1,20,5,94
4,5,12,9,17,21,9,21,13,111
4,5,12,9,18,1,3,25,0,77
4,5,12,9,18,1,14,20,0,83
4,5,12,9,18,1,20,5,0,74
4,5,12,9,18,5,0,0,0,53
4,5,12,9,18,9,1,0,0,58
4,5,12,9,18,9,1,14,20,92
4,5,12,9,18,9,1,20,5,83
4,5,12,9,18,9,15,21,19,112
4,5,12,9,18,9,21,13,0,91
4,5,12,9,18,9,21,13,19,110
4,5,12,9,18,15,21,19,0,103
4,5,12,9,19,0,0,0,0,49
4,5,12,9,19,11,0,0,0,60
4,5,12,9,19,20,0,0,0,69
4,5,12,9,19,20,5,4,0,78
4,5,12,9,19,20,9,14,7,99
4,5,12,9,19,20,19,0,0,88
4,5,12,9,20,0,0,0,0,50
4,5,12,9,20,15,21,19,0,105
4,5,12,9,22,5,18,0,0,75
4,5,12,9,22,5,18,5,4,84
4,5,12,9,22,5,18,5,18,98
4,5,12,9,22,5,18,25,0,100
4,5,12,9,22,5,18,12,25,112
4,5,12,9,22,5,18,15,18,108
4,5,12,9,22,5,18,19,0,94
4,5,12,12,1,18,9,14,7,82
4,5,12,12,5,14,9,20,5,86
4,5,12,12,9,5,19,0,0,66
4,5,12,12,19,0,0,0,0,52
4,5,12,15,15,0,0,0,0,51
4,5,12,15,21,12,0,0,0,69
4,5,12,15,21,19,5,0,0,81
4,5,12,15,21,19,5,4,0,85
4,5,12,15,21,19,5,18,0,99
4,5,12,15,21,19,5,19,0,100
4,5,12,15,21,19,9,14,7,106
4,5,12,16,8,0,0,0,0,45
4,5,12,16,8,1,3,9,4,62
4,5,12,16,8,9,14,9,3,80
4,5,12,16,8,9,14,9,14,91
4,5,12,19,0,0,0,0,0,40
4,5,12,20,1,9,3,0,0,54
4,5,12,20,1,9,20,5,0,76
4,5,12,20,1,12,0,0,0,54
4,5,12,20,1,12,9,11,5,79
4,5,12,20,1,18,9,21,13,103
4,5,12,20,1,19,0,0,0,61
4,5,12,20,1,20,9,15,14,100
4,5,12,20,8,25,18,9,1,102
4,5,12,20,9,3,0,0,0,53
4,5,12,20,9,4,9,1,0,64
4,5,12,20,9,4,9,1,12,76
4,5,12,20,9,4,9,21,13,97
4,5,12,20,15,9,4,0,0,69
4,5,12,20,15,9,4,1,12,82
4,5,12,20,15,9,4,5,9,83
4,5,12,20,15,9,4,19,0,88
4,5,12,21,2,18,1,0,0,63
4,5,12,21,2,18,21,13,0,96
4,5,12,21,3,5,0,0,0,50
4,5,12,21,4,1,2,12,5,66
4,5,12,21,4,5,0,0,0,51
4,5,12,21,4,5,4,0,0,55
4,5,12,21,4,5,18,0,0,69
4,5,12,21,4,5,18,19,0,88
4,5,12,21,4,5,19,0,0,70
4,5,12,21,4,8,5,18,0,77
4,5,12,21,4,9,14,7,0,76
4,5,12,21,7,5,4,0,0,58
4,5,12,21,7,5,19,0,0,73
4,5,12,21,7,9,14,7,0,79
4,5,12,21,13,2,1,20,5,83
4,5,12,21,14,4,21,14,7,102
4,5,12,21,19,9,15,14,0,99
4,5,12,21,19,9,15,14,19,118
4,5,12,21,19,9,22,5,0,97
4,5,12,21,19,15,18,25,0,119
4,5,12,21,19,20,5,18,0,104
4,5,12,21,19,20,5,18,19,123
4,5,12,21,24,5,0,0,0,71
4,5,12,22,5,0,0,0,0,48
4,5,12,22,5,4,0,0,0,52
4,5,12,22,5,18,0,0,0,66
4,5,12,22,5,18,19,0,0,85
4,5,12,22,5,19,0,0,0,67
4,5,12,22,9,14,7,0,0,73
4,5,13,1,7,14,9,6,25,84
4,5,13,1,7,15,7,0,0,52
4,5,13,1,7,15,7,25,0,77
4,5,13,1,7,15,7,9,3,64
4,5,13,1,7,15,7,19,0,71
4,5,13,1,7,15,7,21,5,78
4,5,13,1,9,14,0,0,0,46
4,5,13,1,12,0,0,0,0,35
4,5,13,1,14,4,0,0,0,41
4,5,13,1,14,4,1,14,20,76
4,5,13,1,14,4,5,4,0,50
4,5,13,1,14,4,5,18,0,64
4,5,13,1,14,4,5,18,19,83
4,5,13,1,14,4,9,14,7,71
4,5,13,1,14,4,19,0,0,60
4,5,13,1,14,20,15,9,4,85
4,5,13,1,18,3,1,20,5,70
4,5,13,1,18,3,8,0,0,52
4,5,13,1,18,3,8,5,0,57
4,5,13,1,18,3,8,5,19,76
4,5,13,1,18,3,8,25,0,77
4,5,13,1,18,5,5,0,0,51
4,5,13,1,18,11,0,0,0,52
4,5,13,1,18,11,5,4,0,61
4,5,13,1,18,11,9,14,7,82
4,5,13,1,18,11,19,0,0,71
4,5,13,1,19,20,0,0,0,62
4,5,13,1,19,20,5,4,0,71
4,5,13,1,19,20,9,14,7,92
4,5,13,1,19,20,19,0,0,81
4,5,13,5,0,0,0,0,0,27
4,5,13,5,1,14,0,0,0,42
4,5,13,5,1,14,5,4,0,51
4,5,13,5,1,14,9,14,7,72
4,5,13,5,1,14,15,18,0,75
4,5,13,5,1,14,15,18,19,94
4,5,13,5,1,14,15,21,18,96
4,5,13,5,1,14,19,0,0,61
4,5,13,5,7,15,18,9,3,79
4,5,13,5,12,5,0,0,0,44
4,5,13,5,13,2,18,5,0,65
4,5,13,5,14,3,25,0,0,69
4,5,13,5,14,20,0,0,0,61
4,5,13,5,14,20,1,20,5,87
4,5,13,5,14,20,5,4,0,70
4,5,13,5,14,20,9,0,0,70
4,5,13,5,14,20,9,1,0,71
4,5,13,5,14,20,9,1,12,83
4,5,13,5,14,20,9,1,19,90
4,5,13,5,14,20,9,5,0,75
4,5,13,5,14,20,9,14,7,91
4,5,13,5,14,20,9,19,0,89
4,5,13,5,14,20,19,0,0,80
4,5,13,5,15,18,5,0,0,65
4,5,13,5,18,7,5,0,0,57
4,5,13,5,18,7,5,4,0,61
4,5,13,5,18,7,5,18,0,75
4,5,13,5,18,7,5,19,0,76
4,5,13,5,18,9,20,0,0,74
4,5,13,5,18,9,20,5,4,83
4,5,13,5,18,9,20,19,0,93
4,5,13,5,18,19,1,12,0,77
4,5,13,5,18,19,5,0,0,69
4,5,13,5,18,19,5,4,0,73
4,5,13,5,18,19,9,15,14,102
4,5,13,5,19,0,0,0,0,46
4,5,13,5,19,7,14,5,0,72
4,5,13,5,19,7,14,5,19,91
4,5,13,5,19,13,1,14,0,74
4,5,13,5,19,14,5,0,0,65
4,5,13,5,19,14,5,19,0,84
4,5,13,5,19,14,9,1,12,82
4,5,13,5,20,15,14,0,0,76
4,5,13,5,20,15,14,19,0,95
4,5,13,9,0,0,0,0,0,31
4,5,13,9,1,4,21,12,20,89
4,5,13,9,1,14,7,5,12,70
4,5,13,9,2,1,20,8,0,62
4,5,13,9,2,5,1,19,20,78
4,5,13,9,2,5,12,20,0,70
4,5,13,9,2,15,2,0,0,50
4,5,13,9,2,18,21,20,5,97
4,5,13,9,3,1,14,15,14,78
4,5,13,9,4,5,9,6,25,80
4,5,13,9,4,5,9,20,25,94
4,5,13,9,4,5,22,9,12,83
4,5,13,9,4,15,7,0,0,57
4,5,13,9,4,15,13,5,0,68
4,5,13,9,5,1,7,12,5,61
4,5,13,9,5,19,0,0,0,55
4,5,13,9,7,12,1,3,5,59
4,5,13,9,7,12,15,2,5,72
4,5,13,9,7,15,4,0,0,57
4,5,13,9,7,15,4,19,0,76
4,5,13,9,7,15,18,7,5,83
4,5,13,9,7,18,1,20,5,82
4,5,13,9,7,18,15,1,20,92
4,5,13,9,8,1,7,0,0,47
4,5,13,9,8,1,7,21,5,73
4,5,13,9,8,1,11,5,0,56
4,5,13,9,8,1,17,21,5,83
4,5,13,9,8,9,7,8,0,63
4,5,13,9,8,15,18,19,5,96
4,5,13,9,8,21,13,1,14,88
4,5,13,9,10,1,13,2,5,62
4,5,13,9,10,15,8,14,0,78
4,5,13,9,10,15,8,14,19,97
4,5,13,9,11,9,14,7,0,72
4,5,13,9,12,1,14,3,5,66
4,5,13,9,12,9,15,14,0,81
4,5,13,9,12,21,14,5,0,83
4,5,13,9,12,21,14,5,19,102
4,5,13,9,13,1,14,0,0,59
4,5,13,9,13,1,18,11,0,74
4,5,13,9,13,15,14,4,5,82
4,5,13,9,13,15,14,11,0,84
4,5,13,9,14,21,4,5,0,75
4,5,13,9,15,18,2,9,20,95
4,5,13,9,15,23,12,0,0,81
4,5,13,9,15,24,0,0,0,70
4,5,13,9,16,1,7,1,14,70
4,5,13,9,16,9,11,5,0,72
4,5,13,9,16,9,17,21,5,99
4,5,13,9,16,12,1,20,5,85
4,5,13,9,18,1,3,12,5,70
4,5,13,9,18,1,13,0,0,63
4,5,13,9,18,5,16,0,0,70
4,5,13,9,18,5,16,19,0,89
4,5,13,9,18,8,21,13,2,93
4,5,13,9,18,15,2,5,0,71
4,5,13,9,19,1,2,12,5,70
4,5,13,9,19,1,14,7,0,72
4,5,13,9,19,5,0,0,0,55
4,5,13,9,19,5,4,0,0,59
4,5,13,9,19,5,19,0,0,74
4,5,13,25,19,8,9,16,0,99
4,5,13,9,19,8,9,18,20,105
4,5,13,9,19,9,14,7,0,80
4,5,13,9,19,15,12,4,5,86
4,5,13,9,19,19,0,0,0,69
4,5,13,9,19,19,9,15,14,107
4,5,13,9,19,19,9,22,5,105
4,5,13,9,19,19,12,25,0,106
4,5,13,9,19,19,15,18,25,127
4,5,13,9,19,20,0,0,0,70
4,5,13,25,19,20,9,6,25,126
4,5,13,9,19,21,9,20,0,100
4,5,13,9,20,0,0,0,0,51
4,5,13,9,20,1,19,19,5,95
4,5,13,25,20,8,9,6,25,115
4,5,13,9,20,9,14,20,0,94
4,5,13,9,20,15,14,5,0,85
4,5,13,9,20,18,1,9,14,93
4,5,13,9,20,19,0,0,0,70
4,5,13,9,20,20,5,4,0,80
4,5,13,9,20,20,9,14,7,101
4,5,13,9,20,21,2,5,0,79
4,5,13,9,21,18,7,5,19,101
4,5,13,9,21,18,7,9,3,89
4,5,13,9,21,18,7,15,19,111
4,5,13,9,21,18,7,21,19,117
4,5,13,9,22,15,9,3,5,85
4,5,13,9,22,15,12,0,0,80
4,5,13,9,22,15,12,20,0,100
4,5,13,9,22,15,12,20,5,105
4,5,13,9,22,15,12,20,19,119
4,5,13,9,23,15,12,6,0,87
4,5,13,9,23,15,18,12,4,103
4,5,13,14,9,20,9,15,14,103
4,5,13,15,2,0,0,0,0,39
4,5,13,15,2,2,5,4,0,50
4,5,13,15,2,2,9,14,7,71
4,5,13,15,2,19,0,0,0,58
4,5,13,15,3,18,1,3,25,87
4,5,13,15,3,18,1,20,19,98
4,5,13,15,3,18,1,23,0,82
4,5,13,15,4,5,0,0,0,46
4,5,13,15,4,5,4,0,0,50
4,5,13,15,7,5,14,9,3,75
4,5,13,15,9,4,0,0,0,50
4,5,13,15,12,9,19,8,0,85
4,5,13,15,12,15,7,25,0,96
4,5,13,15,14,5,19,19,0,94
4,5,13,15,14,9,1,3,0,64
4,5,13,15,14,9,1,3,19,83
4,5,13,15,14,9,1,12,0,73
4,5,13,15,14,9,1,14,0,75
4,5,13,15,14,9,1,19,20,100
4,5,13,15,14,9,3,0,0,63
4,5,13,15,14,9,3,1,12,76
4,5,13,15,14,9,15,0,0,75
4,5,13,15,14,9,19,5,0,84
4,5,13,15,14,9,19,5,4,88
4,5,13,15,14,9,19,5,19,103
4,5,13,15,14,9,19,8,0,87
4,5,13,15,14,9,19,13,0,92
4,5,13,15,14,9,19,13,19,111
4,5,13,15,14,9,19,20,0,99
4,5,13,15,14,9,19,20,19,118
4,5,13,15,14,9,26,5,0,91
4,5,13,15,14,9,26,5,4,95
4,5,13,15,14,9,26,5,19,110
4,5,13,15,14,11,9,14,4,89
4,5,13,15,14,12,1,14,4,82
4,5,13,15,14,12,9,11,5,88
4,5,13,15,14,15,13,25,0,104
4,5,13,15,14,18,25,0,0,94
4,5,13,15,14,19,0,0,0,70
4,5,13,15,14,19,8,9,16,103
4,5,13,15,16,8,9,12,0,82
4,5,13,15,16,8,9,12,5,87
4,5,13,15,16,8,15,2,5,83
4,5,13,15,18,1,7,5,0,68
4,5,13,15,19,5,19,0,0,80
4,5,13,15,20,0,0,0,0,57
4,5,13,15,20,5,0,0,0,62
4,5,13,15,20,5,4,0,0,66
4,5,13,15,20,5,19,0,0,81
4,5,13,15,20,9,3,19,0,88
4,5,13,15,20,9,14,7,0,87
4,5,13,15,20,9,15,14,0,95
4,5,13,15,20,9,15,14,19,114
4,5,13,15,20,9,19,20,0,105
4,5,13,15,20,9,19,20,19,124
4,5,13,15,21,14,20,0,0,92
4,5,13,15,21,14,20,5,4,101
4,5,13,15,21,14,20,19,0,111
4,5,13,15,22,5,0,0,0,64
4,5,13,16,14,5,0,0,0,57
4,5,13,16,19,20,5,18,19,119
4,5,13,21,12,3,5,0,0,63
4,5,13,21,12,3,5,14,20,97
4,5,13,21,12,19,9,6,25,114
4,5,13,21,12,19,9,15,14,112
4,5,13,21,18,0,0,0,0,61
4,5,13,21,18,5,0,0,0,66
4,5,13,21,18,5,12,25,0,103
4,5,13,21,18,5,18,0,0,84
4,5,13,21,18,5,19,20,0,105
4,5,13,21,18,9,20,25,0,115
4,5,13,21,18,18,1,7,5,92
4,5,13,21,18,18,1,12,0,92
4,5,13,21,18,18,1,12,19,111
4,5,13,21,18,18,1,14,20,114
4,5,13,21,18,18,5,4,0,88
4,5,13,21,18,18,5,18,0,102
4,5,13,21,18,18,5,18,19,121
4,5,13,21,18,18,9,14,7,109
4,5,13,21,18,19,0,0,0,80
4,5,14,1,25,0,0,0,0,49
4,5,14,1,13,5,0,0,0,42
4,5,14,1,18,0,0,0,0,42
4,5,14,1,18,9,0,0,0,51
4,5,14,1,18,25,0,0,0,67
4,5,14,1,18,9,5,19,0,75
4,5,14,1,18,9,9,0,0,60
4,5,14,1,18,9,21,19,0,91
4,5,14,1,18,15,0,0,0,57
4,5,14,1,20,0,0,0,0,44
4,5,14,1,20,21,18,5,0,88
4,5,14,1,20,21,18,5,4,92
4,5,14,1,20,21,18,5,19,107
4,5,14,1,26,9,6,25,0,90
4,5,14,4,1,0,0,0,0,28
4,5,14,4,18,1,0,0,0,46
4,5,14,4,18,1,12,0,0,58
4,5,14,4,18,1,24,15,14,99
4,5,14,4,18,9,3,0,0,57
4,5,14,4,18,9,20,5,0,79
4,5,14,4,18,9,20,9,3,86
4,5,14,4,18,15,2,5,0,67
4,5,14,4,18,15,4,9,3,76
4,5,14,4,18,15,4,18,1,83
4,5,14,4,18,15,9,4,0,73
4,5,14,4,18,15,14,19,0,93
4,5,14,5,7,1,20,5,0,61
4,5,14,5,8,15,12,5,0,68
4,5,14,5,18,22,1,20,5,94
4,5,14,5,19,0,0,0,0,47
4,5,14,7,21,5,0,0,0,56
4,5,14,7,21,5,19,0,0,75
4,5,14,9,1,2,12,5,0,52
4,5,14,9,1,2,12,25,0,72
4,5,14,9,1,12,0,0,0,45
4,5,14,9,1,12,19,0,0,64
4,5,14,9,5,4,0,0,0,41
4,5,14,9,5,18,0,0,0,55
4,5,14,25,5,18,0,0,0,71
4,5,14,9,5,18,1,7,5,68
4,5,14,9,5,18,5,18,0,78
4,5,14,9,5,18,19,0,0,74
4,5,14,9,5,19,0,0,0,56
4,5,14,9,7,18,1,20,5,83
4,5,14,25,9,14,7,0,0,78
4,5,14,25,9,14,7,12,25,115
4,5,14,9,13,0,0,0,0,45
4,5,14,9,13,19,0,0,0,64
4,5,14,9,20,18,1,20,5,96
4,5,14,9,20,18,9,6,25,110
4,5,14,9,20,18,9,26,5,110
4,5,14,9,26,1,20,5,0,84
4,5,14,9,26,5,0,0,0,63
4,5,14,9,26,5,14,0,0,77
4,5,14,9,26,5,14,5,4,86
4,5,14,9,26,5,14,19,0,96
4,5,14,14,5,4,0,0,0,46
4,5,14,15,13,0,0,0,0,51
4,5,14,15,20,1,2,12,5,78
4,5,14,15,20,1,20,5,0,84
4,5,14,15,20,1,20,21,13,113
4,5,14,15,20,5,0,0,0,63
4,5,14,15,20,5,4,0,0,67
4,5,14,15,20,5,19,0,0,82
4,5,14,15,20,9,22,5,0,94
4,5,14,15,21,14,3,5,0,81
4,5,14,15,21,14,3,5,4,85
4,5,14,15,21,14,3,5,18,99
4,5,14,15,21,14,3,5,19,100
4,5,14,19,0,0,0,0,0,42
4,5,14,19,1,20,5,0,0,68
4,5,14,19,1,20,9,15,14,101
4,5,14,19,5,0,0,0,0,47
4,5,14,19,5,12,25,0,0,84
4,5,14,19,5,14,0,0,0,61
4,5,14,19,5,14,5,19,19,104
4,5,14,19,5,18,0,0,0,65
4,5,14,19,5,19,20,0,0,86
4,5,14,19,8,1,18,5,0,74
4,5,14,19,8,5,18,0,0,73
4,5,14,19,8,9,18,5,0,82
4,5,14,19,9,6,25,0,0,82
4,5,14,19,9,6,9,5,4,75
4,5,14,19,9,6,9,5,18,89
4,5,14,19,9,6,9,5,19,90
4,5,14,19,9,20,25,0,0,96
4,5,14,19,9,20,9,5,19,104
4,5,14,19,21,19,0,0,0,82
4,5,14,20,1,7,18,1,0,70
4,5,14,20,1,12,0,0,0,56
4,5,14,20,1,12,5,0,0,61
4,5,14,20,1,12,7,9,1,73
4,5,14,20,1,12,9,1,0,66
4,5,14,20,1,12,9,19,5,89
4,5,14,20,1,12,9,19,13,97
4,5,14,20,1,12,9,20,25,110
4,5,14,20,1,12,9,26,5,96
4,5,14,20,1,12,12,25,0,93
4,5,14,20,1,12,12,9,1,78
4,5,14,20,1,12,13,1,14,84
4,5,14,20,1,12,13,5,14,88
4,5,14,20,1,12,19,0,0,75
4,5,14,20,1,18,25,0,0,87
4,5,14,20,1,18,9,5,19,95
4,5,14,20,1,20,1,0,0,65
4,5,14,20,1,20,5,0,0,69
4,5,14,20,1,20,5,4,0,73
4,5,14,20,1,20,5,12,25,106
4,5,14,20,1,20,9,15,14,102
4,5,14,20,5,4,0,0,0,52
4,5,14,20,5,12,0,0,0,60
4,5,14,20,5,12,12,5,0,77
4,5,14,20,5,12,12,15,0,87
4,5,14,20,5,12,21,18,5,104
4,5,14,20,5,18,0,0,0,66
4,5,14,20,5,19,0,0,0,67
4,5,14,20,5,24,0,0,0,72
4,5,14,20,25,0,0,0,0,68
4,5,14,20,9,3,1,12,0,68
4,5,14,20,9,3,1,20,5,81
4,5,14,20,9,3,5,20,5,85
4,5,14,20,9,3,12,5,0,72
4,5,14,20,9,3,12,5,19,91
4,5,14,20,9,3,21,12,5,93
4,5,14,20,9,6,15,18,13,104
4,5,14,20,9,12,0,0,0,64
4,5,14,20,9,12,5,0,0,69
4,5,14,20,9,12,5,4,0,73
4,5,14,20,9,12,19,0,0,83
4,5,14,20,9,14,0,0,0,66
4,5,14,20,9,14,1,12,0,79
4,5,14,20,9,14,5,0,0,71
4,5,14,20,9,14,5,19,0,90
4,5,14,20,9,14,7,0,0,73
4,5,14,20,9,14,15,9,4,94
4,5,14,20,9,14,15,13,1,95
4,5,14,20,9,14,19,0,0,85
4,5,14,20,9,19,20,0,0,91
4,5,14,20,9,19,20,9,3,103
4,5,14,20,9,19,20,18,25,134
4,5,14,20,9,19,20,19,0,110
4,5,14,20,9,20,9,15,14,110
4,5,14,20,15,9,4,0,0,71
4,5,14,20,19,0,0,0,0,62
4,5,14,20,21,12,15,21,19,131
4,5,14,20,21,18,1,12,0,95
4,5,14,20,21,18,5,0,0,87
4,5,14,20,21,18,5,19,0,106
4,5,14,21,4,1,14,20,0,83
4,5,14,21,4,1,20,5,0,74
4,5,14,21,4,1,20,5,4,78
4,5,14,21,4,1,20,5,19,93
4,5,14,21,4,5,0,0,0,53
4,5,14,21,4,5,4,0,0,57
4,5,14,21,4,5,18,0,0,71
4,5,14,21,4,5,18,19,0,90
4,5,14,21,4,5,19,0,0,72
4,5,14,21,4,9,14,7,0,78
4,5,14,21,13,5,18,1,12,93
4,5,15,3,21,12,1,20,5,86
4,5,15,4,1,14,4,0,0,47
4,5,15,4,1,14,4,19,0,66
4,5,15,4,1,18,0,0,0,47
4,5,15,4,1,18,1,0,0,48
4,5,15,4,1,18,1,19,0,67
4,5,15,4,1,18,19,0,0,66
4,5,15,4,1,20,5,0,0,54
4,5,15,4,15,18,1,14,20,96
4,5,15,4,15,18,9,19,5,94
4,5,15,4,15,18,9,26,5,101
4,5,15,14,5,18,1,20,5,87
4,5,15,14,20,9,3,0,0,70
4,5,15,18,2,9,20,0,0,73
4,5,15,18,2,9,20,19,0,92
4,5,15,18,19,21,13,0,0,95
4,5,15,19,19,9,6,25,0,102
4,5,15,20,1,0,0,0,0,45
4,5,15,24,9,4,1,14,20,96
4,5,15,24,9,4,1,20,5,87
4,5,15,24,9,4,9,19,5,94
4,5,15,24,9,4,9,26,5,101
4,5,15,26,15,14,9,26,5,119
4,5,16,0,0,0,0,0,0,25
4,5,16,1,0,0,0,0,0,26
4,5,16,1,9,14,20,0,0,69
4,5,16,1,9,14,20,5,4,78
4,5,16,1,9,14,20,19,0,88
4,5,16,1,9,18,0,0,0,53
4,5,16,1,25,19,5,0,0,75
4,5,16,1,25,19,5,5,0,80
4,5,16,1,18,4,9,5,21,83
4,5,16,1,18,11,0,0,0,55
4,5,16,1,18,20,0,0,0,64
4,5,16,1,18,20,5,4,0,73
4,5,16,1,18,20,5,5,0,74
4,5,16,1,18,20,5,18,0,87
4,5,16,1,18,20,9,14,7,94
4,5,16,1,18,20,19,0,0,83
4,5,16,1,18,20,21,18,5,108
4,5,16,1,19,0,0,0,0,45
4,5,16,1,19,3,5,14,20,87
4,5,16,1,19,19,0,0,0,64
4,5,16,1,19,20,21,18,5,109
4,5,16,5,0,0,0,0,0,30
4,5,16,5,1,3,8,0,0,42
4,5,16,5,3,8,5,0,0,46
4,5,16,5,9,14,3,20,0,76
4,5,16,5,12,0,0,0,0,42
4,5,16,5,14,3,9,12,0,68
4,5,16,5,14,4,0,0,0,48
4,5,16,5,14,4,1,14,20,83
4,5,16,5,14,4,5,4,0,57
4,5,16,5,14,4,5,14,20,87
4,5,16,5,14,4,5,18,0,71
4,5,16,5,14,4,9,14,7,78
4,5,16,5,14,4,19,0,0,67
4,5,16,5,15,16,12,5,0,78
4,5,16,5,15,16,12,5,4,82
4,5,16,5,18,4,9,20,0,81
4,5,16,5,18,4,9,20,5,86
4,5,16,5,18,13,0,0,0,61
4,5,16,5,18,13,5,4,0,70
4,5,16,5,18,13,9,14,7,91
4,5,16,5,18,13,19,0,0,80
4,5,16,5,20,5,18,0,0,73
4,5,16,8,1,19,5,0,0,58
4,5,16,8,1,19,5,4,0,62
4,5,16,8,1,19,9,14,7,83
4,5,16,8,12,5,7,13,0,70
4,5,16,9,3,11,12,5,0,65
4,5,16,9,3,20,0,0,0,57
4,5,16,9,3,20,5,4,0,66
4,5,16,9,3,20,5,18,0,80
4,5,16,9,3,20,5,18,19,99
4,5,16,9,3,20,9,14,7,87
4,5,16,9,3,20,9,15,14,95
4,5,16,9,3,20,9,22,5,93
4,5,16,9,3,20,15,18,0,90
4,5,16,9,3,20,15,18,19,109
4,5,16,9,3,20,19,0,0,76
4,5,16,9,3,20,21,18,5,101
4,5,16,9,7,13,5,14,20,93
4,5,16,9,12,1,20,5,0,72
4,5,16,9,12,1,20,5,4,76
4,5,16,9,12,1,20,5,19,91
4,5,16,9,12,1,20,15,18,100
4,5,16,9,12,15,21,19,0,101
4,5,16,9,20,0,0,0,0,54
4,5,16,12,1,3,5,0,0,46
4,5,16,12,1,14,5,0,0,57
4,5,16,12,1,14,5,4,0,61
4,5,16,12,1,14,5,19,0,76
4,5,16,12,1,14,9,14,7,82
4,5,16,12,1,14,20,0,0,72
4,5,16,12,1,19,20,5,18,100
4,5,16,12,5,14,9,19,8,92
4,5,16,12,5,20,5,0,0,67
4,5,16,12,5,20,5,4,0,71
4,5,16,12,5,20,5,19,0,86
4,5,16,12,5,20,9,14,7,92
4,5,16,12,5,20,9,15,14,100
4,5,16,12,5,20,9,22,5,98
4,5,16,12,5,20,15,18,25,120
4,5,16,12,15,25,0,0,0,77
4,5,16,12,15,25,5,4,0,86
4,5,16,12,15,25,9,14,7,107
4,5,16,12,15,25,19,0,0,96
4,5,16,12,15,18,1,20,5,96
4,5,16,12,15,18,5,0,0,75
4,5,16,12,15,18,5,4,0,79
4,5,16,12,15,18,5,18,0,93
4,5,16,12,15,18,5,18,19,112
4,5,16,12,15,18,5,19,0,94
4,5,16,12,15,18,9,14,7,100
4,5,16,12,21,13,1,20,5,97
4,5,16,12,21,13,5,0,0,76
4,5,16,12,21,13,5,4,0,80
4,5,16,12,21,13,5,19,0,95
4,5,16,12,21,13,9,14,7,101
4,5,16,12,21,13,16,0,0,87
4,5,16,15,5,20,9,26,5,105
4,5,16,15,8,0,0,0,0,48
4,5,16,15,12,9,19,8,0,88
4,5,16,15,14,5,0,0,0,59
4,5,16,15,14,5,4,0,0,63
4,5,16,15,14,5,14,20,0,93
4,5,16,15,14,5,14,20,19,112
4,5,16,15,14,5,18,0,0,77
4,5,16,15,14,5,19,0,0,78
4,5,16,15,14,9,14,7,0,84
4,5,16,15,18,20,0,0,0,78
4,5,16,15,18,20,5,0,0,83
4,5,16,15,18,20,5,4,0,87
4,5,16,15,18,20,5,5,0,88
4,5,16,15,18,20,5,5,19,107
4,5,16,15,18,20,5,18,0,101
4,5,16,15,18,20,9,14,7,108
4,5,16,15,18,20,19,0,0,97
4,5,16,15,18,20,21,18,5,122
4,5,16,15,19,1,2,12,5,79
4,5,16,15,19,1,12,0,0,72
4,5,16,15,19,1,12,19,0,91
4,5,16,15,19,5,0,0,0,64
4,5,16,15,19,5,4,0,0,68
4,5,16,15,19,5,18,0,0,82
4,5,16,15,19,5,18,19,0,101
4,5,16,15,19,5,19,0,0,83
4,5,16,15,19,9,14,7,0,89
4,5,16,15,19,9,20,0,0,88
4,5,16,15,19,9,20,1,0,89
4,5,16,15,19,9,20,5,4,97
4,5,16,15,19,9,20,5,5,98
4,5,16,15,19,9,20,15,0,103
4,5,16,15,19,9,20,15,18,121
4,5,16,15,19,9,20,19,0,107
4,5,16,15,19,9,20,21,13,122
4,5,16,15,19,21,18,5,0,103
4,5,16,15,20,0,0,0,0,60
4,5,16,15,20,19,0,0,0,79
4,5,16,18,0,0,0,0,0,43
4,5,16,18,1,22,1,20,5,92
4,5,16,18,1,22,5,0,0,71
4,5,16,18,1,22,5,4,0,75
4,5,16,18,1,22,5,18,0,89
4,5,16,18,1,22,5,18,19,108
4,5,16,18,1,22,5,19,0,90
4,5,16,18,1,22,9,14,7,96
4,5,16,18,1,22,9,20,25,120
4,5,16,18,5,3,1,20,5,77
4,5,16,18,5,4,1,20,5,78
4,5,16,18,5,8,5,14,4,79
4,5,16,18,5,19,19,0,0,86
4,5,16,18,5,19,19,5,4,95
4,5,16,18,5,19,19,5,19,110
4,5,16,18,5,19,19,15,18,119
4,5,16,18,5,19,20,0,0,87
4,5,16,18,5,20,5,18,0,91
4,5,16,18,9,13,5,14,20,104
4,5,16,18,9,14,20,0,0,86
4,5,16,18,9,19,21,18,5,115
4,5,16,18,9,22,1,12,0,87
4,5,16,18,9,22,1,12,19,106
4,5,16,18,9,22,1,20,5,100
4,5,16,18,9,22,5,0,0,79
4,5,16,18,9,22,5,4,0,83
4,5,16,18,9,22,5,18,0,97
4,5,16,18,9,22,5,18,19,116
4,5,16,18,9,22,5,19,0,98
4,5,16,18,9,22,9,14,7,104
4,5,16,18,15,7,18,1,13,97
4,5,16,18,15,13,5,0,0,76
4,5,16,19,9,4,0,0,0,57
4,5,16,19,9,4,5,0,0,62
4,5,16,19,9,4,5,19,0,81
4,5,16,20,0,0,0,0,0,45
4,5,16,20,8,0,0,0,0,53
4,5,16,20,8,5,14,0,0,72
4,5,16,20,8,9,14,7,0,83
4,5,16,20,8,12,5,19,19,108
4,5,16,20,8,19,0,0,0,72
4,5,16,20,8,23,1,25,19,121
4,5,16,20,8,23,9,19,5,109
4,5,16,21,3,5,12,0,0,66
4,5,16,21,12,19,5,0,0,82
4,5,16,21,18,1,14,20,0,99
4,5,16,21,18,1,20,5,0,90
4,5,16,21,18,1,20,5,4,94
4,5,16,21,18,1,20,5,19,109
4,5,16,21,18,1,20,15,18,118
4,5,16,21,18,5,0,0,0,69
4,5,16,21,18,7,5,0,0,76
4,5,16,21,18,7,5,4,0,80
4,5,16,21,18,7,9,14,7,101
4,5,16,21,20,1,2,12,5,86
4,5,16,21,20,1,20,15,18,120
4,5,16,21,20,5,0,0,0,71
4,5,16,21,20,5,4,0,0,75
4,5,16,21,20,5,19,0,0,90
4,5,16,21,20,25,0,0,0,91
4,5,16,21,20,9,5,19,0,99
4,5,16,21,20,9,14,7,0,96
4,5,16,21,20,9,19,5,0,99
4,5,16,21,20,9,19,5,4,103
4,5,16,21,20,9,26,5,0,106
4,5,16,21,20,9,26,5,4,110
4,5,16,21,20,9,26,5,19,125
4,5,17,21,5,21,5,0,0,78
4,5,17,21,5,21,5,4,0,82
4,5,17,21,5,21,5,19,0,97
4,5,17,21,5,21,9,14,7,103
4,5,18,1,3,9,14,5,0,59
4,5,18,1,8,0,0,0,0,36
4,5,18,1,25,0,0,0,0,53
4,5,18,1,9,7,14,0,0,58
4,5,18,1,9,7,14,5,4,67
4,5,18,1,9,7,14,19,0,77
4,5,18,1,9,12,0,0,0,49
4,5,18,1,9,12,5,4,0,58
4,5,18,1,9,12,5,18,0,72
4,5,18,1,9,12,9,14,7,79
4,5,18,1,9,12,19,0,0,68
4,5,18,1,25,19,0,0,0,72
4,5,18,1,14,7,5,0,0,54
4,5,18,1,14,7,5,4,0,58
4,5,18,1,14,7,5,18,0,72
4,5,18,1,14,7,5,19,0,73
4,5,18,1,14,7,9,14,7,79
4,5,18,1,20,0,0,0,0,48
4,5,18,1,20,5,0,0,0,53
4,5,18,1,20,5,4,0,0,57
4,5,18,1,20,5,18,0,0,71
4,5,18,1,20,9,14,7,0,78
4,5,18,1,20,9,15,14,0,86
4,5,18,1,20,9,26,5,0,88
4,5,18,1,20,9,26,5,4,92
4,5,18,1,20,19,0,0,0,67
4,5,18,1,20,20,5,4,0,77
4,5,18,1,20,20,9,14,7,98
4,5,18,2,25,12,9,20,5,100
4,5,18,2,21,11,11,1,0,73
4,5,18,5,0,0,0,0,0,32
4,5,18,5,3,8,15,0,0,58
4,5,18,5,9,7,14,0,0,62
4,5,18,5,9,19,13,0,0,73
4,5,18,5,9,19,20,9,3,92
4,5,18,5,12,9,3,20,0,76
4,5,18,5,12,9,3,20,1,77
4,5,18,5,12,9,3,20,19,95
4,5,18,5,12,9,14,7,0,74
4,5,18,5,16,18,5,19,19,109
4,5,18,5,18,5,0,0,0,55
4,5,18,6,0,0,0,0,0,33
4,5,18,6,12,25,0,0,0,70
4,5,18,6,14,5,19,19,0,90
4,5,18,8,1,13,0,0,0,49
4,5,18,9,3,0,0,0,0,39
4,5,18,9,4,5,0,0,0,45
4,5,18,9,4,5,4,0,0,49
4,5,18,9,4,5,18,0,0,63
4,5,18,9,4,5,18,19,0,82
4,5,18,9,4,5,19,0,0,64
4,5,18,9,4,9,14,7,0,70
4,5,18,9,14,7,5,18,0,80
4,5,18,9,14,7,5,18,19,99
4,5,18,9,19,9,2,12,5,83
4,5,18,9,19,9,15,14,0,93
4,5,18,9,19,9,15,14,19,112
4,5,18,9,19,9,22,5,0,91
4,5,18,9,19,15,18,25,0,113
4,5,18,9,22,0,0,0,0,58
4,5,18,9,22,1,2,12,5,78
4,5,18,9,22,1,2,12,25,98
4,5,18,9,22,1,12,0,0,71
4,5,18,9,22,1,14,20,0,93
4,5,18,9,22,1,20,5,0,84
4,5,18,9,22,1,20,5,19,103
4,5,18,9,22,5,0,0,0,63
4,5,18,9,22,5,4,0,0,67
4,5,18,9,22,5,4,12,25,104
4,5,18,9,22,5,18,0,0,81
4,5,18,9,22,5,18,19,0,100
4,5,18,9,22,5,19,0,0,82
4,5,18,9,22,9,14,7,0,88
4,5,18,13,0,0,0,0,0,40
4,5,18,13,1,0,0,0,0,41
4,5,18,13,1,4,0,0,0,45
4,5,18,13,1,12,0,0,0,53
4,5,18,13,1,12,7,9,1,70
4,5,18,13,1,12,9,20,8,90
4,5,18,13,1,19,0,0,0,60
4,5,18,13,1,20,9,3,0,73
4,5,18,13,1,20,9,14,5,89
4,5,18,13,1,20,15,9,4,89
4,5,18,13,1,20,15,13,1,90
4,5,18,13,1,20,15,13,5,94
4,5,18,13,1,20,15,21,19,116
4,5,18,13,5,19,20,9,4,97
4,5,18,13,9,3,0,0,0,52
4,5,18,13,9,19,0,0,0,68
4,5,18,13,9,19,5,19,0,92
4,5,18,13,9,20,9,19,0,97
4,5,18,13,15,9,4,0,0,68
4,5,18,13,15,9,4,1,12,81
4,5,18,13,15,9,4,19,0,87
4,5,18,13,15,12,0,0,0,67
4,5,18,13,19,0,0,0,0,59
4,5,18,14,0,0,0,0,0,41
4,5,18,14,5,4,0,0,0,50
4,5,18,14,5,18,0,0,0,64
4,5,18,14,6,21,12,0,0,80
4,5,18,14,9,5,18,0,0,73
4,5,18,14,9,14,7,0,0,71
4,5,18,14,12,25,0,0,0,78
4,5,18,15,0,0,0,0,0,42
4,5,18,15,2,5,0,0,0,49
4,5,18,15,7,0,0,0,0,49
4,5,18,15,7,1,20,5,0,75
4,5,18,15,7,1,20,5,4,79
4,5,18,15,7,1,20,5,19,94
4,5,18,15,7,1,20,15,18,103
4,5,18,15,20,18,5,13,5,103
4,5,18,15,21,20,0,0,0,83
4,5,18,18,9,0,0,0,0,54
4,5,18,18,9,3,11,19,0,87
4,5,18,18,9,4,0,0,0,58
4,5,18,18,9,4,5,0,0,63
4,5,18,18,9,5,18,5,0,82
4,5,18,18,9,5,18,5,19,101
4,5,18,18,9,5,19,0,0,78
4,5,18,18,9,14,7,5,18,98
4,5,18,18,9,18,5,0,0,77
4,5,18,18,9,19,5,19,0,97
4,5,18,20,8,0,0,0,0,55
4,5,18,20,18,1,0,0,0,66
4,5,18,20,18,21,13,0,0,99
4,5,18,21,9,14,1,20,5,97
4,5,18,21,19,20,0,0,0,87
4,5,18,22,0,0,0,0,0,49
4,5,18,22,5,0,0,0,0,54
4,5,18,22,9,19,8,0,0,85
4,5,18,22,9,19,8,5,19,109
4,5,19,1,12,20,0,0,0,61
4,5,19,1,12,20,5,4,0,70
4,5,19,1,12,20,5,18,0,84
4,5,19,1,12,20,5,18,19,103
4,5,19,1,12,20,9,14,7,91
4,5,19,1,12,20,19,0,0,80
4,5,19,1,14,4,0,0,0,47
4,5,19,1,14,4,5,4,0,56
4,5,19,1,14,4,9,14,7,77
4,5,19,1,14,4,19,0,0,66
4,5,19,1,21,18,9,14,0,91
4,5,19,1,21,18,9,14,5,96
4,5,19,3,0,0,0,0,0,31
4,5,19,3,1,12,5,0,0,49
4,5,19,3,1,12,5,4,0,53
4,5,19,3,1,12,9,14,7,74
4,5,19,3,1,14,20,0,0,66
4,5,19,3,1,14,20,5,4,75
4,5,19,3,1,14,20,5,18,89
4,5,19,3,1,14,20,19,0,85
4,5,19,3,5,14,4,0,0,54
4,5,19,3,5,14,4,5,4,63
4,5,19,3,5,14,4,5,18,77
4,5,19,3,5,14,4,19,0,73
4,5,19,3,5,14,20,0,0,70
4,5,19,3,5,14,20,19,0,89
4,5,19,3,8,15,15,12,0,81
4,5,19,3,15,18,20,0,0,84
4,5,19,3,18,25,0,0,0,74
4,5,19,3,18,9,1,12,0,71
4,5,19,3,18,9,2,5,0,65
4,5,19,3,18,9,2,5,4,69
4,5,19,3,18,9,2,5,18,83
4,5,19,3,18,9,2,5,19,84
4,5,19,3,18,9,5,4,0,67
4,5,19,3,18,9,5,18,0,81
4,5,19,3,18,9,5,18,19,100
4,5,19,3,18,9,5,19,0,82
4,5,19,3,18,25,9,14,7,104
4,5,19,3,18,9,16,20,0,94
4,5,19,3,18,9,22,5,0,85
4,5,19,3,21,18,5,0,0,75
4,5,19,5,1,13,0,0,0,47
4,5,19,5,3,1,20,5,0,62
4,5,19,5,3,18,1,20,5,80
4,5,19,5,5,4,0,0,0,42
4,5,19,5,12,5,3,20,0,73
4,5,19,5,12,5,3,20,19,92
4,5,19,5,13,5,18,0,0,69
4,5,19,5,18,5,20,0,0,76
4,5,19,5,18,20,0,0,0,71
4,5,19,5,18,20,5,4,0,80
4,5,19,5,18,20,5,18,0,94
4,5,19,5,18,20,5,18,19,113
4,5,19,5,18,20,6,21,12,110
4,5,19,5,18,20,9,3,0,83
4,5,19,5,18,20,9,14,7,101
4,5,19,5,18,20,9,15,14,109
4,5,19,5,18,20,9,19,13,112
4,5,19,5,18,20,19,0,0,90
4,5,19,5,18,22,5,0,0,78
4,5,19,5,18,22,5,4,0,82
4,5,19,5,18,22,5,18,0,96
4,5,19,5,18,22,5,18,19,115
4,5,19,5,18,22,5,19,0,97
4,5,19,5,18,22,9,14,7,103
4,5,19,5,24,0,0,0,0,57
4,5,19,5,24,5,4,0,0,66
4,5,19,5,24,5,19,0,0,81
4,5,19,5,24,9,14,7,0,87
4,5,19,9,1,20,9,14,0,81
4,5,19,25,1,20,9,14,0,97
4,5,19,9,3,1,20,5,0,66
4,5,19,9,3,3,1,14,20,78
4,5,19,9,3,3,1,20,5,69
4,5,19,9,4,5,18,20,1,85
4,5,19,9,4,9,15,19,5,89
4,5,19,9,4,9,15,21,19,105
4,5,19,9,7,8,20,0,0,72
4,5,19,9,7,14,0,0,0,58
4,5,19,9,7,14,1,4,15,78
4,5,19,9,7,14,1,20,5,84
4,5,19,9,7,14,5,4,0,67
4,5,19,9,7,14,5,5,0,68
4,5,19,9,7,14,5,5,19,87
4,5,19,9,7,14,5,18,0,81
4,5,19,9,7,14,5,18,19,100
4,5,19,9,7,14,6,21,12,97
4,5,19,9,7,14,9,14,7,88
4,5,19,9,7,14,19,0,0,77
4,5,19,25,12,0,0,0,0,65
4,5,19,9,12,20,0,0,0,69
4,5,19,9,12,22,5,18,0,94
4,5,19,9,12,22,5,18,19,113
4,5,19,9,14,5,14,3,5,78
4,5,19,9,14,5,14,20,0,90
4,5,19,9,16,9,5,14,20,101
4,5,19,9,18,1,2,12,5,75
4,5,19,9,18,1,2,12,25,95
4,5,19,9,18,5,0,0,0,60
4,5,19,9,18,5,4,0,0,64
4,5,19,9,18,5,4,12,25,101
4,5,19,9,18,5,6,21,12,99
4,5,19,9,18,5,18,0,0,78
4,5,19,9,18,5,18,19,0,97
4,5,19,9,18,5,19,0,0,79
4,5,19,9,18,9,14,7,0,85
4,5,19,9,18,15,21,19,0,110
4,5,19,9,19,20,0,0,0,76
4,5,19,9,19,20,5,4,0,85
4,5,19,9,19,20,9,14,7,106
4,5,19,9,19,20,9,22,5,112
4,5,19,9,19,20,19,0,0,95
4,5,19,9,20,9,15,14,0,95
4,5,19,9,20,9,22,5,0,93
4,5,19,9,26,5,0,0,0,68
4,5,19,11,0,0,0,0,0,39
4,5,19,11,2,15,21,14,4,95
4,5,19,11,9,12,12,0,0,72
4,5,19,11,12,9,11,5,0,76
4,5,19,11,13,1,14,0,0,67
4,5,19,11,13,5,14,0,0,71
4,5,19,11,19,0,0,0,0,58
4,5,19,11,20,15,16,0,0,90
4,5,19,11,20,15,16,19,0,109
4,5,19,12,9,13,5,0,0,67
4,5,19,13,1,3,25,20,5,95
4,5,19,13,1,14,0,0,0,56
4,5,19,13,1,14,19,0,0,75
4,5,19,13,9,3,0,0,0,53
4,5,19,13,9,4,0,0,0,54
4,5,19,13,9,4,9,1,14,78
4,5,19,13,9,4,19,0,0,73
4,5,19,13,9,14,5,0,0,69
4,5,19,13,9,20,9,19,0,98
4,5,19,13,15,3,25,20,5,109
4,5,19,13,15,4,15,14,20,109
4,5,19,13,15,7,5,14,0,82
4,5,19,13,15,9,4,0,0,69
4,5,19,13,15,9,4,19,0,88
4,5,19,13,15,12,1,19,5,93
4,5,19,13,15,12,15,7,25,115
4,5,19,13,15,13,1,0,0,70
4,5,19,13,15,14,0,0,0,70
4,5,19,13,15,14,5,13,5,93
4,5,19,13,15,19,5,0,0,80
4,5,19,13,15,19,9,19,0,103
4,5,19,13,15,19,9,20,5,109
4,5,19,13,15,19,15,13,5,108
4,5,19,13,15,20,15,13,25,129
4,5,19,15,5,21,22,18,5,114
4,5,19,15,12,1,20,5,0,81
4,5,19,15,12,1,20,5,4,85
4,5,19,15,12,1,20,5,18,99
4,5,19,15,12,1,20,5,19,100
4,5,19,15,12,1,20,15,18,109
4,5,19,15,12,5,0,0,0,60
4,5,19,15,18,2,0,0,0,63
4,5,19,15,18,2,5,4,0,72
4,5,19,15,18,2,9,14,7,93
4,5,19,15,18,2,19,0,0,82
4,5,19,15,24,1,12,9,3,92
4,5,19,16,1,9,18,0,0,72
4,5,19,16,1,9,18,5,4,81
4,5,19,16,1,9,18,5,18,95
4,5,19,16,1,9,18,19,0,91
4,5,19,16,1,18,16,12,5,96
4,5,19,16,1,20,3,8,0,76
4,5,19,16,5,3,8,5,0,65
4,5,19,16,5,3,20,0,0,72
4,5,19,16,5,5,4,0,0,58
4,5,19,16,5,14,4,0,0,67
4,5,19,16,5,18,1,3,25,96
4,5,19,16,5,18,1,4,15,87
4,5,19,16,5,18,1,20,5,93
4,5,19,16,5,18,20,0,0,87
4,5,19,16,9,14,0,0,0,67
4,5,19,16,9,19,1,12,0,85
4,5,19,16,9,19,5,0,0,77
4,5,19,16,9,19,5,4,0,81
4,5,19,16,9,19,5,18,0,95
4,5,19,16,9,19,5,18,19,114
4,5,19,16,9,19,5,19,0,96
4,5,19,16,9,19,9,14,7,102
4,5,19,16,9,20,5,0,0,78
4,5,19,16,9,20,5,4,0,82
4,5,19,16,9,20,5,19,0,97
4,5,19,16,9,20,9,14,7,103
4,5,19,16,9,20,15,21,19,128
4,5,19,16,15,9,12,0,0,80
4,5,19,16,15,9,12,5,4,89
4,5,19,16,15,9,12,5,18,103
4,5,19,16,15,9,12,19,0,99
4,5,19,16,15,14,4,0,0,77
4,5,19,16,15,14,4,5,4,86
4,5,19,16,15,14,4,5,18,100
4,5,19,16,15,14,4,19,0,96
4,5,19,16,15,19,5,0,0,83
4,5,19,16,15,20,0,0,0,79
4,5,19,16,15,20,1,20,0,100
4,5,19,16,15,20,9,3,0,91
4,5,19,16,15,20,9,19,13,120
4,5,19,16,15,20,9,19,20,127
4,5,19,16,15,20,9,26,5,119
4,5,19,16,15,20,19,0,0,98
4,5,19,16,15,21,19,5,0,104
4,5,19,16,18,1,9,19,5,96
4,5,19,16,21,13,1,20,5,104
4,5,19,16,21,13,5,0,0,83
4,5,19,18,1,25,0,0,0,72
4,5,19,19,0,0,0,0,0,47
4,5,19,19,1,0,0,0,0,48
4,5,19,19,5,18,20,0,0,90
4,5,19,19,5,18,20,19,0,109
4,5,19,19,9,3,1,20,5,85
4,5,19,19,9,12,0,0,0,68
4,5,19,19,15,21,19,0,0,102
4,5,19,19,21,19,0,0,0,87
4,5,19,20,1,9,14,0,0,72
4,5,19,20,1,9,14,5,4,81
4,5,19,20,1,9,14,19,0,91
4,5,19,20,5,13,16,5,18,105
4,5,19,20,9,14,1,12,0,84
4,5,19,20,9,14,1,20,5,97
4,5,19,20,9,14,5,0,0,76
4,5,19,20,9,14,5,4,0,80
4,5,19,20,9,14,5,19,0,95
4,5,19,20,9,14,9,5,19,104
4,5,19,20,9,14,9,14,7,101
4,5,19,20,9,14,9,19,13,112
4,5,19,20,9,14,9,19,20,119
4,5,19,20,9,20,21,20,5,123
4,5,19,20,15,0,0,0,0,63
4,5,19,20,15,15,12,0,0,90
4,5,19,20,15,21,18,0,0,102
4,5,19,20,18,5,18,0,0,89
4,5,19,20,18,5,19,19,0,109
4,5,19,20,18,25,0,0,0,91
4,5,19,20,18,9,5,18,0,98
4,5,19,20,18,9,5,18,19,117
4,5,19,20,18,15,25,0,0,106
4,5,19,20,18,15,25,5,4,115
4,5,19,20,18,15,25,5,18,129
4,5,19,20,18,15,25,19,0,125
4,5,19,20,18,21,3,20,0,110
4,5,19,20,18,21,3,20,19,129
4,5,19,20,18,21,4,15,0,106
4,5,19,20,21,6,6,0,0,81
4,5,19,20,21,6,6,19,0,100
4,5,19,21,5,20,5,0,0,79
4,5,19,21,5,20,21,4,5,104
4,5,19,21,7,1,18,0,0,75
4,5,19,21,7,1,18,5,4,84
4,5,19,21,7,1,18,19,0,94
4,5,19,21,12,6,21,18,0,106
4,5,19,21,12,6,21,18,19,125
4,5,19,21,12,16,8,21,18,124
4,5,19,21,12,20,15,18,0,114
4,5,19,21,12,20,15,18,25,139
4,5,19,21,13,5,0,0,0,67
4,5,19,21,22,18,5,0,0,94
4,5,20,1,3,8,0,0,0,41
4,5,20,1,3,8,5,0,0,46
4,5,20,1,3,8,5,4,0,50
4,5,20,1,3,8,5,18,0,64
4,5,20,1,3,8,5,18,19,83
4,5,20,1,3,8,5,19,0,65
4,5,20,1,3,8,9,14,7,71
4,5,20,1,3,8,19,0,0,60
4,5,20,1,9,12,0,0,0,51
4,5,20,1,9,12,5,4,0,60
4,5,20,1,9,12,5,18,0,74
4,5,20,1,9,12,5,18,19,93
4,5,20,1,9,12,9,14,7,81
4,5,20,1,9,12,9,19,13,92
4,5,20,1,9,12,9,19,20,99
4,5,20,1,9,12,19,0,0,70
4,5,20,1,9,14,0,0,0,53
4,5,20,1,9,14,1,12,0,66
4,5,20,1,9,14,5,4,0,62
4,5,20,1,9,14,5,5,0,63
4,5,20,1,9,14,5,5,19,82
4,5,20,1,9,14,5,18,0,76
4,5,20,1,9,14,5,18,19,95
4,5,20,1,9,14,9,14,7,83
4,5,20,1,9,14,19,0,0,72
4,5,20,1,14,20,0,0,0,64
4,5,20,1,18,0,0,0,0,48
4,5,20,1,19,19,5,12,0,85
4,5,20,1,20,0,0,0,0,50
4,5,20,1,24,0,0,0,0,54
4,5,20,4,0,0,0,0,0,33
4,5,20,5,3,20,0,0,0,57
4,5,20,5,3,20,5,4,0,66
4,5,20,5,3,20,5,18,0,80
4,5,20,5,3,20,5,18,19,99
4,5,20,5,3,20,9,14,7,87
4,5,20,5,3,20,9,15,14,95
4,5,20,5,3,20,9,22,5,93
4,5,20,5,3,20,15,18,0,90
4,5,20,5,3,20,15,18,19,109
4,5,20,5,3,20,19,0,0,76
4,5,20,5,14,1,14,20,0,83
4,5,20,5,14,20,0,0,0,68
4,5,20,5,14,20,5,0,0,73
4,5,20,5,14,20,5,19,0,92
4,5,20,5,14,20,9,15,14,106
4,5,20,5,14,20,9,22,5,104
4,5,20,5,14,20,19,0,0,87
4,5,20,5,14,21,0,0,0,69
4,5,20,5,14,21,5,0,0,74
4,5,20,5,14,21,5,19,0,93
4,5,20,5,14,21,19,0,0,88
4,5,20,5,18,0,0,0,0,52
4,5,20,5,18,7,5,0,0,64
4,5,20,5,18,7,5,4,0,68
4,5,20,5,18,7,5,14,20,98
4,5,20,5,18,7,5,18,0,82
4,5,20,5,18,7,5,18,19,101
4,5,20,5,18,7,5,19,0,83
4,5,20,5,18,7,9,14,7,89
4,5,20,5,18,9,14,7,0,82
4,5,20,5,18,13,0,0,0,65
4,5,20,5,18,13,1,0,0,66
4,5,20,5,18,13,5,14,20,104
4,5,20,5,18,13,9,14,5,93
4,5,20,5,18,18,5,4,0,79
4,5,20,5,18,18,5,14,20,109
4,5,20,5,18,18,5,18,0,93
4,5,20,5,18,18,5,18,19,112
4,5,20,5,18,18,9,14,7,100
4,5,20,5,18,19,0,0,0,71
4,5,20,5,18,19,9,15,14,109
4,5,20,5,18,19,9,22,5,107
4,5,20,5,19,20,0,0,0,73
4,5,20,5,19,20,5,4,0,82
4,5,20,5,19,20,5,18,0,96
4,5,20,5,19,20,5,18,19,115
4,5,20,5,19,20,9,14,7,103
4,5,20,5,19,20,19,0,0,92
4,5,20,8,18,15,14,5,0,89
4,5,20,8,18,15,14,5,4,93
4,5,20,8,18,15,14,5,18,107
4,5,20,8,18,15,14,5,19,108
4,5,20,9,0,0,0,0,0,38
4,5,20,9,3,11,0,0,0,52
4,5,20,9,3,11,5,4,0,61
4,5,20,9,3,11,5,18,0,75
4,5,20,9,3,11,5,18,19,94
4,5,20,9,3,11,9,14,7,82
4,5,20,9,3,11,19,0,0,71
4,5,20,9,14,0,0,0,0,52
4,5,20,9,14,5,20,0,0,77
4,5,20,9,14,21,5,0,0,78
4,5,20,9,14,21,5,19,0,97
4,5,20,9,14,21,9,20,0,102
4,5,20,14,0,0,0,0,0,43
4,5,20,15,14,1,2,12,5,78
4,5,20,15,14,1,20,5,0,84
4,5,20,15,14,1,20,5,4,88
4,5,20,15,14,1,20,5,19,103
4,5,20,15,14,1,20,15,18,112
4,5,20,15,14,9,26,5,0,98
4,5,20,15,18,19,9,15,14,119
4,5,20,15,18,20,0,0,0,82
4,5,20,15,21,18,0,0,0,83
4,5,20,15,21,18,5,4,0,92
4,5,20,15,21,18,9,14,7,113
4,5,20,15,21,18,19,0,0,102
4,5,20,15,24,0,0,0,0,68
4,5,20,15,24,5,4,0,0,77
4,5,20,15,24,5,19,0,0,92
4,5,20,15,24,9,6,25,0,108
4,5,20,15,24,9,14,7,0,98
4,5,20,18,1,3,20,0,0,71
4,5,20,18,1,3,20,5,4,80
4,5,20,18,1,3,20,5,18,94
4,5,20,18,1,3,20,15,18,104
4,5,20,18,1,3,20,19,0,90
4,5,20,18,1,25,0,0,0,73
4,5,20,18,1,9,14,0,0,71
4,5,20,18,1,9,14,5,4,80
4,5,20,18,1,9,14,19,0,90
4,5,20,18,1,17,21,5,0,91
4,5,20,18,5,3,20,0,0,75
4,5,20,18,5,14,3,8,0,77
4,5,20,18,9,13,5,14,20,108
4,5,20,18,9,20,1,12,0,89
4,5,20,18,9,20,5,4,0,85
4,5,20,18,9,20,9,15,14,114
4,5,20,18,9,20,21,19,0,116
4,5,20,18,21,3,11,0,0,82
4,5,20,18,21,4,5,0,0,77
4,5,20,18,21,4,5,4,0,81
4,5,20,18,21,4,5,19,0,96
4,5,20,18,21,4,9,14,7,102
4,5,20,18,21,19,9,15,14,125
4,5,20,18,21,19,9,22,5,123
4,5,20,18,21,19,15,18,0,120
4,5,20,18,21,19,19,0,0,106
4,5,20,20,5,0,0,0,0,54
4,5,20,21,14,5,0,0,0,69
4,5,20,21,14,5,4,0,0,73
4,5,20,21,14,9,14,7,0,94
4,5,20,21,18,0,0,0,0,68
4,5,20,21,18,2,0,0,0,70
4,5,20,21,18,14,0,0,0,82
4,5,20,21,18,16,1,20,5,110
4,5,21,3,5,0,0,0,0,38
4,5,21,3,5,4,0,0,0,42
4,5,21,3,5,4,12,25,0,79
4,5,21,3,5,19,0,0,0,57
4,5,21,3,9,14,7,0,0,63
4,5,21,12,0,0,0,0,0,42
4,5,21,14,1,13,0,0,0,58
4,5,21,14,9,20,9,14,7,103
4,5,21,19,1,14,0,0,0,64
4,5,21,20,5,18,1,20,5,99
4,5,21,20,5,18,9,3,0,85
4,5,21,20,5,18,9,4,5,91
4,5,21,20,5,18,9,21,13,116
4,5,21,20,5,18,15,14,0,102
4,5,21,20,5,18,15,14,19,121
4,5,21,20,5,18,15,19,25,132
4,5,21,20,15,13,1,12,1,92
4,5,21,20,15,14,0,0,0,79
4,5,21,20,15,22,21,13,0,121
4,5,21,20,15,24,9,4,5,107
4,5,21,20,19,3,8,5,0,85
4,5,21,20,26,9,1,19,0,105
4,5,21,24,0,0,0,0,0,54
4,5,21,26,1,14,0,0,0,71
4,5,22,1,3,8,1,14,0,58
4,5,22,1,4,1,19,9,0,65
4,5,22,1,12,0,0,0,0,44
4,5,22,1,12,12,0,0,0,56
4,5,22,1,12,15,11,1,0,71
4,5,22,1,12,21,1,20,5,91
4,5,22,1,12,21,5,0,0,70
4,5,22,1,12,21,5,4,0,74
4,5,22,1,12,21,5,19,0,89
4,5,22,1,12,21,9,14,7,95
4,5,22,1,14,3,5,0,0,54
4,5,22,1,14,20,0,0,0,66
4,5,22,1,18,1,10,1,0,62
4,5,22,1,18,19,8,9,0,86
4,5,22,1,19,0,0,0,0,51
4,5,22,1,19,20,0,0,0,71
4,5,22,1,19,20,1,20,5,97
4,5,22,1,19,20,5,18,0,94
4,5,22,1,20,1,0,0,0,53
4,5,22,1,21,12,0,0,0,65
4,5,22,1,21,14,20,0,0,87
4,5,22,3,8,1,18,0,0,61
4,5,22,5,0,0,0,0,0,36
4,5,22,5,9,14,0,0,0,59
4,5,22,5,9,14,5,4,0,68
4,5,22,5,9,14,9,14,7,89
4,5,22,5,9,14,19,0,0,78
4,5,22,5,12,0,0,0,0,48
4,5,22,5,12,5,4,0,0,57
4,5,22,5,12,9,14,0,0,71
4,5,22,5,12,9,14,7,0,78
4,5,22,5,12,15,16,0,0,79
4,5,22,5,12,15,16,5,0,84
4,5,22,5,12,15,16,5,4,88
4,5,22,5,12,15,16,5,18,102
4,5,22,5,12,15,16,5,19,103
4,5,22,5,12,15,16,16,5,100
4,5,22,5,12,15,16,19,0,98
4,5,22,5,12,19,0,0,0,67
4,5,22,5,18,2,1,12,0,69
4,5,22,5,19,20,0,0,0,75
4,5,22,5,19,20,5,4,0,84
4,5,22,5,19,20,9,14,7,105
4,5,22,5,19,20,19,0,0,94
4,5,22,5,24,0,0,0,0,60
4,5,22,5,24,9,20,25,0,114
4,5,22,9,1,2,12,5,0,60
4,5,22,9,1,14,3,5,0,63
4,5,22,9,1,14,3,5,19,82
4,5,22,9,1,14,3,25,0,83
4,5,22,9,1,14,20,0,0,75
4,5,22,9,1,14,20,19,0,94
4,5,22,9,1,20,5,0,0,66
4,5,22,9,1,20,5,4,0,70
4,5,22,9,1,20,5,12,25,103
4,5,22,9,1,20,5,19,0,85
4,5,22,9,1,20,9,14,7,91
4,5,22,9,1,20,9,15,14,99
4,5,22,9,1,20,9,22,5,97
4,5,22,9,1,20,15,18,0,94
4,5,22,9,1,20,15,18,25,119
4,5,22,9,1,20,15,18,19,113
4,5,22,9,3,5,0,0,0,48
4,5,22,9,3,5,6,21,12,87
4,5,22,9,3,5,19,0,0,67
4,5,22,9,4,5,0,0,0,49
4,5,22,9,12,2,9,18,4,85
4,5,22,9,12,4,15,13,0,84
4,5,22,9,12,5,4,0,0,61
4,5,22,9,12,5,18,0,0,75
4,5,22,9,12,5,19,19,0,95
4,5,22,9,12,5,20,0,0,77
4,5,22,9,12,6,9,19,8,94
4,5,22,9,12,8,15,15,4,94
4,5,22,9,12,25,0,0,0,77
4,5,22,9,12,9,14,7,0,82
4,5,22,9,12,9,19,8,0,88
4,5,22,9,12,9,19,13,0,93
4,5,22,9,12,9,20,25,0,106
4,5,22,9,12,9,26,5,0,92
4,5,22,9,12,9,26,5,4,96
4,5,22,9,12,11,9,14,0,86
4,5,22,9,12,11,9,14,19,105
4,5,22,9,12,12,5,4,0,73
4,5,22,9,12,12,9,11,5,89
4,5,22,9,12,12,9,14,7,94
4,5,22,9,12,13,1,14,0,80
4,5,22,9,12,13,5,14,20,104
4,5,22,9,12,18,25,0,0,95
4,5,22,9,12,18,9,5,19,103
4,5,22,9,12,19,0,0,0,71
4,5,22,9,12,19,8,9,16,104
4,5,22,9,12,20,18,25,0,115
4,5,22,9,12,23,1,18,4,98
4,5,22,9,12,23,9,19,5,108
4,5,22,9,12,23,15,15,4,109
4,5,22,9,14,3,20,0,0,77
4,5,22,9,15,21,19,0,0,95
4,5,22,9,15,21,19,12,25,132
4,5,22,9,19,1,2,12,5,79
4,5,22,9,19,1,12,0,0,72
4,5,22,9,19,1,12,19,0,91
4,5,22,9,19,5,0,0,0,64
4,5,22,9,19,5,4,0,0,68
4,5,22,9,19,5,5,0,0,69
4,5,22,9,19,5,5,19,0,88
4,5,22,9,19,5,18,0,0,82
4,5,22,9,19,5,18,19,0,101
4,5,22,9,19,5,19,0,0,83
4,5,22,9,19,9,14,7,0,89
4,5,22,9,19,9,14,7,19,108
4,5,22,9,19,15,18,0,0,92
4,5,22,9,19,15,18,19,0,111
4,5,22,9,20,18,9,6,25,118
4,5,22,15,3,1,20,5,0,75
4,5,22,15,9,3,5,0,0,63
4,5,22,15,9,3,5,4,0,67
4,5,22,15,9,3,5,19,0,82
4,5,22,15,9,3,9,14,7,88
4,5,22,15,9,4,0,0,0,59
4,5,22,15,9,18,0,0,0,73
4,5,22,15,9,18,19,0,0,92
4,5,22,15,12,21,20,5,0,104
4,5,22,15,12,22,5,0,0,85
4,5,22,15,12,22,5,4,0,89
4,5,22,15,12,22,5,19,0,104
4,5,22,15,12,22,9,14,7,110
4,5,22,15,14,9,20,5,0,94
4,5,22,15,14,19,0,0,0,79
4,5,22,15,20,0,0,0,0,66
4,5,22,15,20,1,0,0,0,67
4,5,22,15,20,1,18,25,0,110
4,5,22,15,20,5,0,0,0,71
4,5,22,15,20,5,4,0,0,75
4,5,22,15,20,5,4,12,25,112
4,5,22,15,20,5,5,0,0,76
4,5,22,15,20,5,5,19,0,95
4,5,22,15,20,5,18,0,0,89
4,5,22,15,20,5,19,0,0,90
4,5,22,15,20,9,14,7,0,96
4,5,22,15,20,9,15,14,0,104
4,5,22,15,20,9,15,14,19,123
4,5,22,15,20,15,0,0,0,81
4,5,22,15,21,18,0,0,0,85
4,5,22,15,21,18,5,4,0,94
4,5,22,15,21,18,5,18,0,108
4,5,22,15,21,18,5,18,19,127
4,5,22,15,21,18,5,19,19,128
4,5,22,15,21,18,9,14,7,115
4,5,22,15,21,18,19,0,0,104
4,5,22,15,21,20,0,0,0,87
4,5,22,15,21,20,5,18,0,110
4,5,22,15,21,20,6,21,12,126
4,5,22,15,21,20,12,25,0,124
4,5,22,15,22,5,0,0,0,73
4,5,22,15,23,0,0,0,0,69
4,5,22,19,0,0,0,0,0,50
4,5,22,22,5,12,0,0,0,70
4,5,22,23,19,15,18,0,0,106
4,5,23,1,12,0,0,0,0,45
4,5,23,1,14,0,0,0,0,47
4,5,23,1,14,5,5,0,0,57
4,5,23,1,14,9,0,0,0,56
4,5,23,1,14,14,25,0,0,86
4,5,23,1,14,19,0,0,0,66
4,5,23,1,14,19,8,9,16,99
4,5,23,1,18,19,0,0,0,70
4,5,23,1,20,1,0,0,0,54
4,5,23,1,20,5,18,0,0,76
4,5,23,1,20,5,18,5,4,85
4,5,23,1,20,5,18,5,18,99
4,5,23,1,20,5,18,19,0,95
4,5,23,1,24,0,0,0,0,57
4,5,23,1,24,5,4,0,0,66
4,5,23,1,24,5,19,0,0,81
4,5,23,1,24,9,14,7,0,87
4,5,23,2,5,1,13,0,0,53
4,5,23,2,5,18,18,25,0,100
4,5,23,3,1,16,0,0,0,52
4,5,23,3,12,1,23,0,0,71
4,5,23,3,12,1,23,5,4,80
4,5,23,3,12,1,23,19,0,90
4,5,23,3,21,16,0,0,0,72
4,5,23,4,1,13,16,0,0,66
4,5,23,4,18,15,16,0,0,85
4,5,23,4,18,15,16,19,0,104
4,5,23,5,4,0,0,0,0,41
4,5,23,5,25,12,9,20,5,108
4,5,23,5,18,0,0,0,0,55
4,5,23,6,1,12,12,0,0,63
4,5,23,6,1,12,12,19,0,82
4,5,23,6,12,15,23,5,18,111
4,5,23,25,0,0,0,0,0,57
4,5,23,9,5,18,0,0,0,64
4,5,23,9,5,19,20,0,0,85
4,5,23,9,12,25,0,0,0,78
4,5,23,9,14,5,19,19,0,98
4,5,23,9,14,7,0,0,0,62
4,5,23,12,1,16,0,0,0,61
4,5,23,12,1,16,16,5,4,86
4,5,23,12,1,16,19,0,0,80
4,5,23,12,5,19,19,0,0,87
4,5,23,12,9,7,8,20,0,88
4,5,23,12,9,11,5,0,0,69
4,5,23,15,15,12,0,0,0,74
4,5,23,15,15,12,5,4,0,83
4,5,23,15,15,12,9,14,7,104
4,5,23,15,15,12,19,0,0,93
4,5,23,15,18,13,0,0,0,78
4,5,23,15,18,13,5,4,0,87
4,5,23,15,18,13,9,14,7,108
4,5,23,15,18,13,19,0,0,97
4,5,23,18,5,20,0,0,0,75
4,5,23,18,15,20,0,0,0,85
4,5,23,19,0,0,0,0,0,51
4,5,23,20,18,25,0,0,0,95
4,5,23,23,15,18,13,0,0,101
4,5,24,5,19,0,0,0,0,57
4,5,24,25,0,0,0,0,0,58
4,5,24,9,5,0,0,0,0,47
4,5,24,9,5,19,0,0,0,66
4,5,24,20,5,18,9,20,25,130
4,5,24,20,5,18,15,21,19,131
4,5,24,20,15,18,19,1,12,118
4,5,24,20,18,1,4,0,0,76
4,5,24,20,18,1,12,0,0,84
4,5,24,20,18,1,12,12,25,121
4,5,24,20,18,1,14,0,0,86
4,5,24,20,18,1,14,5,0,91
4,5,24,20,18,1,14,19,0,105
4,5,24,20,18,5,18,0,0,94
4,5,24,20,18,9,14,0,0,94
4,5,24,20,18,9,14,5,0,99
4,5,24,20,18,9,14,5,19,118
4,5,24,20,18,9,14,19,0,113
4,5,24,20,18,15,0,0,0,86
4,5,24,20,18,15,18,19,5,128
4,5,24,20,18,15,19,5,0,110
4,5,24,20,18,15,19,5,19,129
4,5,24,20,18,15,21,19,0,126
4,5,26,9,14,3,0,0,0,61
4,5,26,9,14,3,5,4,0,70
4,5,26,9,14,3,9,6,25,101
4,5,26,9,14,3,9,14,7,91
4,5,26,9,14,3,11,5,4,81
4,5,26,9,14,3,19,0,0,80
4,5,26,9,14,11,9,6,25,109
4,7,8,1,9,19,1,0,0,49
4,8,5,18,9,0,0,0,0,44
4,8,25,1,12,0,0,0,0,50
4,8,25,1,14,1,0,0,0,53
4,8,9,11,18,0,0,0,0,50
4,8,9,11,18,19,0,0,0,69
4,8,15,2,5,5,0,0,0,39
4,8,15,2,5,25,0,0,0,59
4,8,15,2,9,0,0,0,0,38
4,8,15,2,25,0,0,0,0,54
4,8,15,2,9,5,0,0,0,43
4,8,15,2,9,5,19,0,0,62
4,8,15,2,9,19,0,0,0,57
4,8,15,12,5,0,0,0,0,44
4,8,15,12,5,19,0,0,0,63
4,8,15,14,5,25,0,0,0,71
4,8,15,14,9,0,0,0,0,50
4,8,15,15,12,5,25,0,0,84
4,8,15,15,12,25,0,0,0,79
4,8,15,15,12,9,5,19,0,87
4,8,15,15,14,0,0,0,0,56
4,8,15,15,18,1,0,0,0,61
4,8,15,15,18,1,19,0,0,80
4,8,15,15,20,9,0,0,0,71
4,8,15,15,20,9,5,0,0,76
4,8,15,15,20,9,5,19,0,95
4,8,15,15,20,9,19,0,0,90
4,8,15,20,5,5,0,0,0,57
4,8,15,20,9,0,0,0,0,56
4,8,15,20,25,0,0,0,0,72
4,8,15,20,9,19,0,0,0,75
4,8,15,21,12,0,0,0,0,60
4,8,15,21,18,18,1,0,0,85
4,8,15,21,18,18,1,19,0,104
4,8,15,23,0,0,0,0,0,50
4,8,15,23,19,0,0,0,0,69
4,8,21,14,3,8,5,5,0,68
4,8,21,14,3,8,9,0,0,67
4,8,21,18,14,1,0,0,0,66
4,8,21,18,14,1,19,0,0,85
4,8,21,18,18,1,0,0,0,70
4,8,21,18,18,25,0,0,0,94
4,8,21,18,18,9,5,0,0,83
4,8,21,18,18,9,5,19,0,102
4,8,21,20,9,0,0,0,0,62
4,8,21,20,9,19,0,0,0,81
4,9,2,1,19,5,0,0,0,40
4,9,2,1,19,9,3,0,0,47
4,9,2,1,20,1,7,0,0,44
4,9,2,2,5,4,0,0,0,26
4,9,2,2,5,18,0,0,0,40
4,9,2,2,5,18,19,0,0,59
4,9,2,2,9,14,7,0,0,47
4,9,2,2,12,5,0,0,0,34
4,9,2,2,12,5,4,0,0,38
4,9,2,2,12,5,18,0,0,52
4,9,2,2,12,5,18,19,0,71
4,9,2,2,12,5,19,0,0,53
4,9,2,2,12,9,14,7,0,59
4,9,2,2,21,11,0,0,0,49
4,25,2,2,21,11,0,0,0,65
4,9,2,2,21,11,9,13,0,71
4,25,2,2,21,11,9,13,0,87
4,9,2,2,21,11,19,0,0,68
4,25,2,2,21,11,19,0,0,84
4,9,2,5,14,26,25,12,0,97
4,9,2,5,14,26,15,25,12,112
4,9,2,8,15,12,5,0,0,55
4,9,2,15,18,1,20,5,0,74
4,9,2,18,1,3,8,0,0,45
4,9,2,18,1,14,3,8,0,59
4,9,2,18,15,13,0,0,0,61
4,9,2,18,15,13,9,4,0,74
4,9,2,18,15,13,9,4,5,79
4,9,2,19,0,0,0,0,0,34
4,9,2,19,20,15,14,5,0,88
4,9,2,19,20,15,14,5,19,107
4,9,2,21,3,1,9,14,5,68
4,9,2,21,20,25,12,0,0,93
4,9,2,21,20,25,18,9,14,122
4,9,3,1,3,9,20,25,0,74
4,9,3,1,3,15,4,25,12,76
4,9,3,1,12,3,9,3,0,44
4,9,3,1,12,3,9,21,13,75
4,9,3,1,18,25,15,14,0,89
4,9,3,1,19,20,0,0,0,56
4,9,3,1,19,20,5,18,25,104
4,9,3,1,19,20,9,3,0,68
4,9,3,1,19,20,19,0,0,75
4,9,3,5,2,15,1,18,4,61
4,9,3,5,2,15,24,0,0,62
4,9,3,5,3,21,16,0,0,61
4,9,3,5,4,0,0,0,0,25
4,9,3,5,25,0,0,0,0,46
4,9,3,5,12,12,1,20,5,71
4,9,3,5,13,1,14,0,0,49
4,9,3,5,14,20,18,1,19,93
4,9,3,5,14,20,18,9,14,96
4,9,3,5,16,12,1,25,0,75
4,9,3,5,18,0,0,0,0,39
4,9,3,5,18,9,15,14,0,77
4,9,3,5,18,15,21,19,0,94
4,9,3,5,18,19,0,0,0,58
4,9,3,5,19,0,0,0,0,40
4,9,3,5,20,25,12,0,0,78
4,9,3,8,1,19,0,0,0,44
4,9,3,8,1,19,9,1,0,54
4,9,3,8,1,19,9,1,12,66
4,9,3,8,1,19,9,21,13,87
4,9,3,8,1,19,20,9,3,76
4,9,3,8,12,15,14,5,0,70
4,9,3,8,15,7,1,13,25,85
4,9,3,8,15,16,20,9,3,87
4,9,3,8,15,18,4,0,0,61
4,9,3,8,15,18,5,5,0,67
4,9,3,8,15,20,9,3,0,71
4,9,3,8,15,20,15,13,25,112
4,9,3,8,18,15,9,3,0,69
4,9,3,8,18,15,9,19,13,98
4,9,3,8,18,15,9,20,5,91
4,9,3,8,18,15,13,1,20,91
4,9,3,8,18,15,13,9,3,82
4,9,3,8,18,15,15,21,19,112
4,9,3,8,20,0,0,0,0,44
4,9,3,25,1,14,0,0,0,56
4,9,3,25,1,14,9,4,0,69
4,9,3,25,1,14,9,4,5,74
4,9,3,25,1,14,9,14,0,79
4,9,3,25,1,14,9,14,5,84
4,9,3,25,3,12,5,0,0,61
4,9,3,25,3,12,25,0,0,81
4,9,3,25,3,12,9,3,0,68
4,9,3,25,3,12,9,5,19,89
4,9,3,25,3,12,9,19,20,104
4,9,3,25,5,13,9,4,0,72
4,9,3,9,5,18,0,0,0,48
4,9,3,9,5,19,20,0,0,69
4,9,3,9,14,7,0,0,0,46
4,9,3,11,5,4,0,0,0,36
4,9,3,11,5,25,19,0,0,76
4,9,3,11,5,14,19,5,19,89
4,9,3,11,5,18,0,0,0,50
4,9,3,11,5,18,5,4,0,59
4,9,3,11,5,18,9,14,7,80
4,9,3,11,5,18,19,0,0,69
4,9,3,11,25,2,9,18,4,85
4,9,3,11,9,5,18,0,0,59
4,9,3,11,9,5,19,0,0,60
4,9,3,11,9,5,19,20,0,80
4,9,3,11,9,14,7,0,0,57
4,9,3,11,9,20,5,0,0,61
4,9,3,11,20,25,0,0,0,72
4,9,3,12,5,19,9,21,13,95
4,9,3,12,9,14,25,0,0,76
4,9,3,12,9,14,9,3,0,63
4,9,3,12,9,14,9,5,19,84
4,9,3,12,9,14,9,19,13,92
4,9,3,12,9,14,15,21,19,106
4,9,3,15,3,3,15,21,19,92
4,9,3,15,4,5,9,14,5,68
4,9,3,15,5,12,15,21,19,103
4,9,3,15,12,9,3,0,0,55
4,9,3,15,12,15,14,0,0,72
4,9,3,15,16,8,1,14,5,75
4,9,3,15,20,0,0,0,0,51
4,9,3,15,20,25,12,0,0,88
4,9,3,15,20,25,12,19,0,107
4,9,3,15,20,19,0,0,0,70
4,9,3,18,1,14,15,9,4,77
4,9,3,18,15,20,1,12,0,82
4,9,3,18,15,20,9,3,0,81
4,9,3,18,15,20,9,19,13,110
4,9,3,18,15,20,15,21,19,124
4,9,3,20,0,0,0,0,0,36
4,9,3,20,1,0,0,0,0,37
4,9,3,20,1,13,5,14,0,69
4,9,3,20,1,13,9,14,1,74
4,9,3,20,1,20,5,0,0,62
4,9,3,20,1,20,5,4,0,66
4,9,3,20,1,20,5,19,0,81
4,9,3,20,1,20,9,14,7,87
4,9,3,20,1,20,9,15,14,95
4,9,3,20,1,20,9,22,5,93
4,9,3,20,1,20,15,18,0,90
4,9,3,20,1,20,15,18,25,115
4,9,3,20,1,20,15,18,19,109
4,9,3,20,1,20,18,9,24,108
4,9,3,20,1,20,21,18,5,101
4,9,3,20,5,18,25,0,0,84
4,9,3,20,25,0,0,0,0,61
4,9,3,20,9,3,0,0,0,48
4,9,3,20,9,5,18,0,0,68
4,9,3,20,9,5,19,20,0,89
4,9,3,20,25,14,9,4,0,88
4,9,3,20,25,15,7,5,14,102
4,9,3,20,25,15,9,4,0,89
4,9,3,20,9,15,14,0,0,74
4,9,3,20,9,15,14,1,12,87
4,9,3,20,9,15,14,19,0,93
4,9,3,20,25,15,20,9,3,108
4,9,3,20,21,13,0,0,0,70
4,9,3,20,21,13,19,0,0,89
4,9,4,1,3,20,0,0,0,41
4,9,4,1,3,20,9,3,0,53
4,9,4,1,3,20,9,3,19,72
4,9,4,1,3,20,25,12,0,78
4,9,4,1,3,20,9,22,5,77
4,9,4,1,3,20,19,0,0,60
4,9,4,1,12,0,0,0,0,30
4,9,4,1,16,16,5,18,0,73
4,9,4,1,16,16,5,18,19,92
4,9,4,1,19,3,1,12,25,78
4,9,4,4,5,18,0,0,0,44
4,9,4,4,5,18,5,4,0,53
4,9,4,4,5,18,9,14,7,74
4,9,4,4,5,19,20,0,0,65
4,9,4,4,25,0,0,0,0,46
4,9,4,4,9,5,19,0,0,54
4,9,4,4,9,11,1,9,0,51
4,9,4,4,12,5,0,0,0,38
4,9,4,4,12,5,4,0,0,42
4,9,4,4,12,5,25,0,0,63
4,9,4,4,12,5,18,0,0,56
4,9,4,4,12,5,18,19,0,75
4,9,4,4,12,5,19,0,0,57
4,9,4,4,12,25,0,0,0,58
4,9,4,4,12,9,5,19,0,66
4,9,4,4,12,9,14,7,0,63
4,9,4,5,12,16,8,0,0,58
4,9,4,5,12,16,8,9,3,70
4,9,4,5,12,16,8,9,4,71
4,9,4,5,16,19,9,4,0,70
4,9,4,5,16,19,9,4,5,75
4,9,4,5,19,20,0,0,0,61
4,9,4,25,0,0,0,0,0,42
4,9,4,9,3,15,25,0,0,69
4,9,4,9,5,0,0,0,0,31
4,9,4,9,5,19,0,0,0,50
4,9,4,25,13,0,0,0,0,55
4,9,4,25,13,1,20,5,0,81
4,9,4,25,13,9,1,0,0,65
4,9,4,25,13,9,19,0,0,83
4,9,4,25,13,9,20,9,19,112
4,9,4,25,13,9,21,13,0,98
4,9,4,25,13,9,21,13,19,117
4,9,4,25,13,15,9,4,0,83
4,9,4,25,13,15,21,19,0,110
4,9,4,25,13,21,19,0,0,95
4,9,4,25,14,1,13,25,0,95
4,9,4,25,14,1,13,9,3,82
4,9,4,9,14,5,0,0,0,45
4,9,4,12,5,0,0,0,0,34
4,9,4,12,5,18,0,0,0,52
4,9,4,14,0,0,0,0,0,31
4,9,4,14,1,0,0,0,0,32
4,9,4,14,20,0,0,0,0,51
4,9,4,15,5,19,0,0,0,56
4,9,4,15,14,9,1,0,0,56
4,9,4,15,19,0,0,0,0,51
4,9,4,18,1,3,8,13,0,60
4,9,4,18,1,3,8,13,1,61
4,9,4,18,9,3,0,0,0,47
4,9,4,18,15,13,25,0,0,88
4,9,4,18,15,13,9,5,19,96
4,9,4,19,20,0,0,0,0,56
4,9,4,21,3,5,0,0,0,46
4,9,4,21,3,5,4,0,0,50
4,9,4,21,3,9,14,7,0,71
4,9,4,21,3,20,9,15,14,99
4,9,4,21,3,20,15,18,0,94
4,25,5,0,0,0,0,0,0,34
4,25,5,1,2,12,5,0,0,54
4,9,5,2,0,0,0,0,0,20
4,9,5,2,1,3,11,0,0,35
4,9,5,2,1,3,11,19,0,54
4,25,5,2,5,3,11,0,0,55
4,9,5,3,1,19,5,0,0,46
4,9,5,3,9,15,21,19,0,85
4,9,5,3,20,1,19,9,19,89
4,9,5,4,0,0,0,0,0,22
4,25,5,4,0,0,0,0,0,38
4,9,5,4,18,1,12,0,0,53
4,9,5,4,18,9,3,0,0,52
4,9,5,7,5,19,9,19,0,77
4,9,5,8,1,18,4,0,0,49
4,9,5,8,1,18,4,19,0,68
4,25,5,8,15,21,19,5,0,102
4,9,5,9,14,7,0,0,0,48
4,25,5,9,14,7,0,0,0,64
4,25,5,9,14,7,19,0,0,83
4,9,5,12,0,0,0,0,0,30
4,9,5,12,4,18,9,14,0,75
4,9,5,12,4,18,9,14,19,94
4,25,5,12,5,1,22,5,19,98
4,9,5,12,5,3,0,0,0,38
4,9,5,12,9,11,5,0,0,55
4,25,5,12,9,14,5,0,0,74
4,9,5,13,0,0,0,0,0,31
4,9,5,13,1,11,5,18,0,66
4,25,5,13,1,11,5,18,0,82
4,9,5,13,1,11,5,18,19,85
4,9,5,13,1,11,9,14,7,73
4,25,5,13,1,11,9,14,7,89
4,9,5,14,5,0,0,0,0,37
4,9,5,14,5,18,0,0,0,55
4,9,5,14,5,19,0,0,0,56
4,9,5,18,0,0,0,0,0,36
4,9,5,18,5,19,5,19,0,84
4,9,5,18,5,19,9,19,0,88
4,9,5,18,5,20,9,3,0,73
4,25,5,18,19,0,0,0,0,71
4,25,5,19,0,0,0,0,0,53
4,9,5,19,5,12,5,4,0,63
4,9,5,19,5,12,9,26,5,94
4,9,5,19,5,12,19,0,0,73
4,9,5,19,5,19,0,0,0,61
4,9,5,19,9,14,11,5,18,94
4,9,5,19,9,19,0,0,0,65
4,9,5,19,20,5,18,0,0,80
4,25,5,19,20,5,18,0,0,96
4,9,5,19,20,5,18,19,0,99
4,9,5,19,20,15,3,11,0,86
4,9,5,19,20,15,3,11,19,105
4,9,5,19,20,18,15,21,19,130
4,9,5,19,20,18,21,1,12,109
4,9,5,19,20,18,21,13,0,109
4,9,5,19,20,18,21,13,19,128
4,9,5,19,20,18,21,19,0,115
4,25,5,19,20,21,6,6,0,106
4,25,5,19,20,21,6,6,19,125
4,9,5,20,1,12,0,0,0,51
4,9,5,20,1,18,25,0,0,82
4,9,5,20,1,18,9,1,14,81
4,9,5,20,1,18,9,5,19,90
4,9,5,20,1,18,9,12,25,103
4,9,5,20,5,4,0,0,0,47
4,9,5,20,5,18,19,0,0,80
4,9,5,20,5,20,9,3,0,75
4,9,5,20,5,20,9,3,19,94
4,9,5,20,5,20,9,19,20,111
4,9,5,20,8,5,18,0,0,69
4,9,5,20,8,5,18,19,0,88
4,9,5,20,8,25,12,0,0,83
4,9,5,20,25,0,0,0,0,63
4,9,5,20,9,3,0,0,0,50
4,9,5,20,9,3,1,12,0,63
4,9,5,20,9,3,9,1,14,74
4,9,5,20,9,3,19,0,0,69
4,9,5,20,9,5,19,0,0,71
4,9,5,20,9,14,5,0,0,66
4,9,5,20,9,14,7,0,0,68
4,9,5,20,9,19,20,0,0,86
4,9,5,20,9,20,9,1,14,91
4,9,5,20,19,0,0,0,0,57
4,9,5,20,20,5,4,0,0,67
4,9,5,20,26,5,9,20,5,103
4,9,5,21,7,1,18,4,0,69
4,25,5,23,1,18,5,0,0,81
4,25,5,23,5,5,4,0,0,71
4,25,5,23,5,5,4,19,0,90
4,9,5,23,9,19,5,0,0,74
4,25,5,23,15,15,4,0,0,91
4,25,5,23,15,15,4,19,0,110
4,9,6,5,18,18,9,15,14,98
4,9,6,6,0,0,0,0,0,25
4,9,6,6,1,13,5,0,0,44
4,9,6,6,5,18,0,0,0,48
4,9,6,6,5,18,5,4,0,57
4,9,6,6,5,18,5,14,0,67
4,9,6,6,5,18,5,14,20,87
4,9,6,6,5,18,5,18,0,71
4,9,6,6,5,18,5,18,19,90
4,9,6,6,5,18,9,14,7,78
4,9,6,6,5,18,19,0,0,67
4,9,6,6,9,3,9,12,5,63
4,9,6,6,9,3,21,12,20,90
4,9,6,6,9,4,5,0,0,43
4,9,6,6,9,4,5,4,0,47
4,9,6,6,9,4,5,14,20,77
4,9,6,6,9,4,9,14,7,68
4,9,6,6,9,14,9,20,25,102
4,9,6,6,12,21,5,14,20,97
4,9,6,6,15,18,13,0,0,71
4,9,6,6,15,18,13,5,0,76
4,9,6,6,15,18,13,5,4,80
4,9,6,6,18,1,3,20,0,67
4,9,6,6,18,1,3,20,19,86
4,9,6,6,21,14,4,0,0,64
4,9,6,6,21,19,1,20,5,91
4,9,6,6,21,19,5,0,0,70
4,9,6,6,21,19,5,4,0,74
4,9,6,6,21,19,5,12,25,107
4,9,6,6,21,19,5,18,0,88
4,9,6,6,21,19,5,18,19,107
4,9,6,6,21,19,5,19,0,89
4,9,6,6,21,19,9,14,7,95
4,9,6,6,21,19,9,15,14,103
4,9,6,6,21,19,9,22,5,101
4,9,6,6,21,19,15,18,0,98
4,9,6,6,21,19,15,18,19,117
4,9,6,12,21,5,14,3,5,79
4,9,6,15,18,13,9,14,0,88
4,9,7,0,0,0,0,0,0,20
4,9,7,1,12,12,1,20,5,71
4,9,7,1,12,12,9,3,0,57
4,9,7,1,13,5,20,9,3,71
4,9,7,1,13,25,0,0,0,59
4,9,7,1,13,9,5,19,0,67
4,9,7,1,13,9,19,20,0,82
4,9,7,1,13,9,19,20,19,101
4,9,7,1,13,13,1,0,0,48
4,9,7,1,13,13,1,19,0,67
4,9,7,1,13,13,1,20,5,73
4,9,7,1,13,13,9,3,0,59
4,9,7,1,13,15,21,19,0,89
4,9,7,1,19,20,18,9,3,90
4,9,7,5,14,5,15,21,19,99
4,9,7,5,14,5,19,9,19,91
4,9,7,5,14,5,20,9,3,76
4,9,7,5,14,25,0,0,0,64
4,9,7,5,14,9,3,0,0,51
4,9,7,5,14,9,20,5,0,73
4,9,7,5,14,15,21,19,0,94
4,9,7,5,18,5,14,20,0,82
4,9,7,5,19,20,1,14,20,99
4,9,7,5,19,20,5,4,0,73
4,9,7,5,19,20,5,18,0,87
4,9,7,5,19,20,5,18,19,106
4,9,7,5,19,20,9,6,0,79
4,9,7,5,19,20,9,14,7,94
4,9,7,5,19,20,9,15,14,102
4,9,7,5,19,20,9,22,5,100
4,9,7,5,19,20,15,18,0,97
4,9,7,5,19,20,15,18,25,122
4,9,7,5,19,20,15,18,19,116
4,9,7,5,19,20,19,0,0,83
4,9,7,5,19,20,21,18,5,108
4,9,7,7,1,2,12,5,0,47
4,9,7,7,5,4,0,0,0,36
4,9,7,7,9,14,7,0,0,57
4,9,7,7,9,14,7,19,0,76
4,9,7,8,20,0,0,0,0,48
4,9,7,8,20,5,4,0,0,57
4,9,7,8,20,5,18,0,0,71
4,9,7,8,20,9,14,7,0,78
4,9,7,8,20,19,0,0,0,67
4,9,7,25,14,9,1,14,0,83
4,9,7,25,14,15,21,19,0,114
4,9,7,9,20,0,0,0,0,49
4,9,7,9,20,1,12,0,0,62
4,9,7,9,20,1,12,9,3,74
4,9,7,9,20,1,12,9,14,85
4,9,7,9,20,1,12,9,19,90
4,9,7,9,20,1,12,12,25,99
4,9,7,9,20,1,12,19,0,81
4,9,7,9,20,1,20,5,0,75
4,9,7,9,20,1,20,5,4,79
4,9,7,9,20,9,19,5,0,82
4,9,7,9,20,9,19,5,4,86
4,9,7,9,20,9,26,5,0,89
4,9,7,9,20,9,26,5,4,93
4,9,7,9,20,9,26,5,18,107
4,9,7,9,20,9,26,5,19,108
4,9,7,9,20,15,14,9,14,101
4,9,7,9,20,15,24,9,14,111
4,9,7,9,20,18,15,14,0,96
4,9,7,9,20,19,0,0,0,68
4,9,7,9,20,21,12,5,0,87
4,9,7,9,20,21,19,0,0,89
4,9,7,12,25,16,8,0,0,81
4,9,7,12,25,16,8,9,3,93
4,9,7,12,15,19,19,9,1,95
4,9,7,12,15,20,0,0,0,67
4,9,7,12,15,20,19,0,0,86
4,9,7,12,15,20,20,9,3,99
4,9,7,13,5,1,20,0,0,59
4,9,7,14,1,20,9,15,14,93
4,9,7,14,5,0,0,0,0,39
4,9,7,14,9,6,25,0,0,74
4,9,7,14,9,6,9,5,4,67
4,9,7,14,9,6,9,5,19,82
4,9,7,14,9,20,1,18,25,107
4,9,7,14,9,20,1,19,0,83
4,9,7,14,9,20,25,0,0,88
4,9,7,14,9,20,9,5,19,96
4,9,7,14,15,19,3,5,0,76
4,9,7,14,15,19,12,5,0,85
4,9,7,14,15,20,9,15,14,107
4,25,7,15,7,18,1,13,0,90
4,9,7,15,14,1,12,0,0,62
4,9,7,15,14,15,21,19,0,104
4,9,7,15,24,9,14,0,0,82
4,9,7,15,24,9,14,19,0,101
4,9,7,18,1,13,0,0,0,52
4,9,7,18,1,16,8,0,0,63
4,9,7,18,1,16,8,9,3,75
4,9,7,18,1,16,8,19,0,82
4,9,7,18,5,19,19,0,0,81
4,9,7,18,5,19,19,5,4,90
4,9,7,18,5,19,19,5,18,104
4,9,7,18,5,19,19,5,19,105
4,9,7,19,0,0,0,0,0,39
4,9,7,21,1,14,9,4,5,74
4,9,7,21,5,0,0,0,0,46
4,9,8,1,12,9,4,0,0,47
4,9,8,1,12,9,4,5,0,52
4,9,8,1,12,15,0,0,0,49
4,9,8,1,12,15,7,5,14,75
4,9,8,5,4,18,1,12,0,61
4,9,8,5,4,18,1,12,19,80
4,9,8,5,4,18,15,14,0,77
4,9,8,5,4,18,15,14,19,96
4,9,8,5,12,25,0,0,0,63
4,9,8,5,12,9,15,19,0,81
4,9,8,5,12,9,21,13,0,81
4,9,8,25,2,18,9,4,0,79
4,9,8,25,2,18,9,4,19,98
4,9,8,25,4,18,1,20,5,94
4,9,8,25,4,18,9,3,0,80
4,9,8,25,4,18,9,4,5,86
4,9,8,25,4,18,9,20,5,102
4,9,8,25,4,18,15,12,0,95
4,9,8,25,4,18,15,24,25,132
4,9,9,1,13,2,0,0,0,38
4,9,9,1,13,2,21,19,0,78
4,25,9,14,7,0,0,0,0,59
4,25,9,14,7,12,25,0,0,96
4,25,9,14,7,14,5,19,19,116
4,25,9,14,7,19,0,0,0,78
4,9,9,15,4,9,4,0,0,54
4,9,9,15,4,9,4,5,0,59
4,9,9,15,4,15,0,0,0,56
4,9,11,1,0,0,0,0,0,25
4,9,11,1,7,5,0,0,0,37
4,25,11,1,7,5,0,0,0,53
4,9,11,1,13,1,12,9,0,60
4,9,11,1,13,1,12,12,9,72
4,9,11,1,18,25,15,14,0,97
4,9,11,1,19,20,0,0,0,64
4,9,11,4,9,11,0,0,0,48
4,9,11,4,9,11,19,0,0,67
4,9,11,5,4,0,0,0,0,33
4,25,11,5,4,0,0,0,0,49
4,9,11,5,7,18,1,22,5,82
4,9,11,5,25,0,0,0,0,54
4,25,11,5,25,0,0,0,0,70
4,9,11,5,12,5,20,0,0,66
4,9,11,5,18,0,0,0,0,47
4,25,11,5,18,0,0,0,0,63
4,9,11,5,18,5,5,22,5,84
4,25,11,5,18,5,5,22,5,100
4,9,11,5,18,9,1,0,0,57
4,9,11,5,18,9,15,14,0,85
4,9,11,5,18,19,0,0,0,66
4,9,11,5,19,0,0,0,0,48
4,25,11,5,19,0,0,0,0,64
4,9,11,5,19,9,4,5,0,66
4,9,11,5,20,5,14,5,0,73
4,9,11,5,20,15,0,0,0,64
4,9,11,5,20,15,14,5,0,83
4,9,11,9,14,7,0,0,0,54
4,25,11,9,14,7,0,0,0,70
4,9,11,11,15,16,0,0,0,66
4,9,11,19,8,1,0,0,0,52
4,9,11,20,1,20,0,0,0,65
4,9,11,20,1,20,19,0,0,84
4,9,12,1,3,20,9,3,0,61
4,9,12,1,3,20,15,14,5,83
4,9,12,1,14,9,1,20,5,75
4,9,12,1,20,1,2,12,5,66
4,9,12,1,20,1,2,12,25,86
4,9,12,1,20,1,14,3,25,89
4,9,12,1,20,1,14,20,0,81
4,9,12,1,20,1,14,20,19,100
4,9,12,1,20,1,20,5,0,72
4,9,12,1,20,1,20,15,18,100
4,9,12,1,20,5,0,0,0,51
4,9,12,1,20,5,4,0,0,55
4,9,12,1,20,5,4,12,25,92
4,9,12,1,20,5,18,0,0,69
4,9,12,1,20,5,18,19,0,88
4,9,12,1,20,5,19,0,0,70
4,9,12,1,20,9,14,7,0,76
4,9,12,1,20,9,15,14,0,84
4,9,12,1,20,9,15,14,19,103
4,9,12,1,20,9,22,5,0,82
4,9,12,1,20,15,18,0,0,79
4,9,12,1,20,15,18,25,0,104
4,9,12,1,20,15,18,19,0,98
4,9,12,4,15,0,0,0,0,44
4,9,12,4,15,5,0,0,0,49
4,9,12,4,15,5,19,0,0,68
4,9,12,4,15,19,0,0,0,63
4,9,12,5,3,20,9,15,14,91
4,9,12,5,13,13,1,0,0,57
4,9,12,5,13,13,1,19,0,76
4,9,12,5,13,13,9,3,0,68
4,9,12,5,20,1,14,20,0,85
4,9,12,5,20,20,1,14,20,105
4,9,12,9,7,5,14,3,5,68
4,9,12,9,7,5,14,3,25,88
4,9,12,9,7,5,14,20,0,80
4,9,12,9,19,0,0,0,0,53
4,9,12,11,5,18,0,0,0,59
4,9,12,12,5,4,0,0,0,46
4,9,12,12,5,14,9,1,4,70
4,9,12,12,5,19,11,0,0,72
4,9,12,12,9,0,0,0,0,46
4,9,12,12,9,5,18,0,0,69
4,9,12,12,9,5,19,0,0,70
4,9,12,12,25,13,1,14,0,90
4,9,12,12,25,13,5,14,0,94
4,9,12,12,9,14,7,0,0,67
4,9,12,12,9,19,0,0,0,65
4,9,12,12,9,19,11,0,0,76
4,9,12,12,19,0,0,0,0,56
4,9,12,12,19,5,5,4,0,70
4,9,12,12,21,5,0,0,0,63
4,9,12,12,21,5,18,0,0,81
4,9,12,12,23,5,5,4,0,74
4,9,12,15,0,0,0,0,0,40
4,9,12,15,7,25,0,0,0,72
4,9,12,15,7,9,3,1,12,72
4,9,12,15,19,0,0,0,0,59
4,9,12,21,3,9,4,0,0,62
4,9,12,21,5,14,4,15,0,84
4,9,12,21,5,14,20,0,0,85
4,9,12,21,5,14,20,19,0,104
4,9,12,21,20,1,14,20,0,101
4,9,12,21,20,5,0,0,0,71
4,9,12,21,20,5,4,0,0,75
4,9,12,21,20,5,4,12,25,112
4,9,12,21,20,5,5,0,0,76
4,9,12,21,20,5,12,25,0,108
4,9,12,21,20,5,14,20,0,105
4,9,12,21,20,5,18,0,0,89
4,9,12,21,20,5,18,19,0,108
4,9,12,21,20,5,19,0,0,90
4,9,12,21,20,9,14,7,0,96
4,9,12,21,20,9,15,14,0,104
4,9,12,21,20,9,15,14,19,123
4,9,12,21,20,9,22,5,0,102
4,9,12,21,20,15,18,0,0,99
4,9,12,21,20,15,18,19,0,118
4,9,12,21,22,25,0,0,0,93
4,9,12,21,22,9,1,0,0,78
4,9,12,21,22,9,1,12,0,90
4,9,12,21,22,9,1,14,0,92
4,9,12,21,22,9,1,20,5,103
4,9,12,21,22,9,15,14,0,106
4,9,12,21,22,9,15,14,19,125
4,9,12,21,22,9,21,13,0,111
4,9,12,21,22,9,21,13,19,130
4,9,13,1,14,5,0,0,0,46
4,9,13,2,5,18,0,0,0,51
4,9,13,2,12,5,0,0,0,45
4,9,13,5,0,0,0,0,0,31
4,9,13,5,4,15,14,0,0,64
4,9,13,5,4,15,14,5,0,69
4,9,13,5,14,19,9,15,14,102
4,9,13,5,14,19,9,22,5,100
4,9,13,5,14,19,21,13,0,98
4,9,13,5,18,0,0,0,0,49
4,9,13,5,18,1,14,0,0,64
4,9,13,5,18,3,21,18,25,116
4,9,13,5,18,9,3,0,0,61
4,9,13,5,18,9,4,5,0,67
4,9,13,5,18,9,19,13,0,90
4,9,13,5,18,9,19,13,19,109
4,9,13,5,18,9,26,5,0,89
4,9,13,5,18,9,26,5,4,93
4,9,13,5,18,9,26,5,19,108
4,9,13,5,18,12,9,5,0,75
4,9,13,5,18,15,21,19,0,104
4,9,13,5,18,19,0,0,0,68
4,9,13,5,19,0,0,0,0,50
4,9,13,5,20,5,18,0,0,74
4,9,13,5,20,5,18,19,0,93
4,9,13,5,20,8,25,12,0,96
4,9,13,5,20,8,25,12,19,115
4,9,13,5,20,8,15,24,25,123
4,9,13,5,20,9,5,14,20,99
4,9,13,5,20,18,25,0,0,94
4,9,13,5,20,18,9,1,0,79
4,9,13,5,20,18,9,3,0,81
4,9,13,25,1,18,25,0,0,95
4,9,13,25,1,18,9,1,14,94
4,9,13,25,1,18,9,3,0,82
4,9,13,9,4,9,1,20,5,74
4,9,13,9,14,0,0,0,0,49
4,9,13,9,14,9,19,8,0,85
4,9,13,9,14,21,5,0,0,75
4,9,13,9,14,21,5,14,20,109
4,9,13,9,14,21,20,1,12,103
4,9,13,9,14,21,20,5,0,95
4,9,13,9,14,21,20,5,4,99
4,9,13,9,19,19,0,0,0,73
4,9,13,9,19,19,9,15,14,111
4,9,13,9,19,19,15,18,25,131
4,9,13,9,20,0,0,0,0,55
4,9,13,9,20,25,0,0,0,80
4,9,13,9,20,9,5,19,0,88
4,9,13,9,20,20,5,4,0,84
4,9,13,9,20,20,9,14,7,105
4,9,13,12,25,0,0,0,0,63
4,9,13,13,1,2,12,5,0,59
4,9,13,13,5,4,0,0,0,48
4,9,13,13,5,18,0,0,0,62
4,9,13,13,5,18,19,0,0,81
4,9,13,13,5,19,20,0,0,83
4,9,13,13,5,20,0,0,0,64
4,9,13,13,25,0,0,0,0,64
4,9,13,13,9,14,7,0,0,69
4,9,13,13,9,19,8,0,0,75
4,9,13,13,9,20,0,0,0,68
4,9,13,13,15,3,11,0,0,68
4,9,13,14,5,19,19,0,0,83
4,9,13,14,5,19,19,5,19,107
4,9,13,15,18,9,3,0,0,71
4,9,13,15,18,16,8,0,0,83
4,9,13,15,18,16,8,9,3,95
4,9,13,15,18,16,8,19,0,102
4,9,13,15,21,20,0,0,0,82
4,9,13,15,21,20,19,0,0,101
4,9,13,16,12,5,0,0,0,59
4,9,13,16,12,5,4,0,0,63
4,9,13,16,12,5,19,0,0,78
4,9,13,16,12,25,0,0,0,79
4,9,13,16,12,9,5,18,0,86
4,9,13,16,12,9,5,19,20,107
4,9,13,16,12,9,14,7,0,84
4,9,13,16,19,0,0,0,0,61
4,9,13,16,19,25,0,0,0,86
4,9,13,21,5,14,3,5,0,74
4,9,13,23,9,20,0,0,0,78
4,9,13,23,9,20,19,0,0,97
4,9,13,23,9,20,20,5,4,107
4,25,14,0,0,0,0,0,0,43
4,25,14,1,7,18,1,16,8,94
4,25,14,1,13,0,0,0,0,57
4,25,14,1,13,5,20,5,18,105
4,25,14,1,13,9,3,0,0,69
4,25,14,1,13,9,3,1,12,82
4,25,14,1,13,9,3,19,0,88
4,25,14,1,13,9,19,0,0,85
4,25,14,1,13,9,19,13,0,98
4,25,14,1,13,9,19,13,19,117
4,25,14,1,13,9,19,20,0,105
4,25,14,1,13,9,19,20,19,124
4,25,14,1,13,9,20,5,0,91
4,25,14,1,13,9,20,5,4,95
4,25,14,1,13,9,20,5,18,109
4,25,14,1,13,9,20,5,19,110
4,25,14,1,13,9,20,9,3,98
4,25,14,1,13,9,26,5,0,97
4,25,14,1,13,15,0,0,0,72
4,9,14,1,13,15,4,5,0,65
4,25,14,1,13,15,19,0,0,91
4,25,14,1,13,15,20,15,18,125
4,25,14,1,16,15,12,9,19,115
4,9,14,1,18,0,0,0,0,46
4,9,14,1,18,3,8,25,0,82
4,9,14,1,18,19,0,0,0,65
4,25,14,1,19,20,0,0,0,83
4,25,14,1,19,20,25,0,0,108
4,25,14,1,19,20,9,3,0,95
4,25,14,1,19,20,9,4,0,96
4,25,14,1,19,20,9,5,19,116
4,25,14,1,19,20,19,0,0,102
4,25,14,1,20,18,15,14,0,111
4,25,14,1,20,18,15,14,19,130
4,9,14,4,5,18,0,0,0,54
4,9,14,4,12,5,0,0,0,48
4,9,14,4,12,5,4,0,0,52
4,9,14,4,12,5,19,0,0,67
4,9,14,4,12,9,14,7,0,73
4,9,14,4,15,14,0,0,0,60
4,25,14,5,0,0,0,0,0,48
4,9,14,5,4,0,0,0,0,36
4,25,14,5,12,19,0,0,0,79
4,9,14,5,18,0,0,0,0,50
4,9,14,5,18,7,1,20,5,83
4,9,14,5,18,9,3,0,0,62
4,9,14,5,18,15,0,0,0,65
4,9,14,5,18,15,19,0,0,84
4,9,14,5,18,19,0,0,0,69
4,9,14,5,19,0,0,0,0,51
4,25,14,5,19,0,0,0,0,67
4,9,14,5,20,9,3,0,0,64
4,9,14,5,20,20,5,0,0,77
4,9,14,5,20,20,5,19,0,96
4,9,14,5,21,18,9,3,0,83
4,9,14,5,21,20,18,15,14,120
4,9,14,7,0,0,0,0,0,34
4,9,14,7,1,18,0,0,0,53
4,9,14,7,2,1,20,0,0,57
4,9,14,7,2,1,20,19,0,76
4,9,14,7,4,15,14,7,0,74
4,9,14,7,4,15,14,7,19,93
4,9,14,7,5,0,0,0,0,39
4,9,14,7,5,4,0,0,0,43
4,9,14,7,5,5,0,0,0,44
4,9,14,7,5,25,0,0,0,64
4,9,14,7,5,9,14,7,0,69
4,9,14,7,5,25,19,0,0,83
4,9,14,7,5,18,0,0,0,57
4,9,14,7,5,19,0,0,0,58
4,9,14,7,8,5,5,0,0,52
4,9,14,7,8,25,0,0,0,67
4,9,14,7,8,9,5,19,0,75
4,9,14,7,25,0,0,0,0,59
4,9,14,7,9,5,18,0,0,66
4,9,14,7,9,5,19,0,0,67
4,9,14,7,9,5,19,20,0,87
4,9,14,7,9,12,25,0,0,80
4,9,14,7,9,14,5,19,19,100
4,9,14,7,9,14,7,0,0,64
4,9,14,7,12,5,4,0,0,55
4,9,14,7,12,5,19,0,0,70
4,9,14,7,12,25,0,0,0,71
4,9,14,7,12,9,14,7,0,76
4,9,14,7,13,1,21,12,0,81
4,9,14,7,15,0,0,0,0,49
4,9,14,7,15,5,19,0,0,73
4,9,14,7,19,0,0,0,0,53
4,9,14,7,21,19,5,19,0,98
4,9,14,8,5,9,18,15,0,82
4,9,14,9,3,0,0,0,0,39
4,9,14,9,3,1,12,0,0,52
4,9,14,9,14,7,0,0,0,57
4,9,14,9,20,18,1,20,5,100
4,9,14,9,20,18,9,12,0,95
4,9,14,9,20,18,9,12,5,100
4,9,14,9,20,18,15,0,0,89
4,9,14,11,0,0,0,0,0,38
4,9,14,11,5,4,0,0,0,47
4,9,14,11,5,25,0,0,0,68
4,9,14,11,5,25,19,0,0,87
4,9,14,11,25,0,0,0,0,63
4,9,14,11,9,5,18,0,0,70
4,9,14,11,9,5,19,0,0,71
4,9,14,11,9,5,19,20,0,91
4,9,14,11,9,14,7,0,0,68
4,9,14,11,12,25,0,0,0,75
4,9,14,11,19,0,0,0,0,57
4,9,14,11,21,13,19,0,0,91
4,9,14,13,1,14,0,0,0,55
4,9,14,13,15,14,20,0,0,89
4,9,14,14,5,4,0,0,0,50
4,9,14,14,5,18,0,0,0,64
4,9,14,14,5,18,25,0,0,89
4,9,14,14,5,18,12,25,0,101
4,9,14,14,5,18,19,0,0,83
4,9,14,14,9,14,7,0,0,71
4,25,14,15,4,5,0,0,0,67
4,25,14,15,4,5,19,0,0,86
4,9,14,15,13,9,3,0,0,67
4,9,14,15,19,0,0,0,0,61
4,9,14,15,19,1,21,18,0,101
4,9,14,15,19,1,21,18,19,120
4,9,14,15,20,8,5,18,5,98
4,9,14,19,0,0,0,0,0,46
4,9,14,19,15,13,5,0,0,79
4,9,14,20,0,0,0,0,0,47
4,9,14,20,5,4,0,0,0,56
4,9,14,20,9,14,7,0,0,77
4,9,14,20,12,5,19,19,0,102
4,9,14,20,19,0,0,0,0,66
4,9,14,21,19,0,0,0,0,67
4,9,15,2,5,12,25,0,0,72
4,9,15,2,15,12,0,0,0,57
4,9,15,2,15,12,15,14,0,86
4,9,15,2,15,12,15,14,19,105
4,9,15,2,15,12,19,0,0,76
4,9,15,3,0,0,0,0,0,31
4,9,15,3,5,19,1,14,0,70
4,9,15,3,5,19,1,14,19,89
4,9,15,3,5,19,5,0,0,60
4,9,15,3,5,19,5,19,0,79
4,9,15,3,5,19,9,1,14,79
4,9,15,3,15,5,12,0,0,63
4,9,15,4,5,0,0,0,0,37
4,9,15,4,5,19,0,0,0,56
4,9,15,4,15,14,20,0,0,81
4,9,15,5,3,25,0,0,0,61
4,9,15,5,3,9,1,14,0,60
4,9,15,5,3,9,15,21,19,100
4,9,15,5,3,9,19,13,0,77
4,9,15,5,3,9,19,13,19,96
4,9,15,5,19,20,18,21,13,124
4,9,15,5,19,20,18,21,19,130
4,9,15,7,5,14,9,20,5,88
4,9,15,9,3,15,21,19,0,95
4,9,15,12,0,0,0,0,0,40
4,9,15,12,5,6,9,14,0,74
4,9,15,12,5,6,9,14,5,79
4,9,15,12,5,6,9,14,19,93
4,9,15,12,19,0,0,0,0,59
4,9,15,13,1,20,5,0,0,67
4,9,15,14,25,13,0,0,0,80
4,9,15,14,25,13,1,12,0,93
4,9,15,14,9,19,5,0,0,75
4,9,15,14,9,26,5,0,0,82
4,25,15,16,8,15,14,5,0,102
4,9,15,16,19,9,4,5,0,81
4,9,15,16,19,9,4,5,19,100
4,9,15,16,19,9,4,9,3,88
4,9,15,16,20,1,19,5,0,89
4,9,15,16,20,1,19,5,19,108
4,9,15,16,20,5,18,0,0,87
4,9,15,16,20,5,18,19,0,106
4,9,15,16,20,18,1,0,0,83
4,9,15,16,20,18,1,12,0,95
4,9,15,16,20,18,1,20,5,108
4,9,15,16,20,18,5,0,0,87
4,9,15,16,20,18,5,19,0,106
4,9,15,16,20,18,25,0,0,107
4,9,15,16,20,18,9,3,0,94
4,9,15,16,20,18,9,3,19,113
4,9,15,18,1,13,1,0,0,61
4,9,15,18,1,13,1,19,0,80
4,9,15,18,1,13,9,3,0,72
4,9,15,18,4,9,14,1,12,86
4,9,15,18,9,19,13,0,0,87
4,9,15,18,9,20,5,0,0,80
4,9,15,18,9,20,5,19,0,99
4,9,15,18,9,20,9,3,0,87
4,9,15,19,5,0,0,0,0,52
4,9,15,19,7,5,14,9,14,96
4,9,15,19,13,9,14,0,0,83
4,9,15,19,13,15,19,5,0,99
4,9,15,19,13,15,19,5,4,103
4,9,15,19,13,15,19,9,19,122
4,9,15,19,13,15,20,9,3,107
4,25,15,19,20,25,12,5,0,125
4,9,15,20,1,0,0,0,0,49
4,25,15,20,8,5,9,19,13,118
4,9,15,20,9,0,0,0,0,57
4,9,15,20,9,3,0,0,0,60
4,9,15,22,21,12,1,18,0,102
4,9,15,24,1,14,0,0,0,67
4,9,15,24,1,14,5,0,0,72
4,9,15,24,1,14,5,19,0,91
4,9,15,24,25,0,0,0,0,77
4,9,15,24,9,4,0,0,0,65
4,9,15,24,9,4,5,0,0,70
4,9,15,24,9,4,5,19,0,89
4,9,15,24,9,4,19,0,0,84
4,9,15,24,9,13,5,0,0,79
4,9,15,24,9,14,0,0,0,75
4,9,15,24,9,14,19,0,0,94
4,9,16,1,18,20,9,20,5,102
4,9,16,1,19,3,8,1,12,73
4,9,16,3,8,9,3,11,0,63
4,9,16,3,15,1,20,0,0,68
4,9,16,5,14,20,5,14,5,92
4,9,16,5,14,20,9,14,5,96
4,9,16,5,16,20,9,4,0,83
4,9,16,5,16,20,9,4,5,88
4,9,16,5,20,20,15,0,0,89
4,9,16,8,1,19,5,0,0,62
4,9,16,8,1,19,5,18,0,80
4,9,16,8,1,19,9,3,0,69
4,9,16,8,5,1,4,0,0,47
4,9,16,8,5,14,1,14,0,71
4,9,16,8,5,14,25,12,0,93
4,9,16,8,5,14,25,12,19,112
4,9,16,8,5,14,15,12,0,83
4,9,16,8,25,5,19,9,19,114
4,25,16,8,15,14,5,0,0,87
4,9,16,8,15,14,9,1,0,76
4,9,16,8,20,8,15,14,7,101
4,9,16,9,3,18,1,20,5,85
4,9,16,25,7,9,0,0,0,70
4,9,16,25,7,21,19,0,0,101
4,9,16,25,12,15,14,0,0,95
4,9,16,25,18,1,13,9,4,99
4,9,16,25,18,5,0,0,0,77
4,9,16,25,18,9,4,25,12,122
4,9,16,12,0,0,0,0,0,41
4,9,16,12,1,14,1,18,0,75
4,9,16,12,1,19,9,3,0,73
4,9,16,12,1,19,9,15,14,99
4,9,16,12,5,0,0,0,0,46
4,9,16,12,5,7,9,1,0,63
4,9,16,12,5,7,9,1,19,82
4,9,16,12,5,7,9,3,0,65
4,9,16,12,5,21,18,1,0,86
4,9,16,12,5,21,18,1,12,98
4,9,16,12,5,21,18,9,3,97
4,9,16,12,5,24,0,0,0,70
4,9,16,12,5,24,5,18,0,93
4,9,16,12,15,5,0,0,0,61
4,9,16,12,15,5,19,0,0,80
4,9,16,12,15,5,20,9,3,93
4,9,16,12,15,9,3,0,0,68
4,9,16,12,15,9,4,0,0,69
4,9,16,12,15,9,4,25,0,94
4,9,16,12,15,9,4,9,3,81
4,9,16,12,15,9,4,19,0,88
4,9,16,12,15,9,19,0,0,84
4,9,16,12,15,13,1,0,0,70
4,9,16,12,15,13,1,3,25,98
4,9,16,12,15,13,1,5,4,79
4,9,16,12,15,13,1,19,0,89
4,9,16,12,15,13,1,20,0,90
4,9,16,12,15,13,1,20,1,91
4,9,16,12,15,13,1,20,5,95
4,9,16,12,15,13,1,20,19,109
4,9,16,12,15,14,5,13,1,89
4,9,16,12,15,14,20,0,0,90
4,9,16,12,15,14,20,9,3,102
4,9,16,12,15,14,20,19,0,109
4,9,16,12,15,16,25,0,0,97
4,9,16,12,15,16,9,1,0,82
4,9,16,12,15,16,9,1,19,101
4,9,16,12,15,16,9,3,0,84
4,9,16,12,15,16,15,4,0,91
4,9,16,12,15,16,15,4,19,110
4,9,16,12,15,19,5,19,0,99
4,9,16,12,15,19,9,19,0,103
4,9,16,12,15,19,15,13,5,108
4,9,16,12,15,20,5,14,5,100
4,9,16,12,21,13,2,9,3,89
4,9,16,13,5,20,5,18,0,90
4,9,16,14,5,5,4,12,5,74
4,9,16,14,5,21,19,20,0,108
4,9,16,14,15,1,14,0,0,73
4,9,16,14,15,1,14,19,0,92
4,9,16,14,15,9,4,0,0,71
4,25,16,14,15,14,5,0,0,93
4,9,16,14,15,15,21,19,0,113
4,9,16,15,4,5,0,0,0,53
4,9,16,15,4,25,0,0,0,73
4,9,16,15,4,9,3,0,0,60
4,9,16,15,4,9,4,0,0,61
4,9,16,15,4,9,5,19,0,81
4,9,16,15,12,1,18,0,0,75
4,9,16,15,12,5,0,0,0,61
4,9,16,15,12,5,19,0,0,80
4,9,16,15,18,16,1,0,0,79
4,9,16,16,1,2,12,5,0,65
4,9,16,16,5,4,0,0,0,54
4,9,16,16,5,18,0,0,0,68
4,9,16,16,5,18,6,21,12,107
4,9,16,16,5,18,19,0,0,87
4,9,16,16,25,0,0,0,0,70
4,9,16,16,9,5,18,0,0,77
4,9,16,16,9,5,19,20,0,98
4,9,16,16,9,14,7,0,0,75
4,9,16,16,9,14,7,19,0,94
4,9,16,16,16,25,0,0,0,86
4,9,16,16,16,9,5,18,0,93
4,9,16,16,16,9,5,19,20,114
4,9,16,18,9,13,1,18,25,113
4,9,16,18,15,16,25,12,0,115
4,9,16,18,15,20,9,3,0,94
4,9,16,19,0,0,0,0,0,48
4,9,16,19,1,4,5,19,0,77
4,9,16,19,1,4,9,14,5,81
4,9,16,19,1,19,0,0,0,68
4,9,16,19,5,25,0,0,0,78
4,9,16,19,5,20,9,3,0,85
4,9,16,19,25,0,0,0,0,73
4,9,16,19,9,5,0,0,0,62
4,9,16,19,15,0,0,0,0,63
4,9,16,19,15,19,0,0,0,82
4,9,16,19,15,19,9,19,0,110
4,9,16,19,20,9,3,11,0,91
4,9,16,19,20,9,3,11,19,110
4,9,16,20,0,0,0,0,0,49
4,9,16,20,5,18,0,0,0,72
4,9,16,20,5,18,1,4,0,77
4,9,16,20,5,18,1,12,0,85
4,9,16,20,5,18,1,14,0,87
4,9,16,20,5,18,1,14,19,106
4,9,16,20,5,18,9,19,20,120
4,9,16,20,5,18,15,9,0,96
4,9,16,20,5,18,15,14,0,101
4,9,16,20,5,18,15,19,0,106
4,9,16,20,5,18,15,21,19,127
4,9,16,20,5,18,21,19,0,112
4,9,16,20,25,3,1,0,0,78
4,9,16,20,25,3,1,19,0,97
4,9,16,20,25,3,8,0,0,85
4,9,16,20,25,3,8,15,14,114
4,9,16,20,25,3,8,19,0,104
4,9,16,20,15,20,5,0,0,89
4,9,16,23,1,18,5,0,0,76
4,9,17,21,1,20,0,0,0,72
4,9,17,21,1,20,19,0,0,91
4,9,18,4,0,0,0,0,0,35
4,9,18,4,21,13,0,0,0,69
4,9,18,4,21,13,19,0,0,88
4,9,18,5,3,12,25,0,0,76
4,9,18,5,3,20,0,0,0,59
4,9,18,5,3,20,5,4,0,68
4,9,18,5,3,20,5,18,0,82
4,9,18,5,3,20,5,19,20,103
4,9,18,5,3,20,5,21,18,103
4,9,18,5,3,20,9,14,7,89
4,9,18,5,3,20,9,15,14,97
4,9,18,5,3,20,9,22,5,95
4,9,18,5,3,20,12,25,0,96
4,9,18,5,3,20,15,18,0,92
4,9,18,5,3,20,15,18,19,111
4,9,18,5,3,20,18,9,24,110
4,9,18,5,3,20,19,0,0,78
4,9,18,5,6,21,12,0,0,75
4,9,18,5,6,21,12,12,25,112
4,9,18,5,12,25,0,0,0,73
4,9,18,5,13,16,20,0,0,85
4,9,18,5,14,5,19,19,0,93
4,9,18,5,16,20,9,15,14,110
4,9,18,5,18,0,0,0,0,54
4,9,18,5,19,20,0,0,0,75
4,9,18,5,24,0,0,0,0,60
4,9,18,5,24,9,20,0,0,89
4,9,18,7,5,0,0,0,0,43
4,9,18,7,5,4,0,0,0,47
4,9,18,7,5,6,21,12,0,82
4,9,18,7,5,12,9,11,5,80
4,9,18,7,5,13,1,14,0,71
4,9,18,7,5,19,0,0,0,62
4,9,18,7,25,0,0,0,0,63
4,9,18,7,9,5,0,0,0,52
4,9,18,7,9,14,7,0,0,68
4,9,18,7,12,5,18,0,0,73
4,9,18,8,1,13,0,0,0,53
4,9,18,8,1,13,19,0,0,72
4,9,18,8,5,13,0,0,0,57
4,9,18,8,9,14,15,21,19,117
4,9,18,9,7,5,0,0,0,52
4,9,18,9,7,5,14,20,0,86
4,9,18,9,7,9,2,12,5,75
4,9,18,9,7,15,0,0,0,62
4,9,18,9,13,5,14,20,0,92
4,9,18,9,20,25,0,0,0,85
4,9,18,11,5,4,0,0,0,51
4,9,18,11,9,14,7,0,0,72
4,9,18,11,19,0,0,0,0,61
4,9,18,12,0,0,0,0,0,43
4,9,18,12,5,4,0,0,0,52
4,9,18,12,9,14,7,0,0,73
4,9,18,12,19,0,0,0,0,62
4,9,18,14,4,12,0,0,0,61
4,9,18,14,4,12,19,0,0,80
4,9,18,20,2,9,18,4,0,84
4,9,18,20,2,15,1,18,4,91
4,9,18,20,5,14,0,0,0,70
4,9,18,20,25,0,0,0,0,76
4,9,18,20,9,5,4,0,0,69
4,9,18,20,9,5,18,0,0,83
4,9,18,20,9,5,19,0,0,84
4,9,18,20,9,5,19,20,0,104
4,9,18,20,25,9,14,7,0,106
4,9,18,20,9,12,25,0,0,97
4,9,18,20,9,14,5,19,19,117
4,9,18,20,16,12,1,20,5,105
4,9,18,20,19,0,0,0,0,70
4,9,18,21,16,20,9,15,14,126
4,25,19,0,0,0,0,0,0,48
4,9,19,1,2,12,5,0,0,52
4,9,19,1,2,12,5,4,0,56
4,9,19,1,2,12,5,18,0,70
4,9,19,1,2,12,5,18,19,89
4,9,19,1,2,12,5,19,0,71
4,9,19,1,2,12,9,14,7,77
4,9,19,1,2,21,19,1,12,88
4,9,19,1,2,21,19,5,0,80
4,9,19,1,2,21,19,5,4,84
4,9,19,1,2,21,19,5,19,99
4,9,19,1,3,3,15,18,4,76
4,9,19,1,3,18,25,12,0,91
4,25,19,1,3,21,19,9,1,102
4,9,19,1,4,10,21,19,20,107
4,9,19,1,4,15,18,14,0,84
4,9,19,1,4,22,9,19,5,92
4,9,19,1,6,6,5,3,20,73
4,9,19,1,6,6,9,18,13,85
4,9,19,1,7,9,15,0,0,64
4,9,19,1,7,18,5,5,0,68
4,9,19,1,7,18,5,5,4,72
4,9,19,1,7,18,5,5,18,86
4,9,19,1,7,18,5,5,19,87
4,9,19,1,12,9,7,14,0,75
4,9,19,1,12,9,11,5,0,70
4,9,19,1,12,12,25,0,0,82
4,9,19,1,12,12,15,23,0,95
4,9,19,1,12,12,15,23,19,114
4,9,19,1,12,20,5,18,14,102
4,9,19,1,14,3,8,15,18,91
4,9,19,1,14,9,13,1,12,82
4,9,19,1,14,14,5,25,0,91
4,9,19,1,14,14,5,24,0,90
4,9,19,1,14,14,21,12,0,94
4,9,19,1,14,14,21,12,19,113
4,9,19,1,14,15,9,14,20,105
4,25,19,1,16,8,9,1,0,83
4,9,19,1,16,16,5,1,18,89
4,9,19,1,18,4,0,0,0,55
4,9,19,1,18,13,0,0,0,64
4,9,19,1,18,13,5,4,0,73
4,9,19,1,18,13,5,18,0,87
4,9,19,1,18,13,5,18,19,106
4,9,19,1,18,13,9,14,7,94
4,9,19,1,18,13,19,0,0,83
4,9,19,1,18,18,1,25,0,95
4,9,19,1,18,18,1,25,19,114
4,9,19,1,18,18,5,19,20,113
4,9,19,1,19,19,5,14,20,110
4,9,19,1,19,20,5,18,0,95
4,9,19,1,19,20,5,18,19,114
4,9,19,1,20,20,9,18,5,105
4,9,19,1,20,20,21,14,5,113
4,9,19,1,22,1,9,12,0,77
4,9,19,1,22,15,21,3,8,102
4,9,19,1,22,15,23,0,0,93
4,9,19,1,22,15,23,1,12,106
4,9,19,1,22,15,23,5,4,102
4,9,19,1,22,15,23,5,18,116
4,9,19,1,22,15,23,19,0,112
4,9,19,1,23,1,0,0,0,57
4,9,19,1,26,15,0,0,0,74
4,9,19,2,1,14,4,0,0,53
4,9,19,2,1,14,4,5,4,62
4,9,19,2,1,14,4,19,0,72
4,9,19,2,1,18,0,0,0,53
4,25,19,2,1,18,9,19,13,110
4,9,19,2,1,18,11,0,0,64
4,9,19,2,1,18,18,5,4,80
4,9,19,2,1,18,19,0,0,72
4,9,19,2,1,19,5,0,0,59
4,9,19,2,5,3,15,13,5,75
4,9,19,2,5,12,9,5,6,71
4,9,19,2,5,14,3,8,0,64
4,9,19,2,5,14,4,0,0,57
4,9,19,2,9,14,4,0,0,61
4,9,19,2,12,1,13,5,0,65
4,9,19,2,12,15,15,13,0,89
4,9,19,2,15,1,18,4,0,72
4,9,19,2,15,4,25,0,0,78
4,9,19,2,15,4,9,5,4,71
4,9,19,2,15,7,21,5,0,82
4,9,19,2,15,19,15,13,0,96
4,9,19,2,15,19,15,13,19,115
4,9,19,2,15,21,14,4,0,88
4,9,19,2,15,23,5,12,0,89
4,9,19,2,15,23,5,12,19,108
4,9,19,2,18,1,9,14,0,76
4,9,19,2,18,1,14,3,8,78
4,9,19,2,21,4,0,0,0,59
4,9,19,2,21,4,4,5,4,72
4,9,19,2,21,4,4,5,18,86
4,9,19,2,21,4,19,0,0,78
4,25,19,2,21,12,9,1,0,93
4,25,19,2,21,12,9,3,0,95
4,9,19,2,21,18,4,5,14,96
4,9,19,2,21,18,25,0,0,98
4,9,19,2,21,18,19,1,12,105
4,9,19,2,21,18,19,5,0,97
4,9,19,2,21,18,19,5,4,101
4,9,19,2,21,18,19,5,18,115
4,9,19,2,21,18,19,5,19,116
4,9,19,2,21,20,20,15,14,124
4,9,19,3,0,0,0,0,0,35
4,9,19,3,1,7,5,0,0,48
4,9,19,3,1,12,0,0,0,48
4,9,19,3,1,12,3,5,4,60
4,9,19,3,1,13,16,0,0,65
4,9,19,3,1,14,4,25,0,79
4,9,19,3,1,14,20,0,0,70
4,9,19,3,1,14,20,5,4,79
4,9,19,3,1,14,20,5,18,93
4,9,19,3,1,14,20,19,0,89
4,9,19,3,1,14,20,21,19,110
4,9,19,3,1,18,4,0,0,58
4,9,19,3,1,18,4,5,4,67
4,9,19,3,1,18,4,5,18,81
4,9,19,3,1,18,4,19,0,77
4,9,19,3,1,19,5,0,0,60
4,9,19,3,1,19,5,4,0,64
4,9,19,3,1,19,5,19,0,79
4,9,19,3,1,19,9,14,7,85
4,9,19,3,1,19,20,12,5,92
4,9,19,3,1,20,20,5,18,99
4,9,19,3,5,4,0,0,0,44
4,9,19,3,5,4,5,0,0,49
4,9,19,3,5,16,20,0,0,76
4,9,19,3,5,16,20,5,4,85
4,9,19,3,5,16,20,19,0,95
4,9,19,3,5,18,14,0,0,72
4,9,19,3,5,18,14,5,4,81
4,9,19,3,5,18,14,5,18,95
4,9,19,3,5,18,14,19,0,91
4,9,19,3,5,18,16,0,0,74
4,9,19,3,5,18,16,5,4,83
4,9,19,3,8,1,18,7,5,74
4,9,19,3,8,1,18,13,0,75
4,9,19,3,8,1,19,5,0,68
4,9,19,3,8,5,22,5,12,87
4,25,19,3,8,9,18,9,1,96
4,25,19,3,8,18,15,1,0,93
4,25,19,3,8,18,15,9,1,102
4,9,19,3,8,21,18,3,8,93
4,9,19,3,9,0,0,0,0,44
4,9,19,3,9,4,5,0,0,53
4,9,19,3,9,6,15,18,13,96
4,9,19,3,9,14,3,20,0,81
4,9,19,3,9,14,4,0,0,62
4,9,19,3,9,14,7,0,0,65
4,9,19,3,9,14,15,9,4,86
4,9,19,3,9,16,12,5,0,77
4,9,19,3,9,16,12,5,4,81
4,9,19,3,9,16,12,5,19,96
4,9,19,3,9,20,9,19,0,92
4,9,19,3,12,1,9,13,0,70
4,9,19,3,12,1,9,13,19,89
4,9,19,3,12,1,19,19,0,86
4,9,19,3,12,9,11,5,0,72
4,9,19,3,12,9,13,1,24,94
4,9,19,3,12,15,1,11,0,74
4,9,19,3,12,15,19,5,0,86
4,9,19,3,12,15,19,5,4,90
4,9,19,3,12,15,19,5,18,104
4,9,19,3,12,15,19,5,19,105
4,9,19,3,12,15,21,4,0,87
4,9,19,3,12,15,21,20,0,103
4,9,19,3,15,0,0,0,0,50
4,9,19,3,15,1,3,8,0,62
4,9,19,3,15,1,19,20,0,90
4,9,19,3,15,2,15,12,9,88
4,9,19,3,15,3,1,18,16,88
4,9,19,3,15,5,4,0,0,59
4,9,19,3,15,9,4,0,0,63
4,9,19,3,15,9,4,1,12,76
4,9,19,3,15,9,4,19,0,82
4,9,19,3,15,9,14,7,0,80
4,9,19,3,15,12,9,20,8,99
4,9,19,3,15,12,15,18,0,95
4,9,19,3,15,12,15,18,19,114
4,9,19,3,15,12,15,21,18,116
4,9,19,3,15,13,6,9,20,98
4,9,19,3,15,13,13,15,14,105
4,9,19,3,15,13,16,20,0,99
4,9,19,3,15,14,21,12,1,98
4,9,19,3,15,18,4,0,0,72
4,9,19,3,15,18,4,5,4,81
4,9,19,3,15,18,4,5,18,95
4,9,19,3,15,18,4,19,0,91
4,9,19,3,15,19,0,0,0,69
4,9,19,3,15,19,20,0,0,89
4,9,19,3,15,21,14,20,0,105
4,9,19,3,15,21,14,20,19,124
4,9,19,3,15,21,16,12,5,104
4,9,19,3,15,21,18,0,0,89
4,9,19,3,15,21,18,19,5,113
4,9,19,3,15,21,18,20,0,109
4,9,19,3,15,21,19,0,0,90
4,9,19,3,15,22,5,18,0,95
4,9,19,3,15,22,5,18,25,120
4,9,19,3,15,22,5,18,19,114
4,9,19,3,15,22,5,18,20,115
4,9,19,3,18,1,4,12,5,75
4,25,19,3,18,1,19,5,0,94
4,25,19,3,18,1,19,5,4,98
4,25,19,3,18,1,19,25,0,114
4,25,19,3,18,1,19,9,1,99
4,25,19,3,18,1,19,9,3,101
4,25,19,3,18,1,20,9,3,102
4,9,19,3,18,5,1,20,5,84
4,9,19,3,18,5,4,9,20,91
4,9,19,3,18,5,5,20,0,83
4,9,19,3,18,5,20,5,0,83
4,9,19,3,18,9,22,5,0,89
4,9,19,3,18,15,23,14,0,105
4,9,19,3,18,15,23,14,19,124
4,9,19,3,19,0,0,0,0,54
4,9,19,3,21,13,2,0,0,71
4,9,19,3,21,13,2,5,18,94
4,9,19,3,21,18,5,0,0,79
4,9,19,3,21,18,5,14,0,93
4,9,19,3,21,18,18,5,0,97
4,9,19,3,21,18,19,21,19,133
4,9,19,3,21,19,0,0,0,75
4,9,19,3,21,19,5,19,0,99
4,9,19,3,21,19,19,0,0,94
4,9,19,3,21,19,19,5,4,103
4,9,19,3,21,19,19,5,18,117
4,9,19,3,21,19,19,5,19,118
4,9,19,3,21,19,20,15,13,123
4,9,19,3,21,20,5,0,0,81
4,9,19,4,1,9,14,0,0,60
4,9,19,4,1,9,14,5,4,69
4,9,19,4,1,9,14,5,18,83
4,9,19,4,1,9,14,12,25,97
4,9,19,4,1,9,14,19,0,79
4,9,19,4,1,18,0,0,0,55
4,9,19,4,5,9,6,25,0,81
4,9,19,4,5,9,14,0,0,64
4,9,19,4,9,1,26,15,0,87
4,9,19,4,21,2,0,0,0,59
4,9,19,5,1,19,5,0,0,62
4,9,19,5,1,19,5,4,0,66
4,9,19,5,1,19,5,19,0,81
4,9,19,5,1,19,25,0,0,82
4,9,19,5,1,19,9,14,7,87
4,9,19,5,4,7,5,0,0,53
4,9,19,5,4,9,6,25,0,81
4,9,19,5,7,14,15,0,0,73
4,9,19,5,12,4,5,18,0,76
4,9,19,5,12,5,14,9,4,81
4,9,19,5,13,2,1,25,0,78
4,9,19,5,13,2,1,12,13,78
4,9,19,5,13,2,1,18,11,82
4,9,19,5,13,2,5,4,0,61
4,9,19,5,13,2,15,4,25,96
4,9,19,5,13,5,0,0,0,55
4,9,19,5,13,9,3,0,0,62
4,9,19,5,13,16,12,15,25,118
4,9,19,5,14,1,2,12,5,71
4,9,19,5,14,1,3,20,0,75
4,9,19,5,14,1,13,15,18,98
4,9,19,5,14,4,15,23,0,93
4,9,19,5,14,4,15,23,19,112
4,9,19,5,14,7,1,7,5,71
4,9,19,5,14,10,15,25,0,101
4,9,19,5,14,13,5,19,8,96
4,9,19,5,14,14,21,9,0,95
4,9,19,5,14,15,18,13,0,97
4,9,19,5,14,18,15,12,0,96
4,9,19,5,14,18,15,12,12,108
4,9,19,5,14,19,15,21,12,118
4,9,19,5,14,19,21,18,5,114
4,9,19,5,14,20,1,9,12,93
4,9,19,5,14,20,5,18,0,94
4,25,19,5,14,20,5,18,25,135
4,9,19,5,14,20,15,13,2,101
4,25,19,5,18,7,9,1,0,88
4,9,19,5,18,20,0,0,0,75
4,9,19,5,19,20,5,5,13,99
4,9,19,5,21,18,0,0,0,76
4,9,19,5,21,18,19,0,0,95
4,9,19,5,21,19,5,0,0,82
4,9,19,5,21,19,5,19,0,101
4,9,19,6,1,9,20,8,0,76
4,9,19,6,1,13,5,0,0,57
4,9,19,6,1,22,15,18,0,94
4,9,19,6,1,22,15,18,19,113
4,9,19,6,1,22,15,21,18,115
4,9,19,6,5,14,0,0,0,57
4,9,19,6,9,7,21,18,5,98
4,9,19,6,12,5,19,8,0,82
4,9,19,6,15,18,5,19,20,115
4,9,19,6,15,18,13,0,0,84
4,9,19,6,18,1,13,5,0,75
4,9,19,6,18,9,1,18,0,84
4,9,19,6,18,15,3,11,0,85
4,9,19,6,18,15,3,11,19,104
4,9,19,7,1,7,5,0,0,52
4,9,19,7,1,22,5,12,0,79
4,9,19,7,5,14,9,3,0,70
4,25,19,7,5,14,9,3,0,86
4,25,19,7,5,14,9,3,19,105
4,9,19,7,5,14,9,21,19,107
4,9,19,7,9,7,0,0,0,55
4,9,19,7,12,15,18,25,0,109
4,9,19,7,12,21,20,0,0,92
4,25,19,7,14,15,19,9,1,113
4,25,19,7,15,14,9,3,0,96
4,9,19,7,15,15,4,0,0,73
4,9,19,7,15,18,7,5,0,84
4,9,19,7,15,18,7,5,4,88
4,9,19,7,15,18,7,5,18,102
4,9,19,7,15,18,7,5,19,103
4,9,19,7,15,19,16,5,12,106
4,9,19,7,15,21,20,0,0,95
4,9,19,7,15,23,14,0,0,91
4,9,19,7,18,1,3,5,0,66
4,9,19,7,18,1,3,5,4,70
4,9,19,7,18,1,3,5,18,84
4,9,19,7,18,1,3,5,19,85
4,9,19,7,18,1,3,9,1,71
4,9,19,7,18,1,4,5,0,67
4,9,19,7,18,1,4,5,4,71
4,9,19,7,18,5,19,19,0,100
4,9,19,7,18,15,19,19,0,110
4,9,19,7,21,9,19,1,25,114
4,9,19,7,21,9,19,1,12,101
4,9,19,7,21,9,19,5,0,93
4,9,19,7,21,9,19,5,4,97
4,9,19,7,21,9,19,5,18,111
4,9,19,7,21,9,19,5,19,112
4,9,19,7,21,12,6,0,0,78
4,9,19,7,21,19,20,0,0,99
4,9,19,7,21,19,20,5,4,108
4,9,19,7,21,19,20,5,18,122
4,9,19,7,21,19,20,19,0,118
4,9,19,8,0,0,0,0,0,40
4,9,19,8,1,2,9,20,0,72
4,9,19,8,1,2,12,5,0,60
4,9,19,8,1,12,12,15,23,103
4,9,19,8,1,21,14,20,0,96
4,9,19,8,2,15,1,18,4,80
4,9,19,8,3,12,15,20,8,98
4,9,19,8,3,12,15,21,20,111
4,9,19,8,3,18,15,19,19,114
4,9,19,8,5,1,18,20,0,84
4,9,19,8,5,1,22,5,14,87
4,9,19,8,5,4,0,0,0,49
4,9,19,8,5,9,18,0,0,72
4,9,19,8,5,12,13,0,0,70
4,9,19,8,5,12,13,5,4,79
4,9,19,8,5,12,13,19,0,89
4,9,19,8,5,18,0,0,0,63
4,9,19,8,5,18,5,14,20,102
4,9,19,8,5,18,9,20,0,92
4,9,19,8,5,18,9,20,19,111
4,9,19,8,5,19,0,0,0,64
4,9,19,8,5,22,5,12,0,84
4,9,19,8,5,22,5,12,25,109
4,9,19,8,5,22,5,12,19,103
4,9,19,8,6,21,12,0,0,79
4,9,19,8,6,21,12,19,0,98
4,9,19,8,25,0,0,0,0,65
4,9,19,8,9,5,18,0,0,72
4,9,19,8,9,5,19,20,0,93
4,9,19,8,9,14,7,0,0,70
4,9,19,8,12,9,11,5,0,77
4,9,19,8,12,9,14,7,0,82
4,9,19,8,13,1,11,5,18,88
4,9,19,8,13,15,16,0,0,84
4,9,19,8,15,13,5,0,0,73
4,9,19,8,15,14,5,19,20,113
4,9,19,8,15,14,15,18,0,102
4,9,19,8,15,14,15,18,19,121
4,9,19,8,15,14,15,21,18,123
4,9,19,8,15,18,14,0,0,87
4,9,19,8,15,18,14,5,18,110
4,9,19,8,15,18,19,5,0,97
4,9,19,8,15,21,19,5,0,100
4,9,19,8,16,1,14,0,0,71
4,9,19,8,16,1,14,19,0,90
4,9,19,8,18,1,7,0,0,66
4,9,19,8,18,1,7,19,0,85
4,9,19,8,20,15,23,5,12,115
4,9,19,8,21,13,15,18,0,107
4,9,19,8,21,13,15,21,18,128
4,9,19,8,23,1,18,5,0,87
4,9,19,8,23,1,18,5,19,106
4,9,19,8,23,1,19,8,0,91
4,9,19,8,23,1,20,5,18,107
4,9,19,8,23,9,16,5,18,111
4,9,19,9,12,1,14,5,0,73
4,9,19,9,12,9,3,9,3,77
4,9,19,9,12,9,3,9,4,78
4,9,19,9,12,12,21,4,5,95
4,9,19,9,13,13,21,18,5,111
4,9,19,9,13,16,1,18,11,100
4,9,19,9,14,6,5,3,20,89
4,9,19,9,14,6,5,19,20,105
4,9,19,9,14,8,21,13,5,102
4,9,19,9,14,19,21,18,5,118
4,9,19,9,14,20,5,18,0,98
4,9,19,9,14,20,5,18,19,117
4,9,19,9,14,21,18,5,0,99
4,9,19,9,14,22,5,19,20,121
4,9,19,9,14,22,9,20,5,111
4,9,19,25,15,11,5,0,0,88
4,9,19,25,15,11,5,4,0,92
4,9,19,25,15,11,5,19,0,107
4,9,19,25,15,11,9,14,7,113
4,9,19,10,1,19,11,5,4,82
4,9,19,10,1,19,11,5,20,98
4,9,19,10,1,19,11,9,20,102
4,9,19,10,5,3,20,0,0,70
4,9,19,10,5,3,20,5,4,79
4,9,19,10,5,3,20,19,0,89
4,9,19,10,5,21,14,5,0,87
4,9,19,10,15,9,14,0,0,80
4,9,19,10,15,9,14,5,4,89
4,9,19,10,15,9,14,19,0,99
4,9,19,10,15,9,14,20,0,100
4,9,19,10,15,9,14,20,19,119
4,9,19,10,21,14,3,20,0,100
4,9,19,10,21,14,3,20,19,119
4,9,19,10,21,14,5,0,0,82
4,9,19,11,0,0,0,0,0,43
4,9,19,11,5,4,0,0,0,52
4,9,19,11,5,12,9,15,14,98
4,9,19,11,5,18,0,0,0,66
4,9,19,11,5,18,25,0,0,91
4,9,19,11,5,20,20,5,0,93
4,9,19,11,5,20,20,5,19,112
4,9,19,11,9,14,7,0,0,73
4,9,19,11,12,5,19,19,0,98
4,9,19,11,12,9,11,5,0,80
4,9,19,11,14,15,23,0,0,95
4,9,19,11,15,19,0,0,0,77
4,9,19,11,19,0,0,0,0,62
4,9,19,12,1,4,5,0,0,54
4,9,19,12,1,4,25,0,0,74
4,25,19,12,1,12,9,1,0,83
4,9,19,12,1,21,18,5,12,101
4,9,19,12,5,1,6,0,0,56
4,9,19,12,5,1,6,5,4,65
4,9,19,12,5,1,12,0,0,62
4,9,19,12,5,1,22,5,0,77
4,9,19,12,5,1,22,5,4,81
4,25,19,12,5,3,20,9,3,100
4,25,19,12,5,24,9,1,0,99
4,25,19,12,5,24,9,1,19,118
4,25,19,12,5,24,9,3,0,101
4,25,19,12,5,24,9,3,19,120
4,9,19,12,9,0,0,0,0,53
4,9,19,12,9,11,5,0,0,69
4,9,19,12,9,11,5,4,0,73
4,9,19,12,9,11,5,14,0,83
4,9,19,12,9,11,5,18,0,87
4,9,19,12,9,11,5,18,19,106
4,9,19,12,9,11,5,19,0,88
4,9,19,12,9,11,9,14,7,94
4,9,19,12,9,13,2,0,0,68
4,9,19,12,9,13,14,0,0,80
4,9,19,12,9,13,14,5,4,89
4,9,19,12,9,13,14,19,0,99
4,9,19,12,9,14,11,0,0,78
4,9,19,12,9,16,0,0,0,69
4,25,19,12,25,19,9,14,0,127
4,9,19,12,9,22,5,0,0,80
4,9,19,12,15,1,4,0,0,64
4,9,19,12,15,3,1,20,5,88
4,9,19,12,15,3,11,0,0,73
4,9,19,12,15,4,7,5,0,75
4,9,19,12,15,4,7,5,4,79
4,9,19,12,15,4,7,5,19,94
4,25,19,12,15,7,25,0,0,107
4,25,19,12,15,7,9,1,0,92
4,9,19,12,15,25,1,12,0,97
4,9,19,12,15,9,7,14,0,89
4,9,19,12,15,22,5,0,0,86
4,25,19,12,21,9,20,5,0,115
4,9,19,12,21,19,20,5,18,127
4,9,19,12,21,19,20,18,5,127
4,9,19,13,1,25,0,0,0,71
4,9,19,13,1,25,5,4,0,80
4,9,19,13,1,25,6,21,12,110
4,9,19,13,1,25,9,14,7,101
4,9,19,13,1,9,12,0,0,67
4,9,19,13,1,9,14,0,0,69
4,9,19,13,1,25,19,0,0,90
4,9,19,13,1,12,0,0,0,58
4,9,19,13,1,12,5,18,0,81
4,9,19,13,1,12,5,19,20,102
4,9,19,13,1,12,9,20,25,112
4,9,19,13,1,12,9,26,5,98
4,9,19,13,1,12,12,25,0,95
4,9,19,13,1,12,19,0,0,77
4,9,19,13,1,14,0,0,0,60
4,9,19,13,1,14,20,12,5,97
4,9,19,13,1,18,2,12,5,83
4,9,19,13,1,18,3,8,0,75
4,9,19,13,1,18,11,0,0,75
4,9,19,13,1,18,11,5,20,100
4,9,19,13,1,18,18,25,0,107
4,9,19,13,1,19,11,0,0,76
4,9,19,13,1,19,20,0,0,85
4,9,19,13,1,19,20,5,4,94
4,9,19,13,1,19,20,19,0,104
4,9,19,13,1,23,0,0,0,69
4,9,19,13,5,0,0,0,0,50
4,9,19,13,5,13,2,5,18,88
4,25,19,13,5,18,9,19,13,125
4,9,19,13,5,18,9,20,0,97
4,9,19,13,5,19,0,0,0,69
4,25,19,13,5,20,18,9,1,114
4,9,19,13,9,14,9,15,14,106
4,9,19,13,9,19,19,0,0,92
4,9,19,13,9,19,19,5,4,101
4,9,19,13,9,19,19,5,18,115
4,9,19,13,9,19,19,5,19,116
4,9,19,13,9,20,0,0,0,74
4,25,19,13,14,5,19,9,1,109
4,9,19,13,15,4,5,4,0,73
4,9,19,13,15,21,14,20,0,115
4,9,19,13,15,21,14,20,19,134
4,9,19,14,1,0,0,0,0,47
4,9,19,14,1,20,21,18,5,111
4,9,19,14,5,19,20,0,0,90
4,25,19,14,5,21,18,9,1,116
4,9,19,14,5,23,0,0,0,74
4,9,19,14,9,3,8,5,0,71
4,25,19,14,15,13,25,0,0,115
4,9,19,14,15,19,5,4,0,89
4,9,19,14,21,13,2,5,18,105
4,9,19,15,2,5,25,0,0,79
4,9,19,15,2,5,25,1,12,92
4,9,19,15,2,5,25,5,4,88
4,9,19,15,2,5,25,5,18,102
4,9,19,15,2,5,25,19,0,98
4,9,19,15,2,12,9,7,5,82
4,9,19,15,3,3,21,16,25,115
4,9,19,15,4,9,3,0,0,63
4,25,19,15,4,9,12,5,0,93
4,25,19,15,4,25,12,5,0,109
4,9,19,15,4,9,21,13,0,94
4,9,19,15,13,1,20,25,0,106
4,9,19,15,13,1,20,9,3,93
4,9,19,15,13,9,3,0,0,72
4,9,19,15,13,21,19,0,0,100
4,9,19,15,18,2,0,0,0,67
4,9,19,15,18,4,1,9,14,93
4,9,19,15,18,4,5,18,0,92
4,9,19,15,18,4,5,18,19,111
4,25,19,15,18,5,24,25,0,135
4,25,19,15,18,5,24,9,1,120
4,9,19,15,18,9,5,14,20,113
4,9,19,15,21,18,0,0,0,86
4,9,19,15,23,14,0,0,0,84
4,9,19,15,23,14,5,4,0,93
4,9,19,15,23,14,9,14,7,114
4,9,19,15,23,14,19,0,0,103
4,9,19,16,0,0,0,0,0,48
4,9,19,16,1,3,5,0,0,57
4,9,19,16,1,9,14,20,0,92
4,9,19,16,1,9,18,0,0,76
4,9,19,16,1,14,4,0,0,67
4,9,19,16,1,18,0,0,0,67
4,9,19,16,1,18,1,7,5,80
4,9,19,16,1,18,1,20,5,93
4,9,19,16,1,18,9,19,8,103
4,9,19,16,1,18,9,20,25,121
4,9,19,16,1,18,11,0,0,78
4,9,19,16,1,18,11,12,5,95
4,9,19,16,1,18,16,12,5,100
4,9,19,16,1,18,20,0,0,87
4,9,19,16,1,18,20,5,4,96
4,9,19,16,1,18,20,19,0,106
4,9,19,16,1,20,3,8,0,80
4,9,19,16,1,20,8,25,0,102
4,25,19,16,1,20,8,25,0,118
4,9,19,16,1,21,16,5,18,109
4,9,19,16,5,1,3,5,0,62
4,9,19,16,5,5,4,0,0,62
4,9,19,16,5,12,0,0,0,65
4,9,19,16,5,12,12,0,0,77
4,9,19,16,5,12,12,5,4,86
4,9,19,16,5,12,12,5,18,100
4,9,19,16,5,12,12,19,0,96
4,9,19,16,5,12,19,0,0,84
4,9,19,16,5,14,3,5,0,75
4,9,19,16,5,14,4,0,0,71
4,9,19,16,5,14,4,5,4,80
4,9,19,16,5,14,4,5,18,94
4,9,19,16,5,14,4,19,0,90
4,9,19,16,5,14,19,5,0,91
4,9,19,16,5,14,19,5,4,95
4,9,19,16,5,14,19,5,18,109
4,9,19,16,5,14,19,5,19,110
4,9,19,16,5,15,16,12,5,101
4,25,19,16,5,16,19,25,0,129
4,25,19,16,5,16,19,9,1,114
4,25,19,16,5,16,20,9,3,117
4,9,19,16,5,18,1,20,15,107
4,9,19,16,5,18,7,5,0,83
4,9,19,16,5,18,13,25,0,109
4,9,19,16,5,18,13,9,3,96
4,9,19,16,5,18,16,12,5,104
4,9,19,16,5,18,19,1,12,103
4,9,19,16,5,18,19,5,0,95
4,9,19,16,5,18,19,5,4,99
4,9,19,16,5,18,19,5,18,113
4,9,19,16,5,18,19,5,19,114
4,9,19,16,5,20,1,12,0,86
4,25,19,16,8,1,7,9,1,90
4,25,19,16,8,1,7,9,3,92
4,25,19,16,8,1,19,9,1,102
4,25,19,16,8,1,19,9,3,104
4,25,19,16,8,5,13,9,1,100
4,25,19,16,8,15,14,9,1,111
4,25,19,16,8,15,14,9,3,113
4,25,19,16,8,15,18,9,1,115
4,25,19,16,8,15,18,9,3,117
4,25,19,16,8,15,20,9,3,119
4,9,19,16,9,3,9,15,14,98
4,9,19,16,9,5,3,5,0,70
4,9,19,16,9,18,5,13,0,93
4,9,19,16,9,18,5,13,5,98
4,9,19,16,9,18,9,20,0,104
4,9,19,16,9,18,9,20,19,123
4,9,19,16,12,1,3,5,0,69
4,9,19,16,12,1,3,5,4,73
4,9,19,16,12,1,3,5,18,87
4,9,19,16,12,1,3,5,19,88
4,9,19,16,12,1,25,0,0,86
4,9,19,16,12,1,25,5,4,95
4,9,19,16,12,1,25,5,18,109
4,9,19,16,12,1,25,19,0,105
4,9,19,16,12,1,14,20,0,95
4,9,19,16,12,1,14,20,19,114
4,25,19,16,12,1,19,9,1,106
4,9,19,16,12,1,20,0,0,81
4,9,19,16,12,5,0,0,0,65
4,9,19,16,12,5,1,19,5,90
4,9,19,16,12,15,4,5,0,84
4,9,19,16,12,15,4,5,4,88
4,9,19,16,12,15,4,5,19,103
4,9,19,16,12,21,13,5,0,99
4,9,19,16,12,21,13,5,4,103
4,9,19,16,12,21,13,5,19,118
4,25,19,16,14,5,1,0,0,84
4,25,19,16,14,5,1,12,0,96
4,25,19,16,14,5,1,19,0,103
4,25,19,16,14,5,9,3,0,95
4,25,19,16,14,15,5,1,0,99
4,25,19,16,14,15,5,1,12,111
4,25,19,16,14,15,5,1,19,118
4,25,19,16,14,15,5,9,3,110
4,25,19,16,14,15,9,0,0,102
4,25,19,16,14,15,9,3,0,105
4,9,19,16,15,9,14,20,0,106
4,9,19,16,15,14,4,0,0,81
4,9,19,16,15,14,4,5,5,91
4,9,19,16,15,14,5,0,0,82
4,9,19,16,15,14,5,4,0,86
4,9,19,16,15,14,5,5,0,87
4,9,19,16,15,14,5,14,20,116
4,9,19,16,15,14,5,18,0,100
4,9,19,16,15,14,7,5,0,89
4,9,19,16,15,14,9,14,7,107
4,9,19,16,15,16,5,0,0,84
4,9,19,16,15,18,15,21,19,136
4,9,19,16,15,18,20,0,0,101
4,9,19,16,15,18,20,5,4,110
4,9,19,16,15,18,20,19,0,120
4,9,19,16,15,19,1,12,0,95
4,9,19,16,15,19,1,12,19,114
4,9,19,16,15,19,5,0,0,87
4,9,19,16,15,19,5,4,0,91
4,9,19,16,15,19,5,18,0,105
4,9,19,16,15,19,5,18,19,124
4,9,19,16,15,19,5,19,0,106
4,9,19,16,15,19,9,14,7,112
4,9,19,16,15,19,9,20,0,111
4,9,19,16,15,19,19,5,4,110
4,9,19,16,15,19,20,0,0,102
4,9,19,16,15,19,21,18,5,126
4,9,19,16,15,23,4,5,18,113
4,9,19,16,18,1,9,19,5,100
4,25,19,16,18,1,24,9,1,117
4,9,19,16,18,5,1,4,0,76
4,9,19,16,18,5,1,4,19,95
4,9,19,16,18,5,19,19,0,109
4,9,19,16,18,9,14,3,5,97
4,9,19,16,18,9,19,15,14,123
4,9,19,16,18,9,26,5,0,106
4,9,19,16,18,9,26,5,4,110
4,9,19,16,18,9,26,5,19,125
4,9,19,16,18,15,6,9,20,116
4,9,19,16,18,15,15,6,0,102
4,9,19,16,18,15,15,6,19,121
4,25,19,16,18,15,19,9,1,126
4,9,19,16,18,15,22,1,12,116
4,9,19,16,18,15,22,5,0,108
4,9,19,16,18,15,22,5,4,112
4,9,19,16,18,15,22,5,14,122
4,9,19,16,18,15,22,5,18,126
4,9,19,16,18,15,22,5,19,127
4,9,19,16,21,12,16,0,0,97
4,9,19,16,21,14,3,20,0,106
4,9,19,16,21,14,7,5,0,95
4,9,19,16,21,18,19,5,0,111
4,9,19,16,21,18,22,5,25,139
4,9,19,16,21,20,1,14,20,124
4,9,19,16,21,20,5,0,0,94
4,9,19,16,21,20,5,4,0,98
4,9,19,16,21,20,5,18,0,112
4,9,19,16,21,20,5,18,19,131
4,9,19,16,21,20,5,19,0,113
4,9,19,16,21,20,9,14,7,119
4,9,19,17,21,9,5,20,0,104
4,9,19,17,21,9,5,20,19,123
4,9,19,17,21,9,19,9,20,127
4,9,19,18,1,25,0,0,0,76
4,9,19,18,1,14,7,5,0,77
4,9,19,18,1,14,11,0,0,76
4,25,19,18,1,16,8,9,1,101
4,9,19,18,1,20,5,0,0,76
4,9,19,18,1,20,5,4,0,80
4,9,19,18,1,20,5,19,0,95
4,9,19,18,1,20,9,14,7,101
4,9,19,18,5,1,19,15,14,104
4,9,19,18,5,7,1,18,4,85
4,9,19,18,5,12,1,20,5,93
4,9,19,18,5,12,9,19,8,103
4,9,19,18,5,16,1,9,18,99
4,9,19,18,5,16,15,18,20,124
4,9,19,18,5,16,21,20,5,117
4,9,19,18,5,19,20,0,0,94
4,9,19,18,9,14,7,0,0,80
4,9,19,18,15,2,5,0,0,72
4,9,19,18,15,2,5,4,0,76
4,9,19,18,15,2,5,18,0,90
4,9,19,18,15,2,5,18,19,109
4,9,19,18,15,2,5,19,0,91
4,9,19,18,15,2,9,14,7,97
4,9,19,18,15,15,6,0,0,86
4,9,19,18,15,15,19,20,0,119
4,9,19,18,15,15,20,0,0,100
4,9,19,18,15,15,20,5,4,109
4,9,19,18,15,15,20,19,0,119
4,9,19,18,15,21,20,0,0,106
4,9,19,18,21,4,4,5,18,102
4,9,19,18,21,12,25,0,0,108
4,9,19,18,21,13,16,0,0,100
4,9,19,18,21,16,20,0,0,107
4,9,19,18,21,16,20,5,4,116
4,9,19,18,21,16,20,5,18,130
4,9,19,18,21,16,20,15,18,140
4,9,19,18,21,16,20,19,0,126
4,9,19,19,0,0,0,0,0,51
4,9,19,19,1,9,20,0,0,81
4,9,19,19,1,22,1,0,0,75
4,9,19,19,1,22,1,7,5,87
4,9,19,19,1,22,5,0,0,79
4,9,19,19,1,22,5,4,0,83
4,9,19,19,1,22,5,19,0,98
4,9,19,19,1,22,9,14,7,104
4,9,19,19,1,22,19,0,0,93
4,9,19,19,5,1,19,15,14,105
4,9,19,19,5,1,20,0,0,77
4,9,19,19,5,1,20,5,4,86
4,9,19,19,5,1,20,19,0,96
4,9,19,19,5,3,20,0,0,79
4,9,19,19,5,3,20,5,4,88
4,9,19,19,5,3,20,15,18,112
4,9,19,19,5,3,20,19,0,98
4,9,19,19,5,9,19,5,0,89
4,9,19,19,5,9,19,5,4,93
4,9,19,19,5,9,19,5,5,94
4,9,19,19,5,9,19,5,19,108
4,9,19,19,5,9,19,9,14,107
4,9,19,19,5,9,19,15,18,117
4,9,19,19,5,9,26,5,0,96
4,9,19,19,5,9,26,5,4,100
4,9,19,19,5,9,26,5,5,101
4,9,19,19,5,9,26,5,19,115
4,9,19,19,5,9,26,9,14,114
4,9,19,19,5,9,26,15,18,124
4,9,19,19,5,13,2,12,5,88
4,9,19,19,5,13,2,12,25,108
4,9,19,19,5,14,20,0,0,90
4,9,19,19,5,14,20,5,4,99
4,9,19,19,5,14,20,19,0,109
4,9,19,19,5,18,20,0,0,94
4,9,19,19,5,18,20,5,4,103
4,9,19,19,5,18,20,19,0,113
4,9,19,19,5,18,22,5,0,101
4,9,19,19,5,18,22,5,4,105
4,9,19,19,5,18,22,5,19,120
4,9,19,19,5,20,20,12,5,113
4,9,19,19,5,22,5,18,0,101
4,9,19,19,5,22,5,18,19,120
4,9,19,19,8,1,4,15,23,102
4,9,19,19,8,9,16,0,0,84
4,9,19,19,8,9,22,5,18,113
4,9,19,19,8,18,15,21,4,117
4,9,19,19,9,4,5,14,20,103
4,9,19,19,9,7,8,20,0,95
4,9,19,19,9,13,9,12,5,99
4,9,19,19,9,13,21,12,5,111
4,9,19,19,9,14,5,23,0,102
4,9,19,19,9,16,1,20,5,102
4,9,19,19,9,20,5,0,0,85
4,25,19,19,14,9,20,5,0,115
4,9,19,19,15,3,9,1,12,91
4,9,19,19,15,7,5,14,25,117
4,9,19,19,15,7,15,14,25,127
4,9,19,19,15,12,21,20,5,124
4,9,19,19,15,12,22,5,0,105
4,9,19,19,15,12,22,5,4,109
4,9,19,19,15,12,22,5,18,123
4,9,19,19,15,12,22,5,19,124
4,9,19,19,15,14,1,14,20,115
4,9,19,19,15,14,1,20,5,106
4,9,19,19,15,14,15,21,19,135
4,9,19,19,15,21,12,0,0,99
4,9,19,19,15,21,18,0,0,105
4,9,19,19,16,9,18,9,20,123
4,9,19,19,16,18,5,1,4,95
4,9,19,19,20,1,20,5,0,97
4,9,19,19,21,1,4,5,0,82
4,9,19,19,21,1,4,5,4,86
4,9,19,19,21,1,4,5,18,100
4,9,19,19,21,1,4,5,19,101
4,9,19,19,21,5,0,0,0,77
4,9,19,19,21,9,20,0,0,101
4,9,19,19,21,9,20,5,4,110
4,9,19,19,21,14,4,5,18,113
4,9,19,20,0,0,0,0,0,52
4,9,19,20,1,4,0,0,0,57
4,9,19,20,1,6,6,0,0,65
4,9,19,20,1,6,6,19,0,84
4,9,19,20,1,9,14,0,0,76
4,9,19,20,1,9,14,5,4,85
4,9,19,20,1,9,14,19,0,95
4,9,19,20,1,12,0,0,0,65
4,9,19,20,1,12,5,0,0,70
4,9,19,20,1,12,9,1,0,75
4,9,19,20,1,12,12,25,0,102
4,9,19,20,1,14,3,5,0,75
4,9,19,20,1,14,3,5,4,79
4,9,19,20,1,14,3,5,19,94
4,9,19,20,1,14,3,25,0,95
4,9,19,20,1,14,14,9,3,93
4,9,19,20,1,14,20,0,0,87
4,9,19,20,1,14,20,12,25,124
4,9,19,20,1,19,20,5,0,97
4,9,19,20,1,19,20,5,4,101
4,9,19,20,1,19,20,5,19,116
4,9,19,20,1,20,5,18,0,96
4,9,19,20,1,22,5,19,0,99
4,25,19,20,1,24,9,1,0,103
4,25,19,20,1,24,9,1,19,122
4,25,19,20,5,3,20,9,3,108
4,9,19,20,5,13,16,5,18,109
4,9,19,20,5,14,1,14,20,106
4,9,19,20,5,14,4,0,0,75
4,9,19,20,5,14,4,5,4,84
4,9,19,20,5,14,4,5,18,98
4,9,19,20,5,14,4,19,0,94
4,9,19,20,5,14,20,0,0,91
4,9,19,20,5,18,0,0,0,75
4,9,19,20,5,18,18,0,0,93
4,9,19,20,8,5,14,5,0,84
4,25,19,20,8,25,13,9,1,124
4,25,19,20,8,25,13,9,3,126
4,9,19,20,8,18,1,12,12,103
4,9,19,20,8,18,15,14,5,112
4,9,19,20,25,0,0,0,0,77
4,9,19,20,9,3,8,0,0,72
4,9,19,20,9,3,8,1,12,85
4,9,19,20,9,3,8,19,0,91
4,9,19,20,9,12,0,0,0,73
4,9,19,20,25,12,1,18,0,108
4,9,19,20,25,12,5,0,0,94
4,9,19,20,9,12,5,18,25,121
4,9,19,20,9,12,12,0,0,85
4,9,19,20,9,12,12,5,4,94
4,9,19,20,9,12,12,5,18,108
4,9,19,20,9,12,12,19,0,104
4,9,19,20,9,12,19,0,0,92
4,9,19,20,9,14,3,20,0,98
4,9,19,20,9,14,7,21,0,103
4,9,19,20,9,14,7,21,5,108
4,9,19,20,9,20,12,5,0,98
4,9,19,20,14,0,0,0,0,66
4,25,19,20,15,3,9,1,0,96
4,25,19,20,15,3,9,1,12,108
4,25,19,20,15,3,9,1,19,115
4,9,19,20,15,13,5,0,0,85
4,25,19,20,15,13,5,0,0,101
4,9,19,20,15,13,5,19,0,104
4,9,19,20,15,13,9,1,14,104
4,25,19,20,15,13,9,3,0,108
4,25,19,20,15,13,15,21,19,151
4,25,19,20,15,14,9,1,0,107
4,25,19,20,15,14,9,1,19,126
4,25,19,20,15,14,9,3,0,109
4,25,19,20,15,16,9,1,0,109
4,25,19,20,15,16,9,1,14,123
4,25,19,20,15,16,9,1,19,128
4,9,19,20,15,18,20,0,0,105
4,9,19,20,15,18,20,5,4,114
4,9,19,20,15,18,20,5,18,128
4,9,19,20,15,18,20,19,0,124
4,9,19,20,18,0,0,0,0,70
4,9,19,20,18,1,3,20,0,94
4,9,19,20,18,1,3,20,19,113
4,9,19,20,18,1,9,12,0,92
4,9,19,20,18,1,9,14,0,94
4,9,19,20,18,1,9,14,19,113
4,9,19,20,18,1,9,14,20,114
4,9,19,20,18,1,9,20,0,100
4,9,19,20,18,1,9,20,5,105
4,9,19,20,18,5,1,13,0,89
4,9,19,20,18,5,19,19,0,113
4,9,19,20,18,5,19,20,0,114
4,9,19,20,18,9,3,20,0,102
4,9,19,20,18,9,3,20,19,121
4,9,19,20,18,9,20,15,0,114
4,9,19,20,18,9,20,15,19,133
4,9,19,20,18,9,24,0,0,103
4,25,19,20,18,15,16,8,25,150
4,9,19,20,18,21,19,19,0,129
4,9,19,20,18,21,19,20,0,130
4,9,19,20,18,21,19,20,19,149
4,9,19,20,21,14,5,0,0,92
4,9,19,20,21,18,2,0,0,93
4,9,19,20,21,18,2,5,4,102
4,9,19,20,21,18,2,5,18,116
4,9,19,20,21,18,2,15,18,126
4,9,19,20,21,18,2,19,0,112
4,9,19,20,21,18,14,0,0,105
4,9,19,21,12,6,1,20,5,97
4,9,19,21,12,6,9,4,0,84
4,9,19,21,12,6,9,4,5,89
4,9,19,21,12,6,9,4,19,103
4,9,19,21,12,16,8,9,4,102
4,9,19,21,14,9,6,25,0,107
4,9,19,21,14,9,15,14,0,105
4,9,19,21,14,9,15,14,19,124
4,9,19,21,14,9,20,5,0,101
4,9,19,21,14,9,20,5,4,105
4,9,19,21,14,9,20,5,18,119
4,9,19,21,14,9,20,5,19,120
4,9,19,21,14,9,20,25,0,121
4,25,19,21,18,25,0,0,0,112
4,25,19,21,18,9,1,0,0,97
4,25,19,21,18,9,1,19,0,116
4,25,19,21,18,9,3,0,0,99
4,9,19,21,19,1,7,5,0,85
4,9,19,21,19,1,14,3,5,95
4,9,19,21,19,5,0,0,0,77
4,9,19,21,19,5,4,0,0,81
4,9,19,21,19,5,19,0,0,96
4,9,19,21,19,9,14,7,0,102
4,9,19,22,1,12,21,5,0,93
4,9,19,22,1,12,21,5,4,97
4,9,19,22,1,12,21,5,19,112
4,9,19,22,5,12,15,16,0,102
4,9,19,22,9,19,1,7,5,95
4,9,19,22,9,19,15,18,0,115
4,9,19,22,15,9,3,5,0,86
4,9,19,22,15,21,3,8,0,101
4,9,19,23,1,18,14,0,0,88
4,9,19,23,1,18,18,5,14,111
4,9,19,23,5,1,16,15,14,106
4,9,19,23,5,14,3,8,0,85
4,9,19,23,5,18,5,0,0,83
4,9,19,23,9,20,0,0,0,84
4,9,19,23,15,14,20,0,0,104
4,9,19,23,15,15,4,0,0,89
4,9,19,23,15,18,20,8,0,116
4,9,20,0,0,0,0,0,0,33
4,9,20,1,12,0,0,0,0,46
4,9,20,1,12,9,0,0,0,55
4,9,20,1,12,9,14,9,0,78
4,9,20,1,19,0,0,0,0,53
4,9,20,1,20,9,15,14,0,92
4,9,20,3,8,0,0,0,0,44
4,9,20,3,8,2,1,14,11,72
4,9,20,3,8,2,21,18,0,85
4,9,20,3,8,4,15,23,14,100
4,9,20,3,8,5,4,0,0,53
4,9,20,3,8,5,18,0,0,67
4,9,20,3,8,5,18,19,0,86
4,9,20,3,8,5,19,0,0,68
4,9,20,3,8,9,14,7,0,74
4,9,20,3,8,12,5,19,19,99
4,9,20,3,8,19,9,4,5,81
4,9,20,5,0,0,0,0,0,38
4,9,20,5,18,0,0,0,0,56
4,9,20,5,18,16,5,14,5,96
4,9,20,5,19,0,0,0,0,57
4,9,20,8,1,12,15,21,19,109
4,9,20,8,5,3,1,12,0,62
4,9,20,8,5,3,15,21,19,104
4,9,20,8,5,9,19,13,0,87
4,9,20,8,5,9,19,13,19,106
4,9,20,8,5,9,19,20,0,94
4,9,20,8,5,9,19,20,19,113
4,9,20,8,5,18,0,0,0,64
4,9,20,8,5,18,5,4,0,73
4,9,20,8,5,18,5,18,0,87
4,9,20,8,5,18,25,0,0,89
4,9,20,8,5,18,9,14,7,94
4,9,20,8,5,18,19,0,0,83
4,9,20,8,25,13,15,12,0,106
4,9,20,8,9,15,9,3,0,77
4,9,20,8,9,15,12,0,0,77
4,9,20,8,9,15,14,0,0,79
4,9,20,8,9,15,14,9,3,91
4,9,20,8,25,18,1,13,2,100
4,9,20,9,14,7,0,0,0,63
4,9,20,9,15,14,0,0,0,71
4,25,20,9,19,3,9,4,0,93
4,9,20,15,11,15,21,19,0,114
4,9,20,15,12,25,12,0,0,97
4,9,20,15,14,5,0,0,0,67
4,9,20,18,5,13,9,4,0,82
4,9,20,18,15,3,8,5,5,87
4,9,20,18,15,9,20,5,0,100
4,9,20,19,0,0,0,0,0,52
4,9,20,19,25,0,0,0,0,77
4,9,20,19,9,5,18,0,0,84
4,9,20,19,9,5,19,20,0,105
4,9,20,20,0,0,0,0,0,53
4,9,20,20,1,25,0,0,0,79
4,9,20,20,1,13,25,0,0,92
4,9,20,20,1,14,4,5,18,95
4,9,20,20,1,14,25,0,0,93
4,9,20,20,1,14,9,5,19,101
4,9,20,20,5,4,0,0,0,62
4,9,20,20,25,0,0,0,0,78
4,9,20,20,9,5,4,0,0,71
4,9,20,20,9,5,19,0,0,86
4,9,20,20,25,9,14,7,0,108
4,9,20,20,9,14,7,0,0,83
4,9,20,20,15,5,4,0,0,77
4,9,20,20,15,5,19,0,0,92
4,9,20,20,15,7,18,1,13,107
4,9,20,20,15,9,14,7,0,98
4,9,20,20,15,12,15,7,25,127
4,9,20,20,15,14,0,0,0,82
4,9,20,20,15,19,0,0,0,87
4,9,20,26,25,0,0,0,0,84
4,9,20,26,9,5,18,0,0,91
4,9,20,26,9,5,19,20,0,112
4,9,21,18,1,14,1,20,5,93
4,9,21,18,5,9,4,5,0,75
4,9,21,18,5,19,5,19,0,100
4,9,21,18,5,19,9,19,0,104
4,9,21,18,5,20,9,3,0,89
4,9,21,18,5,20,9,3,19,108
4,9,21,18,14,0,0,0,0,66
4,9,21,18,14,1,12,0,0,79
4,9,21,18,14,1,12,12,25,116
4,9,21,18,14,1,12,19,0,98
4,9,21,18,14,5,0,0,0,71
4,9,21,18,14,21,12,5,0,104
4,9,21,18,15,14,0,0,0,81
4,9,21,18,15,14,19,0,0,100
4,9,21,20,21,18,14,1,12,120
4,9,22,1,0,0,0,0,0,36
4,9,22,1,7,1,20,5,0,69
4,9,22,1,7,1,20,5,4,73
4,9,22,1,7,1,20,5,19,88
4,9,22,1,12,5,14,3,5,75
4,9,22,1,12,5,14,20,0,87
4,9,22,1,14,0,0,0,0,50
4,9,22,1,14,19,0,0,0,69
4,9,22,1,18,9,1,14,20,98
4,9,22,1,19,0,0,0,0,55
4,9,22,1,19,20,0,0,0,75
4,9,22,1,20,1,0,0,0,57
4,9,22,5,0,0,0,0,0,40
4,9,22,5,2,15,13,2,0,72
4,9,22,5,4,0,0,0,0,44
4,9,22,5,12,0,0,0,0,52
4,9,22,5,12,12,0,0,0,64
4,9,22,5,12,12,5,4,0,73
4,9,22,5,12,12,5,14,20,103
4,9,22,5,12,12,9,14,7,94
4,9,22,5,18,2,0,0,0,60
4,9,22,5,18,7,5,0,0,70
4,9,22,5,18,7,5,4,0,74
4,9,22,5,18,7,5,14,20,104
4,9,22,5,18,7,5,19,0,89
4,9,22,5,18,7,9,14,7,95
4,9,22,5,18,19,0,0,0,77
4,9,22,5,18,19,5,0,0,82
4,9,22,5,18,19,5,12,25,119
4,9,22,5,18,19,9,6,25,117
4,9,22,5,18,19,9,15,14,115
4,9,22,5,18,19,9,20,25,131
4,9,22,5,18,19,12,25,0,114
4,9,22,5,18,19,15,18,25,135
4,9,22,5,18,20,0,0,0,78
4,9,22,5,18,20,5,4,0,87
4,9,22,5,18,20,5,18,0,101
4,9,22,5,18,20,5,18,19,120
4,9,22,5,18,20,9,12,1,100
4,9,22,5,18,20,9,14,7,108
4,9,22,5,18,20,9,19,5,111
4,9,22,5,18,20,9,22,5,114
4,9,22,5,18,20,15,18,0,111
4,9,22,5,18,20,19,0,0,97
4,9,22,5,19,20,0,0,0,79
4,9,22,5,19,20,5,4,0,88
4,9,22,5,19,20,9,14,7,109
4,9,22,5,19,20,19,0,0,98
4,9,22,5,19,20,21,18,5,123
4,9,22,5,20,0,0,0,0,60
4,9,22,9,0,0,0,0,0,44
4,9,22,9,1,0,0,0,0,45
4,9,22,9,4,0,0,0,0,48
4,9,22,9,4,1,2,12,5,68
4,9,22,9,4,1,14,20,0,83
4,9,22,9,4,5,0,0,0,53
4,9,22,9,4,5,4,0,0,57
4,9,22,9,4,5,4,12,25,94
4,9,22,9,4,5,14,4,0,71
4,9,22,9,4,5,14,4,19,90
4,9,22,9,4,5,14,20,0,87
4,9,22,9,4,5,18,0,0,71
4,9,22,9,4,5,18,19,0,90
4,9,22,9,4,5,19,0,0,72
4,9,22,9,4,9,14,7,0,78
4,9,22,9,4,9,22,9,19,107
4,9,22,9,4,21,1,12,0,82
4,9,22,9,4,21,9,20,25,123
4,9,22,9,4,21,15,21,19,124
4,9,22,9,14,1,2,12,5,78
4,9,22,9,14,1,9,12,0,80
4,9,22,9,14,1,20,15,18,112
4,9,22,9,14,5,4,0,0,67
4,9,22,9,14,5,12,25,0,100
4,9,22,9,14,5,18,0,0,81
4,9,22,9,14,5,18,19,0,100
4,9,22,9,14,5,19,0,0,82
4,9,22,9,14,5,19,19,5,106
4,9,22,9,14,5,19,20,0,102
4,9,22,9,14,7,0,0,0,65
4,9,22,9,14,9,6,25,0,98
4,9,22,9,14,25,12,0,0,95
4,9,22,9,14,9,14,7,0,88
4,9,22,9,14,9,19,5,0,91
4,9,22,9,14,9,19,5,4,95
4,9,22,9,14,9,19,5,19,110
4,9,22,9,14,9,20,25,0,112
4,9,22,9,14,9,26,5,0,98
4,9,22,9,14,9,26,5,4,102
4,9,22,9,14,9,26,5,19,117
4,9,22,9,19,1,0,0,0,64
4,9,22,9,19,5,0,0,0,68
4,9,22,9,19,9,0,0,0,72
4,9,22,9,19,9,2,12,5,91
4,9,22,9,19,9,2,12,25,111
4,9,22,9,19,9,15,14,19,120
4,9,22,9,19,9,22,5,0,99
4,9,22,9,19,15,18,0,0,96
4,9,22,9,19,15,18,25,0,121
4,9,22,9,19,15,18,19,0,115
4,9,22,9,19,21,18,1,12,115
4,9,22,15,18,3,5,0,0,76
4,9,22,15,18,3,5,4,0,80
4,9,22,15,18,3,5,5,0,81
4,9,22,15,18,3,5,5,19,100
4,9,22,15,18,3,5,18,0,94
4,9,22,15,18,3,5,18,19,113
4,9,22,15,18,3,5,19,0,95
4,9,22,15,18,3,9,14,7,101
4,9,22,15,18,3,9,22,5,107
4,9,22,15,18,20,0,0,0,88
4,9,22,15,20,0,0,0,0,70
4,9,22,15,20,15,0,0,0,85
4,9,22,15,20,19,0,0,0,89
4,25,22,15,21,18,0,0,0,105
4,25,22,15,21,18,19,0,0,124
4,9,22,21,12,7,1,20,5,101
4,9,22,21,12,7,5,0,0,80
4,9,22,21,12,7,5,4,0,84
4,9,22,21,12,7,5,18,0,98
4,9,22,21,12,7,5,18,19,117
4,9,22,21,12,7,5,19,0,99
4,9,22,21,12,7,9,14,7,105
4,9,22,21,12,19,5,0,0,92
4,9,22,21,12,19,5,4,0,96
4,9,22,21,12,19,9,14,7,117
4,9,22,21,12,19,9,15,14,125
4,9,22,21,12,19,9,22,5,123
4,9,22,21,12,19,15,18,0,120
4,9,22,21,19,0,0,0,0,75
4,9,22,22,25,0,0,0,0,82
4,9,22,22,9,5,4,0,0,75
4,9,22,22,9,5,19,0,0,90
4,9,22,22,25,9,14,7,0,112
4,9,23,1,14,0,0,0,0,51
4,9,23,1,14,9,0,0,0,60
4,9,23,1,14,19,0,0,0,70
4,9,23,1,20,1,0,0,0,58
4,9,24,1,9,14,0,0,0,61
4,9,24,5,14,9,20,5,0,90
4,9,24,25,0,0,0,0,0,62
4,9,24,9,5,19,0,0,0,70
4,9,24,9,20,0,0,0,0,66
4,9,24,9,20,19,0,0,0,85
4,9,26,1,9,14,0,0,0,63
4,9,26,1,9,14,5,0,0,68
4,9,26,4,1,18,0,0,0,62
4,9,26,5,14,0,0,0,0,58
4,9,26,5,14,5,4,0,0,67
4,9,26,5,14,9,14,7,0,88
4,9,26,5,14,13,5,14,20,110
4,9,26,5,14,19,0,0,0,77
4,9,26,25,7,15,20,9,3,118
4,9,26,25,7,15,21,19,0,126
4,9,26,15,9,3,0,0,0,66
4,9,26,26,0,0,0,0,0,65
4,9,26,26,1,18,4,0,0,88
4,9,26,26,1,18,4,12,25,125
4,9,26,26,5,14,0,0,0,84
4,9,26,26,25,0,0,0,0,90
4,9,26,26,9,5,4,0,0,83
4,9,26,26,9,5,18,0,0,97
4,9,26,26,9,5,19,0,0,98
4,9,26,26,9,5,19,20,0,118
4,9,26,26,25,9,14,7,0,120
4,9,26,26,9,12,25,0,0,111
4,9,26,26,9,14,5,19,19,131
4,10,5,2,5,12,0,0,0,38
4,10,5,2,5,12,19,0,0,57
4,10,5,8,1,4,0,0,0,32
4,10,5,12,1,2,0,0,0,34
4,10,5,12,6,1,0,0,0,38
4,10,5,12,12,1,2,0,0,46
4,10,5,12,12,1,2,1,0,47
4,10,5,12,12,1,2,1,8,55
4,10,5,12,12,1,2,1,19,66
4,10,5,18,9,2,0,0,0,48
4,10,5,18,19,1,0,0,0,57
4,10,9,2,2,1,8,0,0,36
4,10,9,14,0,0,0,0,0,37
4,10,9,14,14,0,0,0,0,51
4,10,9,14,14,9,0,0,0,60
4,10,9,14,14,25,0,0,0,76
4,10,9,14,14,19,0,0,0,70
4,10,9,14,19,0,0,0,0,56
4,11,7,0,0,0,0,0,0,22
4,11,12,0,0,0,0,0,0,27
4,11,13,0,0,0,0,0,0,28
4,11,19,0,0,0,0,0,0,34
4,12,18,0,0,0,0,0,0,34
4,12,22,25,0,0,0,0,0,63
4,13,15,4,0,0,0,0,0,36
4,15,2,2,5,4,0,0,0,32
4,15,2,2,5,18,0,0,0,46
4,15,2,2,5,18,19,0,0,65
4,15,2,2,25,0,0,0,0,48
4,15,2,2,9,5,0,0,0,37
4,15,2,2,9,5,19,0,0,56
4,15,2,2,9,14,7,0,0,53
4,15,2,3,8,9,3,11,0,55
4,15,2,5,0,0,0,0,0,26
4,15,2,5,18,13,1,14,0,72
4,15,2,5,18,13,1,14,19,91
4,15,2,25,0,0,0,0,0,46
4,15,2,9,5,19,0,0,0,54
4,15,2,12,0,0,0,0,0,33
4,15,2,12,1,0,0,0,0,34
4,15,2,12,1,19,0,0,0,53
4,15,2,12,15,14,0,0,0,62
4,15,2,12,15,14,5,19,0,86
4,15,2,12,15,14,19,0,0,81
4,15,2,15,19,0,0,0,0,55
4,15,2,18,1,0,0,0,0,40
4,15,2,18,1,15,0,0,0,55
4,15,2,18,1,19,0,0,0,59
4,15,2,18,15,5,19,0,0,78
4,15,2,19,15,14,6,12,25,112
4,15,2,19,15,14,19,0,0,88
4,15,2,21,12,5,0,0,0,59
4,15,3,5,14,20,0,0,0,61
4,15,3,5,14,20,19,0,0,80
4,15,3,8,13,9,1,3,0,56
4,15,3,8,13,9,9,0,0,61
4,15,3,8,13,9,21,19,0,92
4,15,3,8,20,5,18,0,0,73
4,15,3,9,2,12,5,0,0,50
4,15,3,9,12,5,12,25,0,85
4,15,3,9,12,9,20,25,0,97
4,15,3,9,13,1,19,25,0,89
4,15,3,9,13,1,19,9,1,74
4,15,3,9,15,21,19,0,0,86
4,15,3,9,20,25,0,0,0,76
4,15,3,11,0,0,0,0,0,33
4,15,3,11,1,7,5,0,0,46
4,15,3,11,1,7,5,19,0,65
4,15,3,11,5,4,0,0,0,42
4,15,3,11,5,14,0,0,0,52
4,15,3,11,5,18,0,0,0,56
4,15,3,11,5,18,19,0,0,75
4,15,3,11,5,20,0,0,0,58
4,15,3,11,5,20,5,4,0,67
4,15,3,11,5,20,9,14,7,88
4,15,3,11,5,20,19,0,0,77
4,15,3,11,8,1,14,4,0,60
4,15,3,11,8,1,14,4,19,79
4,15,3,11,8,5,1,4,0,51
4,15,3,11,8,15,21,19,5,101
4,15,3,11,25,1,18,4,0,81
4,15,3,11,25,1,18,4,19,100
4,15,3,11,9,14,7,0,0,63
4,15,3,11,9,26,5,0,0,73
4,15,3,11,12,1,14,4,0,64
4,15,3,11,12,1,14,4,19,83
4,15,3,11,13,1,14,0,0,61
4,15,3,11,19,0,0,0,0,52
4,15,3,11,19,9,4,5,0,70
4,15,3,11,19,9,4,5,19,89
4,15,3,13,1,3,0,0,0,39
4,15,3,15,19,1,14,5,0,76
4,15,3,17,21,5,20,0,0,85
4,15,3,20,15,18,1,12,0,88
4,15,3,20,15,18,1,20,5,101
4,15,3,20,15,18,4,15,13,107
4,15,3,20,15,18,5,4,0,84
4,15,3,20,15,18,5,19,19,118
4,15,3,20,15,18,9,1,12,97
4,15,3,20,15,18,9,14,7,105
4,15,3,20,15,18,9,26,5,115
4,15,3,20,15,18,12,25,0,112
4,15,3,20,15,18,19,0,0,94
4,15,3,20,18,5,19,19,0,103
4,15,3,20,18,9,14,1,12,96
4,15,3,20,18,9,14,5,0,88
4,15,3,20,18,9,14,5,19,107
4,15,3,20,18,9,24,0,0,93
4,15,3,20,21,19,0,0,0,82
4,15,3,21,4,18,1,13,1,80
4,15,3,21,13,5,14,20,0,95
4,15,3,21,13,5,14,20,19,114
4,15,4,4,1,18,4,0,0,50
4,15,4,4,1,18,20,0,0,66
4,15,4,4,5,4,0,0,0,36
4,15,4,4,5,18,0,0,0,50
4,15,4,4,5,18,5,4,0,59
4,15,4,4,5,18,5,18,0,73
4,15,4,4,5,18,5,18,19,92
4,15,4,4,5,18,25,0,0,75
4,15,4,4,5,18,9,14,7,80
4,15,4,4,5,18,19,0,0,69
4,15,4,4,25,0,0,0,0,52
4,15,4,4,9,5,0,0,0,41
4,15,4,4,9,5,19,0,0,60
4,15,4,4,9,14,7,0,0,57
4,15,4,4,25,16,15,12,12,107
4,15,4,4,12,5,0,0,0,44
4,15,4,5,3,1,4,5,0,41
4,15,4,5,3,1,6,9,4,51
4,15,4,5,3,1,7,15,14,68
4,15,4,5,3,1,14,1,12,59
4,15,4,5,3,1,14,5,0,51
4,15,4,5,3,1,14,20,0,66
4,15,4,5,3,1,18,3,8,61
4,15,4,5,3,1,20,25,12,89
4,15,4,5,3,25,12,0,0,68
4,15,4,5,3,25,12,9,3,80
4,15,4,7,1,19,20,5,4,79
4,15,4,7,5,4,0,0,0,39
4,15,4,7,5,6,21,12,0,74
4,15,4,7,5,13,19,0,0,67
4,15,4,7,5,18,0,0,0,53
4,15,4,7,5,18,25,0,0,78
4,15,4,7,5,18,9,5,19,86
4,15,4,7,5,18,19,0,0,72
4,15,4,7,5,19,0,0,0,54
4,15,4,7,25,0,0,0,0,55
4,15,4,7,9,5,18,0,0,62
4,15,4,7,9,5,19,20,0,83
4,15,4,7,9,12,25,0,0,76
4,15,4,7,9,14,5,19,19,96
4,15,4,7,9,14,7,0,0,60
4,15,4,9,16,15,12,5,0,80
4,15,4,11,9,14,0,0,0,57
4,15,4,12,5,20,0,0,0,60
4,15,4,13,1,14,0,0,0,51
4,15,4,15,0,0,0,0,0,38
4,15,4,15,5,19,0,0,0,62
4,15,4,15,9,19,13,0,0,79
4,15,4,15,9,19,13,19,0,98
4,15,4,15,14,1,5,14,1,73
4,15,4,15,19,0,0,0,0,57
4,15,4,18,1,14,19,0,0,75
4,15,4,18,1,14,20,1,12,89
4,15,4,19,0,0,0,0,0,42
4,15,4,21,14,11,0,0,0,69
4,15,5,2,9,18,4,0,0,57
4,15,5,7,12,9,3,0,0,55
4,15,5,7,12,9,14,7,0,73
4,15,5,11,0,0,0,0,0,35
4,15,5,12,9,14,7,0,0,66
4,15,5,18,0,0,0,0,0,42
4,15,5,18,19,0,0,0,0,61
4,15,5,19,0,0,0,0,0,43
4,15,5,19,11,9,14,0,0,77
4,15,5,19,11,9,14,19,0,96
4,15,5,19,14,0,0,0,0,57
4,15,5,19,14,20,0,0,0,77
4,15,5,19,20,0,0,0,0,63
4,15,5,20,8,0,0,0,0,52
4,15,5,21,22,18,5,0,0,90
4,15,6,6,0,0,0,0,0,31
4,15,6,6,5,4,0,0,0,40
4,15,6,6,5,18,0,0,0,54
4,15,6,6,5,18,19,0,0,73
4,15,6,6,9,14,7,0,0,61
4,15,6,6,19,0,0,0,0,50
4,15,6,20,2,5,18,18,25,113
4,15,6,21,14,14,25,0,0,99
4,15,7,0,0,0,0,0,0,26
4,15,7,1,12,0,0,0,0,39
4,15,7,1,14,1,0,0,0,42
4,15,7,1,18,5,19,19,1,89
4,15,7,1,20,5,0,0,0,52
4,15,7,2,1,14,5,0,0,48
4,15,7,2,1,14,5,19,0,67
4,15,7,2,9,20,5,0,0,62
4,15,7,2,12,15,23,0,0,78
4,15,7,2,15,1,20,0,0,64
4,15,7,2,15,4,25,0,0,72
4,15,7,2,15,4,9,5,19,80
4,15,7,2,15,12,20,0,0,75
4,15,7,2,21,19,8,0,0,76
4,15,7,3,1,18,20,0,0,68
4,15,7,3,1,18,20,19,0,87
4,15,7,4,15,13,0,0,0,58
4,15,7,4,15,13,19,0,0,77
4,15,7,5,1,18,0,0,0,50
4,15,7,5,1,18,5,4,0,59
4,15,7,5,1,18,19,0,0,69
4,15,7,5,4,15,13,0,0,63
4,15,7,5,4,15,13,19,0,82
4,15,7,5,25,0,0,0,0,56
4,15,7,5,25,19,0,0,0,75
4,15,7,5,12,5,19,19,0,86
4,15,7,5,19,0,0,0,0,50
4,15,7,5,19,8,9,16,0,83
4,15,7,5,19,8,9,16,19,102
4,15,7,6,1,3,5,0,0,41
4,15,7,6,1,3,5,19,0,60
4,15,7,6,1,12,12,0,0,57
4,15,7,6,5,14,14,5,12,82
4,15,7,6,9,7,8,20,0,76
4,15,7,6,9,7,8,20,19,95
4,15,7,6,9,19,8,0,0,68
4,15,7,6,9,19,8,5,19,92
4,15,7,6,15,15,20,0,0,82
4,15,7,6,15,21,7,8,20,103
4,15,7,7,5,4,0,0,0,42
4,15,7,7,5,4,12,25,0,79
4,15,7,7,5,18,5,12,0,73
4,15,7,7,5,18,5,12,19,92
4,15,7,7,5,18,25,0,0,81
4,15,7,7,5,18,9,5,19,89
4,15,7,7,5,18,19,0,0,75
4,15,7,7,5,19,19,0,0,76
4,15,7,7,5,20,0,0,0,58
4,15,7,7,25,0,0,0,0,58
4,15,7,7,9,5,0,0,0,47
4,15,7,7,9,5,18,0,0,65
4,15,7,7,9,5,19,0,0,66
4,15,7,7,9,5,19,20,0,86
4,15,7,7,9,14,7,0,0,63
4,15,7,7,9,19,8,0,0,69
4,15,7,7,9,19,8,12,25,106
4,15,7,7,12,5,0,0,0,50
4,15,7,7,15,0,0,0,0,48
4,15,7,7,15,14,5,0,0,67
4,15,7,7,15,14,5,4,0,71
4,15,7,7,15,14,5,18,0,85
4,15,7,7,15,14,5,19,0,86
4,15,7,7,15,14,5,19,20,106
4,15,7,7,15,14,9,14,7,92
4,15,7,7,18,5,12,0,0,68
4,15,7,7,18,5,12,19,0,87
4,15,7,8,5,1,4,0,0,44
4,15,7,8,15,12,5,0,0,66
4,15,7,8,15,15,4,0,0,68
4,15,7,8,15,21,19,5,0,94
4,15,7,8,15,21,19,5,19,113
4,15,7,25,0,0,0,0,0,51
4,15,7,9,5,0,0,0,0,40
4,15,7,9,5,19,0,0,0,59
4,15,7,12,5,7,0,0,0,50
4,15,7,12,5,7,7,5,4,66
4,15,7,12,5,7,19,0,0,69
4,15,7,12,5,19,19,0,0,81
4,15,7,12,25,0,0,0,0,63
4,15,7,12,9,11,5,0,0,63
4,15,7,13,1,0,0,0,0,40
4,15,7,13,1,14,0,0,0,54
4,15,7,13,1,19,0,0,0,59
4,15,7,13,1,20,1,0,0,61
4,15,7,13,1,20,9,3,0,72
4,15,7,13,1,20,9,3,19,91
4,15,7,13,1,20,9,19,5,93
4,15,7,13,1,20,9,19,13,101
4,15,7,13,1,20,9,19,20,108
4,15,7,13,1,20,9,26,5,100
4,15,7,13,5,1,20,0,0,65
4,15,7,13,5,14,0,0,0,58
4,15,7,13,15,21,20,8,0,103
4,15,7,14,1,16,0,0,0,57
4,15,7,14,1,16,5,4,0,66
4,15,7,14,1,16,5,18,0,80
4,15,7,14,1,16,5,18,19,99
4,15,7,14,1,16,9,14,7,87
4,15,7,14,1,16,16,5,4,82
4,15,7,14,1,16,16,5,18,96
4,15,7,14,1,16,19,0,0,76
4,15,7,16,12,1,20,5,0,80
4,15,7,16,18,15,15,6,0,96
4,15,7,19,2,15,4,25,0,91
4,15,7,19,8,9,16,0,0,78
4,15,7,19,8,15,18,5,0,91
4,15,7,19,11,9,14,0,0,79
4,15,7,19,12,5,4,0,0,66
4,15,7,19,12,5,4,19,0,85
4,15,7,19,12,5,5,16,0,83
4,15,7,19,20,1,9,12,0,87
4,15,7,19,20,15,14,5,0,99
4,15,7,19,20,15,14,5,19,118
4,15,7,20,1,9,12,0,0,68
4,15,7,20,5,5,20,8,0,84
4,15,7,20,9,5,0,0,0,60
4,15,7,20,15,15,20,8,0,104
4,15,7,20,18,9,3,11,0,87
4,15,7,20,18,15,20,0,0,99
4,15,7,20,18,15,20,19,0,118
4,15,7,22,1,14,5,0,0,68
4,15,7,22,1,14,5,19,0,87
4,15,7,23,1,20,3,8,0,81
4,15,7,23,9,14,11,12,5,100
4,15,7,23,15,15,4,0,0,83
4,15,7,23,15,15,4,19,0,102
4,15,8,0,0,0,0,0,0,27
4,15,8,9,3,11,5,25,0,80
4,15,8,20,5,18,0,0,0,70
4,15,25,5,14,0,0,0,0,63
4,15,25,5,14,14,5,0,0,82
4,15,25,5,14,14,5,19,0,101
4,15,25,5,14,19,0,0,0,82
4,15,9,7,20,0,0,0,0,55
4,15,9,7,20,5,0,0,0,60
4,15,9,12,5,4,0,0,0,49
4,15,25,12,5,25,0,0,0,86
4,15,25,12,5,25,19,0,0,105
4,15,9,12,25,0,0,0,0,65
4,15,25,12,25,0,0,0,0,81
4,15,9,12,9,5,19,0,0,73
4,15,25,12,9,5,19,0,0,89
4,15,25,12,20,0,0,0,0,76
4,15,9,14,1,0,0,0,0,43
4,15,9,14,7,0,0,0,0,49
4,15,9,14,7,19,0,0,0,68
4,15,25,19,20,0,0,0,0,83
4,15,9,20,0,0,0,0,0,48
4,15,9,20,5,4,0,0,0,57
4,15,9,20,11,9,14,0,0,82
4,15,9,20,19,0,0,0,0,67
4,15,10,9,7,7,5,18,0,75
4,15,10,9,7,7,25,0,0,77
4,15,10,15,0,0,0,0,0,44
4,15,10,15,19,0,0,0,0,63
4,15,11,5,0,0,0,0,0,35
4,15,11,8,13,1,0,0,0,52
4,15,12,1,2,18,1,0,0,53
4,15,12,1,2,18,1,20,5,78
4,15,12,1,2,18,5,0,0,57
4,15,12,3,1,14,0,0,0,49
4,15,12,3,5,0,0,0,0,39
4,15,12,3,9,0,0,0,0,43
4,15,12,3,9,1,14,0,0,58
4,15,12,3,9,1,14,15,0,73
4,15,12,3,9,14,9,19,20,105
4,15,12,3,9,14,15,0,0,72
4,15,12,4,18,21,13,0,0,87
4,15,12,4,18,21,13,19,0,106
4,15,12,5,1,14,3,5,0,59
4,15,12,5,4,0,0,0,0,40
4,15,12,5,6,9,19,8,0,78
4,15,12,5,6,21,12,0,0,75
4,15,12,5,6,21,12,12,25,112
4,15,12,5,6,21,12,19,0,94
4,15,12,5,14,20,0,0,0,70
4,15,12,5,14,20,5,0,0,75
4,15,12,5,14,20,12,25,0,107
4,15,12,5,18,9,14,0,0,77
4,15,12,5,18,9,20,5,0,88
4,15,12,5,18,9,20,5,19,107
4,15,12,5,18,9,20,9,3,95
4,15,12,5,19,0,0,0,0,55
4,15,12,5,19,13,1,14,0,83
4,15,12,5,19,15,13,5,0,88
4,15,12,5,19,19,0,0,0,74
4,15,12,9,0,0,0,0,0,40
4,15,12,9,1,0,0,0,0,41
4,15,12,9,14,1,0,0,0,55
4,15,12,9,14,5,0,0,0,59
4,15,12,9,14,7,0,0,0,61
4,15,12,9,15,6,15,18,13,107
4,15,12,9,19,9,5,0,0,73
4,15,12,9,20,5,0,0,0,65
4,15,12,9,20,20,12,5,0,97
4,15,12,9,21,13,0,0,0,74
4,15,12,12,1,18,4,5,5,76
4,15,12,12,1,18,4,15,13,94
4,15,12,12,1,18,19,0,0,81
4,15,12,12,2,5,5,18,0,73
4,15,12,12,4,15,13,0,0,75
4,15,12,12,5,4,0,0,0,52
4,15,12,12,6,1,3,5,0,58
4,15,12,12,6,1,3,5,4,62
4,15,12,12,6,9,19,8,0,85
4,15,12,12,8,15,15,4,0,85
4,15,12,12,8,15,21,19,5,111
4,15,12,12,9,1,0,0,0,53
4,15,12,12,9,5,4,0,0,61
4,15,12,12,9,5,18,0,0,75
4,15,12,12,9,5,19,0,0,76
4,15,12,12,25,9,14,7,0,98
4,15,12,12,25,13,1,14,0,96
4,15,12,12,25,13,5,14,0,100
4,15,12,12,9,14,0,0,0,66
4,15,12,12,9,14,5,19,19,109
4,15,12,12,9,14,7,0,0,73
4,15,12,12,9,19,8,0,0,79
4,15,12,12,9,19,8,12,25,116
4,15,12,12,25,23,1,25,0,117
4,15,12,12,13,1,11,5,18,91
4,15,12,12,15,16,0,0,0,74
4,15,12,12,15,16,5,4,0,83
4,15,12,12,15,16,19,0,0,93
4,15,12,12,19,0,0,0,0,62
4,15,12,12,19,8,9,16,0,95
4,15,12,13,1,0,0,0,0,45
4,15,12,13,1,4,5,19,0,73
4,15,12,13,1,14,0,0,0,59
4,15,12,13,1,14,19,0,0,78
4,15,12,13,1,19,0,0,0,64
4,15,12,13,5,14,0,0,0,63
4,15,12,13,5,14,9,3,0,75
4,15,12,13,5,14,19,0,0,82
4,15,12,15,13,9,20,5,0,93
4,15,12,15,13,9,20,9,3,100
4,15,12,15,13,9,26,5,0,99
4,15,12,15,18,0,0,0,0,64
4,15,12,15,18,9,6,9,3,91
4,15,12,15,18,15,19,15,0,113
4,15,12,15,18,15,21,19,0,119
4,15,12,15,18,19,0,0,0,83
4,15,12,15,19,0,0,0,0,65
4,15,12,15,19,5,0,0,0,70
4,15,12,15,21,18,0,0,0,85
4,15,12,15,21,18,19,0,0,104
4,15,12,15,21,19,0,0,0,86
4,15,12,16,8,9,14,19,0,97
4,15,12,19,0,0,0,0,0,50
4,15,12,20,0,0,0,0,0,51
4,15,12,20,8,5,1,4,0,69
4,15,12,20,9,19,8,0,0,87
4,15,12,20,9,19,8,12,25,124
4,15,12,20,19,0,0,0,0,70
4,15,12,21,19,0,0,0,0,71
4,15,12,22,5,14,0,0,0,72
4,15,13,0,0,0,0,0,0,32
4,15,13,1,2,12,5,0,0,52
4,15,13,1,7,5,0,0,0,45
4,15,13,1,9,14,1,12,0,69
4,15,13,1,9,14,19,0,0,75
4,15,13,1,10,9,7,0,0,59
4,15,13,1,12,0,0,0,0,45
4,15,13,1,14,9,1,12,0,69
4,15,13,1,20,9,21,13,0,96
4,15,13,2,1,0,0,0,0,35
4,15,13,2,15,3,0,0,0,52
4,15,13,5,0,0,0,0,0,37
4,15,13,5,4,0,0,0,0,41
4,15,13,5,25,11,9,20,5,107
4,15,13,5,12,9,11,5,0,74
4,15,13,5,14,20,0,0,0,71
4,15,13,5,18,0,0,0,0,55
4,15,13,5,19,0,0,0,0,56
4,15,13,5,19,4,1,25,19,105
4,15,13,5,19,20,9,3,0,88
4,15,13,5,19,20,9,3,19,107
4,15,13,25,0,0,0,0,0,57
4,15,13,9,3,0,0,0,0,44
4,15,13,9,3,1,12,0,0,57
4,15,13,9,3,1,12,12,25,94
4,15,13,9,3,9,12,0,0,65
4,15,13,9,3,9,12,5,0,70
4,15,13,9,3,9,12,5,4,74
4,15,13,9,3,9,12,5,19,89
4,15,13,9,3,9,12,9,9,83
4,15,13,9,3,9,12,19,0,84
4,15,13,9,6,25,0,0,0,72
4,15,13,9,14,1,5,0,0,61
4,15,13,9,14,1,14,3,5,78
4,15,13,9,14,1,14,3,25,98
4,15,13,9,14,1,14,20,0,90
4,15,13,9,14,1,14,20,19,109
4,15,13,9,14,1,20,5,0,81
4,15,13,9,14,1,20,5,4,85
4,15,13,9,14,1,20,5,19,100
4,15,13,9,14,1,20,15,18,109
4,15,13,9,14,5,0,0,0,60
4,15,13,9,14,5,5,0,0,65
4,15,13,9,14,5,5,18,0,83
4,15,13,9,14,5,5,18,19,102
4,15,13,9,14,5,19,0,0,79
4,15,13,9,14,7,0,0,0,62
4,15,13,9,14,9,1,12,0,77
4,15,13,9,14,9,3,1,12,80
4,15,13,9,14,9,3,11,19,97
4,15,13,9,14,9,5,0,0,69
4,15,13,9,14,9,5,19,0,88
4,15,13,9,14,9,15,14,0,93
4,15,13,9,14,9,15,14,19,112
4,15,13,9,14,9,21,13,0,98
4,15,13,9,14,9,21,13,19,117
4,15,13,9,14,15,5,19,0,94
4,15,13,9,14,15,19,0,0,89
4,15,13,9,14,21,12,5,0,93
4,15,13,9,20,1,2,12,5,81
4,15,13,9,20,5,0,0,0,66
4,15,13,9,20,9,3,0,0,73
4,15,13,14,0,0,0,0,0,46
4,15,13,14,5,9,0,0,0,60
4,15,13,15,9,4,0,0,0,60
4,15,13,16,20,0,0,0,0,68
4,15,13,16,20,5,21,19,5,118
4,15,13,19,0,0,0,0,0,51
4,15,13,21,19,0,0,0,0,72
4,15,14,1,2,12,5,0,0,53
4,15,14,1,3,11,0,0,0,48
4,15,14,1,18,25,0,0,0,77
4,15,14,1,18,9,5,19,0,85
4,15,14,1,19,0,0,0,0,53
4,15,14,1,20,0,0,0,0,54
4,15,14,1,20,1,18,25,0,98
4,15,14,1,20,5,0,0,0,59
4,15,14,1,20,5,4,0,0,63
4,15,14,1,20,5,5,0,0,64
4,15,14,1,20,5,19,0,0,78
4,15,14,1,20,9,14,7,0,84
4,15,14,1,20,9,15,0,0,78
4,15,14,1,20,9,15,14,0,92
4,15,14,1,20,9,15,14,19,111
4,15,14,1,20,9,22,5,0,90
4,15,14,1,20,9,22,5,19,109
4,15,14,1,20,15,18,0,0,87
4,15,14,1,20,15,18,25,0,112
4,15,14,1,20,15,18,19,0,106
4,15,14,1,20,18,5,19,19,115
4,15,14,1,24,0,0,0,0,58
4,15,14,3,5,12,12,1,0,66
4,15,14,3,25,0,0,0,0,61
4,15,14,4,1,9,14,5,0,66
4,15,14,4,9,14,5,0,0,65
4,15,14,5,0,0,0,0,0,38
4,15,14,5,3,0,0,0,0,41
4,15,14,5,5,0,0,0,0,43
4,15,14,5,5,19,0,0,0,62
4,15,14,5,25,0,0,0,0,63
4,15,14,5,14,5,19,19,0,95
4,15,14,7,1,0,0,0,0,41
4,15,14,7,1,19,0,0,0,60
4,15,14,7,9,14,7,0,0,70
4,15,14,7,15,12,1,19,0,87
4,15,14,7,15,14,0,0,0,69
4,15,14,7,19,0,0,0,0,59
4,15,14,9,0,0,0,0,0,42
4,15,14,9,3,11,5,18,0,79
4,15,14,9,19,0,0,0,0,61
4,15,14,10,15,14,0,0,0,72
4,15,14,10,15,14,19,0,0,91
4,15,14,11,0,0,0,0,0,44
4,15,14,11,5,25,0,0,0,74
4,15,14,11,5,25,9,19,8,110
4,15,14,11,5,25,9,19,13,115
4,15,14,11,5,25,13,1,14,102
4,15,14,11,5,25,13,5,14,106
4,15,14,11,5,25,19,0,0,93
4,15,14,14,1,18,4,0,0,70
4,15,14,14,1,19,0,0,0,67
4,15,14,14,5,4,0,0,0,56
4,15,14,14,5,5,0,0,0,57
4,15,14,14,5,5,19,0,0,76
4,15,14,14,5,18,4,0,0,74
4,15,14,14,5,18,5,4,0,79
4,15,14,14,5,18,20,0,0,90
4,15,14,14,9,3,11,0,0,70
4,15,14,14,9,14,7,0,0,77
4,15,14,14,9,19,8,0,0,83
4,15,14,14,9,19,8,12,25,120
4,15,14,14,9,19,13,0,0,88
4,15,14,14,15,3,11,0,0,76
4,15,14,14,15,20,0,0,0,82
4,15,14,15,18,0,0,0,0,66
4,15,14,15,18,19,0,0,0,85
4,15,14,15,18,19,8,9,16,118
4,15,14,15,21,7,8,20,0,104
4,15,14,19,0,0,0,0,0,52
4,15,14,19,8,9,16,0,0,85
4,15,14,19,25,0,0,0,0,77
4,15,14,19,9,5,0,0,0,66
4,15,14,19,11,25,0,0,0,88
4,15,14,20,0,0,0,0,0,53
4,15,14,21,13,0,0,0,0,67
4,15,14,21,20,0,0,0,0,74
4,15,14,21,20,19,0,0,0,93
4,15,14,26,5,12,0,0,0,76
4,15,14,26,5,12,12,1,0,89
4,15,14,26,5,12,19,0,0,95
4,15,15,0,0,0,0,0,0,34
4,15,15,2,0,0,0,0,0,36
4,15,15,3,15,20,0,0,0,72
4,15,15,4,1,2,0,0,0,41
4,15,15,4,1,4,0,0,0,43
4,15,15,4,1,4,19,0,0,62
4,15,15,4,1,8,0,0,0,47
4,15,15,4,12,5,0,0,0,55
4,15,15,4,12,5,2,21,7,85
4,15,15,4,12,5,4,0,0,59
4,15,15,4,12,5,18,0,0,73
4,15,15,4,12,5,18,19,0,92
4,15,15,4,12,5,19,0,0,74
4,15,15,4,12,9,14,7,0,80
4,15,15,4,19,11,15,16,0,99
4,15,15,8,9,3,11,5,25,95
4,15,15,8,9,3,11,21,19,105
4,15,15,8,9,14,11,5,25,106
4,15,15,8,9,14,11,21,19,116
4,15,15,10,1,0,0,0,0,45
4,15,15,11,0,0,0,0,0,45
4,15,15,11,5,20,0,0,0,70
4,15,15,11,9,20,0,0,0,74
4,15,15,12,0,0,0,0,0,46
4,15,15,12,5,5,0,0,0,56
4,15,15,12,5,5,19,0,0,75
4,15,15,12,6,21,0,0,0,73
4,15,15,12,9,0,0,0,0,55
4,15,15,12,25,0,0,0,0,71
4,15,15,12,9,5,0,0,0,60
4,15,15,12,9,5,19,0,0,79
4,15,15,13,0,0,0,0,0,47
4,15,15,13,1,7,5,0,0,60
4,15,15,13,2,15,15,11,0,90
4,15,15,13,5,4,0,0,0,56
4,15,15,13,5,18,0,0,0,70
4,15,15,13,6,21,12,0,0,86
4,15,15,13,6,21,12,12,25,123
4,15,15,13,9,14,7,0,0,77
4,15,15,13,12,9,11,5,0,84
4,15,15,13,19,0,0,0,0,66
4,15,15,13,19,1,25,5,18,115
4,15,15,13,19,4,1,25,19,115
4,15,15,13,19,13,1,14,0,94
4,15,15,13,19,20,5,1,4,96
4,15,15,13,19,20,5,18,0,109
4,15,15,13,19,20,5,18,19,128
4,15,15,16,21,20,20,25,0,136
4,15,15,18,0,0,0,0,0,52
4,15,15,18,2,1,0,0,0,55
4,15,15,18,2,5,12,12,0,83
4,15,15,18,2,5,12,12,19,102
4,15,15,18,2,15,25,0,0,94
4,15,15,18,2,18,1,14,4,91
4,15,15,18,3,1,19,5,0,80
4,15,15,18,3,8,5,5,11,84
4,15,15,18,5,4,0,0,0,61
4,15,15,18,6,18,1,13,5,95
4,15,15,18,8,1,23,11,0,95
4,15,15,18,8,5,1,4,0,70
4,15,15,18,25,1,18,4,0,100
4,15,15,18,25,1,18,4,19,119
4,15,15,18,9,14,7,0,0,82
4,15,15,18,10,1,13,2,0,78
4,15,15,18,10,1,13,2,19,97
4,15,15,18,11,5,5,16,0,89
4,15,15,18,11,14,15,2,0,94
4,15,15,18,11,14,15,2,19,113
4,15,15,18,12,5,19,19,0,107
4,15,15,18,12,9,11,5,0,89
4,15,15,18,13,1,9,4,0,79
4,15,15,18,13,1,11,5,18,100
4,15,15,18,13,1,14,0,0,80
4,15,15,18,13,1,20,0,0,86
4,15,15,18,13,1,20,19,0,105
4,15,15,18,13,5,14,0,0,84
4,15,15,18,14,1,9,12,0,88
4,15,15,18,14,1,9,12,19,107
4,15,15,18,14,2,15,15,13,111
4,15,15,18,16,9,5,3,5,90
4,15,15,18,16,12,1,20,5,106
4,15,15,18,16,15,19,20,0,122
4,15,15,18,16,15,19,20,19,141
4,15,15,18,19,0,0,0,0,71
4,15,15,18,19,9,12,12,0,104
4,15,15,18,19,9,12,12,19,123
4,15,15,18,19,20,5,1,4,101
4,15,15,18,19,20,5,16,0,112
4,15,15,18,19,20,5,16,19,131
4,15,15,18,19,20,15,14,5,125
4,15,15,18,19,20,15,16,0,122
4,15,15,18,19,20,15,16,19,141
4,15,15,18,23,1,25,0,0,101
4,15,15,18,23,1,25,19,0,120
4,15,15,18,23,1,18,4,0,98
4,15,15,18,23,5,5,4,0,89
4,15,15,18,23,9,19,5,0,108
4,15,15,22,5,18,0,0,0,79
4,15,15,24,9,4,9,26,5,111
4,15,15,26,5,18,0,0,0,83
4,15,15,26,5,18,19,0,0,102
4,15,15,26,25,0,0,0,0,85
4,15,15,26,9,5,0,0,0,74
4,15,15,26,9,5,19,0,0,93
4,15,16,1,0,0,0,0,0,36
4,15,16,1,13,9,14,5,0,77
4,15,16,1,13,9,14,5,19,96
4,15,16,1,14,20,0,0,0,70
4,15,16,1,14,20,19,0,0,89
4,15,16,1,19,0,0,0,0,55
4,15,16,1,20,20,1,0,0,77
4,15,16,3,8,9,3,11,0,69
4,15,16,5,0,0,0,0,0,40
4,15,16,5,2,15,15,11,0,83
4,15,16,5,4,0,0,0,0,44
4,15,16,5,8,5,1,4,0,58
4,15,16,5,25,0,0,0,0,65
4,15,16,5,18,0,0,0,0,58
4,15,16,5,18,19,0,0,0,77
4,15,16,5,19,0,0,0,0,59
4,15,16,5,19,8,5,5,20,97
4,15,16,5,19,20,5,18,0,102
4,15,16,5,19,20,5,18,19,121
4,15,16,25,0,0,0,0,0,60
4,15,16,9,5,18,0,0,0,67
4,15,16,9,5,19,20,0,0,88
4,15,16,9,14,5,19,19,0,101
4,15,16,9,14,7,0,0,0,65
4,15,16,16,5,4,0,0,0,60
4,15,16,16,9,1,0,0,0,61
4,15,16,16,9,14,7,0,0,81
4,15,16,16,9,15,0,0,0,75
4,15,16,19,20,5,18,0,0,97
4,15,18,1,2,0,0,0,0,40
4,15,18,1,4,0,0,0,0,42
4,15,18,1,4,9,12,12,1,76
4,15,18,1,4,15,19,0,0,76
4,15,18,1,25,0,0,0,0,63
4,15,18,1,12,9,21,13,0,93
4,15,18,2,5,5,20,12,5,86
4,15,18,2,5,12,0,0,0,56
4,15,18,2,9,5,0,0,0,53
4,15,18,2,21,7,0,0,0,67
4,15,18,2,21,7,19,0,0,86
4,15,18,3,1,19,20,18,25,123
4,15,18,5,5,0,0,0,0,47
4,15,18,5,19,20,1,14,5,101
4,15,18,8,1,23,11,0,0,80
4,15,18,8,1,23,11,19,0,99
4,15,18,9,5,19,0,0,0,70
4,15,18,25,12,9,14,5,0,102
4,15,18,25,13,1,14,0,0,90
4,15,18,25,13,5,14,0,0,94
4,15,18,9,16,16,9,4,0,91
4,15,18,10,5,0,0,0,0,52
4,15,18,11,0,0,0,0,0,48
4,15,18,11,25,0,0,0,0,73
4,15,18,11,9,5,18,0,0,80
4,15,18,11,9,5,19,20,0,101
4,15,18,11,19,0,0,0,0,67
4,15,18,12,1,3,8,0,0,61
4,15,18,12,15,20,0,0,0,84
4,15,18,13,0,0,0,0,0,50
4,15,18,13,1,14,3,25,0,93
4,15,18,13,1,14,20,0,0,85
4,15,18,13,1,14,20,12,25,122
4,15,18,13,5,18,0,0,0,73
4,15,18,13,5,18,5,4,0,82
4,15,18,13,5,18,19,0,0,92
4,15,18,13,5,20,20,5,0,100
4,15,18,13,5,21,19,5,0,100
4,15,18,13,25,0,0,0,0,75
4,15,18,13,9,3,5,0,0,67
4,15,18,13,9,5,0,0,0,64
4,15,18,13,9,5,14,20,0,98
4,15,18,13,9,12,15,14,1,101
4,15,18,13,9,14,0,0,0,73
4,15,18,13,9,14,19,0,0,92
4,15,18,13,9,20,1,18,25,123
4,15,18,13,9,20,9,15,14,117
4,15,18,13,9,20,9,22,5,115
4,15,18,13,9,20,15,18,25,137
4,15,18,13,13,9,3,5,0,80
4,15,18,13,15,21,19,5,0,110
4,15,18,13,19,0,0,0,0,69
4,15,18,14,5,3,11,0,0,70
4,15,18,14,5,3,11,19,0,89
4,15,18,14,9,3,0,0,0,63
4,15,18,14,9,3,11,0,0,74
4,15,18,14,9,3,11,19,0,93
4,15,18,14,15,3,11,0,0,80
4,15,18,14,15,3,11,19,0,99
4,15,18,16,0,0,0,0,0,53
4,15,18,16,5,18,0,0,0,76
4,15,18,16,5,18,19,0,0,95
4,15,18,16,19,0,0,0,0,72
4,15,18,18,19,0,0,0,0,74
4,15,18,19,0,0,0,0,0,56
4,15,18,19,1,0,0,0,0,57
4,15,18,19,1,4,0,0,0,61
4,15,18,19,1,12,0,0,0,69
4,15,18,19,1,12,5,0,0,74
4,15,18,19,1,12,5,19,0,93
4,15,18,19,1,12,7,9,1,86
4,15,18,19,1,12,9,19,0,97
4,15,18,19,1,12,12,25,0,106
4,15,18,19,1,12,19,0,0,88
4,15,18,19,5,0,0,0,0,61
4,15,18,19,5,12,0,0,0,73
4,15,18,19,5,12,19,0,0,92
4,15,18,19,5,18,0,0,0,79
4,15,18,19,5,18,19,0,0,98
4,15,18,19,9,0,0,0,0,65
4,15,18,19,9,4,21,3,20,113
4,15,18,19,9,6,12,5,24,112
4,15,18,19,15,12,21,13,0,117
4,15,18,19,21,12,1,0,0,90
4,15,18,19,21,12,21,13,0,123
4,15,18,19,21,13,0,0,0,90
4,15,18,20,5,18,0,0,0,80
4,15,18,20,25,0,0,0,0,82
4,15,18,20,9,14,5,19,19,123
4,15,18,20,9,19,8,9,16,118
4,15,18,20,15,21,18,0,0,111
4,15,18,20,19,0,0,0,0,76
4,15,18,21,3,11,0,0,0,72
4,15,19,1,0,0,0,0,0,39
4,15,19,1,4,8,0,0,0,51
4,15,19,1,7,5,0,0,0,51
4,15,19,1,7,5,19,0,0,70
4,15,19,1,9,14,0,0,0,62
4,15,19,5,0,0,0,0,0,43
4,15,19,5,4,0,0,0,0,47
4,15,19,5,18,0,0,0,0,61
4,15,19,5,18,19,0,0,0,80
4,15,19,5,19,0,0,0,0,62
4,15,19,9,13,5,20,5,18,108
4,15,19,9,13,5,20,18,25,128
4,15,19,9,14,7,0,0,0,68
4,15,19,9,15,12,15,7,25,121
4,15,19,9,19,0,0,0,0,66
4,15,19,15,12,15,7,25,0,112
4,15,19,19,1,12,0,0,0,70
4,15,19,19,1,12,19,0,0,89
4,15,19,19,5,4,0,0,0,66
4,15,19,19,5,12,0,0,0,74
4,15,19,19,5,12,19,0,0,93
4,15,19,19,5,14,14,21,19,130
4,15,19,19,5,18,0,0,0,80
4,15,19,19,5,18,5,20,0,105
4,15,19,19,5,18,5,20,19,124
4,15,19,19,5,18,19,0,0,99
4,15,19,19,5,19,0,0,0,81
4,15,19,19,5,20,25,0,0,107
4,15,19,19,8,15,21,19,5,125
4,15,19,19,25,0,0,0,0,82
4,15,19,19,9,5,18,0,0,89
4,15,19,19,9,5,18,5,0,94
4,15,19,19,9,5,18,19,0,108
4,15,19,19,9,12,0,0,0,78
4,15,19,19,9,12,19,0,0,97
4,15,19,19,9,14,7,0,0,87
4,15,19,19,13,1,14,0,0,85
4,15,19,19,13,5,14,0,0,89
4,15,19,20,0,0,0,0,0,58
4,15,20,1,7,5,0,0,0,52
4,15,20,1,7,5,19,0,0,71
4,15,20,1,12,0,0,0,0,52
4,15,20,1,14,20,0,0,0,74
4,15,20,1,18,4,0,0,0,62
4,15,20,1,18,4,25,0,0,87
4,15,20,1,18,4,9,19,13,103
4,15,20,1,18,4,12,25,0,99
4,15,20,1,18,4,19,0,0,81
4,15,20,1,18,9,5,0,0,72
4,15,20,1,20,5,0,0,0,65
4,15,20,1,20,9,15,14,0,98
4,15,20,1,20,9,15,14,19,117
4,15,20,3,8,9,14,0,0,73
4,15,20,5,4,0,0,0,0,48
4,15,20,5,18,0,0,0,0,62
4,15,20,5,18,19,0,0,0,81
4,15,20,5,19,0,0,0,0,63
4,15,20,8,0,0,0,0,0,47
4,15,20,8,5,18,0,0,0,70
4,15,20,9,5,18,0,0,0,71
4,15,20,9,5,19,20,0,0,92
4,15,20,9,14,5,19,19,0,105
4,15,20,9,14,7,0,0,0,69
4,15,20,9,14,7,12,25,0,106
4,15,20,9,19,8,0,0,0,75
4,15,20,11,9,14,0,0,0,73
4,15,20,12,5,19,19,0,0,94
4,15,20,12,5,20,0,0,0,76
4,15,20,12,9,11,5,0,0,76
4,15,20,20,1,18,4,0,0,82
4,15,20,20,5,4,0,0,0,68
4,15,20,20,5,12,0,0,0,76
4,15,20,20,5,12,19,0,0,95
4,15,20,20,5,18,0,0,0,82
4,15,20,20,5,18,5,12,0,99
4,15,20,20,5,18,5,12,19,118
4,15,20,20,5,18,19,0,0,101
4,15,20,20,9,5,18,0,0,91
4,15,20,20,9,5,19,20,0,112
4,15,20,20,9,12,25,0,0,105
4,15,20,20,9,14,5,19,19,125
4,15,20,20,9,14,7,0,0,89
4,15,20,20,12,5,0,0,0,76
4,15,20,20,12,5,4,0,0,80
4,15,20,20,12,5,18,0,0,94
4,15,20,20,12,5,19,0,0,95
4,15,20,20,12,9,14,7,0,101
4,15,20,20,18,5,12,0,0,94
4,15,20,20,18,5,12,19,0,113
4,15,21,1,14,5,0,0,0,60
4,15,21,1,14,5,19,0,0,79
4,15,21,1,14,9,5,18,0,87
4,15,21,1,18,0,0,0,0,59
4,15,21,2,0,0,0,0,0,42
4,15,21,2,12,5,0,0,0,59
4,15,21,2,12,5,4,0,0,63
4,15,21,2,12,5,25,15,21,120
4,15,21,2,12,5,18,19,0,96
4,15,21,2,12,5,19,0,0,78
4,15,21,2,12,5,20,0,0,79
4,15,21,2,12,5,20,5,4,88
4,15,21,2,12,5,20,15,14,108
4,15,21,2,12,5,20,19,0,98
4,15,21,2,12,5,20,20,5,104
4,15,21,2,12,25,0,0,0,79
4,15,21,2,12,9,14,7,0,84
4,15,21,2,12,15,15,14,0,98
4,15,21,2,12,15,15,14,19,117
4,15,21,2,12,21,18,5,0,98
4,15,21,2,12,21,18,5,19,117
4,15,21,2,20,0,0,0,0,62
4,15,21,2,20,1,2,12,5,82
4,15,21,2,20,1,2,12,25,102
4,15,21,2,20,1,14,3,5,85
4,15,21,2,20,5,4,0,0,71
4,15,21,2,20,5,4,12,25,108
4,15,21,2,20,5,18,0,0,85
4,15,21,2,20,5,18,19,0,104
4,15,21,2,20,6,21,12,0,101
4,15,21,2,20,25,0,0,0,87
4,15,21,2,20,9,14,7,0,92
4,15,21,2,20,12,5,19,19,117
4,15,21,2,20,15,21,19,0,117
4,15,21,2,20,19,0,0,0,81
4,15,21,2,20,19,15,13,5,114
4,15,21,3,0,0,0,0,0,43
4,15,21,3,5,0,0,0,0,48
4,15,21,3,5,12,25,0,0,85
4,15,21,3,5,14,5,19,19,105
4,15,21,3,5,16,5,18,5,92
4,15,21,3,5,20,0,0,0,68
4,15,21,3,5,21,18,0,0,87
4,15,21,3,5,21,18,19,0,106
4,15,21,3,8,5,0,0,0,56
4,15,21,3,8,5,4,0,0,60
4,15,21,3,8,5,19,0,0,75
4,15,21,3,8,9,14,7,0,81
4,15,21,3,9,14,0,0,0,66
4,15,21,3,9,14,5,0,0,71
4,15,21,3,11,5,18,0,0,77
4,15,21,4,12,5,0,0,0,61
4,15,21,7,8,0,0,0,0,55
4,15,21,7,8,2,9,18,4,88
4,15,21,7,8,2,15,25,0,97
4,15,21,7,8,2,15,25,19,116
4,15,21,7,8,6,1,3,5,70
4,15,21,7,8,6,5,5,20,91
4,15,21,7,8,6,15,15,20,111
4,15,21,7,8,8,5,1,4,73
4,15,21,7,8,25,0,0,0,80
4,15,21,7,8,9,5,18,0,87
4,15,21,7,8,9,5,19,20,108
4,15,21,7,8,12,9,11,5,92
4,15,21,7,8,13,5,14,0,87
4,15,21,7,8,14,21,20,0,110
4,15,21,7,8,14,21,20,19,129
4,15,21,7,8,19,0,0,0,74
4,15,21,7,8,20,0,0,0,75
4,15,21,7,8,20,9,5,18,107
4,15,21,7,8,20,9,12,25,121
4,15,21,7,12,0,0,0,0,59
4,15,21,12,3,5,0,0,0,60
4,15,21,13,0,0,0,0,0,53
4,15,21,13,1,0,0,0,0,54
4,15,21,13,1,9,19,20,0,102
4,15,21,13,1,19,0,0,0,73
4,15,21,13,19,0,0,0,0,72
4,15,21,14,4,1,11,5,0,75
4,15,21,16,0,0,0,0,0,56
4,15,21,16,5,18,0,0,0,79
4,15,21,16,9,14,7,0,0,86
4,15,21,16,9,15,14,0,0,94
4,15,21,16,9,15,14,9,0,103
4,15,21,16,16,9,15,14,9,119
4,15,21,18,0,0,0,0,0,58
4,15,21,18,1,0,0,0,0,59
4,15,21,18,1,4,5,0,0,68
4,15,21,18,1,8,0,0,0,67
4,15,21,18,1,8,19,0,0,86
4,15,21,18,1,19,0,0,0,78
4,15,21,18,5,18,0,0,0,81
4,15,21,18,5,19,20,0,0,102
4,15,21,18,9,14,5,0,0,86
4,15,21,18,9,14,5,19,0,105
4,15,21,18,12,25,0,0,0,95
4,15,21,18,14,5,19,19,0,115
4,15,21,19,5,0,0,0,0,64
4,15,21,19,5,4,0,0,0,68
4,15,21,19,5,18,0,0,0,82
4,15,21,19,5,18,19,0,0,101
4,15,21,19,5,19,0,0,0,83
4,15,21,19,9,14,7,0,0,89
4,15,21,20,0,0,0,0,0,60
4,15,21,20,5,18,0,0,0,83
4,15,21,20,15,21,19,0,0,115
4,15,21,22,5,3,15,20,0,105
4,15,21,24,0,0,0,0,0,64
4,15,21,26,1,9,14,5,0,95
4,15,21,26,1,9,14,5,19,114
4,15,21,26,5,16,5,18,0,110
4,15,21,26,5,16,5,18,19,129
4,15,21,26,9,5,13,5,0,98
4,15,21,26,9,5,13,5,19,117
4,15,22,5,3,15,20,0,0,84
4,15,22,5,3,15,20,5,0,89
4,15,22,5,3,15,20,5,19,108
4,15,22,5,3,15,20,19,0,103
4,15,22,5,6,15,15,20,0,102
4,15,22,5,8,15,21,19,5,114
4,15,22,5,25,0,0,0,0,71
4,15,22,5,11,5,25,0,0,87
4,15,22,5,11,5,25,19,0,106
4,15,22,5,11,9,5,0,0,71
4,15,22,5,11,9,5,19,0,90
4,15,22,5,12,5,20,0,0,83
4,15,22,5,12,9,11,5,0,83
4,15,22,5,12,9,14,7,0,88
4,15,22,5,14,0,0,0,0,60
4,15,22,5,14,5,4,0,0,69
4,15,22,5,14,9,14,7,0,90
4,15,22,5,14,19,0,0,0,79
4,15,22,5,19,0,0,0,0,65
4,15,22,5,20,1,9,12,0,88
4,15,22,5,20,1,9,12,19,107
4,15,22,5,23,5,5,4,0,83
4,15,22,5,23,15,15,4,0,103
4,15,22,9,19,8,0,0,0,77
4,15,23,1,2,12,5,0,0,62
4,15,23,1,7,5,0,0,0,55
4,15,23,1,7,5,18,0,0,73
4,15,23,1,7,5,18,19,0,92
4,15,23,3,5,20,0,0,0,70
4,15,23,3,15,20,5,0,0,85
4,15,23,4,25,0,0,0,0,71
4,15,23,4,9,5,18,0,0,78
4,15,23,4,9,5,19,0,0,79
4,15,23,4,9,5,19,20,0,99
4,15,23,4,25,9,19,8,0,107
4,15,23,4,25,9,19,13,0,112
4,15,23,4,9,12,25,0,0,92
4,15,23,4,9,14,5,19,19,112
4,15,23,5,4,0,0,0,0,51
4,15,23,5,12,0,0,0,0,59
4,15,23,5,12,5,4,0,0,68
4,15,23,5,12,9,14,7,0,89
4,15,23,5,12,12,5,4,0,80
4,15,23,5,12,12,9,14,7,101
4,15,23,5,12,19,0,0,0,78
4,15,23,5,18,0,0,0,0,65
4,15,23,5,18,1,12,0,0,78
4,15,23,5,18,5,4,0,0,74
4,15,23,5,18,5,19,19,0,108
4,15,23,5,18,25,0,0,0,90
4,15,23,5,18,9,5,19,0,98
4,15,23,5,18,9,14,7,0,95
4,15,23,5,18,12,5,19,19,120
4,15,23,5,18,19,0,0,0,84
4,15,23,6,0,0,0,0,0,48
4,15,23,6,1,18,20,0,0,87
4,15,23,8,1,3,11,25,0,90
4,15,23,25,0,0,0,0,0,67
4,15,23,9,5,0,0,0,0,56
4,15,23,9,12,25,0,0,0,88
4,15,23,9,14,5,19,19,0,108
4,15,23,9,14,7,0,0,0,72
4,15,23,9,20,3,8,0,0,82
4,15,23,9,20,3,8,5,18,105
4,15,23,12,0,0,0,0,0,54
4,15,23,12,1,19,0,0,0,74
4,15,23,12,5,19,19,0,0,97
4,15,23,12,25,0,0,0,0,79
4,15,23,13,5,14,20,0,0,94
4,15,23,14,2,5,1,18,0,82
4,15,23,14,2,5,1,18,4,86
4,15,23,14,2,5,1,20,0,84
4,15,23,14,2,5,1,20,19,103
4,15,23,14,2,5,14,4,0,81
4,15,23,14,2,5,14,20,0,97
4,15,23,14,2,25,0,0,0,83
4,15,23,14,2,25,5,0,0,88
4,15,23,14,3,1,19,20,0,99
4,15,23,14,3,1,19,20,19,118
4,15,23,14,3,15,13,5,0,92
4,15,23,14,3,15,13,5,18,110
4,15,23,14,3,15,13,5,19,111
4,15,23,14,3,15,21,18,20,133
4,15,23,14,3,18,25,0,0,102
4,15,23,14,3,18,9,5,4,95
4,15,23,14,3,21,18,22,5,125
4,15,23,14,3,21,20,0,0,100
4,15,23,14,4,1,12,5,0,78
4,15,23,14,4,18,1,6,20,105
4,15,23,14,5,4,0,0,0,65
4,15,23,14,5,18,0,0,0,79
4,15,23,14,5,18,19,0,0,98
4,15,23,14,6,1,3,5,0,71
4,15,23,14,6,1,12,12,0,87
4,15,23,14,6,1,12,12,19,106
4,15,23,14,6,5,5,4,0,76
4,15,23,14,6,9,5,12,4,92
4,15,23,14,6,12,15,23,0,112
4,15,23,14,6,15,12,4,0,93
4,15,23,14,7,1,20,5,0,89
4,15,23,14,7,25,22,5,4,119
4,15,23,14,7,15,9,14,7,108
4,15,23,14,7,15,14,5,0,97
4,15,23,14,7,18,1,4,5,91
4,15,23,14,8,1,21,12,0,98
4,15,23,14,8,1,21,12,19,117
4,15,23,14,8,9,12,12,0,97
4,15,23,14,8,9,12,12,19,116
4,15,23,14,25,0,0,0,0,81
4,15,23,14,9,5,18,0,0,88
4,15,23,14,9,5,19,20,0,109
4,15,23,14,9,12,25,0,0,102
4,15,23,14,9,14,5,19,19,122
4,15,23,14,12,1,14,4,0,87
4,15,23,14,12,5,19,19,0,111
4,15,23,14,12,9,5,0,0,82
4,15,23,14,12,9,5,18,0,100
4,15,23,14,12,25,9,14,7,123
4,15,23,14,12,9,11,5,0,93
4,15,23,14,12,9,14,5,0,96
4,15,23,14,12,9,14,11,0,102
4,15,23,14,12,9,14,11,19,121
4,15,23,14,12,15,1,4,0,88
4,15,23,14,12,15,1,4,19,107
4,15,23,14,13,15,19,20,0,123
4,15,23,14,14,5,19,19,0,113
4,15,23,14,16,9,16,5,0,102
4,15,23,14,16,12,1,25,0,110
4,15,23,14,16,12,1,25,19,129
4,15,23,14,16,15,21,18,0,126
4,15,23,14,16,15,21,18,19,145
4,15,23,14,18,1,14,7,5,101
4,15,23,14,18,9,7,8,20,118
4,15,23,14,18,9,22,5,18,128
4,15,23,14,18,21,19,8,0,122
4,15,23,14,19,5,20,0,0,100
4,15,23,14,19,8,1,18,5,107
4,15,23,14,19,8,9,6,20,118
4,15,23,14,19,8,15,18,5,121
4,15,23,14,19,9,4,5,0,93
4,15,23,14,19,9,26,5,0,115
4,15,23,14,19,9,26,5,4,119
4,15,23,14,19,9,26,5,19,134
4,15,23,14,19,12,9,4,5,105
4,15,23,14,19,12,9,16,0,112
4,15,23,14,19,12,15,16,5,123
4,15,23,14,19,13,1,14,0,103
4,15,23,14,19,15,13,5,0,108
4,15,23,14,19,16,15,21,20,147
4,15,23,14,19,20,1,7,5,108
4,15,23,14,19,20,1,9,18,123
4,15,23,14,19,20,1,20,5,121
4,15,23,14,19,23,9,14,7,128
4,15,23,14,20,1,11,5,0,93
4,15,23,14,20,8,18,15,23,140
4,15,23,14,20,9,3,11,0,99
4,15,23,14,20,9,13,5,0,103
4,15,23,14,20,9,13,5,19,122
4,15,23,14,20,15,23,14,0,128
4,15,23,14,20,15,23,14,19,147
4,15,23,14,20,18,5,14,4,117
4,15,23,14,20,18,15,4,0,113
4,15,23,14,20,21,18,14,0,129
4,15,23,14,20,21,18,14,19,148
4,15,23,14,23,1,25,0,0,105
4,15,23,14,23,1,18,4,0,102
4,15,23,14,23,1,18,4,19,121
4,15,23,14,23,1,18,16,0,114
4,15,23,14,23,1,19,8,0,107
4,15,23,14,23,5,5,4,0,93
4,15,23,14,23,5,9,7,8,108
4,15,23,14,23,9,14,4,0,106
4,15,23,14,23,9,20,8,0,116
4,15,23,16,0,0,0,0,0,58
4,15,23,18,5,19,19,0,0,103
4,15,23,18,25,0,0,0,0,85
4,15,23,18,9,5,19,0,0,93
4,15,23,19,1,2,5,12,0,81
4,15,23,19,1,2,5,12,19,100
4,15,23,19,5,0,0,0,0,66
4,15,23,19,5,4,0,0,0,70
4,15,23,19,5,18,0,0,0,84
4,15,23,19,5,18,19,0,0,103
4,15,23,19,5,19,0,0,0,85
4,15,23,19,5,20,0,0,0,86
4,15,23,19,5,20,19,0,0,105
4,15,23,19,9,14,7,0,0,91
4,15,23,22,5,0,0,0,0,69
4,15,24,1,0,0,0,0,0,44
4,15,24,1,19,20,9,3,0,95
4,15,24,25,0,0,0,0,0,68
4,15,24,9,5,0,0,0,0,57
4,15,24,9,5,19,0,0,0,76
4,15,24,15,12,15,7,25,0,117
4,15,26,0,0,0,0,0,0,45
4,15,26,5,0,0,0,0,0,50
4,15,26,5,4,0,0,0,0,54
4,15,26,5,14,0,0,0,0,64
4,15,26,5,14,5,4,0,0,73
4,15,26,5,14,5,18,0,0,87
4,15,26,5,14,9,14,7,0,94
4,15,26,5,14,19,0,0,0,83
4,15,26,5,14,20,0,0,0,84
4,15,26,5,14,20,8,0,0,92
4,15,26,5,14,20,8,19,0,111
4,15,26,5,18,0,0,0,0,68
4,15,26,5,18,19,0,0,0,87
4,15,26,5,19,0,0,0,0,69
4,15,26,25,0,0,0,0,0,70
4,15,26,9,5,19,20,0,0,98
4,15,26,9,12,25,0,0,0,91
4,15,26,9,14,5,19,19,0,111
4,15,26,9,14,7,0,0,0,75
4,15,26,26,12,5,0,0,0,88
4,15,26,26,12,5,4,0,0,92
4,16,20,0,0,0,0,0,0,40
4,18,3,8,0,0,0,0,0,33
4,18,5,1,4,0,0,0,0,32
4,18,5,1,4,1,2,12,5,52
4,18,5,1,4,5,4,0,0,41
4,18,5,1,4,5,18,0,0,55
4,18,5,1,4,6,21,12,0,71
4,18,5,1,4,6,21,12,19,90
4,18,5,1,4,9,14,7,0,62
4,18,5,1,4,12,5,19,19,87
4,18,5,1,4,12,25,0,0,69
4,18,5,1,4,14,5,19,19,89
4,18,5,1,4,19,0,0,0,51
4,18,5,1,13,1,7,5,0,54
4,18,5,1,13,2,15,1,20,79
4,18,5,1,13,5,4,0,0,50
4,18,5,1,13,5,18,0,0,64
4,18,5,1,13,5,18,25,0,89
4,18,5,1,13,5,18,19,0,83
4,18,5,1,13,6,21,12,0,80
4,18,5,1,13,8,15,12,5,81
4,18,5,1,13,25,0,0,0,66
4,18,5,1,13,9,5,18,0,73
4,18,5,1,13,9,5,19,20,94
4,18,5,1,13,9,12,25,0,87
4,18,5,1,13,9,14,7,0,71
4,18,5,1,13,9,19,8,0,77
4,18,5,1,13,12,1,14,4,72
4,18,5,1,13,12,5,19,19,96
4,18,5,1,13,12,5,20,0,78
4,18,5,1,13,12,9,11,5,78
4,18,5,1,13,12,9,20,0,82
4,18,5,1,13,12,15,18,5,91
4,18,5,1,13,19,25,0,0,85
4,18,5,1,13,19,9,12,25,106
4,18,5,1,13,20,0,0,0,61
4,18,5,1,13,20,9,4,5,79
4,18,5,1,13,20,9,13,5,88
4,18,5,1,13,23,9,19,5,97
4,18,5,1,18,0,0,0,0,46
4,18,5,1,18,25,0,0,0,71
4,18,5,1,18,9,5,18,0,78
4,18,5,1,18,9,5,19,0,79
4,18,5,1,18,9,5,19,20,99
4,18,5,1,18,9,12,25,0,92
4,18,5,1,18,9,14,7,0,76
4,18,5,1,18,12,25,0,0,83
4,18,5,1,18,14,5,19,19,103
4,18,5,1,18,19,0,0,0,65
4,18,5,3,8,5,0,0,0,43
4,18,5,3,11,0,0,0,0,41
4,18,5,3,11,25,0,0,0,66
4,18,5,3,11,19,0,0,0,60
4,18,5,4,7,5,0,0,0,43
4,18,5,4,7,5,4,0,0,47
4,18,5,4,7,5,6,21,12,82
4,18,5,4,7,5,18,0,0,61
4,18,5,4,7,5,18,19,0,80
4,18,5,4,7,5,19,0,0,62
4,18,5,4,7,9,14,7,0,68
4,18,5,4,7,9,14,7,19,87
4,18,5,5,0,0,0,0,0,32
4,18,5,5,4,0,0,0,0,36
4,18,5,5,7,8,0,0,0,47
4,18,5,5,9,14,7,0,0,62
4,18,5,5,16,0,0,0,0,48
4,18,5,5,16,25,0,0,0,73
4,18,5,5,19,0,0,0,0,51
4,18,5,7,0,0,0,0,0,34
4,18,5,7,7,25,0,0,0,66
4,18,5,7,7,9,5,18,0,73
4,18,5,7,7,9,5,19,20,94
4,18,5,7,7,9,12,25,0,87
4,18,5,7,7,9,19,8,0,77
4,18,5,7,12,5,19,19,0,89
4,18,5,7,19,0,0,0,0,53
4,18,5,25,0,0,0,0,0,52
4,18,5,9,3,8,0,0,0,47
4,18,5,9,4,5,12,0,0,57
4,18,5,9,4,5,12,19,0,76
4,18,5,9,4,12,0,0,0,52
4,18,5,9,4,12,19,0,0,71
4,18,5,9,7,8,0,0,0,51
4,18,5,9,12,9,14,7,0,78
4,18,5,9,14,20,0,0,0,70
4,18,5,25,14,20,0,0,0,86
4,18,5,11,0,0,0,0,0,38
4,18,5,11,19,0,0,0,0,57
4,18,5,14,3,8,0,0,0,52
4,18,5,14,3,8,5,4,0,61
4,18,5,14,3,8,5,18,0,75
4,18,5,14,3,8,5,18,19,94
4,18,5,14,3,8,5,19,0,76
4,18,5,14,3,8,9,14,7,82
4,18,5,14,7,0,0,0,0,48
4,18,5,14,7,1,7,5,0,61
4,18,5,14,7,8,0,0,0,56
4,18,5,14,20,0,0,0,0,61
4,18,5,16,1,14,5,0,0,63
4,18,5,16,1,14,9,1,0,68
4,18,5,16,1,14,9,4,0,71
4,18,5,16,1,14,9,21,13,101
4,18,5,16,1,14,15,9,4,86
4,18,5,19,19,0,0,0,0,65
4,18,5,19,19,1,7,5,0,78
4,18,5,19,19,1,7,5,19,97
4,18,5,19,19,5,4,0,0,74
4,18,5,19,19,5,18,19,0,107
4,18,5,19,19,5,19,0,0,89
4,18,5,19,19,25,0,0,0,90
4,18,5,19,19,9,5,18,0,97
4,18,5,19,19,9,5,19,20,118
4,18,5,19,19,9,12,25,0,111
4,18,5,19,19,9,14,7,0,95
4,18,5,19,19,9,14,7,19,114
4,18,5,19,19,12,9,14,5,105
4,18,5,19,19,13,1,11,5,95
4,18,5,19,19,15,9,18,0,107
4,18,5,19,19,15,9,18,19,126
4,18,5,19,20,0,0,0,0,66
4,18,5,20,3,8,0,0,0,58
4,18,5,22,5,12,0,0,0,66
4,18,5,23,9,20,5,0,0,84
4,18,25,1,2,12,5,0,0,67
4,18,25,1,4,0,0,0,0,52
4,18,25,1,4,5,19,0,0,76
4,18,25,1,4,5,20,21,13,111
4,18,25,1,4,9,3,0,0,64
4,18,25,1,4,19,0,0,0,71
4,18,9,1,19,0,0,0,0,51
4,18,25,1,19,4,21,19,20,131
4,18,9,2,0,0,0,0,0,33
4,18,9,2,2,5,4,0,0,44
4,18,9,2,2,5,18,0,0,58
4,18,9,2,2,5,20,0,0,60
4,18,9,2,2,9,14,7,0,65
4,18,9,2,2,12,5,0,0,52
4,18,9,2,2,12,5,4,0,56
4,18,9,2,2,12,5,18,0,70
4,18,9,2,2,12,5,18,19,89
4,18,9,2,2,12,5,19,0,71
4,18,9,2,2,12,5,20,0,72
4,18,9,2,2,12,5,20,19,91
4,18,9,2,2,12,25,0,0,72
4,18,9,2,2,12,9,14,7,77
4,18,25,2,5,1,18,4,0,77
4,18,9,2,12,5,20,0,0,70
4,18,9,2,12,5,20,19,0,89
4,18,25,2,18,21,19,8,0,115
4,18,9,2,19,0,0,0,0,52
4,18,25,3,15,1,12,0,0,78
4,18,9,4,4,5,18,0,0,62
4,18,9,4,4,12,5,0,0,56
4,18,9,5,0,0,0,0,0,36
4,18,9,5,3,8,0,0,0,47
4,18,9,5,4,0,0,0,0,40
4,18,9,5,7,8,0,0,0,51
4,18,9,5,18,0,0,0,0,54
4,18,25,5,18,0,0,0,0,70
4,18,9,5,18,13,1,14,0,82
4,18,25,5,18,13,1,14,0,98
4,18,25,5,18,13,5,14,0,102
4,18,9,5,18,19,0,0,0,73
4,18,25,5,18,19,0,0,0,89
4,18,9,5,19,0,0,0,0,55
4,18,9,5,19,20,0,0,0,75
4,18,25,5,19,20,0,0,0,91
4,18,25,6,1,18,13,0,0,85
4,18,25,6,1,18,13,5,18,108
4,18,25,6,1,20,0,0,0,74
4,18,25,6,9,19,20,0,0,101
4,18,25,6,15,15,20,0,0,103
4,18,9,6,20,0,0,0,0,57
4,18,9,6,20,1,7,5,0,70
4,18,9,6,20,1,7,5,19,89
4,18,9,6,20,2,15,12,20,106
4,18,9,6,20,5,4,0,0,66
4,18,9,6,20,5,18,0,0,80
4,18,9,6,20,5,18,19,0,99
4,18,9,6,20,6,9,19,8,99
4,18,9,6,20,25,0,0,0,82
4,18,9,6,20,9,5,18,0,89
4,18,9,6,20,9,5,19,20,110
4,18,9,6,20,12,1,14,4,88
4,18,9,6,20,12,5,19,19,112
4,18,9,6,20,12,5,20,0,94
4,18,9,6,20,13,1,14,0,85
4,18,9,6,20,16,9,14,0,96
4,18,9,6,20,16,9,14,19,115
4,18,9,6,20,19,0,0,0,76
4,18,9,6,20,23,1,25,0,106
4,18,9,6,20,23,5,5,4,94
4,18,9,6,20,23,9,14,4,107
4,18,9,7,8,20,5,14,0,85
4,18,9,7,8,20,9,14,0,89
4,18,25,8,15,21,19,5,0,115
4,18,25,9,14,7,0,0,0,77
4,18,25,9,14,9,4,0,0,83
4,18,25,9,19,8,0,0,0,83
4,18,25,12,1,14,4,0,0,78
4,18,9,12,25,0,0,0,0,68
4,18,25,12,25,0,0,0,0,84
4,18,9,12,12,0,0,0,0,55
4,18,9,12,12,1,2,12,5,75
4,18,9,12,12,2,9,20,0,86
4,18,9,12,12,5,4,0,0,64
4,18,9,12,12,5,18,0,0,78
4,18,9,12,12,5,18,19,0,97
4,18,9,12,12,5,20,0,0,80
4,18,9,12,12,9,14,7,0,85
4,18,9,12,12,9,14,7,19,104
4,18,9,12,12,13,1,14,0,83
4,18,9,12,12,19,0,0,0,74
4,18,25,12,15,20,0,0,0,94
4,18,25,12,15,20,19,0,0,113
4,18,9,12,22,9,19,0,0,93
4,18,25,14,5,19,19,0,0,104
4,18,25,14,5,19,19,5,19,128
4,18,9,14,7,12,5,0,0,69
4,18,9,14,11,0,0,0,0,56
4,18,9,14,11,1,2,12,5,76
4,18,9,14,11,1,2,12,25,96
4,18,9,14,11,5,18,0,0,79
4,18,9,14,11,5,18,25,0,104
4,18,9,14,11,5,18,19,0,98
4,18,9,14,11,25,0,0,0,81
4,18,9,14,11,9,14,7,0,86
4,18,9,14,11,12,5,19,19,111
4,18,9,14,11,19,0,0,0,75
4,18,9,14,14,0,0,0,0,59
4,18,9,16,0,0,0,0,0,47
4,18,9,16,12,5,19,19,0,102
4,18,25,16,15,9,14,20,0,121
4,18,25,16,15,9,14,20,19,140
4,18,9,16,16,1,7,5,0,76
4,18,9,16,16,5,4,0,0,72
4,18,9,16,16,5,18,0,0,86
4,18,9,16,16,5,18,19,0,105
4,18,9,16,16,25,0,0,0,88
4,18,9,16,16,9,5,18,0,95
4,18,9,16,16,9,5,19,20,116
4,18,9,16,16,9,14,7,0,93
4,18,9,16,16,9,14,7,19,112
4,18,9,16,16,12,5,0,0,80
4,18,9,16,16,18,15,15,6,117
4,18,9,16,19,0,0,0,0,66
4,18,9,16,19,20,9,3,11,109
4,18,9,16,19,20,15,14,5,120
4,18,9,16,20,0,0,0,0,67
4,18,25,18,15,20,0,0,0,100
4,18,25,19,0,0,0,0,0,66
4,18,25,19,1,12,20,5,18,122
4,18,9,19,8,5,5,14,0,82
4,18,9,19,11,0,0,0,0,61
4,18,25,19,14,5,0,0,0,85
4,18,9,19,19,5,12,0,0,86
4,18,25,19,20,5,18,0,0,109
4,18,25,20,8,0,0,0,0,75
4,18,9,22,1,2,12,5,0,73
4,18,9,22,1,7,5,0,0,66
4,18,9,22,5,0,0,0,0,58
4,18,9,22,5,1,2,12,5,78
4,18,9,22,5,1,23,1,25,108
4,18,9,22,5,2,15,1,20,96
4,18,9,22,5,2,15,12,20,107
4,18,9,22,5,3,1,16,0,78
4,18,9,22,5,8,5,1,4,76
4,18,9,22,5,12,0,0,0,70
4,18,9,22,5,12,5,4,0,79
4,18,9,22,5,12,5,18,0,93
4,18,9,22,5,12,5,18,19,112
4,18,9,22,5,12,9,14,5,98
4,18,9,22,5,12,9,14,7,100
4,18,9,22,5,12,12,5,4,91
4,18,9,22,5,12,12,5,18,105
4,18,9,22,5,12,19,0,0,89
4,18,9,22,5,14,0,0,0,72
4,18,9,22,5,16,9,16,5,104
4,18,9,22,5,18,0,0,0,76
4,18,9,22,5,18,19,0,0,95
4,18,9,22,5,19,0,0,0,77
4,18,9,22,5,23,1,25,0,107
4,18,9,22,5,23,1,25,19,126
4,18,9,22,5,23,5,12,12,110
4,18,9,22,9,14,7,0,0,83
4,18,9,22,9,14,7,12,25,120
4,18,9,22,9,14,7,19,0,102
4,18,25,23,1,12,12,0,0,95
4,18,25,23,1,12,12,19,0,114
4,18,25,23,15,18,11,5,18,137
4,18,9,26,26,12,5,0,0,100
4,18,9,26,26,12,5,4,0,104
4,18,9,26,26,12,5,19,0,119
4,18,9,26,26,12,25,0,0,120
4,18,9,26,26,12,9,5,18,127
4,18,9,26,26,12,9,14,7,125
4,18,15,3,8,21,9,12,0,90
4,18,15,4,4,21,13,0,0,79
4,18,15,6,0,0,0,0,0,43
4,18,15,6,12,1,14,4,0,74
4,18,15,7,5,18,0,0,0,67
4,18,15,7,5,18,13,1,14,95
4,18,15,7,5,18,13,5,14,99
4,18,15,7,8,0,0,0,0,52
4,18,15,7,8,5,18,0,0,75
4,18,15,7,8,12,9,14,0,87
4,18,15,7,15,13,1,14,0,87
4,18,15,7,21,5,0,0,0,70
4,18,15,7,21,5,19,0,0,89
4,18,15,7,21,5,20,0,0,90
4,18,15,8,0,0,0,0,0,45
4,18,15,9,3,8,0,0,0,57
4,18,15,9,12,0,0,0,0,58
4,18,15,25,12,0,0,0,0,74
4,18,15,9,20,0,0,0,0,66
4,18,15,9,20,19,0,0,0,85
4,18,15,9,20,19,13,1,14,113
4,18,15,9,20,21,18,1,12,118
4,18,15,9,20,21,18,5,0,110
4,18,15,9,20,21,18,5,12,122
4,18,15,12,5,18,9,5,0,86
4,18,15,12,12,0,0,0,0,61
4,18,15,12,12,5,4,0,0,70
4,18,15,12,12,5,18,0,0,84
4,18,15,12,12,5,18,25,0,109
4,18,15,12,12,5,19,20,0,105
4,18,15,12,12,25,0,0,0,86
4,18,15,12,12,9,14,7,0,91
4,18,15,12,12,9,19,8,0,97
4,18,15,12,12,9,19,20,0,109
4,18,15,12,12,14,5,19,19,118
4,18,15,12,12,19,0,0,0,80
4,18,15,13,5,0,0,0,0,55
4,18,15,13,5,4,0,0,0,59
4,18,15,13,5,4,1,18,25,103
4,18,15,13,5,20,5,18,0,98
4,18,15,13,9,3,0,0,0,62
4,18,15,13,9,3,1,12,0,75
4,18,15,13,9,15,9,4,0,87
4,18,15,13,15,9,0,0,0,74
4,18,15,13,15,14,0,0,0,79
4,18,15,13,15,14,4,0,0,83
4,18,15,13,15,14,4,19,0,102
4,18,15,13,15,14,19,0,0,98
4,18,15,13,15,19,0,0,0,84
4,18,15,13,15,21,19,0,0,105
4,18,15,14,1,7,5,0,0,64
4,18,15,14,5,0,0,0,0,56
4,18,15,14,5,4,0,0,0,60
4,18,15,14,5,12,0,0,0,68
4,18,15,14,5,16,9,16,5,102
4,18,15,14,5,18,0,0,0,74
4,18,15,14,5,18,19,0,0,93
4,18,15,14,5,19,0,0,0,75
4,18,15,14,5,20,0,0,0,76
4,18,15,14,7,15,0,0,0,73
4,18,15,14,7,15,19,0,0,92
4,18,15,14,25,0,0,0,0,76
4,18,15,14,9,14,7,0,0,81
4,18,15,14,9,14,7,12,25,118
4,18,15,14,9,19,8,0,0,87
4,18,15,14,9,19,8,12,25,124
4,18,15,14,11,5,12,5,23,107
4,18,15,14,20,5,0,0,0,76
4,18,15,15,2,0,0,0,0,54
4,18,15,15,12,0,0,0,0,64
4,18,15,15,12,5,4,0,0,73
4,18,15,15,12,25,0,0,0,89
4,18,15,15,12,9,5,18,0,96
4,18,15,15,12,9,5,19,20,117
4,18,15,15,12,9,14,7,0,94
4,18,15,15,12,19,0,0,0,83
4,18,15,15,16,0,0,0,0,68
4,18,15,15,16,5,4,0,0,77
4,18,15,15,16,5,18,0,0,91
4,18,15,15,16,25,0,0,0,93
4,18,15,15,16,9,5,18,0,100
4,18,15,15,16,9,5,19,20,121
4,18,15,15,16,9,12,25,0,114
4,18,15,15,16,9,14,7,0,98
4,18,15,15,16,19,0,0,0,87
4,18,15,15,16,20,0,0,0,88
4,18,15,16,0,0,0,0,0,53
4,18,15,16,1,24,0,0,0,78
4,18,15,16,2,5,18,18,25,121
4,18,15,16,3,12,15,20,8,111
4,18,15,16,6,15,18,7,5,104
4,18,15,16,8,5,1,4,0,71
4,18,15,16,8,5,1,4,19,90
4,18,15,16,11,9,3,11,0,87
4,18,15,16,11,9,3,11,19,106
4,18,15,16,12,5,20,0,0,90
4,18,15,16,12,5,20,19,0,109
4,18,15,16,12,9,7,8,20,109
4,18,15,16,12,9,11,5,0,90
4,18,15,16,12,9,14,5,0,93
4,18,15,16,12,9,14,7,0,95
4,18,15,16,13,1,14,0,0,81
4,18,15,16,13,5,1,12,0,84
4,18,15,16,15,21,20,0,0,109
4,18,15,16,15,21,20,19,0,128
4,18,15,16,16,1,7,5,0,82
4,18,15,16,16,5,4,0,0,78
4,18,15,16,16,5,18,0,0,92
4,18,15,16,16,5,18,19,0,111
4,18,15,16,16,25,0,0,0,94
4,18,15,16,16,9,14,7,0,99
4,18,15,16,16,9,14,7,19,118
4,18,15,16,19,0,0,0,0,72
4,18,15,16,19,5,5,4,0,86
4,18,15,16,19,8,15,20,0,115
4,18,15,16,19,8,15,20,19,134
4,18,15,16,19,25,0,0,0,97
4,18,15,16,19,9,3,1,12,97
4,18,15,16,19,9,5,4,0,90
4,18,15,16,19,9,5,19,0,105
4,18,15,16,19,15,14,4,5,110
4,18,15,16,20,0,0,0,0,73
4,18,15,16,22,9,5,0,0,89
4,18,15,16,23,9,19,5,0,109
4,18,15,16,23,15,18,13,0,122
4,18,15,16,23,15,18,20,0,129
4,18,15,16,23,15,18,20,19,148
4,18,15,19,5,18,1,19,0,99
4,18,15,19,8,11,25,0,0,100
4,18,15,19,8,11,9,5,19,108
4,18,15,19,11,25,0,0,0,92
4,18,15,19,11,9,5,19,0,100
4,18,15,19,19,0,0,0,0,75
4,18,15,19,19,5,4,0,0,84
4,18,15,19,19,5,12,0,0,92
4,18,15,19,19,5,18,0,0,98
4,18,15,19,19,5,19,0,0,99
4,18,15,19,19,25,0,0,0,100
4,18,15,19,19,9,5,18,0,107
4,18,15,19,19,9,5,19,20,128
4,18,15,19,19,9,14,7,0,105
4,18,15,19,19,12,5,19,19,130
4,18,15,19,20,4,5,14,0,99
4,18,15,19,20,4,25,0,0,105
4,18,15,21,0,0,0,0,0,58
4,18,15,21,4,0,0,0,0,62
4,18,15,21,7,8,20,0,0,93
4,18,15,21,7,8,20,25,0,118
4,18,15,21,7,8,20,19,0,112
4,18,15,21,11,0,0,0,0,69
4,18,15,21,11,1,14,0,0,84
4,18,15,21,11,5,4,0,0,78
4,18,15,21,11,5,20,0,0,94
4,18,15,21,11,9,14,7,0,99
4,18,15,21,11,9,20,0,0,98
4,18,15,21,11,19,0,0,0,88
4,18,15,21,13,25,0,0,0,96
4,18,15,21,20,8,0,0,0,86
4,18,15,21,20,8,25,0,0,111
4,18,15,21,20,8,9,5,18,118
4,18,15,21,20,8,19,0,0,105
4,18,15,22,5,0,0,0,0,64
4,18,15,22,5,4,0,0,0,68
4,18,15,22,5,18,0,0,0,82
4,18,15,22,5,18,19,0,0,101
4,18,15,22,5,19,0,0,0,83
4,18,15,22,25,0,0,0,0,84
4,18,15,22,9,14,7,0,0,89
4,18,15,23,0,0,0,0,0,60
4,18,15,23,14,0,0,0,0,74
4,18,15,23,14,4,0,0,0,78
4,18,15,23,14,4,5,4,0,87
4,18,15,23,14,4,9,14,7,108
4,18,15,23,14,4,19,0,0,97
4,18,15,23,14,5,4,0,0,83
4,18,15,23,14,5,18,0,0,97
4,18,15,23,14,5,18,19,0,116
4,18,15,23,14,9,14,7,0,104
4,18,15,23,14,9,14,7,19,123
4,18,15,23,14,19,0,0,0,93
4,18,15,23,19,5,0,0,0,84
4,18,15,23,19,5,4,0,0,88
4,18,15,23,19,5,19,0,0,103
4,18,15,23,19,25,0,0,0,104
4,18,15,23,19,9,5,18,0,111
4,18,15,23,19,9,5,19,20,132
4,18,15,23,19,9,12,25,0,125
4,18,15,23,19,9,14,7,0,109
4,18,15,23,20,5,0,0,0,85
4,18,21,2,0,0,0,0,0,45
4,18,21,2,2,5,4,0,0,56
4,18,21,2,2,5,18,0,0,70
4,18,21,2,2,5,18,19,0,89
4,18,21,2,2,9,14,7,0,77
4,18,21,2,2,9,14,7,19,96
4,18,21,2,2,12,5,0,0,64
4,18,21,2,2,12,25,0,0,84
4,18,21,2,12,25,0,0,0,82
4,18,21,2,19,0,0,0,0,64
4,18,21,3,11,5,14,0,0,76
4,18,21,4,7,5,0,0,0,59
4,18,21,4,7,5,4,0,0,63
4,18,21,4,7,5,18,0,0,77
4,18,21,4,7,5,18,25,0,102
4,18,21,4,7,5,18,19,0,96
4,18,21,4,7,5,19,0,0,78
4,18,21,4,7,9,14,7,0,84
4,18,21,4,7,9,19,13,0,95
4,18,21,5,18,25,0,0,0,91
4,18,21,6,6,5,14,0,0,74
4,18,21,7,7,5,4,0,0,66
4,18,21,7,7,5,18,0,0,80
4,18,21,7,7,5,18,25,0,105
4,18,21,7,7,5,20,0,0,82
4,18,21,7,7,5,20,19,0,101
4,18,21,7,7,25,0,0,0,82
4,18,21,7,7,9,5,0,0,71
4,18,21,7,7,9,5,18,0,89
4,18,21,7,7,9,5,19,0,90
4,18,21,7,7,9,5,19,20,110
4,18,21,7,7,9,14,7,0,87
4,18,21,7,7,9,19,20,0,105
4,18,21,7,7,9,19,20,19,124
4,18,21,7,12,5,19,19,0,105
4,18,21,7,13,1,11,5,18,98
4,18,21,7,13,1,14,0,0,78
4,18,21,7,19,0,0,0,0,69
4,18,21,7,19,8,15,16,0,108
4,18,21,7,19,20,15,18,5,127
4,18,21,9,4,9,3,0,0,68
4,18,21,9,4,9,3,1,12,81
4,18,21,9,4,9,19,13,19,116
4,18,21,9,4,18,25,0,0,99
4,18,21,9,4,19,0,0,0,75
4,18,21,9,20,8,0,0,0,80
4,18,21,13,0,0,0,0,0,56
4,18,21,13,2,5,1,20,0,84
4,18,21,13,2,5,1,20,19,103
4,18,21,13,2,12,5,0,0,75
4,18,21,13,2,12,5,4,0,79
4,18,21,13,2,12,5,18,0,93
4,18,21,13,2,12,5,19,0,94
4,18,21,13,2,12,9,14,7,100
4,18,21,13,6,9,18,5,0,94
4,18,21,13,6,9,18,5,19,113
4,18,21,13,6,9,19,8,0,98
4,18,21,13,8,5,1,4,0,74
4,18,21,13,8,5,1,4,19,93
4,18,21,13,12,5,18,0,0,91
4,18,21,13,12,25,0,0,0,93
4,18,21,13,12,9,5,18,0,100
4,18,21,13,12,9,5,19,20,121
4,18,21,13,12,9,11,5,0,93
4,18,21,13,12,9,14,0,0,91
4,18,21,13,12,9,14,5,0,96
4,18,21,13,12,9,14,19,0,110
4,18,21,13,12,15,9,4,0,96
4,18,21,13,13,5,4,0,0,78
4,18,21,13,13,5,18,0,0,92
4,18,21,13,13,5,18,19,0,111
4,18,21,13,13,25,0,0,0,94
4,18,21,13,13,9,14,7,0,99
4,18,21,13,13,15,3,11,0,98
4,18,21,13,18,5,1,4,0,84
4,18,21,13,18,5,1,4,19,103
4,18,21,13,18,15,12,12,0,113
4,18,21,13,18,15,12,12,19,132
4,18,21,13,19,11,9,14,0,109
4,18,21,13,19,12,1,4,5,97
4,18,21,13,19,12,5,18,0,110
4,18,21,13,19,20,9,3,11,118
4,18,21,13,23,15,15,4,0,113
4,18,21,14,7,0,0,0,0,64
4,18,21,14,7,1,18,0,0,83
4,18,21,14,11,0,0,0,0,68
4,18,21,14,11,1,18,4,0,91
4,18,21,14,11,1,18,4,19,110
4,18,21,14,11,5,12,5,23,113
4,18,21,14,11,5,14,0,0,87
4,18,21,14,11,5,14,12,25,124
4,18,21,14,11,5,18,0,0,91
4,18,21,14,11,5,18,25,0,116
4,18,21,14,11,5,19,20,0,112
4,18,21,14,11,12,25,0,0,105
4,18,21,14,11,19,0,0,0,87
4,18,21,14,20,0,0,0,0,77
4,18,21,16,1,12,0,0,0,72
4,18,21,16,5,0,0,0,0,64
4,18,21,16,5,12,0,0,0,76
4,18,21,16,5,12,5,20,0,101
4,18,21,16,5,12,5,20,19,120
4,18,21,16,5,15,12,5,0,96
4,18,21,16,5,19,0,0,0,83
4,18,21,16,5,20,21,13,0,118
4,18,21,16,15,19,5,0,0,98
4,18,21,19,5,4,0,0,0,71
4,18,21,19,5,19,0,0,0,86
4,18,21,20,8,5,18,0,0,94
4,18,21,20,8,5,18,19,0,113
4,18,21,20,20,12,5,0,0,100
4,18,21,24,5,25,0,0,0,97
4,18,21,24,25,0,0,0,0,92
4,18,21,24,9,14,5,19,19,133
4,19,5,3,20,0,0,0,0,51
4,19,5,3,20,19,0,0,0,70
4,19,14,1,13,5,0,0,0,56
4,19,14,1,13,5,19,0,0,75
4,20,4,0,0,0,0,0,0,28
4,20,5,14,20,5,0,0,0,68
4,20,19,5,20,0,0,0,0,68
4,21,2,0,0,0,0,0,0,27
4,21,2,1,19,8,0,0,0,55
4,21,2,2,0,0,0,0,0,29
4,21,2,2,1,0,0,0,0,30
4,21,2,2,1,8,0,0,0,38
4,21,2,2,5,4,0,0,0,38
4,21,2,2,5,8,0,0,0,42
4,21,2,2,5,12,20,10,5,81
4,21,2,2,5,18,0,0,0,52
4,21,2,2,5,18,19,0,0,71
4,21,2,2,25,0,0,0,0,54
4,21,2,2,9,14,0,0,0,52
4,21,2,2,9,14,7,0,0,59
4,21,2,2,9,14,7,19,0,78
4,21,2,2,9,14,19,0,0,71
4,21,2,9,5,20,25,0,0,86
4,21,2,9,5,20,9,5,19,94
4,21,2,9,15,0,0,0,0,51
4,21,2,9,15,19,9,20,25,124
4,21,2,9,15,21,19,0,0,91
4,21,2,9,15,21,19,12,25,128
4,21,2,9,20,1,2,12,5,76
4,21,2,9,20,1,2,12,25,96
4,21,2,9,20,1,14,3,25,99
4,21,2,9,20,1,14,20,0,91
4,21,2,9,20,1,14,20,5,96
4,21,2,9,20,1,20,5,0,82
4,21,2,15,9,19,9,14,0,93
4,21,2,15,9,19,9,14,5,98
4,21,2,15,14,14,5,20,19,114
4,21,2,19,0,0,0,0,0,46
4,21,3,1,12,12,25,0,0,78
4,21,3,1,13,1,18,1,0,62
4,21,3,1,16,5,0,0,0,50
4,21,3,1,20,0,0,0,0,49
4,21,3,1,20,15,0,0,0,64
4,21,3,1,20,15,14,0,0,78
4,21,3,1,20,15,15,14,0,93
4,21,3,1,20,19,0,0,0,68
4,21,3,1,20,21,19,0,0,89
4,21,3,4,1,13,5,0,0,51
4,21,3,5,19,0,0,0,0,52
4,21,3,8,1,14,0,0,0,51
4,21,3,8,5,18,25,0,0,84
4,21,3,8,5,19,19,5,0,84
4,21,3,8,5,19,19,5,19,103
4,21,3,8,25,0,0,0,0,61
4,21,3,8,9,5,19,0,0,69
4,21,3,9,0,0,0,0,0,37
4,21,3,11,2,9,12,12,0,74
4,21,3,11,2,9,12,12,19,93
4,21,3,11,2,12,9,14,4,80
4,21,3,11,2,15,1,18,4,79
4,21,3,11,2,15,1,20,0,77
4,21,3,11,5,4,0,0,0,48
4,21,3,11,5,18,0,0,0,62
4,21,3,11,5,18,25,0,0,87
4,21,3,11,5,18,9,5,19,95
4,21,3,11,5,18,19,0,0,81
4,21,3,11,6,15,15,20,0,95
4,21,3,11,8,15,15,4,0,81
4,21,3,11,8,15,21,19,5,107
4,21,3,11,25,0,0,0,0,64
4,21,3,11,9,5,0,0,0,53
4,21,3,11,9,5,18,0,0,71
4,21,3,11,9,5,19,0,0,72
4,21,3,11,9,5,19,20,0,92
4,21,3,11,9,14,7,0,0,69
4,21,3,11,9,19,8,0,0,75
4,21,3,11,12,1,18,0,0,70
4,21,3,11,12,5,20,0,0,76
4,21,3,11,12,9,14,7,0,81
4,21,3,11,12,9,14,7,19,100
4,21,3,11,13,5,1,20,0,78
4,21,3,11,13,15,12,5,0,84
4,21,3,11,16,9,14,0,0,78
4,21,3,11,16,9,14,19,0,97
4,21,3,11,16,15,14,4,0,88
4,21,3,11,19,0,0,0,0,58
4,21,3,11,19,20,15,14,5,112
4,21,3,11,20,1,9,12,0,81
4,21,3,11,20,1,9,12,19,100
4,21,3,11,23,1,12,11,0,86
4,21,3,11,23,5,5,4,0,76
4,21,3,11,23,5,5,4,19,95
4,21,3,11,23,8,5,1,20,96
4,21,3,11,23,9,6,5,0,82
4,21,3,11,23,9,14,7,0,92
4,21,3,19,0,0,0,0,0,47
4,21,3,20,0,0,0,0,0,48
4,21,3,20,1,12,0,0,0,61
4,21,3,20,5,4,0,0,0,57
4,21,3,20,9,2,12,5,0,76
4,21,3,20,9,12,5,0,0,74
4,21,3,20,9,12,5,12,25,111
4,21,3,20,9,12,9,20,25,123
4,21,3,20,9,12,9,26,5,109
4,21,3,20,9,14,7,0,0,78
4,21,3,20,9,14,7,19,0,97
4,21,3,20,9,15,14,0,0,86
4,21,3,20,12,5,19,19,0,103
4,21,3,20,15,18,0,0,0,81
4,21,3,20,19,0,0,0,0,67
4,21,3,20,21,12,5,0,0,86
4,21,3,20,21,12,5,19,0,105
4,21,3,20,21,18,5,0,0,92
4,21,3,20,21,19,0,0,0,88
4,21,3,20,23,15,18,11,0,115
4,21,4,1,9,13,0,0,0,52
4,21,4,4,5,18,0,0,0,56
4,21,4,4,5,18,25,0,0,81
4,21,4,4,25,0,0,0,0,58
4,21,4,4,9,5,0,0,0,47
4,21,4,4,9,5,19,0,0,66
4,21,4,4,12,5,0,0,0,50
4,21,4,5,0,0,0,0,0,34
4,21,4,5,4,0,0,0,0,38
4,21,4,5,5,14,0,0,0,53
4,21,4,5,5,14,19,0,0,72
4,21,4,5,19,0,0,0,0,53
4,21,4,7,5,14,0,0,0,55
4,21,4,7,5,15,14,0,0,70
4,21,4,7,5,15,14,19,0,89
4,21,4,9,14,5,0,0,0,57
4,21,4,9,14,7,0,0,0,59
4,21,4,9,19,8,0,0,0,65
4,21,4,9,19,8,12,25,0,102
4,21,4,9,19,13,0,0,0,70
4,21,4,12,5,25,9,20,5,105
4,21,4,12,5,18,0,0,0,64
4,21,4,13,1,14,0,0,0,57
4,21,4,19,0,0,0,0,0,48
4,21,5,0,0,0,0,0,0,30
4,21,5,3,5,14,20,15,0,87
4,21,5,3,5,14,20,15,19,106
4,21,5,6,21,12,0,0,0,69
4,21,5,12,0,0,0,0,0,42
4,21,5,12,5,4,0,0,0,51
4,21,5,12,5,18,0,0,0,65
4,21,5,12,5,18,19,0,0,84
4,21,5,12,9,14,7,0,0,72
4,21,5,12,9,19,20,0,0,90
4,21,5,12,9,19,20,9,3,102
4,21,5,12,9,19,20,19,0,109
4,21,5,12,12,5,4,0,0,63
4,21,5,12,12,5,18,0,0,77
4,21,5,12,12,5,18,19,0,96
4,21,5,12,12,9,0,0,0,63
4,21,5,12,12,9,14,7,0,84
4,21,5,12,12,9,19,20,0,102
4,21,5,12,12,9,19,20,19,121
4,21,5,12,12,9,26,5,0,94
4,21,5,12,12,15,0,0,0,69
4,21,5,12,12,15,19,0,0,88
4,21,5,12,19,0,0,0,0,61
4,21,5,14,1,19,0,0,0,64
4,21,5,14,4,5,0,0,0,53
4,21,5,14,4,5,19,0,0,72
4,21,5,14,5,19,19,0,0,87
4,21,5,14,5,19,19,5,19,111
4,21,5,14,14,1,0,0,0,59
4,21,5,14,14,1,4,15,13,91
4,21,5,14,14,1,19,0,0,78
4,21,5,19,0,0,0,0,0,49
4,21,5,20,0,0,0,0,0,50
4,21,5,20,19,0,0,0,0,69
4,21,5,20,20,5,4,0,0,79
4,21,5,20,20,9,14,7,0,100
4,21,5,20,20,9,14,15,0,108
4,21,5,20,20,9,19,20,0,118
4,21,5,20,20,9,19,20,19,137
4,21,5,20,20,15,0,0,0,85
4,21,6,6,1,4,1,18,0,61
4,21,6,6,5,4,0,0,0,46
4,21,6,6,5,12,0,0,0,54
4,21,6,6,5,12,19,0,0,73
4,21,6,6,5,18,0,0,0,60
4,21,6,6,5,18,4,15,13,92
4,21,6,6,5,18,19,0,0,79
4,21,6,6,9,5,19,0,0,70
4,21,6,6,9,14,7,0,0,67
4,21,6,6,12,5,0,0,0,54
4,21,6,6,12,5,19,0,0,73
4,21,6,6,19,0,0,0,0,56
4,21,6,15,9,12,0,0,0,67
4,21,6,18,5,14,9,20,5,102
4,21,6,20,5,18,0,0,0,74
4,21,6,20,5,18,4,1,18,97
4,21,6,20,5,18,25,0,0,99
4,21,6,20,9,20,5,0,0,85
4,21,6,20,18,25,0,0,0,94
4,21,7,0,0,0,0,0,0,32
4,21,7,1,12,0,0,0,0,45
4,21,7,4,21,7,0,0,0,64
4,21,7,5,14,20,15,0,0,86
4,21,7,7,12,5,18,0,0,74
4,21,7,15,14,7,0,0,0,68
4,21,7,15,14,7,19,0,0,87
4,21,7,15,21,20,0,0,0,88
4,21,7,15,21,20,19,0,0,107
4,21,7,19,0,0,0,0,0,51
4,21,8,1,20,0,0,0,0,54
4,21,9,11,5,18,0,0,0,68
4,21,25,11,5,18,0,0,0,84
4,21,9,11,5,18,2,15,11,96
4,21,9,11,5,18,19,0,0,87
4,21,9,13,0,0,0,0,0,47
4,21,9,20,19,0,0,0,0,73
4,21,10,1,14,0,0,0,0,50
4,21,11,1,0,0,0,0,0,37
4,21,11,5,4,15,13,0,0,73
4,21,11,5,4,15,13,19,0,92
4,21,11,5,12,25,0,0,0,78
4,21,11,5,12,9,14,7,0,83
4,21,11,5,18,25,0,0,0,84
4,21,11,5,19,0,0,0,0,60
4,21,11,5,19,8,9,16,0,93
4,21,11,8,14,0,0,0,0,58
4,21,11,11,5,18,0,0,0,70
4,21,11,11,8,1,0,0,0,56
4,21,11,21,13,1,0,0,0,71
4,21,12,2,5,18,20,0,0,82
4,21,12,3,0,0,0,0,0,40
4,21,12,3,1,13,1,18,1,74
4,21,12,3,1,18,14,15,14,102
4,21,12,3,5,12,25,0,0,82
4,21,12,3,5,14,5,19,19,102
4,21,12,3,5,20,0,0,0,65
4,21,12,3,5,20,12,25,0,102
4,21,12,3,5,20,19,0,0,84
4,21,12,3,9,1,14,0,0,64
4,21,12,3,9,1,14,1,19,84
4,21,12,3,9,4,0,0,0,53
4,21,12,3,9,6,25,0,0,80
4,21,12,3,9,6,9,5,4,73
4,21,12,3,9,6,9,5,19,88
4,21,12,3,9,13,5,18,0,85
4,21,12,3,9,13,5,18,19,104
4,21,12,3,9,13,15,18,5,100
4,21,12,3,9,14,5,1,19,88
4,21,12,3,9,20,5,0,0,74
4,21,12,3,9,20,25,0,0,94
4,21,12,3,9,20,15,12,0,96
4,21,12,3,9,20,21,4,5,99
4,21,12,3,15,18,0,0,0,73
4,21,12,3,15,18,1,20,5,99
4,21,12,3,15,19,5,0,0,79
4,21,12,5,4,7,5,0,0,58
4,21,12,5,18,0,0,0,0,60
4,21,12,25,0,0,0,0,0,62
4,21,12,9,1,0,0,0,0,47
4,21,12,9,1,19,0,0,0,66
4,21,12,12,0,0,0,0,0,49
4,21,12,12,1,18,4,0,0,72
4,21,12,12,1,18,4,19,0,91
4,21,12,12,5,4,0,0,0,58
4,21,12,12,5,18,0,0,0,72
4,21,12,12,5,18,25,0,0,97
4,21,12,12,5,19,20,0,0,93
4,21,12,12,8,5,1,4,0,67
4,21,12,12,25,0,0,0,0,74
4,21,12,12,9,6,25,0,0,89
4,21,12,12,9,14,7,0,0,79
4,21,12,12,9,19,8,0,0,85
4,21,12,12,9,19,8,12,25,122
4,21,12,12,9,20,25,0,0,103
4,21,12,12,14,5,19,19,0,106
4,21,12,12,16,1,20,5,0,91
4,21,12,12,19,0,0,0,0,68
4,21,12,12,19,15,13,5,0,101
4,21,12,14,5,19,19,0,0,94
4,21,12,14,5,19,19,5,19,118
4,21,12,15,3,18,1,3,25,102
4,21,12,15,19,9,19,0,0,99
4,21,12,15,20,9,3,0,0,84
4,21,12,19,5,0,0,0,0,61
4,21,12,19,5,13,1,14,0,89
4,21,12,19,5,19,0,0,0,80
4,21,12,20,0,0,0,0,0,57
4,21,12,20,9,5,0,0,0,71
4,21,12,23,9,12,12,25,0,118
4,21,13,0,0,0,0,0,0,38
4,21,13,1,9,19,20,0,0,87
4,21,13,2,0,0,0,0,0,40
4,21,13,2,1,0,0,0,0,41
4,21,13,2,2,5,12,12,0,71
4,21,13,2,2,5,12,12,19,90
4,21,13,2,3,15,23,0,0,81
4,21,13,2,5,4,0,0,0,49
4,21,13,2,5,18,0,0,0,63
4,21,13,2,5,19,20,0,0,84
4,21,13,2,6,9,19,8,0,82
4,21,13,2,6,15,21,14,4,100
4,21,13,2,8,5,1,4,0,58
4,21,13,2,25,0,0,0,0,65
4,21,13,2,9,14,7,0,0,70
4,21,13,2,12,5,0,0,0,57
4,21,13,2,12,25,0,0,0,77
4,21,13,2,14,5,19,19,0,97
4,21,13,2,19,0,0,0,0,59
4,21,13,4,21,13,0,0,0,76
4,21,13,4,21,13,19,0,0,95
4,21,13,5,20,15,19,5,0,102
4,21,13,6,15,21,14,4,0,98
4,21,13,6,15,21,14,4,19,117
4,21,13,11,1,0,0,0,0,50
4,21,13,11,25,0,0,0,0,74
4,21,13,13,5,12,0,0,0,68
4,21,13,13,5,18,5,4,0,83
4,21,13,13,5,18,5,18,0,97
4,21,13,13,25,0,0,0,0,76
4,21,13,13,9,5,4,0,0,69
4,21,13,13,9,5,19,0,0,84
4,21,13,13,25,9,14,7,0,106
4,21,13,13,25,9,19,13,0,117
4,21,13,13,9,14,5,19,19,117
4,21,13,13,25,23,5,5,4,113
4,21,13,13,11,15,16,6,0,99
4,21,13,13,11,15,16,6,19,118
4,21,13,15,14,20,9,20,5,121
4,21,13,15,19,5,0,0,0,77
4,21,13,15,19,9,20,25,0,126
4,21,13,15,21,19,0,0,0,93
4,21,13,16,0,0,0,0,0,54
4,21,13,16,1,7,5,0,0,67
4,21,13,16,3,1,18,20,0,96
4,21,13,16,3,1,18,20,19,115
4,21,13,16,5,4,0,0,0,63
4,21,13,16,5,18,0,0,0,77
4,21,13,16,5,18,19,0,0,96
4,21,13,16,6,9,12,5,0,86
4,21,13,16,25,0,0,0,0,79
4,21,13,16,9,5,18,0,0,86
4,21,13,16,9,5,19,0,0,87
4,21,13,16,9,5,19,20,0,107
4,21,13,16,9,12,25,0,0,100
4,21,13,16,9,14,5,19,19,120
4,21,13,16,9,14,7,0,0,84
4,21,13,16,9,14,7,19,0,103
4,21,13,16,9,19,8,0,0,90
4,21,13,16,9,19,8,12,25,127
4,21,13,16,12,5,0,0,0,71
4,21,13,16,12,5,4,0,0,75
4,21,13,16,12,5,18,0,0,89
4,21,13,16,12,9,14,7,0,96
4,21,13,16,12,9,14,7,19,115
4,21,13,16,15,11,5,0,0,85
4,21,13,16,19,0,0,0,0,73
4,21,13,19,15,12,1,0,0,85
4,21,14,1,9,18,0,0,0,67
4,21,14,1,12,0,0,0,0,52
4,21,14,1,13,0,0,0,0,53
4,21,14,1,13,9,19,0,0,81
4,21,14,1,13,19,0,0,0,72
4,21,14,2,9,18,4,0,0,72
4,21,14,3,5,0,0,0,0,47
4,21,14,3,5,4,15,13,0,79
4,21,14,3,5,8,15,15,4,89
4,21,14,3,5,18,25,0,0,90
4,21,14,3,5,19,0,0,0,66
4,21,14,3,8,0,0,0,0,50
4,21,14,3,8,5,19,0,0,74
4,21,14,3,9,3,1,12,0,67
4,21,14,3,9,6,25,0,0,82
4,21,14,3,9,19,8,0,0,78
4,21,14,3,9,19,8,12,25,115
4,21,14,4,1,19,9,20,5,97
4,21,14,4,1,22,15,5,0,86
4,21,14,4,5,5,19,0,0,72
4,21,14,4,5,18,0,0,0,66
4,21,14,4,18,5,1,18,25,110
4,21,14,5,0,0,0,0,0,44
4,21,14,5,12,1,14,4,0,75
4,21,14,5,12,1,14,4,19,94
4,21,14,5,12,9,11,5,0,81
4,21,14,5,19,0,0,0,0,63
4,21,14,6,9,19,8,0,0,81
4,21,14,7,0,0,0,0,0,46
4,21,14,7,1,18,5,5,0,75
4,21,14,7,1,18,5,5,19,94
4,21,14,7,1,18,9,0,0,74
4,21,14,7,1,19,0,0,0,66
4,21,14,7,2,5,3,11,0,67
4,21,14,7,2,9,18,4,0,79
4,21,14,7,2,18,5,4,0,75
4,21,14,7,5,4,0,0,0,55
4,21,14,7,5,15,14,0,0,80
4,21,14,7,5,15,14,5,18,103
4,21,14,7,5,15,14,19,0,99
4,21,14,7,5,18,0,0,0,69
4,21,14,7,8,9,12,12,0,87
4,21,14,7,8,9,12,12,25,112
4,21,14,7,8,9,12,12,19,106
4,21,14,7,25,0,0,0,0,71
4,21,14,7,25,1,18,4,0,94
4,21,14,7,9,5,18,0,0,78
4,21,14,7,9,5,19,20,0,99
4,21,14,7,9,14,7,0,0,76
4,21,14,7,15,12,0,0,0,73
4,21,14,7,15,14,0,0,0,75
4,21,14,7,19,0,0,0,0,65
4,21,14,25,0,0,0,0,0,64
4,21,14,9,20,5,0,0,0,73
4,21,14,9,20,5,19,0,0,92
4,21,14,9,20,9,3,0,0,80
4,21,14,11,0,0,0,0,0,50
4,21,14,11,1,4,15,15,0,85
4,21,14,11,5,4,0,0,0,59
4,21,14,11,5,18,19,0,0,92
4,21,14,11,9,14,7,0,0,80
4,21,14,11,12,5,0,0,0,67
4,21,14,11,12,5,4,0,0,71
4,21,14,11,12,9,14,7,0,92
4,21,14,11,19,0,0,0,0,69
4,21,14,12,9,14,0,0,0,74
4,21,14,12,9,14,19,0,0,93
4,21,14,14,1,7,5,0,0,66
4,21,14,14,1,7,5,4,0,70
4,21,14,14,1,7,5,19,0,85
4,21,14,14,1,7,9,14,7,91
4,21,14,14,1,11,9,14,0,88
4,21,14,14,5,4,0,0,0,62
4,21,14,14,5,18,0,0,0,76
4,21,14,14,5,19,19,0,0,96
4,21,14,14,5,19,19,5,19,120
4,21,14,14,5,19,20,0,0,97
4,21,14,14,25,0,0,0,0,78
4,21,14,14,9,19,8,0,0,89
4,21,14,14,9,20,5,0,0,87
4,21,14,14,9,20,5,19,0,106
4,21,14,14,15,0,0,0,0,68
4,21,14,14,15,3,11,0,0,82
4,21,14,16,9,3,11,12,5,95
4,21,14,19,20,0,0,0,0,78
4,21,14,19,20,5,18,0,0,101
4,21,14,19,20,15,14,5,0,112
4,21,14,20,0,0,0,0,0,59
4,21,14,20,5,4,0,0,0,68
4,21,14,20,5,18,0,0,0,82
4,21,14,20,9,14,7,0,0,89
4,21,14,20,12,5,0,0,0,76
4,21,14,20,19,0,0,0,0,78
4,21,14,26,9,5,11,20,5,115
4,21,15,0,0,0,0,0,0,40
4,21,15,3,15,19,1,14,5,97
4,21,15,4,5,3,1,14,5,72
4,21,15,4,5,3,9,13,15,89
4,21,15,4,5,4,5,14,1,73
4,21,15,4,5,14,1,0,0,64
4,21,15,4,5,14,1,12,0,76
4,21,15,4,5,14,1,18,25,107
4,21,15,4,5,14,1,19,0,83
4,21,15,4,5,14,1,20,5,89
4,21,15,4,5,14,5,0,0,68
4,21,15,4,5,14,21,13,0,97
4,21,15,4,5,14,21,13,19,116
4,21,15,4,9,1,12,0,0,66
4,21,15,4,9,15,4,5,0,77
4,21,15,4,18,1,13,1,0,77
4,21,15,7,18,1,16,8,0,90
4,21,15,12,5,0,0,0,0,57
4,21,15,12,15,7,0,0,0,74
4,21,15,12,15,7,19,0,0,93
4,21,15,12,15,7,21,5,0,100
4,21,15,12,15,7,21,5,19,119
4,21,15,13,1,3,8,25,0,90
4,21,15,13,9,0,0,0,0,62
4,21,15,13,15,0,0,0,0,68
4,21,15,13,15,19,0,0,0,87
4,21,15,16,15,4,0,0,0,75
4,21,15,16,15,12,25,0,0,108
4,21,15,16,15,12,9,5,19,116
4,21,15,16,15,12,9,19,20,131
4,21,15,16,19,15,14,25,0,129
4,21,15,19,0,0,0,0,0,59
4,21,15,19,5,3,1,14,20,102
4,21,15,20,25,16,5,0,0,106
4,21,15,20,15,14,5,0,0,94
4,21,15,20,15,14,5,4,0,98
4,21,15,20,15,14,5,19,0,113
4,21,15,20,18,9,15,4,5,111
4,21,15,22,9,18,9,0,0,98
4,21,16,0,0,0,0,0,0,41
4,21,16,1,2,12,5,0,0,61
4,21,16,1,20,20,1,0,0,83
4,21,16,5,0,0,0,0,0,46
4,21,16,5,4,0,0,0,0,50
4,21,16,5,4,15,13,0,0,78
4,21,16,5,18,0,0,0,0,64
4,21,16,5,18,25,0,0,0,89
4,21,16,5,18,9,5,19,0,97
4,21,16,5,18,19,0,0,0,83
4,21,16,5,19,0,0,0,0,65
4,21,16,9,14,7,0,0,0,71
4,21,16,9,15,14,0,0,0,79
4,21,16,9,15,14,9,0,0,88
4,21,16,12,1,0,0,0,0,54
4,21,16,12,1,20,9,15,14,112
4,21,16,12,5,0,0,0,0,58
4,21,16,12,5,20,0,0,0,78
4,21,16,12,5,24,0,0,0,82
4,21,16,12,5,24,5,4,0,91
4,21,16,12,5,24,5,18,0,105
4,21,16,12,5,24,5,18,19,124
4,21,16,12,5,24,5,19,0,106
4,21,16,12,5,24,9,14,7,112
4,21,16,12,5,24,9,20,25,136
4,21,16,12,5,24,19,0,0,101
4,21,16,12,25,0,0,0,0,78
4,21,16,12,9,3,1,14,4,84
4,21,16,12,9,3,1,20,5,91
4,21,16,12,9,3,9,1,0,75
4,21,16,12,9,3,9,20,25,119
4,21,16,12,9,6,25,0,0,93
4,21,16,12,9,6,9,5,4,86
4,21,16,12,15,14,0,0,0,82
4,21,16,12,15,14,5,0,0,87
4,21,16,15,14,4,9,9,0,92
4,21,16,15,14,4,9,21,19,123
4,21,16,16,1,0,0,0,0,58
4,21,16,16,5,4,0,0,0,66
4,21,16,16,5,18,0,0,0,80
4,21,16,16,25,0,0,0,0,82
4,21,16,16,9,5,19,0,0,90
4,21,16,16,9,14,7,0,0,87
4,21,16,19,0,0,0,0,0,60
4,21,18,1,0,0,0,0,0,44
4,21,18,1,2,12,5,0,0,63
4,21,18,1,2,12,5,19,0,82
4,21,18,1,2,12,25,0,0,83
4,21,18,1,3,9,14,5,0,75
4,21,18,1,9,14,0,0,0,67
4,21,18,1,12,0,0,0,0,56
4,21,18,1,13,1,20,5,18,101
4,21,18,1,13,5,14,0,0,76
4,21,18,1,13,5,14,19,0,95
4,21,18,1,14,3,5,19,0,85
4,21,18,1,14,7,9,20,5,99
4,21,18,1,17,21,1,18,1,102
4,21,18,1,19,0,0,0,0,63
4,21,18,1,20,9,15,14,0,102
4,21,18,1,20,9,15,14,19,121
4,21,18,1,20,9,22,5,0,100
4,21,18,1,20,9,22,5,19,119
4,21,18,1,24,0,0,0,0,68
4,21,18,2,1,18,0,0,0,64
4,21,18,2,1,18,19,0,0,83
4,21,18,4,5,14,9,20,5,100
4,21,18,4,21,13,0,0,0,81
4,21,18,5,0,0,0,0,0,48
4,21,18,5,4,0,0,0,0,52
4,21,18,5,5,0,0,0,0,53
4,21,18,5,6,21,12,0,0,87
4,21,18,5,14,15,12,0,0,89
4,21,18,5,19,0,0,0,0,67
4,21,18,5,19,19,0,0,0,86
4,21,18,5,19,19,5,19,0,110
4,21,18,5,19,19,15,18,0,119
4,21,18,5,20,0,0,0,0,68
4,21,18,5,20,20,15,0,0,103
4,21,18,5,26,26,1,0,0,101
4,21,18,7,1,8,0,0,0,59
4,21,18,7,1,14,0,0,0,65
4,21,18,7,5,14,0,0,0,69
4,21,18,9,1,14,0,0,0,67
4,21,18,9,1,14,19,0,0,86
4,21,18,9,3,18,21,19,20,133
4,21,18,9,4,9,14,5,0,84
4,21,18,25,12,0,0,0,0,80
4,21,18,9,14,7,0,0,0,73
4,21,18,9,14,7,12,25,0,110
4,21,18,9,15,14,0,0,0,81
4,21,18,9,15,14,19,0,0,100
4,21,18,9,20,25,0,0,0,97
4,21,18,13,1,19,20,0,0,96
4,21,18,13,1,19,20,19,0,115
4,21,18,14,0,0,0,0,0,57
4,21,18,14,4,5,19,20,0,105
4,21,18,14,5,4,0,0,0,66
4,21,18,14,5,4,5,18,0,89
4,21,18,14,5,4,5,19,20,110
4,21,18,14,19,0,0,0,0,76
4,21,18,15,0,0,0,0,0,58
4,21,18,15,3,19,0,0,0,80
4,21,18,15,25,0,0,0,0,83
4,21,18,15,13,5,20,5,18,119
4,21,18,15,19,0,0,0,0,77
4,21,18,15,21,19,0,0,0,98
4,21,18,18,1,0,0,0,0,62
4,21,18,18,1,19,0,0,0,81
4,21,18,18,25,0,0,0,0,86
4,21,18,18,9,5,0,0,0,75
4,21,18,18,9,5,19,0,0,94
4,21,18,18,9,14,0,0,0,84
4,21,18,18,19,0,0,0,0,80
4,21,18,21,11,21,12,9,0,117
4,21,18,21,13,0,0,0,0,77
4,21,18,21,13,19,0,0,0,96
4,21,18,23,1,14,0,0,0,81
4,21,18,23,1,21,14,0,0,102
4,21,18,26,5,5,0,0,0,79
4,21,18,26,9,0,0,0,0,78
4,21,19,1,3,11,0,0,0,59
4,21,19,3,12,5,0,0,0,64
4,21,19,5,14,23,9,14,4,113
4,21,19,8,0,0,0,0,0,52
4,21,19,9,15,0,0,0,0,68
4,21,19,11,0,0,0,0,0,55
4,21,19,11,5,4,0,0,0,64
4,21,19,11,5,14,0,0,0,74
4,21,19,11,25,0,0,0,0,80
4,21,19,11,9,5,18,0,0,87
4,21,19,11,9,5,19,20,0,108
4,21,19,11,9,12,25,0,0,101
4,21,19,11,9,14,5,19,19,121
4,21,19,11,9,14,7,0,0,85
4,21,19,11,9,19,8,0,0,91
4,21,19,11,9,19,8,12,25,128
4,21,19,11,12,25,0,0,0,92
4,21,19,11,14,5,19,19,0,112
4,21,19,11,19,0,0,0,0,74
4,21,19,20,2,1,14,4,0,85
4,21,19,20,2,9,14,0,0,89
4,21,19,20,2,9,14,19,0,108
4,21,19,20,2,12,21,0,0,99
4,21,19,20,2,15,24,0,0,105
4,21,19,20,3,1,18,20,0,106
4,21,19,20,3,12,15,20,8,122
4,21,19,20,3,15,1,20,0,103
4,21,19,20,3,15,22,5,18,127
4,21,19,20,5,4,0,0,0,73
4,21,19,20,5,5,0,0,0,74
4,21,19,20,5,18,13,1,14,115
4,21,19,20,5,18,13,5,14,119
4,21,19,20,5,18,19,0,0,106
4,21,19,20,6,1,12,12,0,95
4,21,19,20,8,5,1,16,0,94
4,21,19,20,8,5,1,16,19,113
4,21,19,20,9,5,18,0,0,96
4,21,19,20,9,5,19,20,0,117
4,21,19,20,25,6,15,15,20,145
4,21,19,20,9,12,25,0,0,110
4,21,19,20,9,14,5,19,19,130
4,21,19,20,9,14,7,0,0,94
4,21,19,20,12,5,19,19,0,119
4,21,19,20,12,9,11,5,0,101
4,21,19,20,13,5,14,0,0,96
4,21,19,20,15,6,6,0,0,91
4,21,19,20,15,6,6,19,0,110
4,21,19,20,15,15,18,0,0,112
4,21,19,20,15,15,18,9,0,121
4,21,19,20,15,21,18,0,0,118
4,21,19,20,16,1,14,0,0,95
4,21,19,20,16,1,14,19,0,114
4,21,19,20,16,15,9,14,20,138
4,21,19,20,16,18,15,15,6,134
4,21,19,20,18,1,7,0,0,90
4,21,19,20,18,1,7,19,0,109
4,21,19,20,19,0,0,0,0,83
4,21,19,20,19,8,5,5,20,121
4,21,19,20,19,20,15,18,13,149
4,21,19,20,20,9,7,8,20,128
4,21,19,20,21,3,11,0,0,99
4,21,19,20,21,11,0,0,0,96
4,21,19,20,21,16,0,0,0,101
4,21,19,20,21,16,19,0,0,120
4,21,19,20,23,15,13,1,14,130
4,21,20,3,8,5,4,0,0,65
4,21,20,3,8,5,19,19,0,99
4,21,20,3,8,9,14,7,0,86
4,21,20,5,15,21,19,0,0,105
4,21,20,5,15,21,19,12,25,142
4,21,20,25,0,0,0,0,0,70
4,21,20,9,1,2,12,5,0,74
4,21,20,9,5,4,0,0,0,63
4,21,20,9,5,19,0,0,0,78
4,21,20,9,6,21,12,0,0,93
4,21,20,9,6,21,12,12,25,130
4,21,20,18,1,0,0,0,0,64
4,21,20,21,2,21,18,9,0,116
4,21,21,13,22,9,18,0,0,108
4,21,21,13,22,9,18,1,12,121
4,21,21,13,22,9,18,9,0,117
4,21,21,13,22,9,18,19,0,127
4,21,22,5,20,0,0,0,0,72
4,21,22,5,20,25,14,0,0,111
4,21,22,5,20,9,14,5,0,100
4,21,22,5,20,25,14,5,0,116
4,21,22,5,20,9,14,5,19,119
4,21,22,5,20,25,14,5,19,135
4,21,22,5,20,25,14,19,0,130
4,21,22,5,20,19,0,0,0,91
4,21,24,0,0,0,0,0,0,49
4,21,24,5,12,12,5,19,0,102
4,21,24,5,19,0,0,0,0,73
4,22,9,7,21,0,0,0,0,63
4,22,15,18,14,9,11,0,0,93
4,23,5,5,2,12,5,0,0,56
4,23,5,12,12,0,0,0,0,56
4,23,5,12,12,5,4,0,0,65
4,23,5,12,12,5,18,0,0,79
4,23,5,12,12,5,18,19,0,98
4,23,5,12,12,9,14,7,0,86
4,23,5,12,12,9,14,7,19,105
4,23,5,12,12,19,0,0,0,75
4,23,5,12,20,0,0,0,0,64
4,23,9,14,4,12,5,0,0,71
4,23,9,14,4,12,5,4,0,75
4,23,9,14,4,12,5,19,0,90
4,23,9,14,4,12,9,14,7,96
4,23,9,14,5,0,0,0,0,55
4,23,9,14,5,4,0,0,0,59
4,23,9,14,5,19,0,0,0,74
4,23,9,14,9,14,7,0,0,80
4,23,20,0,0,0,0,0,0,47
4,26,5,18,5,14,0,0,0,72
4,26,5,18,9,14,0,0,0,76
4,26,5,18,15,14,0,0,0,82
4,26,9,7,7,5,20,1,9,88
4,26,15,0,0,0,0,0,0,45
5,2,2,0,0,0,0,0,0,9
5,2,2,5,4,0,0,0,0,18
5,2,2,5,20,0,0,0,0,34
5,2,2,5,20,19,0,0,0,53
5,2,2,9,14,7,0,0,0,39
5,2,2,13,1,14,0,0,0,37
5,2,2,19,0,0,0,0,0,28
5,2,3,1,19,3,0,0,0,33
5,2,3,4,0,0,0,0,0,14
5,2,4,15,13,1,4,5,0,49
5,2,5,14,5,15,21,19,0,86
5,2,15,14,0,0,0,0,0,36
5,2,15,14,9,5,19,0,0,69
5,2,15,14,9,7,5,0,0,57
5,2,15,14,9,19,5,0,0,69
5,2,15,14,9,19,5,4,0,73
5,2,15,14,9,19,5,19,0,88
5,2,15,14,9,19,9,14,7,94
5,2,15,14,9,19,20,0,0,84
5,2,15,14,9,20,5,0,0,70
5,2,15,14,9,20,5,19,0,89
5,2,15,14,9,26,5,0,0,76
5,2,15,14,9,26,5,4,0,80
5,2,15,14,9,26,5,19,0,95
5,2,15,14,9,26,9,14,7,101
5,2,15,14,19,0,0,0,0,55
5,2,18,1,9,3,11,0,0,49
5,2,18,9,1,20,5,0,0,60
5,2,18,9,1,20,5,4,0,64
5,2,18,9,3,20,25,0,0,82
5,2,18,9,5,20,25,0,0,84
5,2,18,9,12,12,1,4,5,68
5,2,18,9,15,19,5,0,0,73
5,2,18,9,15,19,9,20,25,122
5,2,18,9,15,21,19,0,0,89
5,2,18,9,15,21,19,12,25,126
5,2,21,12,12,1,20,5,0,78
5,2,21,12,12,9,1,20,5,87
5,2,21,12,12,9,5,14,20,100
5,2,21,12,21,19,0,0,0,80
5,2,21,18,1,20,5,4,0,76
5,2,21,18,9,14,0,0,0,69
5,2,21,18,9,14,5,0,0,74
5,2,21,18,14,1,20,5,4,90
5,2,21,18,14,5,1,14,0,80
5,2,21,18,14,5,15,9,4,93
5,2,21,18,14,5,15,21,19,120
5,2,21,18,14,9,1,14,0,84
5,3,2,0,0,0,0,0,0,10
5,3,2,1,19,9,19,0,0,58
5,3,2,1,20,9,3,0,0,43
5,3,2,15,12,5,0,0,0,42
5,3,2,15,12,9,3,0,0,49
5,3,2,15,12,9,3,19,0,68
5,3,3,5,0,0,0,0,0,16
5,3,3,5,14,20,18,9,3,80
5,3,3,8,0,0,0,0,0,19
5,3,3,8,25,13,15,13,1,86
5,3,3,8,25,13,15,19,5,96
5,3,3,25,3,12,5,13,1,70
5,3,3,25,5,19,9,19,0,88
5,3,3,12,5,19,9,1,0,57
5,3,3,12,5,19,9,1,5,62
5,3,3,12,5,19,9,1,12,69
5,3,3,18,9,14,5,0,0,57
5,3,3,18,9,19,9,19,0,85
5,3,3,18,9,20,9,3,0,70
5,3,4,5,13,9,3,0,0,42
5,3,4,5,13,9,20,5,0,64
5,3,4,5,18,15,14,0,0,64
5,3,4,5,18,15,14,9,3,76
5,3,4,25,19,5,19,0,0,80
5,3,4,25,19,9,1,12,0,78
5,3,4,25,19,9,1,19,20,105
5,3,4,25,19,9,19,0,0,84
5,3,4,25,19,15,14,0,0,85
5,3,4,25,19,15,14,5,0,90
5,3,4,25,19,15,14,5,19,109
5,3,4,25,19,15,14,19,0,104
5,3,5,19,9,3,0,0,0,44
5,3,5,19,9,19,0,0,0,60
5,3,5,19,9,19,5,19,0,84
5,3,7,15,14,9,14,0,0,67
5,3,7,15,14,9,14,5,0,72
5,3,8,1,16,16,5,0,0,54
5,3,8,1,16,16,5,5,0,59
5,3,8,1,18,0,0,0,0,35
5,3,8,1,18,4,0,0,0,39
5,3,8,1,18,4,19,0,0,58
5,3,8,5,0,0,0,0,0,21
5,3,8,5,1,0,0,0,0,22
5,3,8,5,4,0,0,0,0,25
5,3,8,5,12,5,20,20,5,83
5,3,8,5,12,12,5,0,0,50
5,3,8,5,12,15,14,0,0,62
5,3,8,5,12,15,14,5,4,71
5,3,8,5,12,15,14,19,0,81
5,3,8,5,14,5,9,4,0,53
5,3,8,5,19,0,0,0,0,40
5,3,8,5,22,1,18,9,1,72
5,3,8,5,22,9,14,0,0,66
5,3,8,9,4,14,1,5,0,49
5,3,8,9,4,14,1,19,0,63
5,3,8,9,14,1,12,0,0,52
5,3,8,9,14,1,20,5,0,65
5,3,8,9,14,1,20,5,4,69
5,3,8,9,14,7,0,0,0,46
5,3,8,9,14,9,0,0,0,48
5,3,8,9,14,9,4,0,0,52
5,3,8,9,14,9,4,1,14,67
5,3,8,9,14,9,20,1,12,81
5,3,8,9,14,9,20,5,0,73
5,3,8,9,14,15,9,4,0,67
5,3,8,9,14,15,9,4,19,86
5,3,8,9,14,21,19,0,0,79
5,3,8,9,21,18,9,4,0,77
5,3,8,9,21,18,15,9,4,92
5,3,8,14,9,4,1,0,0,44
5,3,8,15,5,4,0,0,0,40
5,3,8,15,5,25,0,0,0,61
5,3,8,15,5,18,0,0,0,54
5,3,8,15,5,18,19,0,0,73
5,3,8,15,5,19,0,0,0,55
5,3,8,15,7,18,1,13,0,70
5,3,8,15,7,18,1,16,8,81
5,3,8,15,9,3,0,0,0,43
5,3,8,15,9,14,7,0,0,61
5,3,8,15,9,14,7,12,25,98
5,3,8,15,9,19,13,0,0,72
5,3,8,15,9,19,13,19,0,91
5,3,8,15,9,19,20,0,0,79
5,3,8,15,9,26,5,0,0,71
5,3,8,15,9,26,5,4,0,75
5,3,8,15,9,26,9,14,7,96
5,3,8,15,12,1,12,9,1,66
5,3,8,15,12,1,12,9,3,68
5,3,8,15,12,5,19,19,0,86
5,3,8,15,13,5,20,5,18,92
5,3,8,15,19,0,0,0,0,50
5,3,8,15,22,9,18,21,19,120
5,3,8,15,23,9,19,5,0,87
5,3,8,20,0,0,0,0,0,36
5,3,9,12,9,1,20,5,0,64
5,3,9,26,5,0,0,0,0,48
5,3,11,12,5,9,14,0,0,59
5,3,12,1,9,18,0,0,0,48
5,3,12,1,9,18,19,0,0,67
5,3,12,1,13,16,19,9,1,79
5,3,12,1,13,16,20,9,3,82
5,3,12,1,20,0,0,0,0,41
5,3,12,1,20,5,4,0,0,50
5,3,12,1,20,9,14,7,0,71
5,3,12,1,20,19,0,0,0,60
5,3,12,5,3,20,9,3,0,60
5,3,12,5,3,20,9,19,13,89
5,3,12,5,3,20,9,19,20,96
5,3,12,5,7,13,0,0,0,45
5,3,12,5,7,13,1,0,0,46
5,3,12,5,7,13,5,0,0,50
5,3,12,9,16,19,5,0,0,69
5,3,12,9,16,19,5,4,0,73
5,3,12,9,16,19,5,18,0,87
5,3,12,9,16,19,5,19,0,88
5,3,12,9,16,19,9,14,7,94
5,3,12,9,16,19,9,19,0,92
5,3,12,9,16,20,9,3,0,77
5,3,12,9,16,20,9,3,19,96
5,3,12,15,7,9,3,0,0,54
5,3,12,15,7,9,20,5,0,76
5,3,12,15,7,9,20,5,19,95
5,3,12,15,7,21,5,0,0,68
5,3,12,15,19,9,15,14,0,92
5,3,12,15,19,9,15,14,19,111
5,3,13,14,5,19,9,1,0,69
5,3,15,3,9,4,1,12,0,52
5,3,15,3,9,4,5,0,0,44
5,3,15,3,9,4,5,19,0,63
5,3,15,4,0,0,0,0,0,27
5,3,15,4,5,13,5,0,0,50
5,3,15,6,18,5,1,11,0,64
5,3,15,9,4,0,0,0,0,36
5,3,15,12,0,0,0,0,0,35
5,3,15,12,5,19,0,0,0,59
5,3,15,12,15,7,25,0,0,82
5,3,15,12,15,7,9,3,0,69
5,3,15,12,15,7,9,5,19,90
5,3,15,12,15,7,9,19,20,105
5,3,15,13,15,13,9,19,20,112
5,3,15,14,0,0,0,0,0,37
5,3,15,14,15,13,5,19,5,94
5,3,15,14,15,13,9,3,0,77
5,3,15,14,15,13,9,3,19,96
5,3,15,14,15,13,9,5,19,98
5,3,15,14,15,13,9,19,5,98
5,3,15,14,15,13,9,19,13,106
5,3,15,14,15,13,9,19,20,113
5,3,15,14,15,13,9,26,5,105
5,3,15,16,8,5,14,5,0,71
5,3,15,16,8,15,2,9,1,74
5,3,15,18,3,8,0,0,0,52
5,3,15,18,3,8,5,0,0,57
5,3,15,19,25,19,20,5,13,124
5,3,15,19,16,8,5,18,5,94
5,3,15,19,19,1,9,19,5,95
5,3,15,19,20,1,20,5,0,88
5,3,15,20,25,16,5,0,0,89
5,3,15,20,25,16,5,19,0,108
5,3,15,20,25,16,9,3,0,96
5,3,15,20,15,14,1,12,0,85
5,3,15,20,15,14,5,0,0,77
5,3,15,20,15,14,5,19,0,96
5,3,15,20,15,16,9,3,0,86
5,3,15,21,20,5,0,0,0,69
5,3,16,8,1,19,9,19,0,80
5,3,16,8,15,14,5,13,1,80
5,3,16,8,15,18,5,0,0,70
5,3,16,8,15,18,25,0,0,90
5,3,16,8,15,18,9,1,0,75
5,3,16,8,15,18,9,1,5,80
5,3,16,8,15,18,9,1,19,94
5,3,16,8,15,18,9,26,5,105
5,3,16,8,15,22,1,0,0,70
5,3,16,8,18,1,19,9,19,98
5,3,18,1,19,5,0,0,0,51
5,3,18,1,19,5,21,18,0,90
5,3,18,1,19,5,21,18,19,109
5,3,18,1,19,9,20,5,0,80
5,3,18,5,22,9,19,19,5,105
5,3,18,21,19,0,0,0,0,66
5,3,19,20,1,19,25,0,0,92
5,3,19,20,1,19,9,5,19,100
5,3,19,20,1,19,9,19,0,95
5,3,19,20,1,19,9,26,5,107
5,3,19,20,1,20,9,3,0,80
5,3,19,20,1,20,9,3,1,81
5,3,19,20,1,20,9,3,19,99
5,3,19,20,18,15,16,8,25,129
5,3,20,1,4,0,0,0,0,33
5,3,20,1,4,5,14,9,1,62
5,3,20,1,12,0,0,0,0,41
5,3,20,1,12,12,25,0,0,78
5,3,20,1,19,5,19,0,0,72
5,3,20,1,19,9,1,0,0,58
5,3,20,1,19,9,19,0,0,76
5,3,20,1,20,9,3,0,0,61
5,3,20,5,14,5,0,0,0,52
5,3,20,5,14,20,1,12,0,80
5,3,20,5,18,15,14,0,0,80
5,3,20,8,25,13,1,0,0,75
5,3,20,8,25,13,1,20,1,96
5,3,20,25,16,1,12,0,0,82
5,3,20,25,16,5,0,0,0,74
5,3,20,25,16,5,19,0,0,93
5,3,20,9,18,9,19,0,0,83
5,3,20,15,2,1,20,9,3,78
5,3,20,15,2,12,1,19,20,97
5,3,20,15,3,5,12,9,3,75
5,3,20,15,3,25,19,20,0,110
5,3,20,15,3,18,9,14,5,92
5,3,20,15,4,5,18,13,0,83
5,3,20,15,4,5,18,13,19,102
5,3,20,15,5,14,20,1,4,87
5,3,20,15,5,14,26,25,13,126
5,3,20,15,7,5,14,9,3,81
5,3,20,15,7,12,9,1,0,72
5,3,20,15,12,15,16,8,0,94
5,3,20,15,13,5,18,5,0,84
5,3,20,15,13,5,18,5,19,103
5,3,20,15,13,5,18,9,3,91
5,3,20,15,13,25,0,0,0,81
5,3,20,15,13,15,18,16,8,113
5,3,20,15,16,8,25,20,5,117
5,3,20,15,16,25,0,0,0,84
5,3,20,15,16,9,1,0,0,69
5,3,20,15,16,9,1,19,0,88
5,3,20,15,16,9,3,0,0,71
5,3,20,15,16,12,1,19,25,116
5,3,20,15,16,12,1,19,13,104
5,3,20,15,16,18,15,3,20,115
5,3,20,15,19,1,18,3,0,84
5,3,20,15,19,1,18,3,19,103
5,3,20,15,19,15,13,1,12,103
5,3,20,15,19,15,13,5,0,95
5,3,20,15,19,20,5,1,12,100
5,3,20,15,20,8,5,3,1,80
5,3,20,15,20,8,5,18,13,107
5,3,20,15,20,15,24,9,14,125
5,3,20,15,26,15,1,0,0,85
5,3,20,15,26,15,1,14,0,99
5,3,20,15,26,15,1,14,19,118
5,3,20,15,26,15,9,3,0,96
5,3,20,15,26,15,15,14,0,113
5,3,20,18,15,7,5,14,25,112
5,3,20,18,15,16,9,15,14,115
5,3,20,18,15,16,9,21,13,120
5,3,20,18,15,20,9,3,0,93
5,3,20,20,25,16,1,12,0,102
5,3,21,5,12,12,5,0,0,63
5,3,21,5,12,12,9,14,7,88
5,3,21,13,5,14,1,3,25,90
5,3,21,13,5,14,5,0,0,66
5,3,21,13,5,14,9,3,0,73
5,3,21,13,5,14,9,3,19,92
5,3,21,13,5,14,9,19,13,102
5,3,21,13,5,14,9,19,20,109
5,3,21,18,9,5,0,0,0,61
5,3,21,19,0,0,0,0,0,48
5,3,26,5,13,1,0,0,0,53
5,3,26,5,13,1,19,0,0,72
5,4,4,5,18,0,0,0,0,36
5,4,4,9,5,4,0,0,0,31
5,4,4,9,5,19,0,0,0,46
5,4,4,25,9,14,7,0,0,68
5,4,4,25,18,15,15,20,0,106
5,4,4,9,19,8,0,0,0,49
5,4,4,15,0,0,0,0,0,28
5,4,4,15,5,19,0,0,0,52
5,4,5,1,7,18,1,0,0,41
5,4,5,9,20,9,19,0,0,71
5,4,5,12,23,5,9,19,19,101
5,4,5,13,1,0,0,0,0,28
5,4,5,13,1,19,0,0,0,47
5,4,5,13,1,20,1,0,0,49
5,4,5,13,1,20,15,19,5,87
5,4,5,13,1,20,15,21,19,103
5,4,5,13,9,3,0,0,0,39
5,4,5,14,9,20,5,0,0,62
5,4,5,14,20,1,12,0,0,61
5,4,5,14,20,1,20,5,0,74
5,4,5,14,20,1,20,5,19,93
5,4,5,15,4,25,14,9,1,82
5,4,5,15,12,15,7,25,0,88
5,4,5,15,13,1,14,9,1,67
5,4,5,15,19,3,15,16,25,107
5,4,5,15,20,15,13,25,0,102
5,4,5,19,20,1,14,0,0,68
5,4,5,19,20,9,14,0,0,76
5,4,7,5,2,15,14,5,0,57
5,4,7,5,2,15,14,5,4,61
5,4,7,5,4,0,0,0,0,25
5,4,7,5,12,5,19,19,0,76
5,4,7,5,12,9,14,7,0,63
5,4,7,5,13,1,11,5,18,69
5,4,7,5,13,1,14,0,0,49
5,4,7,5,18,0,0,0,0,39
5,4,7,5,18,13,1,14,0,67
5,4,7,5,18,19,0,0,0,58
5,4,7,5,19,0,0,0,0,40
5,4,7,5,19,8,15,20,0,83
5,4,7,5,19,20,15,14,5,94
5,4,7,5,23,1,25,0,0,70
5,4,7,5,23,1,25,19,0,89
5,4,7,5,23,5,5,4,0,58
5,4,7,5,23,9,19,5,0,77
5,4,7,25,0,0,0,0,0,41
5,4,7,9,5,18,0,0,0,48
5,4,7,9,5,19,20,0,0,69
5,4,7,9,12,25,0,0,0,62
5,4,7,9,14,5,19,19,0,82
5,4,7,9,14,7,0,0,0,46
5,4,7,9,14,7,12,25,0,83
5,4,7,9,14,7,19,0,0,65
5,4,7,18,5,23,0,0,0,62
5,4,7,18,15,23,0,0,0,72
5,4,8,0,0,0,0,0,0,17
5,4,8,19,0,0,0,0,0,36
5,4,9,2,9,12,5,0,0,46
5,4,9,2,9,12,9,20,25,95
5,4,9,2,12,5,0,0,0,37
5,4,9,2,12,5,19,0,0,56
5,4,9,3,20,0,0,0,0,41
5,4,9,3,20,1,12,0,0,54
5,4,9,3,20,1,12,12,25,91
5,4,9,3,20,19,0,0,0,60
5,4,9,3,20,21,13,0,0,75
5,4,9,3,21,12,5,0,0,59
5,4,9,6,1,3,5,0,0,33
5,4,9,6,25,0,0,0,0,49
5,4,9,6,9,3,1,14,20,71
5,4,9,6,9,3,1,20,5,62
5,4,9,6,9,3,5,0,0,41
5,4,9,6,9,3,5,4,0,45
5,4,9,6,9,3,5,19,0,60
5,4,9,6,9,3,9,1,12,58
5,4,9,6,9,3,9,14,7,66
5,4,9,6,9,5,4,0,0,42
5,4,9,6,9,5,18,0,0,56
5,4,9,6,9,5,18,19,0,75
5,4,9,6,9,5,19,0,0,57
5,4,9,6,25,9,14,7,0,79
5,4,9,12,5,0,0,0,0,35
5,4,9,12,5,19,0,0,0,54
5,4,9,12,9,20,25,0,0,84
5,4,9,20,0,0,0,0,0,38
5,4,9,20,1,2,12,5,0,58
5,4,9,20,1,12,0,0,0,51
5,4,9,20,3,8,1,18,0,68
5,4,9,20,5,4,0,0,0,47
5,4,9,20,9,14,7,0,0,68
5,4,9,20,9,15,14,0,0,76
5,4,9,20,9,15,14,19,0,95
5,4,9,20,15,18,0,0,0,71
5,4,9,20,15,18,9,1,12,93
5,4,9,20,15,18,19,0,0,90
5,4,9,20,18,5,19,19,0,99
5,4,9,20,19,0,0,0,0,57
5,4,9,20,21,1,20,5,0,85
5,4,16,12,15,20,0,0,0,72
5,4,21,3,0,0,0,0,0,33
5,4,21,3,1,2,12,5,0,53
5,4,21,3,1,2,12,5,19,72
5,4,21,3,1,14,4,0,0,52
5,4,21,3,1,20,5,0,0,59
5,4,21,3,1,20,5,4,0,63
5,4,21,3,1,20,5,5,0,64
5,4,21,3,1,20,5,19,0,78
5,4,21,3,1,20,9,14,7,84
5,4,21,3,1,20,9,22,5,90
5,4,21,3,1,20,15,18,0,87
5,4,21,3,1,20,15,18,25,112
5,4,21,3,1,20,15,18,19,106
5,4,21,3,5,0,0,0,0,38
5,4,21,3,5,4,0,0,0,42
5,4,21,3,5,13,5,14,20,90
5,4,21,3,5,19,0,0,0,57
5,4,21,3,9,2,12,5,0,61
5,4,21,3,9,14,7,0,0,63
5,4,21,3,9,22,5,0,0,69
5,4,21,3,20,0,0,0,0,53
5,4,21,3,20,9,15,14,0,91
5,4,21,3,20,9,15,14,19,110
5,4,21,3,20,9,22,5,0,89
5,4,21,3,20,15,18,0,0,86
5,4,21,3,20,15,18,19,0,105
5,4,21,3,20,19,0,0,0,72
5,5,2,18,5,5,0,0,0,40
5,5,7,18,1,19,19,0,0,74
5,5,25,21,3,8,0,0,0,67
5,5,25,21,3,11,0,0,0,70
5,5,12,2,1,3,11,0,0,39
5,5,12,2,12,5,14,14,25,94
5,5,12,2,15,1,20,0,0,60
5,5,12,2,15,2,0,0,0,41
5,5,12,2,15,2,2,5,18,66
5,5,12,3,1,11,5,0,0,42
5,5,12,5,18,0,0,0,0,45
5,5,12,5,18,25,0,0,0,70
5,5,12,6,1,18,5,0,0,52
5,5,12,6,9,19,8,0,0,64
5,5,12,7,18,1,19,19,0,86
5,5,12,25,0,0,0,0,0,47
5,5,12,9,5,18,0,0,0,54
5,5,12,9,5,19,20,0,0,75
5,5,12,9,14,7,0,0,0,52
5,5,12,12,9,11,5,0,0,59
5,5,12,16,15,20,0,0,0,73
5,5,12,16,15,21,20,0,0,94
5,5,12,16,15,21,20,19,0,113
5,5,12,19,0,0,0,0,0,41
5,5,12,19,8,15,16,0,0,80
5,5,12,19,11,9,14,0,0,75
5,5,12,19,16,5,1,18,0,81
5,5,12,23,1,18,5,0,0,69
5,5,12,23,15,18,13,0,0,91
5,5,12,23,15,18,13,19,0,110
5,5,13,9,19,0,0,0,0,51
5,5,14,0,0,0,0,0,0,24
5,5,18,0,0,0,0,0,0,28
5,5,18,25,0,0,0,0,0,53
5,5,18,9,5,0,0,0,0,42
5,5,18,9,5,18,0,0,0,60
5,5,18,9,5,19,20,0,0,81
5,5,18,9,12,25,0,0,0,74
5,5,18,9,14,5,19,19,0,94
5,5,18,9,19,15,13,5,0,89
5,5,18,15,3,11,0,0,0,57
5,5,19,15,13,5,0,0,0,62
5,5,20,5,14,0,0,0,0,49
5,6,5,3,11,19,0,0,0,49
5,6,6,0,0,0,0,0,0,17
5,6,6,1,2,12,5,0,0,37
5,6,6,1,3,5,0,0,0,26
5,6,6,1,3,5,4,0,0,30
5,6,6,1,3,5,18,0,0,44
5,6,6,1,3,5,18,19,0,63
5,6,6,1,3,5,19,0,0,45
5,6,6,1,3,9,14,7,0,51
5,6,6,1,18,5,0,0,0,41
5,6,6,1,20,5,0,0,0,43
5,6,6,1,20,21,13,0,0,72
5,6,6,5,3,20,0,0,0,45
5,6,6,5,3,20,5,4,0,54
5,6,6,5,3,20,5,18,0,68
5,6,6,5,3,20,5,18,19,87
5,6,6,5,3,20,6,21,12,84
5,6,6,5,3,20,9,14,7,75
5,6,6,5,3,20,9,22,5,81
5,6,6,5,3,20,15,18,0,78
5,6,6,5,3,20,15,18,19,97
5,6,6,5,3,20,19,0,0,64
5,6,6,5,3,20,21,1,12,79
5,6,6,5,9,18,0,0,0,49
5,6,6,5,14,4,9,0,0,49
5,6,6,5,14,4,9,19,0,68
5,6,6,5,18,5,14,3,5,67
5,6,6,5,18,5,14,20,0,79
5,6,6,5,18,5,14,20,19,98
5,6,6,5,18,15,21,19,0,95
5,6,6,5,20,0,0,0,0,42
5,6,6,5,20,5,0,0,0,47
5,6,6,5,20,5,12,25,0,84
5,6,6,5,20,13,1,14,0,70
5,6,6,5,20,13,5,14,0,74
5,6,6,9,3,1,3,5,0,38
5,6,6,9,3,1,3,25,0,58
5,6,6,9,3,9,5,14,20,77
5,6,6,9,5,18,3,5,0,57
5,6,6,9,7,25,0,0,0,58
5,6,6,9,7,9,1,12,0,55
5,6,6,9,7,9,1,20,5,68
5,6,6,9,7,9,5,19,0,66
5,6,6,12,1,20,5,0,0,55
5,6,6,12,1,20,9,15,14,88
5,6,6,12,15,23,5,18,0,90
5,6,6,12,21,5,14,3,5,77
5,6,6,12,21,5,14,3,25,97
5,6,6,12,21,5,14,20,0,89
5,6,6,12,21,5,14,20,19,108
5,6,6,12,21,22,5,0,0,77
5,6,6,12,21,22,9,1,0,82
5,6,6,12,21,22,9,1,12,94
5,6,6,12,21,22,9,1,19,101
5,6,6,12,21,22,9,21,13,115
5,6,6,12,21,24,0,0,0,74
5,6,6,12,21,24,5,19,0,98
5,6,6,12,21,24,9,15,14,112
5,6,6,15,4,9,5,14,20,84
5,6,6,15,12,9,1,20,5,79
5,6,6,15,18,3,5,0,0,58
5,6,6,15,18,4,0,0,0,54
5,6,6,15,18,13,0,0,0,63
5,6,6,15,18,20,0,0,0,70
5,6,6,15,18,20,6,21,12,109
5,6,6,15,18,20,19,0,0,89
5,6,6,15,19,19,9,15,14,108
5,6,6,18,1,3,20,15,18,92
5,6,6,18,1,25,0,0,0,61
5,6,6,18,5,14,1,20,5,80
5,6,6,18,15,14,20,0,0,84
5,6,6,18,15,14,20,5,4,93
5,6,6,19,0,0,0,0,0,36
5,6,6,21,4,5,0,0,0,47
5,6,6,21,12,7,5,0,0,62
5,6,6,21,12,7,5,4,0,66
5,6,6,21,12,7,5,14,20,96
5,6,6,21,12,7,5,19,0,81
5,6,6,21,12,7,9,14,7,87
5,6,6,21,13,5,0,0,0,56
5,6,6,21,14,4,0,0,0,56
5,6,6,21,19,5,0,0,0,62
5,6,6,21,19,5,4,0,0,66
5,6,6,21,19,5,12,25,0,99
5,6,6,21,19,5,19,0,0,81
5,6,6,21,19,9,14,7,0,87
5,6,6,21,19,9,15,14,0,95
5,6,6,21,19,9,15,14,19,114
5,6,6,21,19,9,22,5,0,93
5,6,6,21,19,15,0,0,0,72
5,6,6,21,22,9,1,20,5,95
5,6,12,0,0,0,0,0,0,23
5,6,15,12,9,15,19,5,0,86
5,6,16,8,0,0,0,0,0,35
5,6,18,1,3,20,15,18,25,111
5,6,18,5,5,20,0,0,0,59
5,6,20,0,0,0,0,0,0,31
5,6,20,5,19,20,0,0,0,75
5,6,20,19,0,0,0,0,0,50
5,6,20,19,15,15,14,0,0,94
5,6,20,19,15,15,14,19,0,113
5,7,5,14,3,5,0,0,0,39
5,7,5,14,3,25,0,0,0,59
5,7,5,18,1,14,0,0,0,50
5,7,5,18,19,0,0,0,0,54
5,7,5,19,20,0,0,0,0,56
5,7,5,19,20,5,4,0,0,65
5,7,5,19,20,9,14,7,0,86
5,7,5,19,20,9,15,14,0,94
5,7,5,19,20,9,15,14,19,113
5,7,5,19,20,9,22,5,0,92
5,7,5,19,20,19,0,0,0,75
5,7,7,0,0,0,0,0,0,19
5,7,7,1,18,0,0,0,0,38
5,7,7,1,18,19,0,0,0,57
5,7,7,2,5,1,20,5,18,70
5,7,7,2,5,18,18,25,0,87
5,7,7,3,18,1,20,5,0,66
5,7,7,3,21,16,0,0,0,59
5,7,7,3,21,16,6,21,12,98
5,7,7,3,21,16,19,0,0,78
5,7,7,5,1,20,5,18,0,68
5,7,7,5,4,0,0,0,0,28
5,7,7,5,18,0,0,0,0,42
5,7,7,5,18,19,0,0,0,61
5,7,7,6,9,19,8,0,0,61
5,7,7,6,18,21,9,20,0,93
5,7,7,8,5,1,4,0,0,37
5,7,7,8,5,1,4,5,4,46
5,7,7,8,5,1,4,19,0,56
5,7,7,8,15,20,0,0,0,62
5,7,7,25,0,0,0,0,0,44
5,7,7,9,14,7,0,0,0,49
5,7,7,12,5,18,0,0,0,54
5,7,7,12,5,19,19,0,0,74
5,7,7,12,9,11,5,0,0,56
5,7,7,13,5,14,20,0,0,71
5,7,7,14,15,7,0,0,0,55
5,7,7,14,15,7,19,0,0,74
5,7,7,16,12,1,14,20,0,82
5,7,7,16,12,1,14,20,19,101
5,7,7,18,15,12,12,0,0,76
5,7,7,18,15,12,12,19,0,95
5,7,7,19,0,0,0,0,0,38
5,7,7,19,8,5,12,12,0,75
5,7,7,19,8,5,12,12,19,94
5,7,7,23,8,9,19,11,0,89
5,7,9,12,15,16,19,0,0,83
5,7,25,16,20,9,1,14,19,116
5,7,9,16,20,15,0,0,0,72
5,7,9,19,0,0,0,0,0,40
5,7,9,19,5,19,0,0,0,64
5,7,12,1,20,5,18,5,0,73
5,7,12,1,20,5,18,5,19,92
5,7,12,9,14,7,0,0,0,54
5,7,12,15,7,21,5,0,0,72
5,7,12,15,13,9,19,5,0,85
5,7,13,1,0,0,0,0,0,26
5,7,15,8,15,15,4,0,0,69
5,7,15,9,19,13,0,0,0,68
5,7,15,9,19,13,19,0,0,87
5,7,15,9,19,20,0,0,0,75
5,7,15,9,19,20,9,3,0,87
5,7,15,9,19,20,18,25,0,118
5,7,15,9,19,20,19,0,0,94
5,7,15,9,20,25,0,0,0,81
5,7,15,9,26,5,0,0,0,67
5,7,15,9,26,5,18,0,0,85
5,7,15,12,0,0,0,0,0,39
5,7,15,12,5,19,19,0,0,82
5,7,15,13,1,14,9,1,0,65
5,7,15,13,1,14,9,1,3,68
5,7,15,13,1,14,9,1,19,84
5,7,15,13,9,19,13,0,0,81
5,7,15,16,8,15,14,25,0,105
5,7,15,16,8,15,14,9,3,92
5,7,15,19,0,0,0,0,0,46
5,7,15,20,8,5,9,19,13,101
5,7,15,20,9,19,13,0,0,88
5,7,15,20,9,19,13,19,0,107
5,7,15,20,9,19,20,0,0,95
5,7,15,20,9,19,20,9,3,107
5,7,15,20,9,19,20,19,0,114
5,7,15,20,9,26,5,0,0,87
5,7,15,20,9,26,5,4,0,91
5,7,15,20,9,26,9,14,7,112
5,7,18,1,3,9,1,19,0,63
5,7,18,5,0,0,0,0,0,35
5,7,18,5,7,9,15,21,19,106
5,7,18,5,19,19,0,0,0,73
5,7,18,5,19,19,5,4,0,82
5,7,18,5,19,19,5,19,0,97
5,7,18,5,19,19,9,14,7,103
5,7,18,5,19,19,9,15,14,111
5,7,18,5,19,19,9,22,5,109
5,7,18,5,19,19,15,18,0,106
5,7,18,5,20,19,0,0,0,74
5,7,18,9,4,0,0,0,0,43
5,7,18,9,13,15,14,25,0,106
5,7,18,9,13,15,14,12,5,98
5,7,18,9,15,20,0,0,0,74
5,7,18,9,20,21,4,5,0,89
5,7,18,15,13,1,14,3,25,101
5,7,21,5,9,9,20,5,0,81
5,8,5,21,0,0,0,0,0,39
5,8,12,9,20,5,0,0,0,59
5,8,21,1,23,1,0,0,0,59
5,9,3,15,19,1,14,5,0,71
5,9,4,5,0,0,0,0,0,23
5,9,4,5,14,20,0,0,0,57
5,25,4,5,14,20,0,0,0,73
5,9,4,5,14,20,12,25,0,94
5,9,4,5,18,0,0,0,0,41
5,9,4,5,18,4,15,23,14,97
5,9,4,5,18,19,0,0,0,60
5,9,4,5,20,9,3,0,0,55
5,9,4,15,7,18,1,16,8,83
5,9,4,15,12,1,0,0,0,46
5,9,4,15,12,9,3,0,0,57
5,9,4,15,12,9,19,13,0,86
5,9,4,15,12,15,7,25,0,92
5,9,4,15,12,15,14,0,0,74
5,9,4,15,12,15,14,19,0,93
5,9,4,15,19,0,0,0,0,52
5,25,5,0,0,0,0,0,0,35
5,25,5,1,2,12,5,0,0,55
5,25,5,2,1,12,12,0,0,62
5,25,5,2,1,12,12,5,4,71
5,25,5,2,1,12,12,19,0,81
5,25,5,2,1,12,13,0,0,63
5,25,5,2,1,18,0,0,0,56
5,25,5,2,1,20,8,0,0,66
5,25,5,2,5,1,13,0,0,56
5,25,5,2,5,1,13,19,0,75
5,25,5,2,5,18,18,25,0,103
5,25,5,2,12,1,3,11,0,64
5,25,5,2,12,9,14,11,0,83
5,25,5,2,15,12,20,0,0,84
5,25,5,2,15,12,20,19,0,103
5,25,5,2,18,5,5,0,0,65
5,25,5,2,18,9,7,8,20,99
5,25,5,2,18,15,23,0,0,93
5,25,5,2,18,15,23,19,0,112
5,25,5,3,21,16,0,0,0,75
5,25,5,3,21,16,19,0,0,94
5,25,5,4,0,0,0,0,0,39
5,25,5,4,14,5,19,19,0,96
5,25,5,4,15,20,0,0,0,74
5,25,5,4,18,15,16,0,0,88
5,25,5,6,12,1,16,0,0,70
5,25,5,6,21,12,0,0,0,74
5,25,5,6,21,12,19,0,0,93
5,25,5,7,12,1,14,3,5,77
5,25,5,7,12,1,19,19,0,93
5,25,5,7,18,15,21,14,4,114
5,25,5,8,15,12,5,0,0,75
5,25,5,8,15,12,5,19,0,94
5,25,5,8,15,15,11,0,0,84
5,25,5,8,15,15,11,19,0,103
5,25,5,25,0,0,0,0,0,60
5,25,5,9,14,7,0,0,0,65
5,25,5,12,1,19,8,0,0,75
5,25,5,12,1,19,8,5,19,99
5,25,5,12,1,19,20,0,0,87
5,25,5,12,5,19,19,0,0,90
5,25,5,12,5,20,0,0,0,72
5,25,5,12,5,20,5,4,0,81
5,25,5,12,5,20,5,5,18,100
5,25,5,12,5,20,9,14,7,102
5,25,5,12,5,20,19,0,0,91
5,25,5,12,5,20,20,5,4,101
5,25,5,12,5,20,20,5,18,115
5,25,5,12,9,4,0,0,0,60
5,25,5,12,9,4,19,0,0,79
5,25,5,12,9,7,8,20,0,91
5,25,5,12,9,11,5,0,0,72
5,25,5,12,9,14,5,0,0,75
5,25,5,12,9,14,5,18,0,93
5,25,5,12,9,14,5,18,19,112
5,25,5,13,1,18,11,0,0,78
5,25,5,14,0,0,0,0,0,49
5,25,5,15,16,5,14,5,18,108
5,25,5,16,9,5,3,5,0,73
5,25,5,16,9,5,3,5,19,92
5,25,5,16,9,20,0,0,0,80
5,25,5,16,15,9,14,20,0,109
5,25,5,16,15,9,14,20,19,128
5,25,5,16,15,16,16,5,18,121
5,25,5,18,0,0,0,0,0,53
5,25,5,18,5,1,3,8,0,70
5,25,5,18,15,15,20,0,0,103
5,25,5,18,19,0,0,0,0,72
5,25,5,19,0,0,0,0,0,54
5,25,5,19,1,12,22,5,0,94
5,25,5,19,5,5,4,0,0,68
5,25,5,19,5,18,22,5,18,122
5,25,5,19,8,1,4,5,0,72
5,25,5,19,8,1,4,5,19,91
5,25,5,19,8,9,5,12,4,92
5,25,5,19,8,9,14,5,0,90
5,25,5,19,8,15,20,0,0,97
5,25,5,19,8,15,20,19,0,116
5,25,5,19,9,7,8,20,0,98
5,25,5,19,9,7,8,20,19,117
5,25,5,19,15,13,5,0,0,87
5,25,5,19,15,18,5,0,0,92
5,25,5,19,15,18,5,19,0,111
5,25,5,19,16,15,20,0,0,105
5,25,5,19,16,15,20,19,0,124
5,25,5,19,19,0,0,0,0,73
5,25,5,19,20,1,12,11,0,98
5,25,5,19,20,1,12,11,19,117
5,25,5,19,20,15,14,5,0,108
5,25,5,19,20,15,14,5,19,127
5,25,5,19,20,18,1,9,14,116
5,25,5,19,20,18,9,14,7,122
5,25,5,20,5,5,20,8,0,93
5,25,5,20,15,15,20,8,0,113
5,25,5,23,1,9,20,5,18,111
5,25,5,23,1,19,8,0,0,86
5,25,5,23,1,19,8,5,19,110
5,25,5,23,1,20,5,18,0,102
5,25,5,23,1,20,5,18,19,121
5,25,5,23,5,1,18,0,0,82
5,25,5,23,9,14,11,0,0,92
5,25,5,23,9,14,11,5,18,115
5,25,5,23,9,14,11,19,0,111
5,25,5,23,15,18,20,0,0,111
5,9,7,8,0,0,0,0,0,29
5,9,7,8,20,0,0,0,0,49
5,25,7,8,20,0,0,0,0,65
5,9,7,8,20,2,1,12,12,76
5,9,7,8,20,5,5,14,0,73
5,9,7,8,20,5,5,14,19,92
5,9,7,8,20,6,15,9,12,91
5,9,7,8,20,6,15,12,4,86
5,9,7,8,20,8,0,0,0,57
5,9,7,8,20,8,5,19,0,81
5,9,7,8,20,8,12,25,0,94
5,9,7,8,20,8,19,0,0,76
5,9,7,8,20,25,0,0,0,74
5,9,7,8,20,9,5,19,0,82
5,9,7,8,20,9,5,20,8,91
5,9,7,8,20,12,9,14,7,91
5,9,7,8,20,19,0,0,0,68
5,9,7,8,20,19,13,1,14,96
5,9,7,8,20,19,13,5,14,100
5,9,7,8,20,19,15,13,5,101
5,9,7,8,20,22,15,0,0,86
5,9,7,8,20,22,15,19,0,105
5,9,7,14,5,0,0,0,0,40
5,25,9,14,7,0,0,0,0,60
5,9,11,15,14,0,0,0,0,54
5,9,11,15,14,5,19,0,0,78
5,9,11,15,14,19,0,0,0,73
5,25,12,0,0,0,0,0,0,42
5,9,12,1,0,0,0,0,0,27
5,9,12,4,0,0,0,0,0,30
5,25,12,9,1,4,0,0,0,56
5,9,13,5,18,0,0,0,0,50
5,9,14,0,0,0,0,0,0,28
5,25,14,0,0,0,0,0,0,44
5,25,14,5,0,0,0,0,0,49
5,9,14,11,1,14,20,5,18,97
5,9,14,11,15,18,14,0,0,86
5,9,14,11,15,18,14,19,0,105
5,25,15,20,0,0,0,0,0,65
5,25,15,20,25,0,0,0,0,90
5,9,18,0,0,0,0,0,0,32
5,25,18,0,0,0,0,0,0,48
5,25,18,1,0,0,0,0,0,49
5,9,18,1,3,11,0,0,0,47
5,25,18,1,14,20,0,0,0,83
5,25,18,1,18,0,0,0,0,67
5,25,18,1,19,0,0,0,0,68
5,25,18,5,14,0,0,0,0,67
5,9,18,5,14,1,18,3,8,81
5,9,18,5,14,9,3,0,0,63
5,9,18,5,14,9,3,15,14,92
5,25,18,5,18,0,0,0,0,71
5,25,18,5,19,0,0,0,0,72
5,9,18,5,19,9,15,14,5,99
5,9,18,25,0,0,0,0,0,57
5,25,18,25,0,0,0,0,0,73
5,25,18,9,5,0,0,0,0,62
5,25,18,9,5,19,0,0,0,81
5,25,18,9,18,0,0,0,0,75
5,9,19,5,7,5,19,5,19,93
5,9,19,5,7,5,19,9,19,97
5,9,19,5,7,5,20,9,3,82
5,9,19,5,12,12,0,0,0,62
5,9,19,15,4,9,3,0,0,64
5,25,19,15,7,5,0,0,0,76
5,9,20,8,5,18,0,0,0,65
5,10,5,3,20,0,0,0,0,43
5,10,5,3,20,1,0,0,0,44
5,10,5,3,20,1,2,12,5,63
5,10,5,3,20,5,4,0,0,52
5,10,5,3,20,5,5,0,0,53
5,10,5,3,20,9,14,7,0,73
5,10,5,3,20,9,15,14,0,81
5,10,5,3,20,9,15,14,19,100
5,10,5,3,20,9,22,5,0,79
5,10,5,3,20,9,22,5,19,98
5,10,5,3,20,13,5,14,20,95
5,10,5,3,20,15,18,0,0,76
5,10,5,3,20,15,18,19,0,95
5,10,5,3,20,19,0,0,0,62
5,10,5,3,20,21,13,0,0,77
5,10,9,3,9,5,14,20,0,75
5,10,9,4,1,12,0,0,0,41
5,10,9,4,15,0,0,0,0,43
5,10,9,4,15,19,0,0,0,62
5,10,15,15,0,0,0,0,0,45
5,10,21,12,1,20,5,0,0,74
5,10,21,12,1,20,9,15,14,107
5,10,21,18,1,20,5,0,0,80
5,10,21,18,1,20,9,15,14,113
5,10,21,19,4,0,0,0,0,59
5,10,21,19,4,5,13,0,0,77
5,11,5,0,0,0,0,0,0,21
5,11,5,4,0,0,0,0,0,25
5,11,5,14,1,13,5,0,0,54
5,11,5,18,0,0,0,0,0,39
5,11,5,18,9,20,5,0,0,73
5,11,5,19,0,0,0,0,0,40
5,11,8,9,13,9,0,0,0,55
5,11,9,14,7,0,0,0,0,46
5,11,9,19,20,9,3,0,0,76
5,11,9,19,20,9,3,19,0,95
5,11,11,1,0,0,0,0,0,28
5,11,16,8,15,18,5,0,0,78
5,11,16,8,15,18,25,0,0,98
5,11,16,8,15,18,9,1,0,83
5,11,16,8,15,18,9,1,19,102
5,11,16,8,15,18,9,26,5,113
5,11,16,23,5,12,5,0,0,77
5,11,16,23,5,12,5,19,0,96
5,11,20,5,14,5,0,0,0,60
5,11,20,5,14,5,19,0,0,79
5,11,20,5,24,9,14,5,0,93
5,11,20,5,24,9,14,5,19,112
5,11,21,5,12,5,0,0,0,59
5,12,2,0,0,0,0,0,0,19
5,12,2,15,9,3,0,0,0,46
5,12,2,15,23,0,0,0,0,57
5,12,2,15,23,2,21,19,8,107
5,12,2,15,23,5,4,0,0,66
5,12,2,15,23,5,18,0,0,80
5,12,2,15,23,25,0,0,0,82
5,12,2,15,23,9,14,7,0,87
5,12,2,15,23,18,15,15,13,118
5,12,2,15,23,19,0,0,0,76
5,12,2,21,3,11,0,0,0,54
5,12,3,1,10,1,0,0,0,32
5,12,3,8,5,5,0,0,0,38
5,12,4,0,0,0,0,0,0,21
5,12,4,5,18,2,21,19,8,94
5,12,4,5,18,8,15,15,4,86
5,12,4,5,18,12,25,0,0,81
5,12,4,5,18,12,9,5,19,89
5,12,4,5,18,12,9,14,7,86
5,12,4,5,18,13,1,14,0,72
5,12,4,5,18,13,5,14,0,76
5,12,4,5,18,14,0,0,0,58
5,12,4,5,18,19,0,0,0,63
5,12,4,5,18,19,8,9,16,96
5,12,4,5,18,23,15,15,4,101
5,12,4,5,18,23,15,18,20,120
5,12,4,5,19,20,0,0,0,65
5,12,4,6,1,20,8,5,18,79
5,12,4,9,14,7,0,0,0,51
5,12,4,13,15,20,8,5,18,100
5,12,4,18,5,19,19,0,0,82
5,12,4,18,9,3,8,0,0,59
5,12,4,18,9,20,3,8,0,79
5,12,4,19,0,0,0,0,0,40
5,12,5,3,0,0,0,0,0,25
5,12,5,3,8,9,0,0,0,42
5,12,5,3,9,22,5,0,0,61
5,12,5,3,9,22,5,19,0,80
5,12,5,3,20,0,0,0,0,45
5,12,5,3,20,1,2,12,5,65
5,12,5,3,20,1,14,20,0,80
5,12,5,3,20,1,18,25,0,89
5,12,5,3,20,5,4,0,0,54
5,12,5,3,20,5,5,0,0,55
5,12,5,3,20,5,5,19,0,74
5,12,5,3,20,9,3,0,0,57
5,12,5,3,20,9,14,7,0,75
5,12,5,3,20,9,15,14,0,83
5,12,5,3,20,9,15,14,19,102
5,12,5,3,20,9,22,5,0,81
5,12,5,3,20,9,22,5,19,100
5,12,5,3,20,12,25,0,0,82
5,12,5,3,20,15,0,0,0,60
5,12,5,3,20,15,18,0,0,78
5,12,5,3,20,15,18,1,12,91
5,12,5,3,20,15,18,19,0,97
5,12,5,3,20,18,1,7,25,96
5,12,5,3,20,18,1,12,0,76
5,12,5,3,20,18,5,0,0,68
5,12,5,3,20,18,5,19,19,106
5,12,5,3,20,18,5,20,0,88
5,12,5,3,20,18,5,20,19,107
5,12,5,3,20,18,9,3,0,75
5,12,5,3,20,18,9,3,19,94
5,12,5,3,20,18,9,6,25,103
5,12,5,3,20,18,9,14,5,91
5,12,5,3,20,18,9,15,14,101
5,12,5,3,20,18,9,26,5,103
5,12,5,3,20,18,15,0,0,78
5,12,5,3,20,18,15,4,5,87
5,12,5,3,20,18,15,5,4,87
5,12,5,3,20,18,15,14,0,92
5,12,5,3,20,18,15,14,19,111
5,12,5,3,20,18,15,19,0,97
5,12,5,3,20,18,21,13,0,97
5,12,5,3,20,18,21,13,19,116
5,12,5,3,20,19,0,0,0,64
5,12,5,3,20,21,1,18,25,110
5,12,5,4,15,9,19,9,14,92
5,12,5,4,15,14,5,0,0,60
5,12,5,7,1,14,3,5,0,52
5,12,5,7,1,14,3,5,19,71
5,12,5,7,1,14,3,25,0,72
5,12,5,7,1,14,20,0,0,64
5,12,5,7,1,14,20,5,0,69
5,12,5,7,1,14,20,5,18,87
5,12,5,7,1,14,20,12,25,101
5,12,5,7,25,0,0,0,0,54
5,12,5,7,9,1,3,0,0,42
5,12,5,7,9,1,3,1,12,55
5,12,5,7,9,1,3,19,0,61
5,12,5,7,9,1,19,20,0,78
5,12,5,7,9,5,19,0,0,62
5,12,5,7,9,15,21,19,0,93
5,12,5,7,9,19,5,0,0,62
5,12,5,7,9,19,5,4,0,66
5,12,5,7,9,19,5,19,0,81
5,12,5,7,9,19,9,14,7,87
5,12,5,7,9,19,20,0,0,77
5,12,5,7,9,19,20,19,0,96
5,12,5,7,9,20,0,0,0,58
5,12,5,7,9,20,19,0,0,77
5,12,5,7,9,26,5,0,0,69
5,12,5,7,9,26,5,4,0,73
5,12,5,7,9,26,5,19,0,88
5,12,5,7,9,26,9,14,7,94
5,12,5,9,4,9,14,0,0,58
5,12,5,11,20,18,1,0,0,72
5,12,5,12,13,5,14,20,19,105
5,12,5,13,0,0,0,0,0,35
5,12,5,13,5,0,0,0,0,40
5,12,5,13,5,14,20,0,0,74
5,12,5,13,5,14,20,1,12,87
5,12,5,13,5,14,20,19,0,93
5,12,5,13,9,0,0,0,0,44
5,12,5,13,9,3,9,14,0,70
5,12,5,13,9,14,0,0,0,58
5,12,5,13,9,19,0,0,0,63
5,12,5,13,15,12,0,0,0,62
5,12,5,13,15,14,7,0,0,71
5,12,5,14,3,8,0,0,0,47
5,12,5,14,3,8,9,0,0,56
5,12,5,14,3,8,9,3,0,59
5,12,5,14,3,8,9,26,5,87
5,12,5,14,3,8,20,9,3,79
5,12,5,14,3,8,21,19,0,87
5,12,5,14,3,20,9,3,0,71
5,12,5,14,7,5,0,0,0,48
5,12,5,14,7,5,12,25,0,85
5,12,5,15,2,12,1,19,20,91
5,12,5,15,12,9,20,5,0,83
5,12,5,15,13,5,20,5,18,98
5,12,5,15,16,12,1,19,20,105
5,12,5,15,16,20,5,14,5,97
5,12,5,15,20,18,9,4,0,88
5,12,5,16,1,9,15,0,0,63
5,12,5,16,8,1,14,3,25,89
5,12,5,16,8,1,14,20,0,81
5,12,5,16,8,1,14,20,1,82
5,12,5,16,8,1,14,20,19,100
5,12,5,21,9,14,0,0,0,66
5,12,5,22,0,0,0,0,0,44
5,12,5,22,1,2,12,5,0,64
5,12,5,22,1,20,5,0,0,70
5,12,5,22,1,20,5,4,0,74
5,12,5,22,1,20,5,19,0,89
5,12,5,22,1,20,9,14,7,95
5,12,5,22,1,20,9,15,14,103
5,12,5,22,1,20,15,0,0,80
5,12,5,22,1,20,15,18,0,98
5,12,5,22,1,20,15,18,25,123
5,12,5,22,1,20,15,18,19,117
5,12,5,22,5,0,0,0,0,49
5,12,5,22,5,14,0,0,0,63
5,12,5,22,5,14,5,18,0,86
5,12,5,22,5,14,19,0,0,82
5,12,5,22,5,14,19,5,19,106
5,12,5,22,5,14,20,8,0,91
5,12,5,22,5,14,20,8,19,110
5,12,5,22,15,14,0,0,0,73
5,12,5,22,15,14,19,0,0,92
5,12,6,4,15,13,0,0,0,55
5,12,6,5,14,6,15,12,11,86
5,12,6,8,15,15,4,0,0,65
5,12,6,9,3,0,0,0,0,35
5,12,6,9,14,0,0,0,0,46
5,12,6,9,14,19,0,0,0,65
5,12,6,9,14,23,15,15,4,103
5,12,6,9,19,8,0,0,0,59
5,12,6,9,19,8,12,25,0,96
5,12,6,11,9,14,0,0,0,57
5,12,6,12,1,14,4,0,0,54
5,12,6,12,9,11,5,0,0,60
5,12,6,12,15,3,11,0,0,64
5,12,6,12,15,3,11,19,0,83
5,12,6,19,8,9,16,0,0,75
5,12,6,23,9,6,5,0,0,66
5,12,6,23,15,18,20,0,0,99
5,12,8,9,0,0,0,0,0,34
5,12,9,1,19,9,20,5,0,80
5,12,9,3,9,20,0,0,0,58
5,12,9,3,9,20,1,20,5,84
5,12,9,3,9,20,5,4,0,67
5,12,9,3,9,20,9,14,7,88
5,12,9,3,9,20,15,18,0,91
5,12,9,3,9,20,15,18,25,116
5,12,9,3,9,20,15,18,19,110
5,12,9,3,9,20,19,0,0,77
5,12,9,4,5,0,0,0,0,35
5,12,9,4,5,4,0,0,0,39
5,12,9,4,5,19,0,0,0,54
5,12,9,4,9,2,12,5,0,58
5,12,9,4,9,14,7,0,0,60
5,12,25,4,15,18,9,3,0,91
5,12,9,7,5,14,4,1,0,57
5,12,9,7,5,14,20,0,0,72
5,12,9,7,9,2,12,5,0,61
5,12,9,7,9,2,12,5,19,80
5,12,9,7,9,2,12,25,0,81
5,12,9,13,9,14,1,14,4,81
5,12,9,13,9,14,1,14,20,97
5,12,9,13,9,14,1,20,5,88
5,12,9,14,7,21,1,20,5,94
5,12,9,14,7,21,5,4,0,77
5,12,9,14,20,0,0,0,0,60
5,12,9,14,20,19,0,0,0,79
5,12,9,17,21,1,20,5,0,90
5,12,9,17,21,1,20,5,4,94
5,12,9,19,9,15,14,0,0,83
5,12,9,19,9,15,14,19,0,102
5,12,9,19,15,18,0,0,0,78
5,12,9,20,5,0,0,0,0,51
5,12,9,20,5,19,0,0,0,70
5,12,9,20,9,19,13,0,0,87
5,12,9,20,9,19,13,19,0,106
5,12,9,20,9,19,20,0,0,94
5,12,9,20,9,19,20,19,0,113
5,12,25,20,18,1,0,0,0,81
5,12,25,20,18,1,12,0,0,93
5,12,25,20,18,9,14,0,0,103
5,12,25,20,18,15,9,4,0,108
5,12,25,20,18,15,14,0,0,109
5,12,25,20,18,15,21,19,0,135
5,12,25,20,18,20,18,1,0,119
5,12,25,20,18,21,13,0,0,114
5,12,9,24,0,0,0,0,0,50
5,12,9,24,1,20,5,0,0,76
5,12,9,24,1,20,9,15,14,109
5,12,9,24,5,4,0,0,0,59
5,12,9,24,9,18,0,0,0,77
5,12,9,24,9,18,19,0,0,96
5,12,11,0,0,0,0,0,0,28
5,12,11,8,15,21,14,4,0,90
5,12,11,8,15,21,14,4,19,109
5,12,11,19,0,0,0,0,0,47
5,12,11,19,12,9,16,0,0,84
5,12,12,1,3,8,9,3,11,64
5,12,12,1,7,1,20,5,0,63
5,12,12,1,7,9,3,0,0,49
5,12,12,5,2,15,18,5,0,74
5,12,12,5,3,11,0,0,0,48
5,12,12,5,14,25,1,18,4,96
5,12,12,6,9,19,8,0,0,71
5,12,12,9,14,7,0,0,0,59
5,12,12,9,14,7,5,0,0,64
5,12,12,9,16,19,5,0,0,78
5,12,12,9,16,19,5,19,0,97
5,12,12,9,16,19,9,19,0,101
5,12,12,9,16,19,15,9,4,101
5,12,12,9,16,19,15,14,5,107
5,12,12,9,16,20,9,3,0,86
5,12,12,9,16,20,15,9,4,102
5,12,12,15,16,19,0,0,0,79
5,12,12,19,0,0,0,0,0,48
5,12,12,23,1,14,4,0,0,71
5,12,13,25,0,0,0,0,0,55
5,12,13,9,5,18,0,0,0,62
5,12,13,9,5,19,20,0,0,83
5,12,13,19,0,0,0,0,0,49
5,12,14,5,0,0,0,0,0,36
5,12,15,3,1,20,9,15,14,94
5,12,15,3,21,12,1,18,0,87
5,12,15,3,21,20,5,0,0,81
5,12,15,3,21,20,9,15,14,114
5,12,15,3,21,20,9,22,5,112
5,12,15,4,0,0,0,0,0,36
5,12,15,4,5,1,19,0,0,61
5,12,15,7,5,0,0,0,0,44
5,12,15,7,25,0,0,0,0,64
5,12,15,7,9,21,13,0,0,82
5,12,15,9,7,14,0,0,0,62
5,12,15,9,7,14,5,4,0,71
5,12,15,9,7,14,5,18,0,85
5,12,15,9,7,14,5,18,19,104
5,12,15,9,7,14,9,14,7,92
5,12,15,9,7,14,19,0,0,81
5,12,15,9,14,0,0,0,0,55
5,12,15,9,14,5,0,0,0,60
5,12,15,9,14,5,4,0,0,64
5,12,15,9,14,5,18,0,0,78
5,12,15,9,14,5,18,19,0,97
5,12,15,9,14,9,14,7,0,85
5,12,15,9,14,13,5,14,20,107
5,12,15,9,14,19,0,0,0,74
5,12,15,14,7,0,0,0,0,53
5,12,15,14,7,1,20,5,0,79
5,12,15,14,7,1,20,5,4,83
5,12,15,14,7,1,20,5,19,98
5,12,15,16,5,0,0,0,0,53
5,12,15,16,5,4,0,0,0,57
5,12,15,16,5,13,5,14,20,105
5,12,15,16,5,18,0,0,0,71
5,12,15,16,5,18,19,0,0,90
5,12,15,16,5,19,0,0,0,72
5,12,15,16,9,14,7,0,0,78
5,12,15,16,19,0,0,0,0,67
5,12,15,17,21,5,14,3,5,97
5,12,15,17,21,5,14,20,0,109
5,12,15,20,9,12,12,15,0,100
5,12,16,9,4,9,20,5,0,80
5,12,18,1,7,5,0,0,0,48
5,12,18,9,3,0,0,0,0,47
5,12,18,9,20,3,8,0,0,75
5,12,18,15,17,21,9,20,5,122
5,12,19,0,0,0,0,0,0,36
5,12,19,5,8,15,23,0,0,87
5,12,19,5,19,0,0,0,0,60
5,12,19,5,23,1,25,19,0,109
5,12,19,5,23,1,18,4,19,106
5,12,19,5,23,8,1,20,0,93
5,12,19,5,23,8,5,14,0,91
5,12,19,5,23,8,5,18,5,100
5,12,19,5,23,9,19,5,0,97
5,12,19,8,9,14,0,0,0,67
5,12,19,9,14,0,0,0,0,59
5,12,20,9,13,5,0,0,0,64
5,12,20,18,15,20,0,0,0,90
5,12,21,1,14,20,0,0,0,73
5,12,21,1,14,20,19,0,0,92
5,12,21,1,20,5,0,0,0,64
5,12,21,1,20,5,4,0,0,68
5,12,21,1,20,5,19,0,0,83
5,12,21,1,20,9,14,7,0,89
5,12,21,3,9,4,0,0,0,54
5,12,21,3,9,4,1,20,5,80
5,12,21,3,20,1,20,5,0,87
5,12,21,4,5,0,0,0,0,47
5,12,21,4,5,4,0,0,0,51
5,12,21,4,5,18,0,0,0,65
5,12,21,4,5,18,19,0,0,84
5,12,21,4,5,19,0,0,0,66
5,12,21,4,9,2,12,5,0,70
5,12,21,4,9,14,7,0,0,72
5,12,21,5,14,20,0,0,0,77
5,12,21,5,14,20,19,0,0,96
5,12,21,13,2,1,20,5,4,83
5,12,21,19,9,15,14,0,0,95
5,12,21,19,9,15,14,19,0,114
5,12,21,19,9,22,5,0,0,93
5,12,21,19,9,22,5,12,25,130
5,12,21,19,15,18,25,0,0,115
5,12,21,20,5,0,0,0,0,63
5,12,21,20,5,4,0,0,0,67
5,12,21,20,5,19,0,0,0,82
5,12,21,20,9,14,7,0,0,88
5,12,21,20,9,15,14,0,0,96
5,12,21,20,9,15,14,19,0,115
5,12,21,20,15,18,0,0,0,91
5,12,21,20,18,9,1,20,5,111
5,12,21,22,9,1,0,0,0,70
5,12,21,22,9,1,12,0,0,82
5,12,21,22,9,1,20,5,0,95
5,12,21,22,9,1,20,5,4,99
5,12,21,22,9,1,20,5,19,114
5,12,21,22,9,5,19,0,0,93
5,12,21,22,9,21,13,0,0,103
5,12,21,22,9,21,13,19,0,122
5,12,21,22,9,22,9,1,0,101
5,12,21,24,1,20,5,0,0,88
5,12,22,1,14,0,0,0,0,54
5,12,22,1,14,9,20,5,0,88
5,12,22,1,14,9,20,9,3,95
5,12,22,5,0,0,0,0,0,44
5,12,22,5,18,0,0,0,0,62
5,12,22,5,18,19,0,0,0,81
5,12,22,5,19,0,0,0,0,63
5,12,22,5,20,0,0,0,0,64
5,12,22,9,19,8,0,0,0,75
5,12,22,9,19,8,12,25,0,112
5,13,2,1,3,5,0,0,0,29
5,13,2,1,3,12,5,0,0,41
5,13,2,1,25,0,0,0,0,46
5,13,2,1,25,5,4,0,0,55
5,13,2,1,25,9,14,7,0,76
5,13,2,1,25,13,5,14,20,98
5,13,2,1,9,14,0,0,0,44
5,13,2,1,25,19,0,0,0,65
5,13,2,1,12,5,0,0,0,38
5,13,2,1,12,12,0,0,0,45
5,13,2,1,12,13,0,0,0,46
5,13,2,1,12,13,5,4,0,55
5,13,2,1,12,13,5,18,0,69
5,13,2,1,12,13,5,18,19,88
5,13,2,1,12,13,9,14,7,76
5,13,2,1,12,13,19,0,0,65
5,13,2,1,14,11,0,0,0,46
5,13,2,1,14,11,5,4,0,55
5,13,2,1,14,11,9,14,7,76
5,13,2,1,14,11,19,0,0,65
5,13,2,1,16,8,9,21,13,88
5,13,2,1,18,0,0,0,0,39
5,13,2,1,18,7,5,0,0,51
5,13,2,1,18,7,15,0,0,61
5,13,2,1,18,7,15,5,4,70
5,13,2,1,18,7,15,5,19,85
5,13,2,1,18,7,15,19,0,80
5,13,2,1,18,11,0,0,0,50
5,13,2,1,18,11,5,4,0,59
5,13,2,1,18,11,9,14,7,80
5,13,2,1,18,11,19,0,0,69
5,13,2,1,18,13,5,14,20,91
5,13,2,1,18,17,21,5,0,82
5,13,2,1,18,18,1,19,0,77
5,13,2,1,18,18,1,19,19,96
5,13,2,1,18,18,5,4,0,66
5,13,2,1,18,18,5,12,0,74
5,13,2,1,18,18,5,14,0,76
5,13,2,1,18,18,9,14,7,87
5,13,2,1,18,19,0,0,0,58
5,13,2,1,19,5,0,0,0,45
5,13,2,1,19,19,1,4,5,69
5,13,2,1,19,19,1,7,5,72
5,13,2,1,19,19,25,0,0,84
5,13,2,1,19,19,9,5,19,92
5,13,2,1,20,8,5,0,0,54
5,13,2,1,20,20,12,5,0,78
5,13,2,1,20,20,12,5,4,82
5,13,2,1,20,20,12,5,19,97
5,13,2,5,1,13,0,0,0,39
5,13,2,5,4,0,0,0,0,29
5,13,2,5,4,4,5,4,0,42
5,13,2,5,4,4,5,18,0,56
5,13,2,5,4,4,9,14,7,63
5,13,2,5,4,13,5,14,20,81
5,13,2,5,4,19,0,0,0,48
5,13,2,5,7,7,1,18,0,58
5,13,2,5,12,9,3,0,0,49
5,13,2,5,12,9,6,0,0,52
5,13,2,5,12,9,14,0,0,60
5,13,2,5,12,12,9,19,8,85
5,13,2,5,18,0,0,0,0,43
5,13,2,5,18,19,0,0,0,62
5,13,2,5,20,20,5,18,0,88
5,13,2,5,26,26,12,5,0,94
5,13,2,5,26,26,12,5,4,98
5,13,2,5,26,26,12,5,18,112
5,13,2,5,26,26,12,5,19,113
5,13,2,9,9,4,0,0,0,42
5,13,2,9,12,12,15,23,0,91
5,13,2,9,14,4,0,0,0,47
5,13,2,9,18,1,0,0,0,48
5,13,2,9,20,20,5,18,0,92
5,13,2,9,20,20,5,18,19,111
5,13,2,12,1,4,4,5,18,64
5,13,2,12,1,14,3,8,0,58
5,13,2,12,1,26,5,0,0,64
5,13,2,12,1,26,5,4,0,68
5,13,2,12,1,26,5,18,0,82
5,13,2,12,1,26,5,18,19,101
5,13,2,12,1,26,5,19,0,83
5,13,2,12,1,26,9,14,7,89
5,13,2,12,1,26,15,14,0,88
5,13,2,12,1,26,15,14,19,107
5,13,2,12,5,13,0,0,0,50
5,13,2,12,5,13,1,0,0,51
5,13,2,12,5,13,5,4,0,59
5,13,2,12,5,13,5,14,20,89
5,13,2,12,5,13,9,14,7,80
5,13,2,12,5,13,9,19,8,86
5,13,2,12,5,13,9,19,20,98
5,13,2,12,5,13,9,26,5,90
5,13,2,12,5,13,19,0,0,69
5,13,2,12,9,3,0,0,0,44
5,13,2,12,9,19,19,0,0,79
5,13,2,12,15,15,13,0,0,75
5,13,2,12,15,19,19,15,13,113
5,13,2,15,4,25,0,0,0,64
5,13,2,15,4,9,5,4,0,57
5,13,2,15,4,9,5,18,0,71
5,13,2,15,4,9,5,18,19,90
5,13,2,15,4,9,5,19,0,72
5,13,2,15,4,25,9,14,7,94
5,13,2,15,7,0,0,0,0,42
5,13,2,15,7,21,5,0,0,68
5,13,2,15,9,12,0,0,0,56
5,13,2,15,9,20,5,0,0,69
5,13,2,15,9,20,5,19,0,88
5,13,2,15,12,4,5,14,0,70
5,13,2,15,12,4,5,14,19,89
5,13,2,15,12,5,0,0,0,52
5,13,2,15,12,5,13,9,1,75
5,13,2,15,12,9,0,0,0,56
5,13,2,15,12,25,0,0,0,72
5,13,2,15,12,9,3,0,0,59
5,13,2,15,12,9,5,19,0,80
5,13,2,15,12,9,19,13,0,88
5,13,2,15,12,9,19,13,19,107
5,13,2,15,12,9,20,5,0,81
5,13,2,15,12,9,21,13,0,90
5,13,2,15,12,9,26,5,0,87
5,13,2,15,12,15,0,0,0,62
5,13,2,15,12,15,14,0,0,76
5,13,2,15,12,21,13,0,0,81
5,13,2,15,12,21,19,0,0,87
5,13,2,15,18,4,5,18,0,80
5,13,2,15,18,4,5,18,19,99
5,13,2,15,19,3,1,20,1,79
5,13,2,15,19,11,0,0,0,65
5,13,2,15,19,11,5,4,0,74
5,13,2,15,19,11,9,14,7,95
5,13,2,15,19,11,19,0,0,84
5,13,2,15,19,15,13,0,0,82
5,13,2,15,19,15,13,5,4,91
5,13,2,15,19,15,13,19,0,101
5,13,2,15,19,19,0,0,0,73
5,13,2,15,19,19,1,7,5,86
5,13,2,15,19,19,5,4,0,82
5,13,2,15,19,19,5,18,0,96
5,13,2,15,19,19,5,18,19,115
5,13,2,15,19,19,5,19,0,97
5,13,2,15,19,19,9,14,7,103
5,13,2,15,19,19,13,1,14,101
5,13,2,15,19,19,13,5,14,105
5,13,2,15,19,20,0,0,0,74
5,13,2,15,19,20,21,18,5,118
5,13,2,15,20,20,12,5,0,92
5,13,2,15,21,14,4,0,0,74
5,13,2,15,23,0,0,0,0,58
5,13,2,15,23,5,4,0,0,67
5,13,2,15,23,5,12,0,0,75
5,13,2,15,23,5,12,5,4,84
5,13,2,15,23,5,12,5,18,98
5,13,2,15,23,5,12,19,0,94
5,13,2,15,23,5,18,0,0,81
5,13,2,15,23,5,18,5,4,90
5,13,2,15,23,5,18,19,0,100
5,13,2,15,23,9,14,7,0,88
5,13,2,15,23,12,0,0,0,70
5,13,2,15,23,13,5,14,20,110
5,13,2,15,23,19,0,0,0,77
5,13,2,15,24,0,0,0,0,59
5,13,2,18,1,3,5,0,0,47
5,13,2,18,1,3,5,4,0,51
5,13,2,18,1,3,5,15,18,80
5,13,2,18,1,3,5,18,0,65
5,13,2,18,1,3,5,18,25,90
5,13,2,18,1,3,5,18,19,84
5,13,2,18,1,3,5,19,0,66
5,13,2,18,1,3,9,14,7,72
5,13,2,18,1,3,9,22,5,78
5,13,2,18,1,9,4,0,0,52
5,13,2,18,1,9,12,0,0,60
5,13,2,18,1,11,5,0,0,55
5,13,2,18,1,14,7,12,5,77
5,13,2,18,1,19,5,0,0,63
5,13,2,18,1,19,21,18,5,102
5,13,2,18,1,22,5,0,0,66
5,13,2,18,1,23,14,0,0,76
5,13,2,18,5,1,3,8,0,55
5,13,2,18,5,1,4,0,0,48
5,13,2,18,5,1,20,8,5,77
5,13,2,18,5,23,0,0,0,66
5,13,2,18,9,7,8,20,0,82
5,13,2,18,25,15,0,0,0,78
5,13,2,18,25,15,9,4,0,91
5,13,2,18,25,15,9,19,13,119
5,13,2,18,25,15,12,0,0,90
5,13,2,18,25,15,13,1,0,92
5,13,2,18,25,15,13,1,19,111
5,13,2,18,25,15,14,0,0,92
5,13,2,18,25,15,14,1,12,105
5,13,2,18,25,15,14,25,0,117
5,13,2,18,25,15,14,9,3,104
5,13,2,18,25,15,14,19,0,111
5,13,2,18,25,15,19,0,0,97
5,13,2,18,25,15,20,9,3,110
5,13,2,18,25,15,21,19,0,118
5,13,2,18,9,20,20,12,5,104
5,13,2,18,25,21,12,3,9,108
5,13,2,18,15,1,4,5,14,77
5,13,2,18,15,3,1,4,15,76
5,13,2,18,15,3,1,20,5,82
5,13,2,18,15,3,8,5,0,69
5,13,2,18,15,7,12,9,15,96
5,13,2,18,15,9,4,5,18,89
5,13,2,18,15,9,12,0,0,74
5,13,2,18,15,9,12,5,4,83
5,13,2,18,15,9,12,5,18,97
5,13,2,18,15,9,12,19,0,93
5,13,2,18,15,14,26,5,0,98
5,13,2,18,15,23,4,0,0,80
5,13,2,18,15,23,14,0,0,90
5,13,2,18,15,23,14,5,4,99
5,13,2,18,15,23,14,19,0,109
5,13,2,18,21,5,0,0,0,64
5,13,2,18,21,5,4,0,0,68
5,13,2,18,21,5,19,0,0,83
5,13,2,18,21,9,14,7,0,89
5,13,2,18,21,20,5,0,0,84
5,13,2,18,21,20,5,4,0,88
5,13,2,18,21,20,5,19,0,103
5,13,2,18,21,20,9,14,7,109
5,13,2,21,2,2,12,5,0,62
5,13,2,21,5,0,0,0,0,46
5,13,2,21,9,1,0,0,0,51
5,13,2,21,12,11,0,0,0,64
5,13,2,21,12,12,0,0,0,65
5,13,2,21,19,0,0,0,0,60
5,13,2,21,19,8,0,0,0,68
5,13,2,21,19,25,0,0,0,85
5,13,2,21,19,11,0,0,0,71
5,13,2,21,19,11,9,14,0,94
5,13,2,21,19,17,21,0,0,98
5,13,2,21,19,17,21,5,0,103
5,13,2,21,19,19,5,4,0,88
5,13,2,21,19,19,9,14,7,109
5,13,3,5,5,0,0,0,0,31
5,13,3,5,5,4,0,0,0,35
5,13,3,5,5,9,14,7,0,61
5,13,3,5,5,19,0,0,0,50
5,13,3,5,9,14,7,0,0,56
5,13,4,1,0,0,0,0,0,23
5,13,5,0,0,0,0,0,0,23
5,13,5,5,18,0,0,0,0,46
5,13,5,5,18,1,20,5,0,72
5,13,5,5,18,1,20,5,19,91
5,13,5,5,18,19,0,0,0,65
5,13,5,5,18,19,8,9,16,98
5,13,5,14,4,0,0,0,0,41
5,13,5,14,4,1,2,12,5,61
5,13,5,14,4,1,20,5,0,67
5,13,5,14,4,1,20,5,4,71
5,13,5,14,4,1,20,5,19,86
5,13,5,14,4,1,20,15,18,95
5,13,5,14,4,5,4,0,0,50
5,13,5,14,4,5,18,0,0,64
5,13,5,14,4,5,18,19,0,83
5,13,5,14,4,9,14,7,0,71
5,13,5,14,4,19,0,0,0,60
5,13,5,18,0,0,0,0,0,41
5,13,5,18,1,12,4,19,0,77
5,13,5,18,1,14,20,0,0,76
5,13,5,18,1,19,0,0,0,61
5,13,5,18,1,21,4,5,0,72
5,13,5,18,7,5,0,0,0,53
5,13,5,18,7,5,4,0,0,57
5,13,5,18,7,5,14,3,5,75
5,13,5,18,7,5,14,3,25,95
5,13,5,18,7,5,14,20,0,87
5,13,5,18,7,5,14,20,19,106
5,13,5,18,7,5,18,19,0,90
5,13,5,18,7,5,19,0,0,72
5,13,5,18,7,9,14,7,0,78
5,13,5,18,9,5,4,0,0,59
5,13,5,18,9,5,19,0,0,74
5,13,5,18,25,9,14,7,0,96
5,13,5,18,9,12,0,0,0,62
5,13,5,18,9,20,0,0,0,70
5,13,5,18,9,20,1,5,0,76
5,13,5,18,9,20,5,4,0,79
5,13,5,18,9,20,9,0,0,79
5,13,5,18,9,20,21,19,0,110
5,13,5,18,9,20,21,20,9,120
5,13,5,18,9,26,5,0,0,81
5,13,5,18,9,26,5,4,0,85
5,13,5,18,9,26,9,14,7,106
5,13,5,18,15,4,0,0,0,60
5,13,5,18,15,4,19,0,0,79
5,13,5,18,15,9,4,0,0,69
5,13,5,18,15,9,4,19,0,88
5,13,5,18,19,5,0,0,0,65
5,13,5,18,19,5,4,0,0,69
5,13,5,18,19,9,15,14,0,98
5,13,5,18,19,9,15,14,19,117
5,13,5,19,0,0,0,0,0,42
5,13,5,19,5,19,0,0,0,66
5,13,5,19,9,19,0,0,0,70
5,13,5,20,9,1,0,0,0,53
5,13,5,20,9,3,0,0,0,55
5,13,5,20,9,3,1,12,0,68
5,13,5,20,9,3,19,0,0,74
5,13,5,20,9,14,0,0,0,66
5,13,5,20,9,14,5,0,0,71
5,13,5,20,9,14,5,19,0,90
5,13,5,20,9,14,19,0,0,85
5,13,5,20,15,12,15,7,25,117
5,13,5,21,0,0,0,0,0,44
5,13,5,21,19,0,0,0,0,63
5,13,5,21,20,5,0,0,0,69
5,13,5,21,20,5,19,0,0,88
5,13,6,15,18,20,8,0,0,85
5,13,7,1,12,12,1,0,0,51
5,13,9,1,0,0,0,0,0,28
5,13,9,3,0,0,0,0,0,30
5,13,9,3,1,14,20,0,0,65
5,13,9,3,1,20,5,0,0,56
5,13,9,3,1,20,9,15,14,89
5,13,9,3,20,9,15,14,0,88
5,13,9,3,20,15,18,25,0,108
5,13,25,4,0,0,0,0,0,47
5,13,25,4,5,0,0,0,0,52
5,13,25,4,5,19,0,0,0,71
5,13,25,4,9,1,14,0,0,71
5,13,25,4,19,0,0,0,0,66
5,13,9,7,1,20,5,0,0,60
5,13,9,7,1,20,5,4,0,64
5,13,9,7,1,20,5,19,0,79
5,13,9,7,1,20,9,14,7,85
5,13,9,7,18,0,0,0,0,52
5,13,9,7,18,1,14,20,0,87
5,13,9,7,18,1,14,20,19,106
5,13,9,7,18,1,20,5,0,78
5,13,9,7,18,1,20,5,4,82
5,13,9,7,18,1,20,5,19,97
5,13,9,7,18,1,20,15,18,106
5,13,9,7,18,5,0,0,0,57
5,13,9,7,18,5,5,0,0,62
5,13,9,7,18,5,19,0,0,76
5,13,9,14,5,14,3,5,19,87
5,13,9,14,5,14,3,25,0,88
5,13,9,14,5,14,20,0,0,80
5,13,9,14,5,14,20,12,25,117
5,13,9,18,0,0,0,0,0,45
5,13,9,18,1,20,5,0,0,71
5,13,9,18,1,20,5,19,0,90
5,13,9,18,19,0,0,0,0,64
5,13,9,18,19,8,9,16,0,97
5,13,9,19,19,1,18,25,0,109
5,13,9,19,19,1,18,9,1,94
5,13,9,19,19,9,0,0,0,74
5,13,9,19,19,9,12,5,0,91
5,13,9,19,19,9,15,14,0,103
5,13,9,19,19,9,15,14,19,122
5,13,9,19,19,9,22,5,0,101
5,13,9,19,19,15,18,25,0,123
5,13,9,20,0,0,0,0,0,47
5,13,9,20,19,0,0,0,0,66
5,13,9,20,20,1,14,3,5,90
5,13,9,20,20,5,4,0,0,76
5,13,9,20,20,5,14,20,0,106
5,13,9,20,20,5,18,0,0,90
5,13,9,20,20,5,18,19,0,109
5,13,9,20,20,9,14,7,0,97
5,13,13,1,14,20,12,5,0,83
5,13,13,1,18,2,12,5,0,69
5,13,13,1,18,2,12,5,4,73
5,13,13,1,18,22,5,12,0,89
5,13,13,5,12,5,9,1,0,63
5,13,13,5,14,9,1,0,0,60
5,13,13,5,14,9,3,0,0,62
5,13,13,5,14,19,9,20,5,103
5,13,13,5,18,19,0,0,0,73
5,13,13,5,20,18,15,16,5,110
5,13,13,5,20,18,15,16,25,130
5,13,13,5,20,19,0,0,0,75
5,13,13,5,23,0,0,0,0,59
5,13,13,15,22,5,0,0,0,73
5,13,15,4,9,14,0,0,0,60
5,13,15,4,9,14,19,0,0,79
5,13,15,12,12,9,1,20,5,92
5,13,15,12,12,9,5,14,20,105
5,13,15,12,15,1,0,0,0,61
5,13,15,12,21,13,5,14,20,118
5,13,15,14,7,0,0,0,0,54
5,13,15,14,25,0,0,0,0,72
5,13,15,20,5,0,0,0,0,58
5,13,15,20,5,4,0,0,0,62
5,13,15,20,5,18,0,0,0,76
5,13,15,20,5,18,19,0,0,95
5,13,15,20,5,19,0,0,0,77
5,13,15,20,9,14,7,0,0,83
5,13,15,20,9,15,14,0,0,91
5,13,15,20,9,15,14,1,12,104
5,13,15,20,9,15,14,5,4,100
5,13,15,20,9,15,14,19,0,110
5,13,15,20,9,22,5,0,0,89
5,13,15,20,9,22,5,12,25,126
5,13,15,20,9,22,9,19,13,125
5,13,15,20,9,22,9,20,25,138
5,13,15,22,5,0,0,0,0,60
5,13,16,1,3,11,5,20,0,74
5,13,16,1,5,19,20,9,3,91
5,13,16,1,9,18,0,0,0,62
5,13,16,1,9,19,20,9,3,95
5,13,16,1,12,5,0,0,0,52
5,13,16,1,12,5,4,0,0,56
5,13,16,1,12,5,18,0,0,70
5,13,16,1,12,5,18,19,0,89
5,13,16,1,12,5,19,0,0,71
5,13,16,1,12,9,14,7,0,77
5,13,16,1,12,12,0,0,0,59
5,13,16,1,14,1,4,1,0,55
5,13,16,1,14,5,12,0,0,66
5,13,16,1,14,5,12,5,4,75
5,13,16,1,14,5,12,19,0,85
5,13,16,1,14,14,5,12,0,80
5,13,16,1,14,15,16,12,25,117
5,13,16,1,16,5,18,0,0,74
5,13,16,1,18,11,0,0,0,64
5,13,16,1,18,12,0,0,0,65
5,13,16,1,19,13,0,0,0,67
5,13,16,1,19,13,1,0,0,68
5,13,16,1,19,19,9,15,14,111
5,13,16,1,20,8,25,0,0,88
5,13,16,1,20,8,9,3,0,75
5,13,16,1,20,8,9,5,19,96
5,13,16,1,20,8,9,26,5,103
5,13,16,1,20,18,15,14,0,102
5,13,16,5,1,18,12,0,0,70
5,13,16,5,9,14,5,0,0,67
5,13,16,5,9,18,5,13,1,85
5,13,16,5,13,1,20,1,0,74
5,13,16,5,14,14,1,7,5,80
5,13,16,5,15,16,12,5,0,87
5,13,16,5,15,16,12,5,4,91
5,13,16,5,18,5,19,19,0,100
5,13,16,5,18,25,0,0,0,82
5,13,16,5,18,9,5,19,0,90
5,13,16,5,18,9,12,0,0,78
5,13,16,5,18,9,19,8,0,93
5,13,16,5,18,9,26,5,0,97
5,13,16,5,18,15,18,0,0,90
5,13,16,5,18,15,18,19,0,109
5,13,16,5,19,20,0,0,0,78
5,13,16,5,19,20,9,3,0,90
5,13,16,5,20,18,15,21,19,132
5,13,16,5,24,1,0,0,0,64
5,13,16,8,1,19,5,0,0,67
5,13,16,8,1,19,5,19,0,86
5,13,16,8,1,19,9,19,0,90
5,13,16,8,1,19,9,19,5,95
5,13,16,8,1,19,9,26,5,102
5,13,16,8,1,20,9,3,0,75
5,13,16,8,25,19,5,13,1,105
5,13,16,8,12,25,19,9,19,126
5,13,16,8,18,1,24,9,19,113
5,13,16,8,18,5,14,19,25,123
5,13,16,9,3,20,21,18,5,110
5,13,16,25,5,13,1,0,0,78
5,13,16,25,5,13,1,19,0,97
5,13,16,25,5,13,1,20,1,99
5,13,16,25,5,13,9,3,0,89
5,13,16,9,5,18,3,5,0,74
5,13,16,25,5,19,9,19,0,111
5,13,16,9,7,8,20,0,0,78
5,13,16,25,15,3,5,12,5,99
5,13,16,25,18,5,1,12,0,95
5,13,16,25,18,5,1,14,0,97
5,13,16,25,18,5,1,14,19,116
5,13,16,9,18,5,13,1,0,80
5,13,16,9,18,5,19,0,0,85
5,13,16,25,18,5,21,13,0,116
5,13,16,25,18,5,21,13,1,117
5,13,16,9,18,25,0,0,0,86
5,13,16,9,18,9,3,0,0,73
5,13,16,9,18,9,3,1,12,86
5,13,16,25,18,9,3,1,12,102
5,13,16,9,18,9,3,19,0,92
5,13,16,9,18,9,19,13,0,102
5,13,16,25,18,15,19,9,19,139
5,13,16,12,1,3,5,0,0,55
5,13,16,12,1,3,5,4,0,59
5,13,16,12,1,3,5,19,0,74
5,13,16,12,1,3,9,14,7,80
5,13,16,12,1,14,5,0,0,66
5,13,16,12,1,14,5,4,0,70
5,13,16,12,1,14,5,19,0,85
5,13,16,12,1,14,9,14,7,91
5,13,16,12,1,19,20,5,18,109
5,13,16,12,1,19,20,9,3,98
5,13,16,12,1,19,20,18,1,105
5,13,16,12,5,1,4,0,0,56
5,13,16,12,5,3,20,9,3,86
5,13,16,12,5,3,20,15,14,103
5,13,16,12,15,25,0,0,0,86
5,13,16,12,15,25,5,0,0,91
5,13,16,12,15,25,5,4,0,95
5,13,16,12,15,25,5,5,0,96
5,13,16,12,15,25,5,5,19,115
5,13,16,12,15,25,5,18,0,109
5,13,16,12,15,25,5,18,19,128
5,13,16,12,15,25,5,19,0,110
5,13,16,12,15,25,9,14,7,116
5,13,16,12,15,25,19,0,0,105
5,13,16,12,15,18,5,0,0,84
5,13,16,12,21,13,5,0,0,85
5,13,16,12,21,14,7,5,0,93
5,13,16,15,3,11,5,20,0,88
5,13,16,15,4,9,1,0,0,63
5,13,16,15,4,9,21,13,0,96
5,13,16,15,9,19,15,14,0,106
5,13,16,15,9,19,15,14,19,125
5,13,16,15,12,4,5,18,0,88
5,13,16,15,18,5,20,9,3,104
5,13,16,15,18,25,0,0,0,92
5,13,16,15,18,9,1,12,0,89
5,13,16,15,18,9,18,9,1,104
5,13,16,15,18,9,21,13,19,129
5,13,16,15,18,20,5,0,0,92
5,13,16,15,22,5,18,0,0,94
5,13,16,15,23,5,18,0,0,95
5,13,16,15,23,5,18,5,4,104
5,13,16,15,23,5,18,19,0,114
5,13,16,18,5,14,20,0,0,91
5,13,16,18,5,19,1,0,0,77
5,13,16,18,5,19,19,5,0,100
5,13,16,18,5,19,19,5,19,119
5,13,16,18,9,13,5,0,0,79
5,13,16,18,9,14,20,0,0,95
5,13,16,18,9,19,5,0,0,85
5,13,16,18,9,19,5,19,0,104
5,13,16,18,9,19,15,14,0,109
5,13,16,18,9,26,5,0,0,92
5,13,16,18,9,26,5,19,0,111
5,13,16,20,0,0,0,0,0,54
5,13,16,20,25,0,0,0,0,79
5,13,16,20,9,1,2,12,5,83
5,13,16,20,9,5,4,0,0,72
5,13,16,20,9,5,18,0,0,86
5,13,16,20,9,5,18,19,0,105
5,13,16,20,9,5,19,0,0,87
5,13,16,20,9,5,19,20,0,107
5,13,16,20,25,9,14,7,0,109
5,13,16,20,9,12,25,0,0,100
5,13,16,20,9,14,5,19,19,120
5,13,16,20,9,14,7,19,0,103
5,13,16,20,9,14,19,0,0,96
5,13,16,20,9,15,0,0,0,78
5,13,16,20,9,15,14,0,0,92
5,13,16,20,9,15,14,1,12,105
5,13,16,20,25,19,9,19,0,126
5,13,16,20,9,22,5,0,0,90
5,13,16,20,15,18,0,0,0,87
5,13,16,20,15,18,5,19,0,111
5,13,16,20,15,18,25,0,0,112
5,13,16,21,18,16,12,5,0,106
5,13,16,21,18,16,12,5,4,110
5,13,16,21,18,16,12,5,19,125
5,13,16,21,26,26,12,5,0,124
5,13,18,1,21,4,0,0,0,62
5,13,18,15,4,5,0,0,0,60
5,13,21,12,1,2,12,5,0,71
5,13,21,12,1,14,20,0,0,86
5,13,21,12,1,20,5,0,0,77
5,13,21,12,1,20,5,4,0,81
5,13,21,12,1,20,5,19,0,96
5,13,21,12,1,20,9,14,7,102
5,13,21,12,1,20,9,15,14,110
5,13,21,12,1,20,9,22,5,108
5,13,21,12,1,20,15,18,0,105
5,13,21,12,1,20,15,18,25,130
5,13,21,12,1,20,15,18,19,124
5,13,21,12,5,0,0,0,0,56
5,13,21,12,7,5,0,0,0,63
5,13,21,12,7,5,14,3,5,85
5,13,21,12,7,5,14,19,0,96
5,13,21,12,7,5,14,20,0,97
5,13,21,12,15,21,19,0,0,106
5,13,21,12,15,21,19,12,25,143
5,13,21,12,19,0,0,0,0,70
5,13,21,12,19,9,2,12,5,98
5,13,21,12,19,9,3,0,0,82
5,13,21,12,19,9,6,25,0,110
5,13,21,12,19,9,14,0,0,93
5,13,21,12,19,9,15,14,0,108
5,13,21,12,19,9,15,14,19,127
5,13,21,12,19,9,22,5,0,106
5,13,21,12,19,15,9,4,0,98
5,13,21,12,19,15,9,4,19,117
5,13,21,12,19,15,18,0,0,103
5,13,21,14,3,20,0,0,0,76
5,13,21,14,3,20,15,18,25,134
5,13,21,14,7,5,0,0,0,65
5,13,21,19,0,0,0,0,0,58
5,13,21,19,9,6,25,0,0,98
5,13,21,19,9,6,9,5,4,91
5,13,21,19,9,6,9,5,19,106
5,13,21,19,9,22,5,0,0,94
5,14,2,9,2,5,0,0,0,37
5,14,2,12,15,3,0,0,0,51
5,14,2,18,1,22,5,0,0,67
5,14,2,21,19,19,8,5,0,93
5,14,3,0,0,0,0,0,0,22
5,14,3,1,4,18,5,0,0,50
5,14,3,1,5,14,9,1,0,52
5,14,3,1,7,5,0,0,0,35
5,14,3,1,7,5,4,0,0,39
5,14,3,1,7,5,19,0,0,54
5,14,3,1,7,9,14,7,0,60
5,14,3,1,11,5,0,0,0,39
5,14,3,1,12,12,15,23,0,85
5,14,3,1,13,16,0,0,0,52
5,14,3,1,13,16,5,4,0,61
5,14,3,1,13,16,9,14,7,82
5,14,3,1,13,16,19,0,0,71
5,14,3,1,14,11,5,18,0,71
5,14,3,1,14,20,8,9,19,93
5,14,3,1,16,19,21,12,5,96
5,14,3,1,16,20,9,22,5,95
5,14,3,1,18,4,9,15,14,83
5,14,3,1,18,16,1,0,0,58
5,14,3,1,18,16,9,0,0,66
5,14,3,1,18,16,9,21,13,100
5,14,3,1,18,16,21,19,0,97
5,14,3,1,19,5,0,0,0,47
5,14,3,1,19,5,4,0,0,51
5,14,3,1,19,5,19,0,0,66
5,14,3,1,19,8,0,0,0,50
5,14,3,1,19,8,5,4,0,59
5,14,3,1,19,8,5,19,0,74
5,14,3,1,19,8,9,14,7,80
5,14,3,1,19,9,14,7,0,72
5,14,3,1,19,20,1,7,5,75
5,14,3,1,19,20,18,5,0,85
5,14,3,1,21,13,1,0,0,58
5,14,3,1,21,19,20,5,19,107
5,14,3,1,21,19,20,9,3,95
5,14,3,1,22,5,0,0,0,50
5,14,3,5,0,0,0,0,0,27
5,14,3,5,6,1,12,15,14,75
5,14,3,5,9,14,20,0,0,70
5,14,3,5,9,14,20,5,0,75
5,14,3,5,9,14,20,5,19,94
5,14,3,5,12,12,0,0,0,51
5,14,3,5,14,19,5,0,0,65
5,14,3,5,14,20,5,18,0,84
5,14,3,5,16,8,1,12,1,65
5,14,3,8,1,6,5,0,0,42
5,14,3,8,1,9,14,0,0,54
5,14,3,8,1,9,14,5,4,63
5,14,3,8,1,9,14,19,0,73
5,14,3,8,1,9,18,0,0,58
5,14,3,8,1,12,9,3,5,60
5,14,3,8,1,14,14,5,12,76
5,14,3,8,1,14,20,0,0,65
5,14,3,8,1,14,20,5,4,74
5,14,3,8,1,14,20,5,18,88
5,14,3,8,1,14,20,19,0,84
5,14,3,8,1,18,7,5,0,61
5,14,3,8,1,18,7,5,4,65
5,14,3,8,1,18,13,0,0,62
5,14,3,8,1,18,14,5,12,80
5,14,3,8,1,19,5,0,0,55
5,14,3,8,1,19,5,4,0,59
5,14,3,8,1,19,5,18,0,73
5,14,3,8,1,19,5,18,19,92
5,14,3,8,1,19,5,19,0,74
5,14,3,8,1,19,9,14,7,80
5,14,3,8,1,19,20,5,14,89
5,14,3,8,5,1,19,15,14,84
5,14,3,8,5,1,20,0,0,56
5,14,3,8,5,3,11,0,0,49
5,14,3,8,5,5,18,0,0,58
5,14,3,8,5,9,18,9,1,72
5,14,3,8,5,17,21,5,18,96
5,14,3,8,5,19,15,14,0,83
5,14,3,8,5,19,15,21,14,104
5,14,3,8,5,19,20,0,0,74
5,14,3,8,9,12,1,4,1,57
5,14,3,8,25,12,5,13,1,86
5,14,3,8,25,13,1,0,0,69
5,14,3,8,9,19,5,12,0,75
5,14,3,8,25,20,18,1,5,99
5,14,3,8,15,18,9,1,12,85
5,14,3,8,15,18,9,3,0,75
5,14,3,8,21,18,3,8,0,80
5,14,3,25,0,0,0,0,0,47
5,14,3,9,1,0,0,0,0,32
5,14,3,25,3,0,0,0,0,50
5,14,3,25,3,12,0,0,0,62
5,14,3,25,3,12,9,3,0,74
5,14,3,25,3,12,9,3,19,93
5,14,3,9,5,14,20,5,0,75
5,14,3,9,14,1,19,0,0,65
5,14,3,9,14,4,5,18,0,72
5,14,3,9,14,9,12,12,15,93
5,14,3,9,16,8,5,18,0,78
5,14,3,9,16,8,5,18,19,97
5,14,3,9,18,3,12,5,0,69
5,14,3,9,18,3,12,5,4,73
5,14,3,9,18,3,12,5,18,87
5,14,3,9,18,3,12,5,19,88
5,14,3,25,18,20,9,4,0,98
5,14,3,9,19,20,0,0,0,70
5,14,3,25,19,20,0,0,0,86
5,14,3,25,19,20,5,4,0,95
5,14,3,25,19,20,9,14,7,116
5,14,3,25,19,20,19,0,0,105
5,14,3,9,20,1,4,5,12,73
5,14,3,12,0,0,0,0,0,34
5,14,3,12,1,18,5,20,0,78
5,14,3,12,1,19,16,0,0,70
5,14,3,12,1,19,16,5,4,79
5,14,3,12,1,19,16,19,0,89
5,14,3,12,1,22,5,0,0,62
5,14,3,12,1,22,5,4,0,66
5,14,3,12,1,22,5,19,0,81
5,14,3,12,1,22,9,14,7,87
5,14,3,12,5,1,18,0,0,58
5,14,3,12,9,19,9,19,0,90
5,14,3,12,9,20,9,3,0,75
5,14,3,12,9,20,9,3,19,94
5,14,3,12,15,1,11,0,0,61
5,14,3,12,15,7,0,0,0,56
5,14,3,12,15,19,5,0,0,73
5,14,3,12,15,19,5,4,0,77
5,14,3,12,15,19,5,18,0,91
5,14,3,12,15,19,5,18,19,110
5,14,3,12,15,19,5,19,0,92
5,14,3,12,15,19,9,14,7,98
5,14,3,12,15,19,21,18,5,112
5,14,3,12,15,20,8,5,0,82
5,14,3,12,15,21,4,0,0,74
5,14,3,15,1,3,8,0,0,49
5,14,3,15,4,5,0,0,0,46
5,14,3,15,4,5,4,0,0,50
5,14,3,15,4,5,18,0,0,64
5,14,3,15,4,5,18,19,0,83
5,14,3,15,4,5,19,0,0,65
5,14,3,15,4,9,14,7,0,71
5,14,3,15,4,9,14,7,19,90
5,14,3,15,6,6,9,14,0,72
5,14,3,15,9,12,0,0,0,58
5,14,3,15,12,4,5,14,0,72
5,14,3,15,12,12,1,18,0,80
5,14,3,15,12,15,18,0,0,82
5,14,3,15,12,15,21,18,0,103
5,14,3,15,12,16,9,1,0,75
5,14,3,15,12,16,9,15,14,103
5,14,3,15,12,21,13,14,0,97
5,14,3,15,12,21,18,5,0,93
5,14,3,15,13,25,0,0,0,75
5,14,3,15,13,9,1,0,0,60
5,14,3,15,13,9,1,19,20,99
5,14,3,15,13,9,3,0,0,62
5,14,3,15,13,9,13,9,1,82
5,14,3,15,13,9,21,13,0,93
5,14,3,15,13,9,21,13,19,112
5,14,3,15,13,13,15,14,0,92
5,14,3,15,13,16,1,14,25,106
5,14,3,15,13,16,1,19,19,105
5,14,3,15,15,16,0,0,0,68
5,14,3,15,18,5,0,0,0,60
5,14,3,15,18,5,4,0,0,64
5,14,3,15,18,5,19,0,0,79
5,14,3,15,18,9,14,7,0,85
5,14,3,15,18,15,14,1,12,97
5,14,3,15,18,15,14,5,20,109
5,14,3,15,18,16,15,18,5,109
5,14,3,15,21,14,20,5,18,115
5,14,3,15,21,18,1,7,5,89
5,14,3,15,22,5,18,0,0,82
5,14,3,15,23,12,0,0,0,72
5,14,3,18,1,1,12,0,0,54
5,14,3,18,1,4,12,5,0,62
5,14,3,18,1,14,9,1,12,77
5,14,3,18,1,20,25,0,0,86
5,14,3,18,5,1,19,5,0,70
5,14,3,18,5,5,12,0,0,62
5,14,3,18,9,13,19,15,14,110
5,14,3,18,9,14,1,12,0,76
5,14,3,18,9,14,9,3,0,75
5,14,3,18,9,14,9,20,5,97
5,14,3,18,9,14,15,9,4,91
5,14,3,18,25,16,20,0,0,101
5,14,3,18,25,16,20,5,4,110
5,14,3,18,25,16,20,19,0,120
5,14,3,18,9,19,16,0,0,84
5,14,3,18,15,1,3,8,0,67
5,14,3,18,15,23,14,0,0,92
5,14,3,18,21,19,20,0,0,100
5,14,3,18,21,19,20,5,4,109
5,14,3,18,21,19,20,19,0,119
5,14,3,21,13,2,5,18,0,81
5,14,3,21,13,2,5,18,19,100
5,14,3,21,16,0,0,0,0,59
5,14,3,21,18,12,0,0,0,73
5,14,3,21,18,20,1,9,14,105
5,14,3,21,19,8,9,15,14,108
5,14,4,0,0,0,0,0,0,23
5,14,4,1,2,12,5,0,0,43
5,14,4,1,13,1,7,5,0,50
5,14,4,1,13,1,7,5,4,54
5,14,4,1,13,1,7,5,19,69
5,14,4,1,13,1,19,11,0,68
5,14,4,1,13,5,2,1,0,45
5,14,4,1,13,5,2,1,5,50
5,14,4,1,13,5,2,1,19,64
5,14,4,1,13,5,2,9,3,56
5,14,4,1,13,14,9,6,25,91
5,14,4,1,14,7,5,18,0,68
5,14,4,1,14,7,5,18,19,87
5,14,4,1,14,7,9,21,13,88
5,14,4,1,15,18,20,9,3,89
5,14,4,1,18,3,8,0,0,53
5,14,4,1,18,3,8,25,0,78
5,14,4,1,18,11,0,0,0,53
5,14,4,1,19,5,8,0,0,56
5,14,4,1,26,5,0,0,0,55
5,14,4,2,1,12,12,0,0,50
5,14,4,2,15,1,18,4,0,63
5,14,4,2,18,1,9,14,0,67
5,14,4,2,18,1,9,14,19,86
5,14,4,4,1,13,1,7,5,54
5,14,4,5,0,0,0,0,0,28
5,14,4,5,1,18,0,0,0,47
5,14,4,5,1,18,5,4,0,56
5,14,4,5,1,18,9,14,7,77
5,14,4,5,1,18,19,0,0,66
5,14,4,5,1,22,15,18,19,103
5,14,4,5,1,22,15,21,18,105
5,14,4,5,2,20,0,0,0,50
5,14,4,5,3,8,1,0,0,40
5,14,4,5,4,0,0,0,0,32
5,14,4,5,9,3,20,9,3,72
5,14,4,5,9,7,14,0,0,58
5,14,4,5,13,9,1,12,0,63
5,14,4,5,13,9,3,0,0,53
5,14,4,5,13,9,3,1,12,66
5,14,4,5,13,9,3,19,0,72
5,14,4,5,13,9,19,13,0,82
5,14,4,5,13,9,19,13,19,101
5,14,4,5,14,9,26,5,0,82
5,14,4,5,14,9,26,5,14,96
5,14,4,5,14,20,0,0,0,62
5,14,4,5,18,5,0,0,0,51
5,14,4,5,18,13,9,3,0,71
5,14,4,5,18,15,14,0,0,75
5,14,4,5,18,15,14,9,3,87
5,14,4,5,22,9,12,0,0,71
5,14,4,5,23,0,0,0,0,51
5,14,4,5,24,9,14,5,0,80
5,14,4,5,24,9,14,5,19,99
5,14,4,6,9,12,5,0,0,55
5,14,4,7,1,13,5,0,0,49
5,14,4,7,1,13,5,19,0,68
5,14,4,7,1,20,5,0,0,56
5,14,4,8,1,14,4,0,0,50
5,14,4,9,1,0,0,0,0,33
5,14,4,9,1,2,12,5,5,57
5,14,4,9,1,4,5,13,0,55
5,14,4,9,1,16,5,18,0,72
5,14,4,9,3,20,0,0,0,55
5,14,4,25,13,1,0,0,0,62
5,14,4,25,13,1,12,0,0,74
5,14,4,9,14,7,0,0,0,53
5,14,4,9,14,7,19,0,0,72
5,14,4,25,19,9,19,0,0,95
5,14,4,9,20,5,0,0,0,57
5,14,4,9,20,5,4,0,0,61
5,14,4,9,20,5,19,0,0,76
5,14,4,9,20,9,14,7,0,82
5,14,4,9,22,5,0,0,0,59
5,14,4,9,22,5,19,0,0,78
5,14,4,10,21,14,11,0,0,79
5,14,4,12,5,1,6,0,0,47
5,14,4,12,5,1,22,5,19,87
5,14,4,12,5,19,19,0,0,78
5,14,4,12,5,19,19,12,25,115
5,14,4,12,15,14,7,0,0,71
5,14,4,13,15,19,20,0,0,90
5,14,4,14,15,20,5,0,0,77
5,14,4,14,15,20,5,19,0,96
5,14,4,15,2,12,1,19,20,92
5,14,4,15,3,1,18,16,0,76
5,14,4,15,3,1,18,16,19,95
5,14,4,15,3,1,19,20,0,81
5,14,4,15,3,25,3,12,5,86
5,14,4,15,3,25,19,20,0,105
5,14,4,15,3,25,20,9,3,98
5,14,4,15,3,12,9,14,5,81
5,14,4,15,3,15,5,12,5,78
5,14,4,15,3,15,14,5,0,75
5,14,4,15,3,18,9,14,0,82
5,14,4,15,3,18,9,14,5,87
5,14,4,15,4,5,18,13,0,78
5,14,4,15,4,5,18,13,19,97
5,14,4,15,5,18,7,9,3,80
5,14,4,15,7,1,13,25,0,84
5,14,4,15,7,1,13,9,3,71
5,14,4,15,7,5,14,0,0,64
5,14,4,15,7,5,14,25,0,89
5,14,4,15,7,5,14,9,3,76
5,14,4,15,7,5,14,19,0,83
5,14,4,15,7,14,1,20,8,88
5,14,4,15,12,5,13,13,1,82
5,14,4,15,12,25,13,16,8,112
5,14,4,15,12,25,19,9,14,117
5,14,4,15,13,5,0,0,0,56
5,14,4,15,13,5,20,18,25,119
5,14,4,15,13,9,24,9,19,112
5,14,4,15,13,15,18,16,8,108
5,14,4,15,16,8,1,7,25,95
5,14,4,15,16,8,25,20,5,112
5,14,4,15,16,12,1,19,13,99
5,14,4,15,16,12,1,19,20,106
5,14,4,15,16,15,4,0,0,73
5,14,4,15,16,15,4,19,0,92
5,14,4,15,16,18,15,3,20,110
5,14,4,15,18,1,12,0,0,69
5,14,4,15,18,5,0,0,0,61
5,14,4,15,18,16,8,9,14,103
5,14,4,15,18,19,5,0,0,80
5,14,4,15,18,19,5,4,0,84
5,14,4,15,18,19,5,5,0,85
5,14,4,15,18,19,5,5,19,104
5,14,4,15,18,19,5,18,0,98
5,14,4,15,18,19,5,18,19,117
5,14,4,15,18,19,5,19,0,99
5,14,4,15,18,19,9,14,7,105
5,14,4,15,18,19,15,18,0,108
5,14,4,15,18,19,15,18,19,127
5,14,4,15,19,1,18,3,0,79
5,14,4,15,19,1,18,3,19,98
5,14,4,15,19,3,15,16,5,96
5,14,4,15,19,3,15,16,25,116
5,14,4,15,19,13,9,3,0,82
5,14,4,15,19,13,15,19,0,104
5,14,4,15,19,13,15,19,5,109
5,14,4,15,19,15,13,5,0,90
5,14,4,15,19,15,13,5,19,109
5,14,4,15,19,16,5,18,13,109
5,14,4,15,19,16,15,18,5,111
5,14,4,15,19,19,0,0,0,76
5,14,4,15,19,20,5,1,0,83
5,14,4,15,19,20,5,1,12,95
5,14,4,15,19,20,5,21,13,116
5,14,4,15,19,20,25,12,5,119
5,14,4,15,19,20,15,13,1,106
5,14,4,15,19,20,15,13,5,110
5,14,4,15,20,8,5,3,1,75
5,14,4,15,20,8,5,18,13,102
5,14,4,15,20,8,25,19,0,110
5,14,4,15,20,25,19,0,0,102
5,14,4,15,20,15,24,9,3,109
5,14,4,15,20,15,24,9,14,120
5,14,4,15,21,2,20,0,0,81
5,14,4,15,21,20,5,0,0,84
5,14,4,15,22,5,18,0,0,83
5,14,4,15,23,0,0,0,0,61
5,14,4,15,23,5,4,0,0,70
5,14,4,15,23,5,18,0,0,84
5,14,4,15,23,5,18,19,0,103
5,14,4,15,23,9,14,7,0,91
5,14,4,15,23,13,5,14,20,113
5,14,4,15,23,19,0,0,0,80
5,14,4,15,26,15,1,0,0,80
5,14,4,15,26,15,9,3,0,91
5,14,4,16,1,16,5,18,0,79
5,14,4,16,1,16,5,18,19,98
5,14,4,16,9,5,3,5,0,61
5,14,4,16,12,1,25,0,0,77
5,14,4,16,12,1,20,5,0,77
5,14,4,16,12,1,20,5,19,96
5,14,4,16,15,9,14,20,0,97
5,14,4,16,15,9,14,20,19,116
5,14,4,18,9,14,0,0,0,64
5,14,4,18,9,14,19,0,0,83
5,14,4,18,21,4,7,5,0,78
5,14,4,18,21,13,16,6,0,97
5,14,4,19,0,0,0,0,0,42
5,14,4,19,5,1,12,0,0,60
5,14,4,19,8,1,11,5,0,67
5,14,4,19,8,5,5,20,0,80
5,14,4,19,8,9,16,0,0,75
5,14,4,19,23,5,5,16,0,91
5,14,4,21,5,0,0,0,0,49
5,14,4,21,5,4,0,0,0,53
5,14,4,21,5,13,5,14,20,101
5,14,4,21,5,19,0,0,0,68
5,14,4,21,9,14,7,0,0,74
5,14,4,21,14,7,5,15,14,99
5,14,4,21,18,1,0,0,0,63
5,14,4,21,18,1,2,12,5,82
5,14,4,21,18,1,2,12,25,102
5,14,4,21,18,1,14,3,5,85
5,14,4,21,18,1,14,20,0,97
5,14,4,21,18,5,0,0,0,67
5,14,4,21,18,5,4,0,0,71
5,14,4,21,18,5,18,0,0,85
5,14,4,21,18,5,19,0,0,86
5,14,4,21,18,9,14,7,0,92
5,14,4,21,18,15,0,0,0,77
5,14,4,21,18,15,19,0,0,96
5,14,4,23,1,25,19,0,0,91
5,14,4,23,9,19,5,0,0,79
5,14,5,0,0,0,0,0,0,24
5,14,5,3,1,20,5,0,0,53
5,14,5,3,12,1,14,14,0,68
5,14,5,4,0,0,0,0,0,28
5,14,5,9,4,0,0,0,0,37
5,14,5,13,1,0,0,0,0,38
5,14,5,13,1,19,0,0,0,57
5,14,5,13,1,20,1,0,0,59
5,14,5,13,25,0,0,0,0,62
5,14,5,13,9,5,4,0,0,55
5,14,5,13,9,5,19,0,0,70
5,14,5,13,25,9,14,7,0,92
5,14,5,13,25,12,9,11,5,99
5,14,5,13,25,19,8,9,16,114
5,14,5,14,20,0,0,0,0,58
5,14,5,18,7,5,9,1,0,64
5,14,5,18,7,5,19,9,19,101
5,14,5,18,7,5,20,9,3,86
5,14,5,18,7,25,0,0,0,74
5,14,5,18,7,9,3,0,0,61
5,14,5,18,7,9,3,1,12,74
5,14,5,18,7,9,3,15,0,76
5,14,5,18,7,9,4,0,0,62
5,14,5,18,7,9,4,19,0,81
5,14,5,18,7,9,5,19,0,82
5,14,5,18,7,9,19,5,0,82
5,14,5,18,7,9,19,5,4,86
5,14,5,18,7,9,19,5,18,100
5,14,5,18,7,9,19,5,19,101
5,14,5,18,7,9,19,13,0,90
5,14,5,18,7,9,19,20,0,97
5,14,5,18,7,9,26,5,0,89
5,14,5,18,7,9,26,5,4,93
5,14,5,18,7,9,26,5,18,107
5,14,5,18,7,9,26,5,19,108
5,14,5,18,7,21,13,5,14,102
5,14,5,18,22,1,20,5,0,90
5,14,5,18,22,1,20,5,4,94
5,14,5,18,22,1,20,5,19,109
5,14,5,18,22,1,20,15,18,118
5,14,5,18,22,5,0,0,0,69
5,14,5,18,22,15,21,19,0,119
5,14,5,21,3,8,0,0,0,56
5,14,5,21,7,8,0,0,0,60
5,14,5,23,0,0,0,0,0,47
5,14,6,1,3,5,0,0,0,34
5,14,6,1,3,5,4,0,0,38
5,14,6,1,3,5,19,0,0,53
5,14,6,1,3,9,14,7,0,59
5,14,6,1,13,9,19,8,0,75
5,14,6,1,13,15,21,19,0,94
5,14,6,1,14,20,0,0,0,60
5,14,6,1,14,20,19,0,0,79
5,14,6,1,18,3,5,0,0,52
5,14,6,1,19,20,5,14,0,84
5,14,6,1,20,9,3,15,0,73
5,14,6,1,22,15,18,0,0,81
5,14,6,5,1,20,21,18,5,95
5,14,6,5,3,20,0,0,0,53
5,14,6,5,5,2,12,5,0,54
5,14,6,5,5,2,12,5,4,58
5,14,6,5,5,2,12,5,18,72
5,14,6,5,5,2,12,5,19,73
5,14,6,5,12,15,14,0,0,71
5,14,6,5,15,6,6,0,0,57
5,14,6,5,15,6,6,5,4,66
5,14,6,5,15,6,6,19,0,76
5,14,6,5,19,20,5,18,0,92
5,14,6,5,20,20,5,18,0,93
5,14,6,5,20,20,5,18,19,112
5,14,6,5,22,5,18,0,0,75
5,14,6,5,22,5,18,5,4,84
5,14,6,5,22,5,18,19,0,94
5,14,6,9,5,6,0,0,0,45
5,14,6,9,5,18,3,5,0,65
5,14,6,9,7,21,18,5,0,85
5,14,6,9,12,1,4,5,0,56
5,14,6,9,12,1,4,5,4,60
5,14,6,9,12,1,4,5,19,75
5,14,6,9,12,5,0,0,0,51
5,14,6,9,12,5,4,0,0,55
5,14,6,9,14,0,0,0,0,48
5,14,6,9,18,5,0,0,0,57
5,14,6,9,18,13,0,0,0,65
5,14,6,12,1,13,5,0,0,56
5,14,6,12,1,13,5,4,0,60
5,14,6,12,1,13,5,19,0,75
5,14,6,12,1,13,9,14,7,81
5,14,6,12,5,19,8,0,0,69
5,14,6,12,15,23,5,18,0,98
5,14,6,15,9,12,0,0,0,61
5,14,6,15,12,4,0,0,0,56
5,14,6,15,12,4,5,4,0,65
5,14,6,15,12,4,5,14,0,75
5,14,6,15,12,4,5,18,0,79
5,14,6,15,12,4,5,18,19,98
5,14,6,15,12,4,9,14,7,86
5,14,6,15,12,4,19,0,0,75
5,14,6,15,12,12,15,23,0,102
5,14,6,15,14,3,5,0,0,62
5,14,6,15,14,3,5,4,0,66
5,14,6,15,14,3,5,5,0,67
5,14,6,15,18,3,5,0,0,66
5,14,6,15,18,3,5,4,0,70
5,14,6,15,18,3,5,18,0,84
5,14,6,15,18,3,5,18,19,103
5,14,6,15,18,3,5,19,0,85
5,14,6,15,18,3,9,14,7,91
5,14,6,15,18,3,9,22,5,97
5,14,6,15,18,5,19,20,0,102
5,14,6,15,18,11,0,0,0,69
5,14,6,15,18,13,0,0,0,71
5,14,6,15,18,20,0,0,0,78
5,14,6,15,18,20,8,0,0,86
5,14,6,15,18,20,21,14,5,118
5,14,6,15,21,12,0,0,0,73
5,14,6,15,21,12,4,5,18,100
5,14,6,18,1,9,0,0,0,53
5,14,6,18,1,13,5,0,0,62
5,14,6,18,1,13,5,4,0,66
5,14,6,18,1,13,5,19,0,81
5,14,6,18,1,13,9,14,7,87
5,14,6,18,1,14,3,8,0,69
5,14,6,18,5,5,0,0,0,53
5,14,6,18,5,14,26,25,0,113
5,14,6,18,15,23,1,18,4,104
5,14,6,21,4,4,12,5,0,71
5,14,6,21,13,5,0,0,0,64
5,14,6,21,18,18,15,23,0,120
5,14,7,1,7,5,0,0,0,39
5,14,7,1,7,5,4,0,0,43
5,14,7,1,7,5,4,12,25,80
5,14,7,1,7,5,5,0,0,44
5,14,7,1,7,5,18,0,0,57
5,14,7,1,7,5,18,19,0,76
5,14,7,1,7,5,19,0,0,58
5,14,7,1,7,9,14,7,0,64
5,14,7,1,12,12,1,14,20,86
5,14,7,1,15,12,0,0,0,54
5,14,7,1,18,2,0,0,0,47
5,14,7,1,18,2,12,5,0,64
5,14,7,1,18,4,5,0,0,54
5,14,7,1,18,12,1,14,4,76
5,14,7,1,18,13,5,14,20,97
5,14,7,1,21,4,0,0,0,52
5,14,7,1,26,5,0,0,0,58
5,14,7,5,12,13,1,14,14,85
5,14,7,5,13,0,0,0,0,44
5,14,7,5,14,4,5,18,0,72
5,14,7,5,14,4,5,18,19,91
5,14,7,5,14,4,21,18,5,93
5,14,7,8,12,5,0,0,0,51
5,14,7,8,15,19,20,5,4,97
5,14,7,9,12,4,0,0,0,51
5,14,7,9,12,4,5,4,0,60
5,14,7,9,12,4,9,14,7,81
5,14,7,9,12,4,19,0,0,70
5,14,7,9,14,0,0,0,0,49
5,14,7,9,14,5,0,0,0,54
5,14,7,9,14,5,4,0,0,58
5,14,7,9,14,5,5,18,0,77
5,14,7,9,14,5,5,18,25,102
5,14,7,9,14,5,5,18,19,96
5,14,7,9,14,5,13,1,14,82
5,14,7,9,14,5,13,5,14,86
5,14,7,9,14,5,18,25,0,97
5,14,7,9,14,5,19,0,0,73
5,14,7,9,14,9,14,7,0,79
5,14,7,9,14,15,21,19,0,104
5,14,7,9,18,4,0,0,0,57
5,14,7,9,18,4,5,4,0,66
5,14,7,9,18,4,9,14,7,87
5,14,7,9,18,4,12,5,0,74
5,14,7,9,18,4,12,5,4,78
5,14,7,9,18,4,12,5,19,93
5,14,7,9,18,4,19,0,0,76
5,14,7,9,18,20,0,0,0,73
5,14,7,9,19,3,15,16,5,93
5,14,7,25,19,3,15,16,5,109
5,14,7,12,0,0,0,0,0,38
5,14,7,12,1,3,9,1,12,64
5,14,7,12,1,4,0,0,0,43
5,14,7,12,1,4,4,5,14,66
5,14,7,12,1,14,20,5,0,78
5,14,7,12,5,9,13,0,0,65
5,14,7,12,25,14,0,0,0,77
5,14,7,12,25,14,19,0,0,96
5,14,7,12,9,19,8,5,4,83
5,14,7,12,9,19,8,5,19,98
5,14,7,12,15,2,5,0,0,60
5,14,7,12,15,2,5,4,0,64
5,14,7,12,15,2,9,14,7,85
5,14,7,12,15,15,13,0,0,81
5,14,7,12,15,18,25,0,0,96
5,14,7,12,21,5,0,0,0,64
5,14,7,12,21,20,0,0,0,79
5,14,7,12,21,20,5,0,0,84
5,14,7,12,21,20,19,0,0,98
5,14,7,12,21,20,20,5,4,108
5,14,7,15,2,5,0,0,0,48
5,14,7,15,12,4,0,0,0,57
5,14,7,15,12,4,5,14,0,76
5,14,7,15,18,5,0,0,0,64
5,14,7,15,18,7,5,0,0,71
5,14,7,15,18,7,5,4,0,75
5,14,7,15,18,7,5,19,0,90
5,14,7,15,18,7,9,14,7,96
5,14,7,15,21,5,0,0,0,67
5,14,7,15,21,5,5,0,0,72
5,14,7,15,21,12,5,4,0,83
5,14,7,15,21,13,5,14,20,114
5,14,7,18,0,0,0,0,0,44
5,14,7,18,1,3,5,0,0,53
5,14,7,18,1,3,5,4,0,57
5,14,7,18,1,3,9,14,7,78
5,14,7,18,1,6,6,0,0,57
5,14,7,18,1,6,6,5,4,66
5,14,7,18,1,6,20,0,0,71
5,14,7,18,1,6,20,5,4,80
5,14,7,18,1,6,20,5,18,94
5,14,7,18,1,6,20,19,0,90
5,14,7,18,1,9,12,0,0,66
5,14,7,18,1,9,12,5,4,75
5,14,7,18,1,9,12,19,0,85
5,14,7,18,1,9,14,0,0,68
5,14,7,18,1,9,14,5,4,77
5,14,7,18,1,9,14,5,18,91
5,14,7,18,1,9,14,19,0,87
5,14,7,18,1,13,0,0,0,58
5,14,7,18,1,13,13,1,0,72
5,14,7,18,1,13,13,5,0,76
5,14,7,18,1,13,13,5,19,95
5,14,7,18,1,13,13,9,3,83
5,14,7,18,1,13,19,0,0,77
5,14,7,18,1,16,8,25,0,94
5,14,7,18,1,16,8,9,1,79
5,14,7,18,1,16,8,9,3,81
5,14,7,18,1,16,16,12,5,94
5,14,7,18,1,19,16,0,0,80
5,14,7,18,1,22,5,0,0,72
5,14,7,18,1,22,5,4,0,76
5,14,7,18,1,22,5,14,0,86
5,14,7,18,1,22,5,18,0,90
5,14,7,18,1,22,5,18,19,109
5,14,7,18,1,22,5,19,0,91
5,14,7,18,1,22,9,14,7,97
5,14,7,18,5,1,20,5,14,89
5,14,7,18,5,5,14,0,0,68
5,14,7,18,5,7,5,0,0,61
5,14,7,18,5,7,7,5,0,68
5,14,7,18,9,4,0,0,0,57
5,14,7,18,9,5,22,5,0,85
5,14,7,18,15,15,22,5,0,101
5,14,7,18,15,19,19,0,0,97
5,14,7,18,15,19,19,5,4,106
5,14,7,18,15,19,19,5,18,120
5,14,7,18,15,19,19,5,19,121
5,14,7,19,0,0,0,0,0,45
5,14,7,21,1,18,4,0,0,70
5,14,7,21,12,6,0,0,0,65
5,14,7,21,12,6,5,4,0,74
5,14,7,21,12,6,9,14,7,95
5,14,7,21,12,6,19,0,0,84
5,14,8,1,12,12,15,23,0,90
5,14,8,1,12,15,0,0,0,55
5,14,8,1,12,15,5,4,0,64
5,14,8,1,12,15,5,19,0,79
5,14,8,1,12,15,9,14,7,85
5,14,8,1,12,15,19,0,0,74
5,14,8,1,13,16,5,18,0,80
5,14,8,1,14,3,5,0,0,50
5,14,8,1,14,3,5,4,0,54
5,14,8,1,14,3,5,18,0,68
5,14,8,1,14,3,5,18,19,87
5,14,8,1,14,3,5,19,0,69
5,14,8,1,14,3,9,14,7,75
5,14,8,1,14,3,9,22,5,81
5,14,8,1,16,16,25,0,0,85
5,14,8,1,18,2,15,18,0,81
5,14,8,1,18,2,15,21,18,102
5,14,8,1,18,4,5,14,0,69
5,14,8,1,18,4,25,0,0,75
5,14,8,1,20,0,0,0,0,48
5,14,8,1,21,12,19,5,0,85
5,14,8,1,21,14,20,0,0,83
5,14,8,1,26,1,18,4,0,77
5,14,8,5,1,18,19,5,0,75
5,14,8,5,1,18,20,0,0,71
5,14,8,5,1,18,20,5,14,90
5,14,8,5,1,22,5,14,0,74
5,14,8,5,4,7,5,0,0,48
5,14,8,5,12,13,0,0,0,57
5,14,8,5,18,9,20,0,0,79
5,14,8,25,4,18,9,20,5,108
5,14,8,25,4,18,15,19,0,108
5,14,8,25,4,18,15,21,19,129
5,14,8,15,18,18,15,18,0,111
5,14,8,15,18,20,0,0,0,80
5,14,8,21,9,12,5,0,0,74
5,14,8,21,14,7,5,18,0,92
5,14,8,21,19,11,0,0,0,78
5,14,9,7,13,1,0,0,0,49
5,14,9,7,13,1,19,0,0,68
5,14,9,7,13,1,20,1,0,70
5,14,9,7,13,1,20,9,3,81
5,14,9,7,21,1,0,0,0,57
5,14,9,19,12,5,0,0,0,64
5,14,9,19,12,5,4,0,0,68
5,14,9,19,12,5,19,0,0,83
5,14,9,19,12,9,14,7,0,89
5,14,10,1,9,12,0,0,0,51
5,14,10,1,13,2,0,0,0,45
5,14,10,1,13,2,5,4,0,54
5,14,10,5,12,12,25,0,0,83
5,14,10,5,15,16,1,18,4,88
5,14,10,5,23,5,12,0,0,74
5,14,10,15,25,0,0,0,0,69
5,14,10,15,25,1,2,12,5,89
5,14,10,15,25,1,2,12,25,109
5,14,10,15,25,5,4,0,0,78
5,14,10,15,25,5,18,0,0,92
5,14,10,15,25,5,18,19,0,111
5,14,10,15,25,9,14,7,0,99
5,14,10,15,25,13,5,14,20,121
5,14,10,15,9,14,0,0,0,67
5,14,10,15,9,14,4,5,18,94
5,14,10,15,9,14,5,4,0,76
5,14,10,15,9,14,5,18,0,90
5,14,10,15,9,14,5,18,19,109
5,14,10,15,9,14,9,14,7,97
5,14,10,15,9,14,19,0,0,86
5,14,10,15,25,19,0,0,0,88
5,14,11,5,14,14,5,12,0,80
5,14,11,5,18,14,5,12,0,84
5,14,11,9,14,4,12,5,0,74
5,14,11,9,14,4,12,5,4,78
5,14,11,9,14,4,12,5,18,92
5,14,11,9,14,4,12,5,19,93
5,14,11,15,12,16,9,1,0,83
5,14,11,15,12,16,9,15,14,111
5,14,11,18,1,1,12,0,0,62
5,14,12,0,0,0,0,0,0,31
5,14,12,1,3,5,0,0,0,40
5,14,12,1,3,5,4,0,0,44
5,14,12,1,3,5,19,0,0,59
5,14,12,1,3,9,14,7,0,65
5,14,12,1,25,0,0,0,0,57
5,14,12,1,18,4,0,0,0,54
5,14,12,1,18,7,5,0,0,62
5,14,12,1,18,7,5,4,0,66
5,14,12,1,18,7,5,18,0,80
5,14,12,1,18,7,5,18,19,99
5,14,12,1,18,7,5,19,0,81
5,14,12,1,18,7,9,14,7,87
5,14,12,1,21,18,5,12,0,88
5,14,12,5,1,6,0,0,0,43
5,14,12,5,1,7,21,5,0,70
5,14,12,5,1,7,21,5,4,74
5,14,12,5,5,14,0,0,0,55
5,14,12,5,14,7,20,8,0,85
5,14,12,9,5,6,0,0,0,51
5,14,12,9,6,5,0,0,0,51
5,14,12,9,7,8,20,0,0,75
5,14,12,9,7,8,20,5,14,94
5,14,12,9,13,14,0,0,0,67
5,14,12,9,14,11,0,0,0,65
5,14,12,9,14,11,5,4,0,74
5,14,12,9,14,11,9,14,7,95
5,14,12,9,19,20,0,0,0,79
5,14,12,9,19,20,5,4,0,88
5,14,12,9,19,20,5,5,0,89
5,14,12,9,19,20,5,5,19,108
5,14,12,9,19,20,5,18,0,102
5,14,12,9,19,20,5,18,19,121
5,14,12,9,19,20,9,14,7,109
5,14,12,9,19,20,19,0,0,98
5,14,12,9,22,5,0,0,0,67
5,14,12,9,22,5,14,0,0,81
5,14,12,9,22,5,14,5,4,90
5,14,12,9,22,5,14,5,18,104
5,14,12,9,22,5,14,19,0,100
5,14,12,15,3,11,0,0,0,60
5,14,12,15,4,7,5,0,0,62
5,14,12,21,13,9,14,5,0,93
5,14,12,21,18,5,0,0,0,75
5,14,12,21,20,5,0,0,0,77
5,14,13,1,14,3,8,5,0,63
5,14,13,1,18,2,12,5,0,70
5,14,13,1,18,2,12,5,4,74
5,14,13,1,19,11,0,0,0,63
5,14,13,1,19,19,0,0,0,71
5,14,13,5,19,8,0,0,0,64
5,14,13,5,19,8,5,4,0,73
5,14,13,5,19,8,5,19,0,88
5,14,13,5,19,8,9,14,7,94
5,14,13,5,23,0,0,0,0,60
5,14,13,9,19,20,0,0,0,80
5,14,13,9,20,25,0,0,0,86
5,14,13,9,20,9,5,19,0,94
5,14,13,15,19,19,0,0,0,85
5,14,13,15,22,5,0,0,0,74
5,14,13,21,6,6,12,5,0,82
5,14,14,1,7,5,0,0,0,46
5,14,14,5,1,4,0,0,0,43
5,14,14,5,1,4,9,3,0,55
5,14,14,5,1,4,19,0,0,62
5,14,14,5,1,7,15,14,0,75
5,14,14,5,1,7,15,14,19,94
5,14,14,5,1,20,9,3,0,71
5,14,14,5,4,18,1,0,0,61
5,14,14,5,18,22,5,0,0,83
5,14,14,5,23,0,0,0,0,61
5,14,14,9,1,0,0,0,0,43
5,14,14,9,3,8,5,0,0,58
5,14,14,15,2,12,5,0,0,67
5,14,14,15,2,12,5,4,0,71
5,14,14,15,2,12,5,18,0,85
5,14,14,15,2,12,5,18,19,104
5,14,14,15,2,12,5,19,0,86
5,14,14,15,2,12,9,14,7,92
5,14,14,15,25,0,0,0,0,73
5,14,14,15,9,3,0,0,0,60
5,14,14,15,13,9,3,0,0,73
5,14,14,21,9,0,0,0,0,63
5,14,14,21,25,1,14,20,0,114
5,14,14,21,25,1,14,20,5,119
5,14,14,21,25,5,0,0,0,84
5,14,14,21,9,5,4,0,0,72
5,14,14,21,25,5,5,0,0,89
5,14,14,21,25,9,14,7,0,109
5,14,14,21,9,19,0,0,0,82
5,14,15,3,25,20,5,0,0,87
5,14,15,4,1,12,0,0,0,51
5,14,15,4,1,12,12,25,0,88
5,14,15,4,1,20,5,0,0,64
5,14,15,4,1,20,9,15,14,97
5,14,15,4,5,0,0,0,0,43
5,14,15,9,12,0,0,0,0,55
5,14,15,9,14,20,0,0,0,77
5,14,15,12,0,0,0,0,0,46
5,14,15,12,1,19,5,0,0,71
5,14,15,12,1,19,5,19,0,90
5,14,15,12,1,20,5,0,0,72
5,14,15,12,9,3,0,0,0,58
5,14,15,12,9,26,5,0,0,86
5,14,15,12,9,26,5,4,0,90
5,14,15,12,9,26,9,14,7,111
5,14,15,12,15,7,25,0,0,93
5,14,15,12,15,7,9,5,19,101
5,14,15,12,15,7,9,19,20,116
5,14,15,12,19,0,0,0,0,65
5,14,15,13,1,14,9,1,0,72
5,14,15,13,1,14,9,1,3,75
5,14,15,13,15,20,25,0,0,107
5,14,15,16,12,1,14,0,0,77
5,14,15,16,12,9,15,14,0,100
5,14,15,18,7,1,14,9,3,86
5,14,15,18,13,0,0,0,0,65
5,14,15,18,13,9,15,21,19,129
5,14,15,18,13,9,20,25,0,119
5,14,15,18,13,15,21,19,0,120
5,14,15,18,14,0,0,0,0,66
5,14,15,19,9,19,0,0,0,81
5,14,15,19,9,19,5,19,0,105
5,14,15,19,9,19,20,0,0,101
5,14,15,19,20,15,19,9,19,135
5,14,15,21,7,8,0,0,0,70
5,14,15,21,7,8,19,0,0,89
5,14,15,21,14,3,5,0,0,77
5,14,15,21,14,3,5,4,0,81
5,14,15,21,14,3,5,19,0,96
5,14,15,21,14,3,9,14,7,102
5,14,15,23,0,0,0,0,0,57
5,14,15,23,19,0,0,0,0,76
5,14,16,9,1,0,0,0,0,45
5,14,16,12,1,14,5,0,0,67
5,14,16,12,1,14,5,4,0,71
5,14,16,12,1,14,5,19,0,86
5,14,16,12,1,14,9,14,7,92
5,14,17,21,1,18,20,5,18,119
5,14,17,21,5,18,5,0,0,85
5,14,17,21,5,21,5,0,0,88
5,14,17,21,5,21,5,4,0,92
5,14,17,21,5,21,5,19,0,107
5,14,17,21,9,3,11,5,14,99
5,14,17,21,9,18,5,0,0,89
5,14,17,21,9,18,5,4,0,93
5,14,17,21,9,18,5,18,0,107
5,14,17,21,9,18,5,19,0,108
5,14,17,21,9,18,25,0,0,109
5,14,17,21,9,18,9,5,19,117
5,14,17,21,9,18,9,14,7,114
5,14,18,1,3,5,0,0,0,46
5,14,18,1,7,5,0,0,0,50
5,14,18,1,7,5,4,0,0,54
5,14,18,1,7,5,4,12,25,91
5,14,18,1,7,5,19,0,0,69
5,14,18,1,7,9,14,7,0,75
5,14,18,1,25,0,0,0,0,63
5,14,18,1,9,12,0,0,0,59
5,14,18,1,13,1,4,1,0,57
5,14,18,1,14,7,5,0,0,64
5,14,18,1,14,11,0,0,0,63
5,14,18,1,16,20,0,0,0,74
5,14,18,1,16,20,5,4,0,83
5,14,18,1,16,20,9,14,7,104
5,14,18,1,16,20,19,0,0,93
5,14,18,1,16,20,21,18,5,118
5,14,18,1,22,9,19,8,0,96
5,14,18,8,5,21,13,0,0,84
5,14,18,9,2,0,0,0,0,48
5,14,18,9,3,8,0,0,0,57
5,14,18,9,3,8,5,4,0,66
5,14,18,9,3,8,5,18,0,80
5,14,18,9,3,8,5,18,19,99
5,14,18,9,3,8,5,19,0,81
5,14,18,9,3,8,9,14,7,87
5,14,18,9,4,7,5,4,0,66
5,14,18,9,7,8,20,0,0,81
5,14,18,9,14,7,0,0,0,67
5,14,18,9,14,7,5,4,0,76
5,14,18,9,14,7,9,14,7,97
5,14,18,9,16,5,14,0,0,81
5,14,18,9,22,5,0,0,0,73
5,14,18,15,2,5,0,0,0,59
5,14,18,15,2,5,4,0,0,63
5,14,18,15,2,5,18,0,0,77
5,14,18,15,2,5,18,19,0,96
5,14,18,15,2,5,19,0,0,78
5,14,18,15,2,9,14,7,0,84
5,14,18,15,12,0,0,0,0,64
5,14,18,15,12,12,0,0,0,76
5,14,18,15,12,12,5,0,0,81
5,14,18,15,12,12,5,4,0,85
5,14,18,15,12,12,5,5,0,86
5,14,18,15,12,12,5,5,19,105
5,14,18,15,12,12,5,18,0,99
5,14,18,15,12,12,5,18,19,118
5,14,18,15,12,12,5,19,0,100
5,14,18,15,12,12,9,14,7,106
5,14,18,15,12,12,19,0,0,95
5,14,18,15,12,13,5,14,20,116
5,14,18,15,12,19,0,0,0,83
5,14,18,15,15,20,0,0,0,87
5,14,18,15,15,20,5,4,0,96
5,14,18,15,15,20,9,14,7,117
5,14,18,15,15,20,19,0,0,106
5,14,18,15,21,7,8,0,0,88
5,14,18,15,21,14,4,0,0,91
5,14,18,21,9,14,0,0,0,81
5,14,18,21,20,0,0,0,0,78
5,14,19,1,6,5,0,0,0,50
5,14,19,1,6,6,18,15,14,98
5,14,19,1,9,14,20,0,0,82
5,14,19,1,12,1,4,1,0,57
5,14,19,1,13,16,12,5,0,85
5,14,19,1,13,16,12,5,18,103
5,14,19,1,13,16,12,5,19,104
5,14,19,1,14,4,0,0,0,57
5,14,19,1,14,4,1,12,0,70
5,14,19,1,20,5,0,0,0,64
5,14,19,3,1,12,5,0,0,59
5,14,19,3,5,14,5,0,0,65
5,14,19,3,15,14,3,5,0,78
5,14,19,3,15,14,3,5,4,82
5,14,19,3,15,14,3,5,19,97
5,14,19,3,18,15,12,12,0,98
5,14,19,3,18,15,12,12,19,117
5,14,19,5,0,0,0,0,0,43
5,14,19,5,1,12,0,0,0,56
5,14,19,5,1,12,5,4,0,65
5,14,19,5,1,12,9,14,7,86
5,14,19,5,1,13,0,0,0,57
5,14,19,5,1,18,0,0,0,62
5,14,19,5,1,18,3,8,0,73
5,14,19,5,1,20,0,0,0,64
5,14,19,5,1,20,5,4,0,73
5,14,19,5,1,20,9,14,7,94
5,14,19,5,5,12,0,0,0,60
5,14,19,5,5,13,0,0,0,61
5,14,19,5,12,12,21,18,5,111
5,14,19,5,13,2,12,5,0,75
5,14,19,5,13,2,12,5,19,94
5,14,19,5,18,1,16,8,0,86
5,14,19,5,18,6,0,0,0,67
5,14,19,5,18,6,5,4,0,76
5,14,19,5,18,6,9,14,7,97
5,14,19,5,18,6,19,0,0,86
5,14,19,5,20,5,0,0,0,68
5,14,19,8,1,4,5,0,0,56
5,14,19,8,1,4,15,23,0,89
5,14,19,8,1,23,12,0,0,82
5,14,19,8,5,1,20,8,0,80
5,14,19,8,5,1,20,8,5,85
5,14,19,8,5,1,20,8,19,99
5,14,19,8,5,12,12,0,0,75
5,14,19,8,5,12,20,5,18,106
5,14,19,8,9,5,12,4,0,76
5,14,19,8,18,9,14,5,0,92
5,14,19,8,18,9,14,5,4,96
5,14,19,8,18,9,14,5,19,111
5,14,19,8,18,15,21,4,0,104
5,14,19,8,18,15,21,4,19,123
5,14,19,9,5,14,20,0,0,86
5,14,19,9,6,15,18,13,0,99
5,14,19,9,7,14,3,25,0,96
5,14,19,9,7,14,5,4,0,77
5,14,19,9,7,14,9,14,7,98
5,14,19,9,7,14,18,25,0,111
5,14,19,9,7,14,19,0,0,87
5,14,19,9,12,1,7,5,0,72
5,14,19,9,12,1,7,5,4,76
5,14,19,9,12,1,7,5,19,91
5,14,19,9,12,1,20,5,0,85
5,14,19,9,12,5,0,0,0,64
5,14,19,9,12,5,4,0,0,68
5,14,19,9,12,5,19,0,0,83
5,14,19,9,12,9,14,7,0,89
5,14,19,9,12,9,19,20,0,107
5,14,19,9,12,22,5,18,0,104
5,14,19,9,14,4,15,14,0,94
5,14,19,11,25,0,0,0,0,74
5,14,19,11,9,5,4,0,0,67
5,14,19,11,25,5,4,0,0,83
5,14,19,11,9,5,19,0,0,82
5,14,19,11,25,9,14,7,0,104
5,14,19,12,1,22,5,0,0,78
5,14,19,12,1,22,5,4,0,82
5,14,19,12,1,22,5,18,0,96
5,14,19,12,1,22,5,18,19,115
5,14,19,12,1,22,5,19,0,97
5,14,19,12,1,22,9,14,7,103
5,14,19,12,21,13,2,5,18,109
5,14,19,13,1,12,12,0,0,76
5,14,19,14,1,18,5,0,0,76
5,14,19,14,1,18,5,4,0,80
5,14,19,14,1,18,5,18,0,94
5,14,19,14,1,18,5,18,19,113
5,14,19,14,1,18,5,19,0,95
5,14,19,14,1,18,9,14,7,101
5,14,19,14,1,18,12,0,0,83
5,14,19,14,1,18,12,5,4,92
5,14,19,14,1,18,12,19,0,102
5,14,19,14,15,23,0,0,0,90
5,14,19,15,2,5,18,0,0,78
5,14,19,15,16,8,9,3,0,89
5,14,19,15,18,3,5,12,0,91
5,14,19,15,18,3,5,12,12,103
5,14,19,15,18,3,5,12,19,110
5,14,19,15,18,18,15,23,0,127
5,14,19,15,21,12,0,0,0,86
5,14,19,15,21,12,5,4,0,95
5,14,19,15,21,12,9,14,7,116
5,14,19,15,21,12,19,0,0,105
5,14,19,16,1,14,7,12,5,93
5,14,19,16,5,12,12,0,0,83
5,14,19,16,8,5,18,5,0,90
5,14,19,16,8,5,18,5,4,94
5,14,19,16,8,5,18,5,19,109
5,14,19,16,9,18,9,20,0,110
5,14,19,16,15,18,9,1,0,97
5,14,19,20,1,13,16,0,0,88
5,14,19,20,1,18,0,0,0,77
5,14,19,20,1,20,5,0,0,84
5,14,19,20,1,20,9,20,5,113
5,14,19,20,5,5,12,0,0,80
5,14,19,20,5,5,16,0,0,84
5,14,19,20,25,12,5,0,0,100
5,14,19,20,15,15,12,0,0,100
5,14,19,20,15,18,5,0,0,96
5,14,19,21,1,2,12,5,0,79
5,14,19,21,1,14,3,5,0,82
5,14,19,21,1,14,20,0,0,94
5,14,19,21,5,0,0,0,0,64
5,14,19,21,5,4,0,0,0,68
5,14,19,21,5,18,0,0,0,82
5,14,19,21,5,19,0,0,0,83
5,14,19,21,9,14,7,0,0,89
5,14,19,21,9,14,7,12,25,126
5,14,19,21,9,20,5,0,0,93
5,14,19,21,12,16,8,21,18,134
5,14,19,21,18,1,14,3,5,100
5,14,19,21,18,5,0,0,0,82
5,14,19,21,18,5,4,0,0,86
5,14,19,21,18,5,18,0,0,100
5,14,19,21,18,5,18,19,0,119
5,14,19,21,18,5,19,0,0,101
5,14,19,21,18,9,14,7,0,107
5,14,19,23,1,20,8,5,0,95
5,14,19,23,1,20,8,5,4,99
5,14,19,23,1,20,8,5,19,114
5,14,19,23,5,5,16,0,0,87
5,14,19,23,5,5,20,5,14,110
5,14,20,0,0,0,0,0,0,39
5,14,20,1,3,8,0,0,0,51
5,14,20,1,3,11,12,5,0,71
5,14,20,1,4,0,0,0,0,44
5,14,20,1,9,12,0,0,0,61
5,14,20,1,9,12,5,4,0,70
5,14,20,1,9,12,5,18,0,84
5,14,20,1,9,12,5,18,19,103
5,14,20,1,9,12,9,14,7,91
5,14,20,1,9,12,19,0,0,80
5,14,20,1,12,0,0,0,0,52
5,14,20,1,12,5,14,20,0,91
5,14,20,1,12,12,25,0,0,89
5,14,20,1,13,5,0,0,0,58
5,14,20,1,13,5,2,1,0,61
5,14,20,1,13,5,2,1,5,66
5,14,20,1,13,5,2,1,19,80
5,14,20,1,13,5,2,9,3,72
5,14,20,1,14,7,12,5,0,78
5,14,20,1,14,7,12,5,4,82
5,14,20,1,14,7,12,5,18,96
5,14,20,1,14,7,12,5,19,97
5,14,20,1,19,5,19,0,0,83
5,14,20,1,19,9,1,0,0,69
5,14,20,1,19,9,1,19,0,88
5,14,20,1,19,9,19,0,0,87
5,14,20,1,19,20,9,3,0,91
5,14,20,5,1,0,0,0,0,45
5,14,20,5,12,1,13,0,0,70
5,14,20,5,12,5,3,8,25,97
5,14,20,5,13,16,5,19,20,117
5,14,20,5,13,16,12,5,0,90
5,14,20,5,14,4,5,18,0,85
5,14,20,5,14,4,18,5,0,85
5,14,20,5,14,4,18,5,19,104
5,14,20,5,14,20,5,0,0,83
5,14,20,5,14,20,5,19,0,102
5,14,20,5,18,0,0,0,0,62
5,14,20,5,18,1,0,0,0,63
5,14,20,5,18,1,2,12,5,82
5,14,20,5,18,1,4,5,14,86
5,14,20,5,18,1,12,0,0,75
5,14,20,5,18,1,12,12,25,112
5,14,20,5,18,1,20,5,0,88
5,14,20,5,18,1,21,24,5,113
5,14,20,5,18,5,4,0,0,71
5,14,20,5,18,5,18,0,0,85
5,14,20,5,18,5,18,19,0,104
5,14,20,5,18,6,5,1,20,94
5,14,20,5,18,9,1,0,0,72
5,14,20,5,18,9,3,0,0,74
5,14,20,5,18,9,14,7,0,92
5,14,20,5,18,9,20,9,19,119
5,14,20,5,18,13,5,20,5,105
5,14,20,5,18,13,9,19,5,108
5,14,20,5,18,15,9,4,0,90
5,14,20,5,18,15,14,0,0,91
5,14,20,5,18,15,14,19,0,110
5,14,20,5,18,15,26,15,1,119
5,14,20,5,18,19,0,0,0,81
5,14,20,5,18,20,1,9,14,106
5,14,20,5,18,20,1,11,5,99
5,14,20,5,20,5,0,0,0,69
5,14,20,8,1,12,16,25,0,101
5,14,20,8,5,1,12,0,0,65
5,14,20,8,5,1,14,0,0,67
5,14,20,8,5,1,19,13,0,85
5,14,20,8,5,1,20,5,0,78
5,14,20,8,5,15,19,0,0,86
5,14,20,8,5,20,9,3,0,84
5,14,20,8,25,13,5,13,5,108
5,14,20,8,18,1,12,0,0,78
5,14,20,8,18,1,12,12,0,90
5,14,20,8,18,1,12,12,19,109
5,14,20,8,18,1,12,19,0,97
5,14,20,8,18,9,12,12,0,98
5,14,20,8,18,15,14,5,0,99
5,14,20,8,18,15,14,5,4,103
5,14,20,8,18,15,14,5,19,118
5,14,20,8,18,15,14,7,0,101
5,14,20,8,21,19,5,0,0,92
5,14,20,8,21,19,5,4,0,96
5,14,20,8,21,19,5,19,0,111
5,14,20,8,21,19,9,14,7,117
5,14,20,9,1,0,0,0,0,49
5,14,20,9,3,5,0,0,0,56
5,14,20,9,3,5,4,0,0,60
5,14,20,9,3,5,6,21,12,95
5,14,20,9,3,5,18,0,0,74
5,14,20,9,3,5,18,19,0,93
5,14,20,9,3,5,19,0,0,75
5,14,20,9,3,9,14,7,0,81
5,14,20,9,5,18,0,0,0,71
5,14,20,9,5,19,0,0,0,72
5,14,20,9,6,25,0,0,0,79
5,14,20,9,6,9,3,1,12,79
5,14,20,25,16,9,5,19,0,113
5,14,20,9,18,5,0,0,0,71
5,14,20,9,18,5,12,25,0,108
5,14,20,9,18,5,19,0,0,90
5,14,20,9,18,5,20,25,0,116
5,14,20,9,18,9,19,0,0,94
5,14,20,9,20,25,0,0,0,93
5,14,20,9,20,9,5,19,0,101
5,14,20,9,20,12,5,0,0,85
5,14,20,9,20,12,5,4,0,89
5,14,20,9,20,12,5,19,0,104
5,14,20,9,20,12,9,14,7,110
5,14,20,9,20,21,12,5,0,106
5,14,20,15,2,12,1,19,20,108
5,14,20,15,3,5,12,5,0,79
5,14,20,15,3,25,19,20,0,121
5,14,20,15,3,15,5,12,0,89
5,14,20,15,3,15,5,12,5,94
5,14,20,15,3,15,14,5,0,91
5,14,20,15,3,15,14,9,4,99
5,14,20,15,4,5,18,13,0,94
5,14,20,15,4,5,18,13,19,113
5,14,20,15,8,25,1,12,0,100
5,14,20,15,9,12,0,0,0,75
5,14,20,15,9,12,5,4,0,84
5,14,20,15,9,12,9,14,7,105
5,14,20,15,9,12,19,0,0,94
5,14,20,15,9,18,5,0,0,86
5,14,20,15,13,0,0,0,0,67
5,14,20,15,13,2,0,0,0,69
5,14,20,15,13,2,5,4,0,78
5,14,20,15,13,2,9,14,7,99
5,14,20,15,13,2,19,0,0,88
5,14,20,15,13,5,18,5,0,95
5,14,20,15,13,5,18,9,3,102
5,14,20,15,13,9,3,0,0,79
5,14,20,15,13,9,3,1,12,92
5,14,20,15,13,9,15,14,0,105
5,14,20,15,13,15,9,4,0,95
5,14,20,15,13,15,12,0,0,94
5,14,20,15,14,5,0,0,0,73
5,14,20,15,14,9,3,0,0,80
5,14,20,15,16,8,25,20,5,128
5,14,20,15,16,9,3,0,0,82
5,14,20,15,16,9,3,1,12,95
5,14,20,15,16,12,1,19,13,115
5,14,20,15,16,18,15,3,20,126
5,14,20,15,16,20,9,3,0,102
5,14,20,15,16,20,9,3,19,121
5,14,20,15,18,20,9,12,12,125
5,14,20,15,19,1,18,3,0,95
5,14,20,15,20,9,3,0,0,86
5,14,20,15,21,18,0,0,0,93
5,14,20,15,21,18,1,7,5,106
5,14,20,15,26,15,1,0,0,96
5,14,20,15,26,15,1,12,0,108
5,14,20,15,26,15,1,14,0,110
5,14,20,15,26,15,1,14,19,129
5,14,20,15,26,15,9,3,0,107
5,14,20,15,26,15,15,14,0,124
5,14,20,18,0,0,0,0,0,57
5,14,20,18,1,3,20,5,0,86
5,14,20,18,1,4,1,0,0,63
5,14,20,18,1,4,1,19,0,82
5,14,20,18,1,9,12,0,0,79
5,14,20,18,1,9,12,19,0,98
5,14,20,18,1,9,14,0,0,81
5,14,20,18,1,9,14,5,4,90
5,14,20,18,1,9,14,5,18,104
5,14,20,18,1,9,14,19,0,100
5,14,20,18,1,13,13,5,12,101
5,14,20,18,1,14,3,5,0,80
5,14,20,18,1,14,3,5,4,84
5,14,20,18,1,14,3,5,18,98
5,14,20,18,1,14,3,5,19,99
5,14,20,18,1,14,20,0,0,92
5,14,20,18,1,14,20,19,0,111
5,14,20,18,1,16,0,0,0,74
5,14,20,18,1,16,16,5,4,99
5,14,20,18,1,16,16,5,18,113
5,14,20,18,1,16,19,0,0,93
5,14,20,18,5,0,0,0,0,62
5,14,20,18,5,1,20,0,0,83
5,14,20,18,5,1,20,5,4,92
5,14,20,18,5,1,20,5,18,106
5,14,20,18,5,1,20,25,0,108
5,14,20,18,5,1,20,19,0,102
5,14,20,18,5,3,0,0,0,65
5,14,20,18,5,3,8,1,20,94
5,14,20,18,5,3,15,20,5,105
5,14,20,18,5,4,5,21,24,116
5,14,20,18,5,5,0,0,0,67
5,14,20,18,5,5,19,0,0,86
5,14,20,18,5,6,5,18,0,91
5,14,20,18,5,12,1,3,0,78
5,14,20,18,5,13,5,19,19,118
5,14,20,18,5,13,5,20,19,119
5,14,20,18,5,14,3,8,0,87
5,14,20,18,5,16,0,0,0,78
5,14,20,18,5,16,1,19,0,98
5,14,20,18,5,16,15,20,0,113
5,14,20,18,5,16,15,20,19,132
5,14,20,18,5,16,20,0,0,98
5,14,20,18,5,18,0,0,0,80
5,14,20,18,5,19,15,12,0,108
5,14,20,18,5,19,15,12,19,127
5,14,20,18,5,19,19,5,0,105
5,14,20,18,5,26,0,0,0,88
5,14,20,18,25,0,0,0,0,82
5,14,20,18,9,1,0,0,0,67
5,14,20,18,9,5,19,0,0,90
5,14,20,18,9,11,5,0,0,82
5,14,20,18,25,13,1,14,0,110
5,14,20,18,25,13,5,14,0,114
5,14,20,18,25,23,1,25,0,131
5,14,20,18,25,23,1,25,19,150
5,14,20,18,15,3,8,21,19,123
5,14,20,18,15,16,25,0,0,113
5,14,20,18,15,16,9,3,0,100
5,14,20,18,15,16,9,5,19,121
5,14,20,18,15,16,9,15,14,126
5,14,20,18,15,16,9,21,13,131
5,14,20,18,15,21,7,8,0,108
5,14,20,18,21,19,20,0,0,117
5,14,20,18,21,19,20,5,4,126
5,14,20,18,21,19,20,19,0,136
5,14,20,20,5,0,0,0,0,64
5,14,20,21,14,5,0,0,0,79
5,14,20,21,18,18,5,20,0,121
5,14,20,23,9,14,5,0,0,90
5,14,20,23,9,14,5,4,0,94
5,14,20,23,9,14,5,19,0,109
5,14,20,23,9,14,9,14,7,115
5,14,20,23,9,19,20,0,0,110
5,14,20,23,9,19,20,5,4,119
5,14,20,23,9,19,20,19,0,129
5,14,20,23,9,20,5,0,0,96
5,14,21,3,12,5,1,20,5,86
5,14,21,13,5,18,1,20,5,102
5,14,21,14,3,9,1,20,5,92
5,14,21,18,5,0,0,0,0,63
5,14,21,18,5,4,0,0,0,67
5,14,21,18,5,19,0,0,0,82
5,14,21,18,5,19,5,19,0,106
5,14,21,18,5,19,9,19,0,110
5,14,21,18,5,20,9,3,0,95
5,14,21,18,9,14,7,0,0,88
5,14,21,18,14,25,0,0,0,97
5,14,22,0,0,0,0,0,0,41
5,14,22,1,25,5,0,0,0,72
5,14,22,1,16,15,18,0,0,91
5,14,22,1,16,15,21,18,0,112
5,14,22,1,19,19,1,12,0,93
5,14,22,1,21,12,20,0,0,95
5,14,22,5,9,7,12,5,0,79
5,14,22,5,9,12,0,0,0,67
5,14,22,5,12,15,16,0,0,89
5,14,22,5,12,15,16,5,0,94
5,14,22,5,12,15,16,5,4,98
5,14,22,5,12,15,16,5,18,112
5,14,22,5,12,15,16,5,19,113
5,14,22,5,12,15,16,19,0,108
5,14,22,5,14,15,13,0,0,88
5,14,22,5,14,15,13,5,4,97
5,14,22,5,14,15,13,19,0,107
5,14,22,5,14,20,21,1,12,114
5,14,22,5,18,4,21,18,5,112
5,14,22,5,18,7,21,18,5,115
5,14,22,5,18,13,5,9,12,103
5,14,22,25,0,0,0,0,0,66
5,14,22,9,1,2,12,5,0,70
5,14,22,9,1,2,12,25,0,90
5,14,22,9,5,4,0,0,0,59
5,14,22,9,5,18,0,0,0,73
5,14,22,9,5,18,19,0,0,92
5,14,22,9,5,19,0,0,0,74
5,14,22,9,7,15,18,0,0,90
5,14,22,25,9,14,7,0,0,96
5,14,22,25,9,14,7,12,25,133
5,14,22,9,14,5,0,0,0,69
5,14,22,9,14,5,4,0,0,73
5,14,22,9,15,21,19,0,0,105
5,14,22,9,15,21,19,12,25,142
5,14,22,9,18,5,0,0,0,73
5,14,22,9,18,15,14,0,0,97
5,14,22,9,18,15,14,1,12,110
5,14,22,9,18,15,14,5,4,106
5,14,22,9,18,15,14,9,3,109
5,14,22,9,18,15,14,19,0,116
5,14,22,9,19,1,7,5,0,82
5,14,22,9,19,1,7,5,4,86
5,14,22,9,19,1,7,5,19,101
5,14,22,9,19,9,15,14,0,107
5,14,22,9,19,9,15,14,19,126
5,14,22,15,9,0,0,0,0,65
5,14,22,15,25,0,0,0,0,81
5,14,22,15,9,19,0,0,0,84
5,14,22,15,25,19,0,0,0,100
5,14,22,15,25,19,8,9,16,133
5,14,22,15,12,21,13,5,0,107
5,14,22,15,12,21,16,5,14,124
5,14,23,1,12,12,0,0,0,67
5,14,23,1,12,12,15,23,0,105
5,14,23,5,1,22,5,0,0,75
5,14,23,5,1,22,5,4,0,79
5,14,23,5,1,22,9,14,7,100
5,14,23,5,2,0,0,0,0,49
5,14,23,8,5,5,12,0,0,72
5,14,23,8,5,5,12,5,4,81
5,14,23,8,5,5,12,19,0,91
5,14,23,9,4,5,14,0,0,74
5,14,23,9,14,4,0,0,0,69
5,14,23,9,14,4,9,14,7,99
5,14,23,9,14,4,19,0,0,88
5,14,23,9,14,7,0,0,0,72
5,14,23,9,14,7,12,25,0,109
5,14,23,9,19,5,14,0,0,89
5,14,23,15,13,1,14,0,0,85
5,14,23,15,13,2,0,0,0,72
5,14,23,15,13,2,5,4,0,81
5,14,23,15,13,2,9,14,7,102
5,14,23,15,13,2,19,0,0,91
5,14,23,15,15,4,0,0,0,76
5,14,23,15,18,20,8,5,4,112
5,14,23,15,18,20,8,25,0,128
5,14,23,15,21,14,4,0,0,96
5,14,23,15,22,5,0,0,0,84
5,14,23,15,22,5,14,0,0,98
5,14,23,18,1,16,0,0,0,77
5,14,23,18,1,16,16,5,4,102
5,14,23,18,1,16,19,0,0,96
5,14,23,18,1,16,20,0,0,97
5,14,23,18,5,1,20,8,0,94
5,14,23,18,5,1,20,8,5,99
5,14,23,18,9,20,5,0,0,94
5,14,23,18,15,21,7,8,20,131
5,14,23,23,15,22,5,0,0,107
5,14,23,23,15,22,5,14,0,121
5,14,26,25,7,15,20,9,3,124
5,14,26,25,13,0,0,0,0,83
5,14,26,25,13,1,20,9,3,116
5,14,26,25,13,5,0,0,0,88
5,14,26,25,13,5,19,0,0,107
5,14,26,25,13,9,3,0,0,95
5,14,26,25,13,15,19,9,19,145
5,14,26,25,13,15,20,9,3,130
5,14,26,25,13,19,0,0,0,102
5,14,26,15,14,5,0,0,0,79
5,14,26,15,15,20,25,0,0,120
5,14,26,15,15,20,9,3,0,107
5,14,26,15,15,20,9,3,19,126
5,15,2,9,15,14,20,0,0,80
5,15,2,9,15,14,20,19,0,99
5,15,4,9,19,3,9,4,0,68
5,15,9,20,8,0,0,0,0,57
5,15,9,20,8,19,0,0,0,76
5,15,12,1,20,9,15,14,0,91
5,15,12,5,0,0,0,0,0,37
5,15,12,9,5,14,14,5,0,79
5,15,12,9,16,9,12,5,0,83
5,15,12,9,16,9,12,5,19,102
5,15,12,9,20,8,0,0,0,69
5,15,12,9,20,8,19,0,0,88
5,15,12,15,16,9,12,5,0,89
5,15,12,15,16,9,12,5,19,108
5,15,14,0,0,0,0,0,0,34
5,15,14,9,1,14,0,0,0,58
5,15,14,9,19,13,0,0,0,75
5,15,14,9,19,13,19,0,0,94
5,15,14,19,0,0,0,0,0,53
5,15,16,8,25,20,5,0,0,94
5,15,16,8,25,20,9,3,0,101
5,15,16,8,25,20,15,14,0,118
5,15,19,1,20,5,0,0,0,65
5,15,19,9,4,5,0,0,0,57
5,15,19,9,14,0,0,0,0,62
5,15,19,9,14,1,20,5,0,88
5,15,19,9,14,5,0,0,0,67
5,15,19,9,14,5,19,0,0,86
5,15,19,9,14,9,3,0,0,74
5,15,19,9,14,12,9,11,5,99
5,15,19,9,14,19,0,0,0,81
5,15,21,19,0,0,0,0,0,60
5,15,26,15,15,14,0,0,0,90
5,15,26,15,15,14,1,12,0,103
5,16,5,4,1,16,8,9,3,67
5,16,5,5,0,0,0,0,0,31
5,16,5,5,9,19,20,0,0,79
5,16,5,5,9,19,20,19,0,98
5,16,5,5,19,0,0,0,0,50
5,16,5,9,4,9,1,0,0,49
5,16,5,9,18,9,3,0,0,65
5,16,5,9,18,9,4,0,0,66
5,16,5,9,19,15,4,9,1,83
5,16,5,14,4,25,13,1,0,83
5,16,5,14,4,25,13,1,12,95
5,16,5,14,4,25,13,5,0,87
5,16,5,14,4,25,20,5,19,113
5,16,5,14,5,20,9,3,0,77
5,16,5,14,12,1,0,0,0,53
5,16,5,18,7,14,5,0,0,70
5,16,5,18,7,14,5,19,0,89
5,16,5,18,12,1,14,0,0,71
5,16,5,18,22,1,0,0,0,67
5,16,8,1,0,0,0,0,0,30
5,16,8,1,8,0,0,0,0,38
5,16,8,1,8,19,0,0,0,57
5,16,8,1,16,19,5,0,0,70
5,16,8,1,18,13,15,14,25,115
5,16,8,1,19,0,0,0,0,49
5,16,8,5,2,5,0,0,0,41
5,16,8,5,2,5,1,0,0,42
5,16,8,5,2,5,9,1,0,51
5,16,8,5,2,5,9,15,14,79
5,16,8,5,2,5,19,0,0,60
5,16,8,5,2,5,21,13,0,75
5,16,8,5,2,9,0,0,0,45
5,16,8,5,2,9,3,0,0,48
5,16,8,5,2,15,9,0,0,60
5,16,8,5,2,15,19,0,0,70
5,16,8,5,2,21,19,0,0,76
5,16,8,5,3,20,9,3,0,69
5,16,8,5,4,18,1,19,0,76
5,16,8,5,4,18,9,14,0,79
5,16,8,5,4,18,9,14,5,84
5,16,8,5,4,18,9,14,19,98
5,16,8,5,12,9,19,0,0,74
5,16,8,5,13,5,18,1,5,76
5,16,8,5,13,5,18,1,12,83
5,16,8,5,13,5,18,1,14,85
5,16,8,5,13,5,18,1,19,90
5,16,8,5,13,5,18,9,3,82
5,16,8,5,13,5,18,9,4,83
5,16,8,5,13,5,18,9,19,98
5,16,8,5,13,5,18,15,14,99
5,16,8,5,19,20,9,1,0,83
5,16,8,5,19,20,9,1,14,97
5,16,8,5,20,1,5,0,0,60
5,16,8,5,20,5,0,0,0,59
5,16,8,5,20,9,3,0,0,66
5,16,8,25,4,18,9,1,4,90
5,16,8,25,4,18,9,4,0,89
5,16,8,25,13,14,9,21,13,124
5,16,8,9,16,16,9,1,0,80
5,16,8,9,16,16,9,1,12,92
5,16,8,9,16,16,9,21,13,113
5,16,8,25,18,1,0,0,0,73
5,16,8,25,18,1,5,0,0,78
5,16,8,25,18,21,12,1,0,106
5,16,8,15,4,0,0,0,0,48
5,16,8,15,4,19,0,0,0,67
5,16,8,15,9,0,0,0,0,53
5,16,8,15,18,0,0,0,0,62
5,16,8,15,18,1,12,0,0,75
5,16,8,15,18,1,12,20,25,120
5,16,8,15,18,1,20,5,0,88
5,16,8,15,18,1,20,5,19,107
5,16,8,15,18,9,0,0,0,71
5,16,8,15,18,9,3,0,0,74
5,16,8,15,18,19,0,0,0,81
5,16,8,15,18,19,8,9,16,114
5,16,8,15,18,21,19,0,0,102
5,16,8,16,8,1,20,8,1,83
5,16,9,0,0,0,0,0,0,30
5,16,9,2,1,19,1,12,0,65
5,16,9,2,1,20,21,19,0,93
5,16,9,2,9,15,20,9,3,88
5,16,9,2,12,1,19,20,0,84
5,16,9,2,12,1,19,20,19,103
5,16,9,2,12,5,13,1,0,63
5,16,9,2,15,12,5,0,0,64
5,16,9,2,15,12,25,0,0,84
5,16,9,2,15,12,9,3,0,71
5,16,9,2,15,12,9,5,19,92
5,16,9,2,15,12,9,19,13,100
5,16,9,3,0,0,0,0,0,33
5,16,9,3,1,12,0,0,0,46
5,16,9,3,1,12,25,24,0,95
5,16,9,3,1,12,12,25,0,83
5,16,9,3,1,14,20,8,9,85
5,16,9,3,1,18,4,9,1,66
5,16,9,3,1,18,9,4,0,65
5,16,9,3,1,18,16,0,0,68
5,16,9,3,1,18,16,1,12,81
5,16,9,3,1,18,16,19,0,87
5,16,9,3,5,4,5,0,0,47
5,16,9,3,5,4,9,1,0,52
5,16,9,3,5,4,9,1,12,64
5,16,9,3,5,4,9,1,14,66
5,16,9,3,5,4,9,21,13,85
5,16,9,3,5,12,5,0,0,55
5,16,9,3,5,14,5,0,0,57
5,16,9,3,5,14,5,19,0,76
5,16,9,3,5,14,9,19,13,93
5,16,9,3,5,14,9,20,25,106
5,16,9,3,5,14,20,5,18,95
5,16,9,3,5,14,20,18,1,91
5,16,9,3,5,14,20,18,5,95
5,16,9,3,8,9,12,0,0,62
5,16,9,3,8,9,12,5,0,67
5,16,9,3,8,9,12,9,1,72
5,16,9,3,8,15,18,9,3,86
5,16,9,3,25,3,12,5,0,78
5,16,9,3,25,3,12,5,19,97
5,16,9,3,25,3,12,9,3,85
5,16,9,3,9,5,18,0,0,65
5,16,9,3,25,5,19,9,19,110
5,16,9,3,9,19,13,0,0,74
5,16,9,3,9,19,20,0,0,81
5,16,9,3,25,20,5,0,0,83
5,16,9,3,12,5,19,5,19,93
5,16,9,3,12,5,19,9,19,97
5,16,9,3,12,25,0,0,0,70
5,16,9,3,12,9,4,1,12,71
5,16,9,3,12,9,11,5,0,70
5,16,9,3,12,9,14,1,12,81
5,16,9,3,15,5,12,1,18,84
5,16,9,3,15,5,12,5,0,70
5,16,9,3,15,5,12,9,1,75
5,16,9,3,15,12,9,3,0,72
5,16,9,3,15,18,13,9,3,91
5,16,9,3,15,19,20,1,12,100
5,16,9,3,15,20,25,12,0,105
5,16,9,3,15,20,25,12,19,124
5,16,9,3,18,1,19,9,19,99
5,16,9,3,18,9,19,5,19,103
5,16,9,3,18,9,19,9,19,107
5,16,9,3,18,9,20,9,3,92
5,16,9,3,19,0,0,0,0,52
5,16,9,3,21,18,5,0,0,77
5,16,9,3,21,18,5,19,0,96
5,16,9,3,21,18,9,19,8,108
5,16,9,4,5,13,25,0,0,77
5,16,9,4,5,13,9,1,12,74
5,16,9,4,5,13,9,3,0,64
5,16,9,4,5,13,9,3,19,83
5,16,9,4,5,18,13,0,0,70
5,16,9,4,5,18,13,1,0,71
5,16,9,4,5,18,13,1,12,83
5,16,9,4,5,18,13,9,3,82
5,16,9,4,5,18,13,9,19,98
5,16,9,4,5,18,13,19,0,89
5,16,9,4,9,1,0,0,0,44
5,16,9,4,9,3,20,9,3,78
5,16,9,4,15,19,9,20,5,102
5,16,9,4,15,20,5,0,0,74
5,16,9,4,15,20,5,19,0,93
5,16,9,4,15,20,9,3,0,81
5,16,9,4,21,18,1,12,0,86
5,16,9,6,1,21,14,1,0,73
5,16,9,6,1,21,14,1,5,78
5,16,9,6,1,21,14,1,12,85
5,16,9,6,1,21,14,1,19,92
5,16,9,6,15,3,1,12,0,67
5,16,9,7,1,5,15,21,19,98
5,16,9,7,1,13,9,3,0,63
5,16,9,7,1,19,20,5,18,100
5,16,9,7,5,1,12,0,0,55
5,16,9,7,5,1,14,0,0,57
5,16,9,7,5,5,0,0,0,47
5,16,9,7,5,9,3,0,0,54
5,16,9,7,5,14,5,0,0,61
5,16,9,7,5,14,9,3,0,68
5,16,9,7,5,14,9,19,20,104
5,16,9,7,5,14,15,21,19,111
5,16,9,7,5,15,21,19,0,97
5,16,9,7,5,21,13,0,0,76
5,16,9,7,25,14,5,0,0,81
5,16,9,7,25,14,25,0,0,101
5,16,9,7,25,14,9,5,19,109
5,16,9,7,25,14,15,21,19,131
5,16,9,7,25,14,21,13,0,110
5,16,9,7,12,15,20,0,0,84
5,16,9,7,14,5,0,0,0,56
5,16,9,7,15,14,0,0,0,66
5,16,9,7,15,14,1,12,0,79
5,16,9,7,15,14,5,0,0,71
5,16,9,7,15,14,5,19,0,90
5,16,9,7,15,14,9,3,0,78
5,16,9,7,15,14,9,19,13,107
5,16,9,7,15,14,9,21,13,109
5,16,9,7,15,14,15,19,0,100
5,16,9,7,15,14,15,21,19,121
5,16,9,7,15,14,19,0,0,85
5,16,9,7,18,1,13,0,0,69
5,16,9,7,18,1,13,13,5,87
5,16,9,7,18,1,13,19,0,88
5,16,9,7,18,1,16,8,0,80
5,16,9,7,18,1,16,8,25,105
5,16,9,7,18,1,16,8,19,99
5,16,9,8,25,1,12,0,0,76
5,16,9,8,25,4,18,9,3,97
5,16,9,11,5,9,1,0,0,56
5,16,9,11,25,0,0,0,0,66
5,16,9,11,9,1,0,0,0,51
5,16,9,11,12,5,19,5,19,101
5,16,9,11,12,5,19,9,19,105
5,16,9,12,0,0,0,0,0,42
5,16,9,12,1,2,18,1,0,64
5,16,9,12,1,2,18,21,13,97
5,16,9,12,1,20,5,0,0,68
5,16,9,12,1,20,5,4,0,72
5,16,9,12,1,20,9,14,7,93
5,16,9,12,1,20,9,15,14,101
5,16,9,12,1,20,15,18,0,96
5,16,9,12,1,20,15,18,25,121
5,16,9,12,5,13,13,1,0,74
5,16,9,12,5,13,13,1,12,86
5,16,9,12,5,14,25,0,0,86
5,16,9,12,5,16,19,25,0,107
5,16,9,12,5,16,19,9,1,92
5,16,9,12,5,16,20,9,3,95
5,16,9,12,9,13,14,9,1,88
5,16,9,12,9,20,8,9,3,91
5,16,25,12,12,9,1,0,0,80
5,16,25,12,12,9,15,14,0,108
5,16,9,12,15,2,5,0,0,64
5,16,9,12,15,7,0,0,0,64
5,16,9,12,15,7,1,20,5,90
5,16,9,12,15,7,9,3,0,76
5,16,9,12,15,7,9,19,13,105
5,16,9,12,15,7,9,19,20,112
5,16,9,12,15,7,9,26,5,104
5,16,9,12,15,7,19,0,0,83
5,16,9,12,15,7,21,5,0,90
5,16,9,12,15,7,21,5,4,94
5,16,9,12,15,7,21,5,19,109
5,16,9,12,15,9,1,0,0,67
5,16,9,13,1,3,21,19,0,87
5,16,9,13,5,18,0,0,0,66
5,16,9,13,5,18,1,12,0,79
5,16,9,13,5,18,1,19,5,91
5,16,9,13,5,18,5,0,0,71
5,16,9,13,5,18,5,19,0,90
5,16,9,13,5,18,9,3,0,78
5,16,9,13,5,18,9,4,5,84
5,16,9,13,5,18,9,19,5,99
5,16,9,13,5,18,9,19,13,107
5,16,9,13,5,18,9,20,5,100
5,16,9,13,5,18,9,26,5,106
5,16,9,13,5,18,15,14,0,95
5,16,9,13,5,18,19,0,0,85
5,16,9,13,5,18,21,13,0,100
5,16,9,13,25,19,9,1,0,97
5,16,9,13,25,19,9,21,13,130
5,16,9,13,25,20,8,0,0,96
5,16,9,13,15,18,16,8,1,101
5,16,9,14,1,15,9,0,0,69
5,16,9,14,1,15,19,0,0,79
5,16,9,14,1,18,4,0,0,67
5,16,9,14,1,19,20,25,0,109
5,16,9,14,1,19,20,9,3,96
5,16,9,14,5,20,20,5,0,94
5,16,9,14,5,21,18,1,12,101
5,16,9,14,5,21,18,9,1,98
5,16,9,14,7,12,5,0,0,68
5,16,9,14,9,3,9,1,0,66
5,16,9,14,9,3,9,1,12,78
5,16,9,14,9,3,9,1,14,80
5,16,9,14,9,3,9,15,14,94
5,16,9,14,25,3,20,9,19,120
5,16,9,14,9,11,9,1,0,74
5,16,9,14,9,11,9,1,14,88
5,16,9,14,9,11,9,15,14,102
5,16,9,14,9,14,5,0,0,72
5,16,9,15,20,9,3,0,0,77
5,16,9,16,1,14,25,0,0,86
5,16,9,16,1,14,9,5,19,94
5,16,9,16,1,19,20,9,3,98
5,16,9,16,8,1,14,9,3,81
5,16,9,16,8,25,12,12,0,103
5,16,9,16,8,25,19,5,19,122
5,16,9,16,8,25,19,9,19,126
5,16,9,16,8,25,20,1,12,112
5,16,9,16,8,25,20,5,0,104
5,16,9,16,8,25,20,5,19,123
5,16,9,16,8,25,20,9,3,111
5,16,9,16,8,15,18,1,0,88
5,16,9,16,8,18,1,7,13,93
5,16,9,16,9,1,12,0,0,68
5,16,9,16,12,1,19,13,0,91
5,16,9,16,12,5,21,18,1,103
5,16,9,16,12,5,24,9,19,115
5,16,9,16,12,15,3,5,0,81
5,16,9,16,12,15,9,3,0,85
5,16,9,16,12,15,15,14,0,102
5,16,9,16,15,4,9,1,0,75
5,16,9,16,15,4,9,1,12,87
5,16,9,16,15,4,9,20,5,99
5,16,9,16,15,4,9,21,13,108
5,16,9,16,15,12,9,3,0,85
5,16,9,16,15,12,9,19,13,114
5,16,9,16,15,12,9,26,5,113
5,16,9,16,18,15,3,20,0,102
5,16,9,16,20,5,18,9,3,101
5,16,9,16,21,2,5,19,0,93
5,16,9,16,21,2,9,3,0,81
5,16,9,16,21,2,9,19,0,97
5,16,9,18,15,7,5,14,25,114
5,16,9,18,15,20,0,0,0,83
5,16,9,18,18,8,5,13,1,93
5,16,9,18,18,8,5,13,5,97
5,16,9,19,3,5,14,9,1,81
5,16,9,19,3,9,1,0,0,62
5,16,9,19,3,9,1,19,0,81
5,16,9,19,3,12,5,18,1,88
5,16,9,19,3,15,16,5,0,88
5,16,9,19,3,15,16,5,19,107
5,16,9,19,3,15,16,25,0,108
5,16,9,19,5,4,9,1,0,68
5,16,9,19,5,13,5,13,5,90
5,16,9,19,15,4,1,12,0,81
5,16,9,19,15,4,5,0,0,73
5,16,9,19,15,4,5,19,0,92
5,16,9,19,15,4,9,1,12,90
5,16,9,19,15,4,9,3,0,80
5,16,9,19,15,13,1,12,0,90
5,16,9,19,15,13,5,0,0,82
5,16,9,19,15,13,5,19,0,101
5,16,9,19,16,1,4,9,1,80
5,16,9,19,16,5,18,13,0,101
5,16,9,19,16,9,14,1,12,101
5,16,9,19,16,15,18,5,0,103
5,16,9,19,20,1,19,5,19,113
5,16,9,19,20,1,19,25,0,114
5,16,9,19,20,1,19,9,19,117
5,16,9,19,20,1,20,9,3,102
5,16,9,19,20,1,24,9,19,122
5,16,9,19,20,5,13,5,0,92
5,16,9,19,20,5,13,9,3,99
5,16,9,19,20,5,14,1,0,89
5,16,9,19,20,5,18,14,1,107
5,16,9,19,20,25,12,1,18,125
5,16,9,19,20,25,12,5,0,111
5,16,9,19,20,25,12,5,19,130
5,16,9,19,20,12,1,18,0,100
5,16,9,19,20,12,5,18,0,104
5,16,9,19,20,12,5,18,19,123
5,16,9,19,20,15,12,1,18,115
5,16,9,19,20,15,12,5,18,119
5,16,9,19,20,15,12,5,20,121
5,16,9,19,20,15,12,9,3,108
5,16,9,19,20,15,13,1,0,98
5,16,9,19,20,15,13,1,12,110
5,16,9,19,20,15,13,5,0,102
5,16,9,19,20,18,15,13,1,116
5,16,9,20,0,0,0,0,0,50
5,16,9,20,1,3,20,9,3,86
5,16,9,20,1,16,8,0,0,75
5,16,9,20,1,16,8,5,18,98
5,16,9,20,1,16,8,9,3,87
5,16,9,20,1,16,8,19,0,94
5,16,9,20,1,19,5,19,0,94
5,16,9,20,1,19,9,19,0,98
5,16,9,20,1,24,25,0,0,100
5,16,9,20,1,24,9,1,12,97
5,16,9,20,1,24,9,3,0,87
5,16,9,20,1,24,9,5,19,108
5,16,9,20,1,24,9,19,0,103
5,16,9,20,5,12,1,0,0,68
5,16,9,20,5,14,15,14,0,98
5,16,9,20,8,1,13,9,1,82
5,16,9,20,8,5,3,1,0,67
5,16,9,20,8,5,3,1,12,79
5,16,9,20,8,5,3,9,1,76
5,16,9,20,8,5,12,9,1,85
5,16,9,20,8,5,13,0,0,76
5,16,9,20,8,5,13,5,0,81
5,16,9,20,8,5,19,9,19,110
5,16,9,20,8,5,20,0,0,83
5,16,9,20,8,5,20,9,3,95
5,16,9,20,8,5,20,15,14,112
5,16,9,20,8,5,20,19,0,102
5,16,9,20,8,9,0,0,0,67
5,16,9,20,8,25,13,5,0,101
5,16,9,20,25,13,16,1,0,105
5,16,9,20,15,11,5,0,0,81
5,16,9,20,15,13,1,20,5,104
5,16,9,20,15,13,5,0,0,83
5,16,9,20,15,13,5,19,0,102
5,16,9,20,15,13,9,3,0,90
5,16,9,20,15,13,9,19,5,111
5,16,9,20,15,13,9,19,20,126
5,16,9,20,15,13,9,26,5,118
5,16,9,20,15,14,9,3,0,91
5,16,9,20,15,14,9,15,14,117
5,16,9,20,15,24,15,9,4,117
5,16,9,20,18,1,0,0,0,69
5,16,9,20,18,9,1,0,0,78
5,16,9,20,18,9,20,5,0,102
5,16,9,20,18,9,20,9,3,109
5,16,9,20,18,15,16,5,0,104
5,16,9,20,18,15,16,8,25,132
5,16,9,21,18,1,12,0,0,82
5,16,9,22,1,12,22,5,0,92
5,16,9,24,25,12,15,21,19,146
5,16,9,26,5,21,24,9,19,134
5,16,9,26,15,1,12,0,0,84
5,16,9,26,15,1,14,0,0,86
5,16,9,26,15,9,3,0,0,83
5,16,9,26,15,9,19,13,0,112
5,16,9,26,15,9,19,13,19,131
5,16,9,26,15,9,20,5,0,105
5,16,9,26,15,9,20,5,19,124
5,16,9,26,15,15,14,0,0,100
5,16,9,26,15,15,20,25,0,131
5,16,9,26,15,15,20,9,3,118
5,16,9,26,26,15,1,0,0,98
5,16,12,15,20,0,0,0,0,68
5,16,15,3,8,0,0,0,0,47
5,16,15,3,8,1,0,0,0,48
5,16,15,3,8,1,12,0,0,60
5,16,15,3,8,1,12,12,25,97
5,16,15,3,8,5,0,0,0,52
5,16,15,3,8,9,19,13,0,88
5,16,15,3,8,9,19,20,0,95
5,16,15,3,8,19,0,0,0,66
5,16,15,4,5,0,0,0,0,45
5,16,15,4,5,19,0,0,0,64
5,16,15,4,9,3,0,0,0,52
5,16,15,9,19,20,0,0,0,84
5,16,15,14,7,5,0,0,0,62
5,16,15,14,25,13,0,0,0,88
5,16,15,14,25,13,25,0,0,113
5,16,15,14,25,13,9,3,0,100
5,16,15,14,25,13,9,5,19,121
5,16,15,14,25,13,9,19,13,129
5,16,15,14,25,13,9,19,20,136
5,16,15,14,25,13,9,26,5,128
5,16,15,14,25,13,15,21,19,143
5,16,15,14,25,13,19,0,0,107
5,16,15,14,25,13,21,19,0,128
5,16,15,16,0,0,0,0,0,52
5,16,15,16,5,5,0,0,0,62
5,16,15,16,5,5,19,0,0,81
5,16,15,16,15,5,1,14,0,87
5,16,15,16,15,5,9,1,0,82
5,16,15,16,15,5,9,1,19,101
5,16,15,16,15,5,9,19,20,120
5,16,15,16,20,0,0,0,0,72
5,16,15,16,20,5,19,0,0,96
5,16,15,16,20,9,3,0,0,84
5,16,15,16,20,9,19,20,0,120
5,16,15,18,14,9,20,9,3,109
5,16,15,19,5,19,0,0,0,79
5,16,15,20,1,20,9,15,14,115
5,16,15,24,25,0,0,0,0,85
5,16,15,24,9,4,5,0,0,78
5,16,15,24,9,4,5,19,0,97
5,16,15,24,9,4,9,26,5,113
5,16,15,24,9,5,4,0,0,78
5,16,15,24,25,5,4,0,0,94
5,16,15,24,9,5,19,0,0,93
5,16,15,24,25,9,14,7,0,115
5,16,18,9,19,0,0,0,0,67
5,16,18,9,19,5,0,0,0,72
5,16,18,15,19,25,0,0,0,98
5,16,18,21,9,14,15,19,5,122
5,16,19,9,12,15,14,19,0,109
5,16,19,15,13,9,20,5,0,102
5,16,21,12,1,18,25,0,0,98
5,16,21,12,1,20,9,15,14,113
5,16,21,12,9,19,0,0,0,82
5,16,21,12,15,0,0,0,0,69
5,16,21,12,15,9,4,0,0,82
5,16,21,12,15,14,5,19,0,107
5,16,21,12,15,19,9,19,0,116
5,16,21,12,15,20,9,3,0,101
5,16,21,18,1,12,0,0,0,73
5,16,21,18,1,20,5,0,0,86
5,16,21,18,1,20,9,15,14,119
5,17,16,20,0,0,0,0,0,58
5,17,21,1,2,12,5,0,0,63
5,17,21,1,2,12,25,0,0,83
5,17,21,1,5,22,1,12,0,84
5,17,21,1,12,0,0,0,0,56
5,17,21,1,12,1,2,12,5,76
5,17,21,1,12,5,4,0,0,65
5,17,21,1,12,9,14,7,0,86
5,17,21,1,12,9,19,5,0,89
5,17,21,1,12,9,19,5,4,93
5,17,21,1,12,9,19,5,19,108
5,17,21,1,12,9,19,20,0,104
5,17,21,1,12,9,26,5,0,96
5,17,21,1,12,9,26,5,4,100
5,17,21,1,12,9,26,5,18,114
5,17,21,1,12,9,26,5,19,115
5,17,21,1,12,12,5,4,0,77
5,17,21,1,12,12,5,18,0,91
5,17,21,1,12,12,25,0,0,93
5,17,21,1,12,12,9,14,7,98
5,17,21,1,12,14,5,19,19,113
5,17,21,1,12,19,0,0,0,75
5,17,21,1,14,20,0,0,0,78
5,17,21,1,20,1,2,12,5,84
5,17,21,1,20,5,0,0,0,69
5,17,21,1,20,5,4,0,0,73
5,17,21,1,20,5,19,0,0,88
5,17,21,1,20,9,14,7,0,94
5,17,21,1,20,9,15,14,0,102
5,17,21,1,20,9,15,14,19,121
5,17,21,1,20,9,22,5,0,100
5,17,21,1,20,15,18,0,0,97
5,17,21,1,20,15,18,19,0,116
5,17,21,5,18,18,25,0,0,109
5,17,21,5,18,18,9,5,19,117
5,17,21,5,19,0,0,0,0,67
5,17,21,9,1,14,7,12,5,91
5,17,21,9,1,24,5,0,0,82
5,17,21,9,1,24,5,4,0,86
5,17,21,9,1,24,9,1,12,99
5,17,21,9,3,21,18,22,5,121
5,17,21,9,4,0,0,0,0,56
5,17,21,9,4,5,14,19,5,99
5,17,21,9,4,9,19,20,0,104
5,17,21,9,6,15,18,13,0,104
5,17,21,9,12,1,20,5,18,108
5,17,21,9,12,9,14,0,0,87
5,17,21,9,12,9,18,9,1,101
5,17,21,9,12,15,2,5,4,90
5,17,21,9,13,15,4,1,12,97
5,17,21,9,13,15,12,1,12,105
5,17,21,9,13,15,12,1,18,111
5,17,21,9,14,1,12,0,0,79
5,17,21,9,14,1,20,5,0,92
5,17,21,9,14,5,0,0,0,71
5,17,21,9,14,5,12,25,0,108
5,17,21,9,14,5,19,0,0,90
5,17,21,9,14,9,1,0,0,76
5,17,21,9,14,9,20,25,0,120
5,17,21,9,14,15,24,0,0,105
5,17,21,9,14,15,24,5,19,129
5,17,21,9,14,21,19,0,0,106
5,17,21,9,16,0,0,0,0,68
5,17,21,9,16,1,7,1,0,77
5,17,21,9,16,1,7,5,0,81
5,17,21,9,16,1,7,5,19,100
5,17,21,9,16,5,4,0,0,77
5,17,21,9,16,5,4,1,12,90
5,17,21,9,16,5,4,5,0,82
5,17,21,9,16,12,21,22,5,128
5,17,21,9,16,13,5,14,20,120
5,17,21,9,16,15,9,19,5,116
5,17,21,9,16,16,5,4,0,93
5,17,21,9,16,16,5,18,0,107
5,17,21,9,16,16,5,18,19,126
5,17,21,9,16,16,9,14,7,114
5,17,21,9,16,19,0,0,0,87
5,17,21,9,16,20,0,0,0,88
5,17,21,9,18,15,20,1,12,118
5,17,21,9,19,5,20,1,0,97
5,17,21,9,19,5,20,9,3,108
5,17,21,9,19,9,4,5,4,93
5,17,21,9,19,9,26,5,4,115
5,17,21,9,19,15,14,0,0,100
5,17,21,9,20,1,2,12,5,92
5,17,21,9,20,1,2,12,25,112
5,17,21,9,20,1,14,20,0,107
5,17,21,9,20,5,19,0,0,96
5,17,21,9,20,9,5,19,0,105
5,17,21,9,20,9,19,20,0,120
5,17,21,9,22,0,0,0,0,74
5,17,21,9,22,1,12,5,0,92
5,17,21,9,22,1,12,21,5,113
5,17,21,9,22,1,12,22,5,114
5,17,21,9,22,15,3,1,12,105
5,17,21,9,22,15,11,5,0,105
5,17,21,9,22,15,11,5,19,124
5,17,21,9,22,15,17,21,5,132
5,17,21,9,22,15,20,5,0,114
5,17,21,15,9,4,0,0,0,71
5,17,21,15,9,4,5,1,14,91
5,17,21,22,1,12,5,14,20,117
5,18,2,9,1,0,0,0,0,35
5,18,2,9,21,13,0,0,0,68
5,18,2,9,21,13,19,0,0,87
5,18,4,22,1,18,11,0,0,79
5,18,5,3,20,0,0,0,0,51
5,18,5,3,20,1,2,12,5,71
5,18,5,3,20,5,4,0,0,60
5,18,5,3,20,5,18,0,0,74
5,18,5,3,20,5,18,19,0,93
5,18,5,3,20,9,12,5,0,77
5,18,5,3,20,9,14,7,0,81
5,18,5,3,20,9,15,14,0,89
5,18,5,3,20,9,15,14,19,108
5,18,5,3,20,9,22,5,0,87
5,18,5,3,20,12,25,0,0,88
5,18,5,3,20,14,5,19,19,108
5,18,5,3,20,15,18,0,0,84
5,18,5,3,20,15,18,19,0,103
5,18,5,3,20,19,0,0,0,70
5,18,5,12,15,14,7,0,0,76
5,18,5,13,9,3,0,0,0,53
5,18,5,13,9,20,1,12,0,83
5,18,5,13,9,20,5,0,0,75
5,18,5,13,9,20,5,19,0,94
5,18,5,13,9,20,9,3,0,82
5,18,5,13,9,20,9,19,8,106
5,18,5,13,9,20,9,19,13,111
5,18,5,13,15,12,15,7,25,115
5,18,5,13,21,18,9,0,0,89
5,18,5,14,1,3,8,0,0,54
5,18,5,14,15,23,0,0,0,80
5,18,5,16,19,9,14,0,0,86
5,18,5,16,19,9,14,19,0,105
5,18,5,16,20,0,0,0,0,64
5,18,5,16,20,1,19,5,0,89
5,18,5,16,20,9,3,0,0,76
5,18,5,16,20,9,15,14,0,102
5,18,5,18,0,0,0,0,0,46
5,18,5,20,8,9,3,0,0,68
5,18,5,20,8,9,19,9,1,94
5,18,5,20,8,9,19,13,0,97
5,18,5,20,8,9,19,13,19,116
5,18,5,20,8,9,20,9,3,97
5,18,5,23,8,9,12,5,0,85
5,18,5,23,8,9,12,5,19,104
5,18,6,0,0,0,0,0,0,29
5,18,7,0,0,0,0,0,0,30
5,18,7,1,12,0,0,0,0,43
5,18,7,1,13,9,14,5,0,72
5,18,7,1,19,9,1,0,0,60
5,18,7,1,19,20,9,3,0,82
5,18,7,1,20,5,0,0,0,56
5,18,7,1,20,5,19,0,0,75
5,18,7,1,20,9,22,5,0,87
5,18,7,1,20,15,9,4,0,79
5,18,7,13,5,20,5,18,0,91
5,18,7,15,0,0,0,0,0,45
5,18,7,15,4,9,3,0,0,61
5,18,7,15,7,18,1,13,0,84
5,18,7,15,7,18,1,16,8,95
5,18,7,15,9,19,13,0,0,86
5,18,7,15,12,15,7,25,0,104
5,18,7,15,13,5,20,5,18,106
5,18,7,15,14,0,0,0,0,59
5,18,7,15,14,15,13,9,3,99
5,18,7,15,16,8,9,12,5,95
5,18,7,15,16,12,1,19,13,106
5,18,7,15,19,20,1,20,0,105
5,18,7,15,20,0,0,0,0,65
5,18,7,15,20,5,4,0,0,74
5,18,7,15,20,9,3,0,0,77
5,18,7,15,20,9,14,0,0,88
5,18,7,15,20,9,14,5,0,93
5,18,7,15,20,9,19,13,0,106
5,18,7,15,20,9,19,13,19,125
5,18,7,15,20,9,19,20,0,113
5,18,7,15,20,9,26,5,0,105
5,18,7,15,20,9,26,5,4,109
5,18,7,15,20,15,24,9,14,127
5,18,7,15,20,19,0,0,0,84
5,18,7,19,0,0,0,0,0,49
5,18,7,21,19,9,1,0,0,80
5,18,25,0,0,0,0,0,0,48
5,18,9,1,0,0,0,0,0,33
5,18,9,3,1,4,0,0,0,40
5,18,9,3,1,12,0,0,0,48
5,18,9,3,1,19,0,0,0,55
5,18,9,3,5,20,1,12,0,73
5,18,9,3,5,20,21,13,0,94
5,18,9,3,8,20,8,21,19,111
5,18,9,3,8,20,15,9,4,91
5,18,9,3,9,21,19,0,0,84
5,18,9,3,15,9,4,0,0,63
5,18,9,3,15,12,9,14,0,85
5,18,9,7,5,18,15,14,19,110
5,18,9,7,9,2,12,5,0,67
5,18,25,8,20,18,9,19,13,135
5,18,9,11,9,20,5,0,0,77
5,18,9,14,5,21,13,0,0,85
5,18,9,14,7,15,0,0,0,68
5,18,25,14,7,15,0,0,0,84
5,18,9,14,7,15,5,19,0,92
5,18,25,14,7,15,5,19,0,108
5,18,9,14,7,15,19,0,0,87
5,18,25,14,7,15,19,0,0,103
5,18,9,14,9,20,5,0,0,80
5,18,9,14,14,9,3,0,0,72
5,18,9,14,15,19,5,0,0,85
5,18,9,15,13,5,20,5,18,108
5,18,9,15,14,9,20,5,0,95
5,18,9,15,16,8,25,9,4,109
5,18,25,15,16,9,4,0,0,92
5,18,25,15,16,19,9,4,0,111
5,18,9,19,20,9,3,0,0,83
5,18,9,19,20,9,3,1,12,96
5,18,9,19,20,9,3,19,0,102
5,18,25,20,8,5,13,1,0,95
5,18,25,20,8,5,13,1,12,107
5,18,25,20,8,5,13,1,19,114
5,18,25,20,8,5,13,9,3,106
5,18,25,20,8,18,5,1,14,114
5,18,25,20,8,18,5,14,5,118
5,18,25,20,8,18,9,3,0,106
5,18,25,20,8,18,9,14,0,117
5,18,25,20,8,18,9,14,5,122
5,18,25,20,8,18,9,19,13,135
5,18,25,20,8,18,9,20,5,128
5,18,25,20,8,18,15,9,4,122
5,18,25,20,8,18,15,12,0,121
5,18,25,20,8,18,15,14,0,123
5,18,25,20,8,18,15,14,19,142
5,18,25,20,8,18,15,19,5,133
5,18,9,26,15,0,0,0,0,73
5,18,11,0,0,0,0,0,0,34
5,18,11,5,0,0,0,0,0,39
5,18,12,9,3,8,5,0,0,60
5,18,12,11,9,14,7,0,0,76
5,18,12,11,9,14,7,19,0,95
5,18,13,5,12,9,14,0,0,76
5,18,13,9,12,9,14,5,0,85
5,18,13,9,14,5,4,0,0,68
5,18,13,9,14,5,5,0,0,69
5,18,13,9,14,5,19,0,0,83
5,18,13,9,14,5,20,20,5,109
5,18,13,9,14,9,14,7,0,89
5,18,13,9,14,9,20,5,19,112
5,18,13,9,14,15,9,19,0,102
5,18,13,9,20,0,0,0,0,65
5,18,14,5,19,0,0,0,0,61
5,18,14,5,19,19,5,0,0,85
5,18,14,19,0,0,0,0,0,56
5,18,15,4,1,2,12,5,0,62
5,18,15,4,5,0,0,0,0,47
5,18,15,4,5,4,0,0,0,51
5,18,15,4,5,14,20,0,0,81
5,18,15,4,5,19,0,0,0,66
5,18,15,4,9,2,12,5,0,70
5,18,15,4,9,14,7,0,0,72
5,18,15,7,1,20,5,0,0,71
5,18,15,7,5,14,25,0,0,89
5,18,15,7,5,14,9,3,0,76
5,18,15,7,5,14,15,21,19,119
5,18,15,13,1,14,9,1,0,76
5,18,15,19,5,0,0,0,0,62
5,18,15,19,5,12,25,0,0,99
5,18,15,19,5,19,0,0,0,81
5,18,15,19,9,2,12,5,0,85
5,18,15,19,9,15,14,0,0,95
5,18,15,19,9,15,14,1,12,108
5,18,15,19,9,15,14,19,0,114
5,18,15,19,9,22,5,0,0,93
5,18,15,19,9,22,9,20,25,142
5,18,15,19,20,18,1,20,5,121
5,18,15,20,5,13,1,0,0,77
5,18,15,20,5,13,5,0,0,81
5,18,15,20,5,19,9,19,0,110
5,18,15,20,5,20,9,3,0,95
5,18,15,20,9,3,0,0,0,70
5,18,15,20,9,3,1,0,0,71
5,18,15,20,9,3,1,12,0,83
5,18,15,20,9,3,9,19,13,111
5,18,15,20,9,3,9,19,20,118
5,18,15,20,9,3,9,26,5,110
5,18,15,20,9,3,19,0,0,89
5,18,15,20,25,12,9,4,0,108
5,18,15,20,9,19,13,0,0,99
5,18,15,20,9,19,13,19,0,118
5,18,15,20,9,26,5,0,0,98
5,18,15,20,9,26,5,4,0,102
5,18,15,20,9,26,5,19,0,117
5,18,15,20,9,26,9,14,7,123
5,18,15,20,15,12,15,7,25,132
5,18,15,20,15,16,1,20,8,118
5,18,18,0,0,0,0,0,0,41
5,18,18,1,2,12,5,0,0,61
5,18,18,1,2,21,14,4,0,83
5,18,18,1,14,3,25,0,0,84
5,18,18,1,14,3,9,5,19,92
5,18,18,1,14,4,0,0,0,60
5,18,18,1,14,4,19,0,0,79
5,18,18,1,14,20,0,0,0,76
5,18,18,1,14,20,12,25,0,113
5,18,18,1,14,20,18,25,0,119
5,18,18,1,14,20,19,0,0,95
5,18,18,1,20,1,0,0,0,63
5,18,18,1,20,1,19,0,0,82
5,18,18,1,20,9,3,0,0,74
5,18,18,1,20,9,3,1,12,87
5,18,18,1,20,9,3,19,0,93
5,18,18,1,20,21,13,0,0,96
5,18,18,1,20,21,13,19,0,115
5,18,18,1,20,21,20,1,0,104
5,18,18,5,4,0,0,0,0,50
5,18,18,8,9,14,5,0,0,77
5,18,18,8,9,14,5,19,0,96
5,18,18,9,14,7,0,0,0,71
5,18,18,9,14,7,12,25,0,108
5,18,18,9,20,5,0,0,0,75
5,18,18,15,14,0,0,0,0,70
5,18,18,15,14,5,15,21,19,130
5,18,18,15,18,0,0,0,0,74
5,18,18,15,18,4,21,13,16,128
5,18,18,15,18,6,21,12,0,113
5,18,18,15,18,9,19,20,0,122
5,18,18,15,18,12,5,19,19,129
5,18,18,15,18,19,0,0,0,93
5,18,18,19,0,0,0,0,0,60
5,18,18,19,25,14,0,0,0,99
5,18,19,1,20,26,0,0,0,89
5,18,19,1,20,26,5,19,0,113
5,18,19,5,19,0,0,0,0,66
5,18,19,8,0,0,0,0,0,50
5,18,19,20,0,0,0,0,0,62
5,18,19,20,23,8,9,12,5,119
5,18,20,8,0,0,0,0,0,51
5,18,20,8,5,14,0,0,0,70
5,18,20,8,12,25,0,0,0,88
5,18,20,8,12,9,14,7,0,93
5,18,21,3,0,0,0,0,0,47
5,18,21,3,9,3,0,0,0,59
5,18,21,3,9,6,15,18,13,108
5,18,21,3,9,14,0,0,0,70
5,18,21,3,20,0,0,0,0,67
5,18,21,3,20,1,14,3,5,90
5,18,21,3,20,1,20,5,0,93
5,18,21,3,20,1,20,5,4,97
5,18,21,3,20,1,20,5,19,112
5,18,21,3,20,5,4,0,0,76
5,18,21,3,20,9,14,7,0,97
5,18,21,3,20,9,15,14,0,105
5,18,21,3,20,19,0,0,0,86
5,18,21,4,9,20,0,0,0,77
5,18,21,4,9,20,5,0,0,82
5,18,21,4,9,20,5,12,25,119
5,18,21,4,9,20,9,15,14,115
5,18,21,7,1,20,5,0,0,77
5,18,21,7,1,20,9,15,14,110
5,18,21,7,1,20,15,18,25,130
5,18,21,7,9,14,15,21,19,129
5,18,21,7,15,0,0,0,0,66
5,18,21,7,15,19,0,0,0,85
5,18,21,13,16,0,0,0,0,73
5,18,21,13,16,5,14,20,0,112
5,18,21,16,20,0,0,0,0,80
5,18,21,16,20,5,4,0,0,89
5,18,21,16,20,9,2,12,5,108
5,18,21,16,20,9,14,7,0,110
5,18,21,16,20,9,15,14,0,118
5,18,21,16,20,9,15,14,19,137
5,18,21,16,20,9,22,5,0,116
5,18,21,16,20,9,22,5,19,135
5,18,21,16,20,19,0,0,0,99
5,18,22,9,12,0,0,0,0,66
5,18,22,9,12,19,0,0,0,85
5,18,26,1,8,12,5,18,0,93
5,19,2,1,25,0,0,0,0,52
5,19,3,1,0,0,0,0,0,28
5,19,3,1,12,1,4,5,0,50
5,19,3,1,12,1,4,5,4,54
5,19,3,1,12,1,4,5,18,68
5,19,3,1,12,1,4,5,19,69
5,19,3,1,12,1,4,15,0,60
5,19,3,1,12,1,14,0,0,55
5,19,3,1,12,1,20,5,0,66
5,19,3,1,12,1,20,5,4,70
5,19,3,1,12,1,20,5,19,85
5,19,3,1,12,9,5,18,0,72
5,19,3,1,12,9,14,0,0,63
5,19,3,1,12,12,15,16,0,83
5,19,3,1,12,12,15,16,19,102
5,19,3,1,12,15,16,0,0,71
5,19,3,1,12,15,16,5,0,76
5,19,3,1,12,15,16,5,4,80
5,19,3,1,12,15,16,19,0,90
5,19,3,1,13,2,9,15,0,67
5,19,3,1,13,2,18,15,14,90
5,19,3,1,16,1,2,12,5,64
5,19,3,1,16,1,4,5,0,54
5,19,3,1,16,1,4,5,19,73
5,19,3,1,16,1,4,15,0,64
5,19,3,1,16,1,7,5,0,57
5,19,3,1,16,5,0,0,0,49
5,19,3,1,16,5,4,0,0,53
5,19,3,1,16,5,5,0,0,54
5,19,3,1,16,5,5,19,0,73
5,19,3,1,16,5,6,21,12,88
5,19,3,1,16,5,18,0,0,67
5,19,3,1,16,5,18,19,0,86
5,19,3,1,16,5,19,0,0,68
5,19,3,1,16,5,23,1,25,98
5,19,3,1,16,9,14,7,0,74
5,19,3,1,16,9,19,13,0,85
5,19,3,1,16,9,19,13,19,104
5,19,3,1,16,9,19,20,0,92
5,19,3,1,16,9,19,20,19,111
5,19,3,1,18,0,0,0,0,46
5,19,3,1,18,7,15,20,0,88
5,19,3,1,18,7,15,20,19,107
5,19,3,1,18,15,12,5,0,78
5,19,3,1,18,15,12,5,19,97
5,19,3,1,18,16,0,0,0,62
5,19,3,1,18,16,5,4,0,71
5,19,3,1,18,16,9,14,7,92
5,19,3,1,18,16,19,0,0,81
5,19,3,1,18,19,0,0,0,65
5,19,3,5,14,3,5,0,0,54
5,19,3,5,14,20,0,0,0,66
5,19,3,8,1,12,15,20,0,83
5,19,3,8,1,12,15,20,19,102
5,19,3,8,1,18,0,0,0,54
5,19,3,8,1,18,1,0,0,55
5,19,3,8,1,18,9,14,5,82
5,19,3,8,1,18,15,9,4,82
5,19,3,8,1,18,19,0,0,73
5,19,3,8,1,21,6,5,0,68
5,19,3,8,1,21,14,7,5,83
5,19,3,8,5,1,20,0,0,61
5,19,3,8,5,1,20,5,4,70
5,19,3,8,5,1,20,15,18,94
5,19,3,8,5,1,20,19,0,80
5,19,3,8,5,12,0,0,0,52
5,19,3,8,5,12,5,0,0,57
5,19,3,8,5,22,5,0,0,67
5,19,3,8,5,22,9,14,0,85
5,19,3,8,5,23,0,0,0,63
5,19,3,8,5,23,1,12,0,76
5,19,3,8,5,23,1,12,19,95
5,19,3,8,5,23,5,4,0,72
5,19,3,8,5,23,5,18,0,86
5,19,3,8,5,23,5,18,19,105
5,19,3,8,5,23,9,14,7,93
5,19,3,8,5,23,19,0,0,82
5,19,3,8,25,14,9,20,5,108
5,19,3,8,15,16,16,5,0,87
5,19,3,8,18,21,6,5,0,85
5,19,3,12,1,14,4,18,5,81
5,19,3,12,1,22,1,7,5,75
5,19,3,15,2,1,0,0,0,45
5,19,3,15,2,5,4,15,0,68
5,19,3,15,2,9,12,12,1,78
5,19,3,15,2,9,20,1,0,74
5,19,3,15,3,8,5,15,14,87
5,19,3,15,12,1,18,0,0,73
5,19,3,15,12,1,18,19,0,92
5,19,3,15,14,19,15,14,0,104
5,19,3,15,16,5,20,0,0,83
5,19,3,15,16,5,20,1,0,84
5,19,3,15,16,5,20,20,5,108
5,19,3,15,18,20,0,0,0,80
5,19,3,15,18,20,1,7,5,93
5,19,3,15,18,20,5,4,0,89
5,19,3,15,18,20,5,5,0,90
5,19,3,15,18,20,9,14,7,110
5,19,3,15,18,20,19,0,0,99
5,19,3,15,20,0,0,0,0,62
5,19,3,15,20,5,4,0,0,71
5,19,3,15,20,9,14,7,0,92
5,19,3,15,20,19,0,0,0,81
5,19,3,15,21,20,0,0,0,83
5,19,3,18,25,0,0,0,0,70
5,19,3,18,9,2,1,14,15,86
5,19,3,18,9,2,5,0,0,61
5,19,3,18,9,2,5,4,0,65
5,19,3,18,9,2,9,14,7,86
5,19,3,18,9,13,5,0,0,72
5,19,3,18,9,16,20,0,0,90
5,19,3,18,15,4,0,0,0,64
5,19,3,18,15,12,0,0,0,72
5,19,3,18,15,12,12,0,0,84
5,19,3,18,15,16,21,12,15,124
5,19,3,18,15,23,0,0,0,83
5,19,3,18,15,23,5,4,0,92
5,19,3,18,15,23,5,5,0,93
5,19,3,18,15,23,9,14,7,113
5,19,3,18,15,23,19,0,0,102
5,19,3,18,21,1,7,5,0,79
5,19,3,21,1,7,5,0,0,61
5,19,3,21,1,7,5,19,0,80
5,19,3,21,4,15,0,0,0,67
5,19,3,21,4,15,19,0,0,86
5,19,3,21,5,12,1,0,0,66
5,19,3,21,12,5,14,20,0,99
5,19,3,21,12,5,14,20,19,118
5,19,3,21,12,5,20,9,14,108
5,19,3,21,12,9,3,0,0,72
5,19,3,21,12,9,14,0,0,83
5,19,4,18,1,7,15,12,0,81
5,19,5,0,0,0,0,0,0,29
5,19,5,13,16,12,1,19,25,115
5,19,5,16,20,1,20,5,0,91
5,19,5,18,5,0,0,0,0,52
5,19,5,18,9,14,0,0,0,70
5,19,5,18,9,14,5,0,0,75
5,19,5,18,9,14,5,19,0,94
5,19,5,19,0,0,0,0,0,48
5,19,5,24,21,1,12,0,0,87
5,19,7,21,1,18,4,0,0,75
5,19,8,9,14,0,0,0,0,55
5,19,9,16,8,15,14,1,12,99
5,19,11,1,18,0,0,0,0,54
5,19,11,1,18,19,0,0,0,73
5,19,11,5,18,0,0,0,0,58
5,19,11,5,18,19,0,0,0,77
5,19,11,9,13,15,5,19,0,96
5,19,12,1,2,15,14,0,0,68
5,19,12,9,19,15,18,0,0,97
5,19,12,15,9,7,14,0,0,81
5,19,13,1,25,12,5,0,0,80
5,19,14,5,0,0,0,0,0,43
5,19,14,5,3,25,0,0,0,71
5,19,15,3,25,3,12,9,3,94
5,19,15,3,9,6,15,18,13,103
5,19,15,4,9,3,0,0,0,55
5,19,15,14,5,21,18,1,12,110
5,19,15,16,7,9,0,0,0,71
5,19,15,16,8,1,7,1,12,84
5,19,15,16,8,1,7,9,0,80
5,19,15,16,8,1,7,15,0,86
5,19,15,16,8,1,7,21,19,111
5,19,15,16,8,15,18,9,1,106
5,19,15,16,8,15,18,9,3,108
5,19,15,20,5,18,25,0,0,107
5,19,15,20,5,18,9,3,0,94
5,19,15,20,5,18,9,3,1,95
5,19,15,20,5,18,9,3,19,113
5,19,15,20,5,18,9,19,13,123
5,19,15,20,5,18,9,19,20,130
5,19,15,20,5,18,9,26,5,122
5,19,15,20,18,15,16,5,0,113
5,19,15,20,18,15,16,9,1,118
5,19,15,20,18,15,16,9,3,120
5,19,16,1,3,5,0,0,0,49
5,19,16,1,4,1,0,0,0,46
5,19,16,1,4,15,14,0,0,74
5,19,16,1,7,14,15,12,5,94
5,19,16,1,12,9,5,18,0,85
5,19,16,1,12,9,5,18,19,104
5,19,16,1,14,15,12,0,0,82
5,19,16,1,14,15,12,5,19,106
5,19,16,1,14,20,15,15,14,119
5,19,16,1,18,3,5,20,0,87
5,19,16,1,18,20,15,19,0,113
5,19,16,1,20,8,1,20,5,95
5,19,16,1,22,5,0,0,0,68
5,19,16,1,22,5,12,0,0,80
5,19,16,5,3,5,0,0,0,53
5,19,16,5,3,9,1,12,0,70
5,19,16,5,9,18,5,0,0,77
5,19,16,8,18,5,19,9,19,118
5,19,16,9,1,12,0,0,0,62
5,19,16,9,1,12,19,0,0,81
5,19,16,9,5,4,0,0,0,58
5,19,16,9,5,7,12,5,0,78
5,19,16,9,5,18,0,0,0,72
5,19,16,9,5,19,0,0,0,73
5,19,16,9,7,12,5,0,0,73
5,19,16,25,9,14,7,0,0,95
5,19,16,9,14,1,12,0,0,76
5,19,16,9,14,5,12,0,0,80
5,19,16,9,14,5,20,20,5,113
5,19,16,9,14,7,15,12,5,102
5,19,16,9,14,9,12,12,15,111
5,19,16,9,14,15,0,0,0,78
5,19,16,9,14,15,19,0,0,97
5,19,16,9,15,14,1,7,5,91
5,19,16,12,1,14,1,4,5,77
5,19,16,12,5,5,19,0,0,81
5,19,16,15,14,20,15,14,0,118
5,19,16,15,14,20,15,15,14,133
5,19,16,15,21,19,1,7,5,108
5,19,16,15,21,19,1,12,0,108
5,19,16,15,21,19,1,12,19,127
5,19,16,15,21,19,5,0,0,100
5,19,16,15,21,19,5,4,0,104
5,19,16,15,21,19,5,18,0,118
5,19,16,15,21,19,5,18,19,137
5,19,16,15,21,19,5,19,0,119
5,19,16,15,21,19,9,14,7,125
5,19,16,18,5,19,19,15,0,116
5,19,16,18,5,19,19,15,19,135
5,19,16,18,9,14,7,1,12,101
5,19,16,18,9,19,5,0,0,91
5,19,16,18,9,20,0,0,0,87
5,19,16,18,9,20,19,0,0,106
5,19,16,18,15,22,5,0,0,100
5,19,16,21,14,4,9,1,0,89
5,19,17,21,1,13,1,20,5,102
5,19,17,21,5,0,0,0,0,67
5,19,17,21,9,18,5,4,0,98
5,19,17,21,9,18,5,19,0,113
5,19,17,21,9,18,9,14,7,119
5,19,17,21,9,19,19,5,0,114
5,19,18,15,7,0,0,0,0,64
5,19,18,15,7,9,13,0,0,86
5,19,18,15,7,19,0,0,0,83
5,19,19,0,0,0,0,0,0,43
5,19,19,1,25,0,0,0,0,69
5,19,19,1,25,5,4,0,0,78
5,19,19,1,25,5,18,0,0,92
5,19,19,1,25,5,18,19,0,111
5,19,19,1,25,5,20,20,5,119
5,19,19,1,25,9,3,1,12,94
5,19,19,1,25,9,14,7,0,99
5,19,19,1,25,9,19,8,0,105
5,19,19,1,25,9,19,13,0,110
5,19,19,1,25,9,19,20,0,117
5,19,19,1,25,9,19,20,19,136
5,19,19,1,25,12,5,20,0,106
5,19,19,1,25,19,0,0,0,88
5,19,19,1,14,3,9,1,0,71
5,19,19,1,14,3,9,1,19,90
5,19,19,1,14,7,0,0,0,65
5,19,19,1,18,20,0,0,0,82
5,19,19,5,0,0,0,0,0,48
5,19,19,5,4,0,0,0,0,52
5,19,19,5,4,1,0,0,0,53
5,19,19,5,4,5,0,0,0,57
5,19,19,5,5,0,0,0,0,53
5,19,19,5,14,3,5,0,0,70
5,19,19,5,14,3,5,4,0,74
5,19,19,5,14,3,5,19,0,89
5,19,19,5,14,3,25,0,0,90
5,19,19,5,14,3,9,14,7,95
5,19,19,5,14,8,15,21,20,126
5,19,19,5,14,20,9,1,0,92
5,19,19,5,14,20,9,1,12,104
5,19,19,5,14,23,15,15,4,119
5,19,19,5,18,1,0,0,0,67
5,19,19,5,19,0,0,0,0,67
5,19,19,5,24,9,20,5,0,106
5,19,19,9,22,5,0,0,0,79
5,19,19,12,9,14,7,0,0,85
5,19,19,15,9,7,14,0,0,88
5,19,19,15,9,14,0,0,0,81
5,19,19,15,9,14,5,4,0,90
5,19,19,15,9,14,5,5,0,91
5,19,19,15,9,14,5,18,0,104
5,19,19,15,9,14,9,14,7,111
5,19,19,15,9,14,19,0,0,100
5,19,19,15,14,9,20,5,0,106
5,19,19,15,14,9,20,5,19,125
5,19,19,15,18,1,14,20,0,111
5,19,20,0,0,0,0,0,0,44
5,19,20,1,2,0,0,0,0,47
5,19,20,1,2,12,5,0,0,64
5,19,20,1,2,12,9,19,8,95
5,19,20,1,3,1,4,5,0,58
5,19,20,1,4,1,12,0,0,62
5,19,20,1,4,5,12,0,0,66
5,19,20,1,4,9,15,0,0,73
5,19,20,1,4,15,0,0,0,64
5,19,20,1,6,1,0,0,0,52
5,19,20,1,6,5,20,0,0,76
5,19,20,1,6,5,20,20,5,101
5,19,20,1,12,12,0,0,0,69
5,19,20,1,13,5,14,5,0,82
5,19,20,1,13,9,14,0,0,81
5,19,20,1,13,9,14,5,20,106
5,19,20,1,13,16,0,0,0,74
5,19,20,1,13,16,1,7,5,87
5,19,20,1,13,16,5,4,5,88
5,19,20,1,13,16,9,5,0,88
5,19,20,1,14,3,9,1,19,91
5,19,20,1,14,7,0,0,0,66
5,19,20,1,14,20,9,15,14,117
5,19,20,1,20,5,0,0,0,70
5,19,20,1,20,5,4,0,0,74
5,19,20,1,20,5,12,25,0,107
5,19,20,1,20,5,19,0,0,89
5,19,20,1,20,9,14,7,0,95
5,19,20,1,20,19,0,0,0,84
5,19,20,5,5,13,0,0,0,67
5,19,20,5,5,13,5,4,0,76
5,19,20,5,5,13,5,18,0,90
5,19,20,5,5,13,9,14,7,97
5,19,20,5,5,13,19,0,0,86
5,19,20,5,18,1,19,5,0,92
5,19,20,5,18,1,19,5,19,111
5,19,20,5,18,9,6,25,0,107
5,19,20,5,18,9,26,5,0,107
5,19,20,5,18,12,9,14,0,102
5,19,20,5,18,12,9,14,7,109
5,19,20,5,18,15,19,0,0,101
5,19,20,5,18,19,0,0,0,86
5,19,20,5,22,9,14,0,0,94
5,19,20,8,5,18,9,1,14,99
5,19,20,8,5,19,5,19,0,100
5,19,20,8,5,19,9,1,0,86
5,19,20,8,5,19,9,1,19,105
5,19,20,8,5,19,9,15,0,100
5,19,20,8,5,19,9,19,0,104
5,19,20,8,5,20,5,0,0,82
5,19,20,8,5,20,5,19,0,101
5,19,20,8,5,20,9,3,0,89
5,19,20,8,5,20,9,3,19,108
5,19,20,9,13,1,2,12,5,86
5,19,20,9,13,1,2,12,25,106
5,19,20,9,13,1,20,5,0,92
5,19,20,9,13,1,20,5,4,96
5,19,20,9,13,1,20,5,19,111
5,19,20,9,13,1,20,15,18,120
5,19,20,9,22,1,7,5,0,88
5,19,20,9,22,1,12,0,0,88
5,19,20,9,22,1,20,5,0,101
5,19,20,9,22,1,20,5,4,105
5,19,20,9,22,1,20,5,19,120
5,19,20,9,22,1,20,15,18,129
5,19,20,9,22,5,0,0,0,80
5,19,20,13,1,18,11,0,0,87
5,19,20,15,3,0,0,0,0,62
5,19,20,15,3,1,4,1,0,68
5,19,20,15,3,19,0,0,0,81
5,19,20,15,9,12,0,0,0,80
5,19,20,15,9,12,5,0,0,85
5,19,20,15,12,9,4,5,0,89
5,19,20,15,14,9,1,14,19,116
5,19,20,15,16,0,0,0,0,75
5,19,20,15,16,16,1,7,5,104
5,19,20,15,16,16,1,12,0,104
5,19,20,15,16,16,5,4,0,100
5,19,20,15,16,16,5,12,0,108
5,19,20,15,16,16,5,12,19,127
5,19,20,15,16,16,9,14,7,121
5,19,20,15,16,19,0,0,0,94
5,19,20,15,17,21,5,0,0,102
5,19,20,15,22,5,18,19,0,123
5,19,20,18,1,4,1,0,0,68
5,19,20,18,1,4,1,19,0,87
5,19,20,18,1,4,5,0,0,72
5,19,20,18,1,4,9,15,12,103
5,19,20,18,1,4,9,15,20,111
5,19,20,18,1,4,15,0,0,82
5,19,20,18,1,7,15,12,0,97
5,19,20,18,1,7,15,12,5,102
5,19,20,18,1,7,15,14,0,99
5,19,20,18,1,7,15,14,19,118
5,19,20,18,1,25,0,0,0,88
5,19,20,18,1,25,5,4,0,97
5,19,20,18,1,25,9,14,7,118
5,19,20,18,1,25,19,0,0,107
5,19,20,18,1,12,0,0,0,75
5,19,20,18,1,14,7,5,0,89
5,19,20,18,1,14,7,5,4,93
5,19,20,18,1,14,7,5,18,107
5,19,20,18,1,14,7,5,19,108
5,19,20,18,1,14,7,12,5,101
5,19,20,18,1,16,1,4,5,89
5,19,20,18,5,0,0,0,0,67
5,19,20,18,5,1,20,0,0,88
5,19,20,18,5,1,20,5,4,97
5,19,20,18,5,1,20,19,0,107
5,19,20,18,5,16,5,0,0,88
5,19,20,18,9,1,20,5,0,97
5,19,20,18,9,3,8,0,0,82
5,19,20,18,9,3,8,5,0,87
5,19,20,18,9,6,0,0,0,77
5,19,20,18,9,14,19,0,0,104
5,19,20,18,9,15,12,0,0,98
5,19,20,18,9,15,12,19,0,117
5,19,20,18,15,7,5,14,0,103
5,19,20,18,15,7,5,14,19,122
5,19,20,18,15,14,5,0,0,96
5,19,20,18,15,14,5,19,0,115
5,19,20,18,15,21,19,0,0,117
5,19,20,18,21,1,12,0,0,96
5,19,20,18,21,1,20,5,0,109
5,19,20,18,21,13,0,0,0,96
5,19,20,18,21,13,19,0,0,115
5,19,20,18,21,19,0,0,0,102
5,19,20,18,21,19,5,19,0,126
5,19,20,21,1,14,20,0,0,100
5,19,20,21,1,18,25,0,0,109
5,19,20,21,1,18,9,1,12,106
5,19,20,21,1,18,9,1,14,108
5,19,20,21,1,18,9,5,19,117
5,19,20,21,1,18,9,14,5,112
5,19,20,21,1,20,5,0,0,91
5,19,20,21,4,25,0,0,0,94
5,19,20,21,6,1,0,0,0,72
5,19,20,21,15,19,9,20,25,153
5,19,20,21,15,21,19,0,0,120
5,19,20,21,18,5,0,0,0,88
5,19,21,18,9,5,14,3,5,99
5,19,21,18,9,5,14,3,25,119
5,19,21,18,9,5,14,20,0,111
5,19,21,18,9,14,5,0,0,91
5,20,3,5,20,5,18,1,0,77
5,20,3,5,20,5,18,1,19,96
5,20,3,8,0,0,0,0,0,36
5,20,3,8,1,14,20,0,0,71
5,20,3,8,1,14,20,19,0,90
5,20,3,8,5,4,0,0,0,45
5,20,3,8,5,18,0,0,0,59
5,20,3,8,5,18,19,0,0,78
5,20,3,8,5,19,0,0,0,60
5,20,3,8,9,14,7,0,0,66
5,20,3,8,9,14,7,19,0,85
5,20,5,14,0,0,0,0,0,44
5,20,5,15,19,20,9,3,0,96
5,20,5,18,14,1,12,0,0,75
5,20,5,18,14,1,12,12,25,112
5,20,5,18,14,1,12,19,0,94
5,20,5,18,14,5,0,0,0,67
5,20,5,18,14,9,19,5,0,95
5,20,5,18,14,9,19,5,4,99
5,20,5,18,14,9,19,5,19,114
5,20,5,18,14,9,19,8,0,98
5,20,5,18,14,9,20,25,0,116
5,20,5,18,14,9,26,5,0,102
5,20,5,18,14,9,26,5,4,106
5,20,5,18,14,9,26,5,19,121
5,20,5,19,9,1,14,0,0,73
5,20,5,19,9,1,14,19,0,92
5,20,8,0,0,0,0,0,0,33
5,20,8,1,12,0,0,0,0,46
5,20,8,1,14,1,12,0,0,61
5,20,8,1,14,5,0,0,0,53
5,20,8,1,14,5,19,0,0,72
5,20,8,1,14,15,25,12,0,100
5,20,8,1,14,15,12,0,0,75
5,20,8,1,14,15,12,19,0,94
5,20,8,5,12,9,14,7,0,80
5,20,8,5,14,5,0,0,0,57
5,20,8,5,14,5,19,0,0,76
5,20,8,5,14,9,3,0,0,64
5,20,8,5,14,25,12,0,0,89
5,20,8,5,14,15,9,4,0,80
5,20,8,5,14,15,12,0,0,79
5,20,8,5,16,8,15,14,0,91
5,20,8,5,18,0,0,0,0,56
5,20,8,5,18,1,20,5,0,82
5,20,8,5,18,5,1,12,0,74
5,20,8,5,18,5,1,14,0,76
5,20,8,5,18,5,4,0,0,65
5,20,8,5,18,5,14,5,0,80
5,20,8,5,18,5,15,21,19,116
5,20,8,5,18,9,1,12,0,78
5,20,8,5,18,9,3,0,0,68
5,20,8,5,18,9,3,1,12,81
5,20,8,5,18,9,6,25,0,96
5,20,8,5,18,9,14,0,0,79
5,20,8,5,18,9,15,14,0,94
5,20,8,5,18,9,19,8,0,92
5,20,8,5,18,9,19,13,0,97
5,20,8,5,18,9,26,5,0,96
5,20,8,5,18,9,26,5,4,100
5,20,8,5,18,9,26,5,18,114
5,20,8,5,18,9,26,5,19,115
5,20,8,5,18,12,9,11,5,93
5,20,8,5,18,14,5,20,0,95
5,20,8,5,18,14,5,20,19,114
5,20,8,5,18,15,12,0,0,83
5,20,8,5,18,15,21,19,0,111
5,20,8,5,18,19,0,0,0,75
5,20,8,9,3,0,0,0,0,45
5,20,8,9,3,1,12,0,0,58
5,20,8,9,3,1,12,12,25,95
5,20,8,9,3,1,12,19,0,77
5,20,8,9,3,9,1,14,0,69
5,20,8,9,3,9,1,14,19,88
5,20,8,9,3,9,19,13,0,86
5,20,8,9,3,9,19,20,0,93
5,20,8,9,3,9,19,20,19,112
5,20,8,9,3,9,26,5,0,85
5,20,8,9,3,9,26,5,4,89
5,20,8,9,3,9,26,5,19,104
5,20,8,9,3,19,0,0,0,64
5,20,8,9,4,0,0,0,0,46
5,20,8,9,4,5,0,0,0,51
5,20,8,9,4,5,14,5,0,70
5,20,8,25,12,1,13,9,14,107
5,20,8,25,12,1,20,5,0,96
5,20,8,25,12,1,20,5,4,100
5,20,8,25,12,1,20,5,19,115
5,20,8,25,12,5,14,5,0,94
5,20,8,25,12,5,14,5,19,113
5,20,8,25,12,5,14,9,3,101
5,20,8,25,12,9,3,0,0,82
5,20,8,25,12,9,14,0,0,93
5,20,8,25,12,19,0,0,0,89
5,20,8,9,14,5,0,0,0,61
5,20,8,25,14,5,0,0,0,77
5,20,8,25,14,5,19,0,0,96
5,20,8,9,14,25,12,0,0,93
5,20,8,25,14,25,12,0,0,109
5,20,8,9,14,25,12,19,0,112
5,20,8,25,14,25,12,19,0,128
5,20,8,9,15,4,9,4,5,79
5,20,8,9,15,14,0,0,0,71
5,20,8,9,15,14,9,3,0,83
5,20,8,9,15,14,9,14,5,99
5,20,8,9,15,14,19,0,0,90
5,20,8,9,15,16,19,0,0,92
5,20,8,9,26,5,0,0,0,73
5,20,8,13,15,9,4,0,0,74
5,20,8,13,15,9,4,1,12,87
5,20,8,13,15,9,4,19,0,93
5,20,8,13,15,12,9,20,8,110
5,20,8,13,15,19,5,0,0,85
5,20,8,14,1,12,0,0,0,60
5,20,8,14,1,18,3,8,0,77
5,20,8,14,1,18,3,8,25,102
5,20,8,14,1,18,3,8,19,96
5,20,8,14,9,3,0,0,0,59
5,20,8,14,9,3,1,12,0,72
5,20,8,14,9,3,9,19,13,100
5,20,8,14,9,3,9,19,20,107
5,20,8,14,9,3,9,20,25,113
5,20,8,14,9,3,9,26,5,99
5,20,8,14,9,3,15,14,0,88
5,20,8,14,9,3,19,0,0,78
5,20,8,14,9,19,8,0,0,83
5,20,8,14,9,26,5,0,0,87
5,20,8,14,15,4,9,3,25,103
5,20,8,14,15,7,0,0,0,69
5,20,8,14,15,7,5,14,25,113
5,20,8,14,15,12,0,0,0,74
5,20,8,14,15,12,15,7,25,121
5,20,8,14,15,19,0,0,0,81
5,20,8,14,15,19,5,19,0,105
5,20,8,15,12,9,4,5,0,78
5,20,8,15,12,15,7,25,0,107
5,20,8,15,12,15,7,9,3,94
5,20,8,15,14,15,13,9,3,102
5,20,8,15,14,15,14,5,0,96
5,20,8,15,16,15,5,9,1,94
5,20,8,15,19,0,0,0,0,67
5,20,8,15,19,5,19,0,0,91
5,20,8,15,24,25,0,0,0,97
5,20,8,15,24,9,4,5,0,90
5,20,8,15,24,9,5,19,0,105
5,20,8,15,24,25,12,0,0,109
5,20,8,15,24,25,12,19,0,128
5,20,8,18,15,7,0,0,0,73
5,20,8,18,15,7,9,13,0,95
5,20,8,18,15,7,19,0,0,92
5,20,8,19,0,0,0,0,0,52
5,20,25,0,0,0,0,0,0,50
5,20,9,1,13,0,0,0,0,48
5,20,9,3,0,0,0,0,0,37
5,20,25,13,0,0,0,0,0,63
5,20,25,13,1,0,0,0,0,64
5,20,25,13,9,3,0,0,0,75
5,20,25,13,15,12,0,0,0,90
5,20,25,13,15,12,15,7,25,137
5,20,25,13,15,14,0,0,0,92
5,20,25,13,15,14,9,3,0,104
5,20,25,13,15,14,19,0,0,111
5,20,9,15,7,5,14,9,3,87
5,20,9,15,12,1,20,5,0,87
5,20,9,15,12,1,20,5,4,91
5,20,9,15,12,1,20,5,19,106
5,20,9,15,12,9,14,0,0,84
5,20,9,15,12,9,26,5,0,101
5,20,9,15,12,15,7,25,0,108
5,20,9,15,12,15,7,9,3,95
5,20,9,15,12,15,7,21,5,109
5,20,25,16,9,3,0,0,0,78
5,20,25,16,9,3,1,12,0,91
5,20,9,17,21,5,20,0,0,97
5,20,9,17,21,5,20,20,5,122
5,20,14,1,19,0,0,0,0,59
5,20,15,6,6,5,0,0,0,57
5,20,15,9,12,5,19,0,0,85
5,20,15,21,6,6,5,0,0,78
5,20,18,5,14,14,5,0,0,81
5,20,18,9,5,18,0,0,0,75
5,20,18,15,7,0,0,0,0,65
5,20,18,15,7,9,13,0,0,87
5,20,18,15,7,19,0,0,0,84
5,20,18,21,19,3,1,14,19,120
5,20,20,5,0,0,0,0,0,50
5,20,20,5,18,3,1,16,0,88
5,20,20,9,18,15,14,5,0,106
5,20,20,12,5,0,0,0,0,62
5,20,20,12,5,4,0,0,0,66
5,20,20,12,9,14,7,0,0,87
5,20,21,1,0,0,0,0,0,47
5,20,21,4,5,0,0,0,0,55
5,20,21,4,5,19,0,0,0,74
5,20,21,9,0,0,0,0,0,55
5,20,21,9,19,0,0,0,0,74
5,20,21,22,5,0,0,0,0,73
5,20,21,22,5,5,0,0,0,78
5,20,23,1,19,0,0,0,0,68
5,20,23,5,5,0,0,0,0,58
5,20,23,5,5,19,0,0,0,77
5,20,23,9,20,5,0,0,0,82
5,21,2,20,5,18,9,1,0,81
5,21,3,1,9,14,5,0,0,58
5,21,3,1,9,14,5,19,0,77
5,21,3,1,9,18,9,20,5,91
5,21,3,1,12,25,14,0,0,81
5,21,3,1,12,25,16,20,0,103
5,21,3,1,12,25,16,20,9,112
5,21,3,1,12,25,16,20,19,122
5,21,3,1,18,25,15,20,5,113
5,21,3,1,18,16,9,3,0,76
5,21,3,1,18,16,15,21,19,119
5,21,3,7,9,1,0,0,0,46
5,21,3,8,25,13,15,21,19,130
5,21,3,8,12,15,18,9,3,94
5,21,3,8,15,12,15,7,25,111
5,21,3,8,18,5,0,0,0,60
5,21,3,8,18,5,4,0,0,64
5,21,3,8,18,5,19,0,0,79
5,21,3,8,18,9,14,7,0,85
5,21,3,8,18,15,9,3,0,82
5,21,3,8,18,15,9,20,5,104
5,21,3,8,18,15,13,5,0,88
5,21,3,8,18,15,14,5,0,89
5,21,3,25,3,12,9,3,0,81
5,21,3,9,12,9,1,20,5,85
5,21,3,12,1,19,5,0,0,66
5,21,3,12,1,19,5,19,0,85
5,21,3,12,5,9,4,0,0,59
5,21,3,15,12,9,20,5,0,90
5,21,3,15,14,5,0,0,0,63
5,21,3,15,14,9,3,0,0,70
5,21,3,15,19,13,9,4,0,89
5,21,3,18,1,19,25,0,0,92
5,21,3,18,1,19,9,1,0,77
5,21,3,18,1,19,9,20,5,101
5,21,3,18,5,0,0,0,0,52
5,21,3,18,9,20,5,0,0,81
5,21,3,18,9,20,5,19,0,100
5,21,3,18,9,20,9,3,0,88
5,21,3,20,9,0,0,0,0,58
5,21,3,20,9,3,1,12,0,74
5,21,4,1,0,0,0,0,0,31
5,21,4,1,5,13,15,14,0,78
5,21,4,1,5,13,15,14,25,103
5,21,4,1,5,13,15,14,19,97
5,21,4,1,12,5,14,5,0,67
5,21,4,5,13,15,14,0,0,77
5,21,4,5,13,15,14,25,0,102
5,21,4,5,13,15,14,9,1,87
5,21,4,5,13,15,14,9,3,89
5,21,4,5,13,15,14,19,0,96
5,21,4,5,19,13,15,12,0,94
5,21,4,9,1,12,25,20,5,102
5,21,5,3,20,9,3,0,0,66
5,21,5,13,5,18,9,19,13,108
5,21,6,12,1,22,9,14,5,95
5,21,7,5,0,0,0,0,0,38
5,21,7,5,14,5,19,9,3,88
5,21,7,5,14,5,19,9,19,104
5,21,7,5,14,5,20,9,3,89
5,21,7,5,14,25,0,0,0,77
5,21,7,5,14,9,1,19,0,81
5,21,7,5,14,9,3,0,0,64
5,21,7,5,14,9,3,1,12,77
5,21,7,5,14,9,3,19,0,83
5,21,7,5,14,9,19,13,0,93
5,21,7,5,14,9,19,20,0,100
5,21,7,5,14,9,19,20,19,119
5,21,7,5,14,15,12,0,0,79
5,21,7,5,14,15,12,19,0,98
5,21,7,12,5,14,1,19,0,84
5,21,7,12,5,14,15,9,4,92
5,21,7,15,14,9,3,0,0,74
5,21,8,1,7,5,19,0,0,66
5,21,8,5,4,18,1,12,0,74
5,21,11,1,9,18,9,20,5,99
5,21,11,1,18,25,15,20,5,121
5,21,11,20,15,12,9,20,5,118
5,21,12,1,3,8,1,14,0,65
5,21,12,1,3,8,1,14,19,84
5,21,12,1,3,8,15,14,0,79
5,21,12,1,3,8,15,14,19,98
5,21,12,25,19,9,20,5,0,116
5,21,12,25,20,9,14,0,0,106
5,21,12,25,20,9,14,5,0,111
5,21,12,25,20,9,20,5,0,117
5,21,12,15,7,25,0,0,0,85
5,21,12,15,7,9,1,0,0,70
5,21,12,15,7,9,1,5,0,75
5,21,12,15,7,9,1,19,0,89
5,21,12,15,7,9,3,0,0,72
5,21,12,15,7,9,3,1,12,85
5,21,12,15,7,9,5,19,0,93
5,21,12,15,7,9,15,21,19,124
5,21,12,15,7,9,19,5,0,93
5,21,12,15,7,9,19,5,4,97
5,21,12,15,7,9,19,5,18,111
5,21,12,15,7,9,19,5,19,112
5,21,12,15,7,9,19,13,0,101
5,21,12,15,7,9,19,20,0,108
5,21,12,15,7,9,19,20,19,127
5,21,12,15,7,9,21,13,0,103
5,21,12,15,7,9,21,13,19,122
5,21,12,15,7,9,26,5,0,100
5,21,12,15,7,9,26,5,4,104
5,21,12,15,7,9,26,5,18,118
5,21,12,15,7,9,26,5,19,119
5,21,12,15,16,8,9,4,0,90
5,21,13,5,12,1,14,9,14,94
5,21,13,5,14,9,4,0,0,71
5,21,13,5,18,9,19,13,0,103
5,21,13,25,3,5,20,5,0,97
5,21,13,25,3,5,20,9,3,104
5,21,13,9,20,15,19,9,19,130
5,21,13,9,20,15,20,9,3,115
5,21,13,15,9,18,15,21,19,136
5,21,13,15,18,16,8,9,3,108
5,21,14,4,5,13,0,0,0,62
5,21,14,9,3,9,4,0,0,65
5,21,14,15,13,25,0,0,0,93
5,21,14,21,3,8,0,0,0,72
5,21,14,21,3,8,1,12,0,85
5,21,14,21,3,8,9,19,5,105
5,21,14,21,3,8,9,19,13,113
5,21,14,21,3,8,9,26,5,112
5,21,14,21,3,8,15,9,4,100
5,21,14,21,3,8,18,25,0,115
5,21,14,21,3,8,19,0,0,91
5,21,15,4,9,3,0,0,0,57
5,21,15,14,25,13,0,0,0,93
5,21,15,14,25,13,25,0,0,118
5,21,15,14,25,13,9,14,0,116
5,21,15,14,25,13,15,21,19,148
5,21,15,19,13,9,20,5,0,107
5,21,15,21,1,5,0,0,0,68
5,21,16,1,4,0,0,0,0,47
5,21,16,1,20,8,25,0,0,96
5,21,16,1,20,15,18,25,0,121
5,21,16,1,20,15,18,9,14,119
5,21,16,1,20,18,9,4,0,94
5,21,16,1,20,18,9,4,19,113
5,21,16,5,16,19,25,0,0,107
5,21,16,5,16,19,9,1,0,92
5,21,16,5,16,19,9,1,19,111
5,21,16,5,16,19,9,5,19,115
5,21,16,5,16,20,9,3,0,95
5,21,16,8,1,21,19,9,4,104
5,21,16,8,5,13,25,0,0,93
5,21,16,8,5,13,9,1,14,92
5,21,16,8,5,13,9,19,5,101
5,21,16,8,5,13,9,19,13,109
5,21,16,8,5,13,9,19,20,116
5,21,16,8,5,13,9,26,5,108
5,21,16,8,5,13,15,21,19,123
5,21,16,8,5,14,9,3,0,81
5,21,16,8,5,14,9,3,19,100
5,21,16,8,15,14,0,0,0,79
5,21,16,8,15,14,5,0,0,84
5,21,16,8,15,14,25,0,0,104
5,21,16,8,15,14,9,1,0,89
5,21,16,8,15,14,9,1,4,93
5,21,16,8,15,14,9,3,0,91
5,21,16,8,15,14,9,5,19,112
5,21,16,8,15,14,25,13,0,117
5,21,16,8,15,14,9,19,5,112
5,21,16,8,15,14,9,19,13,120
5,21,16,8,15,14,9,21,13,122
5,21,16,8,15,14,9,26,5,119
5,21,16,8,15,14,15,14,0,108
5,21,16,8,15,14,15,21,19,134
5,21,16,8,15,18,25,0,0,108
5,21,16,8,15,18,9,1,0,93
5,21,16,8,15,18,9,1,19,112
5,21,16,8,15,18,9,3,0,95
5,21,16,8,15,20,9,3,0,97
5,21,16,8,15,20,9,4,5,103
5,21,16,8,18,1,19,25,0,113
5,21,16,8,18,15,5,0,0,88
5,21,16,8,18,15,5,19,0,107
5,21,16,8,21,9,19,13,0,112
5,21,16,8,21,9,19,13,19,131
5,21,16,8,21,9,19,20,0,119
5,21,16,8,21,9,19,20,19,138
5,21,16,8,21,9,26,5,0,111
5,21,16,8,21,9,26,5,4,115
5,21,16,9,15,14,0,0,0,80
5,21,16,9,15,14,5,0,0,85
5,21,16,25,18,5,14,5,0,109
5,21,16,25,18,9,15,14,0,123
5,21,16,9,20,20,15,14,5,125
5,21,16,12,1,19,20,9,3,106
5,21,16,12,15,9,4,0,0,82
5,21,16,12,15,9,4,25,0,107
5,21,16,12,15,9,4,19,0,101
5,21,16,12,15,20,9,4,0,102
5,21,16,14,5,1,0,0,0,62
5,21,16,14,5,1,19,0,0,81
5,21,16,14,5,9,3,0,0,73
5,21,16,14,15,5,1,0,0,77
5,21,16,14,15,5,1,19,0,96
5,21,16,14,15,5,9,3,0,88
5,21,16,15,20,1,13,9,3,103
5,21,16,18,1,3,20,9,3,96
5,21,16,18,1,24,9,1,0,95
5,21,18,1,19,9,1,14,19,107
5,21,18,8,25,20,8,13,25,143
5,21,18,8,15,4,9,14,5,99
5,21,18,8,15,4,15,12,0,98
5,21,18,25,1,12,5,1,14,102
5,21,18,25,2,1,20,8,0,100
5,21,18,25,15,11,25,0,0,120
5,21,18,25,15,14,0,0,0,98
5,21,18,25,16,8,1,7,5,106
5,21,18,9,16,9,0,0,0,78
5,21,18,9,16,15,19,0,0,103
5,21,18,9,16,21,16,9,0,115
5,21,18,9,16,21,19,0,0,109
5,21,18,25,19,3,15,16,5,127
5,21,18,9,20,5,0,0,0,78
5,21,18,25,20,5,0,0,0,94
5,21,18,25,20,8,5,18,13,133
5,21,18,25,20,8,13,25,0,135
5,21,18,25,20,8,13,9,3,122
5,21,18,25,20,15,13,9,4,130
5,21,18,25,20,15,16,9,3,132
5,21,18,15,0,0,0,0,0,59
5,21,18,15,2,9,14,0,0,84
5,21,18,15,11,25,0,0,0,95
5,21,18,15,11,9,5,19,0,103
5,21,18,15,11,15,21,19,0,125
5,21,18,15,16,5,1,14,19,114
5,21,18,15,16,8,9,21,13,126
5,21,18,15,16,9,21,13,0,118
5,21,18,15,16,9,21,13,19,137
5,21,18,15,19,0,0,0,0,78
5,21,18,15,21,19,0,0,0,99
5,21,19,15,12,0,0,0,0,72
5,21,19,20,1,3,25,0,0,94
5,21,19,20,1,3,9,5,19,102
5,21,19,20,1,20,9,3,0,98
5,21,19,20,5,12,5,0,0,87
5,21,19,20,5,12,5,19,0,106
5,21,19,20,25,12,5,0,0,107
5,21,19,21,3,8,9,1,14,101
5,21,20,1,14,14,9,14,0,98
5,21,20,1,24,25,0,0,0,96
5,21,20,1,24,9,3,0,0,83
5,21,20,1,24,9,5,0,0,85
5,21,20,1,24,9,5,19,0,104
5,21,20,1,24,9,20,5,0,105
5,21,20,1,24,9,20,9,3,112
5,21,20,5,3,8,14,9,3,88
5,21,20,5,3,20,9,3,0,86
5,21,20,5,3,20,9,3,19,105
5,21,20,5,3,20,15,9,4,102
5,21,20,5,24,9,1,0,0,85
5,21,20,8,1,14,1,19,25,114
5,21,20,8,5,14,9,3,0,85
5,21,20,8,5,14,9,3,19,104
5,21,20,8,5,14,9,19,20,121
5,21,20,8,5,18,9,1,14,101
5,21,20,8,5,18,13,9,3,102
5,21,20,8,25,13,25,0,0,117
5,21,20,8,25,18,15,9,4,125
5,21,20,15,3,9,1,0,0,74
5,21,20,15,13,15,21,19,0,129
5,21,20,15,14,25,0,0,0,100
5,21,20,18,15,16,8,25,0,128
5,21,20,18,15,16,8,9,3,115
5,21,20,18,15,16,9,3,0,107
5,21,20,18,15,16,15,21,19,150
5,21,22,18,15,21,0,0,0,102
5,21,24,1,14,20,8,9,3,105
5,21,24,1,14,20,8,9,14,116
5,21,24,5,14,9,20,5,0,103
5,21,24,5,14,9,20,5,19,122
5,22,5,3,8,21,18,18,0,100
5,22,5,3,11,0,0,0,0,46
5,22,5,3,20,1,14,20,0,90
5,22,5,3,20,5,4,0,0,64
5,22,5,3,20,9,3,0,0,67
5,22,5,3,20,9,15,14,0,93
5,22,5,3,20,9,15,14,19,112
5,22,5,3,20,15,18,0,0,88
5,22,5,10,1,18,0,0,0,61
5,22,5,12,9,7,8,20,0,88
5,22,5,12,15,14,7,0,0,80
5,22,5,14,2,12,21,19,8,108
5,22,5,14,4,15,23,14,0,102
5,22,5,14,5,0,0,0,0,51
5,22,5,14,5,4,0,0,0,55
5,22,5,14,5,18,0,0,0,69
5,22,5,14,5,18,19,0,0,88
5,22,5,14,5,19,20,0,0,90
5,22,5,14,6,1,12,12,0,77
5,22,5,14,6,1,12,12,19,96
5,22,5,14,6,15,18,20,8,113
5,22,5,14,7,12,15,13,5,98
5,22,5,14,7,12,15,23,0,103
5,22,5,14,8,1,14,4,0,73
5,22,5,14,8,5,1,4,0,64
5,22,5,14,9,14,7,0,0,76
5,22,5,14,9,14,7,19,0,95
5,22,5,14,12,25,0,0,0,83
5,22,5,14,12,9,7,8,20,102
5,22,5,14,12,15,14,7,0,94
5,22,5,14,13,5,20,5,0,89
5,22,5,14,14,5,19,19,0,103
5,22,5,14,15,15,0,0,0,76
5,22,5,14,19,0,0,0,0,65
5,22,5,14,19,15,14,7,0,101
5,22,5,14,19,15,14,7,19,120
5,22,5,14,20,0,0,0,0,66
5,22,5,14,20,1,9,12,0,88
5,22,5,14,20,6,21,12,0,105
5,22,5,14,20,9,4,5,0,84
5,22,5,14,20,9,4,5,19,103
5,22,5,14,20,9,13,5,0,93
5,22,5,14,20,12,5,19,19,121
5,22,5,14,20,19,0,0,0,85
5,22,5,14,20,21,1,12,0,100
5,22,5,14,20,21,1,20,5,113
5,22,5,14,23,9,19,5,0,102
5,22,5,17,21,5,0,0,0,75
5,22,5,18,0,0,0,0,0,50
5,22,5,18,7,12,1,4,5,79
5,22,5,18,25,0,0,0,0,75
5,22,5,18,25,2,15,4,25,121
5,22,5,18,9,3,8,0,0,70
5,22,5,18,25,4,1,25,0,105
5,22,5,18,25,4,5,1,12,97
5,22,5,18,25,8,15,23,0,121
5,22,5,18,25,12,9,11,5,112
5,22,5,18,25,13,5,14,0,107
5,22,5,18,25,14,5,19,19,132
5,22,5,18,25,15,14,5,0,109
5,22,5,18,25,23,1,25,0,124
5,22,5,18,25,23,8,5,14,125
5,22,5,18,13,15,0,0,0,78
5,22,5,18,13,15,18,5,0,101
5,22,5,18,14,5,19,19,0,107
5,22,5,18,14,9,15,9,4,101
5,22,5,18,19,5,0,0,0,74
5,22,5,18,19,9,2,12,5,97
5,22,5,18,19,9,15,14,0,107
5,22,5,18,19,9,15,14,19,126
5,22,5,18,19,9,22,5,0,105
5,22,5,18,20,5,4,0,0,79
5,22,5,18,20,9,12,5,0,96
5,22,5,18,20,9,14,7,0,100
5,22,5,18,20,15,18,0,0,103
5,22,5,18,20,15,18,19,0,122
5,22,5,18,20,19,0,0,0,89
5,22,5,18,23,8,9,3,8,101
5,22,5,18,23,8,15,0,0,96
5,22,5,19,0,0,0,0,0,51
5,22,5,19,5,0,0,0,0,56
5,22,5,19,20,1,18,0,0,90
5,22,5,20,9,4,5,0,0,70
5,22,5,23,5,5,4,0,0,69
5,22,7,0,0,0,0,0,0,34
5,22,9,2,18,1,20,5,0,82
5,22,9,3,11,5,0,0,0,55
5,22,9,3,20,0,0,0,0,59
5,22,9,3,20,5,4,0,0,68
5,22,9,3,20,5,5,0,0,69
5,22,9,3,20,5,5,19,0,88
5,22,9,3,20,9,14,7,0,89
5,22,9,3,20,9,15,14,0,97
5,22,9,3,20,9,15,14,19,116
5,22,9,3,20,15,18,0,0,92
5,22,9,3,20,15,18,19,0,111
5,22,9,3,20,19,0,0,0,78
5,22,9,4,5,14,3,5,0,67
5,22,9,4,5,14,3,5,4,71
5,22,9,4,5,14,3,5,19,86
5,22,9,4,5,14,20,0,0,79
5,22,9,4,5,14,20,12,25,116
5,22,9,12,0,0,0,0,0,48
5,22,9,12,4,15,5,18,0,90
5,22,9,12,4,15,5,18,19,109
5,22,9,12,4,15,9,14,7,97
5,22,9,12,5,18,0,0,0,71
5,22,9,12,5,19,20,0,0,92
5,22,9,12,12,5,18,0,0,83
5,22,9,12,12,5,19,20,0,104
5,22,9,12,12,25,0,0,0,85
5,22,9,12,14,5,19,19,0,105
5,22,9,12,16,18,15,15,6,118
5,22,9,12,19,0,0,0,0,67
5,22,9,12,19,1,25,5,18,116
5,22,9,14,3,5,0,0,0,58
5,22,9,14,3,5,4,0,0,62
5,22,9,14,3,5,19,0,0,77
5,22,9,14,3,9,2,12,5,81
5,22,9,14,3,9,2,12,25,101
5,22,9,14,3,9,14,7,0,83
5,22,9,14,3,9,22,5,0,89
5,22,9,18,1,20,5,0,0,80
5,22,9,18,1,20,9,15,14,113
5,22,9,18,1,20,15,0,0,90
5,22,9,18,20,21,1,20,5,121
5,22,9,19,9,20,5,0,0,89
5,22,9,20,1,2,12,5,0,76
5,22,9,20,1,20,5,0,0,82
5,22,9,20,1,20,9,15,14,115
5,22,9,20,5,0,0,0,0,61
5,22,9,20,5,4,0,0,0,65
5,22,9,20,5,18,14,1,12,106
5,22,9,20,5,19,0,0,0,80
5,22,9,20,9,14,7,0,0,86
5,22,9,20,20,1,20,5,0,102
5,22,15,3,1,2,12,5,0,65
5,22,15,3,1,20,5,0,0,71
5,22,15,3,1,20,5,4,0,75
5,22,15,3,1,20,9,14,7,96
5,22,15,3,1,20,9,15,14,104
5,22,15,3,1,20,9,22,5,102
5,22,15,3,1,20,15,18,0,99
5,22,15,3,1,20,15,18,25,124
5,22,15,3,1,20,15,18,19,118
5,22,15,3,1,20,18,9,24,117
5,22,15,5,0,0,0,0,0,47
5,22,15,11,5,0,0,0,0,58
5,22,15,11,5,4,0,0,0,62
5,22,15,11,5,18,0,0,0,76
5,22,15,11,5,18,19,0,0,95
5,22,15,11,5,19,0,0,0,77
5,22,15,11,9,14,7,0,0,83
5,22,15,12,1,20,5,0,0,80
5,22,15,12,21,20,5,0,0,100
5,22,15,12,21,20,5,19,0,119
5,22,15,12,21,20,9,15,14,133
5,22,15,12,21,20,9,22,5,131
5,22,15,12,21,20,15,9,4,123
5,22,15,12,22,1,2,12,5,96
5,22,15,12,22,5,0,0,0,81
5,22,15,12,22,5,4,0,0,85
5,22,15,12,22,5,14,20,0,115
5,22,15,12,22,5,18,0,0,99
5,22,15,12,22,5,18,19,0,118
5,22,15,12,22,5,19,0,0,100
5,22,15,12,22,9,14,7,0,106
5,22,15,12,22,21,12,21,19,149
5,22,15,13,9,20,0,0,0,84
5,22,15,22,1,5,0,0,0,70
5,22,21,12,7,1,20,5,0,93
5,22,21,12,7,5,0,0,0,72
5,22,21,12,19,5,0,0,0,84
5,22,21,12,19,9,15,14,0,117
5,22,21,12,19,9,15,14,19,136
5,22,22,9,22,1,0,0,0,81
5,22,26,15,14,5,0,0,0,87
5,22,26,15,14,5,19,0,0,106
5,23,4,5,18,0,0,0,0,55
5,23,5,12,5,1,19,5,0,75
5,23,5,18,5,18,0,0,0,74
5,23,5,18,25,0,0,0,0,76
5,23,5,18,9,5,19,0,0,84
5,23,5,18,19,0,0,0,0,70
5,23,5,19,0,0,0,0,0,52
5,23,5,19,20,0,0,0,0,72
5,23,8,15,23,0,0,0,0,74
5,23,15,21,14,4,0,0,0,82
5,23,18,25,0,0,0,0,0,71
5,23,20,5,0,0,0,0,0,53
5,24,3,1,12,1,20,5,0,71
5,24,3,1,13,2,0,0,0,48
5,24,3,1,13,2,5,18,0,71
5,24,3,1,13,2,9,15,14,86
5,24,3,1,18,14,1,20,5,91
5,24,3,1,21,4,1,20,5,84
5,24,3,1,22,1,20,5,0,81
5,24,3,1,22,1,20,5,4,85
5,24,3,1,22,1,20,5,19,100
5,24,3,1,22,1,20,15,18,109
5,24,3,1,22,5,0,0,0,60
5,24,3,5,3,1,20,5,0,66
5,24,3,5,4,5,14,20,0,80
5,24,3,5,5,4,0,0,0,46
5,24,3,5,5,4,5,4,0,55
5,24,3,5,5,4,5,18,0,69
5,24,3,5,5,4,5,18,19,88
5,24,3,5,5,4,9,14,7,76
5,24,3,5,5,4,19,0,0,65
5,24,3,5,12,0,0,0,0,49
5,24,3,5,12,5,14,20,5,93
5,24,3,5,12,12,5,4,0,70
5,24,3,5,12,12,5,14,20,100
5,24,3,5,12,12,9,14,7,91
5,24,3,5,12,19,0,0,0,68
5,24,3,5,12,19,5,0,0,73
5,24,3,5,12,19,9,14,0,91
5,24,3,5,14,20,18,1,12,102
5,24,3,5,14,20,18,9,3,101
5,24,3,5,16,1,2,12,5,73
5,24,3,5,16,20,0,0,0,73
5,24,3,5,16,20,1,14,20,108
5,24,3,5,16,20,5,4,0,82
5,24,3,5,16,20,5,18,0,96
5,24,3,5,16,20,9,14,7,103
5,24,3,5,16,20,9,15,0,97
5,24,3,5,16,20,9,15,14,111
5,24,3,5,16,20,9,22,5,109
5,24,3,5,16,20,15,18,0,106
5,24,3,5,16,20,19,0,0,92
5,24,3,5,18,3,9,19,5,91
5,24,3,5,18,14,0,0,0,69
5,24,3,5,18,16,0,0,0,71
5,24,3,5,18,16,20,0,0,91
5,24,3,5,18,16,20,1,0,92
5,24,3,5,18,16,20,5,4,100
5,24,3,5,18,16,20,5,18,114
5,24,3,5,18,16,20,15,18,124
5,24,3,5,18,16,20,19,0,110
5,24,3,5,19,19,0,0,0,75
5,24,3,5,19,19,5,4,0,84
5,24,3,5,19,19,5,19,0,99
5,24,3,5,19,19,9,22,5,111
5,24,3,5,19,19,13,1,14,103
5,24,3,5,19,19,13,5,14,107
5,24,3,8,0,0,0,0,0,40
5,24,3,8,1,14,7,5,0,67
5,24,3,8,1,14,7,5,4,71
5,24,3,8,1,14,7,5,5,72
5,24,3,8,1,14,7,5,18,85
5,24,3,8,1,14,7,5,19,86
5,24,3,8,5,1,20,0,0,66
5,24,3,9,4,5,0,0,0,50
5,24,3,9,4,5,4,0,0,54
5,24,3,9,4,5,19,0,0,69
5,24,3,9,4,9,14,7,0,75
5,24,3,9,13,5,18,0,0,77
5,24,3,9,13,5,18,19,0,96
5,24,3,9,16,9,5,14,20,105
5,24,3,9,16,12,5,0,0,74
5,24,3,9,16,12,5,19,0,93
5,24,3,9,16,21,12,1,0,91
5,24,3,9,16,21,12,1,18,109
5,24,3,9,16,21,12,5,0,95
5,24,3,9,16,21,12,21,13,124
5,24,3,9,18,3,12,5,0,79
5,24,3,9,19,1,2,12,5,80
5,24,3,9,19,5,0,0,0,65
5,24,3,9,19,5,4,0,0,69
5,24,3,9,19,5,13,1,14,93
5,24,3,9,19,5,13,5,14,97
5,24,3,9,19,5,19,0,0,84
5,24,3,9,19,9,14,7,0,90
5,24,3,9,19,9,15,14,0,98
5,24,3,9,19,9,15,14,19,117
5,24,3,9,19,15,18,0,0,93
5,24,3,25,19,20,0,0,0,96
5,24,3,25,19,20,5,4,0,105
5,24,3,9,20,1,2,12,5,81
5,24,3,9,20,1,2,12,25,101
5,24,3,9,20,1,14,3,25,104
5,24,3,9,20,1,14,20,0,96
5,24,3,9,20,1,14,20,19,115
5,24,3,9,20,1,20,5,0,87
5,24,3,9,20,1,20,15,18,115
5,24,3,9,20,5,0,0,0,66
5,24,3,9,20,5,4,0,0,70
5,24,3,9,20,5,4,12,25,107
5,24,3,9,20,5,18,0,0,84
5,24,3,9,20,5,18,19,0,103
5,24,3,9,20,5,19,0,0,85
5,24,3,9,20,9,14,7,0,91
5,24,3,9,20,9,22,5,0,97
5,24,3,9,20,15,14,0,0,90
5,24,3,9,20,15,14,9,3,102
5,24,3,9,20,15,14,19,0,109
5,24,3,9,20,15,18,0,0,94
5,24,3,9,20,15,18,25,0,119
5,24,3,9,20,15,18,19,0,113
5,24,3,9,20,18,15,14,0,108
5,24,3,12,0,0,0,0,0,44
5,24,3,12,1,9,13,0,0,67
5,24,3,12,1,9,13,5,4,76
5,24,3,12,1,9,13,5,18,90
5,24,3,12,1,9,13,19,0,86
5,24,3,12,1,13,0,0,0,58
5,24,3,12,1,22,5,0,0,72
5,24,3,12,1,22,5,19,0,91
5,24,3,12,15,19,21,18,5,122
5,24,3,12,21,4,5,0,0,74
5,24,3,12,21,4,5,4,0,78
5,24,3,12,21,4,5,18,0,92
5,24,3,12,21,4,5,18,19,111
5,24,3,12,21,4,5,19,0,93
5,24,3,12,21,4,9,14,7,99
5,24,3,12,21,19,9,15,14,122
5,24,3,12,21,19,9,22,5,120
5,24,3,12,21,19,15,18,25,142
5,24,3,15,3,20,0,0,0,70
5,24,3,15,3,20,9,15,14,108
5,24,3,15,13,13,21,14,5,113
5,24,3,15,18,9,1,20,5,100
5,24,3,18,5,13,5,14,20,107
5,24,3,18,5,19,3,5,0,82
5,24,3,18,5,20,1,0,0,76
5,24,3,18,5,20,1,12,0,88
5,24,3,18,5,20,5,0,0,80
5,24,3,18,5,20,5,4,0,84
5,24,3,18,5,20,5,18,0,98
5,24,3,18,5,20,5,18,19,117
5,24,3,18,5,20,5,19,0,99
5,24,3,18,5,20,9,14,7,105
5,24,3,18,5,20,9,15,14,113
5,24,3,18,5,20,9,22,5,111
5,24,3,18,5,20,15,18,25,133
5,24,3,21,2,1,14,20,0,90
5,24,3,21,4,0,0,0,0,57
5,24,3,21,4,1,20,5,0,83
5,24,3,21,4,9,20,0,0,86
5,24,3,21,12,16,1,20,5,107
5,24,3,21,18,0,0,0,0,71
5,24,3,21,18,18,5,14,20,128
5,24,3,21,18,19,5,0,0,95
5,24,3,21,18,19,5,4,0,99
5,24,3,21,18,19,9,14,7,120
5,24,3,21,18,19,9,15,14,128
5,24,3,21,18,19,9,22,5,126
5,24,3,21,18,19,15,18,25,148
5,24,3,21,18,19,21,19,0,130
5,24,3,21,18,22,1,20,5,119
5,24,3,21,18,22,5,4,0,102
5,24,3,21,19,1,2,12,5,92
5,24,3,21,19,1,2,12,25,112
5,24,3,21,19,1,12,0,0,85
5,24,3,21,19,1,20,15,18,126
5,24,3,21,19,5,0,0,0,77
5,24,3,21,19,5,4,0,0,81
5,24,3,21,19,5,6,21,12,116
5,24,3,21,19,5,18,0,0,95
5,24,3,21,19,5,18,19,0,114
5,24,3,21,19,5,19,0,0,96
5,24,3,21,19,9,14,7,0,102
5,24,3,21,19,9,22,5,0,108
5,24,3,21,19,19,0,0,0,91
5,24,3,21,19,19,5,4,0,100
5,24,3,21,19,19,9,14,7,121
5,24,3,21,19,19,9,15,0,115
5,24,3,21,19,19,9,15,14,129
5,24,4,5,12,9,3,20,15,97
5,24,4,9,5,0,0,0,0,47
5,24,5,1,20,0,0,0,0,55
5,24,5,3,0,0,0,0,0,37
5,24,5,3,18,1,2,12,5,75
5,24,5,3,18,1,2,12,25,95
5,24,5,3,18,1,20,5,0,81
5,24,5,3,18,1,20,5,4,85
5,24,5,3,18,1,20,5,19,100
5,24,5,3,18,1,20,15,18,109
5,24,5,3,19,0,0,0,0,56
5,24,5,3,20,0,0,0,0,57
5,24,5,3,21,20,1,14,20,113
5,24,5,3,21,20,5,0,0,83
5,24,5,3,21,20,5,4,0,87
5,24,5,3,21,20,5,18,0,101
5,24,5,3,21,20,5,18,19,120
5,24,5,3,21,20,5,19,0,102
5,24,5,3,21,20,9,14,7,108
5,24,5,3,21,20,9,15,14,116
5,24,5,3,21,20,9,22,5,114
5,24,5,3,21,20,15,18,0,111
5,24,5,3,21,20,15,18,25,136
5,24,5,3,21,20,15,18,19,130
5,24,5,3,21,20,18,25,0,121
5,24,5,3,21,20,18,9,24,129
5,24,5,4,5,0,0,0,0,43
5,24,5,4,5,14,20,0,0,77
5,24,5,4,18,1,0,0,0,57
5,24,5,4,18,1,5,0,0,62
5,24,5,4,18,1,12,0,0,69
5,24,5,7,5,19,5,19,0,89
5,24,5,7,5,19,9,19,0,93
5,24,5,7,5,19,9,19,20,113
5,24,5,7,5,20,5,0,0,71
5,24,5,7,5,20,5,19,0,90
5,24,5,7,5,20,9,3,0,78
5,24,5,7,5,20,9,3,19,97
5,24,5,7,5,20,9,19,20,114
5,24,5,13,16,12,1,0,0,76
5,24,5,13,16,12,1,18,0,94
5,24,5,13,16,12,1,18,25,119
5,24,5,13,16,12,1,18,19,113
5,24,5,13,16,12,9,0,0,84
5,24,5,13,16,12,9,6,25,115
5,24,5,13,16,12,21,13,0,109
5,24,5,13,16,20,0,0,0,83
5,24,5,13,16,20,5,4,0,92
5,24,5,13,16,20,9,12,5,109
5,24,5,13,16,20,9,14,7,113
5,24,5,13,16,20,9,15,14,121
5,24,5,13,16,20,9,22,5,119
5,24,5,13,16,20,19,0,0,102
5,24,5,17,21,1,20,21,18,132
5,24,5,17,21,25,0,0,0,97
5,24,5,17,21,9,1,12,0,94
5,24,5,17,21,9,5,19,0,105
5,24,5,18,3,5,0,0,0,60
5,24,5,18,3,5,14,20,0,94
5,24,5,18,3,9,19,5,0,88
5,24,5,18,3,9,19,5,4,92
5,24,5,18,3,9,19,5,18,106
5,24,5,18,3,9,19,5,19,107
5,24,5,18,3,9,20,5,0,89
5,24,5,18,3,9,20,15,18,117
5,24,5,18,5,19,9,19,0,104
5,24,5,18,7,15,14,9,3,100
5,24,5,18,7,21,1,12,0,93
5,24,5,18,7,21,5,0,0,85
5,24,5,18,7,21,5,19,0,104
5,24,5,18,20,0,0,0,0,72
5,24,5,18,20,5,4,0,0,81
5,24,5,18,20,9,14,7,0,102
5,24,5,18,20,9,15,14,0,110
5,24,5,18,20,9,15,14,19,129
5,24,5,18,20,9,22,5,0,108
5,24,5,18,20,19,0,0,0,91
5,24,5,19,0,0,0,0,0,53
5,24,5,19,9,15,14,0,0,91
5,24,5,19,20,21,1,20,5,120
5,24,5,21,14,20,0,0,0,89
5,24,6,9,7,21,18,5,0,95
5,24,6,12,5,3,20,0,0,75
5,24,6,15,4,9,1,20,5,89
5,24,6,15,12,9,1,20,5,97
5,24,8,1,12,1,2,12,5,70
5,24,8,1,12,1,14,20,0,85
5,24,8,1,12,1,14,20,19,104
5,24,8,1,12,1,20,5,0,76
5,24,8,1,12,5,0,0,0,55
5,24,8,1,12,5,4,0,0,59
5,24,8,1,12,5,14,20,0,89
5,24,8,1,12,5,14,20,19,108
5,24,8,1,12,5,19,0,0,74
5,24,8,1,12,9,14,7,0,80
5,24,8,1,14,3,5,0,0,60
5,24,8,1,21,19,20,0,0,98
5,24,8,1,21,19,20,5,4,107
5,24,8,1,21,19,20,5,18,121
5,24,8,1,21,19,20,19,0,117
5,24,8,2,14,0,0,0,0,53
5,24,8,5,4,18,1,0,0,65
5,24,8,5,4,18,1,5,0,70
5,24,8,9,2,9,20,0,0,77
5,24,8,9,2,9,20,5,4,86
5,24,8,9,2,9,20,5,18,100
5,24,8,9,2,9,20,15,18,110
5,24,8,9,2,9,20,19,0,96
5,24,8,15,18,20,0,0,0,90
5,24,8,15,18,20,5,4,0,99
5,24,8,15,18,20,5,18,0,113
5,24,8,15,18,20,5,18,19,132
5,24,8,15,18,20,9,14,7,120
5,24,8,15,18,20,19,0,0,109
5,24,8,21,13,1,20,5,0,97
5,24,8,21,13,1,20,5,4,101
5,24,8,21,13,1,20,15,18,125
5,24,8,21,13,5,0,0,0,76
5,24,8,21,13,5,4,0,0,80
5,24,8,21,13,5,18,0,0,94
5,24,8,21,13,5,18,19,0,113
5,24,8,21,13,5,19,0,0,95
5,24,8,21,13,9,14,7,0,101
5,24,8,21,19,2,1,14,4,98
5,24,9,2,9,12,1,20,5,87
5,24,9,5,19,0,0,0,0,62
5,24,9,7,5,1,14,20,0,85
5,24,9,7,5,1,14,20,5,90
5,24,9,7,5,14,3,5,0,72
5,24,9,7,5,14,3,5,19,91
5,24,9,7,5,14,3,25,0,92
5,24,9,7,5,14,20,0,0,84
5,24,9,7,5,14,20,5,18,107
5,24,9,7,5,14,20,12,25,121
5,24,9,7,9,2,12,5,0,73
5,24,9,7,21,9,20,25,0,120
5,24,9,7,21,15,21,19,0,121
5,24,9,12,1,2,12,5,0,70
5,24,9,12,1,18,3,8,0,80
5,24,9,12,5,4,0,0,0,59
5,24,9,12,5,4,15,13,0,87
5,24,9,12,5,13,5,14,20,107
5,24,9,12,5,18,0,0,0,73
5,24,9,12,5,19,0,0,0,74
5,24,9,12,9,1,14,0,0,74
5,24,9,12,9,3,0,0,0,62
5,24,9,12,9,14,7,0,0,80
5,24,9,12,9,20,25,0,0,104
5,24,9,12,9,20,9,15,14,117
5,24,9,13,9,4,21,19,0,104
5,24,9,13,9,15,21,19,0,115
5,24,9,14,1,14,9,20,5,101
5,24,9,14,5,0,0,0,0,57
5,24,9,14,5,19,0,0,0,76
5,24,9,14,7,0,0,0,0,59
5,24,9,14,9,20,5,0,0,86
5,24,9,14,20,9,14,5,0,100
5,24,9,15,14,0,0,0,0,67
5,24,9,19,20,0,0,0,0,77
5,24,9,19,20,1,14,20,0,112
5,24,9,19,20,5,4,0,0,86
5,24,9,19,20,5,14,3,5,104
5,24,9,19,20,5,14,20,0,116
5,24,9,19,20,5,14,20,19,135
5,24,9,19,20,5,18,0,0,100
5,24,9,19,20,9,2,12,5,105
5,24,9,19,20,9,14,7,0,107
5,24,9,19,20,12,5,19,19,132
5,24,9,19,20,19,0,0,0,96
5,24,9,20,0,0,0,0,0,58
5,24,9,20,1,14,3,5,0,81
5,24,9,20,5,0,0,0,0,63
5,24,9,20,5,4,0,0,0,67
5,24,9,20,9,1,12,0,0,80
5,24,9,20,9,14,7,0,0,88
5,24,9,20,9,15,14,0,0,96
5,24,9,20,9,15,21,19,0,122
5,24,9,20,12,5,19,19,0,113
5,24,9,20,19,0,0,0,0,77
5,24,9,20,21,18,5,0,0,102
5,24,9,20,21,19,0,0,0,98
5,24,12,1,0,0,0,0,0,42
5,24,12,5,24,0,0,0,0,70
5,24,15,3,1,18,4,9,1,80
5,24,15,3,1,18,16,0,0,82
5,24,15,3,1,18,16,19,0,101
5,24,15,3,25,3,12,9,3,99
5,24,15,3,12,9,14,1,12,95
5,24,15,3,12,9,14,5,0,87
5,24,15,3,15,5,12,1,18,98
5,24,15,3,15,5,12,5,0,84
5,24,15,3,15,5,12,9,3,91
5,24,15,3,15,5,12,15,13,107
5,24,15,3,15,5,12,21,13,113
5,24,15,3,15,14,5,0,0,81
5,24,15,3,18,9,14,5,0,93
5,24,15,3,18,9,14,5,19,112
5,24,15,3,21,12,1,20,5,106
5,24,15,4,5,0,0,0,0,53
5,24,15,4,5,18,13,0,0,84
5,24,15,4,5,18,13,1,12,97
5,24,15,4,5,18,13,9,19,112
5,24,15,4,5,18,13,19,0,103
5,24,15,4,25,0,0,0,0,73
5,24,15,4,9,3,0,0,0,60
5,24,15,4,9,19,20,0,0,96
5,24,15,4,9,21,13,0,0,91
5,24,15,4,15,9,0,0,0,72
5,24,15,4,15,14,20,9,1,107
5,24,15,4,15,14,20,9,3,109
5,24,15,4,15,19,0,0,0,82
5,24,15,4,18,15,13,25,0,119
5,24,15,4,18,15,13,9,3,106
5,24,15,4,21,19,5,19,0,112
5,24,15,5,14,26,25,13,5,132
5,24,15,5,18,7,9,3,0,86
5,24,15,7,1,13,25,0,0,90
5,24,15,7,1,13,9,3,0,77
5,24,15,7,1,13,9,5,19,98
5,24,15,7,1,13,15,21,19,120
5,24,15,7,5,14,0,0,0,70
5,24,15,7,5,14,25,0,0,95
5,24,15,7,5,14,9,3,0,82
5,24,15,7,5,14,9,19,13,111
5,24,15,7,5,14,15,21,19,125
5,24,15,7,5,14,19,0,0,89
5,24,15,7,18,1,16,8,0,94
5,24,15,12,5,13,13,1,0,88
5,24,15,12,5,20,5,0,0,86
5,24,15,12,21,20,9,15,14,135
5,24,15,12,22,5,0,0,0,83
5,24,15,13,9,15,14,0,0,95
5,24,15,13,9,19,0,0,0,85
5,24,15,14,5,18,0,0,0,81
5,24,15,14,5,18,1,20,5,107
5,24,15,14,5,21,18,1,12,115
5,24,15,14,9,3,0,0,0,70
5,24,15,14,25,13,0,0,0,96
5,24,15,14,19,0,0,0,0,77
5,24,15,14,19,8,9,16,0,110
5,24,15,14,21,13,9,1,0,102
5,24,15,16,1,20,8,9,3,101
5,24,15,16,8,1,7,25,0,101
5,24,15,16,8,1,19,9,1,98
5,24,15,16,8,1,19,9,3,100
5,24,15,16,8,15,18,9,1,111
5,24,15,16,8,15,18,9,3,113
5,24,15,16,12,1,19,13,0,105
5,24,15,16,15,4,0,0,0,79
5,24,15,16,15,4,9,20,5,113
5,24,15,16,20,0,0,0,0,80
5,24,15,18,0,0,0,0,0,62
5,24,15,18,1,2,12,5,0,82
5,24,15,18,1,20,5,0,0,88
5,24,15,18,2,9,20,1,12,106
5,24,15,18,3,9,19,5,0,98
5,24,15,18,3,9,19,5,4,102
5,24,15,18,3,9,19,5,18,116
5,24,15,18,3,9,19,5,19,117
5,24,15,18,3,9,19,13,0,106
5,24,15,18,3,9,19,13,19,125
5,24,15,18,3,9,19,20,0,113
5,24,15,18,3,9,19,20,1,114
5,24,15,18,3,9,19,20,19,132
5,24,15,18,3,9,26,5,0,105
5,24,15,18,3,9,26,5,4,109
5,24,15,18,3,9,26,5,18,123
5,24,15,18,3,9,26,5,19,124
5,24,15,18,4,9,1,0,0,76
5,24,15,18,4,9,1,12,0,88
5,24,15,18,4,9,21,13,0,109
5,24,15,18,4,9,21,13,19,128
5,24,15,18,4,9,26,5,0,106
5,24,15,18,7,1,14,9,3,96
5,24,15,18,8,1,19,15,14,119
5,24,15,18,13,9,1,0,0,85
5,24,15,18,14,1,20,5,0,102
5,24,15,18,20,9,15,14,0,120
5,24,15,19,5,16,19,9,19,131
5,24,15,19,13,9,3,0,0,88
5,24,15,19,13,15,19,5,0,115
5,24,15,19,13,15,19,5,19,134
5,24,15,19,13,15,19,9,19,138
5,24,15,19,13,15,20,9,3,123
5,24,15,19,16,5,18,13,0,115
5,24,15,19,16,8,5,18,5,115
5,24,15,19,16,15,18,1,12,125
5,24,15,19,16,15,18,5,0,117
5,24,15,19,16,15,18,5,19,136
5,24,15,19,19,1,20,5,0,108
5,24,15,19,19,5,15,21,19,142
5,24,15,19,20,15,13,5,0,116
5,24,15,19,20,15,19,5,4,126
5,24,15,19,20,15,19,5,19,141
5,24,15,19,20,15,19,9,19,145
5,24,15,19,20,15,20,9,3,130
5,24,15,19,20,18,1,0,0,102
5,24,15,19,20,18,1,5,0,107
5,24,15,20,5,18,25,0,0,112
5,24,15,20,5,18,9,3,0,99
5,24,15,20,5,18,9,3,1,100
5,24,15,20,5,18,9,3,19,118
5,24,15,20,8,5,3,1,0,81
5,24,15,20,8,5,3,1,12,93
5,24,15,20,9,3,0,0,0,76
5,24,15,20,9,3,1,0,0,77
5,24,15,20,9,3,9,19,13,117
5,24,15,20,9,3,9,19,20,124
5,24,15,20,9,3,9,20,25,130
5,24,15,20,9,3,19,0,0,95
5,24,15,20,9,19,13,0,0,105
5,24,15,20,9,19,13,19,0,124
5,24,15,20,15,24,9,3,0,115
5,24,15,20,15,24,9,14,0,126
5,24,15,20,15,24,9,14,19,145
5,24,15,20,18,15,16,9,1,123
5,24,15,20,18,15,16,9,3,125
5,24,16,0,0,0,0,0,0,45
5,24,16,1,12,16,1,20,5,100
5,24,16,1,14,4,0,0,0,64
5,24,16,1,14,4,5,4,0,73
5,24,16,1,14,4,5,18,0,87
5,24,16,1,14,4,5,18,19,106
5,24,16,1,14,4,9,14,7,94
5,24,16,1,14,4,15,18,0,97
5,24,16,1,14,4,19,0,0,83
5,24,16,1,14,19,5,0,0,84
5,24,16,1,14,19,5,19,0,103
5,24,16,1,14,19,9,12,5,105
5,24,16,1,14,19,9,15,14,117
5,24,16,1,14,19,9,22,5,115
5,24,16,1,14,19,21,13,0,113
5,24,16,1,14,19,21,18,5,123
5,24,16,1,20,9,1,20,5,101
5,24,16,4,20,0,0,0,0,69
5,24,16,5,3,20,0,0,0,73
5,24,16,5,3,20,1,14,20,108
5,24,16,5,3,20,5,4,0,82
5,24,16,5,3,20,5,18,0,96
5,24,16,5,3,20,5,18,19,115
5,24,16,5,3,20,9,14,7,103
5,24,16,5,3,20,9,15,14,111
5,24,16,5,3,20,9,22,5,109
5,24,16,5,3,20,19,0,0,92
5,24,16,5,4,5,0,0,0,59
5,24,16,5,4,5,4,0,0,63
5,24,16,5,4,9,1,20,5,89
5,24,16,5,4,9,5,14,20,102
5,24,16,5,4,9,14,7,0,84
5,24,16,5,4,9,15,21,19,118
5,24,16,5,4,9,20,5,0,88
5,24,16,5,4,9,20,5,4,92
5,24,16,5,4,9,20,5,18,106
5,24,16,5,4,9,20,5,19,107
5,24,16,5,4,9,20,15,18,116
5,24,16,5,12,0,0,0,0,62
5,24,16,5,12,12,1,14,20,109
5,24,16,5,12,12,5,4,0,83
5,24,16,5,12,12,5,5,0,84
5,24,16,5,12,12,5,5,19,103
5,24,16,5,12,12,5,14,20,113
5,24,16,5,12,12,5,18,0,97
5,24,16,5,12,12,5,18,19,116
5,24,16,5,12,12,9,14,7,104
5,24,16,5,12,19,0,0,0,81
5,24,16,5,14,4,0,0,0,68
5,24,16,5,14,4,5,4,0,77
5,24,16,5,14,4,5,18,0,91
5,24,16,5,14,4,5,18,19,110
5,24,16,5,14,4,9,14,7,98
5,24,16,5,14,4,19,0,0,87
5,24,16,5,14,19,5,0,0,88
5,24,16,5,14,19,5,4,0,92
5,24,16,5,14,19,5,19,0,107
5,24,16,5,14,19,9,14,7,113
5,24,16,5,14,19,9,22,5,119
5,24,16,5,18,9,5,14,20,116
5,24,16,5,18,20,0,0,0,88
5,24,16,5,18,20,5,4,0,97
5,24,16,5,18,20,9,14,7,118
5,24,16,5,18,20,9,19,5,121
5,24,16,5,18,20,9,19,13,129
5,24,16,5,18,20,9,26,5,128
5,24,16,5,18,20,12,25,0,125
5,24,16,5,18,20,19,0,0,107
5,24,16,5,20,9,2,12,5,98
5,24,16,25,0,0,0,0,0,70
5,24,16,9,1,2,12,5,0,74
5,24,16,9,1,20,5,0,0,80
5,24,16,9,1,20,5,4,0,84
5,24,16,9,1,20,5,19,0,99
5,24,16,9,1,20,9,14,7,105
5,24,16,9,1,20,9,15,14,113
5,24,16,9,1,20,9,19,20,123
5,24,16,9,1,20,9,22,5,111
5,24,16,9,1,20,15,18,0,108
5,24,16,9,1,20,15,18,25,133
5,24,16,9,1,20,15,18,19,127
5,24,16,9,12,1,20,5,0,92
5,24,16,9,12,1,20,15,18,120
5,24,16,9,18,1,2,12,5,92
5,24,16,9,18,1,14,20,0,107
5,24,16,9,18,1,20,5,0,98
5,24,16,9,18,1,20,15,18,126
5,24,16,9,18,5,0,0,0,77
5,24,16,9,18,5,4,0,0,81
5,24,16,9,18,5,5,0,0,82
5,24,16,9,18,5,18,0,0,95
5,24,16,9,18,5,18,19,0,114
5,24,16,9,18,5,19,0,0,96
5,24,16,9,18,25,0,0,0,97
5,24,16,9,18,9,5,19,0,105
5,24,16,9,18,9,14,7,0,102
5,24,16,9,19,3,1,20,5,102
5,24,16,12,1,9,14,0,0,81
5,24,16,12,1,9,14,5,4,90
5,24,16,12,1,9,14,5,18,104
5,24,16,12,1,9,14,19,0,100
5,24,16,12,1,9,20,0,0,87
5,24,16,12,1,14,1,20,5,98
5,24,16,12,1,14,20,0,0,92
5,24,16,12,1,14,20,5,4,101
5,24,16,12,1,14,20,19,0,111
5,24,16,12,1,20,0,0,0,78
5,24,16,12,5,5,19,0,0,86
5,24,16,12,5,13,5,14,20,114
5,24,16,12,5,20,5,0,0,87
5,24,16,12,5,20,9,22,5,118
5,24,16,12,5,20,15,18,25,140
5,24,16,12,9,3,1,14,19,103
5,24,16,12,9,3,1,20,5,95
5,24,16,12,9,3,9,20,0,98
5,24,16,12,9,3,9,20,19,117
5,24,16,12,9,4,1,0,0,71
5,24,16,12,15,4,5,0,0,81
5,24,16,12,15,4,5,4,0,85
5,24,16,12,15,4,5,14,20,115
5,24,16,12,15,4,5,18,0,99
5,24,16,12,15,4,5,18,19,118
5,24,16,12,15,4,5,19,0,100
5,24,16,12,15,4,9,14,7,106
5,24,16,12,15,9,20,0,0,101
5,24,16,12,15,9,20,5,4,110
5,24,16,12,15,9,20,5,5,111
5,24,16,12,15,9,20,5,18,124
5,24,16,12,15,9,20,19,0,120
5,24,16,12,15,18,1,20,5,116
5,24,16,12,15,18,5,0,0,95
5,24,16,12,15,18,5,4,0,99
5,24,16,12,15,18,5,18,19,132
5,24,16,12,15,18,5,19,0,114
5,24,16,12,15,18,9,14,7,120
5,24,16,12,15,19,9,15,14,129
5,24,16,12,15,19,9,22,5,127
5,24,16,15,12,9,1,20,5,107
5,24,16,15,12,9,19,8,0,108
5,24,16,15,14,5,0,0,0,79
5,24,16,15,14,5,14,3,5,101
5,24,16,15,14,5,14,3,25,121
5,24,16,15,14,5,14,20,0,113
5,24,16,15,14,5,14,20,19,132
5,24,16,15,14,9,2,12,5,102
5,24,16,15,18,20,0,0,0,98
5,24,16,15,18,20,5,4,0,107
5,24,16,15,18,20,5,18,0,121
5,24,16,15,18,20,5,18,19,140
5,24,16,15,18,20,9,14,7,128
5,24,16,15,18,20,19,0,0,117
5,24,16,15,19,0,0,0,0,79
5,24,16,15,19,1,2,12,5,99
5,24,16,15,19,1,12,0,0,92
5,24,16,15,19,1,12,19,0,111
5,24,16,15,19,5,0,0,0,84
5,24,16,15,19,5,4,0,0,88
5,24,16,15,19,5,18,0,0,102
5,24,16,15,19,5,18,19,0,121
5,24,16,15,19,5,19,0,0,103
5,24,16,15,19,9,14,7,0,109
5,24,16,15,19,9,20,0,0,108
5,24,16,15,19,9,20,5,4,117
5,24,16,15,19,9,20,15,18,141
5,24,16,15,19,9,20,19,0,127
5,24,16,15,19,20,21,18,5,143
5,24,16,15,19,21,18,5,0,123
5,24,16,15,19,21,18,5,19,142
5,24,16,15,21,14,4,0,0,99
5,24,16,15,21,14,4,5,4,108
5,24,16,15,21,14,4,5,18,122
5,24,16,15,21,14,4,19,0,118
5,24,16,18,5,13,5,0,0,86
5,24,16,18,5,19,19,0,0,106
5,24,16,18,5,19,19,5,4,115
5,24,16,18,5,19,19,5,18,129
5,24,16,18,5,19,19,5,19,130
5,24,16,18,5,19,19,9,15,130
5,24,16,18,5,19,19,12,25,143
5,24,16,18,5,19,19,15,0,121
5,24,16,18,5,19,19,15,18,139
5,24,16,18,15,2,1,20,5,106
5,24,16,20,0,0,0,0,0,65
5,24,16,20,12,0,0,0,0,77
5,24,16,21,7,14,0,0,0,87
5,24,16,21,9,20,9,15,14,133
5,24,16,21,12,19,5,0,0,102
5,24,16,21,12,19,5,4,0,106
5,24,16,21,12,19,5,18,0,120
5,24,16,21,12,19,5,19,0,121
5,24,16,21,12,19,9,14,7,127
5,24,16,21,12,19,9,15,14,135
5,24,16,21,12,19,9,22,5,133
5,24,16,21,12,19,15,18,25,155
5,24,16,21,14,7,5,0,0,92
5,24,16,21,14,7,5,4,0,96
5,24,16,21,14,7,5,18,0,110
5,24,16,21,14,7,5,18,19,129
5,24,16,21,14,7,5,19,0,111
5,24,16,21,14,7,9,14,7,117
5,24,16,21,18,7,1,20,5,117
5,24,16,21,18,7,5,0,0,96
5,24,16,23,25,0,0,0,0,93
5,24,17,21,9,18,5,0,0,99
5,24,17,21,9,19,9,20,5,129
5,24,18,0,0,0,0,0,0,47
5,24,18,1,4,9,15,0,0,76
5,24,18,1,4,9,21,19,0,101
5,24,18,21,16,5,1,12,0,102
5,24,18,24,0,0,0,0,0,71
5,24,19,3,9,14,4,0,0,78
5,24,19,3,9,14,4,5,4,87
5,24,19,3,9,14,4,19,0,97
5,24,19,3,9,19,19,15,18,131
5,24,19,3,18,9,2,5,0,85
5,24,19,3,18,9,16,20,0,114
5,24,19,3,21,12,16,0,0,100
5,24,19,5,3,0,0,0,0,56
5,24,19,5,3,1,14,20,0,91
5,24,19,5,3,1,14,20,19,110
5,24,19,5,3,20,0,0,0,76
5,24,19,5,3,20,5,4,0,85
5,24,19,5,3,20,9,12,5,102
5,24,19,5,3,20,9,14,7,106
5,24,19,5,3,20,9,15,14,114
5,24,19,5,3,20,15,18,0,109
5,24,19,5,3,20,19,0,0,95
5,24,19,5,18,20,0,0,0,91
5,24,19,5,18,20,5,4,0,100
5,24,19,5,18,20,9,12,5,117
5,24,19,5,18,20,9,14,7,121
5,24,19,5,18,20,9,15,14,129
5,24,19,5,18,20,19,0,0,110
5,24,19,8,5,1,20,8,0,90
5,24,19,8,9,16,0,0,0,81
5,24,19,9,3,3,1,14,20,98
5,24,19,9,3,3,1,20,5,89
5,24,19,15,12,22,5,0,0,102
5,24,19,15,12,22,5,4,0,106
5,24,19,15,12,22,9,14,7,127
5,24,19,15,13,1,20,9,3,109
5,24,19,16,21,20,15,18,25,163
5,24,19,20,9,12,12,0,0,101
5,24,19,20,18,15,16,8,25,150
5,24,19,20,18,21,3,20,0,130
5,24,19,21,3,3,15,21,19,130
5,24,19,21,3,20,9,15,14,130
5,24,19,21,4,1,20,5,0,99
5,24,19,21,18,7,5,0,0,99
5,24,19,21,18,7,5,14,20,133
5,24,20,0,0,0,0,0,0,49
5,24,20,1,0,0,0,0,0,50
5,24,20,1,3,9,5,0,0,67
5,24,20,1,14,3,5,0,0,72
5,24,20,1,14,3,25,0,0,92
5,24,20,1,14,20,0,0,0,84
5,24,20,1,20,9,3,0,0,82
5,24,20,2,15,15,11,0,0,92
5,24,20,5,13,16,15,18,5,121
5,24,20,5,13,16,15,18,25,141
5,24,20,5,14,4,0,0,0,72
5,24,20,5,14,4,5,4,0,81
5,24,20,5,14,4,5,18,0,95
5,24,20,5,14,4,5,18,19,114
5,24,20,5,14,4,9,14,7,102
5,24,20,5,14,4,19,0,0,91
5,24,20,5,14,19,5,0,0,92
5,24,20,5,14,19,9,12,5,113
5,24,20,5,14,19,9,15,14,125
5,24,20,5,14,19,9,20,25,141
5,24,20,5,14,19,9,22,5,123
5,24,20,5,14,19,15,18,0,120
5,24,20,5,14,19,15,18,25,145
5,24,20,5,14,19,15,18,19,139
5,24,20,5,14,19,21,13,0,121
5,24,20,5,14,19,21,18,5,131
5,24,20,5,14,20,0,0,0,88
5,24,20,5,14,20,19,0,0,107
5,24,20,5,14,21,1,20,5,115
5,24,20,5,18,0,0,0,0,72
5,24,20,5,18,9,15,18,0,114
5,24,20,5,18,9,15,18,19,133
5,24,20,5,18,13,9,14,5,113
5,24,20,5,18,14,0,0,0,86
5,24,20,5,18,14,1,0,0,87
5,24,20,5,18,14,1,12,0,99
5,24,20,5,18,14,1,12,19,118
5,24,20,5,18,14,1,20,0,107
5,24,20,5,18,14,1,20,5,112
5,24,20,5,18,14,5,0,0,91
5,24,20,5,18,14,5,19,0,110
5,24,20,5,18,14,9,20,25,140
5,24,20,5,18,14,9,26,5,126
5,24,20,5,18,14,19,0,0,105
5,24,20,5,18,14,21,13,0,120
5,24,20,5,18,15,21,19,0,127
5,24,20,5,18,19,9,22,5,127
5,24,20,7,0,0,0,0,0,56
5,24,20,9,12,12,0,0,0,82
5,24,20,9,13,1,0,0,0,72
5,24,20,9,13,5,0,0,0,76
5,24,20,9,14,3,20,0,0,95
5,24,20,9,14,3,20,5,4,104
5,24,20,9,14,3,20,15,18,128
5,24,20,9,14,3,20,19,0,114
5,24,20,9,14,5,0,0,0,77
5,24,20,25,16,1,12,0,0,103
5,24,20,9,18,16,0,0,0,92
5,24,20,9,18,16,1,20,5,118
5,24,20,9,19,16,5,24,0,122
5,24,20,9,19,16,9,3,25,130
5,24,20,15,12,0,0,0,0,76
5,24,20,15,12,5,4,0,0,85
5,24,20,15,12,9,14,7,0,106
5,24,20,15,12,12,0,0,0,88
5,24,20,15,12,12,5,4,0,97
5,24,20,15,12,12,5,18,0,111
5,24,20,15,12,12,5,18,19,130
5,24,20,15,12,12,9,14,7,118
5,24,20,15,12,12,19,0,0,107
5,24,20,15,12,13,5,14,20,128
5,24,20,15,12,19,0,0,0,95
5,24,20,15,18,19,9,15,14,139
5,24,20,15,18,19,9,22,5,137
5,24,20,15,18,20,0,0,0,102
5,24,20,15,18,20,5,4,0,111
5,24,20,15,18,20,5,18,0,125
5,24,20,15,18,20,5,18,19,144
5,24,20,15,18,20,9,14,7,132
5,24,20,15,18,20,9,15,14,140
5,24,20,15,18,20,9,22,5,138
5,24,20,15,18,20,19,0,0,121
5,24,20,18,1,0,0,0,0,68
5,24,20,18,1,2,15,12,4,101
5,24,20,18,1,3,20,0,0,91
5,24,20,18,1,3,20,5,4,100
5,24,20,18,1,3,20,15,18,124
5,24,20,18,1,3,20,19,0,110
5,24,20,18,1,4,9,3,20,104
5,24,20,18,1,4,9,20,5,106
5,24,20,18,1,4,15,19,0,106
5,24,20,18,1,6,9,14,5,102
5,24,20,18,1,9,20,0,0,97
5,24,20,18,1,12,9,20,5,114
5,24,20,18,1,12,9,20,25,134
5,24,20,18,1,14,5,1,14,102
5,24,20,18,1,15,18,1,12,114
5,24,20,18,1,17,21,9,26,141
5,24,20,18,1,18,5,4,0,95
5,24,20,18,1,19,0,0,0,87
5,24,20,18,1,21,7,8,20,124
5,24,20,18,1,22,5,18,20,133
5,24,20,18,5,1,20,0,0,93
5,24,20,18,5,13,1,0,0,86
5,24,20,18,5,13,1,12,0,98
5,24,20,18,5,13,5,0,0,90
5,24,20,18,5,13,5,12,25,127
5,24,20,18,5,13,5,18,0,108
5,24,20,18,5,13,5,19,0,109
5,24,20,18,5,13,5,19,20,129
5,24,20,18,5,13,9,19,0,113
5,24,20,18,5,13,9,19,13,126
5,24,20,18,5,13,9,19,20,133
5,24,20,18,5,13,9,20,25,139
5,24,20,18,5,13,21,13,0,119
5,24,20,18,5,13,21,13,1,120
5,24,20,18,9,3,1,20,5,105
5,24,20,18,9,14,19,9,3,121
5,24,20,18,15,13,9,20,0,124
5,24,20,18,15,18,19,1,12,132
5,24,20,18,15,18,19,5,0,124
5,24,20,18,15,22,5,18,20,147
5,24,20,18,21,3,20,0,0,111
5,24,20,18,21,4,5,0,0,97
5,24,20,18,21,4,5,4,0,101
5,24,20,18,21,4,5,18,0,115
5,24,20,18,21,4,5,18,19,134
5,24,20,18,21,4,5,19,0,116
5,24,20,18,21,4,9,14,7,122
5,24,20,18,21,19,9,12,5,133
5,24,20,18,21,19,9,15,14,145
5,24,20,18,21,19,9,22,5,143
5,24,20,18,21,19,15,18,25,165
5,24,20,21,2,1,20,5,0,98
5,24,20,21,14,4,0,0,0,88
5,24,20,21,18,2,0,0,0,90
5,24,20,21,19,9,15,14,0,127
5,24,21,2,5,18,1,14,20,110
5,24,21,2,5,18,1,20,5,101
5,24,21,3,3,15,21,19,0,111
5,24,21,4,1,20,5,0,0,80
5,24,21,4,1,20,5,19,0,99
5,24,21,4,1,20,9,15,14,113
5,24,21,4,1,20,9,22,5,111
5,24,21,4,1,20,15,18,25,133
5,24,21,4,5,0,0,0,0,59
5,24,21,4,5,4,0,0,0,63
5,24,21,4,5,14,3,5,0,81
5,24,21,4,5,19,0,0,0,78
5,24,21,4,9,14,7,0,0,84
5,24,21,12,0,0,0,0,0,62
5,24,21,12,1,20,5,0,0,88
5,24,21,12,4,9,14,7,0,96
5,24,21,12,20,0,0,0,0,82
5,24,21,12,20,1,14,3,5,105
5,24,21,12,20,1,14,3,25,125
5,24,21,12,20,1,14,20,0,117
5,24,21,12,20,5,4,0,0,91
5,24,21,12,20,9,14,7,0,112
5,24,21,12,20,19,0,0,0,101
5,24,21,12,21,12,1,20,5,121
5,24,21,13,2,18,1,12,0,96
5,24,21,14,4,1,14,3,5,91
5,24,21,14,4,1,14,3,25,111
5,24,21,14,4,1,20,5,0,94
5,24,21,18,2,0,0,0,0,70
5,24,21,18,2,1,14,0,0,85
5,24,21,18,2,9,1,0,0,80
5,24,21,18,2,9,1,19,0,99
5,24,21,18,2,19,0,0,0,89
5,24,21,18,7,5,0,0,0,80
5,24,21,19,20,0,0,0,0,89
5,24,21,22,9,1,0,0,0,82
5,24,21,22,9,1,2,12,5,101
5,24,21,22,9,1,5,0,0,87
5,24,21,22,9,1,12,0,0,94
5,24,21,22,9,1,20,5,0,107
5,24,21,22,9,1,20,5,4,111
5,24,21,22,9,1,20,5,19,126
5,24,21,22,9,21,13,0,0,115
5,26,2,1,0,0,0,0,0,34
5,26,15,4,0,0,0,0,0,50
6,3,8,1,18,0,0,0,0,36
6,3,25,0,0,0,0,0,0,34
6,3,15,13,16,0,0,0,0,53
6,3,15,14,22,0,0,0,0,60
6,3,15,14,22,5,18,20,0,103
6,3,16,0,0,0,0,0,0,25
6,4,14,1,13,5,0,0,0,43
6,4,14,1,13,5,19,0,0,62
6,4,20,25,16,5,0,0,0,76
6,4,21,2,0,0,0,0,0,33
6,4,21,2,19,0,0,0,0,52
6,5,2,18,5,19,0,0,0,55
6,5,2,18,9,3,1,14,20,78
6,5,2,18,9,3,9,4,5,61
6,5,2,18,9,3,9,20,25,97
6,5,2,18,9,3,21,12,1,77
6,5,2,18,9,6,9,3,0,58
6,5,2,18,9,6,21,7,5,79
6,5,2,18,9,12,5,0,0,57
6,5,2,18,9,12,9,20,25,106
6,5,2,18,9,19,0,0,0,59
6,5,3,1,12,0,0,0,0,27
6,5,3,1,12,9,20,8,0,64
6,5,3,1,12,15,9,4,0,55
6,5,3,3,8,5,0,0,0,30
6,5,3,5,18,9,19,0,0,65
6,5,3,5,19,0,0,0,0,38
6,5,3,9,1,12,0,0,0,36
6,5,3,9,1,12,19,0,0,55
6,5,3,9,6,15,18,11,0,73
6,5,3,9,20,0,0,0,0,43
6,5,3,11,0,0,0,0,0,25
6,5,3,11,5,20,0,0,0,50
6,5,3,11,6,21,12,0,0,64
6,5,3,11,6,21,12,12,25,101
6,5,3,11,12,5,19,19,0,80
6,5,3,11,12,25,0,0,0,62
6,5,3,11,19,0,0,0,0,44
6,5,3,21,12,1,0,0,0,48
6,5,3,21,12,1,5,0,0,53
6,5,3,21,12,5,14,3,5,74
6,5,3,21,12,5,14,3,25,94
6,5,3,21,12,5,14,20,0,86
6,5,3,21,14,4,0,0,0,53
6,5,3,21,14,4,1,20,5,79
6,5,3,21,14,4,9,6,25,93
6,5,3,21,14,4,9,20,25,107
6,5,3,21,14,4,9,26,5,93
6,5,4,1,25,5,5,0,0,51
6,5,4,1,18,9,5,0,0,48
6,5,4,4,1,14,0,0,0,34
6,5,4,4,1,14,19,0,0,53
6,5,4,5,12,9,14,9,0,64
6,5,4,5,12,12,9,14,9,76
6,5,4,5,18,1,3,25,0,67
6,5,4,5,18,1,12,12,25,88
6,5,4,5,18,1,12,19,0,70
6,5,4,5,18,1,18,25,0,82
6,5,4,5,18,1,18,9,5,71
6,5,4,5,18,1,20,5,0,64
6,5,4,5,18,1,20,5,4,68
6,5,4,5,18,1,20,5,19,83
6,5,4,5,18,1,20,15,18,92
6,5,4,9,20,25,0,0,0,69
6,5,4,14,0,0,0,0,0,29
6,5,4,15,18,1,19,0,0,68
6,5,4,19,0,0,0,0,0,34
6,5,5,1,2,12,5,0,0,36
6,5,5,2,0,0,0,0,0,18
6,5,5,2,12,5,0,0,0,35
6,5,5,2,12,5,18,0,0,53
6,5,5,2,12,5,19,19,0,73
6,5,5,2,12,5,19,20,0,74
6,5,5,2,12,25,0,0,0,55
6,5,5,2,12,9,14,7,0,60
6,5,5,2,12,9,19,8,0,66
6,5,5,4,0,0,0,0,0,20
6,5,5,4,1,2,12,5,0,40
6,5,5,4,2,1,3,11,0,37
6,5,5,4,2,1,3,11,19,56
6,5,5,4,2,1,7,0,0,30
6,5,5,4,2,1,7,19,0,49
6,5,5,4,2,9,14,0,0,45
6,5,5,4,2,15,1,18,4,60
6,5,5,4,2,15,24,0,0,61
6,5,5,4,2,15,24,5,19,85
6,5,5,4,5,4,0,0,0,29
6,5,5,4,5,18,0,0,0,43
6,5,5,4,5,18,19,0,0,62
6,5,5,4,8,5,1,4,0,38
6,5,5,4,8,15,12,5,0,60
6,5,5,4,25,0,0,0,0,45
6,5,5,4,9,14,7,0,0,50
6,5,5,4,9,14,7,19,0,69
6,5,5,4,12,15,20,0,0,67
6,5,5,4,12,15,20,19,0,86
6,5,5,4,13,1,14,0,0,48
6,5,5,4,19,0,0,0,0,39
6,5,5,4,19,13,1,14,0,67
6,5,5,4,19,20,15,3,11,88
6,5,5,4,19,20,21,6,6,92
6,5,5,4,23,1,25,0,0,69
6,5,5,4,23,1,20,5,18,87
6,5,5,9,14,7,0,0,0,46
6,5,5,12,0,0,0,0,0,28
6,5,5,12,1,2,12,5,0,48
6,5,5,12,5,18,0,0,0,51
6,5,5,12,5,18,19,0,0,70
6,5,5,12,5,19,19,0,0,71
6,5,5,12,25,0,0,0,0,53
6,5,5,12,9,5,19,0,0,61
6,5,5,12,9,14,7,0,0,58
6,5,5,12,9,14,7,12,25,95
6,5,5,12,9,14,7,19,0,77
6,5,5,12,19,0,0,0,0,47
6,5,5,18,5,0,0,0,0,39
6,5,5,18,9,5,0,0,0,48
6,5,5,18,9,14,7,0,0,64
6,5,5,19,0,0,0,0,0,35
6,5,5,19,20,0,0,0,0,55
6,5,5,20,0,0,0,0,0,36
6,5,5,20,1,7,5,0,0,49
6,5,5,20,6,9,18,19,20,108
6,5,5,20,12,5,19,19,0,91
6,5,5,26,5,0,0,0,0,47
6,5,5,26,5,4,0,0,0,51
6,5,5,26,5,19,0,0,0,66
6,5,5,26,9,14,7,0,0,72
6,5,6,6,0,0,0,0,0,23
6,5,6,14,9,3,21,20,5,89
6,5,7,1,18,25,0,0,0,62
6,5,7,19,0,0,0,0,0,37
6,5,8,0,0,0,0,0,0,19
6,5,8,19,0,0,0,0,0,38
6,5,9,0,0,0,0,0,0,20
6,5,25,5,18,0,0,0,0,59
6,5,25,5,19,20,0,0,0,80
6,5,9,6,0,0,0,0,0,26
6,5,9,7,8,5,18,0,0,58
6,5,9,7,14,0,0,0,0,41
6,5,9,7,14,5,4,0,0,50
6,5,9,7,14,5,4,12,25,87
6,5,9,7,14,5,18,0,0,64
6,5,9,7,14,5,18,19,0,83
6,5,9,7,14,9,14,7,0,71
6,5,9,7,14,19,0,0,0,60
6,5,25,12,25,0,0,0,0,73
6,5,25,14,5,19,19,0,0,93
6,5,25,14,5,19,19,5,19,117
6,5,9,14,20,0,0,0,0,54
6,5,9,14,20,5,4,0,0,63
6,5,9,14,20,5,18,0,0,77
6,5,9,14,20,9,14,7,0,84
6,5,9,14,20,19,0,0,0,73
6,5,9,18,9,5,0,0,0,52
6,5,9,19,0,0,0,0,0,39
6,5,9,19,5,1,14,14,1,74
6,5,9,19,20,0,0,0,0,59
6,5,9,19,20,25,0,0,0,84
6,5,9,19,20,9,5,18,0,91
6,5,9,19,20,9,5,19,20,112
6,5,9,19,20,19,0,0,0,78
6,5,12,1,6,5,12,0,0,47
6,5,12,1,8,5,5,14,0,56
6,5,12,1,8,9,14,0,0,55
6,5,12,1,14,4,5,18,19,84
6,5,12,4,19,8,5,18,0,77
6,5,12,4,19,16,1,18,0,81
6,5,12,4,19,16,1,18,19,100
6,5,12,4,19,16,1,20,8,91
6,5,12,5,0,0,0,0,0,28
6,5,12,9,3,9,4,5,0,53
6,5,12,9,3,9,6,25,0,75
6,5,12,9,3,9,6,9,3,62
6,5,12,9,4,0,0,0,0,36
6,5,12,9,4,19,0,0,0,55
6,5,12,9,6,15,18,13,0,84
6,5,12,9,14,5,0,0,0,51
6,5,12,9,14,5,12,25,0,88
6,5,12,9,14,5,19,0,0,70
6,5,12,9,14,9,20,25,0,100
6,5,12,12,0,0,0,0,0,35
6,5,12,12,1,0,0,0,0,36
6,5,12,12,1,2,12,5,0,55
6,5,12,12,1,7,5,0,0,48
6,5,12,12,1,7,8,1,0,52
6,5,12,12,1,8,0,0,0,44
6,5,12,12,1,8,5,5,14,68
6,5,12,12,1,8,9,14,0,67
6,5,12,12,1,8,19,0,0,63
6,5,12,12,1,19,0,0,0,55
6,5,12,12,1,20,5,0,0,61
6,5,12,12,1,20,5,4,0,65
6,5,12,12,1,20,5,5,0,66
6,5,12,12,1,20,5,19,0,80
6,5,12,12,1,20,9,14,7,86
6,5,12,12,1,20,9,15,0,80
6,5,12,12,1,20,9,15,14,94
6,5,12,12,1,20,9,15,19,99
6,5,12,12,1,20,15,18,0,89
6,5,12,12,1,20,15,18,25,114
6,5,12,12,1,20,18,9,24,107
6,5,12,12,5,4,0,0,0,44
6,5,12,12,5,14,0,0,0,54
6,5,12,12,5,18,19,0,0,77
6,5,12,12,5,19,20,0,0,79
6,5,12,12,6,1,18,5,0,65
6,5,12,12,25,0,0,0,0,60
6,5,12,12,9,3,0,0,0,47
6,5,12,12,9,5,19,0,0,68
6,5,12,12,9,14,9,3,0,70
6,5,12,12,14,5,19,19,0,92
6,5,12,12,15,5,0,0,0,55
6,5,12,12,15,5,19,0,0,74
6,5,12,12,15,14,0,0,0,64
6,5,12,12,15,23,5,4,0,82
6,5,12,12,15,23,5,19,19,116
6,5,12,12,15,23,9,14,7,103
6,5,12,12,15,23,12,25,0,110
6,5,12,12,15,23,13,1,14,101
6,5,12,12,15,23,13,5,14,105
6,5,12,12,15,23,18,5,4,100
6,5,12,12,19,0,0,0,0,54
6,5,12,12,19,9,4,5,0,72
6,5,12,12,19,13,1,14,0,82
6,5,12,15,9,4,0,0,0,51
6,5,12,15,14,0,0,0,0,52
6,5,12,15,14,5,19,0,0,76
6,5,12,15,14,5,19,19,0,95
6,5,12,15,14,25,0,0,0,77
6,5,12,15,14,9,5,19,0,85
6,5,12,15,14,9,15,21,19,116
6,5,12,15,14,15,21,19,0,107
6,5,12,15,14,18,25,0,0,95
6,5,12,15,14,18,9,5,19,103
6,5,12,15,14,19,0,0,0,71
6,5,12,15,14,23,5,5,4,89
6,5,12,15,14,23,15,15,4,109
6,5,12,15,14,23,15,18,20,128
6,5,12,19,0,0,0,0,0,42
6,5,12,19,9,3,0,0,0,54
6,5,12,19,9,20,5,0,0,76
6,5,12,19,9,20,5,19,0,95
6,5,12,19,9,20,9,3,0,83
6,5,12,19,16,1,18,0,0,77
6,5,12,19,16,1,18,19,0,96
6,5,12,19,16,1,20,8,0,87
6,5,12,19,20,15,14,5,0,96
6,5,12,19,20,15,14,5,19,115
6,5,12,20,5,4,0,0,0,52
6,5,12,20,5,18,0,0,0,66
6,5,12,20,25,6,1,18,5,98
6,5,12,20,9,14,7,0,0,73
6,5,12,20,9,14,7,19,0,92
6,5,12,20,12,9,11,5,0,80
6,5,12,20,13,1,11,5,18,91
6,5,12,20,13,1,14,0,0,71
6,5,12,20,14,5,19,19,0,100
6,5,12,20,19,0,0,0,0,62
6,5,12,20,23,15,18,11,0,110
6,5,12,20,23,15,18,20,0,119
6,5,12,21,3,3,1,0,0,51
6,5,12,21,3,3,1,19,0,70
6,5,12,23,15,18,20,0,0,99
6,5,12,23,15,18,20,19,0,118
6,5,13,1,12,5,0,0,0,42
6,5,13,1,12,5,12,25,0,79
6,5,13,1,12,5,19,0,0,61
6,5,13,1,12,9,19,20,0,85
6,5,13,1,12,9,20,25,0,91
6,5,13,1,12,9,26,5,0,77
6,5,13,3,5,5,0,0,0,37
6,5,13,5,18,5,9,12,0,73
6,5,13,5,18,5,12,12,0,76
6,5,13,5,19,0,0,0,0,48
6,5,13,9,3,0,0,0,0,36
6,5,13,9,3,9,4,5,0,54
6,5,13,9,14,1,3,25,0,76
6,5,13,9,14,1,12,0,0,60
6,5,13,9,14,1,20,5,0,73
6,5,13,9,14,5,9,20,25,106
6,5,13,9,14,9,5,0,0,61
6,5,13,9,14,9,14,0,0,70
6,5,13,9,14,9,14,5,19,94
6,5,13,9,14,9,19,5,0,80
6,5,13,9,14,9,19,5,4,84
6,5,13,9,14,9,19,5,19,99
6,5,13,9,14,9,19,13,0,88
6,5,13,9,14,9,19,13,19,107
6,5,13,9,14,9,19,20,0,95
6,5,13,9,14,9,19,20,19,114
6,5,13,9,14,9,20,25,0,101
6,5,13,9,14,9,26,5,0,87
6,5,13,9,14,9,26,5,4,91
6,5,13,9,14,9,26,5,19,106
6,5,13,13,5,0,0,0,0,42
6,5,13,13,5,19,0,0,0,61
6,5,13,15,18,1,0,0,0,58
6,5,13,15,18,1,12,0,0,70
6,5,13,16,20,25,0,0,0,85
6,5,13,19,0,0,0,0,0,43
6,5,13,21,18,0,0,0,0,63
6,5,13,21,18,19,0,0,0,82
6,5,14,1,7,12,5,0,0,50
6,5,14,1,7,12,5,4,0,54
6,5,14,1,7,12,5,18,0,68
6,5,14,1,7,12,5,19,0,69
6,5,14,1,7,12,9,14,7,75
6,5,14,2,1,14,11,0,0,53
6,5,14,2,5,18,18,25,0,93
6,5,14,3,5,0,0,0,0,33
6,5,14,3,5,4,0,0,0,37
6,5,14,3,5,6,21,12,0,72
6,5,14,3,5,12,5,19,19,88
6,5,14,3,5,12,5,20,0,70
6,5,14,3,5,12,9,11,5,70
6,5,14,3,5,16,12,1,25,87
6,5,14,3,5,16,15,19,20,103
6,5,14,3,5,18,0,0,0,51
6,5,14,3,5,18,5,19,19,94
6,5,14,3,5,18,15,23,0,89
6,5,14,3,5,18,19,0,0,70
6,5,14,3,5,19,0,0,0,52
6,5,14,3,8,5,14,5,0,60
6,5,14,3,8,25,12,0,0,73
6,5,14,3,8,15,12,0,0,63
6,5,14,3,8,15,14,5,0,70
6,5,14,3,9,2,12,5,0,56
6,5,14,3,9,2,12,5,19,75
6,5,14,3,9,14,7,0,0,58
6,5,14,3,9,14,7,19,0,77
6,5,14,4,0,0,0,0,0,29
6,5,14,4,1,2,12,5,0,49
6,5,14,4,5,4,0,0,0,38
6,5,14,4,5,18,0,0,0,52
6,5,14,4,5,18,5,4,0,61
6,5,14,4,5,18,9,14,7,82
6,5,14,4,5,18,19,0,0,71
6,5,14,4,25,0,0,0,0,54
6,5,14,4,9,14,7,0,0,59
6,5,14,4,19,0,0,0,0,48
6,5,14,5,18,1,20,5,0,74
6,5,14,5,19,20,5,18,0,92
6,5,14,5,19,20,18,1,0,88
6,5,14,5,19,20,18,1,5,93
6,5,14,5,19,20,18,1,12,100
6,5,14,5,20,18,5,0,0,73
6,5,14,7,9,20,5,0,0,66
6,5,14,9,20,5,0,0,0,59
6,5,14,11,19,0,0,0,0,55
6,5,14,12,1,14,4,0,0,56
6,5,14,12,1,14,4,5,18,79
6,5,14,13,1,14,0,0,0,53
6,5,14,13,5,14,0,0,0,57
6,5,14,14,5,3,0,0,0,47
6,5,14,14,5,3,19,0,0,66
6,5,14,14,5,12,0,0,0,56
6,5,14,14,5,12,19,0,0,75
6,5,14,14,9,3,9,0,0,60
6,5,14,14,9,7,0,0,0,55
6,5,14,14,9,19,8,0,0,75
6,5,14,19,9,22,5,0,0,80
6,5,14,19,20,5,18,0,0,87
6,5,14,20,0,0,0,0,0,45
6,5,14,20,1,14,25,12,0,97
6,5,14,20,5,18,0,0,0,68
6,5,14,20,8,9,15,14,0,91
6,5,14,21,7,18,5,5,11,92
6,5,14,21,18,15,14,0,0,93
6,5,14,21,18,15,14,19,0,112
6,5,15,4,0,0,0,0,0,30
6,5,15,4,1,12,0,0,0,43
6,5,15,4,1,12,9,20,25,97
6,5,15,4,1,18,25,0,0,74
6,5,15,4,1,18,9,5,19,82
6,5,15,4,1,20,15,18,25,109
6,5,15,4,19,0,0,0,0,49
6,5,15,4,21,13,0,0,0,64
6,5,15,6,6,0,0,0,0,38
6,5,15,6,6,5,4,0,0,47
6,5,15,6,6,5,5,0,0,48
6,5,15,6,6,5,5,19,0,67
6,5,15,6,6,5,18,0,0,61
6,5,15,6,6,5,18,19,0,80
6,5,15,6,6,9,14,7,0,68
6,5,15,6,6,13,5,14,20,90
6,5,15,6,6,15,18,0,0,71
6,5,15,6,6,15,18,19,0,90
6,5,15,6,6,19,0,0,0,57
6,5,15,23,5,18,0,0,0,72
6,5,18,0,0,0,0,0,0,29
6,5,18,1,3,9,15,21,19,97
6,5,18,1,3,9,20,25,0,87
6,5,18,1,12,0,0,0,0,42
6,5,18,1,12,9,14,0,0,65
6,5,18,1,12,12,25,0,0,79
6,5,18,1,19,8,0,0,0,57
6,5,18,2,1,13,0,0,0,45
6,5,18,2,1,13,19,0,0,64
6,5,18,2,5,18,9,20,5,88
6,5,18,4,23,9,20,0,0,85
6,5,18,5,0,0,0,0,0,34
6,5,18,5,19,0,0,0,0,53
6,5,18,5,20,15,18,25,0,112
6,5,18,5,20,18,1,0,0,73
6,5,18,5,20,18,21,13,0,106
6,5,18,6,5,12,0,0,0,52
6,5,18,6,5,20,0,0,0,60
6,5,18,6,15,18,20,8,0,96
6,5,18,7,1,14,9,20,5,85
6,5,18,7,21,19,9,20,5,110
6,5,18,9,1,0,0,0,0,39
6,5,18,9,1,5,0,0,0,44
6,5,18,9,1,12,0,0,0,51
6,5,18,9,1,19,0,0,0,58
6,5,18,9,1,20,9,15,14,97
6,5,18,9,4,7,9,0,0,58
6,5,18,9,4,10,5,5,0,62
6,5,18,9,4,10,9,0,0,61
6,5,18,9,5,0,0,0,0,43
6,5,18,9,7,5,5,0,0,55
6,5,18,9,10,5,5,0,0,58
6,5,18,9,14,5,0,0,0,57
6,5,18,9,14,5,12,25,0,94
6,5,18,9,20,25,0,0,0,83
6,5,18,9,20,9,5,19,0,91
6,5,18,11,0,0,0,0,0,40
6,5,18,11,9,14,0,0,0,63
6,5,18,12,25,0,0,0,0,66
6,5,18,12,9,5,0,0,0,55
6,5,18,12,9,5,4,0,0,59
6,5,18,12,9,5,19,0,0,74
6,5,18,12,25,9,14,7,0,96
6,5,18,12,9,14,7,0,0,71
6,5,18,13,1,3,25,0,0,71
6,5,18,13,1,7,5,0,0,55
6,5,18,13,1,9,12,0,0,64
6,5,18,13,1,12,0,0,0,55
6,5,18,13,1,20,1,0,0,64
6,5,18,13,1,20,1,19,0,83
6,5,18,13,1,20,5,0,0,68
6,5,18,13,5,0,0,0,0,47
6,5,18,13,5,14,20,0,0,81
6,5,18,13,5,14,20,1,12,94
6,5,18,13,5,14,20,5,4,90
6,5,18,13,5,14,20,5,18,104
6,5,18,13,5,14,20,15,18,114
6,5,18,13,5,14,20,19,0,100
6,5,18,13,5,14,20,21,13,115
6,5,18,13,5,18,5,18,0,88
6,5,18,13,5,18,25,0,0,90
6,5,18,13,9,12,1,0,0,64
6,5,18,13,9,12,12,5,20,100
6,5,18,13,9,15,14,0,0,80
6,5,18,13,9,15,14,19,0,99
6,5,18,13,9,19,0,0,0,70
6,5,18,13,9,21,13,0,0,85
6,5,18,13,9,21,13,19,0,104
6,5,18,13,15,18,9,20,5,109
6,5,18,14,2,9,18,4,0,76
6,5,18,14,2,18,1,11,5,80
6,5,18,14,5,4,0,0,0,52
6,5,18,14,5,18,25,0,0,91
6,5,18,14,5,18,9,5,19,99
6,5,18,14,7,1,12,5,0,68
6,5,18,14,25,0,0,0,0,68
6,5,18,14,25,5,1,18,0,92
6,5,18,14,9,5,18,0,0,75
6,5,18,14,9,5,19,20,0,96
6,5,18,14,9,14,19,20,0,105
6,5,18,14,12,1,14,4,0,74
6,5,18,14,12,5,1,6,0,67
6,5,18,14,12,5,19,19,0,98
6,5,18,14,12,9,11,5,0,80
6,5,18,14,19,0,0,0,0,62
6,5,18,14,19,5,5,4,0,76
6,5,18,14,19,8,1,23,0,94
6,5,18,14,19,9,3,11,0,85
6,5,18,14,20,9,3,12,5,92
6,5,18,14,23,15,18,20,0,119
6,5,18,15,3,5,0,0,0,52
6,5,18,15,3,9,15,21,19,111
6,5,18,15,3,9,20,25,0,101
6,5,18,15,8,5,18,0,0,75
6,5,18,15,21,19,0,0,0,84
6,5,18,15,24,0,0,0,0,68
6,5,18,18,0,0,0,0,0,47
6,5,18,18,1,4,15,0,0,67
6,5,18,18,1,13,5,14,20,100
6,5,18,18,1,14,4,9,14,89
6,5,18,18,1,18,25,0,0,91
6,5,18,18,1,19,8,0,0,75
6,5,18,18,1,20,5,0,0,73
6,5,18,18,1,20,5,4,0,77
6,5,18,18,1,20,5,5,14,92
6,5,18,18,1,20,5,19,0,92
6,5,18,18,1,20,9,14,0,91
6,5,18,18,5,1,14,0,0,67
6,5,18,18,5,9,18,15,0,94
6,5,18,18,5,12,5,4,0,73
6,5,18,18,5,12,9,14,7,94
6,5,18,18,5,12,12,5,4,85
6,5,18,18,5,12,19,0,0,83
6,5,18,18,5,15,21,19,0,107
6,5,18,18,5,20,0,0,0,72
6,5,18,18,5,20,5,4,0,81
6,5,18,18,5,20,5,18,0,95
6,5,18,18,5,20,5,18,19,114
6,5,18,18,5,20,25,0,0,97
6,5,18,18,5,20,9,14,7,102
6,5,18,18,5,20,19,0,0,91
6,5,18,18,5,20,20,15,0,107
6,5,18,18,25,0,0,0,0,72
6,5,18,18,9,1,7,5,0,69
6,5,18,18,25,1,7,5,0,85
6,5,18,18,9,1,7,5,19,88
6,5,18,18,25,2,15,1,20,110
6,5,18,18,9,3,0,0,0,59
6,5,18,18,9,5,4,0,0,65
6,5,18,18,9,5,18,0,0,79
6,5,18,18,9,5,19,0,0,80
6,5,18,18,25,9,14,7,0,102
6,5,18,18,25,13,1,14,0,100
6,5,18,18,25,13,5,14,0,104
6,5,18,18,9,14,7,0,0,77
6,5,18,18,9,20,5,0,0,81
6,5,18,18,9,20,5,19,0,100
6,5,18,18,9,20,9,3,0,88
6,5,18,18,9,20,9,14,0,99
6,5,18,18,9,20,9,14,19,118
6,5,18,18,25,23,1,25,0,121
6,5,18,18,15,3,5,14,5,89
6,5,18,18,15,20,25,16,5,128
6,5,18,18,15,21,19,0,0,102
6,5,18,18,21,7,15,0,0,90
6,5,18,18,21,12,5,0,0,85
6,5,18,18,21,12,5,4,0,89
6,5,18,18,21,12,5,18,0,103
6,5,18,18,21,12,5,19,0,104
6,5,18,18,21,12,9,14,7,110
6,5,18,18,21,13,19,0,0,100
6,5,18,19,13,9,20,5,0,95
6,5,18,20,5,18,0,0,0,72
6,5,18,20,8,0,0,0,0,57
6,5,18,20,8,5,18,0,0,80
6,5,18,20,9,12,5,0,0,75
6,5,18,20,9,12,5,12,25,112
6,5,18,20,9,12,9,19,5,103
6,5,18,20,9,12,9,26,5,110
6,5,18,21,0,0,0,0,0,50
6,5,18,21,12,1,0,0,0,63
6,5,18,21,12,1,5,0,0,68
6,5,18,21,12,1,9,3,0,75
6,5,18,21,12,1,18,0,0,81
6,5,18,21,12,1,19,0,0,82
6,5,18,21,12,5,0,0,0,67
6,5,18,21,12,5,4,0,0,71
6,5,18,21,12,5,19,0,0,86
6,5,18,21,12,9,3,0,0,74
6,5,18,21,12,9,14,7,0,92
6,5,18,22,0,0,0,0,0,51
6,5,18,22,1,14,9,20,5,100
6,5,18,22,5,14,3,5,0,78
6,5,18,22,5,14,3,25,0,98
6,5,18,22,5,14,20,0,0,90
6,5,18,22,5,14,20,12,25,127
6,5,18,22,9,4,0,0,0,64
6,5,18,22,9,4,9,20,25,118
6,5,18,22,9,4,12,25,0,101
6,5,18,22,15,18,0,0,0,84
6,5,18,22,15,18,15,21,19,139
6,5,18,22,15,18,19,0,0,103
6,5,18,22,15,21,18,0,0,105
6,5,18,22,15,21,18,19,0,124
6,5,19,3,21,5,0,0,0,59
6,5,19,3,21,5,19,0,0,78
6,5,19,5,12,19,0,0,0,66
6,5,19,19,0,0,0,0,0,49
6,5,19,19,5,0,0,0,0,54
6,5,19,19,5,4,0,0,0,58
6,5,19,19,5,12,25,0,0,91
6,5,19,19,5,19,0,0,0,73
6,5,19,19,5,23,9,19,5,110
6,5,19,19,9,14,7,0,0,79
6,5,19,19,23,1,25,19,0,117
6,5,19,19,23,9,19,5,0,105
6,5,19,20,0,0,0,0,0,50
6,5,19,20,1,5,0,0,0,56
6,5,19,20,1,12,0,0,0,63
6,5,19,20,1,12,12,25,0,100
6,5,19,20,5,12,12,1,5,85
6,5,19,20,5,18,0,0,0,73
6,5,19,20,5,18,5,4,0,82
6,5,19,20,5,18,9,14,7,103
6,5,19,20,5,18,19,0,0,92
6,5,19,20,25,0,0,0,0,75
6,5,19,20,9,12,15,7,25,118
6,5,19,20,9,14,0,0,0,73
6,5,19,20,9,14,1,20,5,99
6,5,19,20,9,14,5,0,0,78
6,5,19,20,9,14,7,0,0,80
6,5,19,20,9,22,1,12,0,94
6,5,19,20,9,22,1,12,19,113
6,5,19,20,9,22,5,0,0,86
6,5,19,20,9,22,5,12,25,123
6,5,19,20,9,22,9,20,25,135
6,5,19,20,9,22,15,21,19,136
6,5,19,20,15,12,15,7,25,124
6,5,19,20,15,14,0,0,0,79
6,5,19,20,15,15,14,0,0,94
6,5,19,20,15,15,14,5,4,103
6,5,19,20,15,15,14,25,0,119
6,5,19,20,15,15,14,19,0,113
6,5,19,20,21,3,1,0,0,75
6,5,19,20,21,3,9,14,5,102
6,5,19,20,21,3,15,21,19,129
6,5,20,1,0,0,0,0,0,32
6,5,20,1,12,0,0,0,0,44
6,5,20,1,12,9,19,13,0,85
6,5,20,1,19,0,0,0,0,51
6,5,20,1,20,9,15,14,0,90
6,5,20,1,20,9,15,14,19,109
6,5,20,3,8,0,0,0,0,42
6,5,20,3,8,5,4,0,0,51
6,5,20,3,8,5,18,0,0,65
6,5,20,3,8,5,18,19,0,84
6,5,20,3,8,5,19,0,0,66
6,5,20,3,8,9,14,7,0,72
6,5,20,5,0,0,0,0,0,36
6,5,20,5,4,0,0,0,0,40
6,5,20,5,12,5,19,19,0,91
6,5,20,5,18,9,20,1,0,84
6,5,20,5,18,9,20,1,19,103
6,5,20,5,19,0,0,0,0,55
6,5,20,9,1,12,0,0,0,53
6,5,20,9,1,12,5,19,0,77
6,5,20,9,1,12,9,19,0,81
6,5,20,9,1,12,19,0,0,72
6,5,20,9,3,8,0,0,0,51
6,5,20,9,3,8,5,19,0,75
6,5,20,9,3,8,9,3,0,63
6,5,20,9,3,8,9,19,13,92
6,5,20,9,3,8,9,19,20,99
6,5,20,9,3,8,9,26,5,91
6,5,20,9,3,8,18,25,0,94
6,5,20,9,3,9,4,1,12,69
6,5,20,9,3,9,4,5,0,61
6,5,20,9,3,9,4,5,19,80
6,5,20,9,4,0,0,0,0,44
6,5,20,9,4,9,20,25,0,98
6,5,20,9,4,12,25,0,0,81
6,5,20,9,4,14,5,19,19,101
6,5,20,9,14,7,0,0,0,61
6,5,20,9,19,0,0,0,0,59
6,5,20,9,19,5,0,0,0,64
6,5,20,9,19,8,0,0,0,67
6,5,20,9,19,8,5,5,18,95
6,5,20,9,19,8,5,18,0,90
6,5,20,9,19,8,5,19,0,91
6,5,20,9,19,8,9,3,0,79
6,5,20,9,19,8,9,19,13,108
6,5,20,9,19,8,9,19,20,115
6,5,20,9,19,8,9,26,5,107
6,5,20,9,19,8,18,25,0,110
6,5,20,12,15,3,11,0,0,72
6,5,20,12,15,3,11,5,4,81
6,5,20,12,15,3,11,19,0,91
6,5,20,12,15,23,0,0,0,81
6,5,20,15,12,15,7,25,0,105
6,5,20,15,13,5,20,18,25,127
6,5,20,15,18,0,0,0,0,64
6,5,20,15,18,19,0,0,0,83
6,5,20,19,0,0,0,0,0,50
6,5,20,20,5,4,0,0,0,60
6,5,20,20,5,18,0,0,0,74
6,5,20,20,5,18,5,4,0,83
6,5,20,20,5,18,5,18,0,97
6,5,20,20,5,18,5,18,19,116
6,5,20,20,5,18,9,14,7,104
6,5,20,20,5,18,19,0,0,93
6,5,20,20,9,3,21,19,0,103
6,5,20,20,9,14,7,0,0,81
6,5,20,20,12,5,0,0,0,68
6,5,20,20,12,5,4,0,0,72
6,5,20,20,12,5,18,0,0,86
6,5,20,20,12,5,19,0,0,87
6,5,20,20,12,9,14,7,0,93
6,5,20,20,12,9,14,7,19,112
6,5,20,20,19,20,5,9,14,118
6,5,20,20,21,3,9,14,5,103
6,5,20,20,21,3,9,14,9,107
6,5,20,21,18,5,0,0,0,75
6,5,20,21,19,0,0,0,0,71
6,5,20,21,19,5,19,0,0,95
6,5,20,23,1,0,0,0,0,55
6,5,21,0,0,0,0,0,0,32
6,5,21,1,7,5,0,0,0,45
6,5,21,1,18,0,0,0,0,51
6,5,21,1,18,19,0,0,0,70
6,5,21,4,0,0,0,0,0,36
6,5,21,4,1,12,0,0,0,49
6,5,21,4,1,12,9,19,5,82
6,5,21,4,1,12,9,19,13,90
6,5,21,4,1,12,9,19,20,97
6,5,21,4,1,12,9,20,25,103
6,5,21,4,1,12,9,26,5,89
6,5,21,4,1,12,12,25,0,86
6,5,21,4,1,18,25,0,0,80
6,5,21,4,1,18,9,5,19,88
6,5,21,4,1,20,1,18,25,101
6,5,21,4,1,20,15,18,25,115
6,5,21,4,5,4,0,0,0,45
6,5,21,4,5,5,0,0,0,46
6,5,21,4,5,18,0,0,0,59
6,5,21,4,9,14,7,0,0,66
6,5,21,4,9,19,20,0,0,84
6,5,21,4,9,19,20,19,0,103
6,5,21,4,19,0,0,0,0,55
6,5,21,4,21,13,0,0,0,70
6,5,21,5,4,0,0,0,0,41
6,5,21,9,12,12,1,7,5,78
6,5,21,9,12,12,5,0,0,70
6,5,21,9,12,12,5,20,0,90
6,5,21,9,14,7,0,0,0,62
6,5,21,12,1,13,15,18,20,111
6,5,21,19,0,0,0,0,0,51
6,5,21,20,5,0,0,0,0,57
6,5,21,20,5,18,0,0,0,75
6,5,21,20,5,18,5,18,0,98
6,5,22,5,18,0,0,0,0,56
6,5,22,5,18,2,21,19,8,106
6,5,22,5,18,3,21,16,0,96
6,5,22,5,18,5,4,0,0,65
6,5,22,5,18,5,20,0,0,81
6,5,22,5,18,6,5,23,0,90
6,5,22,5,18,6,5,23,19,109
6,5,22,5,18,7,21,13,0,97
6,5,22,5,18,25,0,0,0,81
6,5,22,5,18,9,14,7,0,86
6,5,22,5,18,9,19,8,0,92
6,5,22,5,18,12,5,19,19,111
6,5,22,5,18,12,9,11,5,93
6,5,22,5,18,15,21,19,0,111
6,5,22,5,18,18,15,15,20,124
6,5,22,5,18,19,0,0,0,75
6,5,22,5,18,20,18,1,16,111
6,5,22,5,18,20,23,9,7,115
6,5,22,5,18,23,5,5,4,93
6,5,22,5,18,23,15,18,20,132
6,5,23,0,0,0,0,0,0,34
6,5,23,5,18,0,0,0,0,57
6,5,23,5,19,20,0,0,0,78
6,5,23,13,1,14,4,0,0,66
6,5,23,13,5,20,19,0,0,91
6,5,23,14,5,19,0,0,0,72
6,5,23,14,5,19,5,19,0,96
6,5,23,14,5,19,19,0,0,91
6,5,23,14,5,19,19,5,19,115
6,5,23,19,15,13,5,0,0,86
6,5,23,20,5,18,0,0,0,77
6,5,23,20,5,18,5,18,0,100
6,5,23,20,18,9,12,19,0,112
6,5,26,5,19,0,0,0,0,61
6,5,26,26,5,4,0,0,0,72
6,5,26,26,5,19,0,0,0,87
6,5,26,26,25,0,0,0,0,88
6,7,14,0,0,0,0,0,0,27
6,7,18,9,4,0,0,0,0,44
6,8,18,5,18,0,0,0,0,55
6,9,2,2,5,4,0,0,0,28
6,9,2,2,5,18,0,0,0,42
6,9,2,2,5,18,25,0,0,67
6,9,2,2,5,18,19,0,0,61
6,9,2,2,9,14,7,0,0,49
6,9,2,4,15,13,0,0,0,49
6,9,2,5,18,5,4,0,0,49
6,9,2,5,18,6,9,12,12,79
6,9,2,5,18,9,26,5,0,80
6,9,2,5,18,9,26,5,4,84
6,9,2,5,18,9,26,5,18,98
6,9,2,5,18,9,26,5,19,99
6,9,2,5,18,12,5,19,19,95
6,9,2,5,18,15,21,19,0,95
6,9,2,5,18,19,0,0,0,59
6,9,2,5,18,23,1,18,5,87
6,9,2,18,1,0,0,0,0,36
6,9,2,18,1,14,14,5,0,69
6,9,2,18,1,20,9,15,14,94
6,9,2,18,1,20,21,19,0,96
6,9,2,18,5,0,0,0,0,40
6,9,2,18,5,4,0,0,0,44
6,9,2,18,5,6,9,12,12,79
6,9,2,18,5,12,5,19,19,95
6,9,2,18,5,19,0,0,0,59
6,9,2,18,5,23,1,18,5,87
6,9,2,18,25,0,0,0,0,60
6,9,2,18,9,6,15,18,13,96
6,9,2,18,9,12,0,0,0,56
6,9,2,18,9,12,12,1,0,69
6,9,2,18,9,12,12,1,5,74
6,9,2,18,9,12,12,1,18,87
6,9,2,18,9,12,12,5,4,77
6,9,2,18,9,12,19,0,0,75
6,9,2,18,9,14,0,0,0,58
6,9,2,18,9,14,1,20,5,84
6,9,2,18,9,14,5,0,0,63
6,9,2,18,9,14,15,9,4,86
6,9,2,18,9,14,15,19,5,97
6,9,2,18,9,14,15,21,19,113
6,9,2,18,9,14,19,0,0,77
6,9,2,18,15,0,0,0,0,50
6,9,2,18,15,3,25,19,20,117
6,9,2,18,15,3,25,20,5,103
6,9,2,18,15,7,12,9,1,79
6,9,2,18,15,9,4,0,0,63
6,9,2,18,15,9,4,19,0,82
6,9,2,18,15,9,14,0,0,73
6,9,2,18,15,9,14,19,0,92
6,9,2,18,15,12,9,20,5,96
6,9,2,18,15,13,1,0,0,64
6,9,2,18,15,13,1,19,0,83
6,9,2,18,15,13,1,20,1,85
6,9,2,18,15,19,5,0,0,74
6,9,2,18,15,19,5,19,0,93
6,9,2,18,15,19,9,19,0,97
6,9,2,18,15,19,9,20,25,123
6,9,2,18,15,20,9,3,0,82
6,9,2,18,15,21,19,0,0,90
6,9,2,18,15,21,19,12,25,127
6,9,2,19,0,0,0,0,0,36
6,9,2,19,20,5,18,0,0,79
6,9,2,21,12,1,0,0,0,51
6,9,2,21,12,1,5,0,0,56
6,9,2,21,12,1,18,0,0,69
6,9,2,21,12,1,18,5,0,74
6,9,2,21,12,1,18,9,1,79
6,9,2,21,12,1,19,0,0,70
6,9,3,0,0,0,0,0,0,18
6,9,3,1,18,25,0,0,0,62
6,9,3,1,18,9,5,19,0,70
6,9,3,1,20,9,15,14,0,77
6,9,3,3,8,5,0,0,0,34
6,9,3,5,0,0,0,0,0,23
6,25,3,5,0,0,0,0,0,39
6,9,3,5,12,12,5,0,0,52
6,9,3,5,19,0,0,0,0,42
6,25,3,5,19,0,0,0,0,58
6,9,3,8,1,20,0,0,0,47
6,9,3,8,5,0,0,0,0,31
6,9,3,8,5,19,0,0,0,50
6,9,3,8,21,0,0,0,0,47
6,9,3,8,21,19,0,0,0,66
6,9,3,9,6,15,18,13,0,79
6,9,3,9,14,0,0,0,0,41
6,9,3,9,14,19,0,0,0,60
6,9,3,11,12,5,0,0,0,46
6,9,3,11,12,5,18,0,0,64
6,9,3,11,12,5,19,20,0,85
6,9,3,11,12,5,20,25,0,91
6,9,3,11,12,25,0,0,0,66
6,9,3,15,0,0,0,0,0,33
6,9,3,15,5,19,0,0,0,57
6,9,3,15,9,4,0,0,0,46
6,9,3,15,9,4,1,12,0,59
6,9,3,15,9,4,5,19,0,70
6,9,3,20,0,0,0,0,0,38
6,9,3,20,1,20,9,15,14,97
6,9,3,20,9,12,0,0,0,59
6,9,3,20,9,12,5,0,0,64
6,9,3,20,9,12,9,20,25,113
6,9,3,20,9,15,14,0,0,76
6,9,3,20,9,15,14,1,12,89
6,9,3,20,9,15,14,5,18,99
6,9,3,20,9,15,14,19,0,95
6,9,3,20,9,15,21,19,0,102
6,9,3,20,9,22,5,0,0,74
6,9,3,20,9,22,5,12,25,111
6,9,3,20,15,18,0,0,0,71
6,9,3,21,19,5,19,0,0,82
6,9,4,0,0,0,0,0,0,19
6,9,4,1,12,7,15,0,0,54
6,9,4,1,20,5,0,0,0,45
6,9,4,1,20,9,15,14,0,78
6,9,4,1,23,9,0,0,0,52
6,9,4,4,5,4,0,0,0,32
6,9,4,4,9,14,7,0,0,53
6,9,4,4,12,5,0,0,0,40
6,9,4,4,12,5,2,15,23,80
6,9,4,4,12,5,4,0,0,44
6,9,4,4,12,5,25,0,0,65
6,9,4,4,12,5,25,19,0,84
6,9,4,4,12,5,18,0,0,58
6,9,4,4,12,5,18,25,0,83
6,9,4,4,12,5,18,19,0,77
6,9,4,4,12,5,19,0,0,59
6,9,4,4,12,25,0,0,0,60
6,9,4,4,12,9,5,19,0,68
6,9,4,4,12,9,14,7,0,65
6,9,4,5,9,19,13,0,0,65
6,9,4,5,9,19,13,19,0,84
6,9,4,5,9,19,20,0,0,72
6,9,4,5,9,19,20,9,3,84
6,9,4,5,9,19,20,19,0,91
6,9,4,5,12,5,19,0,0,60
6,9,4,5,15,19,0,0,0,58
6,9,4,6,1,4,0,0,0,30
6,9,4,7,5,0,0,0,0,31
6,9,4,7,5,4,0,0,0,35
6,9,4,7,5,19,0,0,0,50
6,9,4,7,5,20,0,0,0,51
6,9,4,7,5,20,5,4,0,60
6,9,4,7,5,20,5,18,0,74
6,9,4,7,5,20,5,18,19,93
6,9,4,7,5,20,25,0,0,76
6,9,4,7,5,20,9,12,25,97
6,9,4,7,5,20,9,14,7,81
6,9,4,7,5,20,19,0,0,70
6,9,4,7,9,14,7,0,0,56
6,9,4,9,2,21,19,0,0,70
6,9,4,9,3,9,14,1,12,67
6,9,4,9,3,21,12,1,0,65
6,9,4,9,3,21,12,1,5,70
6,9,4,12,5,25,0,0,0,61
6,9,4,12,5,25,19,0,0,80
6,9,4,15,19,0,0,0,0,53
6,9,4,19,0,0,0,0,0,38
6,9,4,21,3,9,1,0,0,53
6,9,4,21,3,9,1,12,0,65
6,9,4,21,3,9,1,18,25,96
6,9,5,0,0,0,0,0,0,20
6,9,5,4,0,0,0,0,0,24
6,9,5,6,0,0,0,0,0,26
6,9,5,6,4,15,13,0,0,58
6,9,5,6,4,15,13,19,0,77
6,9,5,6,19,0,0,0,0,45
6,9,5,12,0,0,0,0,0,32
6,9,5,12,4,2,1,12,12,63
6,9,5,12,4,2,9,18,4,69
6,9,5,12,4,5,4,0,0,45
6,9,5,12,4,5,14,0,0,55
6,9,5,12,4,5,18,0,0,59
6,9,5,12,4,5,18,19,0,78
6,9,5,12,4,6,1,18,5,66
6,9,5,12,4,25,0,0,0,61
6,9,5,12,4,9,5,0,0,50
6,9,5,12,4,9,19,8,0,72
6,9,5,12,4,12,5,6,20,79
6,9,5,12,4,13,1,14,0,64
6,9,5,12,4,13,5,14,0,68
6,9,5,12,4,13,9,3,5,66
6,9,5,12,4,19,13,1,14,83
6,9,5,12,4,19,13,5,14,87
6,9,5,12,4,23,1,18,4,82
6,9,5,12,4,23,15,18,11,103
6,9,5,12,4,23,15,18,20,112
6,9,5,14,4,6,21,12,0,77
6,9,5,14,4,8,5,1,4,56
6,9,5,14,4,9,19,8,0,74
6,9,5,14,4,9,19,13,0,79
6,9,5,14,4,12,25,0,0,75
6,9,5,14,4,12,9,5,18,82
6,9,5,14,4,12,9,11,5,75
6,9,5,14,4,19,0,0,0,57
6,9,5,14,4,19,8,9,16,90
6,9,5,14,20,0,0,0,0,54
6,9,5,18,3,5,0,0,0,46
6,9,5,18,3,5,12,25,0,83
6,9,5,18,3,5,14,0,0,60
6,9,5,18,3,5,14,5,4,69
6,9,5,18,3,5,18,0,0,64
6,9,5,18,3,5,19,20,0,85
6,9,5,18,3,12,25,0,0,78
6,9,5,18,4,9,14,7,0,72
6,9,5,18,9,0,0,0,0,47
6,9,5,18,25,0,0,0,0,63
6,9,5,18,9,5,18,0,0,70
6,9,5,18,9,5,19,20,0,91
6,9,5,18,9,12,25,0,0,84
6,9,5,18,9,14,5,19,19,104
6,9,5,18,20,5,0,0,0,63
6,9,5,19,20,1,0,0,0,60
6,9,5,19,20,1,19,0,0,79
6,9,6,5,4,0,0,0,0,30
6,9,6,5,18,0,0,0,0,44
6,9,6,5,18,19,0,0,0,63
6,9,6,5,19,0,0,0,0,45
6,9,6,9,5,0,0,0,0,35
6,9,6,9,14,7,0,0,0,51
6,9,6,9,19,8,0,0,0,57
6,9,6,20,5,5,14,0,0,65
6,9,6,20,5,5,14,5,18,88
6,9,6,20,5,5,14,19,0,84
6,9,6,20,5,5,14,20,8,93
6,9,6,20,8,0,0,0,0,49
6,9,6,20,8,12,25,0,0,86
6,9,6,20,8,19,0,0,0,68
6,9,6,20,25,0,0,0,0,66
6,9,6,20,9,5,19,0,0,74
6,9,6,20,9,5,20,8,0,83
6,9,6,20,9,5,20,8,19,102
6,9,6,20,25,6,15,12,4,103
6,9,7,0,0,0,0,0,0,22
6,9,7,1,18,25,0,0,0,66
6,9,7,1,18,15,0,0,0,56
6,9,7,2,9,18,4,0,0,55
6,9,7,2,15,25,0,0,0,64
6,9,7,5,1,20,5,18,0,71
6,9,7,5,1,20,5,18,19,90
6,9,7,5,14,20,0,0,0,61
6,9,7,5,20,5,18,0,0,70
6,9,7,7,5,4,0,0,0,38
6,9,7,7,5,18,25,0,0,77
6,9,7,7,25,0,0,0,0,54
6,9,7,7,9,5,18,0,0,61
6,9,7,7,9,5,19,20,0,82
6,9,7,7,9,14,7,0,0,59
6,9,7,7,12,5,0,0,0,46
6,9,7,7,21,13,0,0,0,63
6,9,7,8,20,0,0,0,0,50
6,9,7,8,20,1,2,12,5,70
6,9,7,8,20,5,18,0,0,73
6,9,7,8,20,5,18,19,0,92
6,9,7,8,20,9,14,7,0,80
6,9,7,8,20,9,14,7,19,99
6,9,7,8,20,19,0,0,0,69
6,9,7,8,20,23,9,20,5,107
6,9,7,12,5,19,19,0,0,77
6,9,7,12,9,11,5,0,0,59
6,9,7,13,5,14,20,0,0,74
6,9,7,13,5,14,20,1,12,87
6,9,7,13,5,14,20,19,0,93
6,9,7,15,0,0,0,0,0,37
6,9,7,16,5,3,11,5,18,80
6,9,7,19,0,0,0,0,0,41
6,9,7,19,8,5,12,12,0,78
6,9,7,21,12,1,20,5,0,81
6,9,7,21,12,1,20,5,4,85
6,9,7,21,12,9,14,5,0,83
6,9,7,21,12,9,14,5,19,102
6,9,7,21,18,1,0,0,0,62
6,9,7,21,18,1,2,12,5,81
6,9,7,21,18,1,5,0,0,67
6,9,7,21,18,1,12,0,0,74
6,9,7,21,18,1,12,12,25,111
6,9,7,21,18,1,14,20,0,96
6,9,7,21,18,1,14,20,5,101
6,9,7,21,18,1,14,20,19,115
6,9,7,21,18,1,20,5,0,87
6,9,7,21,18,1,20,15,0,97
6,9,7,21,18,5,0,0,0,66
6,9,7,21,18,5,4,0,0,70
6,9,7,21,18,5,4,12,25,107
6,9,7,21,18,5,18,0,0,84
6,9,7,21,18,5,18,19,0,103
6,9,7,21,18,5,19,0,0,85
6,9,7,21,18,5,20,20,5,111
6,9,7,21,18,25,0,0,0,86
6,9,7,21,18,9,1,12,0,83
6,9,7,21,18,9,14,5,0,89
6,9,7,21,18,9,14,5,19,108
6,9,7,21,18,9,14,7,0,91
6,9,7,21,18,9,14,7,19,110
6,9,7,21,18,9,19,13,0,102
6,9,7,21,18,9,19,20,0,109
6,9,7,21,18,9,19,20,5,114
6,9,7,21,18,9,26,5,0,101
6,9,7,23,15,18,13,0,0,91
6,9,7,23,15,18,20,0,0,98
6,9,7,23,15,18,20,19,0,117
6,9,11,5,0,0,0,0,0,31
6,25,11,5,0,0,0,0,0,47
6,9,11,5,4,0,0,0,0,35
6,9,11,5,25,0,0,0,0,56
6,9,11,5,18,25,0,0,0,74
6,25,11,5,19,0,0,0,0,66
6,9,11,8,0,0,0,0,0,34
6,9,11,9,5,0,0,0,0,40
6,9,11,9,14,7,0,0,0,56
6,9,12,0,0,0,0,0,0,27
6,9,12,1,0,0,0,0,0,28
6,9,12,1,3,5,0,0,0,36
6,9,12,1,3,5,15,21,19,91
6,9,12,1,3,5,18,0,0,54
6,9,12,1,7,18,5,5,0,63
6,9,12,1,7,18,5,5,4,67
6,9,12,1,7,18,5,5,19,82
6,9,12,1,13,5,14,20,0,80
6,9,12,1,13,5,14,20,19,99
6,9,12,1,14,4,5,18,0,69
6,9,12,1,14,4,5,18,19,88
6,9,12,1,15,0,0,0,0,43
6,9,12,1,18,0,0,0,0,46
6,9,12,1,18,5,5,0,0,56
6,9,12,1,18,5,5,19,0,75
6,9,12,1,18,9,1,5,0,61
6,9,12,1,18,9,1,12,0,68
6,9,12,1,18,9,1,14,0,70
6,9,12,1,18,9,9,4,0,68
6,9,12,1,18,9,9,4,19,87
6,9,12,1,18,9,15,21,19,110
6,9,12,1,19,19,5,0,0,71
6,9,12,1,20,5,0,0,0,53
6,9,12,1,20,15,18,0,0,81
6,9,12,1,20,15,18,25,0,106
6,9,12,1,20,21,18,5,0,92
6,9,12,1,20,21,18,5,19,111
6,9,12,1,26,5,0,0,0,59
6,9,12,1,26,5,18,0,0,77
6,9,12,2,5,18,20,19,0,91
6,9,12,3,8,0,0,0,0,38
6,9,12,3,8,5,4,0,0,47
6,9,12,3,8,5,18,0,0,61
6,9,12,3,8,5,18,25,0,86
6,9,12,3,8,5,18,19,0,80
6,9,12,3,8,5,19,0,0,62
6,9,12,3,8,9,14,7,0,68
6,9,12,5,0,0,0,0,0,32
6,9,12,5,1,0,0,0,0,33
6,9,12,5,1,2,12,5,0,52
6,9,12,5,3,1,18,4,0,58
6,9,12,5,3,8,1,18,0,62
6,9,12,5,4,0,0,0,0,36
6,9,12,5,6,9,19,8,0,74
6,9,12,5,12,9,11,5,0,69
6,9,12,5,13,1,11,5,18,80
6,9,12,5,13,1,18,11,0,75
6,9,12,5,13,1,18,11,19,94
6,9,12,5,13,15,20,0,0,80
6,9,12,5,14,1,13,5,0,65
6,9,12,5,14,1,13,5,19,84
6,9,12,5,18,19,0,0,0,69
6,9,12,5,19,1,22,5,0,79
6,9,12,5,19,13,9,20,8,101
6,9,12,5,19,14,9,6,6,86
6,9,12,5,19,16,5,3,0,75
6,9,12,5,20,0,0,0,0,52
6,9,12,5,20,5,4,0,0,61
6,9,12,5,20,9,14,7,0,82
6,9,12,5,20,19,0,0,0,71
6,25,12,6,15,20,0,0,0,84
6,25,12,6,15,20,19,0,0,103
6,25,12,7,10,1,0,0,0,61
6,25,12,7,10,21,18,0,0,99
6,9,12,9,0,0,0,0,0,36
6,9,12,9,1,12,0,0,0,49
6,9,12,9,1,12,9,20,25,103
6,9,12,9,1,12,12,25,0,86
6,9,12,9,1,20,5,0,0,62
6,9,12,9,1,20,5,4,0,66
6,9,12,9,1,20,5,19,0,81
6,9,12,9,1,20,9,14,7,87
6,9,12,9,1,20,9,15,14,95
6,9,12,9,2,5,7,0,0,50
6,9,12,9,2,5,7,19,0,69
6,9,12,9,3,1,12,0,0,52
6,9,12,9,3,9,3,0,0,51
6,9,12,9,3,9,4,1,12,65
6,9,12,9,3,9,4,5,0,57
6,9,12,9,3,9,4,5,19,76
6,9,12,9,3,9,14,0,0,62
6,9,12,9,3,9,20,5,0,73
6,9,12,9,3,15,9,4,0,67
6,9,12,9,3,15,9,4,19,86
6,9,12,9,5,20,25,0,0,86
6,9,12,9,6,15,18,13,0,88
6,9,12,9,7,18,1,9,14,85
6,9,12,9,7,18,1,14,5,81
6,9,12,9,7,18,5,5,0,71
6,9,12,9,7,18,5,5,4,75
6,9,12,9,7,18,5,5,19,90
6,9,12,9,9,0,0,0,0,45
6,9,12,9,14,7,0,0,0,57
6,9,12,9,14,7,19,0,0,76
6,9,12,9,15,17,21,5,0,94
6,9,12,9,16,16,9,0,0,77
6,9,12,9,16,16,9,3,0,80
6,9,12,9,19,20,5,18,0,98
6,9,12,9,19,20,5,18,19,117
6,9,12,9,20,5,0,0,0,61
6,9,12,9,21,19,0,0,0,76
6,25,12,11,5,18,0,0,0,77
6,9,12,12,0,0,0,0,0,39
6,9,12,12,1,0,0,0,0,40
6,9,12,12,1,2,12,5,0,59
6,9,12,12,1,7,18,5,5,75
6,9,12,12,5,0,0,0,0,44
6,9,12,12,5,2,5,7,0,58
6,9,12,12,5,4,0,0,0,48
6,9,12,12,5,13,15,20,0,92
6,9,12,12,5,18,3,1,16,82
6,9,12,12,5,18,19,0,0,81
6,9,12,12,5,19,0,0,0,63
6,9,12,12,5,20,0,0,0,64
6,9,12,12,5,20,5,4,0,73
6,9,12,12,5,20,5,18,0,87
6,9,12,12,5,20,9,14,7,94
6,9,12,12,5,20,19,0,0,83
6,9,12,12,5,21,12,0,0,77
6,9,12,12,25,0,0,0,0,64
6,9,12,12,9,5,19,0,0,72
6,9,12,12,9,14,7,0,0,69
6,9,12,12,9,14,7,12,25,106
6,9,12,12,9,14,7,19,0,88
6,9,12,12,9,16,0,0,0,64
6,9,12,12,9,16,5,4,0,73
6,9,12,12,9,16,5,5,14,88
6,9,12,12,9,16,9,14,7,94
6,9,12,12,9,16,19,0,0,83
6,9,12,12,9,19,20,5,18,110
6,9,12,12,13,1,19,19,0,91
6,9,12,12,15,0,0,0,0,54
6,9,12,12,15,3,11,0,0,68
6,9,12,12,15,19,0,0,0,73
6,9,12,12,15,23,9,20,5,111
6,9,12,12,19,0,0,0,0,58
6,9,12,13,0,0,0,0,0,40
6,9,12,13,1,2,12,5,0,60
6,9,12,13,3,1,18,4,0,66
6,9,12,13,3,1,18,4,19,85
6,9,12,13,4,15,13,0,0,72
6,9,12,13,4,15,13,19,0,91
6,9,12,13,5,4,0,0,0,49
6,9,12,13,5,18,19,0,0,82
6,9,12,13,5,20,0,0,0,65
6,9,12,13,7,15,5,18,0,85
6,9,12,13,7,15,5,18,19,104
6,9,12,13,7,15,9,14,7,92
6,9,12,13,25,0,0,0,0,65
6,9,12,13,9,3,0,0,0,52
6,9,12,13,9,5,18,0,0,72
6,9,12,13,9,5,19,20,0,93
6,9,12,13,9,6,15,18,13,101
6,9,12,13,9,12,25,0,0,86
6,9,12,13,9,14,5,19,19,106
6,9,12,13,9,14,7,0,0,70
6,9,12,13,9,19,8,0,0,76
6,9,12,13,9,19,20,0,0,88
6,9,12,13,9,26,5,0,0,80
6,9,12,13,9,26,5,4,0,84
6,9,12,13,9,26,9,14,7,105
6,9,12,13,12,1,14,4,0,71
6,9,12,13,12,1,14,4,19,90
6,9,12,13,12,9,11,5,0,77
6,9,12,13,13,1,11,5,0,70
6,9,12,13,13,1,11,5,18,88
6,9,12,13,15,7,5,14,0,81
6,9,12,13,19,0,0,0,0,59
6,9,12,13,19,5,20,0,0,84
6,9,12,13,19,5,20,19,0,103
6,9,12,13,19,12,9,4,5,89
6,9,12,13,19,20,18,9,16,122
6,9,12,15,16,12,21,13,5,109
6,9,12,15,16,15,4,9,1,87
6,9,12,15,19,0,0,0,0,61
6,9,12,15,19,5,0,0,0,66
6,9,12,15,19,5,12,12,5,95
6,9,12,15,19,15,6,5,0,87
6,9,12,15,19,21,19,0,0,101
6,9,12,19,0,0,0,0,0,46
6,9,12,20,0,0,0,0,0,47
6,9,12,20,5,18,0,0,0,70
6,9,12,20,5,18,5,4,0,79
6,9,12,20,5,18,5,18,0,93
6,9,12,20,5,18,5,18,19,112
6,9,12,20,5,18,9,14,7,100
6,9,12,20,5,18,13,1,14,98
6,9,12,20,5,18,13,5,14,102
6,9,12,20,5,18,19,0,0,89
6,9,12,20,8,0,0,0,0,55
6,9,12,20,8,25,0,0,0,80
6,9,12,20,8,9,5,18,0,87
6,9,12,20,8,9,5,19,20,108
6,9,12,20,8,9,6,25,0,95
6,9,12,20,8,9,12,25,0,101
6,9,12,20,8,12,5,19,19,110
6,9,12,20,8,19,0,0,0,74
6,9,12,20,18,1,2,12,5,85
6,9,12,20,18,1,20,5,0,91
6,9,12,20,18,1,20,5,4,95
6,9,12,20,18,1,20,5,19,110
6,9,12,20,18,5,0,0,0,70
6,9,12,21,13,0,0,0,0,61
6,9,13,2,12,5,0,0,0,47
6,9,13,2,12,5,19,0,0,66
6,9,13,2,18,9,1,0,0,58
6,9,13,2,18,9,1,5,0,63
6,9,13,2,18,9,1,12,0,70
6,9,13,2,18,9,1,20,5,83
6,9,13,2,18,9,12,12,1,82
6,9,13,5,20,9,3,0,0,65
6,9,14,1,2,12,5,0,0,49
6,9,14,1,7,12,5,0,0,54
6,9,14,1,7,12,5,4,0,58
6,9,14,1,7,12,5,18,0,72
6,9,14,1,7,12,5,18,19,91
6,9,14,1,7,12,5,19,0,73
6,9,14,1,7,12,9,14,7,79
6,9,14,1,12,0,0,0,0,42
6,9,14,1,12,5,0,0,0,47
6,9,14,1,12,5,19,0,0,66
6,9,14,1,12,9,19,0,0,70
6,9,14,1,12,9,19,13,0,83
6,9,14,1,12,9,19,13,19,102
6,9,14,1,12,9,19,20,0,90
6,9,14,1,12,9,19,20,19,109
6,9,14,1,12,9,20,25,0,96
6,9,14,1,12,9,26,5,0,82
6,9,14,1,12,9,26,5,4,86
6,9,14,1,12,9,26,5,19,101
6,9,14,1,12,12,25,0,0,79
6,9,14,1,12,19,0,0,0,61
6,9,14,1,14,3,5,4,0,56
6,9,14,1,14,3,5,18,0,70
6,9,14,1,14,3,5,19,0,71
6,9,14,1,14,3,9,1,12,69
6,9,14,1,14,3,9,5,18,79
6,9,14,1,14,3,9,14,7,77
6,9,14,1,14,3,9,19,20,95
6,9,14,1,18,25,0,0,0,73
6,9,14,2,1,3,11,0,0,46
6,9,14,2,1,3,11,19,0,65
6,9,14,2,15,14,5,0,0,65
6,9,14,3,1,0,0,0,0,33
6,9,14,3,1,19,0,0,0,52
6,9,14,3,8,0,0,0,0,40
6,9,14,3,8,5,4,0,0,49
6,9,14,3,8,5,18,25,0,88
6,9,14,3,8,5,19,0,0,64
6,9,14,4,0,0,0,0,0,33
6,9,14,4,1,2,12,5,0,53
6,9,14,4,1,12,0,0,0,46
6,9,14,4,5,18,0,0,0,56
6,9,14,4,5,18,19,0,0,75
6,9,14,4,6,1,21,12,20,93
6,9,14,4,8,15,18,14,0,88
6,9,14,4,25,0,0,0,0,58
6,9,14,4,9,14,7,0,0,63
6,9,14,4,9,14,7,19,0,82
6,9,14,4,10,1,14,0,0,58
6,9,14,4,15,14,0,0,0,62
6,9,14,4,19,0,0,0,0,52
6,9,14,5,1,2,12,5,0,54
6,9,14,5,2,5,14,20,0,75
6,9,14,5,3,15,13,2,0,67
6,9,14,5,4,0,0,0,0,38
6,9,14,5,4,18,1,23,0,80
6,9,14,5,5,18,0,0,0,57
6,9,14,5,9,19,8,0,0,70
6,9,14,5,12,5,1,6,0,58
6,9,14,5,12,5,19,19,0,89
6,9,14,5,12,25,0,0,0,71
6,9,14,5,13,5,14,20,0,86
6,9,14,5,14,5,19,19,0,91
6,9,14,5,18,25,0,0,0,77
6,9,14,5,18,9,5,19,0,85
6,9,14,5,19,0,0,0,0,53
6,9,14,5,19,16,21,14,0,104
6,9,14,5,19,19,5,0,0,77
6,9,14,5,19,19,5,4,0,81
6,9,14,5,19,19,5,18,0,95
6,9,14,5,19,19,5,19,0,96
6,9,14,5,19,19,9,14,7,102
6,9,14,5,19,20,0,0,0,73
6,9,14,5,19,20,9,12,12,106
6,9,14,5,19,20,18,1,0,92
6,9,14,5,20,15,16,0,0,85
6,9,14,5,23,0,0,0,0,57
6,9,14,5,23,5,4,0,0,66
6,9,14,6,9,19,8,0,0,71
6,9,14,6,9,19,8,5,19,95
6,9,14,6,15,15,20,0,0,85
6,9,14,6,15,15,20,19,0,104
6,9,14,7,1,14,0,0,0,51
6,9,14,7,5,14,20,0,0,75
6,9,14,7,5,18,0,0,0,59
6,9,14,7,5,18,5,4,0,68
6,9,14,7,5,18,5,18,0,82
6,9,14,7,5,18,5,18,19,101
6,9,14,7,5,18,25,0,0,84
6,9,14,7,5,18,9,14,7,89
6,9,14,7,5,18,12,5,20,96
6,9,14,7,5,18,19,0,0,78
6,9,14,7,5,18,20,9,16,104
6,9,14,7,9,1,14,0,0,60
6,9,14,7,18,1,13,0,0,68
6,9,14,7,18,9,7,15,0,85
6,9,14,9,1,12,0,0,0,51
6,9,14,9,1,12,5,4,0,60
6,9,14,9,1,12,19,0,0,70
6,9,14,9,3,1,12,0,0,54
6,9,14,9,3,1,12,12,25,91
6,9,14,9,3,9,19,13,0,82
6,9,14,9,3,11,0,0,0,52
6,9,14,9,3,11,25,0,0,77
6,9,14,9,3,11,9,5,18,84
6,9,14,9,3,11,9,12,25,98
6,9,14,9,3,11,9,14,0,75
6,9,14,9,3,11,9,14,7,82
6,9,14,9,6,25,0,0,0,69
6,9,14,9,6,9,3,0,0,56
6,9,14,9,11,9,14,0,0,72
6,9,14,9,11,9,14,7,0,79
6,9,14,9,14,7,0,0,0,59
6,9,14,9,14,7,19,0,0,78
6,9,14,9,19,0,0,0,0,57
6,9,14,9,19,5,19,0,0,81
6,9,14,9,19,8,0,0,0,65
6,9,14,9,19,8,5,4,0,74
6,9,14,9,19,8,5,18,0,88
6,9,14,9,19,8,5,18,19,107
6,9,14,9,19,8,5,19,0,89
6,9,14,9,19,8,9,14,7,95
6,9,14,9,20,1,18,25,0,102
6,9,14,9,20,5,0,0,0,63
6,9,14,9,20,5,12,25,0,100
6,9,14,9,20,5,19,0,0,82
6,9,14,9,20,25,0,0,0,83
6,9,14,9,20,9,19,13,0,99
6,9,14,9,20,9,22,5,0,94
6,9,14,9,20,21,4,5,0,88
6,9,14,9,20,21,4,5,19,107
6,9,14,10,1,14,0,0,0,54
6,9,14,11,5,4,0,0,0,49
6,9,14,11,5,12,0,0,0,57
6,9,14,11,25,0,0,0,0,65
6,9,14,11,9,14,7,0,0,70
6,9,14,11,19,0,0,0,0,59
6,9,14,12,5,19,19,0,0,84
6,9,14,12,5,20,0,0,0,66
6,9,14,12,9,11,5,0,0,66
6,9,14,13,1,18,11,19,0,91
6,9,14,14,1,3,0,0,0,47
6,9,14,14,1,3,11,0,0,58
6,9,14,14,1,14,0,0,0,58
6,9,14,14,5,4,0,0,0,52
6,9,14,14,5,18,0,0,0,66
6,9,14,14,5,19,11,15,0,93
6,9,14,14,9,3,11,0,0,66
6,9,14,14,9,3,11,25,0,91
6,9,14,14,9,5,18,0,0,75
6,9,14,14,9,5,19,20,0,96
6,9,14,14,9,14,7,0,0,73
6,9,14,14,9,16,0,0,0,68
6,9,14,14,13,1,18,11,19,105
6,9,14,14,15,3,0,0,0,61
6,9,14,14,15,3,8,9,15,93
6,9,14,14,19,0,0,0,0,62
6,9,14,15,3,8,9,15,0,79
6,9,14,15,3,8,9,15,19,98
6,9,14,15,19,0,0,0,0,63
6,9,14,19,0,0,0,0,0,48
6,9,14,19,16,15,20,0,0,99
6,9,15,18,4,0,0,0,0,52
6,9,15,18,4,5,4,0,0,61
6,9,15,18,4,19,0,0,0,71
6,9,15,18,9,14,0,0,0,71
6,9,15,18,9,20,5,0,0,82
6,9,15,18,9,20,21,18,1,117
6,9,15,18,9,20,21,18,5,121
6,9,16,5,14,14,25,0,0,89
6,9,16,16,5,14,3,5,0,74
6,9,16,16,12,5,0,0,0,64
6,9,16,16,12,5,19,0,0,83
6,9,17,8,0,0,0,0,0,40
6,9,17,21,5,0,0,0,0,58
6,9,17,21,5,19,0,0,0,77
6,9,18,3,1,0,0,0,0,37
6,25,18,4,0,0,0,0,0,53
6,25,18,4,21,14,7,0,0,95
6,9,18,5,0,0,0,0,0,38
6,9,18,5,1,2,12,5,0,58
6,9,18,5,1,18,13,0,0,70
6,9,18,5,1,18,13,5,4,79
6,9,18,5,1,18,13,19,0,89
6,9,18,5,2,1,3,11,0,55
6,9,18,5,2,1,12,12,0,65
6,9,18,5,2,1,12,12,19,84
6,9,18,5,2,1,19,5,0,65
6,9,18,5,2,1,19,5,19,84
6,9,18,5,2,5,4,0,0,49
6,9,18,5,2,9,18,4,0,71
6,9,18,5,2,9,18,4,19,90
6,9,18,5,2,15,1,18,4,78
6,9,18,5,2,15,1,20,0,76
6,9,18,5,2,15,1,20,19,95
6,9,18,5,2,15,25,0,0,80
6,9,18,5,2,15,12,20,0,87
6,9,18,5,2,15,13,2,0,70
6,9,18,5,2,15,13,2,19,89
6,9,18,5,2,15,15,20,0,90
6,9,18,5,2,15,20,5,0,80
6,9,18,5,2,15,24,0,0,79
6,9,18,5,2,15,24,5,19,103
6,9,18,5,2,18,1,14,4,77
6,9,18,5,2,18,1,20,0,79
6,9,18,5,2,18,1,20,19,98
6,9,18,5,2,18,5,1,11,75
6,9,18,5,2,21,7,0,0,68
6,9,18,5,2,21,7,19,0,87
6,9,18,5,2,21,18,14,0,93
6,9,18,5,3,12,1,25,0,79
6,9,18,5,3,12,1,25,19,98
6,9,18,5,3,15,1,20,0,77
6,9,18,5,3,18,5,19,20,103
6,9,18,5,4,0,0,0,0,42
6,9,18,5,4,1,13,16,0,72
6,9,18,5,4,1,13,16,19,91
6,9,18,5,4,15,7,0,0,64
6,9,18,5,4,15,7,19,0,83
6,9,18,5,4,18,1,11,5,77
6,9,18,5,6,1,12,12,0,69
6,9,18,5,6,1,14,7,0,66
6,9,18,5,6,1,14,7,19,85
6,9,18,5,6,9,7,8,20,88
6,9,18,5,6,12,25,0,0,81
6,9,18,5,6,12,9,5,19,89
6,9,18,5,6,12,9,18,20,103
6,9,18,5,7,21,1,18,4,89
6,9,18,5,8,1,12,12,0,71
6,9,18,5,8,1,12,12,19,90
6,9,18,5,8,15,21,19,5,106
6,9,18,5,12,5,19,19,0,93
6,9,18,5,12,9,7,8,20,94
6,9,18,5,12,9,11,5,0,75
6,9,18,5,12,9,14,7,0,80
6,9,18,5,12,9,20,0,0,79
6,9,18,5,12,15,3,11,0,79
6,9,18,5,12,15,3,11,19,98
6,9,18,5,13,1,14,0,0,66
6,9,18,5,13,5,14,0,0,70
6,9,18,5,16,1,14,0,0,69
6,9,18,5,16,1,14,19,0,88
6,9,18,5,16,9,14,11,0,88
6,9,18,5,16,9,14,11,19,107
6,9,18,5,16,12,1,3,5,75
6,9,18,5,16,12,15,23,0,104
6,9,18,5,16,12,21,7,0,94
6,9,18,5,16,12,21,7,19,113
6,9,18,5,16,15,20,0,0,89
6,9,18,5,16,15,23,5,18,115
6,9,18,5,16,18,15,15,6,108
6,9,18,5,18,0,0,0,0,56
6,9,18,5,18,15,15,13,0,99
6,9,18,5,18,15,15,13,19,118
6,9,18,5,18,19,0,0,0,75
6,9,18,5,19,0,0,0,0,57
6,9,18,5,19,1,6,5,0,69
6,9,18,5,19,8,1,6,20,92
6,9,18,5,19,8,9,14,5,93
6,9,18,5,19,9,4,5,0,75
6,9,18,5,19,9,4,5,18,93
6,9,18,5,19,9,4,5,19,94
6,9,18,5,19,16,15,21,20,129
6,9,18,5,19,20,15,16,0,108
6,9,18,5,19,20,15,18,13,123
6,9,18,5,20,1,9,12,0,80
6,9,18,5,20,8,15,18,14,113
6,9,18,5,20,15,16,0,0,89
6,9,18,5,20,15,23,5,18,119
6,9,18,5,20,18,1,16,0,93
6,9,18,5,20,18,1,16,19,112
6,9,18,5,23,1,12,12,0,86
6,9,18,5,23,1,18,4,0,84
6,9,18,5,23,1,20,5,18,105
6,9,18,5,23,5,5,4,0,75
6,9,18,5,23,5,5,4,19,94
6,9,18,5,23,15,15,4,0,95
6,9,18,5,23,15,15,4,19,114
6,9,18,5,23,15,18,11,0,105
6,9,18,5,23,15,18,11,25,130
6,9,18,5,23,15,18,11,19,124
6,9,18,5,23,15,18,13,0,107
6,9,18,5,23,15,18,13,19,126
6,9,18,25,0,0,0,0,0,58
6,9,18,9,14,5,19,19,0,99
6,9,18,9,14,7,0,0,0,63
6,9,18,9,14,7,19,0,0,82
6,9,18,11,0,0,0,0,0,44
6,9,18,11,5,4,0,0,0,53
6,9,18,11,5,18,0,0,0,67
6,9,18,11,9,14,0,0,0,67
6,9,18,11,9,14,7,0,0,74
6,9,18,11,9,14,19,0,0,86
6,9,18,12,15,20,0,0,0,80
6,9,18,13,0,0,0,0,0,46
6,9,18,13,1,0,0,0,0,47
6,9,18,13,1,13,5,14,20,99
6,9,18,13,1,14,3,5,0,69
6,9,18,13,1,14,19,0,0,80
6,9,18,13,1,18,9,9,0,83
6,9,18,13,1,18,9,21,19,114
6,9,18,13,1,20,9,15,14,105
6,9,18,13,5,4,0,0,0,55
6,9,18,13,5,18,0,0,0,69
6,9,18,13,5,18,19,0,0,88
6,9,18,13,5,19,20,0,0,90
6,9,18,13,9,14,7,0,0,76
6,9,18,13,9,20,25,0,0,100
6,9,18,13,9,20,21,4,5,105
6,9,18,13,12,1,14,4,0,77
6,9,18,13,12,5,19,19,0,101
6,9,18,13,12,25,0,0,0,83
6,9,18,13,14,5,19,19,0,103
6,9,18,13,19,0,0,0,0,65
6,9,18,13,23,1,18,5,0,93
6,9,18,14,0,0,0,0,0,47
6,9,18,14,19,0,0,0,0,66
6,9,18,18,25,0,0,0,0,76
6,9,18,18,9,14,7,0,0,81
6,9,18,19,0,0,0,0,0,52
6,9,18,19,20,0,0,0,0,72
6,9,18,19,20,2,15,18,14,121
6,9,18,19,20,5,18,0,0,95
6,9,18,19,20,8,1,14,4,99
6,9,18,19,20,12,25,0,0,109
6,9,18,19,20,12,9,14,7,114
6,9,18,19,20,14,5,19,19,129
6,9,18,19,20,19,0,0,0,91
6,9,18,19,20,19,8,9,16,124
6,9,18,20,8,19,0,0,0,80
6,9,19,3,0,0,0,0,0,37
6,9,19,3,1,12,0,0,0,50
6,9,19,3,1,12,9,6,25,90
6,9,19,3,1,12,9,19,13,91
6,9,19,3,1,12,9,20,25,104
6,9,19,3,1,12,9,26,5,90
6,9,19,3,1,12,12,25,0,87
6,9,19,3,1,12,19,0,0,69
6,9,19,3,19,0,0,0,0,56
6,9,19,3,21,19,0,0,0,77
6,9,19,5,0,0,0,0,0,39
6,9,19,5,20,9,14,0,0,82
6,9,19,8,1,2,12,5,0,62
6,9,19,8,2,5,4,0,0,53
6,9,19,8,2,5,18,18,25,110
6,9,19,8,2,15,1,20,0,80
6,9,19,8,2,15,1,20,19,99
6,9,19,8,2,15,12,20,0,91
6,9,19,8,2,15,12,20,19,110
6,9,19,8,2,15,14,5,0,78
6,9,19,8,2,15,14,5,19,97
6,9,19,8,2,15,23,12,0,94
6,9,19,8,2,15,23,12,19,113
6,9,19,8,5,1,20,5,18,91
6,9,19,8,5,4,0,0,0,51
6,9,19,8,5,25,5,0,0,77
6,9,19,8,5,25,5,19,0,96
6,9,19,8,5,18,2,15,25,107
6,9,19,8,5,18,5,19,19,108
6,9,19,8,5,18,25,0,0,90
6,9,19,8,5,18,9,5,19,98
6,9,19,8,5,18,13,1,14,93
6,9,19,8,5,18,13,5,14,97
6,9,19,8,5,20,0,0,0,67
6,9,19,8,6,1,12,12,0,73
6,9,19,8,6,21,12,0,0,81
6,9,19,8,7,1,18,20,8,96
6,9,19,8,7,9,7,0,0,65
6,9,19,8,7,9,7,19,0,84
6,9,19,8,7,18,1,19,19,106
6,9,19,8,8,15,12,4,0,81
6,9,19,8,8,15,15,4,0,84
6,9,19,8,8,15,15,11,0,91
6,9,19,8,8,15,15,11,19,110
6,9,19,8,8,15,21,19,5,110
6,9,19,8,25,0,0,0,0,67
6,9,19,8,25,1,18,4,0,90
6,9,19,8,25,2,1,3,11,84
6,9,19,8,9,5,18,0,0,74
6,9,19,8,9,5,19,20,0,95
6,9,19,8,9,6,25,0,0,82
6,9,19,8,9,6,9,5,4,75
6,9,19,8,9,12,25,0,0,88
6,9,19,8,9,14,5,19,19,108
6,9,19,8,9,14,7,0,0,72
6,9,19,8,9,14,7,12,25,109
6,9,19,8,9,14,7,19,0,91
6,9,19,8,12,5,19,19,0,97
6,9,19,8,12,5,20,0,0,79
6,9,19,8,12,9,11,5,0,79
6,9,19,8,12,9,14,5,0,82
6,9,19,8,12,9,14,5,19,101
6,9,19,8,12,9,14,7,0,84
6,9,19,8,13,5,1,12,0,73
6,9,19,8,13,5,1,12,19,92
6,9,19,8,13,5,14,0,0,74
6,9,19,8,13,15,21,20,8,119
6,9,19,8,14,5,20,0,0,81
6,9,19,8,14,5,20,19,0,100
6,9,19,8,16,12,1,20,5,96
6,9,19,8,16,15,12,5,0,90
6,9,19,8,16,15,12,5,19,109
6,9,19,8,16,15,14,4,0,91
6,9,19,8,16,15,14,4,19,110
6,9,19,8,16,15,15,12,0,100
6,9,19,8,16,15,20,0,0,93
6,9,19,8,16,15,21,14,4,112
6,9,19,8,19,11,9,14,0,95
6,9,19,8,19,16,5,1,18,101
6,9,19,8,20,1,9,12,19,103
6,9,19,8,23,1,25,0,0,91
6,9,19,8,23,1,25,19,0,110
6,9,19,8,23,5,5,4,0,79
6,9,19,8,23,5,9,18,0,97
6,9,19,8,23,9,6,5,0,85
6,9,19,8,23,9,22,5,19,120
6,9,19,8,23,15,13,1,14,108
6,9,19,8,23,15,15,4,0,99
6,9,19,8,23,15,18,11,19,128
6,9,19,8,23,15,18,13,0,111
6,9,19,14,15,7,1,0,0,71
6,9,19,19,1,20,5,0,0,79
6,9,19,19,9,12,5,0,0,79
6,9,19,19,9,12,9,20,25,128
6,9,19,19,9,15,14,0,0,91
6,9,19,19,9,15,14,1,12,104
6,9,19,19,9,15,14,5,4,100
6,9,19,19,9,15,14,19,0,110
6,9,19,19,9,16,5,4,0,87
6,9,19,19,9,16,5,4,19,106
6,9,19,19,9,22,5,0,0,89
6,9,19,19,12,5,0,0,0,70
6,9,19,19,21,18,1,0,0,93
6,9,19,19,21,18,1,12,0,105
6,9,19,19,21,18,5,0,0,97
6,9,19,19,21,18,5,4,0,101
6,9,19,19,21,18,5,19,0,116
6,9,19,19,21,18,25,0,0,117
6,9,19,19,21,18,9,14,7,122
6,9,19,20,0,0,0,0,0,54
6,9,19,20,5,4,0,0,0,63
6,9,19,20,5,18,0,0,0,77
6,9,19,20,6,9,7,8,20,104
6,9,19,20,6,21,12,0,0,93
6,9,19,20,6,21,12,19,0,112
6,9,19,20,9,1,14,1,0,79
6,9,19,20,9,3,0,0,0,66
6,9,19,20,9,3,1,12,0,79
6,9,19,20,9,3,21,6,6,99
6,9,19,20,9,6,25,0,0,94
6,9,19,20,9,14,5,19,19,120
6,9,19,20,9,14,7,0,0,84
6,9,19,20,9,14,21,20,0,118
6,9,19,20,12,5,0,0,0,71
6,9,19,20,12,9,11,5,0,91
6,9,19,20,13,5,12,5,0,89
6,9,19,20,14,15,20,5,0,108
6,9,19,20,14,15,20,5,19,127
6,9,19,20,19,0,0,0,0,73
6,9,19,20,21,3,1,0,0,79
6,9,19,20,21,12,1,0,0,88
6,9,19,20,21,12,1,5,0,93
6,9,19,20,21,12,1,18,0,106
6,9,19,20,21,12,1,19,0,107
6,9,19,20,21,12,1,20,5,113
6,9,19,20,21,12,5,0,0,92
6,9,19,20,21,12,9,26,5,127
6,9,19,20,21,12,15,19,5,126
6,9,19,20,21,12,15,21,19,142
6,9,19,20,23,9,19,5,0,110
6,9,20,3,8,5,0,0,0,51
6,9,20,3,8,5,4,0,0,55
6,9,20,3,8,5,5,0,0,56
6,9,20,3,8,5,18,0,0,69
6,9,20,3,8,5,18,5,4,78
6,9,20,3,8,5,18,25,0,94
6,9,20,3,8,5,19,0,0,70
6,9,20,3,8,5,20,0,0,71
6,9,20,3,8,5,20,19,0,90
6,9,20,3,8,5,23,0,0,74
6,9,20,3,8,5,23,19,0,93
6,9,20,3,8,25,0,0,0,71
6,9,20,6,21,12,0,0,0,74
6,9,20,6,21,12,12,25,0,111
6,9,20,9,6,9,5,4,0,68
6,9,20,12,25,0,0,0,0,72
6,9,20,13,5,14,20,0,0,87
6,9,20,13,5,14,20,19,0,106
6,9,20,14,5,19,19,0,0,92
6,9,20,14,5,19,19,5,19,116
6,9,20,15,21,20,0,0,0,91
6,9,20,18,15,15,20,0,0,103
6,9,20,20,1,2,12,5,0,75
6,9,20,20,1,7,5,0,0,68
6,25,20,20,5,0,0,0,0,76
6,9,20,20,5,4,0,0,0,64
6,9,20,20,5,14,0,0,0,74
6,9,20,20,5,18,0,0,0,78
6,9,20,20,5,18,19,0,0,97
6,25,20,20,5,19,0,0,0,95
6,9,20,20,5,19,20,0,0,99
6,9,20,20,25,0,0,0,0,80
6,9,20,20,9,5,18,0,0,87
6,9,20,20,9,5,19,20,0,108
6,9,20,20,25,6,9,5,4,104
6,9,20,20,9,12,25,0,0,101
6,9,20,20,9,14,5,19,19,121
6,9,20,20,9,14,7,12,25,122
6,9,20,20,9,14,7,19,0,104
6,9,20,20,9,20,0,0,0,84
6,9,20,20,25,23,1,25,19,148
6,9,20,20,25,23,9,19,5,136
6,9,20,23,5,5,4,0,0,72
6,9,21,13,1,18,1,0,0,69
6,9,22,5,0,0,0,0,0,42
6,9,22,5,2,1,18,0,0,63
6,9,22,5,6,15,12,4,0,79
6,9,22,5,12,9,14,7,0,84
6,9,22,5,16,5,14,3,5,85
6,9,22,5,16,5,14,14,25,116
6,9,22,5,16,9,14,19,0,100
6,9,22,5,18,0,0,0,0,60
6,9,22,5,18,19,0,0,0,79
6,9,22,5,19,0,0,0,0,61
6,9,22,5,19,3,15,18,5,102
6,9,22,5,19,15,13,5,0,94
6,9,22,9,19,8,0,0,0,73
6,9,24,0,0,0,0,0,0,39
6,9,24,1,2,12,5,0,0,59
6,9,24,1,7,5,0,0,0,52
6,9,24,1,20,5,0,0,0,65
6,9,24,1,20,5,4,0,0,69
6,9,24,1,20,5,19,0,0,84
6,9,24,1,20,9,6,0,0,75
6,9,24,1,20,9,6,19,0,94
6,9,24,1,20,9,14,7,0,90
6,9,24,1,20,9,15,14,0,98
6,9,24,1,20,9,15,14,19,117
6,9,24,1,20,9,22,5,0,96
6,9,24,1,20,9,22,5,19,115
6,9,24,1,20,15,18,0,0,93
6,9,24,1,20,21,18,5,0,104
6,9,24,5,0,0,0,0,0,44
6,9,24,5,4,0,0,0,0,48
6,9,24,5,4,12,25,0,0,85
6,9,24,5,4,14,5,19,19,105
6,9,24,5,18,0,0,0,0,62
6,9,24,5,18,19,0,0,0,81
6,9,24,5,19,0,0,0,0,63
6,9,24,7,9,7,0,0,0,62
6,9,24,9,4,9,20,25,0,106
6,9,24,9,14,7,0,0,0,69
6,9,24,9,14,7,19,0,0,88
6,9,24,9,15,14,0,0,0,77
6,9,24,9,20,0,0,0,0,68
6,9,24,9,20,25,0,0,0,93
6,9,24,9,20,9,5,19,0,101
6,9,24,9,22,5,0,0,0,75
6,9,24,20,0,0,0,0,0,59
6,9,24,20,21,18,5,0,0,103
6,9,24,20,21,18,5,19,0,122
6,9,24,21,16,0,0,0,0,76
6,9,24,21,16,19,0,0,0,95
6,9,24,21,18,5,0,0,0,83
6,9,24,21,18,5,19,0,0,102
6,9,26,0,0,0,0,0,0,41
6,9,26,5,12,25,9,20,5,117
6,9,26,7,9,7,0,0,0,64
6,9,26,7,9,7,19,0,0,83
6,9,26,26,0,0,0,0,0,67
6,9,26,26,5,4,0,0,0,76
6,9,26,26,5,18,0,0,0,90
6,9,26,26,5,18,19,0,0,109
6,9,26,26,5,19,0,0,0,91
6,9,26,26,25,0,0,0,0,92
6,9,26,26,9,5,18,0,0,99
6,9,26,26,9,5,19,20,0,120
6,9,26,26,9,14,7,0,0,97
6,9,26,26,12,5,0,0,0,84
6,9,26,26,12,5,4,0,0,88
6,9,26,26,12,5,19,0,0,103
6,9,26,26,12,9,14,7,0,109
6,9,26,26,23,1,20,5,18,134
6,10,5,12,4,0,0,0,0,37
6,10,5,12,4,19,0,0,0,56
6,10,5,18,4,9,14,7,0,73
6,10,15,18,4,0,0,0,0,53
6,10,15,18,4,5,4,0,0,62
6,10,15,18,4,19,0,0,0,72
6,12,3,8,5,0,0,0,0,34
6,12,3,8,5,20,20,5,0,79
6,12,4,0,0,0,0,0,0,22
6,12,4,24,20,0,0,0,0,66
6,12,5,1,0,0,0,0,0,24
6,12,5,1,2,1,7,0,0,34
6,12,5,1,2,1,7,19,0,53
6,12,5,1,2,1,14,5,0,46
6,12,5,1,2,1,14,5,19,65
6,12,5,1,2,9,20,5,0,60
6,12,5,1,2,9,20,5,19,79
6,12,5,1,2,21,7,0,0,54
6,12,5,1,2,21,7,19,0,73
6,12,5,1,4,15,3,11,0,57
6,12,5,1,25,0,0,0,0,49
6,12,5,1,11,0,0,0,0,35
6,12,5,1,13,0,0,0,0,37
6,12,5,1,13,25,0,0,0,62
6,12,5,1,13,19,0,0,0,56
6,12,5,1,16,9,20,0,0,69
6,12,5,1,16,9,20,19,0,88
6,12,5,1,18,0,0,0,0,42
6,12,5,1,19,0,0,0,0,43
6,12,5,1,19,5,5,4,0,57
6,12,5,1,23,5,5,4,0,61
6,12,5,1,23,15,15,4,0,81
6,12,5,1,23,15,18,20,0,100
6,12,5,1,23,15,18,20,19,119
6,12,5,2,9,12,5,0,0,51
6,12,5,2,15,20,15,13,25,113
6,12,5,3,8,5,0,0,0,39
6,12,5,3,8,5,19,0,0,58
6,12,5,3,8,5,20,20,5,84
6,12,5,3,11,5,4,0,0,46
6,12,5,3,11,5,14,0,0,56
6,12,5,3,11,5,18,5,4,69
6,12,5,3,11,25,0,0,0,62
6,12,5,3,11,9,5,18,0,69
6,12,5,3,11,9,5,19,20,90
6,12,5,3,11,9,14,7,0,67
6,12,5,3,11,12,5,4,0,58
6,12,5,3,11,12,5,19,19,92
6,12,5,3,11,19,0,0,0,56
6,12,5,3,14,15,4,1,12,72
6,12,5,3,14,15,4,5,0,64
6,12,5,3,20,0,0,0,0,46
6,12,5,3,20,9,15,14,0,84
6,12,5,3,20,9,15,14,19,103
6,12,5,3,20,15,18,0,0,79
6,12,5,4,0,0,0,0,0,27
6,12,5,4,7,5,0,0,0,39
6,12,5,4,7,5,4,0,0,43
6,12,5,4,7,5,19,0,0,58
6,12,5,4,7,25,0,0,0,59
6,12,5,4,7,9,5,18,0,66
6,12,5,4,7,9,5,19,20,87
6,12,5,4,7,9,14,7,0,64
6,12,5,4,7,12,9,14,7,76
6,12,5,5,0,0,0,0,0,28
6,12,5,5,3,5,4,0,0,40
6,12,5,5,3,5,18,0,0,54
6,12,5,5,3,5,18,19,0,73
6,12,5,5,3,5,19,0,0,55
6,12,5,5,3,8,0,0,0,39
6,12,5,5,3,8,5,4,0,48
6,12,5,5,3,8,5,19,0,63
6,12,5,5,3,8,9,14,7,69
6,12,5,5,3,25,0,0,0,56
6,12,5,5,3,9,5,18,0,63
6,12,5,5,3,9,5,19,20,84
6,12,5,5,3,9,12,25,0,77
6,12,5,5,3,9,14,7,0,61
6,12,5,5,9,14,7,0,0,58
6,12,5,5,18,0,0,0,0,46
6,12,5,5,18,5,4,0,0,55
6,12,5,5,18,5,18,0,0,69
6,12,5,5,18,9,14,7,0,76
6,12,5,5,18,9,19,8,0,82
6,12,5,5,18,19,0,0,0,65
6,12,5,5,19,0,0,0,0,47
6,12,5,5,20,5,4,0,0,57
6,12,5,5,20,5,14,0,0,67
6,12,5,5,20,5,18,0,0,71
6,12,5,5,20,5,19,20,0,92
6,12,5,5,20,6,21,12,0,87
6,12,5,5,20,9,14,7,0,78
6,12,5,5,20,9,14,7,19,97
6,12,5,5,20,12,25,0,0,85
6,12,5,5,20,14,5,19,19,105
6,12,5,5,20,19,0,0,0,67
6,12,5,5,20,23,9,14,7,101
6,12,5,7,13,0,0,0,0,43
6,12,5,25,0,0,0,0,0,48
6,12,5,25,5,4,0,0,0,57
6,12,5,25,5,4,12,25,0,94
6,12,5,25,9,14,7,0,0,78
6,12,5,25,12,1,14,4,0,79
6,12,5,9,14,7,0,0,0,53
6,12,5,25,19,0,0,0,0,67
6,12,5,9,19,8,9,7,0,75
6,12,5,25,19,15,13,5,0,100
6,12,5,13,5,0,0,0,0,41
6,12,5,13,5,18,0,0,0,59
6,12,5,13,9,19,8,5,4,81
6,12,5,13,9,19,8,5,19,96
6,12,5,14,3,8,0,0,0,48
6,12,5,14,3,8,5,4,0,57
6,12,5,14,3,8,5,19,0,72
6,12,5,14,3,8,9,14,7,78
6,12,5,14,19,5,0,0,0,61
6,12,5,14,19,5,4,0,0,65
6,12,5,14,19,5,18,0,0,79
6,12,5,14,19,5,18,19,0,98
6,12,5,14,19,5,19,0,0,80
6,12,5,14,19,9,14,7,0,86
6,12,5,14,20,5,19,0,0,81
6,12,5,18,18,25,0,0,0,84
6,12,5,18,18,9,5,4,0,77
6,12,5,18,18,25,9,14,7,114
6,12,5,19,8,0,0,0,0,50
6,12,5,19,8,5,4,0,0,59
6,12,5,19,8,5,14,0,0,69
6,12,5,19,8,5,18,0,0,73
6,12,5,19,8,5,18,19,0,92
6,12,5,19,8,5,19,0,0,74
6,12,5,19,8,6,21,12,0,89
6,12,5,19,8,8,15,15,4,92
6,12,5,19,8,8,15,15,11,99
6,12,5,19,8,25,0,0,0,75
6,12,5,19,8,9,5,18,0,82
6,12,5,19,8,9,5,19,20,103
6,12,5,19,8,9,14,7,0,80
6,12,5,19,8,9,14,7,19,99
6,12,5,19,8,12,5,19,19,105
6,12,5,19,8,12,25,0,0,87
6,12,5,19,8,12,9,5,18,94
6,12,5,19,8,12,9,11,5,87
6,12,5,19,8,12,9,12,25,108
6,12,5,19,8,12,9,14,7,92
6,12,5,19,8,13,5,14,20,102
6,12,5,19,8,16,15,20,0,101
6,12,5,19,8,16,15,20,19,120
6,12,5,20,0,0,0,0,0,43
6,12,5,20,3,8,5,4,0,63
6,12,5,20,3,8,5,18,19,96
6,12,5,20,3,8,5,19,0,78
6,12,5,20,3,8,9,14,7,84
6,12,5,20,8,5,18,0,0,74
6,12,5,20,20,15,14,0,0,92
6,12,5,21,18,5,20,0,0,87
6,12,5,21,18,5,20,20,25,132
6,12,5,21,18,15,14,0,0,91
6,12,5,21,18,15,14,5,5,101
6,12,5,21,18,15,14,14,5,110
6,12,5,23,0,0,0,0,0,46
6,12,5,23,5,4,0,0,0,55
6,12,5,23,9,20,0,0,0,75
6,12,5,23,19,0,0,0,0,65
6,12,5,24,0,0,0,0,0,47
6,12,5,24,1,7,15,14,0,84
6,12,5,24,5,4,0,0,0,56
6,12,5,24,5,19,0,0,0,71
6,12,5,24,9,2,12,5,0,75
6,12,5,24,9,2,12,25,0,95
6,12,5,24,9,12,5,0,0,73
6,12,5,24,9,12,9,20,25,122
6,12,5,24,9,14,7,0,0,77
6,12,5,24,9,15,14,0,0,85
6,12,5,24,9,15,14,1,12,98
6,12,5,24,9,15,14,19,0,104
6,12,5,24,9,20,25,0,0,101
6,12,5,24,9,20,9,13,5,103
6,12,5,24,9,22,5,0,0,83
6,12,5,24,15,0,0,0,0,62
6,12,5,24,15,18,0,0,0,80
6,12,5,24,15,18,19,0,0,99
6,12,5,24,20,9,13,5,0,94
6,12,5,24,21,15,19,5,0,107
6,12,5,24,21,15,21,19,0,123
6,12,5,24,21,18,1,0,0,87
6,12,5,24,21,18,1,12,0,99
6,12,5,24,21,18,5,0,0,91
6,12,5,24,21,18,5,4,0,95
6,12,5,24,21,18,5,19,0,110
6,12,25,0,0,0,0,0,0,43
6,12,25,1,2,12,5,0,0,63
6,12,25,1,23,1,25,0,0,93
6,12,25,1,23,1,25,19,0,112
6,12,25,2,1,3,11,0,0,60
6,12,25,2,1,12,12,0,0,70
6,12,25,2,1,14,5,0,0,65
6,12,25,2,5,12,20,0,0,82
6,12,25,2,5,12,20,19,0,101
6,12,25,2,25,0,0,0,0,70
6,12,25,2,25,19,0,0,0,89
6,12,25,2,12,5,23,0,0,85
6,12,25,2,12,15,23,0,0,95
6,12,25,2,12,15,23,14,0,109
6,12,25,2,12,15,23,19,0,114
6,12,25,2,15,1,20,0,0,81
6,12,25,2,15,1,20,19,0,100
6,12,25,2,15,25,0,0,0,85
6,12,25,2,15,25,19,0,0,104
6,12,25,2,15,15,11,0,0,86
6,12,25,2,18,21,19,8,0,111
6,12,9,3,0,0,0,0,0,30
6,12,25,3,1,19,20,5,18,109
6,12,9,3,6,12,1,3,0,52
6,12,9,3,8,20,5,18,0,81
6,12,9,3,8,20,5,18,19,100
6,12,9,3,11,0,0,0,0,41
6,12,9,3,11,5,4,0,0,50
6,12,9,3,11,5,18,0,0,64
6,12,9,3,11,5,18,5,4,73
6,12,9,3,11,5,18,25,0,89
6,12,9,3,11,5,18,19,0,83
6,12,9,3,11,25,0,0,0,66
6,12,9,3,11,9,14,7,0,71
6,12,9,3,11,19,0,0,0,60
6,12,9,3,19,0,0,0,0,49
6,12,9,4,4,5,18,0,0,58
6,12,9,4,7,5,0,0,0,43
6,12,25,5,1,20,5,18,0,92
6,12,9,5,4,0,0,0,0,36
6,12,9,5,18,0,0,0,0,50
6,12,25,5,18,0,0,0,0,66
6,12,9,5,18,19,0,0,0,69
6,12,25,5,18,19,0,0,0,85
6,12,9,5,19,0,0,0,0,51
6,12,9,5,19,20,0,0,0,71
6,12,9,6,6,21,19,0,0,79
6,12,25,6,12,1,16,0,0,78
6,12,25,6,12,15,23,5,18,122
6,12,9,7,7,5,4,0,0,50
6,12,9,7,7,5,18,0,0,64
6,12,9,7,8,20,5,4,0,71
6,12,9,7,8,20,5,18,0,85
6,12,9,7,8,20,6,21,12,101
6,12,9,7,8,20,25,0,0,87
6,12,9,7,8,20,9,5,18,94
6,12,9,7,8,20,9,12,25,108
6,12,9,7,8,20,9,14,7,92
6,12,9,7,8,20,19,0,0,81
6,12,25,9,14,7,0,0,0,73
6,12,25,9,14,7,12,25,0,110
6,12,25,9,14,7,19,0,0,92
6,12,25,12,5,1,6,0,0,67
6,12,25,12,5,1,22,5,19,107
6,12,25,12,5,19,19,0,0,98
6,12,25,13,1,14,0,0,0,71
6,12,25,13,5,14,0,0,0,75
6,12,9,13,6,12,1,13,0,72
6,12,9,13,6,12,1,13,19,91
6,12,9,13,13,5,18,0,0,76
6,12,9,13,16,0,0,0,0,56
6,12,9,13,19,25,0,0,0,84
6,12,9,13,19,9,5,18,0,91
6,12,9,13,19,9,5,19,0,92
6,12,9,13,19,9,5,19,20,112
6,12,9,13,19,9,12,25,0,105
6,12,9,14,3,8,0,0,0,52
6,12,9,14,3,8,5,4,0,61
6,12,9,14,3,8,5,18,0,75
6,12,9,14,3,8,5,18,19,94
6,12,9,14,3,8,5,19,0,76
6,12,9,14,3,8,9,14,7,82
6,12,9,14,4,5,18,0,0,68
6,12,9,14,4,5,18,19,0,87
6,12,9,14,4,15,19,1,0,80
6,12,9,14,4,15,19,25,0,104
6,12,25,14,5,19,19,0,0,100
6,12,9,14,7,0,0,0,0,48
6,12,9,14,7,4,21,19,20,112
6,12,9,14,7,5,18,0,0,71
6,12,9,14,7,5,18,19,0,90
6,12,9,14,7,25,0,0,0,73
6,12,9,14,7,9,14,7,0,78
6,12,9,14,7,19,0,0,0,67
6,12,9,14,11,9,20,5,0,86
6,12,9,14,20,5,4,0,0,70
6,12,9,14,20,5,18,0,0,84
6,12,9,14,20,8,5,1,4,79
6,12,9,14,20,25,0,0,0,86
6,12,9,14,20,9,5,18,0,93
6,12,9,14,20,9,5,19,20,114
6,12,9,14,20,9,6,25,0,101
6,12,9,14,20,9,12,25,0,107
6,12,9,14,20,9,14,7,0,91
6,12,9,14,20,12,5,19,19,116
6,12,9,14,20,12,9,11,5,98
6,12,9,14,20,12,15,3,11,102
6,12,9,14,20,19,0,0,0,80
6,12,9,14,20,23,15,15,4,118
6,12,9,14,20,23,15,18,11,128
6,12,25,15,6,6,0,0,0,70
6,12,25,15,6,6,19,0,0,89
6,12,9,15,13,1,0,0,0,56
6,12,25,15,22,5,18,0,0,103
6,12,25,15,22,5,18,19,0,122
6,12,25,16,1,16,5,18,0,99
6,12,25,16,1,16,5,18,19,118
6,12,25,16,1,19,20,0,0,99
6,12,25,16,1,19,20,19,0,118
6,12,9,16,5,0,0,0,0,48
6,12,25,16,5,0,0,0,0,64
6,12,9,16,5,4,0,0,0,52
6,12,9,16,6,12,15,16,0,92
6,12,9,16,9,14,7,0,0,73
6,12,9,16,10,1,3,11,0,68
6,12,9,16,16,1,14,3,5,82
6,12,9,16,16,1,14,3,25,102
6,12,9,16,16,1,14,20,0,94
6,12,9,16,16,5,4,0,0,68
6,12,9,16,16,5,18,0,0,82
6,12,9,16,16,5,18,25,0,107
6,12,9,16,16,5,18,19,0,101
6,12,9,16,16,5,19,20,0,103
6,12,9,16,16,9,14,7,0,89
6,12,25,16,18,15,15,6,0,113
6,12,9,16,19,0,0,0,0,62
6,12,9,18,20,0,0,0,0,65
6,12,9,18,20,1,2,12,5,85
6,12,9,18,20,5,4,0,0,74
6,12,9,18,20,5,18,0,0,88
6,12,9,18,20,5,18,19,0,107
6,12,9,18,20,25,0,0,0,90
6,12,9,18,20,9,5,18,0,97
6,12,9,18,20,9,5,19,20,118
6,12,9,18,20,9,7,9,7,97
6,12,9,18,20,9,14,7,0,95
6,12,9,18,20,9,19,8,0,101
6,12,9,18,20,12,9,14,7,107
6,12,9,18,20,19,0,0,0,84
6,12,25,19,3,8,5,19,0,97
6,12,9,19,11,0,0,0,0,57
6,12,9,19,11,5,4,0,0,66
6,12,9,19,11,25,0,0,0,82
6,12,9,19,11,9,5,18,0,89
6,12,9,19,11,9,5,19,20,110
6,12,25,19,16,5,3,11,0,97
6,12,25,19,16,5,3,11,19,116
6,12,25,19,23,1,20,0,0,106
6,12,9,20,0,0,0,0,0,47
6,12,25,20,1,9,12,0,0,85
6,12,9,20,3,8,0,0,0,58
6,12,9,20,3,8,5,4,0,67
6,12,9,20,3,8,5,14,0,77
6,12,9,20,3,8,5,19,0,82
6,12,9,20,3,8,9,14,7,88
6,12,9,20,5,0,0,0,0,52
6,12,25,20,5,0,0,0,0,68
6,12,9,20,5,4,0,0,0,56
6,12,25,20,5,4,0,0,0,72
6,12,9,20,5,19,0,0,0,71
6,12,25,20,5,19,0,0,0,87
6,12,9,20,6,15,12,4,0,84
6,12,25,20,9,5,18,0,0,95
6,12,25,20,9,5,18,19,0,114
6,12,25,20,9,13,5,0,0,90
6,12,9,20,9,14,7,0,0,77
6,12,25,20,9,14,7,0,0,93
6,12,25,20,9,14,7,19,0,112
6,12,25,20,18,1,16,0,0,98
6,12,25,20,18,1,16,19,0,117
6,12,9,20,19,0,0,0,0,66
6,12,9,20,20,5,4,0,0,76
6,12,9,20,20,5,18,0,0,90
6,12,9,20,20,5,18,5,4,99
6,12,9,20,20,5,18,14,0,104
6,12,9,20,20,5,18,19,0,109
6,12,9,20,20,25,0,0,0,92
6,12,9,20,20,9,14,7,0,97
6,12,9,20,23,9,20,5,0,104
6,12,9,22,22,5,18,0,0,94
6,12,9,22,22,5,18,19,0,113
6,12,25,23,1,25,0,0,0,92
6,12,25,23,1,25,19,0,0,111
6,12,25,23,5,9,7,8,20,115
6,12,25,23,8,5,5,12,0,96
6,12,25,23,8,5,5,12,19,115
6,12,25,23,9,14,3,8,0,100
6,12,25,23,9,18,5,0,0,98
6,12,25,23,15,18,20,0,0,119
6,12,9,24,0,0,0,0,0,51
6,12,9,24,23,5,5,4,0,88
6,12,12,0,0,0,0,0,0,30
6,12,14,5,18,9,5,0,0,69
6,12,14,5,21,18,0,0,0,76
6,12,14,5,21,19,5,0,0,82
6,12,15,1,4,0,0,0,0,38
6,12,15,1,20,0,0,0,0,54
6,12,15,1,20,1,2,12,5,74
6,12,15,1,20,1,7,5,0,67
6,12,15,1,20,1,7,5,19,86
6,12,15,1,20,5,4,0,0,63
6,12,15,1,20,5,12,0,0,71
6,12,15,1,20,5,12,19,0,90
6,12,15,1,20,5,18,0,0,77
6,12,15,1,20,5,18,19,0,96
6,12,15,1,20,25,0,0,0,79
6,12,15,1,20,9,5,18,0,86
6,12,15,1,20,9,5,19,20,107
6,12,15,1,20,9,14,7,0,84
6,12,15,1,20,9,22,5,0,90
6,12,15,1,20,12,5,19,19,109
6,12,15,1,20,13,1,14,0,82
6,12,15,1,20,13,5,14,0,86
6,12,15,1,20,19,0,0,0,73
6,12,15,1,20,19,13,1,14,101
6,12,15,1,20,19,13,5,14,105
6,12,15,2,0,0,0,0,0,35
6,12,15,2,2,25,0,0,0,62
6,12,15,3,0,0,0,0,0,36
6,12,15,3,3,5,4,0,0,48
6,12,15,3,3,9,0,0,0,48
6,12,15,3,3,9,14,7,0,69
6,12,15,3,3,15,19,5,0,78
6,12,15,3,3,21,12,1,18,91
6,12,15,3,3,21,12,5,0,77
6,12,15,3,3,21,12,5,19,96
6,12,15,3,3,21,12,9,0,81
6,12,15,3,3,21,12,21,19,112
6,12,15,3,3,21,19,0,0,79
6,12,15,3,11,0,0,0,0,47
6,12,15,3,11,2,5,4,0,58
6,12,15,3,11,5,4,0,0,56
6,12,15,3,11,5,18,0,0,70
6,12,15,3,11,25,0,0,0,72
6,12,15,3,11,9,5,18,0,79
6,12,15,3,11,9,5,19,20,100
6,12,15,3,11,9,14,7,0,77
6,12,15,3,11,9,14,7,19,96
6,12,15,3,11,12,5,19,19,102
6,12,15,3,11,12,9,11,5,84
6,12,15,3,11,12,9,14,7,89
6,12,15,3,11,13,1,14,0,75
6,12,15,3,11,19,0,0,0,66
6,12,15,3,11,23,9,19,5,103
6,12,15,3,15,15,14,0,0,80
6,12,15,3,19,0,0,0,0,55
6,12,15,4,7,5,0,0,0,49
6,12,15,5,0,0,0,0,0,38
6,12,15,5,2,5,18,7,0,70
6,12,15,5,25,0,0,0,0,63
6,12,15,5,19,0,0,0,0,57
6,12,15,7,0,0,0,0,0,40
6,12,15,7,7,1,2,12,5,67
6,12,15,7,7,5,4,0,0,56
6,12,15,7,7,5,18,0,0,70
6,12,15,7,7,5,18,19,0,89
6,12,15,7,7,9,14,7,0,77
6,12,15,7,7,9,14,7,19,96
6,12,15,7,19,0,0,0,0,59
6,12,15,7,19,20,5,18,0,102
6,12,15,9,20,0,0,0,0,62
6,12,15,25,20,0,0,0,0,78
6,12,15,11,1,20,9,0,0,74
6,12,15,11,1,20,9,19,0,93
6,12,15,11,9,20,5,0,0,78
6,12,15,14,7,0,0,0,0,54
6,12,15,14,7,19,0,0,0,73
6,12,15,15,4,1,2,12,5,72
6,12,15,15,4,1,7,5,0,65
6,12,15,15,4,3,15,3,11,84
6,12,15,15,4,5,4,0,0,61
6,12,15,15,4,5,18,0,0,75
6,12,15,15,4,5,18,19,0,94
6,12,15,15,4,7,1,20,5,85
6,12,15,15,4,25,0,0,0,77
6,12,15,15,4,9,14,7,0,82
6,12,15,15,4,12,5,19,19,107
6,12,15,15,4,12,5,20,0,89
6,12,15,15,4,12,9,11,5,89
6,12,15,15,4,12,9,20,0,93
6,12,15,15,4,13,1,18,11,95
6,12,15,15,4,19,0,0,0,71
6,12,15,15,4,20,9,13,5,99
6,12,15,15,4,23,1,25,0,101
6,12,15,15,4,23,1,25,19,120
6,12,15,15,4,23,1,12,12,100
6,12,15,15,5,25,0,0,0,78
6,12,15,15,9,5,0,0,0,62
6,12,15,15,11,0,0,0,0,59
6,12,15,15,11,1,14,0,0,74
6,12,15,15,18,0,0,0,0,66
6,12,15,15,18,1,7,5,0,79
6,12,15,15,18,1,7,5,19,98
6,12,15,15,18,5,4,0,0,75
6,12,15,15,18,5,18,0,0,89
6,12,15,15,18,5,18,19,0,108
6,12,15,15,18,8,5,1,4,84
6,12,15,15,18,9,14,7,0,96
6,12,15,15,18,9,14,7,19,115
6,12,15,15,18,12,5,19,19,121
6,12,15,15,18,13,1,14,0,94
6,12,15,15,18,13,5,14,0,98
6,12,15,15,18,19,0,0,0,85
6,12,15,15,18,19,8,15,23,131
6,12,15,15,18,23,1,25,0,115
6,12,15,15,18,23,1,18,4,112
6,12,15,15,18,23,9,19,5,122
6,12,15,15,19,25,0,0,0,92
6,12,15,15,19,9,5,0,0,81
6,12,15,15,19,9,5,19,0,100
6,12,15,15,26,25,0,0,0,99
6,12,15,15,26,9,5,0,0,88
6,12,15,15,26,9,5,19,0,107
6,12,15,16,5,18,15,15,0,102
6,12,15,16,8,15,21,19,5,117
6,12,15,16,15,22,5,18,0,109
6,12,15,16,15,22,5,18,19,128
6,12,15,16,16,5,4,0,0,74
6,12,15,16,16,5,18,0,0,88
6,12,15,16,16,5,18,19,0,107
6,12,15,16,16,25,0,0,0,90
6,12,15,16,16,9,5,18,0,97
6,12,15,16,16,9,5,19,0,98
6,12,15,16,16,9,5,19,20,118
6,12,15,16,16,9,12,25,0,111
6,12,15,16,16,9,14,7,0,95
6,12,15,16,23,9,14,7,0,102
6,12,15,18,1,5,0,0,0,57
6,12,15,18,1,12,9,26,5,104
6,12,15,18,1,12,12,25,0,101
6,12,15,18,1,13,15,18,0,98
6,12,15,18,1,13,15,21,18,119
6,12,15,18,1,14,0,0,0,66
6,12,15,18,1,19,0,0,0,71
6,12,15,18,1,20,5,0,0,77
6,12,15,18,5,1,20,0,0,77
6,12,15,18,5,1,20,5,0,82
6,12,15,18,5,1,20,5,4,86
6,12,15,18,5,14,3,5,19,97
6,12,15,18,5,14,20,0,0,90
6,12,15,18,5,20,0,0,0,76
6,12,15,18,5,20,1,0,0,77
6,12,15,18,5,20,5,4,0,85
6,12,15,18,5,20,19,0,0,95
6,12,15,18,5,20,20,25,0,121
6,12,15,18,5,20,21,13,0,110
6,12,15,18,9,1,7,5,0,73
6,12,15,18,9,1,20,5,0,86
6,12,15,18,9,1,20,5,4,90
6,12,15,18,9,3,1,14,0,78
6,12,15,18,9,3,9,14,0,86
6,12,15,18,9,4,0,0,0,64
6,12,15,18,9,4,1,14,19,98
6,12,15,18,9,4,5,1,14,84
6,12,15,18,9,4,9,20,25,118
6,12,15,18,9,4,12,25,0,101
6,12,15,18,9,6,15,18,13,112
6,12,15,18,9,7,5,14,0,86
6,12,15,18,9,7,5,14,19,105
6,12,15,18,9,11,1,14,0,86
6,12,15,18,9,11,5,14,0,90
6,12,15,18,9,12,1,7,5,85
6,12,15,18,9,12,5,7,5,89
6,12,15,18,9,14,19,0,0,93
6,12,15,18,9,19,20,0,0,99
6,12,15,18,9,19,20,9,3,111
6,12,15,18,9,19,20,18,25,142
6,12,15,18,9,19,20,19,0,118
6,12,15,18,9,26,9,14,5,114
6,12,15,18,15,15,14,0,0,95
6,12,15,18,15,21,14,0,0,101
6,12,15,18,15,21,19,0,0,106
6,12,15,18,21,9,20,0,0,101
6,12,15,18,21,9,20,19,0,120
6,12,15,18,21,12,1,0,0,85
6,12,15,18,21,12,1,5,0,90
6,12,15,18,21,12,1,19,0,104
6,12,15,18,21,12,5,14,20,123
6,12,15,19,3,21,12,1,18,107
6,12,15,19,3,21,12,5,0,93
6,12,15,19,3,21,12,5,20,113
6,12,15,19,8,0,0,0,0,60
6,12,15,19,19,1,0,0,0,72
6,12,15,19,19,5,4,0,0,80
6,12,15,19,19,5,19,0,0,95
6,12,15,19,19,9,5,18,0,103
6,12,15,19,19,9,5,19,0,104
6,12,15,19,19,9,5,19,20,124
6,12,15,19,19,9,12,25,0,117
6,12,15,19,19,9,14,7,0,101
6,12,15,20,0,0,0,0,0,53
6,12,15,20,1,0,0,0,0,54
6,12,15,20,1,7,5,0,0,66
6,12,15,20,1,7,5,19,0,85
6,12,15,20,1,14,20,0,0,88
6,12,15,20,1,19,0,0,0,73
6,12,15,20,1,20,9,15,14,112
6,12,15,20,1,20,9,22,5,110
6,12,15,20,5,0,0,0,0,58
6,12,15,20,5,18,0,0,0,76
6,12,15,20,9,12,12,1,0,87
6,12,15,20,9,12,12,1,19,106
6,12,15,20,15,18,9,1,12,108
6,12,15,20,19,0,0,0,0,72
6,12,15,20,19,1,13,0,0,86
6,12,15,20,19,1,13,19,0,105
6,12,15,20,19,1,14,0,0,87
6,12,15,20,19,5,14,0,0,91
6,12,15,20,19,15,14,0,0,101
6,12,15,20,20,5,14,0,0,92
6,12,15,20,20,5,18,0,0,96
6,12,15,21,14,3,5,0,0,76
6,12,15,21,14,3,5,4,0,80
6,12,15,21,14,3,5,25,0,101
6,12,15,21,14,3,5,19,0,95
6,12,15,21,14,3,25,0,0,96
6,12,15,21,14,3,9,5,18,103
6,12,15,21,14,3,9,14,7,101
6,12,15,21,14,4,5,18,0,95
6,12,15,21,14,4,5,18,19,114
6,12,15,21,18,0,0,0,0,72
6,12,15,21,18,5,4,0,0,81
6,12,15,21,18,25,0,0,0,97
6,12,15,21,18,9,14,7,0,102
6,12,15,21,18,9,19,8,0,108
6,12,15,21,18,9,19,8,25,133
6,12,15,21,18,12,5,19,19,127
6,12,15,21,18,12,9,11,5,109
6,12,15,21,18,19,0,0,0,91
6,12,15,21,19,5,0,0,0,78
6,12,15,21,19,8,0,0,0,81
6,12,15,21,20,0,0,0,0,74
6,12,15,21,20,5,4,0,0,83
6,12,15,21,20,5,18,0,0,97
6,12,15,21,20,5,18,19,0,116
6,12,15,21,20,9,14,7,0,104
6,12,15,21,20,19,0,0,0,93
6,12,15,23,0,0,0,0,0,56
6,12,15,23,1,2,12,5,0,76
6,12,15,23,1,7,5,0,0,69
6,12,15,23,1,7,5,19,0,88
6,12,15,23,3,8,1,18,20,106
6,12,15,23,5,0,0,0,0,61
6,12,15,23,5,4,0,0,0,65
6,12,15,23,5,18,1,7,5,92
6,12,15,23,5,18,2,5,4,90
6,12,15,23,5,18,5,4,0,88
6,12,15,23,5,18,5,18,0,102
6,12,15,23,5,18,5,18,19,121
6,12,15,23,5,18,5,20,0,104
6,12,15,23,5,18,5,20,19,123
6,12,15,23,5,18,6,12,25,122
6,12,15,23,5,18,6,21,12,118
6,12,15,23,5,18,25,0,0,104
6,12,15,23,5,18,9,5,18,111
6,12,15,23,5,18,9,12,25,125
6,12,15,23,5,18,9,14,7,109
6,12,15,23,5,18,9,19,20,127
6,12,15,23,5,18,12,5,20,116
6,12,15,23,5,18,16,15,20,130
6,12,15,23,9,14,7,0,0,86
6,12,15,23,9,14,7,12,25,123
6,12,15,23,11,0,0,0,0,67
6,12,15,23,13,5,20,5,18,117
6,12,15,23,14,0,0,0,0,70
6,12,15,23,15,6,6,0,0,83
6,12,15,23,19,0,0,0,0,75
6,12,15,23,19,8,5,5,20,113
6,12,15,23,19,20,15,14,5,129
6,12,18,9,5,0,0,0,0,50
6,12,21,0,0,0,0,0,0,39
6,12,21,1,20,5,0,0,0,65
6,12,21,1,22,9,12,0,0,83
6,12,21,1,22,9,12,5,0,88
6,12,21,2,0,0,0,0,0,41
6,12,21,2,2,5,4,0,0,52
6,12,21,2,2,5,18,0,0,66
6,12,21,2,2,5,18,19,0,85
6,12,21,2,2,9,14,7,0,73
6,12,21,2,4,21,2,0,0,68
6,12,21,2,4,21,2,19,0,87
6,12,21,2,19,0,0,0,0,60
6,12,21,3,1,14,0,0,0,57
6,12,21,3,20,21,1,14,20,118
6,12,21,3,20,21,1,20,5,109
6,12,21,3,20,21,15,21,19,138
6,12,21,5,0,0,0,0,0,44
6,12,21,5,4,0,0,0,0,48
6,12,21,5,25,0,0,0,0,69
6,12,21,5,12,5,19,19,0,99
6,12,21,5,12,12,5,14,0,87
6,12,21,5,12,12,9,14,0,91
6,12,21,5,12,12,9,20,5,102
6,12,21,5,13,1,14,0,0,72
6,12,21,5,13,5,14,0,0,76
6,12,21,5,14,3,5,0,0,66
6,12,21,5,14,3,25,0,0,86
6,12,21,5,14,3,9,5,19,94
6,12,21,5,14,20,0,0,0,78
6,12,21,5,14,20,12,25,0,115
6,12,21,5,18,0,0,0,0,62
6,12,21,5,18,9,3,0,0,74
6,12,21,5,18,9,3,19,0,93
6,12,21,5,19,0,0,0,0,63
6,12,21,5,23,15,18,11,0,111
6,12,21,6,6,0,0,0,0,51
6,12,21,6,6,5,4,0,0,60
6,12,21,6,6,5,18,0,0,74
6,12,21,6,6,25,0,0,0,76
6,12,21,6,6,9,5,18,0,83
6,12,21,6,6,9,5,19,20,104
6,12,21,6,6,9,12,25,0,97
6,12,21,6,6,9,14,7,0,81
6,12,21,6,6,19,0,0,0,70
6,12,21,7,5,12,0,0,0,63
6,12,21,7,5,12,13,1,14,91
6,12,21,7,5,12,13,5,14,95
6,12,21,9,2,12,5,0,0,67
6,12,21,9,4,0,0,0,0,52
6,12,21,9,4,1,12,0,0,65
6,12,21,9,4,1,12,12,25,102
6,12,21,9,4,9,2,12,5,80
6,12,21,9,4,9,3,0,0,64
6,12,21,9,4,9,3,19,0,83
6,12,21,9,4,9,6,25,0,92
6,12,21,9,4,9,19,5,0,85
6,12,21,9,4,9,19,5,4,89
6,12,21,9,4,9,19,5,18,103
6,12,21,9,4,9,19,5,19,104
6,12,21,9,4,9,19,13,0,93
6,12,21,9,4,9,19,20,0,100
6,12,21,9,4,9,20,25,0,106
6,12,21,9,4,9,26,5,0,92
6,12,21,9,4,9,26,5,4,96
6,12,21,9,4,9,26,5,18,110
6,12,21,9,4,9,26,5,19,111
6,12,21,9,4,12,25,0,0,89
6,12,21,9,4,14,5,19,19,109
6,12,21,9,4,18,1,13,0,84
6,12,21,9,4,18,1,13,19,103
6,12,21,9,4,19,0,0,0,71
6,12,21,9,7,18,1,13,0,87
6,12,21,9,14,7,0,0,0,69
6,12,21,25,20,0,0,0,0,84
6,12,21,9,20,1,14,20,0,103
6,12,21,25,20,19,0,0,0,103
6,12,21,11,5,0,0,0,0,55
6,12,21,11,5,4,0,0,0,59
6,12,21,11,5,25,0,0,0,80
6,12,21,11,5,12,5,19,19,110
6,12,21,11,5,19,0,0,0,74
6,12,21,11,5,23,15,18,13,124
6,12,21,11,5,23,15,18,20,131
6,12,21,11,25,0,0,0,0,75
6,12,21,11,9,5,18,0,0,82
6,12,21,11,9,5,19,20,0,103
6,12,21,11,9,12,25,0,0,96
6,12,21,11,9,14,5,19,19,116
6,12,21,11,9,14,7,0,0,80
6,12,21,13,5,0,0,0,0,57
6,12,21,13,5,4,0,0,0,61
6,12,21,13,5,18,9,14,0,98
6,12,21,13,5,19,0,0,0,76
6,12,21,13,9,14,7,0,0,82
6,12,21,13,9,14,15,19,5,114
6,12,21,13,9,14,15,21,19,130
6,12,21,13,13,5,18,0,0,88
6,12,21,13,13,5,18,25,0,113
6,12,21,13,13,15,24,0,0,104
6,12,21,13,13,15,24,5,4,113
6,12,21,13,13,15,24,5,19,128
6,12,21,13,16,0,0,0,0,68
6,12,21,13,16,5,4,0,0,77
6,12,21,13,16,9,14,7,0,98
6,12,21,13,16,19,0,0,0,87
6,12,21,14,7,0,0,0,0,60
6,12,21,14,11,0,0,0,0,64
6,12,21,14,11,5,4,0,0,73
6,12,21,14,11,5,25,0,0,94
6,12,21,14,11,5,25,19,0,113
6,12,21,14,11,5,18,0,0,87
6,12,21,14,11,5,18,19,0,106
6,12,21,14,11,25,0,0,0,89
6,12,21,14,11,25,4,15,13,121
6,12,21,14,11,9,5,19,0,97
6,12,21,14,11,25,9,19,8,125
6,12,21,14,11,25,9,19,13,130
6,12,21,14,11,25,9,20,5,123
6,12,21,14,11,25,9,26,5,129
6,12,21,14,11,9,14,7,0,94
6,12,21,14,11,19,0,0,0,83
6,12,21,15,2,15,18,9,3,101
6,12,21,15,2,15,18,9,4,102
6,12,21,15,18,0,0,0,0,72
6,12,21,15,18,1,14,0,0,87
6,12,21,15,18,1,14,5,0,92
6,12,21,15,18,1,20,5,0,98
6,12,21,15,18,1,20,5,4,102
6,12,21,15,18,5,14,5,0,96
6,12,21,15,18,5,14,5,19,115
6,12,21,15,18,5,14,25,12,128
6,12,21,15,18,5,19,3,5,104
6,12,21,15,18,9,3,0,0,84
6,12,21,15,18,9,4,0,0,85
6,12,21,15,18,9,4,5,0,90
6,12,21,15,18,9,4,5,19,109
6,12,21,15,18,9,4,19,0,104
6,12,21,15,18,25,12,0,0,109
6,12,21,15,18,9,14,0,0,95
6,12,21,15,18,9,14,5,0,100
6,12,21,15,18,9,14,5,19,119
6,12,21,15,18,9,14,19,0,114
6,12,21,15,18,9,20,5,0,106
6,12,21,15,18,9,20,5,19,125
6,12,21,15,18,15,7,5,14,113
6,12,21,15,18,15,9,4,0,100
6,12,21,15,18,15,19,9,19,134
6,12,21,15,18,15,20,9,3,119
6,12,21,15,18,19,0,0,0,91
6,12,21,15,18,19,16,1,18,126
6,12,21,18,14,0,0,0,0,71
6,12,21,18,18,0,0,0,0,75
6,12,21,18,18,25,0,0,0,100
6,12,21,18,18,9,5,4,0,93
6,12,21,18,18,9,5,19,0,108
6,12,21,18,18,25,9,14,7,130
6,12,21,18,20,0,0,0,0,77
6,12,21,19,0,0,0,0,0,58
6,12,21,19,8,0,0,0,0,66
6,12,21,19,8,1,2,12,5,86
6,12,21,19,8,5,4,0,0,75
6,12,21,19,8,5,18,0,0,89
6,12,21,19,8,5,18,19,0,108
6,12,21,19,8,5,19,0,0,90
6,12,21,19,8,5,19,20,0,110
6,12,21,19,8,7,1,20,5,99
6,12,21,19,8,25,0,0,0,91
6,12,21,19,8,14,5,19,19,123
6,12,21,19,11,0,0,0,0,69
6,12,21,19,11,5,18,0,0,92
6,12,21,19,20,5,18,0,0,101
6,12,21,19,20,5,18,5,4,110
6,12,21,19,20,5,18,5,18,124
6,12,21,19,20,5,18,25,0,126
6,12,21,19,20,5,18,19,0,120
6,12,21,19,20,18,1,20,5,122
6,12,21,19,20,18,9,14,5,124
6,12,21,19,20,18,15,9,4,124
6,12,21,19,20,18,21,13,0,130
6,12,21,20,5,0,0,0,0,64
6,12,21,20,5,2,9,18,4,97
6,12,21,20,5,4,0,0,0,68
6,12,21,20,5,25,0,0,0,89
6,12,21,20,5,12,9,11,5,101
6,12,21,20,5,18,0,0,0,82
6,12,21,20,5,18,19,0,0,101
6,12,21,20,5,19,0,0,0,83
6,12,21,20,5,23,15,18,11,131
6,12,21,20,8,5,18,0,0,90
6,12,21,20,25,0,0,0,0,84
6,12,21,20,9,5,18,0,0,91
6,12,21,20,9,5,19,20,0,112
6,12,21,20,9,14,1,0,0,83
6,12,21,20,9,14,7,0,0,89
6,12,21,20,9,14,7,19,0,108
6,12,21,20,9,19,20,0,0,107
6,12,21,20,9,19,20,19,0,126
6,12,21,20,20,5,18,0,0,102
6,12,21,20,20,5,18,5,4,111
6,12,21,20,20,5,18,5,18,125
6,12,21,20,20,5,18,25,0,127
6,12,21,20,20,5,18,19,0,121
6,12,21,22,9,1,12,0,0,83
6,12,21,22,9,1,20,9,3,103
6,12,21,22,9,15,0,0,0,85
6,12,21,22,9,15,19,5,0,109
6,12,21,22,9,15,21,19,0,125
6,12,21,24,0,0,0,0,0,63
6,12,21,24,1,20,9,15,14,122
6,12,21,24,5,4,0,0,0,72
6,12,21,24,5,18,0,0,0,86
6,12,21,24,5,19,0,0,0,87
6,12,21,24,7,18,1,16,8,113
6,12,21,24,9,2,12,5,0,91
6,12,21,24,9,2,12,25,0,111
6,12,21,24,9,12,5,0,0,89
6,12,21,24,9,12,9,20,25,138
6,12,21,24,9,14,7,0,0,93
6,12,21,24,9,15,14,0,0,101
6,12,21,24,9,15,14,1,12,114
6,12,21,24,9,15,14,19,0,120
6,12,21,24,9,22,5,0,0,99
6,12,21,24,13,5,20,5,18,124
6,12,21,24,18,15,15,20,0,131
6,12,21,24,21,18,5,0,0,107
6,12,21,24,23,5,5,4,0,100
6,13,20,0,0,0,0,0,0,39
6,14,5,19,5,0,0,0,0,49
6,15,2,2,5,4,0,0,0,34
6,15,2,2,9,14,7,0,0,55
6,15,2,19,0,0,0,0,0,42
6,15,3,1,12,0,0,0,0,37
6,15,3,1,12,9,19,5,0,70
6,15,3,1,12,9,19,5,4,74
6,15,3,1,12,9,19,5,19,89
6,15,3,1,12,9,26,5,0,77
6,15,3,1,12,9,26,5,4,81
6,15,3,1,12,9,26,5,19,96
6,15,3,1,12,12,25,0,0,74
6,15,3,1,12,15,9,4,0,65
6,15,3,9,0,0,0,0,0,33
6,15,3,9,13,5,20,5,18,94
6,15,3,9,13,5,20,18,25,114
6,15,3,11,12,5,0,0,0,52
6,15,3,15,9,4,19,0,0,71
6,15,3,15,13,5,20,5,18,100
6,15,3,15,13,5,20,18,25,120
6,15,3,19,12,5,0,0,0,60
6,15,3,21,19,0,0,0,0,64
6,15,3,21,19,1,2,12,5,84
6,15,3,21,19,5,4,0,0,73
6,15,3,21,19,5,18,0,0,87
6,15,3,21,19,5,18,19,0,106
6,15,3,21,19,5,19,0,0,88
6,15,3,21,19,9,14,7,0,94
6,15,3,21,19,12,5,19,19,119
6,15,3,21,19,19,5,4,0,92
6,15,3,21,19,19,5,19,0,107
6,15,3,21,19,19,9,14,7,113
6,15,4,0,0,0,0,0,0,25
6,15,4,4,1,0,0,0,0,30
6,15,4,4,5,18,0,0,0,52
6,15,4,4,5,18,5,4,0,61
6,15,4,4,5,18,5,18,0,75
6,15,4,4,5,18,9,14,7,82
6,15,4,4,5,18,19,0,0,71
6,15,4,5,18,0,0,0,0,48
6,15,4,7,5,0,0,0,0,37
6,15,4,7,5,12,0,0,0,49
6,15,4,9,5,14,20,0,0,73
6,15,5,4,5,18,1,12,0,66
6,15,5,4,5,18,1,20,9,83
6,15,5,4,5,18,9,19,0,81
6,15,5,6,6,13,5,14,20,90
6,15,5,8,14,0,0,0,0,48
6,15,5,8,14,12,9,11,5,85
6,15,5,8,14,19,0,0,0,67
6,15,5,9,19,8,0,0,0,62
6,15,5,12,5,19,19,0,0,81
6,15,5,12,9,11,5,0,0,63
6,15,5,13,1,14,0,0,0,54
6,15,5,13,5,14,0,0,0,58
6,15,5,19,0,0,0,0,0,45
6,15,5,19,8,9,16,0,0,78
6,15,5,20,1,12,0,0,0,59
6,15,5,20,1,12,9,19,13,100
6,15,5,20,1,20,9,15,14,105
6,15,5,20,9,0,0,0,0,55
6,15,5,20,9,3,9,4,5,76
6,15,5,20,9,4,0,0,0,59
6,15,5,20,15,18,0,0,0,79
6,15,5,20,15,18,19,0,0,98
6,15,5,20,21,18,5,0,0,90
6,15,5,20,21,19,0,0,0,86
6,15,5,20,21,19,5,19,0,110
6,15,6,1,18,18,1,23,0,88
6,15,7,0,0,0,0,0,0,28
6,15,7,1,19,0,0,0,0,48
6,15,7,2,1,14,11,0,0,56
6,15,7,2,15,21,14,4,0,84
6,15,7,2,15,23,0,0,0,68
6,15,7,2,15,23,19,0,0,87
6,15,7,4,15,7,0,0,0,54
6,15,7,4,15,7,19,0,0,73
6,15,7,4,15,13,0,0,0,60
6,15,7,5,0,0,0,0,0,33
6,15,7,5,1,20,5,18,0,77
6,15,7,5,25,0,0,0,0,58
6,15,7,5,25,19,0,0,0,77
6,15,7,6,18,21,9,20,0,102
6,15,7,6,18,21,9,20,19,121
6,15,7,7,1,7,5,0,0,48
6,15,7,7,1,7,5,19,0,67
6,15,7,7,1,18,1,0,0,55
6,15,7,7,5,4,0,0,0,44
6,15,7,7,5,18,0,0,0,58
6,15,7,7,5,18,19,0,0,77
6,15,7,7,25,0,0,0,0,60
6,15,7,7,9,5,18,0,0,67
6,15,7,7,9,5,19,20,0,88
6,15,7,7,9,12,25,0,0,81
6,15,7,7,9,14,5,19,19,101
6,15,7,7,9,14,7,0,0,65
6,15,7,7,9,19,8,0,0,71
6,15,7,8,15,18,14,0,0,83
6,15,7,8,15,18,14,19,0,102
6,15,7,25,0,0,0,0,0,53
6,15,7,25,4,15,13,0,0,85
6,15,7,9,5,0,0,0,0,42
6,15,7,9,5,19,0,0,0,61
6,15,7,25,9,19,8,0,0,89
6,15,7,25,9,19,13,0,0,94
6,15,7,25,9,19,13,19,0,113
6,15,7,12,5,0,0,0,0,45
6,15,7,12,5,19,19,0,0,83
6,15,7,12,9,5,20,20,15,109
6,15,7,13,1,14,0,0,0,56
6,15,7,13,5,14,0,0,0,60
6,15,7,15,0,0,0,0,0,43
6,15,7,15,14,0,0,0,0,57
6,15,7,15,21,0,0,0,0,64
6,15,7,16,18,15,15,6,0,98
6,15,7,18,1,13,0,0,0,60
6,15,7,18,1,13,9,20,5,94
6,15,7,18,1,13,9,20,25,114
6,15,7,18,21,13,0,0,0,80
6,15,7,19,0,0,0,0,0,47
6,15,7,21,19,0,0,0,0,68
6,15,8,0,0,0,0,0,0,29
6,15,8,1,20,0,0,0,0,50
6,15,8,14,0,0,0,0,0,43
6,15,8,14,19,0,0,0,0,62
6,15,25,1,9,20,5,0,0,81
6,15,25,1,9,20,9,3,0,88
6,15,9,2,12,5,0,0,0,49
6,15,9,2,12,5,19,0,0,68
6,15,9,2,12,5,19,19,5,92
6,15,25,2,15,1,20,0,0,84
6,15,25,5,18,0,0,0,0,69
6,15,25,5,18,19,0,0,0,88
6,15,9,12,0,0,0,0,0,42
6,15,9,12,1,2,12,5,0,62
6,15,9,12,5,4,0,0,0,51
6,15,9,12,5,18,0,0,0,65
6,15,9,12,9,14,7,0,0,72
6,15,9,12,19,0,0,0,0,61
6,15,9,12,19,13,1,14,0,89
6,15,9,12,19,13,5,14,0,93
6,15,9,14,0,0,0,0,0,44
6,15,9,14,5,4,0,0,0,53
6,15,9,14,9,14,7,0,0,74
6,15,9,14,9,14,7,12,25,111
6,15,9,14,19,0,0,0,0,63
6,15,25,19,0,0,0,0,0,65
6,15,25,19,5,14,0,0,0,84
6,15,9,19,15,14,0,0,0,78
6,15,9,19,15,14,19,0,0,97
6,15,9,19,20,5,4,0,0,78
6,15,9,19,20,5,18,0,0,92
6,15,9,19,20,25,0,0,0,94
6,15,9,19,20,9,14,7,0,99
6,15,9,19,20,19,0,0,0,88
6,15,9,20,5,18,0,0,0,73
6,15,12,0,0,0,0,0,0,33
6,15,12,1,3,9,14,0,0,60
6,15,12,1,3,9,14,19,0,79
6,15,12,1,20,5,0,0,0,59
6,15,12,1,20,5,19,0,0,78
6,15,12,3,7,5,13,15,20,96
6,15,12,4,0,0,0,0,0,37
6,15,12,4,1,2,12,5,0,57
6,15,12,4,1,7,5,0,0,50
6,15,12,4,1,23,1,25,0,87
6,15,12,4,2,15,1,20,0,75
6,15,12,4,2,15,1,20,19,94
6,15,12,4,5,4,0,0,0,46
6,15,12,4,5,4,12,25,0,83
6,15,12,4,5,14,0,0,0,56
6,15,12,4,5,18,0,0,0,60
6,15,12,4,5,18,15,12,0,87
6,15,12,4,5,18,15,12,19,106
6,15,12,4,5,18,19,0,0,79
6,15,12,4,25,0,0,0,0,62
6,15,12,4,9,14,7,0,0,67
6,15,12,4,12,5,19,19,0,92
6,15,12,4,15,21,20,0,0,93
6,15,12,4,15,21,20,19,0,112
6,15,12,4,19,0,0,0,0,56
6,15,12,4,19,11,9,18,20,114
6,15,12,4,19,20,15,15,12,118
6,15,12,4,21,18,5,0,0,81
6,15,12,4,23,1,18,4,19,102
6,15,12,5,0,0,0,0,0,38
6,15,12,5,25,5,0,0,0,68
6,15,12,7,5,18,9,20,5,97
6,15,12,9,1,0,0,0,0,43
6,15,12,9,1,7,5,0,0,55
6,15,12,9,1,7,5,4,0,59
6,15,12,9,1,7,5,19,0,74
6,15,12,9,1,7,9,14,7,80
6,15,12,9,1,12,0,0,0,55
6,15,12,9,1,18,0,0,0,61
6,15,12,9,1,18,25,0,0,86
6,15,12,9,1,20,5,0,0,68
6,15,12,9,1,20,5,4,0,72
6,15,12,9,1,20,5,19,0,87
6,15,12,9,1,20,9,14,7,93
6,15,12,9,1,20,9,15,14,101
6,15,12,9,1,20,15,18,0,96
6,15,12,9,1,20,21,18,5,107
6,15,12,9,3,0,0,0,0,45
6,15,12,9,5,0,0,0,0,47
6,15,12,9,5,19,0,0,0,66
6,15,12,9,9,6,15,18,13,103
6,15,12,9,12,25,0,0,0,79
6,15,12,9,15,0,0,0,0,57
6,15,12,9,15,5,4,0,0,66
6,15,12,9,15,9,14,7,0,87
6,15,12,9,15,12,1,20,5,95
6,15,12,9,15,12,5,0,0,74
6,15,12,9,15,12,15,19,5,108
6,15,12,9,15,19,0,0,0,76
6,15,12,9,15,19,5,0,0,81
6,15,12,9,15,19,9,20,25,130
6,15,12,9,15,20,0,0,0,77
6,15,12,9,15,21,19,0,0,97
6,15,12,9,15,21,19,12,25,134
6,15,12,9,21,13,0,0,0,76
6,15,12,9,21,13,19,0,0,95
6,15,12,11,0,0,0,0,0,44
6,15,12,11,2,15,1,20,0,82
6,15,12,11,3,18,1,6,20,92
6,15,12,11,6,18,5,5,0,78
6,15,12,11,25,0,0,0,0,69
6,15,12,11,9,5,0,0,0,58
6,15,12,11,9,5,19,0,0,77
6,15,12,11,9,19,8,0,0,80
6,15,12,11,12,1,14,4,0,75
6,15,12,11,12,9,11,5,0,81
6,15,12,11,12,15,18,5,0,94
6,15,12,11,12,15,18,5,19,113
6,15,12,11,12,15,18,9,3,101
6,15,12,11,13,15,15,20,0,107
6,15,12,11,13,15,15,20,19,126
6,15,12,11,13,15,20,0,0,92
6,15,12,11,13,15,20,5,0,97
6,15,12,11,13,15,20,5,18,115
6,15,12,11,13,15,20,5,19,116
6,15,12,11,13,15,20,19,0,111
6,15,12,11,18,9,7,8,20,106
6,15,12,11,19,0,0,0,0,63
6,15,12,11,19,1,25,0,0,89
6,15,12,11,19,5,25,0,0,93
6,15,12,11,19,25,0,0,0,88
6,15,12,11,19,9,5,18,0,95
6,15,12,11,19,9,5,19,20,116
6,15,12,11,19,9,12,25,0,109
6,15,12,11,19,15,14,7,0,99
6,15,12,11,19,15,14,7,19,118
6,15,12,11,20,1,12,5,0,82
6,15,12,11,20,1,12,5,19,101
6,15,12,11,23,1,25,0,0,93
6,15,12,11,23,1,25,19,0,112
6,15,12,12,0,0,0,0,0,45
6,15,12,12,5,18,0,0,0,68
6,15,12,12,5,19,0,0,0,69
6,15,12,12,5,20,1,7,5,83
6,15,12,12,5,20,20,9,0,99
6,15,12,12,5,20,20,15,0,105
6,15,12,12,9,3,12,5,0,74
6,15,12,12,9,3,12,5,19,93
6,15,12,12,9,3,21,12,5,95
6,15,12,12,9,5,4,0,0,63
6,15,12,12,25,5,18,0,0,93
6,15,12,12,9,5,19,0,0,78
6,15,12,12,9,6,21,12,0,93
6,15,12,12,25,9,14,7,0,100
6,15,12,12,9,12,25,0,0,91
6,15,12,12,9,19,0,0,0,73
6,15,12,12,15,23,0,0,0,83
6,15,12,12,15,23,5,4,0,92
6,15,12,12,15,23,5,18,0,106
6,15,12,12,15,23,5,18,19,125
6,15,12,12,15,23,5,20,8,116
6,15,12,12,15,23,9,14,7,113
6,15,12,12,15,23,19,0,0,102
6,15,12,12,15,23,21,16,0,120
6,15,13,5,14,20,0,0,0,73
6,15,13,5,14,20,5,4,0,82
6,15,13,5,14,20,5,18,0,96
6,15,13,5,14,20,5,18,19,115
6,15,13,5,14,20,9,14,7,103
6,15,13,5,14,20,15,0,0,88
6,15,13,5,14,20,19,0,0,92
6,15,13,5,19,0,0,0,0,58
6,15,13,9,20,5,0,0,0,68
6,15,13,9,20,5,19,0,0,87
6,15,14,4,0,0,0,0,0,39
6,15,14,4,1,3,15,0,0,58
6,15,14,4,1,11,0,0,0,51
6,15,14,4,1,14,20,0,0,74
6,15,14,4,1,14,20,19,0,93
6,15,14,4,1,20,5,21,18,104
6,15,14,4,5,4,0,0,0,48
6,15,14,4,5,18,0,0,0,62
6,15,14,4,5,19,20,0,0,83
6,15,14,4,9,14,7,0,0,69
6,15,14,4,9,19,8,0,0,75
6,15,14,4,12,5,0,0,0,56
6,15,14,4,12,5,4,0,0,60
6,15,14,4,12,5,18,0,0,74
6,15,14,4,12,5,18,19,0,93
6,15,14,4,12,5,19,0,0,75
6,15,14,4,12,25,0,0,0,76
6,15,14,4,12,9,11,5,0,76
6,15,14,4,12,9,14,7,0,81
6,15,14,4,12,9,14,7,19,100
6,15,14,4,14,5,19,19,0,96
6,15,14,4,15,14,0,0,0,68
6,15,14,4,19,0,0,0,0,58
6,15,14,4,21,0,0,0,0,60
6,15,14,4,21,5,0,0,0,65
6,15,14,4,21,5,19,0,0,84
6,15,14,4,21,11,0,0,0,71
6,15,14,4,21,19,0,0,0,79
6,15,14,5,0,0,0,0,0,40
6,15,14,12,25,0,0,0,0,72
6,15,14,14,9,19,8,0,0,85
6,15,14,15,0,0,0,0,0,50
6,15,14,20,0,0,0,0,0,55
6,15,14,20,1,12,0,0,0,68
6,15,14,20,1,12,12,25,0,105
6,15,14,20,1,14,5,12,0,87
6,15,14,20,1,14,5,12,19,106
6,15,14,20,1,14,7,5,0,82
6,15,14,20,1,14,7,5,19,101
6,15,14,20,5,4,0,0,0,64
6,15,14,20,6,21,12,0,0,94
6,15,14,20,9,14,1,12,0,91
6,15,14,20,9,14,1,19,0,98
6,15,14,20,12,5,20,0,0,92
6,15,14,20,19,0,0,0,0,74
6,15,15,0,0,0,0,0,0,36
6,15,15,4,0,0,0,0,0,40
6,15,15,4,5,18,0,0,0,63
6,15,15,4,6,21,12,0,0,79
6,15,15,4,25,0,0,0,0,65
6,15,15,4,9,5,0,0,0,54
6,15,15,4,9,5,19,0,0,73
6,15,15,4,12,5,19,19,0,95
6,15,15,4,19,0,0,0,0,59
6,15,15,4,19,20,21,6,6,112
6,15,15,6,1,18,1,23,0,85
6,15,15,6,1,18,1,23,19,104
6,15,15,25,15,21,14,7,0,118
6,15,15,25,21,14,7,0,0,103
6,15,15,12,0,0,0,0,0,48
6,15,15,12,1,2,12,5,0,68
6,15,15,12,4,15,13,0,0,80
6,15,15,12,5,4,0,0,0,57
6,15,15,12,5,18,0,0,0,71
6,15,15,12,5,18,25,0,0,96
6,15,15,12,5,18,9,5,19,104
6,15,15,12,5,19,19,0,0,91
6,15,15,12,6,9,19,8,0,90
6,15,15,12,8,1,18,4,25,104
6,15,15,12,8,5,1,4,0,66
6,15,15,12,9,6,25,0,0,88
6,15,15,12,9,14,7,0,0,78
6,15,15,12,9,19,8,0,0,84
6,15,15,12,9,19,8,5,18,107
6,15,15,12,9,19,8,12,25,121
6,15,15,12,12,9,11,5,0,85
6,15,15,12,16,18,15,15,6,118
6,15,15,12,19,0,0,0,0,67
6,15,15,12,19,3,1,16,0,87
6,15,15,12,19,3,1,16,19,106
6,15,15,12,19,8,9,16,0,100
6,15,15,14,5,18,0,0,0,73
6,15,15,19,20,5,18,0,0,98
6,15,15,19,20,5,18,5,18,121
6,15,15,20,1,7,5,0,0,69
6,15,15,20,1,7,5,19,0,88
6,15,15,20,2,1,3,11,0,73
6,15,15,20,2,1,12,12,0,83
6,15,15,20,2,1,12,12,19,102
6,15,15,20,2,1,14,4,0,77
6,15,15,20,2,1,20,8,0,87
6,15,15,20,2,1,20,8,19,106
6,15,15,20,2,5,1,20,0,84
6,15,15,20,2,15,1,18,4,96
6,15,15,20,2,15,25,0,0,98
6,15,15,20,2,15,25,19,0,117
6,15,15,20,3,12,15,20,8,114
6,15,15,20,5,4,0,0,0,65
6,15,15,20,5,9,20,5,0,95
6,15,15,20,5,18,0,0,0,79
6,15,15,20,5,18,19,0,0,98
6,15,15,20,6,1,12,12,0,87
6,15,15,20,6,1,12,12,19,106
6,15,15,20,6,1,18,5,18,104
6,15,15,20,6,1,21,12,20,116
6,15,15,20,6,5,5,4,0,76
6,15,15,20,6,15,12,11,0,100
6,15,15,20,6,21,12,0,0,95
6,15,15,20,7,5,1,18,0,87
6,15,15,20,7,5,1,18,19,106
6,15,15,20,7,5,12,4,0,84
6,15,15,20,7,12,15,22,5,117
6,15,15,20,7,18,9,16,0,106
6,15,15,20,8,1,12,20,0,97
6,15,15,20,8,9,12,0,0,85
6,15,15,20,8,9,12,12,0,97
6,15,15,20,8,9,12,12,19,116
6,15,15,20,8,9,12,19,0,104
6,15,15,20,8,15,12,4,0,95
6,15,15,20,8,15,12,4,19,114
6,15,15,20,8,15,15,11,0,105
6,15,15,20,8,15,20,0,0,99
6,15,15,20,25,0,0,0,0,81
6,15,15,20,9,5,0,0,0,70
6,15,15,20,9,5,18,0,0,88
6,15,15,20,9,5,19,0,0,89
6,15,15,20,9,5,19,20,0,109
6,15,15,20,9,14,7,0,0,86
6,15,15,20,9,14,7,12,25,123
6,15,15,20,9,14,7,19,0,105
6,15,15,20,12,5,0,0,0,73
6,15,15,20,12,5,4,0,0,77
6,15,15,20,12,5,18,0,0,91
6,15,15,20,12,5,18,19,0,110
6,15,15,20,12,5,19,0,0,92
6,15,15,20,12,5,19,19,0,111
6,15,15,20,12,9,7,8,20,112
6,15,15,20,12,9,11,5,0,93
6,15,15,20,12,9,14,7,0,98
6,15,15,20,12,15,3,11,0,97
6,15,15,20,12,15,7,0,0,90
6,15,15,20,12,15,15,19,5,122
6,15,15,20,13,1,11,5,18,104
6,15,15,20,13,1,14,0,0,84
6,15,15,20,13,1,14,18,25,127
6,15,15,20,13,1,18,11,0,99
6,15,15,20,13,1,18,11,19,118
6,15,15,20,13,5,14,0,0,88
6,15,15,20,14,15,20,5,0,110
6,15,15,20,14,15,20,5,4,114
6,15,15,20,14,15,20,5,19,129
6,15,15,20,16,1,3,5,0,81
6,15,15,20,16,1,3,5,19,100
6,15,15,20,16,1,4,0,0,77
6,15,15,20,16,1,4,19,0,96
6,15,15,20,16,1,20,8,0,101
6,15,15,20,16,1,20,8,19,120
6,15,15,20,16,9,3,11,0,95
6,15,15,20,16,12,1,20,5,110
6,15,15,20,16,15,21,14,4,126
6,15,15,20,16,18,9,14,20,133
6,15,15,20,18,1,3,5,0,83
6,15,15,20,18,1,3,5,19,102
6,15,15,20,18,1,9,12,0,96
6,15,15,20,18,5,19,20,0,118
6,15,15,20,18,5,19,20,19,137
6,15,15,20,18,9,12,12,0,107
6,15,15,20,18,15,15,13,0,117
6,15,15,20,18,15,16,5,0,110
6,15,15,20,18,15,16,5,19,129
6,15,15,20,19,0,0,0,0,75
6,15,15,20,19,3,1,12,4,95
6,15,15,20,19,25,0,0,0,100
6,15,15,20,19,9,5,0,0,89
6,15,15,20,19,9,5,19,0,108
6,15,15,20,19,12,15,7,0,109
6,15,15,20,19,12,15,7,19,128
6,15,15,20,19,15,18,5,0,113
6,15,15,20,19,15,18,5,19,132
6,15,15,20,19,20,1,12,11,119
6,15,15,20,19,20,1,12,12,120
6,15,15,20,19,20,5,16,0,116
6,15,15,20,19,20,5,16,19,135
6,15,15,20,19,20,9,3,11,118
6,15,15,20,19,20,15,3,11,124
6,15,15,20,19,20,15,14,5,129
6,15,15,20,19,20,15,15,12,137
6,15,15,20,23,1,25,0,0,105
6,15,15,20,23,1,25,19,0,124
6,15,15,20,23,1,12,11,0,103
6,15,15,20,23,1,12,12,0,104
6,15,15,20,23,1,12,12,19,123
6,15,15,20,23,5,1,18,0,103
6,15,15,20,23,5,1,18,25,128
6,15,15,20,23,5,1,18,19,122
6,15,15,20,23,15,18,11,0,123
6,15,15,20,23,15,18,11,19,142
6,15,15,20,23,15,18,14,0,126
6,15,15,26,12,5,0,0,0,79
6,15,15,26,12,5,4,0,0,83
6,15,15,26,12,5,18,0,0,97
6,15,15,26,12,5,18,19,0,116
6,15,15,26,12,5,19,0,0,98
6,15,15,26,12,9,14,7,0,104
6,15,16,0,0,0,0,0,0,37
6,15,16,4,15,15,4,12,5,92
6,15,16,12,9,14,7,0,0,79
6,15,16,16,5,4,0,0,0,62
6,15,16,16,5,18,25,0,0,101
6,15,16,16,5,18,9,5,19,109
6,15,16,16,5,18,12,25,0,113
6,15,16,16,25,0,0,0,0,78
6,15,16,16,9,14,7,0,0,83
6,15,16,16,9,19,8,0,0,89
6,15,16,16,9,19,8,12,25,126
6,15,16,19,0,0,0,0,0,56
6,15,16,19,8,9,16,0,0,89
6,15,18,1,0,0,0,0,0,40
6,15,18,1,7,5,0,0,0,52
6,15,18,1,7,5,4,0,0,56
6,15,18,1,7,5,18,0,0,70
6,15,18,1,7,5,18,19,0,89
6,15,18,1,7,5,19,0,0,71
6,15,18,1,7,9,14,7,0,77
6,15,18,1,25,0,0,0,0,65
6,15,18,1,25,5,4,0,0,74
6,15,18,1,25,5,18,0,0,88
6,15,18,1,25,5,18,19,0,107
6,15,18,1,25,9,14,7,0,95
6,15,18,1,25,19,0,0,0,84
6,15,18,1,12,9,20,5,0,86
6,15,18,1,13,0,0,0,0,53
6,15,18,1,13,5,14,0,0,72
6,15,18,1,13,5,14,19,0,91
6,15,18,1,13,9,14,1,0,77
6,15,18,1,13,9,14,1,12,89
6,15,18,1,13,19,0,0,0,72
6,15,18,1,14,5,0,0,0,59
6,15,18,1,14,5,5,14,0,78
6,15,18,1,14,5,15,21,19,114
6,15,18,1,19,13,21,3,8,104
6,15,18,1,19,20,5,18,15,117
6,15,18,2,0,0,0,0,0,41
6,15,18,2,1,4,0,0,0,46
6,15,18,2,1,4,5,0,0,51
6,15,18,2,1,18,0,0,0,60
6,15,18,2,1,18,5,0,0,65
6,15,18,2,1,18,18,5,4,87
6,15,18,2,1,20,8,5,0,75
6,15,18,2,2,15,18,5,0,81
6,15,18,2,2,15,18,14,5,95
6,15,18,2,5,1,18,0,0,65
6,15,18,2,5,1,18,5,18,88
6,15,18,2,5,1,18,19,0,84
6,15,18,2,5,19,9,20,5,99
6,15,18,2,25,0,0,0,0,66
6,15,18,2,9,4,0,0,0,54
6,15,18,2,9,4,1,12,0,67
6,15,18,2,9,4,1,12,19,86
6,15,18,2,9,4,4,1,12,71
6,15,18,2,9,4,4,5,14,77
6,15,18,2,9,4,4,5,18,81
6,15,18,2,9,4,19,0,0,73
6,15,18,2,25,5,0,0,0,71
6,15,18,2,25,19,5,14,0,104
6,15,18,2,9,20,0,0,0,70
6,15,18,2,9,20,5,0,0,75
6,15,18,2,12,1,3,11,0,68
6,15,18,2,12,5,4,0,0,62
6,15,18,2,12,15,23,0,0,91
6,15,18,2,15,4,5,0,0,65
6,15,18,2,15,4,5,4,0,69
6,15,18,2,15,4,5,19,0,84
6,15,18,2,15,4,9,14,7,90
6,15,18,2,15,18,5,0,0,79
6,15,18,2,15,18,14,0,0,88
6,15,18,2,15,18,14,5,0,93
6,15,18,2,15,23,0,0,0,79
6,15,18,2,18,5,1,11,0,76
6,15,18,2,18,21,9,19,5,113
6,15,18,2,19,0,0,0,0,60
6,15,18,3,1,18,9,1,0,71
6,15,18,3,1,18,22,5,0,88
6,15,18,3,1,20,0,0,0,63
6,15,18,3,5,0,0,0,0,47
6,15,18,3,5,1,2,12,5,67
6,15,18,3,5,4,0,0,0,51
6,15,18,3,5,4,12,25,0,88
6,15,18,3,5,6,21,12,0,86
6,15,18,3,5,12,5,19,19,102
6,15,18,3,5,12,5,20,0,84
6,15,18,3,5,13,5,1,20,86
6,15,18,3,5,13,5,14,20,99
6,15,18,3,5,14,5,0,0,66
6,15,18,3,5,16,19,0,0,82
6,15,18,3,5,16,19,5,19,106
6,15,18,3,5,16,21,20,0,104
6,15,18,3,5,18,0,0,0,65
6,15,18,3,5,18,19,0,0,84
6,15,18,3,5,20,0,0,0,67
6,15,18,3,8,1,19,5,0,75
6,15,18,3,8,5,0,0,0,55
6,15,18,3,8,5,19,0,0,74
6,15,18,3,25,0,0,0,0,67
6,15,18,3,9,2,12,5,0,70
6,15,18,3,9,2,12,25,0,90
6,15,18,3,9,14,7,0,0,72
6,15,18,3,9,14,7,12,25,109
6,15,18,3,9,16,1,12,0,80
6,15,18,3,9,16,1,20,5,93
6,15,18,3,9,16,5,19,0,91
6,15,18,3,9,16,9,1,12,89
6,15,18,3,9,20,5,0,0,76
6,15,18,3,9,22,5,0,0,78
6,15,18,3,12,5,1,22,5,87
6,15,18,3,12,15,19,5,0,93
6,15,18,3,21,20,0,0,0,83
6,15,18,4,1,2,12,5,0,63
6,15,18,4,1,25,19,0,0,88
6,15,18,4,1,13,0,0,0,57
6,15,18,4,5,1,12,0,0,61
6,15,18,4,5,4,0,0,0,52
6,15,18,4,25,0,0,0,0,68
6,15,18,4,9,4,0,0,0,56
6,15,18,4,12,5,19,19,0,98
6,15,18,4,15,0,0,0,0,58
6,15,18,4,15,5,19,0,0,82
6,15,18,4,15,9,14,7,0,88
6,15,18,4,15,14,5,0,0,77
6,15,18,4,18,9,22,5,0,97
6,15,18,4,21,12,12,0,0,88
6,15,18,4,23,9,14,5,0,94
6,15,18,5,0,0,0,0,0,44
6,15,18,5,1,3,20,0,0,68
6,15,18,5,1,4,1,16,20,86
6,15,18,5,1,12,12,15,20,104
6,15,18,5,1,18,13,0,0,76
6,15,18,5,1,18,13,5,4,85
6,15,18,5,1,18,13,19,0,95
6,15,18,5,2,1,25,0,0,72
6,15,18,5,2,1,25,19,0,91
6,15,18,5,2,1,18,0,0,65
6,15,18,5,2,5,1,18,0,70
6,15,18,5,2,5,1,18,19,89
6,15,18,5,2,25,0,0,0,71
6,15,18,5,2,25,5,0,0,76
6,15,18,5,2,9,20,20,0,95
6,15,18,5,2,12,5,19,19,101
6,15,18,5,2,15,1,18,4,84
6,15,18,5,2,15,4,5,0,70
6,15,18,5,2,15,4,5,4,74
6,15,18,5,2,15,4,5,18,88
6,15,18,5,2,15,4,5,19,89
6,15,18,5,2,15,4,25,0,90
6,15,18,5,2,15,15,13,0,89
6,15,18,5,2,15,15,13,19,108
6,15,18,5,2,15,15,20,0,96
6,15,18,5,2,15,23,0,0,84
6,15,18,5,2,15,23,19,0,103
6,15,18,5,2,18,1,3,5,73
6,15,18,5,2,18,1,9,14,88
6,15,18,5,2,21,19,8,0,94
6,15,18,5,3,1,2,9,14,73
6,15,18,5,3,1,18,0,0,66
6,15,18,5,3,1,19,20,0,87
6,15,18,5,3,1,19,20,19,106
6,15,18,5,3,8,1,19,5,80
6,15,18,5,3,8,15,9,18,97
6,15,18,5,3,9,20,5,4,85
6,15,18,5,3,12,1,23,0,83
6,15,18,5,3,12,15,19,5,98
6,15,18,5,3,15,13,5,0,80
6,15,18,5,3,15,15,12,0,89
6,15,18,5,3,15,21,14,20,117
6,15,18,5,3,15,21,18,20,121
6,15,18,5,3,15,22,5,18,107
6,15,18,5,4,1,25,0,0,74
6,15,18,5,4,1,25,19,0,93
6,15,18,5,4,1,20,5,0,74
6,15,18,5,4,1,20,5,4,78
6,15,18,5,4,1,20,5,19,93
6,15,18,5,4,1,23,14,0,86
6,15,18,5,4,5,3,11,0,67
6,15,18,5,4,5,3,11,19,86
6,15,18,5,4,5,5,13,0,71
6,15,18,5,4,5,5,16,0,74
6,15,18,5,4,5,19,11,0,83
6,15,18,5,4,9,4,0,0,61
6,15,18,5,4,15,0,0,0,63
6,15,18,5,4,15,5,19,0,87
6,15,18,5,4,15,9,14,7,93
6,15,18,5,4,15,14,5,0,82
6,15,18,5,4,15,15,13,0,91
6,15,18,5,4,15,15,13,19,110
6,15,18,5,4,15,15,18,0,96
6,15,18,5,4,21,14,5,0,88
6,15,18,5,6,1,3,5,0,59
6,15,18,5,6,1,3,5,19,78
6,15,18,5,6,1,21,12,20,104
6,15,18,5,6,5,5,12,0,72
6,15,18,5,6,5,5,12,19,91
6,15,18,5,6,5,5,20,0,80
6,15,18,5,6,5,12,20,0,87
6,15,18,5,6,5,14,3,5,77
6,15,18,5,6,5,14,4,0,73
6,15,18,5,6,5,14,4,19,92
6,15,18,5,6,6,5,12,20,93
6,15,18,5,6,9,5,12,4,80
6,15,18,5,6,9,14,0,0,73
6,15,18,5,6,9,20,0,0,79
6,15,18,5,6,12,1,14,11,88
6,15,18,5,6,12,1,16,0,79
6,15,18,5,6,15,15,20,0,100
6,15,18,5,6,18,15,14,20,117
6,15,18,5,7,1,13,5,0,70
6,15,18,5,7,1,20,5,0,77
6,15,18,5,7,9,6,20,0,86
6,15,18,5,7,9,18,20,8,106
6,15,18,5,7,12,5,1,13,82
6,15,18,5,7,12,15,23,0,101
6,15,18,5,7,15,0,0,0,66
6,15,18,5,7,15,5,18,0,89
6,15,18,5,7,15,5,18,19,108
6,15,18,5,7,15,5,19,0,90
6,15,18,5,7,15,9,14,7,96
6,15,18,5,7,15,14,5,0,85
6,15,18,5,7,21,5,19,19,115
6,15,18,5,7,21,20,0,0,92
6,15,18,5,7,21,20,19,0,111
6,15,18,5,8,1,12,6,0,71
6,15,18,5,8,1,12,12,0,77
6,15,18,5,8,1,14,4,0,71
6,15,18,5,8,1,14,4,19,90
6,15,18,5,8,1,18,4,0,75
6,15,18,5,8,1,20,3,8,84
6,15,18,5,8,5,1,4,0,62
6,15,18,5,8,5,1,4,19,81
6,15,18,5,8,5,1,18,0,76
6,15,18,5,8,5,14,20,0,91
6,15,18,5,8,5,23,0,0,80
6,15,18,5,8,9,12,12,0,85
6,15,18,5,8,15,3,11,0,81
6,15,18,5,8,15,12,4,0,83
6,15,18,5,8,15,15,4,0,86
6,15,18,5,8,15,15,6,0,88
6,15,18,5,8,15,15,6,19,107
6,15,18,5,8,15,15,11,0,93
6,15,18,5,8,15,18,19,5,109
6,15,18,5,25,1,18,4,0,92
6,15,18,5,25,1,18,4,19,111
6,15,18,5,25,5,1,18,0,93
6,15,18,5,9,7,14,0,0,74
6,15,18,5,9,7,14,5,18,97
6,15,18,5,9,7,14,12,25,111
6,15,18,5,9,7,14,19,0,93
6,15,18,5,9,18,15,14,0,100
6,15,18,5,10,21,4,7,5,91
6,15,18,5,11,5,5,12,0,77
6,15,18,5,11,9,14,7,0,85
6,15,18,5,11,14,5,5,0,79
6,15,18,5,11,14,5,23,0,97
6,15,18,5,11,14,15,23,0,107
6,15,18,5,11,14,15,23,14,121
6,15,18,5,11,14,15,23,19,126
6,15,18,5,12,0,0,0,0,56
6,15,18,5,12,1,4,25,0,86
6,15,18,5,12,1,25,0,0,82
6,15,18,5,12,1,9,4,0,70
6,15,18,5,12,1,14,4,19,94
6,15,18,5,12,5,5,3,8,77
6,15,18,5,12,5,7,0,0,68
6,15,18,5,12,5,7,19,0,87
6,15,18,5,12,9,13,2,0,80
6,15,18,5,12,9,13,2,19,99
6,15,18,5,12,9,22,5,0,92
6,15,18,5,12,15,3,11,0,85
6,15,18,5,12,15,3,11,19,104
6,15,18,5,12,15,15,11,0,97
6,15,18,5,12,15,15,16,0,102
6,15,18,5,12,15,16,5,18,110
6,15,18,5,13,1,4,5,0,67
6,15,18,5,13,1,18,3,8,87
6,15,18,5,13,1,18,11,0,87
6,15,18,5,13,1,19,20,0,97
6,15,18,5,13,1,19,20,19,116
6,15,18,5,13,5,1,14,0,77
6,15,18,5,13,5,1,14,20,97
6,15,18,5,13,5,12,20,0,94
6,15,18,5,13,5,14,0,0,76
6,15,18,5,13,9,12,11,0,89
6,15,18,5,13,9,12,11,19,108
6,15,18,5,13,9,14,4,0,84
6,15,18,5,13,15,19,20,0,111
6,15,18,5,14,1,13,5,0,77
6,15,18,5,14,1,13,5,4,81
6,15,18,5,14,1,13,5,19,96
6,15,18,5,14,5,14,20,0,97
6,15,18,5,14,5,23,19,0,105
6,15,18,5,14,9,7,8,20,102
6,15,18,5,14,15,15,14,0,102
6,15,18,5,14,15,15,14,19,121
6,15,18,5,14,15,20,5,0,98
6,15,18,5,14,15,20,5,4,102
6,15,18,5,14,19,1,12,0,90
6,15,18,5,14,19,9,3,0,89
6,15,18,5,14,19,9,3,19,108
6,15,18,5,15,18,4,5,18,104
6,15,18,5,15,18,12,15,16,120
6,15,18,5,16,1,4,0,0,65
6,15,18,5,16,1,12,5,0,78
6,15,18,5,16,1,12,5,4,82
6,15,18,5,16,1,18,20,0,99
6,15,18,5,16,1,18,20,19,118
6,15,18,5,16,1,19,19,0,99
6,15,18,5,16,1,19,20,0,100
6,15,18,5,16,1,23,0,0,84
6,15,18,5,16,1,23,19,0,103
6,15,18,5,16,5,1,11,0,77
6,15,18,5,16,5,1,11,19,96
6,15,18,5,16,9,5,3,5,82
6,15,18,5,16,12,1,3,5,81
6,15,18,5,16,12,1,25,0,98
6,15,18,5,16,12,1,25,19,117
6,15,18,5,16,12,1,14,0,87
6,15,18,5,16,12,15,20,0,107
6,15,18,5,16,15,9,14,20,118
6,15,18,5,16,15,12,5,0,92
6,15,18,5,16,15,12,5,4,96
6,15,18,5,16,15,18,3,8,104
6,15,18,5,16,15,19,20,0,114
6,15,18,5,16,18,9,19,5,111
6,15,18,5,16,18,9,26,5,118
6,15,18,5,18,1,11,5,0,79
6,15,18,5,18,1,14,0,0,77
6,15,18,5,18,1,14,11,0,88
6,15,18,5,18,1,14,11,19,107
6,15,18,5,18,5,1,3,8,79
6,15,18,5,18,5,1,4,0,72
6,15,18,5,18,9,2,0,0,73
6,15,18,5,18,9,2,19,0,92
6,15,18,5,18,9,7,8,20,106
6,15,18,5,18,15,25,1,12,115
6,15,18,5,18,15,15,13,0,105
6,15,18,5,18,21,14,0,0,97
6,15,18,5,18,21,14,19,0,116
6,15,18,5,19,0,0,0,0,63
6,15,18,5,19,1,25,0,0,89
6,15,18,5,19,1,9,4,0,77
6,15,18,5,19,1,9,12,0,85
6,15,18,5,19,1,9,12,19,104
6,15,18,5,19,1,25,19,0,108
6,15,18,5,19,1,23,0,0,87
6,15,18,5,19,3,5,14,5,90
6,15,18,5,19,3,5,14,20,105
6,15,18,5,19,5,1,20,0,89
6,15,18,5,19,5,5,0,0,73
6,15,18,5,19,5,5,14,0,87
6,15,18,5,19,5,5,18,0,91
6,15,18,5,19,5,5,18,19,110
6,15,18,5,19,5,5,19,0,92
6,15,18,5,19,5,25,0,0,93
6,15,18,5,19,5,9,14,7,98
6,15,18,5,19,5,9,26,5,108
6,15,18,5,19,5,14,4,0,86
6,15,18,5,19,5,14,19,5,106
6,15,18,5,19,5,20,0,0,88
6,15,18,5,19,8,1,6,20,98
6,15,18,5,19,8,1,14,11,97
6,15,18,5,19,8,1,16,5,93
6,15,18,5,19,8,5,5,20,101
6,15,18,5,19,8,9,6,20,106
6,15,18,5,19,8,9,16,0,96
6,15,18,5,19,8,15,3,11,100
6,15,18,5,19,8,15,5,0,91
6,15,18,5,19,8,15,16,0,102
6,15,18,5,19,8,15,18,5,109
6,15,18,5,19,8,15,20,0,106
6,15,18,5,19,8,15,20,19,125
6,15,18,5,19,8,15,23,0,109
6,15,18,5,19,8,15,23,14,123
6,15,18,5,19,8,15,23,19,128
6,15,18,5,19,9,4,5,0,81
6,15,18,5,19,9,4,5,19,100
6,15,18,5,19,9,7,8,20,107
6,15,18,5,19,9,7,14,0,93
6,15,18,5,19,9,14,0,0,86
6,15,18,5,19,9,14,7,0,93
6,15,18,5,19,11,9,14,0,97
6,15,18,5,19,11,9,14,19,116
6,15,18,5,19,11,9,18,20,121
6,15,18,5,19,12,1,3,11,90
6,15,18,5,19,12,15,23,0,113
6,15,18,5,19,15,21,14,4,117
6,15,18,5,19,16,1,11,5,96
6,15,18,5,19,16,5,1,11,96
6,15,18,5,19,16,5,5,4,93
6,15,18,5,19,16,5,14,20,118
6,15,18,5,19,16,15,11,5,110
6,15,18,5,19,20,1,6,6,96
6,15,18,5,19,20,1,7,5,96
6,15,18,5,19,20,1,25,0,109
6,15,18,5,19,20,1,9,18,111
6,15,18,5,19,20,1,25,19,128
6,15,18,5,19,20,1,12,0,96
6,15,18,5,19,20,1,12,12,108
6,15,18,5,19,20,1,20,5,109
6,15,18,5,19,20,5,4,0,92
6,15,18,5,19,20,5,5,16,109
6,15,18,5,19,20,5,13,0,101
6,15,18,5,19,20,5,16,0,104
6,15,18,5,19,20,5,18,25,131
6,15,18,5,19,20,5,18,19,125
6,15,18,5,19,20,6,21,12,122
6,15,18,5,19,20,25,0,0,108
6,15,18,5,19,20,9,1,12,105
6,15,18,5,19,20,9,3,11,106
6,15,18,5,19,20,9,14,5,111
6,15,18,5,19,20,9,14,7,113
6,15,18,5,19,20,9,19,8,119
6,15,18,5,19,20,18,1,12,114
6,15,18,5,19,20,18,25,0,126
6,15,18,5,19,20,19,0,0,102
6,15,18,5,19,20,21,4,25,133
6,15,18,5,19,23,5,1,18,110
6,15,18,5,19,23,5,1,20,112
6,15,18,5,19,23,15,18,5,124
6,15,18,5,19,23,15,18,14,133
6,15,18,5,20,0,0,0,0,64
6,15,18,5,20,1,3,11,0,79
6,15,18,5,20,1,11,5,0,81
6,15,18,5,20,1,12,11,0,88
6,15,18,5,20,1,19,20,5,109
6,15,18,5,20,5,1,3,8,81
6,15,18,5,20,5,5,20,8,102
6,15,18,5,20,5,12,12,0,93
6,15,18,5,20,5,12,12,19,112
6,15,18,5,20,8,9,14,11,106
6,15,18,5,20,9,13,5,0,91
6,15,18,5,20,9,13,5,4,95
6,15,18,5,20,9,13,5,19,110
6,15,18,5,20,25,16,5,0,110
6,15,18,5,20,15,11,5,14,109
6,15,18,5,20,15,12,4,0,95
6,15,18,5,20,15,15,20,8,122
6,15,18,5,20,15,16,0,0,95
6,15,18,5,20,15,16,19,0,114
6,15,18,5,20,18,1,3,5,91
6,15,18,5,20,21,18,14,0,117
6,15,18,5,21,19,5,0,0,89
6,15,18,5,21,20,20,5,18,128
6,15,18,5,22,1,12,21,5,105
6,15,18,5,22,5,18,0,0,89
6,15,18,5,22,5,18,19,0,108
6,15,18,5,22,9,5,23,0,103
6,15,18,5,22,15,21,3,8,113
6,15,18,5,22,15,23,0,0,104
6,15,18,5,23,1,18,4,0,90
6,15,18,5,23,1,18,13,0,99
6,15,18,5,23,1,18,14,0,100
6,15,18,5,23,1,18,14,19,119
6,15,18,5,23,5,5,14,0,91
6,15,18,5,23,5,5,16,0,93
6,15,18,5,23,5,9,7,8,96
6,15,18,5,23,5,14,20,0,106
6,15,18,5,23,9,14,4,0,94
6,15,18,5,23,9,14,7,0,97
6,15,18,5,23,9,14,7,19,116
6,15,18,5,23,9,19,8,0,103
6,15,18,5,23,9,20,0,0,96
6,15,18,5,23,15,13,1,14,110
6,15,18,5,23,15,13,5,14,114
6,15,18,5,23,15,18,4,0,104
6,15,18,5,23,15,18,4,19,123
6,15,18,5,23,15,18,12,4,116
6,15,18,5,23,15,18,14,0,114
6,15,18,5,24,0,0,0,0,68
6,15,18,6,1,9,18,14,0,87
6,15,18,6,1,12,20,0,0,78
6,15,18,6,1,18,5,0,0,69
6,15,18,6,1,18,19,0,0,83
6,15,18,6,1,21,12,20,0,99
6,15,18,6,5,1,18,0,0,69
6,15,18,6,5,9,20,0,0,79
6,15,18,6,5,9,20,5,4,88
6,15,18,6,5,9,20,5,18,102
6,15,18,6,5,9,20,19,0,98
6,15,18,6,5,14,4,0,0,68
6,15,18,6,5,14,4,5,4,77
6,15,18,6,5,14,4,19,0,87
6,15,18,6,5,24,0,0,0,74
6,15,18,6,9,3,1,20,5,83
6,15,18,6,9,20,0,0,0,74
6,15,18,7,1,2,0,0,0,49
6,15,18,7,1,9,14,19,20,109
6,15,18,7,1,20,0,0,0,67
6,15,18,7,1,20,8,5,18,98
6,15,18,7,1,22,5,0,0,74
6,15,18,7,5,0,0,0,0,51
6,15,18,7,5,1,2,12,5,71
6,15,18,7,5,4,0,0,0,55
6,15,18,7,5,4,12,25,0,92
6,15,18,7,5,6,21,12,0,90
6,15,18,7,5,13,1,14,0,79
6,15,18,7,5,13,5,14,0,83
6,15,18,7,5,18,0,0,0,69
6,15,18,7,5,18,25,0,0,94
6,15,18,7,5,18,9,5,19,102
6,15,18,7,5,18,19,0,0,88
6,15,18,7,5,19,0,0,0,70
6,15,18,7,5,20,0,0,0,71
6,15,18,7,5,20,6,21,12,110
6,15,18,7,5,20,9,22,5,107
6,15,18,7,5,20,19,0,0,90
6,15,18,7,5,20,20,0,0,91
6,15,18,7,5,20,20,5,0,96
6,15,18,7,5,20,20,5,18,114
6,15,18,7,9,5,0,0,0,60
6,15,18,7,9,6,20,0,0,81
6,15,18,7,9,14,7,0,0,76
6,15,18,7,9,14,7,19,0,95
6,15,18,7,9,22,5,0,0,82
6,15,18,7,9,22,5,14,0,96
6,15,18,7,9,22,5,18,0,100
6,15,18,7,9,22,5,18,19,119
6,15,18,7,9,22,5,19,0,101
6,15,18,7,9,22,9,14,7,107
6,15,18,7,15,0,0,0,0,61
6,15,18,7,15,5,18,0,0,84
6,15,18,7,15,5,18,19,0,103
6,15,18,7,15,5,19,0,0,85
6,15,18,7,15,9,14,7,0,91
6,15,18,7,15,14,5,0,0,80
6,15,18,7,15,20,0,0,0,81
6,15,18,7,15,20,20,5,14,120
6,15,18,7,18,15,23,0,0,102
6,15,18,7,18,15,23,14,0,116
6,15,18,8,1,9,12,5,0,74
6,15,18,8,1,12,5,0,0,65
6,15,18,8,5,5,4,0,0,61
6,15,18,8,15,15,0,0,0,77
6,15,18,8,15,15,25,0,0,102
6,15,18,8,15,15,9,5,0,91
6,15,18,8,15,23,0,0,0,85
6,15,18,25,9,5,12,4,0,94
6,15,18,9,14,19,5,3,0,89
6,15,18,9,14,20,0,0,0,82
6,15,18,9,14,20,19,0,0,101
6,15,18,10,1,19,11,9,20,109
6,15,18,10,5,19,11,5,20,109
6,15,18,10,21,4,7,5,0,86
6,15,18,10,21,4,7,5,4,90
6,15,18,10,21,4,7,5,18,104
6,15,18,10,21,4,7,5,19,105
6,15,18,11,0,0,0,0,0,50
6,15,18,11,1,2,12,5,0,70
6,15,18,11,2,1,12,12,0,77
6,15,18,11,2,5,1,18,4,80
6,15,18,11,5,4,0,0,0,59
6,15,18,11,5,4,12,25,0,96
6,15,18,11,5,18,0,0,0,73
6,15,18,11,5,18,19,0,0,92
6,15,18,11,6,21,12,0,0,89
6,15,18,11,6,21,12,19,0,108
6,15,18,11,8,5,1,4,0,68
6,15,18,11,25,0,0,0,0,75
6,15,18,11,9,5,18,0,0,82
6,15,18,11,9,5,19,20,0,103
6,15,18,11,9,14,5,19,19,116
6,15,18,11,9,14,7,0,0,80
6,15,18,11,12,5,19,19,0,105
6,15,18,11,12,9,6,20,0,97
6,15,18,11,12,9,6,20,19,116
6,15,18,11,12,9,11,5,0,87
6,15,18,11,13,1,14,0,0,78
6,15,18,11,13,5,14,0,0,82
6,15,18,11,19,6,21,12,0,108
6,15,18,11,19,13,9,20,8,119
6,15,18,11,20,1,9,12,0,92
6,15,18,11,23,9,19,5,0,106
6,15,18,12,1,25,0,0,0,77
6,15,18,12,1,9,14,0,0,75
6,15,18,12,1,14,1,0,0,67
6,15,18,12,1,14,1,19,0,86
6,15,18,12,1,14,5,0,0,71
6,15,18,12,5,1,22,5,0,84
6,15,18,12,5,6,20,0,0,82
6,15,18,12,5,9,20,0,0,85
6,15,18,12,5,19,5,0,0,80
6,15,18,12,5,20,0,0,0,76
6,15,18,12,9,5,0,0,0,65
6,15,18,12,9,22,5,0,0,87
6,15,18,12,15,9,14,0,0,89
6,15,18,12,15,18,5,0,0,89
6,15,18,12,15,18,14,0,0,98
6,15,18,12,15,18,14,5,18,121
6,15,18,12,15,18,14,12,25,135
6,15,18,13,0,0,0,0,0,52
6,15,18,13,1,0,0,0,0,53
6,15,18,13,1,2,12,5,0,72
6,15,18,13,1,2,12,25,0,92
6,15,18,13,1,7,5,14,0,79
6,15,18,13,1,12,0,0,0,65
6,15,18,13,1,12,9,14,19,107
6,15,18,13,1,12,9,19,5,98
6,15,18,13,1,12,9,19,13,106
6,15,18,13,1,12,9,19,20,113
6,15,18,13,1,12,9,20,8,102
6,15,18,13,1,12,9,20,25,119
6,15,18,13,1,12,9,26,5,105
6,15,18,13,1,12,12,25,0,102
6,15,18,13,1,12,19,0,0,84
6,15,18,13,1,13,9,4,5,84
6,15,18,13,1,13,9,4,15,94
6,15,18,13,1,14,20,0,0,87
6,15,18,13,1,14,20,19,0,106
6,15,18,13,1,20,0,0,0,73
6,15,18,13,1,20,5,0,0,78
6,15,18,13,1,20,5,4,0,82
6,15,18,13,1,20,5,19,0,97
6,15,18,13,1,20,9,14,7,103
6,15,18,13,1,20,9,15,14,111
6,15,18,13,1,20,9,22,5,109
6,15,18,13,1,20,19,0,0,92
6,15,18,13,1,20,20,5,4,102
6,15,18,13,1,20,20,5,18,116
6,15,18,13,1,20,21,18,5,117
6,15,18,13,1,26,1,14,0,94
6,15,18,13,1,26,25,12,0,116
6,15,18,13,2,25,0,0,0,79
6,15,18,13,2,15,1,18,4,92
6,15,18,13,5,0,0,0,0,57
6,15,18,13,5,4,0,0,0,61
6,15,18,13,5,4,15,14,0,90
6,15,18,13,5,5,0,0,0,62
6,15,18,13,5,12,0,0,0,69
6,15,18,13,5,12,20,0,0,89
6,15,18,13,5,14,5,0,0,76
6,15,18,13,5,14,9,3,0,83
6,15,18,13,5,18,0,0,0,75
6,15,18,13,5,18,5,20,0,100
6,15,18,13,5,18,12,25,0,112
6,15,18,13,5,18,19,0,0,94
6,15,18,13,5,19,0,0,0,76
6,15,18,13,6,5,5,4,0,72
6,15,18,13,6,5,5,4,19,91
6,15,18,13,6,21,12,0,0,91
6,15,18,13,25,0,0,0,0,77
6,15,18,13,9,1,20,5,0,87
6,15,18,13,9,3,0,0,0,64
6,15,18,13,9,3,1,14,0,79
6,15,18,13,9,3,1,18,25,108
6,15,18,13,9,3,1,20,5,90
6,15,18,13,9,3,9,4,0,77
6,15,18,13,9,3,9,4,5,82
6,15,18,13,9,3,9,14,5,92
6,15,18,13,25,12,0,0,0,89
6,15,18,13,25,12,1,12,0,102
6,15,18,13,25,12,1,20,5,115
6,15,18,13,25,12,19,0,0,108
6,15,18,13,9,14,0,0,0,75
6,15,18,13,9,14,1,20,5,101
6,15,18,13,9,14,7,0,0,82
6,15,18,13,9,19,13,0,0,93
6,15,18,13,9,20,25,0,0,106
6,15,18,13,12,5,19,19,0,107
6,15,18,13,12,25,0,0,0,89
6,15,18,13,14,1,9,12,0,88
6,15,18,13,15,12,9,20,0,108
6,15,18,13,15,12,9,20,5,113
6,15,18,13,15,12,19,0,0,98
6,15,18,13,15,19,5,0,0,91
6,15,18,13,15,19,9,20,25,140
6,15,18,13,15,21,19,0,0,107
6,15,18,13,15,24,9,13,5,118
6,15,18,13,19,0,0,0,0,71
6,15,18,13,21,12,1,0,0,86
6,15,18,13,21,12,1,5,0,91
6,15,18,13,21,12,1,9,3,98
6,15,18,13,21,12,1,18,0,104
6,15,18,13,21,12,1,18,25,129
6,15,18,13,21,12,1,19,0,105
6,15,18,13,21,12,1,20,5,111
6,15,18,13,21,12,5,0,0,90
6,15,18,13,21,12,9,19,5,118
6,15,18,13,21,12,9,19,13,126
6,15,18,13,21,12,9,19,20,133
6,15,18,13,21,12,9,26,5,125
6,15,18,13,23,15,18,11,0,119
6,15,18,14,1,3,9,3,0,69
6,15,18,14,1,24,9,4,0,91
6,15,18,14,3,1,19,20,0,96
6,15,18,14,5,14,19,20,0,111
6,15,18,14,5,14,20,0,0,92
6,15,18,14,9,3,1,12,0,78
6,15,18,14,9,3,1,20,5,91
6,15,18,14,9,3,5,19,0,89
6,15,18,14,9,14,19,20,0,115
6,15,18,14,9,24,0,0,0,86
6,15,18,15,12,4,0,0,0,70
6,15,18,16,1,19,19,0,0,94
6,15,18,16,5,20,0,0,0,80
6,15,18,16,9,14,5,0,0,83
6,15,18,16,9,14,5,4,0,87
6,15,18,16,9,14,9,14,7,108
6,15,18,16,9,20,0,0,0,84
6,15,18,16,18,9,19,5,0,106
6,15,18,18,1,0,0,0,0,58
6,15,18,18,1,4,0,0,0,62
6,15,18,18,1,4,5,18,0,85
6,15,18,18,1,18,4,0,0,80
6,15,18,18,1,18,4,5,18,103
6,15,18,18,5,12,0,0,0,74
6,15,18,18,9,4,5,0,0,75
6,15,18,18,9,12,0,0,0,78
6,15,18,18,9,20,0,0,0,86
6,15,18,18,21,5,0,0,0,83
6,15,18,19,1,4,15,0,0,78
6,15,18,19,1,25,0,0,0,84
6,15,18,19,1,11,5,0,0,75
6,15,18,19,1,11,5,14,0,89
6,15,18,19,1,11,5,18,0,93
6,15,18,19,1,11,5,18,19,112
6,15,18,19,1,11,5,19,0,94
6,15,18,19,1,11,9,14,7,100
6,15,18,19,1,18,0,0,0,77
6,15,18,19,5,5,0,0,0,68
6,15,18,19,5,5,11,0,0,79
6,15,18,19,5,5,14,0,0,82
6,15,18,19,5,20,0,0,0,83
6,15,18,19,8,1,16,5,0,88
6,15,18,19,12,1,3,11,0,85
6,15,18,19,12,1,11,5,0,87
6,15,18,19,12,15,20,8,0,113
6,15,18,19,12,15,23,0,0,108
6,15,18,19,15,15,11,0,0,99
6,15,18,19,15,15,20,8,0,116
6,15,18,19,16,5,1,11,0,91
6,15,18,19,16,5,14,4,0,97
6,15,18,19,16,5,14,20,0,113
6,15,18,19,16,15,11,5,0,105
6,15,18,19,16,15,11,5,14,119
6,15,18,19,16,18,5,1,4,102
6,15,18,19,20,1,12,12,0,103
6,15,18,19,20,1,14,4,0,97
6,15,18,19,20,5,1,12,0,96
6,15,18,19,21,14,7,0,0,100
6,15,18,19,23,1,20,0,0,102
6,15,18,19,23,5,1,18,0,105
6,15,18,19,23,5,1,18,19,124
6,15,18,19,23,15,18,5,0,119
6,15,18,19,23,15,18,14,0,128
6,15,18,20,1,11,5,0,0,76
6,15,18,20,1,12,9,3,5,89
6,15,18,20,1,24,5,4,0,93
6,15,18,20,5,0,0,0,0,64
6,15,18,20,5,19,0,0,0,83
6,15,18,20,8,2,25,0,0,94
6,15,18,20,8,3,1,12,12,95
6,15,18,20,8,3,1,13,5,89
6,15,18,20,8,3,15,13,5,103
6,15,18,20,8,3,21,20,0,111
6,15,18,20,8,6,1,18,5,97
6,15,18,20,8,7,1,26,5,106
6,15,18,20,8,7,15,0,0,89
6,15,18,20,8,25,0,0,0,92
6,15,18,20,8,9,14,11,0,101
6,15,18,20,8,15,14,0,0,96
6,15,18,20,8,19,5,20,0,111
6,15,18,20,8,20,5,12,12,116
6,15,18,20,8,23,1,18,4,113
6,15,18,20,8,23,9,20,8,127
6,15,18,20,25,0,0,0,0,84
6,15,18,20,9,5,19,0,0,92
6,15,18,20,9,5,20,8,0,101
6,15,18,20,9,5,20,8,19,120
6,15,18,20,9,6,25,0,0,99
6,15,18,20,9,6,9,5,4,92
6,15,18,20,9,6,9,5,18,106
6,15,18,20,9,6,9,5,19,107
6,15,18,20,9,6,25,19,0,118
6,15,18,20,25,6,9,22,5,126
6,15,18,20,25,6,15,12,4,121
6,15,18,20,25,9,19,8,0,120
6,15,18,20,9,12,1,7,5,93
6,15,18,20,9,15,18,9,0,110
6,15,18,20,9,19,0,0,0,87
6,15,18,20,9,20,21,4,5,118
6,15,18,20,12,5,20,0,0,96
6,15,18,20,14,9,7,8,20,117
6,15,18,20,18,1,14,8,0,100
6,15,18,20,18,5,1,4,0,87
6,15,18,20,18,5,19,19,0,120
6,15,18,20,19,0,0,0,0,78
6,15,18,20,21,9,20,25,0,134
6,15,18,20,21,9,20,21,19,149
6,15,18,20,21,14,1,20,5,120
6,15,18,20,21,14,5,4,0,103
6,15,18,20,21,14,5,12,0,111
6,15,18,20,21,14,5,19,0,118
6,15,18,20,21,14,9,14,7,124
6,15,18,20,21,14,9,20,5,128
6,15,18,20,21,14,9,26,5,134
6,15,18,20,21,14,15,21,19,149
6,15,18,20,21,21,14,5,4,124
6,15,18,21,13,9,26,5,0,113
6,15,18,21,13,19,0,0,0,92
6,15,18,22,1,25,0,0,0,87
6,15,18,23,1,11,5,0,0,79
6,15,18,23,1,11,5,4,0,83
6,15,18,23,1,12,11,0,0,86
6,15,18,23,1,14,4,5,18,104
6,15,18,23,1,18,4,1,12,98
6,15,18,23,1,18,4,5,4,94
6,15,18,23,1,18,4,5,18,108
6,15,18,23,1,18,4,12,25,122
6,15,18,23,1,18,4,19,0,104
6,15,18,23,1,18,14,0,0,95
6,15,18,23,1,19,20,5,0,107
6,15,18,23,5,1,14,0,0,82
6,15,18,23,5,1,18,0,0,86
6,15,18,23,5,1,18,25,0,111
6,15,18,23,5,5,14,4,0,90
6,15,18,23,5,5,16,0,0,88
6,15,18,23,5,12,11,0,0,90
6,15,18,23,5,14,20,0,0,101
6,15,18,23,8,25,0,0,0,95
6,15,18,23,15,4,5,14,0,100
6,15,18,23,15,18,4,5,14,118
6,15,18,23,15,18,5,0,0,100
6,15,18,23,15,18,11,0,0,106
6,15,18,23,15,18,14,0,0,109
6,15,18,23,18,1,16,0,0,97
6,15,18,26,0,0,0,0,0,65
6,15,18,26,1,14,4,15,0,99
6,15,18,26,1,14,4,15,19,118
6,15,18,26,1,20,15,0,0,101
6,15,19,8,0,0,0,0,0,48
6,15,19,9,5,0,0,0,0,54
6,15,19,19,1,0,0,0,0,60
6,15,19,19,1,5,0,0,0,65
6,15,19,19,1,7,5,0,0,72
6,15,19,19,1,14,5,0,0,79
6,15,19,19,1,18,9,1,14,102
6,15,19,19,1,20,5,0,0,85
6,15,19,19,5,0,0,0,0,64
6,15,19,19,5,4,0,0,0,68
6,15,19,19,5,19,0,0,0,83
6,15,19,19,5,20,0,0,0,84
6,15,19,19,5,20,20,5,0,109
6,15,19,19,5,20,20,5,19,128
6,15,19,19,9,3,11,0,0,82
6,15,19,19,9,3,11,5,4,91
6,15,19,19,9,3,11,5,18,105
6,15,19,19,9,3,11,19,0,101
6,15,19,19,9,6,9,5,4,92
6,15,19,19,9,6,15,18,13,120
6,15,19,19,9,12,0,0,0,80
6,15,19,19,9,12,1,7,5,93
6,15,19,19,9,12,4,15,13,112
6,15,19,19,9,12,5,4,0,89
6,15,19,19,9,12,9,6,25,120
6,15,19,19,9,12,9,19,5,113
6,15,19,19,9,12,9,19,13,121
6,15,19,19,9,12,9,19,20,128
6,15,19,19,9,12,9,26,5,120
6,15,19,19,9,12,15,7,25,127
6,15,19,19,9,12,19,0,0,99
6,15,19,19,12,9,6,25,0,111
6,15,19,19,15,18,0,0,0,92
6,15,19,19,15,18,9,1,12,114
6,15,19,19,15,18,19,0,0,111
6,15,19,19,21,12,1,0,0,93
6,15,19,19,21,12,1,5,0,98
6,15,19,19,21,12,1,20,5,118
6,15,19,19,21,12,5,0,0,97
6,15,19,19,21,12,5,20,0,117
6,15,19,20,5,12,12,0,0,89
6,15,19,20,5,18,1,7,5,96
6,15,19,20,5,18,5,4,0,92
6,15,19,20,5,18,5,18,0,106
6,15,19,20,5,18,5,18,19,125
6,15,19,20,5,18,9,14,7,113
6,15,19,20,5,18,9,20,5,117
6,15,19,20,18,5,19,19,0,121
6,15,20,3,8,0,0,0,0,52
6,15,20,3,8,5,4,0,0,61
6,15,20,8,5,18,0,0,0,72
6,15,20,8,5,18,9,14,7,102
6,15,20,9,22,5,0,0,0,77
6,15,20,13,1,12,0,0,0,67
6,15,20,21,9,0,0,0,0,71
6,15,21,0,0,0,0,0,0,42
6,15,21,4,0,0,0,0,0,46
6,15,21,5,20,20,0,0,0,87
6,15,21,5,20,20,5,0,0,92
6,15,21,5,20,20,5,5,0,97
6,15,21,5,20,20,5,19,0,111
6,15,21,7,1,4,5,0,0,59
6,15,21,7,1,19,19,5,0,93
6,15,21,7,8,20,0,0,0,77
6,15,21,7,8,20,5,14,0,96
6,15,21,7,8,20,25,0,0,102
6,15,21,7,21,5,0,0,0,75
6,15,21,10,4,1,18,0,0,75
6,15,21,10,4,1,18,25,0,100
6,15,21,10,4,1,18,18,25,118
6,15,21,12,0,0,0,0,0,54
6,15,21,12,1,7,5,0,0,67
6,15,21,12,1,18,4,0,0,77
6,15,21,12,1,18,4,19,0,96
6,15,21,12,2,18,15,15,4,108
6,15,21,12,4,5,18,0,0,81
6,15,21,12,4,18,5,0,0,81
6,15,21,12,5,4,0,0,0,63
6,15,21,12,5,18,0,0,0,77
6,15,21,12,5,19,20,0,0,98
6,15,21,12,9,14,7,0,0,84
6,15,21,12,9,14,7,19,0,103
6,15,21,12,9,19,8,0,0,90
6,15,21,12,12,25,0,0,0,91
6,15,21,12,13,1,18,20,0,106
6,15,21,12,13,15,21,20,8,131
6,15,21,12,19,0,0,0,0,73
6,15,21,12,19,15,13,5,0,106
6,15,21,13,1,18,20,0,0,94
6,15,21,14,0,0,0,0,0,56
6,15,21,14,3,5,0,0,0,64
6,15,21,14,4,0,0,0,0,60
6,15,21,14,4,5,4,0,0,69
6,15,21,14,4,5,18,0,0,83
6,15,21,14,4,5,18,5,4,92
6,15,21,14,4,5,18,25,0,108
6,15,21,14,4,5,18,19,0,102
6,15,21,14,4,9,14,7,0,90
6,15,21,14,4,12,9,14,7,102
6,15,21,14,4,18,5,19,19,121
6,15,21,14,4,18,25,0,0,103
6,15,21,14,4,18,9,5,19,111
6,15,21,14,4,18,15,21,19,133
6,15,21,14,4,19,0,0,0,79
6,15,21,14,20,1,9,14,0,100
6,15,21,14,20,1,9,14,19,119
6,15,21,14,20,5,0,0,0,81
6,15,21,14,20,6,21,12,0,115
6,15,21,14,20,19,0,0,0,95
6,15,21,18,2,0,0,0,0,62
6,15,21,18,2,1,12,12,0,87
6,15,21,18,2,5,18,9,5,99
6,15,21,18,2,12,5,0,0,79
6,15,21,18,3,8,5,0,0,76
6,15,21,18,3,8,5,5,0,81
6,15,21,18,3,8,5,18,0,94
6,15,21,18,3,8,5,20,0,96
6,15,21,18,3,8,9,20,5,105
6,15,21,18,5,18,0,0,0,83
6,15,21,18,6,15,12,4,0,97
6,15,21,18,7,15,14,0,0,96
6,15,21,18,7,15,14,19,0,115
6,15,21,18,12,9,14,7,0,102
6,15,21,18,14,5,1,21,0,101
6,15,21,18,14,5,19,19,0,117
6,15,21,18,16,5,14,3,5,103
6,15,21,18,16,5,14,14,25,134
6,15,21,18,16,12,5,24,0,117
6,15,21,18,17,21,9,14,5,126
6,15,21,18,18,1,7,0,0,86
6,15,21,18,18,5,0,0,0,83
6,15,21,18,18,9,5,18,0,110
6,15,21,18,19,0,0,0,0,79
6,15,21,18,19,3,15,18,5,120
6,15,21,18,19,15,13,5,0,112
6,15,21,18,19,15,13,5,19,131
6,15,21,18,20,5,5,14,0,104
6,15,21,18,20,5,5,14,19,123
6,15,21,18,20,8,0,0,0,88
6,15,21,18,20,8,5,18,0,111
6,15,21,18,20,8,12,25,0,125
6,15,21,18,20,8,19,0,0,107
6,15,21,19,19,1,0,0,0,81
6,15,21,20,5,0,0,0,0,67
6,15,21,20,5,18,0,0,0,85
6,15,21,20,8,0,0,0,0,70
6,15,21,20,25,0,0,0,0,87
6,15,21,20,18,1,0,0,0,81
6,15,21,20,18,5,0,0,0,85
6,15,22,5,1,0,0,0,0,49
6,15,22,5,1,5,0,0,0,54
6,15,22,5,1,12,0,0,0,61
6,15,22,5,1,19,0,0,0,68
6,15,22,5,1,20,5,0,0,74
6,15,22,5,1,20,5,4,0,78
6,15,22,5,1,20,9,15,14,107
6,15,22,5,9,6,15,18,13,109
6,15,22,5,14,20,0,0,0,82
6,15,22,5,15,12,1,0,0,76
6,15,22,5,15,12,1,5,0,81
6,15,22,5,15,12,1,18,0,94
6,15,22,5,15,12,1,19,0,95
6,15,22,5,15,12,1,20,5,101
6,15,22,5,15,12,5,0,0,80
6,15,22,5,15,12,5,19,0,99
6,15,22,5,15,12,5,20,0,100
6,15,22,5,15,12,5,20,19,119
6,15,22,9,12,12,1,0,0,77
6,15,23,0,0,0,0,0,0,44
6,15,23,1,7,5,0,0,0,57
6,15,23,5,12,12,19,0,0,92
6,15,23,5,14,20,0,0,0,83
6,15,23,11,0,0,0,0,0,55
6,15,23,12,0,0,0,0,0,56
6,15,23,12,5,4,0,0,0,65
6,15,23,12,5,18,25,0,0,104
6,15,23,12,5,18,9,20,5,113
6,15,23,12,5,18,19,0,0,98
6,15,23,12,6,15,15,20,0,112
6,15,23,12,9,14,7,0,0,86
6,15,23,12,9,14,7,19,0,105
6,15,23,12,16,15,24,0,0,111
6,15,23,12,16,15,24,5,19,135
6,15,23,12,19,0,0,0,0,75
6,15,24,2,1,14,5,0,0,67
6,15,24,2,5,18,18,25,0,113
6,15,24,3,8,15,16,0,0,87
6,15,24,5,4,0,0,0,0,54
6,15,24,5,18,0,0,0,0,68
6,15,24,5,18,25,0,0,0,93
6,15,24,5,19,0,0,0,0,69
6,15,24,6,5,5,20,0,0,81
6,15,24,6,9,14,7,5,18,104
6,15,24,6,9,18,5,0,0,83
6,15,24,6,9,18,5,19,0,102
6,15,24,6,9,19,8,0,0,87
6,15,24,6,9,19,8,5,19,111
6,15,24,7,12,15,22,5,0,106
6,15,24,7,12,15,22,5,19,125
6,15,24,8,15,12,5,0,0,85
6,15,24,8,15,12,5,19,0,104
6,15,24,8,15,21,14,4,0,107
6,15,24,8,15,21,14,4,19,126
6,15,24,25,0,0,0,0,0,70
6,15,24,9,5,0,0,0,0,59
6,15,24,9,5,18,0,0,0,77
6,15,24,9,5,19,20,0,0,98
6,15,24,9,12,25,0,0,0,91
6,15,24,9,14,5,19,19,0,111
6,15,24,9,14,7,0,0,0,75
6,15,24,9,14,7,19,0,0,94
6,15,24,9,19,8,0,0,0,81
6,15,24,9,20,5,0,0,0,79
6,15,24,12,25,0,0,0,0,82
6,15,24,12,9,11,5,0,0,82
6,15,24,16,18,15,15,6,0,115
6,15,24,19,8,9,16,0,0,97
6,15,24,19,11,9,14,0,0,98
6,15,24,19,11,9,14,19,0,117
6,15,24,20,1,9,12,0,0,87
6,15,24,20,1,9,12,5,4,96
6,15,24,20,1,9,12,19,0,106
6,15,24,20,15,14,7,21,5,127
6,15,24,20,18,15,20,19,0,137
6,15,24,23,15,15,4,0,0,102
6,15,26,25,0,0,0,0,0,72
6,15,26,9,5,18,0,0,0,79
6,15,26,9,5,19,20,0,0,100
6,15,26,9,14,5,19,19,0,113
6,16,12,15,20,0,0,0,0,69
6,16,19,16,19,0,0,0,0,76
6,18,4,5,14,0,0,0,0,47
6,18,5,1,11,0,0,0,0,41
6,18,5,1,11,4,15,13,0,73
6,18,5,1,11,5,4,0,0,50
6,18,5,1,11,5,18,25,0,89
6,18,5,1,11,6,21,12,0,80
6,18,5,1,11,25,0,0,0,66
6,18,5,1,11,9,5,18,0,73
6,18,5,1,11,9,5,19,20,94
6,18,5,1,11,9,12,25,0,87
6,18,5,1,11,9,14,7,0,71
6,18,5,1,11,9,19,8,0,77
6,18,5,1,11,15,21,20,0,97
6,18,5,1,11,15,21,20,19,116
6,18,5,1,11,16,15,20,0,92
6,18,5,1,11,19,0,0,0,60
6,18,5,1,13,0,0,0,0,43
6,18,5,1,20,8,0,0,0,58
6,18,5,3,11,0,0,0,0,43
6,18,5,3,11,5,4,0,0,52
6,18,5,3,11,5,14,0,0,62
6,18,5,3,11,5,14,5,4,71
6,18,5,3,11,5,20,0,0,68
6,18,5,3,11,12,5,0,0,60
6,18,5,3,11,12,5,4,0,64
6,18,5,3,11,12,5,19,0,79
6,18,5,3,11,12,25,0,0,80
6,18,5,3,11,12,9,5,18,87
6,18,5,3,11,12,9,14,7,85
6,18,5,3,11,12,9,19,8,91
6,18,5,4,1,9,14,5,0,62
6,18,5,4,4,15,0,0,0,52
6,18,5,5,0,0,0,0,0,34
6,18,5,5,2,1,19,5,0,61
6,18,5,5,2,5,5,0,0,46
6,18,5,5,2,5,5,19,0,65
6,18,5,5,2,25,0,0,0,61
6,18,5,5,2,9,5,0,0,50
6,18,5,5,2,9,5,19,0,69
6,18,5,5,2,15,1,18,4,74
6,18,5,5,2,15,15,20,0,86
6,18,5,5,2,15,15,20,25,111
6,18,5,5,2,15,15,20,19,105
6,18,5,5,4,13,5,14,0,70
6,18,5,5,4,15,13,19,0,85
6,18,5,5,4,15,15,20,0,88
6,18,5,5,6,4,0,0,0,44
6,18,5,5,6,15,18,13,0,86
6,18,5,5,8,1,14,4,0,61
6,18,5,5,8,15,12,4,19,92
6,18,5,5,9,14,7,0,0,64
6,18,5,5,9,14,7,19,0,83
6,18,5,5,9,19,8,0,0,70
6,18,5,5,12,1,7,5,0,59
6,18,5,5,12,1,14,3,5,69
6,18,5,5,12,25,0,0,0,71
6,18,5,5,12,15,1,4,0,66
6,18,5,5,12,15,1,4,19,85
6,18,5,5,13,5,14,0,0,66
6,18,5,5,14,0,0,0,0,48
6,18,5,5,14,4,0,0,0,52
6,18,5,5,14,5,19,19,0,91
6,18,5,5,18,19,0,0,0,71
6,18,5,5,19,0,0,0,0,53
6,18,5,5,19,8,5,5,20,91
6,18,5,5,19,9,1,19,0,82
6,18,5,5,19,16,0,0,0,69
6,18,5,5,19,16,1,3,0,73
6,18,5,5,19,16,1,3,5,78
6,18,5,5,19,20,0,0,0,73
6,18,5,5,19,20,25,12,5,115
6,18,5,5,19,20,15,14,5,107
6,18,5,5,20,0,0,0,0,54
6,18,5,5,20,8,9,14,11,96
6,18,5,5,20,25,0,0,0,79
6,18,5,5,23,1,25,0,0,83
6,18,5,5,23,1,25,19,0,102
6,18,5,5,23,1,18,4,0,80
6,18,5,5,23,8,5,5,12,87
6,18,5,5,23,9,12,12,0,90
6,18,5,5,23,15,13,1,14,100
6,18,5,5,23,15,13,5,14,104
6,18,5,5,26,1,2,12,5,80
6,18,5,5,26,5,0,0,0,65
6,18,5,5,26,5,4,0,0,69
6,18,5,5,26,5,18,0,0,83
6,18,5,5,26,5,18,19,0,102
6,18,5,5,26,5,19,0,0,84
6,18,5,5,26,25,0,0,0,85
6,18,5,5,26,9,14,7,0,90
6,18,5,7,9,20,0,0,0,65
6,18,5,25,1,12,9,20,5,101
6,18,5,9,7,8,20,0,0,73
6,18,5,9,7,8,20,5,4,82
6,18,5,9,7,8,20,5,18,96
6,18,5,9,7,8,20,19,0,92
6,18,5,9,10,15,0,0,0,63
6,18,5,9,14,1,7,5,0,65
6,18,5,9,18,0,0,0,0,56
6,18,5,9,20,0,0,0,0,58
6,18,5,9,20,8,0,0,0,66
6,18,5,9,20,25,0,0,0,83
6,18,5,13,4,0,0,0,0,46
6,18,5,13,4,12,25,0,0,83
6,18,5,13,4,14,5,19,19,103
6,18,5,13,9,20,21,19,0,111
6,18,5,13,20,0,0,0,0,62
6,18,5,14,0,0,0,0,0,43
6,18,5,14,1,0,0,0,0,44
6,18,5,14,1,12,0,0,0,56
6,18,5,14,1,20,5,0,0,69
6,18,5,14,3,8,5,4,0,63
6,18,5,14,3,8,5,14,0,73
6,18,5,14,3,8,5,19,0,78
6,18,5,14,3,8,9,14,7,84
6,18,5,14,5,20,9,3,0,80
6,18,5,14,5,20,9,3,19,99
6,18,5,14,14,5,0,0,0,62
6,18,5,14,21,12,1,0,0,77
6,18,5,14,21,12,1,18,0,95
6,18,5,14,21,12,21,13,0,110
6,18,5,14,21,13,0,0,0,77
6,18,5,14,21,13,19,0,0,96
6,18,5,14,21,14,1,0,0,79
6,18,5,14,26,25,0,0,0,94
6,18,5,14,26,9,3,0,0,81
6,18,5,14,26,9,5,4,0,87
6,18,5,14,26,9,5,19,0,102
6,18,5,14,26,25,9,14,7,124
6,18,5,14,26,9,12,25,0,115
6,18,5,17,0,0,0,0,0,46
6,18,5,17,21,5,14,3,5,94
6,18,5,17,21,5,14,3,25,114
6,18,5,17,21,5,14,20,0,106
6,18,5,17,21,5,14,20,19,125
6,18,5,18,5,19,0,0,0,71
6,18,5,19,3,1,4,5,0,61
6,18,5,19,3,15,0,0,0,66
6,18,5,19,3,15,5,4,0,75
6,18,5,19,3,15,5,18,0,89
6,18,5,19,3,15,5,18,19,108
6,18,5,19,3,15,5,19,0,90
6,18,5,19,3,15,9,14,7,96
6,18,5,19,3,15,9,19,20,114
6,18,5,19,3,15,19,0,0,85
6,18,5,19,8,0,0,0,0,56
6,18,5,19,8,5,4,0,0,65
6,18,5,19,8,5,14,0,0,75
6,18,5,19,8,5,14,5,4,84
6,18,5,19,8,5,14,5,18,98
6,18,5,19,8,5,14,19,0,94
6,18,5,19,8,5,18,0,0,79
6,18,5,19,8,5,19,0,0,80
6,18,5,19,8,5,19,20,0,100
6,18,5,19,8,5,20,0,0,81
6,18,5,19,8,5,20,19,0,100
6,18,5,19,8,9,14,7,0,86
6,18,5,19,8,9,19,8,0,92
6,18,5,19,8,12,25,0,0,93
6,18,5,19,8,13,1,14,0,84
6,18,5,19,8,13,5,14,0,88
6,18,5,19,8,13,5,14,20,108
6,18,5,19,8,14,5,19,19,113
6,18,5,19,14,5,0,0,0,67
6,18,5,19,14,5,12,19,0,98
6,18,5,19,19,0,0,0,0,67
6,18,5,19,19,5,18,0,0,90
6,18,5,20,0,0,0,0,0,49
6,18,5,20,6,21,12,0,0,88
6,18,5,20,6,21,12,12,25,125
6,18,5,20,9,19,8,0,0,85
6,18,5,20,9,26,5,0,0,89
6,18,5,20,12,5,19,19,0,104
6,18,5,20,19,0,0,0,0,68
6,18,5,20,19,1,23,0,0,92
6,18,5,20,19,1,23,19,0,111
6,18,5,20,19,15,13,5,0,101
6,18,5,20,20,0,0,0,0,69
6,18,5,20,20,1,7,5,0,82
6,18,5,20,20,5,0,0,0,74
6,18,5,20,20,5,4,0,0,78
6,18,5,20,20,5,14,0,0,88
6,18,5,20,20,5,18,0,0,92
6,18,5,20,20,5,18,19,0,111
6,18,5,20,20,25,0,0,0,94
6,18,5,20,20,9,5,18,0,101
6,18,5,20,20,9,5,19,20,122
6,18,5,20,20,9,14,7,0,99
6,18,5,20,21,13,0,0,0,83
6,18,5,20,23,1,25,19,0,117
6,18,5,20,23,9,19,5,0,105
6,18,5,20,23,15,18,11,0,116
6,18,5,20,23,15,18,11,19,135
6,18,5,21,4,9,1,14,19,97
6,18,9,1,2,12,5,0,0,53
6,18,9,1,14,4,0,0,0,52
6,18,9,1,14,4,9,19,5,85
6,18,9,1,18,0,0,0,0,52
6,18,9,1,18,2,9,18,4,85
6,18,9,1,18,8,15,15,4,94
6,18,9,1,18,25,0,0,0,77
6,18,9,1,18,9,5,19,0,85
6,18,9,1,18,12,25,0,0,89
6,18,9,1,18,12,9,14,7,94
6,18,9,1,18,19,0,0,0,71
6,18,9,1,20,9,15,14,0,92
6,18,9,2,0,0,0,0,0,35
6,18,9,2,2,25,0,0,0,62
6,18,9,2,2,12,5,0,0,54
6,18,9,2,2,12,5,4,0,58
6,18,9,2,2,12,5,18,0,72
6,18,9,2,2,12,5,18,25,97
6,18,9,2,2,12,5,18,19,91
6,18,9,2,2,12,5,19,0,73
6,18,9,2,2,12,9,14,7,79
6,18,9,2,2,12,9,19,8,85
6,18,9,2,15,18,7,0,0,75
6,18,9,2,15,18,7,8,0,83
6,18,9,3,1,3,5,0,0,45
6,18,9,3,1,14,4,5,12,72
6,18,9,3,1,14,4,15,0,70
6,18,9,3,1,19,19,5,5,85
6,18,9,3,1,20,9,15,14,95
6,18,9,3,1,20,9,22,5,93
6,18,9,3,11,12,5,0,0,64
6,18,9,3,20,9,0,0,0,65
6,18,9,3,20,9,15,14,0,94
6,18,9,3,20,9,15,14,19,113
6,18,9,4,7,5,0,0,0,49
6,18,9,4,7,5,19,0,0,68
6,18,9,4,19,20,15,15,12,118
6,18,9,5,4,3,1,11,5,62
6,18,9,5,14,4,5,4,0,65
6,18,9,5,14,4,9,14,7,86
6,18,9,5,14,4,19,0,0,75
6,18,9,5,18,0,0,0,0,56
6,18,25,5,18,0,0,0,0,72
6,18,9,5,18,19,0,0,0,75
6,18,25,5,18,19,0,0,0,91
6,18,9,5,19,5,0,0,0,62
6,18,9,5,19,5,9,20,5,96
6,18,9,5,26,5,0,0,0,69
6,18,9,5,26,5,4,0,0,73
6,18,9,5,26,5,18,0,0,87
6,18,9,5,26,5,19,0,0,88
6,18,9,5,26,25,0,0,0,89
6,18,9,5,26,9,14,7,0,94
6,18,9,7,0,0,0,0,0,40
6,18,9,7,1,7,5,0,0,53
6,18,9,7,1,20,5,0,0,66
6,18,9,7,1,20,5,19,0,85
6,18,9,7,1,20,15,15,14,105
6,18,9,7,5,6,1,3,20,75
6,18,9,7,7,5,4,0,0,56
6,18,9,7,7,5,18,0,0,70
6,18,9,7,7,9,14,7,0,77
6,18,9,7,7,12,5,0,0,64
6,18,9,7,8,20,0,0,0,68
6,18,9,7,8,20,5,4,0,77
6,18,9,7,8,20,5,14,0,87
6,18,9,7,8,20,5,14,19,106
6,18,9,7,8,20,5,18,0,91
6,18,9,7,8,20,6,21,12,107
6,18,9,7,8,20,25,0,0,93
6,18,9,7,8,20,9,14,7,98
6,18,9,7,8,20,19,0,0,87
6,18,9,7,9,4,0,0,0,53
6,18,9,7,9,4,9,20,25,107
6,18,9,7,9,4,12,25,0,90
6,18,9,7,15,18,0,0,0,73
6,18,9,7,15,18,9,3,0,85
6,18,9,7,15,18,9,6,25,113
6,18,9,7,19,0,0,0,0,59
6,18,25,9,14,7,0,0,0,79
6,18,9,10,15,12,0,0,0,70
6,18,9,10,15,12,5,0,0,75
6,18,9,10,15,12,5,19,0,94
6,18,9,10,15,12,9,20,15,114
6,18,9,11,5,0,0,0,0,49
6,18,9,12,1,12,0,0,0,58
6,18,9,12,12,0,0,0,0,57
6,18,9,12,12,2,1,3,11,74
6,18,9,12,12,5,4,0,0,66
6,18,9,12,12,5,18,0,0,80
6,18,9,12,12,5,18,25,0,105
6,18,9,12,12,5,18,19,0,99
6,18,9,12,12,25,0,0,0,82
6,18,9,12,12,9,5,18,0,89
6,18,9,12,12,9,5,19,0,90
6,18,9,12,12,9,5,19,20,110
6,18,9,12,12,9,12,25,0,103
6,18,9,12,12,9,14,7,0,87
6,18,9,12,12,9,14,7,19,106
6,18,9,12,12,19,0,0,0,76
6,18,9,13,0,0,0,0,0,46
6,18,9,13,9,20,20,19,0,114
6,18,9,14,7,5,0,0,0,59
6,18,9,14,7,5,4,0,0,63
6,18,9,14,7,5,12,5,20,96
6,18,9,14,7,5,14,20,0,93
6,18,9,14,7,5,16,15,4,94
6,18,9,14,7,5,19,0,0,78
6,18,9,14,7,25,0,0,0,79
6,18,9,14,7,9,5,18,0,86
6,18,9,14,7,9,5,19,20,107
6,18,9,14,7,9,14,7,0,84
6,18,25,16,1,14,0,0,0,80
6,18,25,16,1,14,19,0,0,99
6,18,9,16,16,5,18,0,0,88
6,18,9,16,16,5,18,5,18,111
6,18,9,16,16,5,18,25,0,113
6,18,9,16,16,5,20,0,0,90
6,18,9,19,1,4,15,0,0,72
6,18,9,19,2,5,5,19,0,83
6,18,9,19,3,1,0,0,0,56
6,18,9,19,3,1,12,0,0,68
6,18,9,19,5,0,0,0,0,57
6,18,9,19,5,19,0,0,0,76
6,18,9,19,5,20,20,5,0,102
6,18,9,19,5,20,20,5,19,121
6,18,9,19,5,21,18,0,0,96
6,18,9,19,5,21,18,19,0,115
6,18,9,19,11,0,0,0,0,63
6,18,9,19,11,5,4,0,0,72
6,18,9,19,11,5,18,0,0,86
6,18,9,19,11,5,18,19,0,105
6,18,9,19,11,5,19,20,0,107
6,18,9,19,11,5,20,0,0,88
6,18,9,19,11,5,20,19,0,107
6,18,9,19,11,6,21,12,0,102
6,18,9,19,11,25,0,0,0,88
6,18,9,19,11,9,5,18,0,95
6,18,9,19,11,9,5,19,20,116
6,18,9,19,11,9,12,25,0,109
6,18,9,19,11,9,14,0,0,86
6,18,9,19,11,9,14,7,0,93
6,18,9,19,11,12,5,0,0,80
6,18,9,19,11,19,0,0,0,82
6,18,9,19,12,5,20,0,0,89
6,18,9,19,15,12,5,5,0,89
6,18,9,19,15,14,0,0,0,81
6,18,9,19,19,0,0,0,0,71
6,18,9,19,19,15,14,0,0,100
6,18,9,19,19,15,14,19,0,119
6,18,9,19,20,0,0,0,0,72
6,18,9,19,21,18,5,0,0,96
6,18,9,19,26,11,1,0,0,90
6,18,9,20,0,0,0,0,0,53
6,18,9,20,8,0,0,0,0,61
6,18,9,20,8,2,15,18,8,104
6,18,9,20,8,2,15,20,0,98
6,18,9,20,8,25,0,0,0,86
6,18,9,20,8,12,5,19,0,97
6,18,9,20,8,19,0,0,0,80
6,18,9,20,8,23,15,18,11,128
6,18,9,20,20,0,0,0,0,73
6,18,9,20,20,1,20,1,0,95
6,18,9,20,20,5,4,0,0,82
6,18,9,20,20,5,18,0,0,96
6,18,9,20,20,5,18,5,4,105
6,18,9,20,20,5,18,5,18,119
6,18,9,20,20,5,18,19,0,115
6,18,9,20,20,9,14,7,0,103
6,18,9,20,26,5,19,0,0,103
6,18,9,22,15,12,0,0,0,82
6,18,9,22,15,12,5,4,0,91
6,18,9,22,15,12,5,18,0,105
6,18,9,22,15,12,5,18,19,124
6,18,9,22,15,12,9,14,7,112
6,18,9,22,15,12,9,19,13,123
6,18,9,22,15,12,9,19,20,130
6,18,9,22,15,12,9,20,25,136
6,18,9,22,15,12,9,26,5,122
6,18,9,22,15,12,12,5,4,103
6,18,9,22,15,12,12,5,18,117
6,18,9,22,15,12,15,21,19,137
6,18,9,22,15,12,19,0,0,101
6,18,9,24,9,15,14,0,0,95
6,18,9,26,0,0,0,0,0,59
6,18,9,26,1,4,15,0,0,79
6,18,9,26,5,0,0,0,0,64
6,18,9,26,5,4,0,0,0,68
6,18,9,26,5,12,0,0,0,76
6,18,9,26,5,18,0,0,0,82
6,18,9,26,5,18,19,0,0,101
6,18,9,26,5,19,0,0,0,83
6,18,9,26,5,20,20,5,0,109
6,18,9,26,5,20,20,5,19,128
6,18,9,26,9,14,7,0,0,89
6,18,9,26,26,0,0,0,0,85
6,18,9,26,26,1,14,20,5,125
6,18,9,26,26,5,4,0,0,94
6,18,9,26,26,5,14,0,0,104
6,18,9,26,26,5,18,0,0,108
6,18,9,26,26,5,18,19,0,127
6,18,9,26,26,5,19,0,0,109
6,18,9,26,26,25,0,0,0,110
6,18,9,26,26,9,5,18,0,117
6,18,9,26,26,9,5,19,20,138
6,18,9,26,26,9,12,25,0,131
6,18,9,26,26,9,14,7,0,115
6,18,9,26,26,12,5,0,0,102
6,18,9,26,26,12,5,4,0,106
6,18,9,26,26,12,5,18,0,120
6,18,9,26,26,12,5,18,19,139
6,18,9,26,26,12,5,19,0,121
6,18,9,26,26,12,25,0,0,122
6,18,9,26,26,12,9,5,18,129
6,18,9,26,26,12,9,14,7,127
6,18,15,0,0,0,0,0,0,39
6,18,15,3,11,0,0,0,0,53
6,18,15,3,11,5,4,0,0,62
6,18,15,3,11,9,14,7,0,83
6,18,15,3,11,12,5,19,19,108
6,18,15,3,11,12,9,11,5,90
6,18,15,3,11,19,0,0,0,72
6,18,15,5,0,0,0,0,0,44
6,18,15,5,13,1,14,0,0,72
6,18,15,5,19,0,0,0,0,63
6,18,15,7,2,9,20,0,0,77
6,18,15,7,5,1,20,5,18,95
6,18,15,7,5,25,5,0,0,81
6,18,15,7,5,25,5,4,0,85
6,18,15,7,5,25,5,19,0,100
6,18,15,7,6,1,3,5,0,61
6,18,15,7,6,9,19,8,0,88
6,18,15,7,6,15,15,20,0,102
6,18,15,7,7,5,4,0,0,62
6,18,15,7,7,5,18,0,0,76
6,18,15,7,7,5,18,25,0,101
6,18,15,7,7,25,0,0,0,78
6,18,15,7,7,9,5,18,0,85
6,18,15,7,7,9,5,19,0,86
6,18,15,7,7,9,5,19,20,106
6,18,15,7,7,9,14,7,0,83
6,18,15,7,7,9,19,8,0,89
6,18,15,7,8,15,15,4,0,88
6,18,15,7,12,1,14,4,0,77
6,18,15,7,12,5,1,6,0,70
6,18,15,7,12,5,7,0,0,70
6,18,15,7,12,5,20,0,0,83
6,18,15,7,12,5,20,19,0,102
6,18,15,7,12,9,11,5,0,83
6,18,15,7,12,9,14,7,0,88
6,18,15,7,13,1,14,0,0,74
6,18,15,7,13,1,18,3,8,89
6,18,15,7,13,5,14,0,0,78
6,18,15,7,13,15,21,20,8,123
6,18,15,7,14,15,19,5,0,99
6,18,15,7,19,0,0,0,0,65
6,18,15,7,19,11,9,14,0,99
6,18,15,7,19,11,9,14,19,118
6,18,15,7,19,16,1,23,14,119
6,18,15,7,19,20,15,15,12,127
6,18,15,7,23,15,18,20,0,122
6,18,15,8,12,9,3,8,0,79
6,18,15,9,4,5,21,18,0,96
6,18,15,9,19,5,0,0,0,72
6,18,15,9,19,19,5,0,0,91
6,18,15,11,9,14,0,0,0,73
6,18,15,12,9,3,0,0,0,63
6,18,15,12,9,3,6,21,12,102
6,18,15,12,9,3,11,5,4,83
6,18,15,12,9,3,11,5,18,97
6,18,15,12,9,3,11,25,0,99
6,18,15,12,9,3,11,12,25,111
6,18,15,12,9,3,11,19,0,93
6,18,15,12,9,3,12,25,0,100
6,18,15,12,9,3,19,0,0,82
6,18,15,13,0,0,0,0,0,52
6,18,15,13,1,7,5,0,0,65
6,18,15,13,1,7,5,19,0,84
6,18,15,13,5,14,20,25,0,116
6,18,15,13,6,9,12,5,0,84
6,18,15,13,23,1,18,4,0,98
6,18,15,13,23,1,18,4,19,117
6,18,15,14,4,0,0,0,0,57
6,18,15,14,4,1,7,5,0,70
6,18,15,14,4,5,4,0,0,66
6,18,15,14,4,5,14,20,0,96
6,18,15,14,4,5,19,3,5,89
6,18,15,14,4,5,21,18,19,120
6,18,15,14,4,12,5,19,19,112
6,18,15,14,4,12,5,20,0,94
6,18,15,14,4,15,19,5,0,96
6,18,15,14,4,15,21,19,0,112
6,18,15,14,4,19,0,0,0,76
6,18,15,14,19,0,0,0,0,72
6,18,15,14,20,0,0,0,0,73
6,18,15,14,20,1,4,0,0,78
6,18,15,14,20,1,7,5,0,86
6,18,15,14,20,1,7,5,18,104
6,18,15,14,20,1,7,5,19,105
6,18,15,14,20,1,12,0,0,86
6,18,15,14,20,1,12,9,19,114
6,18,15,14,20,1,12,12,25,123
6,18,15,14,20,1,12,19,0,105
6,18,15,14,20,1,20,5,0,99
6,18,15,14,20,5,4,0,0,82
6,18,15,14,20,5,14,9,19,120
6,18,15,14,20,5,18,0,0,96
6,18,15,14,20,5,19,0,0,97
6,18,15,14,20,9,5,18,0,105
6,18,15,14,20,9,5,18,19,124
6,18,15,14,20,9,14,7,0,103
6,18,15,14,20,9,19,0,0,101
6,18,15,14,20,12,1,19,8,113
6,18,15,14,20,12,5,19,19,128
6,18,15,14,20,12,5,20,0,110
6,18,15,14,20,12,5,20,19,129
6,18,15,14,20,15,14,0,0,102
6,18,15,14,20,15,14,19,0,121
6,18,15,14,20,19,0,0,0,92
6,18,15,14,20,19,13,1,14,120
6,18,15,14,20,21,18,5,0,117
6,18,15,14,20,23,1,25,19,141
6,18,15,14,20,23,1,18,4,119
6,18,15,14,20,23,9,19,5,129
6,18,15,15,13,0,0,0,0,67
6,18,15,16,16,9,19,8,0,107
6,18,15,18,5,0,0,0,0,62
6,18,15,18,5,14,0,0,0,76
6,18,15,18,25,0,0,0,0,82
6,18,15,19,8,0,0,0,0,66
6,18,15,19,11,0,0,0,0,69
6,18,15,19,20,2,9,18,4,111
6,18,15,19,20,2,9,20,0,109
6,18,15,19,20,2,9,20,5,114
6,18,15,19,20,2,15,23,0,118
6,18,15,19,20,5,4,0,0,87
6,18,15,19,20,5,4,19,0,106
6,18,15,19,20,5,18,0,0,101
6,18,15,19,20,6,9,19,8,120
6,18,15,19,20,25,0,0,0,103
6,18,15,19,20,9,5,18,0,110
6,18,15,19,20,9,5,19,20,131
6,18,15,19,20,9,12,25,0,124
6,18,15,19,20,9,14,7,0,108
6,18,15,19,20,9,14,7,19,127
6,18,15,19,20,12,5,19,19,133
6,18,15,19,20,12,9,11,5,115
6,18,15,19,20,18,15,15,20,146
6,18,15,19,20,19,0,0,0,97
6,18,15,19,20,23,5,5,4,115
6,18,15,19,20,23,15,18,11,145
6,18,15,19,20,23,15,18,20,154
6,18,15,20,0,0,0,0,0,59
6,18,15,20,8,0,0,0,0,67
6,18,15,20,8,5,4,0,0,76
6,18,15,20,8,5,18,0,0,90
6,18,15,20,8,25,0,0,0,92
6,18,15,20,8,9,5,18,0,99
6,18,15,20,8,9,5,19,20,120
6,18,15,20,8,9,12,25,0,113
6,18,15,20,8,9,14,7,0,97
6,18,15,20,8,12,5,19,19,122
6,18,15,20,8,19,0,0,0,86
6,18,15,20,8,19,15,13,5,119
6,18,15,20,20,1,7,5,0,92
6,18,15,20,20,1,7,5,19,111
6,18,15,20,20,5,4,0,0,88
6,18,15,20,20,5,21,18,0,123
6,18,15,20,20,5,21,18,19,142
6,18,15,20,20,9,14,7,0,109
6,18,15,20,20,15,12,1,0,107
6,18,15,20,20,15,12,5,0,111
6,18,15,20,20,15,14,0,0,108
6,18,15,21,6,18,15,21,0,120
6,18,15,21,6,18,15,21,19,139
6,18,15,21,7,8,0,0,0,75
6,18,15,21,7,8,25,0,0,100
6,18,15,21,14,3,5,0,0,82
6,18,15,21,14,3,5,4,0,86
6,18,15,21,14,3,5,19,0,101
6,18,15,21,14,3,9,14,7,107
6,18,15,21,19,25,0,0,0,104
6,18,15,21,19,9,5,18,0,111
6,18,15,21,19,9,5,19,20,132
6,18,15,21,19,20,0,0,0,99
6,18,15,21,19,20,25,0,0,124
6,18,15,21,26,5,0,0,0,91
6,18,15,21,26,25,0,0,0,111
6,18,15,21,26,9,5,18,0,118
6,18,15,21,26,9,5,19,20,139
6,18,15,23,0,0,0,0,0,62
6,18,15,23,1,18,4,0,0,85
6,18,15,23,1,18,4,12,25,122
6,18,15,23,5,18,0,0,0,85
6,18,15,23,25,0,0,0,0,87
6,18,15,23,12,0,0,0,0,74
6,18,15,23,14,0,0,0,0,76
6,18,15,23,14,5,4,0,0,85
6,18,15,23,14,5,18,0,0,99
6,18,15,23,14,5,18,19,0,118
6,18,15,23,14,6,21,12,0,115
6,18,15,23,14,25,0,0,0,101
6,18,15,23,14,9,14,7,0,106
6,18,15,23,14,12,5,19,19,131
6,18,15,23,14,19,0,0,0,95
6,18,15,23,19,0,0,0,0,81
6,18,15,23,19,25,0,0,0,106
6,18,15,23,19,9,5,18,0,113
6,18,15,23,19,9,5,19,20,134
6,18,15,23,19,9,12,25,0,127
6,18,15,23,19,20,0,0,0,101
6,18,15,23,19,20,5,4,0,110
6,18,15,23,19,20,25,0,0,126
6,18,15,23,19,20,9,5,18,133
6,18,15,23,19,20,9,12,25,147
6,18,15,23,19,20,19,0,0,120
6,18,15,23,26,5,0,0,0,93
6,18,15,23,26,25,0,0,0,113
6,18,15,23,26,9,5,18,0,120
6,18,15,23,26,9,5,19,20,141
6,18,15,23,26,9,12,25,0,134
6,18,15,23,26,12,5,4,0,109
6,18,15,23,26,12,25,0,0,125
6,18,15,26,5,0,0,0,0,70
6,18,15,26,5,14,0,0,0,84
6,18,15,26,5,14,12,25,0,121
6,18,19,9,11,5,20,0,0,88
6,18,19,9,11,5,20,19,0,107
6,18,20,0,0,0,0,0,0,44
6,18,21,2,2,9,19,8,0,85
6,18,21,3,20,5,4,0,0,77
6,18,21,3,20,9,6,25,0,108
6,18,21,3,20,15,19,1,14,117
6,18,21,3,20,15,19,5,0,107
6,18,21,3,20,15,19,5,19,126
6,18,21,3,20,21,1,18,25,133
6,18,21,3,20,21,1,20,5,115
6,18,21,3,20,21,15,19,5,128
6,18,21,3,20,21,15,21,19,144
6,18,21,3,20,21,18,5,0,112
6,18,21,3,20,21,19,0,0,108
6,18,21,7,0,0,0,0,0,52
6,18,21,7,1,12,0,0,0,65
6,18,21,7,1,12,9,19,13,106
6,18,21,7,1,12,9,19,20,113
6,18,21,7,1,12,9,20,25,119
6,18,21,7,1,12,12,25,0,102
6,18,21,7,7,1,14,0,0,74
6,18,21,7,7,5,4,0,0,68
6,18,21,7,7,9,14,0,0,82
6,18,21,7,7,9,14,7,0,89
6,18,21,7,19,0,0,0,0,71
6,18,21,9,20,0,0,0,0,74
6,18,21,9,20,1,4,5,0,84
6,18,21,9,20,1,7,5,0,87
6,18,21,9,20,1,7,5,19,106
6,18,21,9,20,3,1,11,5,94
6,18,21,9,20,5,4,0,0,83
6,18,21,9,20,5,18,0,0,97
6,18,21,9,20,5,18,5,18,120
6,18,21,9,20,5,18,25,0,122
6,18,21,9,20,5,18,19,0,116
6,18,21,9,20,6,21,12,0,113
6,18,21,9,20,25,0,0,0,99
6,18,21,9,20,9,5,18,0,106
6,18,21,9,20,9,5,19,20,127
6,18,21,9,20,9,12,25,0,120
6,18,21,9,20,9,14,7,0,104
6,18,21,9,20,9,15,14,0,112
6,18,21,9,20,9,15,14,19,131
6,18,21,9,20,9,19,20,0,122
6,18,21,9,20,9,22,5,0,110
6,18,21,9,20,12,5,19,19,129
6,18,21,9,20,12,5,20,0,111
6,18,21,9,20,12,5,20,19,130
6,18,21,9,20,12,9,11,5,111
6,18,21,9,20,12,9,14,7,116
6,18,21,9,20,19,0,0,0,93
6,18,21,9,20,20,9,13,5,121
6,18,21,9,20,23,9,19,5,130
6,18,21,9,20,23,15,15,4,131
6,18,21,9,20,23,15,18,13,143
6,18,21,13,1,18,25,12,0,114
6,18,21,13,5,14,20,0,0,97
6,18,21,13,5,14,20,25,0,122
6,18,21,13,5,14,20,21,13,131
6,18,21,13,5,20,25,0,0,108
6,18,21,13,16,0,0,0,0,74
6,18,21,13,16,5,18,25,0,122
6,18,21,13,16,25,0,0,0,99
6,18,21,13,16,9,5,18,0,106
6,18,21,13,16,9,5,19,20,127
6,18,21,13,16,9,12,25,0,120
6,18,21,13,16,9,19,8,0,110
6,18,21,13,16,12,5,0,0,91
6,18,21,13,16,12,5,4,0,95
6,18,21,13,16,12,9,14,7,116
6,18,21,13,16,19,0,0,0,93
6,18,21,14,4,5,12,0,0,80
6,18,21,19,8,0,0,0,0,72
6,18,21,19,12,1,0,0,0,77
6,18,21,19,20,0,0,0,0,84
6,18,21,19,20,1,0,0,0,85
6,18,21,19,20,18,1,20,5,128
6,18,21,19,20,21,12,1,0,118
6,18,21,19,20,21,12,5,0,122
6,18,21,19,20,21,12,5,19,141
6,18,21,19,20,21,12,21,13,151
6,18,21,19,20,21,13,0,0,118
6,18,21,19,20,21,13,19,0,137
6,18,21,20,1,7,5,0,0,78
6,18,21,20,5,24,0,0,0,94
6,18,21,20,9,3,1,14,20,112
6,18,21,20,9,3,5,19,0,101
6,18,21,20,9,3,5,20,1,103
6,18,21,20,9,3,15,19,5,116
6,18,21,20,9,3,15,21,19,132
6,18,21,20,9,6,25,0,0,105
6,18,21,20,9,12,12,1,0,99
6,18,21,26,0,0,0,0,0,71
6,18,23,25,0,0,0,0,0,72
6,19,9,5,19,20,0,0,0,78
6,19,20,15,18,5,0,0,0,83
6,20,8,0,0,0,0,0,0,34
6,20,8,13,0,0,0,0,0,47
6,20,14,3,13,4,0,0,0,60
6,20,14,5,18,18,0,0,0,81
6,21,2,0,0,0,0,0,0,29
6,21,2,2,5,4,0,0,0,40
6,21,2,2,5,18,25,0,0,79
6,21,2,2,25,0,0,0,0,56
6,21,2,2,9,14,7,0,0,61
6,21,2,19,0,0,0,0,0,48
6,21,2,19,25,0,0,0,0,73
6,21,2,19,9,5,18,0,0,80
6,21,2,19,9,5,19,20,0,101
6,21,3,1,3,5,15,21,19,94
6,21,3,1,20,5,0,0,0,56
6,21,3,1,20,9,15,14,0,89
6,21,3,1,20,9,15,21,19,115
6,21,3,8,9,0,0,0,0,47
6,21,3,8,19,9,1,19,0,86
6,21,3,8,19,9,14,0,0,80
6,21,3,8,19,9,14,5,0,85
6,21,3,8,19,9,14,5,19,104
6,21,3,8,19,9,14,19,0,99
6,21,3,8,19,9,20,5,0,91
6,21,3,8,19,15,14,5,0,91
6,21,3,9,0,0,0,0,0,39
6,21,3,9,14,9,20,1,0,83
6,21,3,11,0,0,0,0,0,41
6,21,3,11,5,4,0,0,0,50
6,21,3,11,5,18,0,0,0,64
6,21,3,11,5,18,19,0,0,83
6,21,3,11,9,14,7,0,0,71
6,21,3,11,19,0,0,0,0,60
6,21,3,11,21,16,0,0,0,78
6,21,3,11,21,16,19,0,0,97
6,21,3,11,23,9,20,0,0,93
6,21,3,15,9,4,0,0,0,58
6,21,3,15,9,4,1,12,0,71
6,21,3,15,9,4,9,14,0,81
6,21,3,15,9,4,19,0,0,77
6,21,3,15,19,1,14,0,0,79
6,21,3,15,19,5,0,0,0,69
6,21,3,15,19,5,19,0,0,88
6,21,3,15,21,19,0,0,0,85
6,21,3,21,19,0,0,0,0,70
6,21,3,21,19,5,4,0,0,79
6,21,3,21,19,5,19,0,0,94
6,21,4,4,5,18,0,0,0,58
6,21,4,4,12,5,0,0,0,52
6,21,4,4,12,5,4,0,0,56
6,21,4,4,12,5,18,0,0,70
6,21,4,4,12,5,19,0,0,71
6,21,4,4,12,9,14,7,0,77
6,21,4,5,18,0,0,0,0,54
6,21,4,7,5,0,0,0,0,43
6,21,4,7,5,4,0,0,0,47
6,21,4,7,5,18,0,0,0,61
6,21,4,7,5,19,0,0,0,62
6,21,4,7,25,0,0,0,0,63
6,21,4,7,9,14,7,0,0,68
6,21,4,19,0,0,0,0,0,50
6,21,5,8,18,5,18,19,0,100
6,21,5,12,0,0,0,0,0,44
6,21,5,12,5,4,0,0,0,53
6,21,5,12,5,18,0,0,0,67
6,21,5,12,5,18,19,0,0,86
6,21,5,12,9,14,7,0,0,74
6,21,5,12,9,26,5,18,0,102
6,21,5,12,12,5,4,0,0,65
6,21,5,12,12,5,18,0,0,79
6,21,5,12,12,5,18,19,0,98
6,21,5,12,12,9,14,7,0,86
6,21,5,12,19,0,0,0,0,63
6,21,5,12,23,15,15,4,0,101
6,21,5,18,20,5,0,0,0,75
6,21,6,6,0,0,0,0,0,39
6,21,6,6,25,0,0,0,0,64
6,21,6,6,9,20,0,0,0,68
6,21,6,6,12,5,0,0,0,56
6,21,7,0,0,0,0,0,0,34
6,21,7,1,3,25,0,0,0,63
6,21,7,1,3,9,15,21,19,102
6,21,7,1,3,9,20,25,0,92
6,21,7,1,12,0,0,0,0,47
6,21,7,1,12,12,25,0,0,84
6,21,7,1,18,1,0,0,0,54
6,21,7,1,18,4,0,0,0,57
6,21,7,1,20,15,0,0,0,70
6,21,7,1,20,15,19,0,0,89
6,21,7,5,0,0,0,0,0,39
6,21,7,7,5,4,0,0,0,50
6,21,7,7,25,0,0,0,0,66
6,21,7,7,9,5,18,0,0,73
6,21,7,7,9,5,19,20,0,94
6,21,7,7,9,12,25,0,0,87
6,21,7,7,9,14,7,0,0,71
6,21,7,8,5,20,20,1,0,88
6,21,7,8,5,20,20,1,19,107
6,21,7,8,5,20,20,5,0,92
6,21,7,9,5,0,0,0,0,48
6,21,7,9,5,14,20,0,0,82
6,21,7,9,15,0,0,0,0,58
6,21,7,9,15,19,0,0,0,77
6,21,7,9,20,0,0,0,0,63
6,21,7,9,20,1,20,5,0,89
6,21,7,9,20,1,20,5,4,93
6,21,7,9,20,9,22,5,0,99
6,21,7,9,20,9,22,5,19,118
6,21,7,12,5,0,0,0,0,51
6,21,7,12,5,4,0,0,0,55
6,21,7,12,5,13,1,14,0,79
6,21,7,12,5,13,5,14,0,83
6,21,7,12,5,18,0,0,0,69
6,21,7,12,5,19,0,0,0,70
6,21,7,12,9,14,7,0,0,76
6,21,7,19,0,0,0,0,0,53
6,21,7,21,0,0,0,0,0,55
6,21,7,21,5,0,0,0,0,60
6,21,7,21,5,4,0,0,0,64
6,21,7,21,5,12,9,11,5,97
6,21,7,21,5,19,0,0,0,79
6,21,7,21,9,14,7,0,0,85
6,21,7,21,9,19,20,0,0,103
6,21,7,21,9,19,20,19,0,122
6,21,7,21,19,0,0,0,0,74
6,21,8,18,5,18,19,0,0,95
6,21,9,4,8,9,18,0,0,75
6,21,25,5,0,0,0,0,0,57
6,21,9,18,4,1,25,19,0,103
6,21,10,9,19,0,0,0,0,65
6,21,12,0,0,0,0,0,0,39
6,21,12,3,9,6,15,18,13,103
6,21,12,3,9,13,5,14,20,103
6,21,12,3,18,1,0,0,0,61
6,21,12,3,18,1,12,0,0,73
6,21,12,3,18,1,20,5,0,86
6,21,12,3,18,21,13,0,0,94
6,21,12,3,18,21,13,5,4,103
6,21,12,3,18,21,13,19,0,113
6,21,12,6,9,12,0,0,0,66
6,21,12,6,9,12,12,0,0,78
6,21,12,6,9,12,12,5,4,87
6,21,12,6,9,12,12,5,18,101
6,21,12,6,9,12,12,19,0,97
6,21,12,6,9,12,19,0,0,85
6,21,12,6,21,12,0,0,0,78
6,21,12,7,5,14,3,5,0,73
6,21,12,7,5,14,3,25,0,93
6,21,12,7,5,14,20,0,0,85
6,21,12,7,5,14,20,12,25,122
6,21,12,7,9,4,0,0,0,59
6,21,12,7,9,4,5,0,0,64
6,21,12,7,9,4,9,20,25,113
6,21,12,7,15,18,0,0,0,79
6,21,12,7,15,18,9,4,0,92
6,21,12,7,15,18,15,21,19,134
6,21,12,7,15,21,18,0,0,100
6,21,12,7,21,18,1,12,0,98
6,21,12,7,21,18,1,14,20,120
6,21,12,7,21,18,1,20,1,107
6,21,12,7,21,18,1,20,5,111
6,21,12,7,21,18,9,20,5,119
6,21,12,7,21,18,15,21,19,140
6,21,12,8,1,13,19,0,0,80
6,21,12,9,3,9,14,5,0,79
6,21,12,9,7,15,0,0,0,70
6,21,12,25,9,5,0,0,0,78
6,21,12,9,13,1,18,20,0,100
6,21,12,11,0,0,0,0,0,50
6,21,12,12,0,0,0,0,0,51
6,21,12,12,1,7,5,0,0,64
6,21,12,12,1,13,0,0,0,65
6,21,12,12,1,13,19,0,0,84
6,21,12,12,2,1,3,11,0,68
6,21,12,12,2,1,3,11,19,87
6,21,12,12,4,15,0,0,0,70
6,21,12,12,5,4,0,0,0,60
6,21,12,12,5,18,5,4,0,83
6,21,12,12,5,18,25,0,0,99
6,21,12,12,5,18,9,5,19,107
6,21,12,12,5,18,9,14,7,104
6,21,12,12,5,18,19,0,0,93
6,21,12,12,5,19,20,0,0,95
6,21,12,12,6,1,3,5,0,66
6,21,12,12,6,1,3,5,19,85
6,21,12,12,6,9,12,0,0,78
6,21,12,12,25,0,0,0,0,76
6,21,12,12,25,13,1,18,20,128
6,21,12,12,9,14,7,0,0,81
6,21,12,12,9,19,8,0,0,87
6,21,12,12,13,15,21,20,8,128
6,21,12,12,14,5,19,19,0,108
6,21,12,12,15,13,0,0,0,79
6,21,12,12,19,0,0,0,0,70
6,21,12,12,20,5,18,13,0,107
6,21,12,12,20,9,13,5,0,98
6,21,12,12,23,15,18,4,0,111
6,21,12,12,23,15,18,4,19,130
6,21,12,13,1,18,0,0,0,71
6,21,12,13,1,18,19,0,0,90
6,21,12,13,5,14,0,0,0,71
6,21,12,13,9,14,1,0,0,76
6,21,12,13,9,14,1,14,20,110
6,21,12,13,9,14,1,20,5,101
6,21,12,13,9,14,5,0,0,80
6,21,12,13,9,14,5,4,0,84
6,21,12,13,9,14,5,19,0,99
6,21,12,13,9,14,9,3,0,87
6,21,12,13,9,14,9,14,7,105
6,21,12,13,9,14,15,21,19,130
6,21,12,14,5,19,19,0,0,96
6,21,12,14,5,19,19,5,19,120
6,21,12,19,1,13,9,3,0,84
6,21,12,19,15,13,5,0,0,91
6,21,12,19,15,13,5,12,25,128
6,21,12,20,8,0,0,0,0,67
6,21,12,22,5,14,5,0,0,85
6,21,12,22,9,4,0,0,0,74
6,21,12,22,15,21,19,0,0,116
6,21,12,23,1,0,0,0,0,63
6,21,12,26,9,5,0,0,0,79
6,21,13,0,0,0,0,0,0,40
6,21,13,1,3,9,15,21,19,108
6,21,13,1,4,5,0,0,0,50
6,21,13,1,4,15,0,0,0,60
6,21,13,1,4,15,19,0,0,79
6,21,13,1,7,5,0,0,0,53
6,21,13,1,7,9,14,5,0,76
6,21,13,1,14,20,0,0,0,75
6,21,13,1,18,1,19,5,0,84
6,21,13,1,18,1,19,5,19,103
6,21,13,1,18,1,20,5,0,85
6,21,13,1,18,1,20,5,19,104
6,21,13,1,18,9,3,0,0,71
6,21,13,1,18,25,12,0,0,96
6,21,13,1,18,9,14,0,0,82
6,21,13,1,18,9,14,5,0,87
6,21,13,1,18,9,21,13,0,102
6,21,13,1,18,15,9,4,0,87
6,21,13,1,18,15,12,5,0,91
6,21,13,1,18,15,12,5,19,110
6,21,13,1,18,15,12,9,3,98
6,21,13,1,20,15,18,25,0,119
6,21,13,1,20,15,18,9,1,104
6,21,13,2,12,5,0,0,0,59
6,21,13,2,12,5,4,0,0,63
6,21,13,2,12,5,18,0,0,77
6,21,13,2,12,5,18,19,0,96
6,21,13,2,12,5,19,0,0,78
6,21,13,2,12,9,14,7,0,84
6,21,13,5,0,0,0,0,0,45
6,21,13,5,4,0,0,0,0,49
6,21,13,5,12,5,19,19,0,100
6,21,13,5,12,9,11,5,0,82
6,21,13,5,18,0,0,0,0,63
6,21,13,5,18,5,12,0,0,80
6,21,13,5,18,15,15,20,0,113
6,21,13,5,18,19,0,0,0,82
6,21,13,5,19,0,0,0,0,64
6,21,13,5,20,0,0,0,0,65
6,21,13,5,20,19,0,0,0,84
6,21,13,5,20,20,5,0,0,90
6,21,13,5,20,20,5,19,0,109
6,21,13,5,21,19,5,0,0,90
6,21,13,5,21,19,5,19,0,109
6,21,13,5,23,15,18,20,0,121
6,21,13,25,0,0,0,0,0,65
6,21,13,9,4,0,0,0,0,53
6,21,13,9,4,9,20,25,0,107
6,21,13,9,4,21,3,20,0,97
6,21,13,9,5,18,0,0,0,72
6,21,13,9,5,19,20,0,0,93
6,21,13,9,6,25,0,0,0,80
6,21,13,9,7,1,14,20,0,91
6,21,13,9,7,1,14,20,19,110
6,21,13,9,7,1,20,5,0,82
6,21,13,9,7,1,20,5,4,86
6,21,13,9,7,1,20,5,19,101
6,21,13,9,7,1,20,15,18,110
6,21,13,9,12,25,0,0,0,86
6,21,13,9,14,5,19,19,0,106
6,21,13,9,14,7,0,0,0,70
6,21,13,9,14,7,12,25,0,107
6,21,13,9,19,8,0,0,0,76
6,21,13,9,19,8,9,14,7,106
6,21,13,9,19,8,12,25,0,113
6,21,13,9,19,20,5,18,25,136
6,21,13,9,20,15,18,25,0,127
6,21,13,13,5,12,0,0,0,70
6,21,13,13,12,5,0,0,0,70
6,21,13,15,19,5,0,0,0,79
6,21,13,15,19,9,20,25,0,128
6,21,13,15,21,19,0,0,0,95
6,21,13,15,21,19,12,25,0,132
6,21,13,21,12,9,0,0,0,82
6,21,13,21,12,21,19,0,0,113
6,21,14,0,0,0,0,0,0,41
6,21,14,1,13,2,21,12,5,95
6,21,14,1,13,2,21,12,15,105
6,21,14,2,18,5,0,0,0,66
6,21,14,3,20,9,15,14,0,102
6,21,14,3,20,9,15,14,19,121
6,21,14,3,20,15,18,0,0,97
6,21,14,3,20,15,18,19,0,116
6,21,14,3,20,21,19,0,0,104
6,21,14,4,0,0,0,0,0,45
6,21,14,4,1,2,12,5,0,65
6,21,14,4,1,12,0,0,0,58
6,21,14,4,1,13,5,14,20,98
6,21,14,4,1,20,18,9,24,117
6,21,14,4,5,4,0,0,0,54
6,21,14,4,5,18,0,0,0,68
6,21,14,4,5,18,19,0,0,87
6,21,14,4,9,0,0,0,0,54
6,21,14,4,9,3,0,0,0,57
6,21,14,4,9,6,15,18,13,106
6,21,14,4,9,14,7,0,0,75
6,21,14,4,9,20,15,18,0,107
6,21,14,4,12,5,19,19,0,100
6,21,14,4,18,1,9,19,5,97
6,21,14,4,19,0,0,0,0,64
6,21,14,4,21,3,11,0,0,80
6,21,14,4,21,12,9,14,5,106
6,21,14,4,21,14,7,9,0,96
6,21,14,4,21,19,0,0,0,85
6,21,14,5,2,18,5,0,0,71
6,21,14,5,2,18,9,1,12,88
6,21,14,5,2,18,15,21,19,121
6,21,14,5,18,1,12,0,0,77
6,21,14,5,18,1,12,12,25,114
6,21,14,5,18,1,12,19,0,96
6,21,14,5,18,1,18,25,0,108
6,21,14,5,18,1,20,5,0,90
6,21,14,5,18,5,1,12,0,82
6,21,14,5,19,20,0,0,0,85
6,21,14,5,19,20,1,12,0,98
6,21,14,6,1,9,18,0,0,75
6,21,14,6,1,9,18,19,0,94
6,21,14,6,5,19,20,0,0,91
6,21,14,7,1,12,0,0,0,61
6,21,14,7,1,12,19,0,0,80
6,21,14,7,1,20,5,0,0,74
6,21,14,7,1,20,5,4,0,78
6,21,14,7,1,20,9,14,7,99
6,21,14,7,1,20,9,15,14,107
6,21,14,7,5,0,0,0,0,53
6,21,14,7,9,0,0,0,0,57
6,21,14,7,9,1,14,0,0,72
6,21,14,7,9,2,12,5,0,76
6,21,14,7,9,2,12,5,19,95
6,21,14,7,9,3,0,0,0,60
6,21,14,7,9,3,9,4,5,78
6,21,14,7,9,4,0,0,0,61
6,21,14,7,9,6,25,0,0,88
6,21,14,7,9,6,15,18,13,109
6,21,14,7,9,12,12,21,19,121
6,21,14,7,9,14,0,0,0,71
6,21,14,7,9,19,20,1,20,117
6,21,14,7,9,20,5,0,0,82
6,21,14,7,15,0,0,0,0,63
6,21,14,7,15,5,19,0,0,87
6,21,14,7,15,9,4,0,0,76
6,21,14,7,15,9,4,1,12,89
6,21,14,7,15,9,4,19,0,95
6,21,14,7,15,12,15,7,25,122
6,21,14,7,15,19,5,0,0,87
6,21,14,7,15,19,9,20,25,136
6,21,14,7,15,21,19,0,0,103
6,21,14,7,21,19,0,0,0,88
6,21,14,7,21,19,5,4,0,97
6,21,14,7,21,19,5,19,0,112
6,21,14,7,21,19,25,0,0,113
6,21,14,9,3,0,0,0,0,53
6,21,14,9,3,12,5,0,0,70
6,21,14,9,3,12,5,19,0,89
6,21,14,9,3,21,12,1,18,105
6,21,14,9,3,21,12,5,0,91
6,21,14,9,3,21,12,9,0,95
6,21,14,9,3,21,12,21,19,126
6,21,14,9,6,15,18,13,0,102
6,21,14,9,19,0,0,0,0,69
6,21,14,11,5,4,0,0,0,61
6,21,14,11,5,18,0,0,0,75
6,21,14,11,5,18,19,0,0,94
6,21,14,11,25,0,0,0,0,77
6,21,14,11,9,1,19,0,0,81
6,21,14,11,9,5,18,0,0,84
6,21,14,11,9,5,19,20,0,105
6,21,14,11,9,14,5,19,19,118
6,21,14,11,9,14,7,0,0,82
6,21,14,11,19,0,0,0,0,71
6,21,14,12,9,0,0,0,0,62
6,21,14,13,1,11,5,18,0,89
6,21,14,13,1,11,9,14,7,96
6,21,14,14,5,4,0,0,0,64
6,21,14,14,5,12,0,0,0,72
6,21,14,14,5,12,5,4,0,81
6,21,14,14,5,12,9,14,7,102
6,21,14,14,5,12,12,5,4,93
6,21,14,14,5,12,19,0,0,91
6,21,14,14,25,0,0,0,0,80
6,21,14,14,9,5,18,0,0,87
6,21,14,14,9,5,19,0,0,88
6,21,14,14,9,5,19,20,0,108
6,21,14,14,9,12,25,0,0,101
6,21,14,14,25,13,1,14,0,108
6,21,14,14,25,13,5,14,0,112
6,21,14,14,9,13,5,14,20,116
6,21,14,14,9,14,5,19,19,121
6,21,14,14,9,14,7,0,0,85
6,21,14,15,18,9,0,0,0,83
6,21,14,15,18,9,14,0,0,97
6,21,14,19,0,0,0,0,0,60
6,21,14,19,20,5,18,0,0,103
6,21,14,20,0,0,0,0,0,61
6,21,18,1,3,1,14,1,0,65
6,21,18,1,3,9,15,21,19,113
6,21,18,1,3,9,20,25,0,103
6,21,18,1,12,0,0,0,0,58
6,21,18,1,14,0,0,0,0,60
6,21,18,1,14,4,9,0,0,73
6,21,18,1,14,5,0,0,0,65
6,21,18,1,14,5,19,0,0,84
6,21,18,1,14,15,9,4,0,88
6,21,18,1,14,15,19,5,0,99
6,21,18,1,14,15,19,5,19,118
6,21,18,1,14,19,0,0,0,79
6,21,18,1,26,1,14,0,0,87
6,21,18,1,26,1,14,5,0,92
6,21,18,2,5,1,18,5,18,94
6,21,18,2,5,12,15,23,0,102
6,21,18,2,5,12,15,23,19,121
6,21,18,2,9,19,8,0,0,83
6,21,18,2,9,19,8,5,4,92
6,21,18,2,9,19,8,5,18,106
6,21,18,2,9,19,8,5,19,107
6,21,18,3,1,0,0,0,0,49
6,21,18,3,1,5,0,0,0,54
6,21,18,3,1,12,0,0,0,61
6,21,18,3,1,20,5,0,0,74
6,21,18,3,1,20,5,4,0,78
6,21,18,3,1,20,5,12,25,111
6,21,18,3,1,20,5,19,0,93
6,21,18,3,1,20,9,14,7,99
6,21,18,3,1,20,9,15,14,107
6,21,18,3,9,6,15,18,13,109
6,21,18,3,9,12,9,1,0,79
6,21,18,3,18,1,5,1,19,92
6,21,18,3,21,12,1,0,0,82
6,21,18,3,21,12,1,5,0,87
6,21,18,3,21,12,1,18,0,100
6,21,18,3,21,12,5,0,0,86
6,21,18,3,21,12,21,13,0,115
6,21,18,4,5,12,0,0,0,66
6,21,18,4,12,5,0,0,0,66
6,21,18,6,21,18,0,0,0,90
6,21,18,6,21,18,1,12,0,103
6,21,18,6,21,18,1,12,19,122
6,21,18,6,21,18,1,14,0,105
6,21,18,6,21,18,1,14,19,124
6,21,18,6,21,18,5,19,0,114
6,21,18,6,21,18,25,12,0,127
6,21,18,6,21,18,9,14,5,118
6,21,18,6,21,18,15,9,4,118
6,21,18,6,21,18,15,12,0,117
6,21,18,6,21,18,15,12,5,122
6,21,18,6,21,18,15,21,19,145
6,21,18,9,1,12,0,0,0,67
6,21,18,9,1,14,20,0,0,89
6,21,18,9,2,21,14,4,0,95
6,21,18,9,3,1,14,5,0,77
6,21,18,9,5,4,0,0,0,63
6,21,18,9,6,25,0,0,0,85
6,21,18,9,12,0,0,0,0,66
6,21,18,25,12,0,0,0,0,82
6,21,18,9,12,5,0,0,0,71
6,21,18,9,12,9,3,0,0,78
6,21,18,9,15,19,1,0,0,89
6,21,18,9,15,19,9,20,25,142
6,21,18,9,15,19,15,0,0,103
6,21,18,9,15,21,19,0,0,109
6,21,18,9,15,21,19,5,18,132
6,21,18,9,15,21,19,12,25,146
6,21,18,9,19,15,14,0,0,102
6,21,18,9,22,1,5,0,0,82
6,21,18,12,0,0,0,0,0,57
6,21,18,12,1,2,12,5,0,77
6,21,18,12,1,14,1,0,0,73
6,21,18,12,1,14,1,19,0,92
6,21,18,12,1,14,5,0,0,77
6,21,18,12,5,4,0,0,0,66
6,21,18,12,5,18,0,0,0,80
6,21,18,12,5,18,19,0,0,99
6,21,18,12,5,19,19,0,0,100
6,21,18,12,9,14,7,0,0,87
6,21,18,12,15,14,7,19,0,112
6,21,18,12,15,21,7,8,0,108
6,21,18,12,15,21,7,8,19,127
6,21,18,12,19,0,0,0,0,76
6,21,18,13,5,14,20,5,0,102
6,21,18,13,5,14,20,25,0,122
6,21,18,13,5,20,25,0,0,108
6,21,18,13,5,20,9,5,19,116
6,21,18,13,9,14,20,0,0,101
6,21,18,13,9,20,25,0,0,112
6,21,18,13,9,20,9,5,19,120
6,21,18,14,1,3,5,0,0,68
6,21,18,14,1,3,5,4,0,72
6,21,18,14,1,3,5,18,0,86
6,21,18,14,1,3,5,19,0,87
6,21,18,14,1,3,9,14,7,93
6,21,18,14,1,3,9,20,5,97
6,21,18,14,1,7,5,0,0,72
6,21,18,14,5,18,0,0,0,82
6,21,18,14,9,13,5,14,20,120
6,21,18,14,9,19,8,0,0,95
6,21,18,14,9,19,8,5,4,104
6,21,18,14,9,19,8,5,18,118
6,21,18,14,9,19,8,5,19,119
6,21,18,14,9,20,0,0,0,88
6,21,18,14,9,20,21,18,5,132
6,21,18,15,1,20,5,0,0,86
6,21,18,15,9,3,0,0,0,72
6,21,18,15,9,4,0,0,0,73
6,21,18,15,9,14,0,0,0,83
6,21,18,15,12,5,0,0,0,77
6,21,18,15,18,0,0,0,0,78
6,21,18,15,18,5,0,0,0,83
6,21,18,15,18,5,19,0,0,102
6,21,18,15,18,19,0,0,0,97
6,21,18,16,8,25,0,0,0,94
6,21,18,18,5,4,0,0,0,72
6,21,18,18,25,0,0,0,0,88
6,21,18,18,9,5,18,0,0,95
6,21,18,18,9,5,18,5,4,104
6,21,18,18,9,5,18,25,0,120
6,21,18,18,9,5,18,19,0,114
6,21,18,18,9,5,19,20,0,116
6,21,18,18,9,12,25,0,0,109
6,21,18,18,9,14,5,18,0,109
6,21,18,18,9,14,5,18,19,128
6,21,18,18,9,14,5,19,19,129
6,21,18,18,9,14,7,0,0,93
6,21,18,18,9,14,7,19,0,112
6,21,18,18,15,23,0,0,0,101
6,21,18,18,15,23,5,4,0,110
6,21,18,18,15,23,5,18,0,124
6,21,18,18,15,23,5,18,19,143
6,21,18,18,15,23,25,0,0,126
6,21,18,18,15,23,9,14,7,131
6,21,18,18,15,23,19,0,0,120
6,21,18,18,21,18,5,0,0,107
6,21,18,19,0,0,0,0,0,64
6,21,18,19,5,13,9,4,5,100
6,21,18,19,20,15,14,5,0,118
6,21,18,20,8,5,18,0,0,96
6,21,18,20,8,5,18,5,4,105
6,21,18,20,8,5,18,5,18,119
6,21,18,20,8,5,18,12,25,133
6,21,18,20,8,5,18,19,0,115
6,21,18,20,8,5,19,20,0,117
6,21,18,20,8,25,0,0,0,98
6,21,18,20,9,22,5,0,0,101
6,21,18,20,9,22,5,12,25,138
6,21,18,20,21,13,0,0,0,99
6,21,18,21,14,3,12,5,0,100
6,21,18,21,14,3,12,5,19,119
6,21,18,26,5,0,0,0,0,76
6,21,18,26,5,3,8,1,20,108
6,21,18,26,5,4,0,0,0,80
6,21,18,26,5,12,9,14,7,118
6,21,18,26,5,18,25,0,0,119
6,21,18,26,5,19,0,0,0,95
6,21,18,26,5,20,15,16,0,127
6,21,18,26,25,0,0,0,0,96
6,21,18,26,9,5,18,0,0,103
6,21,18,26,9,5,19,20,0,124
6,21,19,1,9,14,0,0,0,70
6,21,19,1,9,14,19,0,0,89
6,21,19,1,18,9,1,12,0,87
6,21,19,1,18,9,15,19,5,113
6,21,19,1,18,15,12,5,0,97
6,21,19,1,20,5,0,0,0,72
6,21,19,3,0,0,0,0,0,49
6,21,19,3,9,14,0,0,0,72
6,21,19,3,15,21,19,0,0,104
6,21,19,5,1,21,0,0,0,73
6,21,19,5,2,15,1,18,4,91
6,21,19,5,4,0,0,0,0,55
6,21,19,5,5,0,0,0,0,56
6,21,19,5,5,19,0,0,0,75
6,21,19,5,12,0,0,0,0,63
6,21,19,5,12,1,7,5,0,76
6,21,19,5,12,1,7,5,19,95
6,21,19,5,12,5,19,19,0,106
6,21,19,5,12,9,11,5,0,88
6,21,19,5,12,19,0,0,0,82
6,21,19,5,16,12,21,7,0,107
6,21,19,5,19,0,0,0,0,70
6,21,19,5,20,18,15,14,0,118
6,21,19,8,20,0,0,0,0,74
6,21,19,9,2,12,5,0,0,74
6,21,19,9,2,12,25,0,0,94
6,21,19,9,6,15,18,13,0,107
6,21,19,9,12,0,0,0,0,67
6,21,19,9,12,1,4,5,0,77
6,21,19,9,12,1,4,5,4,81
6,21,19,9,12,1,4,5,19,96
6,21,19,9,12,5,0,0,0,72
6,21,19,9,12,5,5,18,0,95
6,21,19,9,12,5,5,18,19,114
6,21,19,9,12,9,5,18,0,99
6,21,19,9,12,9,5,18,19,118
6,21,19,9,12,12,1,4,5,89
6,21,19,9,12,12,25,0,0,104
6,21,19,9,12,19,0,0,0,86
6,21,19,9,14,7,0,0,0,76
6,21,19,9,14,9,19,20,0,117
6,21,19,9,14,9,20,5,0,103
6,21,19,9,15,14,0,0,0,84
6,21,19,9,15,14,1,12,0,97
6,21,19,9,15,14,9,19,13,125
6,21,19,9,15,14,9,19,20,132
6,21,19,9,15,14,19,0,0,103
6,21,19,11,0,0,0,0,0,57
6,21,19,15,9,4,0,0,0,74
6,21,19,19,0,0,0,0,0,65
6,21,19,19,5,4,0,0,0,74
6,21,19,19,5,18,0,0,0,88
6,21,19,19,5,18,19,0,0,107
6,21,19,19,5,19,0,0,0,89
6,21,19,19,25,0,0,0,0,90
6,21,19,19,9,5,18,0,0,97
6,21,19,19,9,5,19,20,0,118
6,21,19,19,9,6,25,0,0,105
6,21,19,19,9,12,25,0,0,111
6,21,19,19,9,14,5,19,19,131
6,21,19,19,9,14,7,0,0,95
6,21,19,19,12,5,0,0,0,82
6,21,19,19,15,3,11,0,0,94
6,21,19,19,16,15,20,0,0,116
6,21,19,19,16,15,20,19,0,135
6,21,19,20,0,0,0,0,0,66
6,21,19,20,5,5,0,0,0,76
6,21,19,20,5,18,0,0,0,89
6,21,19,20,5,18,9,3,0,101
6,21,19,20,5,20,0,0,0,91
6,21,19,20,25,0,0,0,0,91
6,21,19,20,9,1,14,0,0,90
6,21,19,20,9,1,14,19,0,109
6,21,19,20,9,3,0,0,0,78
6,21,19,20,9,3,19,0,0,97
6,21,19,20,9,5,0,0,0,80
6,21,19,20,9,5,18,0,0,98
6,21,19,20,9,5,19,20,0,119
6,21,19,20,9,7,1,20,5,108
6,21,19,20,9,12,25,0,0,112
6,21,19,20,9,12,21,7,19,134
6,21,19,20,9,14,0,0,0,89
6,21,19,20,9,14,5,19,19,132
6,21,19,20,12,5,0,0,0,83
6,21,19,20,15,3,0,0,0,84
6,21,19,21,12,1,0,0,0,80
6,21,19,21,12,1,5,0,0,85
6,21,19,21,12,1,19,0,0,99
6,21,19,21,13,1,0,0,0,81
6,21,19,21,18,5,0,0,0,90
6,21,20,0,0,0,0,0,0,47
6,21,20,3,8,5,12,0,0,75
6,21,20,3,8,5,12,12,0,87
6,21,20,5,0,0,0,0,0,52
6,21,20,8,1,18,3,0,0,77
6,21,20,8,1,18,3,19,0,96
6,21,20,8,1,18,11,0,0,85
6,21,20,8,1,18,11,19,0,104
6,21,20,8,15,18,3,0,0,91
6,21,20,8,15,18,3,19,0,110
6,21,20,8,15,18,11,0,0,99
6,21,20,8,15,18,11,19,0,118
6,21,20,9,12,5,0,0,0,73
6,21,20,9,12,5,25,0,0,98
6,21,20,9,12,5,12,25,0,110
6,21,20,9,12,9,20,25,0,122
6,21,20,9,12,9,26,5,0,108
6,21,20,9,12,15,21,19,0,123
6,21,20,15,14,0,0,0,0,76
6,21,20,15,14,19,0,0,0,95
6,21,20,20,1,8,0,0,0,76
6,21,20,20,5,18,0,0,0,90
6,21,20,20,5,18,5,20,0,115
6,21,20,20,15,3,11,0,0,96
6,21,20,20,15,3,11,19,0,115
6,21,20,21,18,1,2,12,5,106
6,21,20,21,18,1,12,0,0,99
6,21,20,21,18,1,13,1,0,101
6,21,20,21,18,1,13,9,3,112
6,21,20,21,18,5,0,0,0,91
6,21,20,21,18,5,12,25,0,128
6,21,20,21,18,5,19,0,0,110
6,21,20,21,18,9,3,0,0,98
6,21,20,21,18,9,19,13,19,146
6,21,20,21,18,9,19,20,19,153
6,21,20,21,18,9,20,25,0,140
6,21,20,21,18,9,26,5,0,126
6,21,20,21,18,15,0,0,0,101
6,21,20,23,1,0,0,0,0,71
6,21,20,26,0,0,0,0,0,73
6,21,20,26,5,4,0,0,0,82
6,21,20,26,5,19,0,0,0,97
6,21,20,26,9,14,7,0,0,103
6,21,26,5,0,0,0,0,0,58
6,21,26,5,4,0,0,0,0,62
6,21,26,5,5,0,0,0,0,63
6,21,26,5,5,19,0,0,0,82
6,21,26,5,19,0,0,0,0,77
6,21,26,9,12,0,0,0,0,74
6,21,26,9,12,19,0,0,0,93
6,21,26,9,14,7,0,0,0,83
6,21,26,26,0,0,0,0,0,79
6,21,26,26,2,1,12,12,0,106
6,21,26,26,5,4,0,0,0,88
6,21,26,26,5,19,0,0,0,103
6,21,26,26,25,0,0,0,0,104
6,21,26,26,9,5,18,0,0,111
6,21,26,26,9,5,19,20,0,132
6,21,26,26,9,12,25,0,0,125
6,21,26,26,9,14,5,19,0,126
6,21,26,26,9,14,5,19,19,145
6,21,26,26,9,14,7,0,0,109
6,21,26,26,12,5,0,0,0,96
6,21,26,26,20,1,9,12,0,121
6,23,5,12,12,9,14,7,0,88
7,3,15,14,22,0,0,0,0,61
7,3,15,14,22,5,18,20,0,104
7,4,9,14,6,15,0,0,0,55
7,5,2,1,14,7,0,0,0,36
7,5,2,1,14,7,1,0,0,37
7,5,2,2,9,5,0,0,0,30
7,5,2,21,18,0,0,0,0,53
7,5,3,11,0,0,0,0,0,26
7,5,3,11,5,4,0,0,0,35
7,5,3,11,9,14,7,0,0,56
7,5,3,11,15,0,0,0,0,41
7,5,3,11,15,5,19,0,0,65
7,5,3,11,15,9,4,0,0,54
7,5,3,11,15,19,0,0,0,60
7,5,3,11,15,20,9,1,14,85
7,5,3,11,15,20,9,4,0,74
7,5,3,11,15,20,15,9,4,89
7,5,3,11,19,0,0,0,0,45
7,5,4,1,3,11,20,0,0,51
7,5,4,1,3,20,0,0,0,40
7,5,4,1,14,9,20,5,0,65
7,5,4,1,14,11,5,14,0,61
7,5,4,4,0,0,0,0,0,20
7,5,4,4,5,18,0,0,0,43
7,5,4,4,19,0,0,0,0,39
7,5,4,5,3,11,20,0,0,55
7,5,4,18,9,20,5,0,0,68
7,5,4,19,0,0,0,0,0,35
7,5,4,21,14,11,0,0,0,62
7,5,5,2,15,14,7,0,0,55
7,5,5,2,21,14,7,0,0,61
7,5,5,4,0,0,0,0,0,21
7,5,5,7,1,23,0,0,0,48
7,5,5,7,1,23,19,0,0,67
7,5,5,9,14,7,0,0,0,47
7,5,5,10,5,5,0,0,0,37
7,5,5,11,0,0,0,0,0,28
7,5,5,11,25,0,0,0,0,53
7,5,5,11,9,5,18,0,0,60
7,5,5,11,9,5,19,20,0,81
7,5,5,11,19,0,0,0,0,47
7,5,5,12,2,5,3,0,0,39
7,5,5,12,2,5,3,11,0,50
7,5,5,12,2,5,11,0,0,47
7,5,5,12,8,15,21,20,0,93
7,5,5,16,15,21,14,4,0,87
7,5,5,16,15,21,14,4,19,106
7,5,5,18,1,8,0,0,0,44
7,5,5,19,0,0,0,0,0,36
7,5,5,19,5,0,0,0,0,41
7,5,5,19,20,0,0,0,0,56
7,5,5,19,20,19,0,0,0,75
7,5,5,20,0,0,0,0,0,37
7,5,5,26,5,18,0,0,0,66
7,5,5,26,5,18,19,0,0,85
7,5,6,9,12,20,5,0,0,64
7,5,7,5,14,9,15,14,0,76
7,5,7,7,0,0,0,0,0,26
7,5,7,7,5,5,0,0,0,36
7,5,7,7,5,18,0,0,0,49
7,5,7,7,5,18,25,0,0,74
7,5,8,5,25,0,0,0,0,50
7,5,8,12,5,14,9,20,5,85
7,5,25,0,0,0,0,0,0,37
7,5,25,1,14,0,0,0,0,52
7,5,9,3,0,0,0,0,0,24
7,5,25,5,18,9,20,5,0,94
7,5,25,12,9,5,19,0,0,82
7,5,9,14,0,0,0,0,0,35
7,5,9,18,0,0,0,0,0,39
7,5,9,18,1,0,0,0,0,40
7,5,9,19,1,0,0,0,0,41
7,5,25,19,5,18,0,0,0,79
7,5,25,19,5,18,1,12,0,92
7,5,25,19,5,18,9,3,0,91
7,5,25,19,5,18,9,14,5,107
7,5,25,19,5,18,9,19,8,115
7,5,25,19,5,18,9,20,5,113
7,5,25,19,5,18,19,0,0,98
7,5,9,19,8,1,0,0,0,49
7,5,9,19,8,1,19,0,0,68
7,5,9,19,15,14,0,0,0,69
7,5,9,19,20,12,9,3,8,92
7,5,9,20,10,9,5,0,0,65
7,5,11,11,15,14,9,4,0,76
7,5,11,11,15,14,15,9,4,91
7,5,12,1,2,12,5,0,0,44
7,5,12,1,4,1,0,0,0,30
7,5,12,1,4,1,19,0,0,49
7,5,12,1,14,20,0,0,0,59
7,5,12,1,14,20,19,0,0,78
7,5,12,1,19,20,9,3,0,76
7,5,12,1,20,5,0,0,0,50
7,5,12,1,20,5,4,0,0,54
7,5,12,1,20,5,19,0,0,69
7,5,12,1,20,9,0,0,0,54
7,5,12,1,20,9,1,0,0,55
7,5,12,1,20,9,14,0,0,68
7,5,12,1,20,9,14,5,0,73
7,5,12,1,20,9,14,5,4,77
7,5,12,1,20,9,14,5,19,92
7,5,12,1,20,9,14,7,0,75
7,5,12,1,20,9,14,19,0,87
7,5,12,1,20,9,15,14,0,83
7,5,12,1,20,9,15,14,19,102
7,5,12,1,20,15,0,0,0,60
7,5,12,1,20,15,19,0,0,79
7,5,12,1,20,15,19,5,0,84
7,5,12,4,0,0,0,0,0,28
7,5,12,4,1,2,12,5,0,48
7,5,12,4,1,14,20,0,0,63
7,5,12,4,5,4,0,0,0,37
7,5,12,4,5,18,0,0,0,51
7,5,12,4,5,18,19,0,0,70
7,5,12,4,9,14,7,0,0,58
7,5,12,4,9,14,7,19,0,77
7,5,12,4,19,0,0,0,0,47
7,5,12,5,3,8,9,9,4,62
7,5,12,5,5,13,0,0,0,47
7,5,12,5,5,19,0,0,0,53
7,5,12,9,4,0,0,0,0,37
7,5,12,9,4,9,20,25,0,91
7,5,12,9,4,12,25,0,0,74
7,5,12,9,4,14,5,19,19,94
7,5,12,9,7,14,9,20,5,88
7,5,12,9,12,1,8,0,0,54
7,5,12,9,14,15,20,20,5,107
7,5,12,12,0,0,0,0,0,36
7,5,12,12,1,14,20,0,0,71
7,5,12,12,1,14,20,19,0,90
7,5,12,12,5,4,0,0,0,45
7,5,12,12,25,0,0,0,0,61
7,5,12,12,9,14,7,0,0,66
7,5,12,15,6,5,18,0,0,68
7,5,12,15,6,18,5,0,0,68
7,5,12,15,7,5,14,9,3,77
7,5,12,15,14,7,0,0,0,60
7,5,12,15,19,3,15,16,25,117
7,5,12,15,19,5,0,0,0,63
7,5,12,15,19,9,5,0,0,72
7,5,12,15,19,9,14,0,0,81
7,5,12,15,19,9,14,5,0,86
7,5,12,19,0,0,0,0,0,43
7,5,12,19,5,13,9,1,0,71
7,5,12,19,5,13,9,3,0,73
7,5,12,19,5,13,9,14,0,84
7,5,12,19,5,13,9,14,5,89
7,5,12,20,0,0,0,0,0,44
7,5,12,20,19,0,0,0,0,63
7,5,13,1,20,18,9,1,0,74
7,5,13,1,20,18,9,15,20,108
7,5,13,1,21,22,5,0,0,74
7,5,13,5,9,14,4,5,0,62
7,5,13,5,12,0,0,0,0,42
7,5,13,5,12,5,4,0,0,51
7,5,13,5,12,12,5,4,0,63
7,5,13,5,12,12,9,15,14,92
7,5,13,5,12,12,21,19,0,94
7,5,13,5,12,19,0,0,0,61
7,5,13,9,14,1,12,0,0,61
7,5,13,9,14,1,12,12,25,98
7,5,13,9,14,1,20,5,0,74
7,5,13,9,14,1,20,5,4,78
7,5,13,9,14,1,20,5,19,93
7,5,13,9,14,9,19,0,0,76
7,5,13,9,14,15,18,21,13,115
7,5,13,9,14,15,21,19,0,103
7,5,13,12,5,19,19,0,0,80
7,5,13,12,9,3,8,0,0,57
7,5,13,12,9,11,5,0,0,62
7,5,13,13,1,5,0,0,0,44
7,5,13,13,1,14,0,0,0,53
7,5,13,13,1,18,25,0,0,82
7,5,13,13,1,20,5,0,0,64
7,5,13,13,1,20,5,4,0,68
7,5,13,13,1,20,5,19,0,83
7,5,13,13,1,20,9,14,7,89
7,5,13,13,1,20,9,15,14,97
7,5,13,13,1,20,9,22,5,95
7,5,13,13,5,4,0,0,0,47
7,5,13,13,5,12,0,0,0,55
7,5,13,13,5,15,21,19,0,98
7,5,13,13,5,18,0,0,0,61
7,5,13,13,5,18,25,0,0,86
7,5,13,13,25,0,0,0,0,63
7,5,13,13,9,5,18,0,0,70
7,5,13,13,9,5,19,20,0,91
7,5,13,13,9,6,15,18,13,99
7,5,13,13,9,12,25,0,0,84
7,5,13,13,9,14,5,19,19,104
7,5,13,13,9,14,7,0,0,68
7,5,13,13,9,16,1,18,1,83
7,5,13,13,15,9,4,0,0,66
7,5,13,13,15,12,15,7,25,112
7,5,13,13,21,12,1,0,0,72
7,5,13,13,21,12,5,0,0,76
7,5,13,13,21,12,5,19,0,95
7,5,13,15,12,15,7,25,0,99
7,5,13,15,14,9,5,19,0,87
7,5,13,15,20,0,0,0,0,60
7,5,13,15,20,5,0,0,0,65
7,5,13,15,20,5,19,0,0,84
7,5,13,15,20,19,0,0,0,79
7,5,13,16,25,12,9,4,0,91
7,5,13,19,2,15,11,0,0,72
7,5,13,19,2,15,11,19,0,91
7,5,13,19,2,21,3,11,0,81
7,5,13,19,2,21,3,11,19,100
7,5,13,19,5,0,0,0,0,49
7,5,13,19,5,19,0,0,0,68
7,5,13,19,8,15,18,14,0,99
7,5,13,19,20,15,14,5,0,98
7,5,13,19,20,15,14,5,19,117
7,5,13,21,12,0,0,0,0,58
7,5,13,21,20,9,0,0,0,75
7,5,13,21,20,12,9,3,8,98
7,5,13,23,15,18,11,0,0,92
7,5,14,0,0,0,0,0,0,26
7,5,14,1,5,0,0,0,0,32
7,5,14,1,12,0,0,0,0,39
7,5,14,1,16,16,0,0,0,59
7,5,14,1,16,16,5,0,0,64
7,5,14,1,16,16,5,4,0,68
7,5,14,1,16,16,5,18,0,82
7,5,14,1,16,16,9,14,7,89
7,5,14,1,18,3,8,0,0,56
7,5,14,1,18,3,8,1,0,57
7,5,14,4,1,18,13,5,0,67
7,5,14,4,1,18,13,5,19,86
7,5,14,4,5,18,0,0,0,53
7,5,14,4,5,18,5,4,0,62
7,5,14,4,5,18,5,18,0,76
7,5,14,4,5,18,9,14,7,83
7,5,14,4,5,18,19,0,0,72
7,5,14,5,0,0,0,0,0,31
7,5,14,5,1,12,0,0,0,44
7,5,14,5,1,12,15,7,25,91
7,5,14,5,1,18,0,0,0,50
7,5,14,5,1,18,3,8,0,61
7,5,14,5,1,20,0,0,0,52
7,5,14,5,3,15,18,0,0,67
7,5,14,5,11,9,0,0,0,51
7,5,14,5,15,12,15,7,25,105
7,5,14,5,16,0,0,0,0,47
7,5,14,5,16,9,0,0,0,56
7,5,14,5,18,1,0,0,0,50
7,5,14,5,18,1,2,12,5,69
7,5,14,5,18,1,12,0,0,62
7,5,14,5,18,1,12,3,25,90
7,5,14,5,18,1,12,5,0,67
7,5,14,5,18,1,12,9,1,72
7,5,14,5,18,1,12,12,0,74
7,5,14,5,18,1,12,12,25,99
7,5,14,5,18,1,12,19,0,81
7,5,14,5,18,1,12,20,25,107
7,5,14,5,18,1,14,20,0,84
7,5,14,5,18,1,20,5,0,75
7,5,14,5,18,1,20,5,4,79
7,5,14,5,18,1,20,5,18,93
7,5,14,5,18,1,20,5,19,94
7,5,14,5,18,1,20,15,18,103
7,5,14,5,18,9,3,0,0,61
7,5,14,5,18,9,3,1,12,74
7,5,14,5,18,9,3,19,0,80
7,5,14,5,18,9,19,0,0,77
7,5,14,5,18,15,21,19,0,104
7,5,14,5,19,0,0,0,0,50
7,5,14,5,19,5,18,9,14,96
7,5,14,5,19,5,19,0,0,74
7,5,14,5,19,9,1,12,0,72
7,5,14,5,19,9,3,0,0,62
7,5,14,5,19,9,19,0,0,78
7,5,14,5,20,8,12,9,3,83
7,5,14,5,20,9,3,0,0,63
7,5,14,5,20,9,3,1,12,76
7,5,14,5,20,9,3,19,0,82
7,5,14,5,20,9,11,1,0,72
7,5,14,5,20,13,15,9,12,100
7,5,14,5,20,15,9,4,0,79
7,5,14,5,20,15,18,0,0,84
7,5,14,5,20,15,21,19,0,106
7,5,14,5,20,19,0,0,0,70
7,5,14,5,20,20,5,0,0,76
7,5,14,5,20,20,5,19,0,95
7,5,14,5,22,1,19,0,0,73
7,5,14,5,22,15,9,19,5,101
7,5,14,7,8,9,19,0,0,69
7,5,14,25,0,0,0,0,0,51
7,5,14,9,1,12,0,0,0,48
7,5,14,9,1,12,9,20,25,102
7,5,14,9,1,12,9,26,5,88
7,5,14,9,1,12,12,25,0,85
7,5,14,9,1,14,0,0,0,50
7,5,14,9,3,0,0,0,0,38
7,5,14,9,3,1,12,12,25,88
7,5,14,9,3,21,12,1,18,90
7,5,14,9,3,21,12,21,13,105
7,5,14,9,5,19,0,0,0,59
7,5,14,9,9,0,0,0,0,44
7,5,14,9,14,0,0,0,0,49
7,5,14,9,15,0,0,0,0,50
7,5,14,9,15,14,0,0,0,64
7,5,14,9,16,0,0,0,0,51
7,5,14,9,16,1,16,0,0,68
7,5,14,9,16,1,16,19,0,87
7,5,14,9,16,19,0,0,0,70
7,5,14,25,19,0,0,0,0,70
7,5,14,9,19,1,18,15,0,88
7,5,14,9,19,20,5,9,14,102
7,5,14,9,19,20,9,14,0,97
7,5,14,9,20,0,0,0,0,55
7,5,14,9,20,1,12,0,0,68
7,5,14,9,20,1,12,9,1,78
7,5,14,9,20,1,12,9,3,80
7,5,14,9,20,1,12,12,25,105
7,5,14,9,20,1,12,19,0,87
7,5,14,9,20,9,14,7,0,85
7,5,14,9,20,9,22,1,12,99
7,5,14,9,20,9,22,5,0,91
7,5,14,9,20,9,22,5,19,110
7,5,14,9,20,15,18,0,0,88
7,5,14,9,20,15,18,25,0,113
7,5,14,9,20,15,18,19,0,107
7,5,14,9,20,21,18,5,0,99
7,5,14,9,20,21,18,5,19,118
7,5,14,9,21,19,0,0,0,75
7,5,14,9,21,19,5,19,0,99
7,5,14,9,26,1,8,0,0,70
7,5,14,9,26,5,18,15,0,99
7,5,14,15,1,19,0,0,0,61
7,5,14,15,2,12,1,19,20,95
7,5,14,15,3,9,4,1,12,70
7,5,14,15,3,9,4,5,0,62
7,5,14,15,3,9,4,5,19,81
7,5,14,15,9,19,5,0,0,74
7,5,14,15,9,19,5,19,0,93
7,5,14,15,13,0,0,0,0,54
7,5,14,15,13,5,0,0,0,59
7,5,14,15,13,5,19,0,0,78
7,5,14,15,13,9,3,0,0,66
7,5,14,15,13,19,0,0,0,73
7,5,14,15,14,5,13,1,0,74
7,5,14,15,19,0,0,0,0,60
7,5,14,15,20,25,16,5,0,107
7,5,14,15,20,25,16,5,19,126
7,5,14,15,20,25,16,9,3,114
7,5,14,15,21,19,0,0,0,81
7,5,14,15,22,9,14,15,0,101
7,5,14,18,5,0,0,0,0,49
7,5,14,18,5,19,0,0,0,68
7,5,14,18,15,0,0,0,0,59
7,5,14,18,15,19,0,0,0,78
7,5,14,19,0,0,0,0,0,45
7,5,14,19,5,14,7,0,0,71
7,5,14,19,5,14,7,19,0,90
7,5,14,19,15,14,0,0,0,74
7,5,14,20,5,5,12,0,0,68
7,5,14,20,5,5,12,5,18,91
7,5,14,20,5,5,12,12,25,105
7,5,14,20,8,9,20,5,0,88
7,5,14,20,25,0,0,0,0,71
7,5,14,20,9,1,14,0,0,70
7,5,14,20,9,1,14,1,12,83
7,5,14,20,9,1,14,9,3,82
7,5,14,20,9,1,14,9,14,93
7,5,14,20,9,1,14,19,0,89
7,5,14,20,9,9,14,0,0,78
7,5,14,20,9,12,0,0,0,67
7,5,14,20,9,12,5,19,0,91
7,5,14,20,9,12,9,3,0,79
7,5,14,20,9,12,9,19,8,103
7,5,14,20,9,12,9,19,13,108
7,5,14,20,9,12,9,20,25,121
7,5,14,20,9,12,9,26,5,107
7,5,14,20,9,19,1,20,5,100
7,5,14,20,9,19,5,9,14,102
7,5,14,20,9,19,9,3,0,86
7,5,14,20,9,19,9,14,0,97
7,5,14,20,9,21,13,0,0,89
7,5,14,20,12,5,0,0,0,63
7,5,14,20,12,5,4,0,0,67
7,5,14,20,12,5,13,1,14,91
7,5,14,20,12,5,13,5,14,95
7,5,14,20,12,5,18,0,0,81
7,5,14,20,12,5,19,0,0,82
7,5,14,20,12,5,19,20,0,102
7,5,14,20,12,25,0,0,0,83
7,5,14,20,12,9,14,7,0,88
7,5,14,20,13,1,14,0,0,74
7,5,14,20,18,9,3,5,0,81
7,5,14,20,18,9,3,5,19,100
7,5,14,20,18,9,5,19,0,97
7,5,14,20,18,9,6,25,0,104
7,5,14,20,19,0,0,0,0,65
7,5,14,21,0,0,0,0,0,47
7,5,14,21,1,0,0,0,0,48
7,5,14,21,1,12,0,0,0,60
7,5,14,21,3,12,1,19,20,102
7,5,14,21,6,12,5,3,20,93
7,5,14,21,6,12,5,24,0,94
7,5,14,21,9,14,5,0,0,75
7,5,14,21,9,14,5,12,25,112
7,5,14,21,19,0,0,0,0,66
7,5,14,21,19,5,19,0,0,90
7,5,15,2,9,15,14,20,0,87
7,5,15,2,9,15,19,0,0,72
7,5,15,2,12,1,19,20,0,81
7,5,15,2,15,20,1,14,25,104
7,5,15,3,1,18,16,9,3,77
7,5,15,3,5,18,9,20,5,87
7,5,15,3,8,18,15,14,25,110
7,5,15,3,25,3,12,9,3,82
7,5,15,3,12,9,14,5,0,70
7,5,15,3,18,1,20,9,3,81
7,5,15,4,0,0,0,0,0,31
7,5,15,4,1,5,19,9,1,66
7,5,15,4,1,12,0,0,0,44
7,5,15,4,5,0,0,0,0,36
7,5,15,4,5,19,0,0,0,55
7,5,15,4,5,19,25,0,0,80
7,5,15,4,5,19,9,1,0,65
7,5,15,4,5,19,9,3,0,67
7,5,15,4,5,19,9,3,19,86
7,5,15,4,5,19,9,5,19,88
7,5,15,4,5,19,9,19,20,103
7,5,15,4,5,20,5,0,0,61
7,5,15,4,5,20,9,3,0,68
7,5,15,4,5,20,9,3,19,87
7,5,15,4,9,3,0,0,0,43
7,5,15,4,9,19,20,0,0,79
7,5,15,4,21,3,11,0,0,66
7,5,15,4,21,3,11,19,0,85
7,5,15,5,13,20,18,25,0,108
7,5,15,5,20,8,14,9,3,86
7,5,15,6,15,18,13,0,0,79
7,5,15,7,0,0,0,0,0,34
7,5,15,7,5,14,0,0,0,53
7,5,15,7,5,14,25,0,0,78
7,5,15,7,5,14,9,3,0,65
7,5,15,7,5,14,15,21,19,108
7,5,15,7,14,15,19,25,0,107
7,5,15,7,14,15,19,9,19,110
7,5,15,7,14,15,19,20,0,102
7,5,15,7,15,14,25,0,0,88
7,5,15,7,15,14,9,3,0,75
7,5,15,7,18,1,16,8,25,102
7,5,15,9,4,0,0,0,0,40
7,5,15,9,4,1,12,0,0,53
7,5,15,9,4,19,0,0,0,59
7,5,15,12,0,0,0,0,0,39
7,5,15,12,1,20,18,25,0,103
7,5,15,12,15,7,5,18,0,84
7,5,15,12,15,7,5,18,19,103
7,5,15,12,15,7,25,0,0,86
7,5,15,12,15,7,9,1,14,85
7,5,15,12,15,7,9,3,0,73
7,5,15,12,15,7,9,5,19,94
7,5,15,12,15,7,9,19,5,94
7,5,15,12,15,7,9,19,20,109
7,5,15,12,15,7,9,26,5,101
7,5,15,13,0,0,0,0,0,40
7,5,15,13,1,12,25,0,0,78
7,5,15,13,1,12,9,3,0,65
7,5,15,13,1,12,9,19,13,94
7,5,15,13,1,14,3,5,0,63
7,5,15,13,1,14,3,5,18,81
7,5,15,13,1,14,3,25,0,83
7,5,15,13,1,14,20,0,0,75
7,5,15,13,1,14,20,9,3,87
7,5,15,13,5,20,5,18,0,88
7,5,15,13,5,20,5,18,19,107
7,5,15,13,5,20,18,25,0,108
7,5,15,13,5,20,18,9,3,95
7,5,15,13,5,20,18,9,4,96
7,5,15,13,25,9,4,0,0,78
7,5,15,13,15,18,15,9,0,97
7,5,15,13,15,18,16,8,25,122
7,5,15,16,8,1,7,25,0,84
7,5,15,16,8,1,7,9,1,69
7,5,15,16,8,9,12,9,4,85
7,5,15,16,8,25,20,5,0,101
7,5,15,16,8,25,20,5,19,120
7,5,15,16,8,25,20,9,3,108
7,5,15,16,8,15,14,5,19,104
7,5,15,16,15,12,1,18,0,89
7,5,15,16,15,14,25,0,0,97
7,5,15,16,15,14,9,3,0,84
7,5,15,16,15,14,9,3,19,103
7,5,15,16,18,15,2,5,0,83
7,5,15,18,1,13,1,0,0,60
7,5,15,18,7,9,1,14,19,95
7,5,15,18,7,9,3,0,0,64
7,5,15,18,7,9,3,1,12,77
7,5,15,18,7,9,3,19,0,83
7,5,15,18,7,9,21,13,0,95
7,5,15,19,3,15,16,25,0,105
7,5,15,19,3,15,16,9,3,92
7,5,15,19,9,4,0,0,0,59
7,5,15,19,9,4,5,0,0,64
7,5,15,19,16,8,5,18,5,98
7,5,15,19,20,1,20,9,3,99
7,5,15,20,1,3,20,9,3,83
7,5,15,20,1,24,5,19,0,96
7,5,15,20,1,24,25,0,0,97
7,5,15,20,1,24,9,19,0,100
7,5,15,20,8,5,18,13,0,91
7,5,15,20,25,0,0,0,0,72
7,5,15,20,9,3,0,0,0,59
7,5,15,20,9,3,1,12,0,72
7,5,15,20,9,12,12,1,0,81
7,5,15,20,15,14,9,3,0,88
7,5,15,20,15,14,21,19,0,116
7,5,15,20,18,15,16,25,0,121
7,5,15,20,18,15,16,9,3,108
7,5,16,8,25,18,5,1,14,99
7,5,16,15,21,14,0,0,0,78
7,5,18,1,5,18,1,0,0,55
7,5,18,1,8,0,0,0,0,39
7,5,18,1,8,19,0,0,0,58
7,5,18,1,14,9,1,12,0,67
7,5,18,1,14,9,1,12,19,86
7,5,18,1,14,9,3,0,0,57
7,5,18,1,14,25,12,0,0,82
7,5,18,1,14,9,14,0,0,68
7,5,18,1,14,9,15,12,0,81
7,5,18,1,14,9,15,12,19,100
7,5,18,1,14,9,21,13,19,107
7,5,18,1,18,1,0,0,0,50
7,5,18,1,18,4,9,1,0,63
7,5,18,1,18,4,9,1,19,82
7,5,18,1,19,20,9,1,14,94
7,5,18,1,20,5,0,0,0,56
7,5,18,1,20,5,4,0,0,60
7,5,18,1,20,5,12,25,0,93
7,5,18,1,20,25,0,0,0,76
7,5,18,1,20,9,3,0,0,63
7,5,18,2,0,0,0,0,0,32
7,5,18,2,5,0,0,0,0,37
7,5,18,2,5,18,1,19,0,75
7,5,18,2,9,12,0,0,0,53
7,5,18,2,9,12,12,5,0,70
7,5,18,2,9,12,12,5,19,89
7,5,18,2,9,12,19,0,0,72
7,5,18,2,15,0,0,0,0,47
7,5,18,3,18,15,23,0,0,89
7,5,18,5,1,7,12,5,0,60
7,5,18,5,6,1,0,0,0,42
7,5,18,5,14,4,1,0,0,54
7,5,18,5,14,4,21,13,0,87
7,5,18,5,14,20,0,0,0,69
7,5,18,5,14,20,19,0,0,88
7,5,18,5,14,21,11,0,0,81
7,5,18,5,14,21,11,19,0,100
7,5,18,6,1,12,3,15,14,81
7,5,18,6,21,12,0,0,0,69
7,5,18,9,1,20,18,9,3,90
7,5,18,9,13,0,0,0,0,52
7,5,18,25,15,14,9,4,0,97
7,5,18,9,16,0,0,0,0,55
7,5,18,11,9,14,0,0,0,64
7,5,18,12,1,14,4,0,0,61
7,5,18,13,0,0,0,0,0,43
7,5,18,13,1,12,0,0,0,56
7,5,18,13,1,14,4,5,18,85
7,5,18,13,1,14,5,0,0,63
7,5,18,13,1,14,5,12,25,100
7,5,18,13,1,14,9,5,19,91
7,5,18,13,1,14,25,12,0,95
7,5,18,13,1,14,9,20,5,92
7,5,18,13,1,14,9,21,13,101
7,5,18,13,1,14,15,21,19,113
7,5,18,13,1,14,19,0,0,77
7,5,18,13,1,18,9,21,13,105
7,5,18,13,5,14,0,0,0,62
7,5,18,13,5,14,19,0,0,81
7,5,18,13,6,18,5,5,0,77
7,5,18,13,25,0,0,0,0,68
7,5,18,13,9,3,9,4,5,73
7,5,18,13,9,5,18,0,0,75
7,5,18,13,9,5,19,20,0,96
7,5,18,13,9,6,21,7,5,91
7,5,18,13,9,7,5,14,5,83
7,5,18,13,9,14,1,0,0,67
7,5,18,13,9,14,1,14,20,101
7,5,18,13,9,14,1,20,5,92
7,5,18,13,9,14,7,0,0,73
7,5,18,13,12,5,19,19,0,98
7,5,18,13,12,9,11,5,0,80
7,5,18,13,12,9,14,7,0,85
7,5,18,13,15,14,0,0,0,72
7,5,18,13,16,18,15,15,6,113
7,5,18,13,19,0,0,0,0,62
7,5,18,13,21,12,5,0,0,81
7,5,18,14,1,20,9,22,5,101
7,5,18,14,9,20,26,0,0,99
7,5,18,15,3,15,13,25,0,101
7,5,18,15,3,15,13,9,1,86
7,5,18,15,4,5,18,13,1,86
7,5,18,15,14,20,0,0,0,79
7,5,18,15,14,20,1,12,0,92
7,5,18,15,14,20,5,19,0,103
7,5,18,15,14,20,9,3,0,91
7,5,18,15,14,20,9,14,5,107
7,5,18,15,14,20,9,19,13,120
7,5,18,15,14,20,15,0,0,94
7,5,18,15,16,9,7,1,0,78
7,5,18,15,21,19,0,0,0,85
7,5,18,19,21,13,0,0,0,83
7,5,18,21,14,4,0,0,0,69
7,5,18,21,14,4,9,1,12,91
7,5,18,21,14,4,9,22,5,105
7,5,18,21,14,4,19,0,0,88
7,5,18,22,1,15,0,0,0,68
7,5,19,9,20,8,0,0,0,68
7,5,19,12,9,14,7,0,0,73
7,5,19,14,5,18,1,4,0,73
7,5,19,14,9,14,7,0,0,75
7,5,19,19,0,0,0,0,0,50
7,5,19,19,1,13,9,14,5,92
7,5,19,19,5,18,15,14,0,102
7,5,19,19,15,0,0,0,0,65
7,5,19,19,15,5,4,0,0,74
7,5,19,19,15,5,19,0,0,89
7,5,19,20,0,0,0,0,0,51
7,5,19,20,1,5,0,0,0,57
7,5,19,20,1,12,20,5,14,103
7,5,19,20,1,12,20,5,18,107
7,5,19,20,1,12,20,19,0,103
7,5,19,20,1,14,20,0,0,86
7,5,19,20,1,16,15,19,0,102
7,5,19,20,1,20,5,0,0,77
7,5,19,20,1,20,5,4,0,81
7,5,19,20,1,20,5,19,0,96
7,5,19,20,1,20,9,14,7,102
7,5,19,20,1,20,9,15,14,110
7,5,19,20,1,20,9,22,5,108
7,5,19,20,1,20,15,18,25,130
7,5,19,20,5,0,0,0,0,56
7,5,19,20,5,4,0,0,0,60
7,5,19,20,5,14,0,0,0,70
7,5,19,20,5,14,9,14,7,100
7,5,19,20,5,18,0,0,0,74
7,5,19,20,5,19,0,0,0,75
7,5,19,20,9,3,0,0,0,63
7,5,19,20,9,3,1,12,0,76
7,5,19,20,9,15,0,0,0,75
7,5,19,20,9,15,14,0,0,89
7,5,19,20,14,9,14,7,0,95
7,5,19,20,15,14,9,5,0,94
7,5,19,20,15,18,0,0,0,84
7,5,19,20,19,0,0,0,0,70
7,5,19,20,21,18,1,0,0,91
7,5,19,20,21,18,1,12,0,103
7,5,19,20,21,18,5,0,0,95
7,5,19,20,21,18,5,4,0,99
7,5,19,20,21,18,5,18,0,113
7,5,19,20,21,18,5,18,19,132
7,5,19,20,21,18,5,19,0,114
7,5,19,20,21,18,9,14,7,120
7,5,19,20,21,18,9,19,20,138
7,5,19,23,1,18,16,0,0,89
7,5,20,0,0,0,0,0,0,32
7,5,20,1,0,0,0,0,0,33
7,5,20,1,2,12,5,0,0,52
7,5,20,1,8,0,0,0,0,41
7,5,20,1,19,0,0,0,0,52
7,5,20,1,20,1,2,12,5,73
7,5,20,1,23,1,25,0,0,82
7,5,20,1,23,1,25,19,0,101
7,5,20,6,4,0,0,0,0,42
7,5,20,8,5,18,0,0,0,63
7,5,20,9,4,0,0,0,0,45
7,5,20,12,9,14,7,0,0,74
7,5,20,13,5,19,15,19,20,123
7,5,20,16,5,14,14,25,0,106
7,5,20,19,0,0,0,0,0,51
7,5,20,19,16,1,0,0,0,68
7,5,20,19,16,1,3,5,0,76
7,5,20,20,1,2,12,5,0,72
7,5,20,20,5,18,5,4,0,84
7,5,20,20,5,18,9,14,7,105
7,5,20,20,5,18,19,0,0,94
7,5,20,20,9,14,7,0,0,82
7,5,20,21,16,0,0,0,0,69
7,5,20,21,16,19,0,0,0,88
7,5,21,12,1,8,0,0,0,54
7,5,21,13,19,0,0,0,0,65
7,5,23,7,1,23,0,0,0,66
7,5,23,7,1,23,5,4,0,75
7,5,23,7,1,23,25,0,0,91
7,5,23,7,1,23,9,19,8,102
7,5,23,7,1,23,18,25,0,109
7,5,23,7,1,23,19,0,0,85
7,5,26,0,0,0,0,0,0,38
7,5,26,5,18,1,8,0,0,70
7,7,18,0,0,0,0,0,0,32
7,8,2,15,18,0,0,0,0,50
7,8,5,2,5,20,1,0,0,48
7,8,5,5,0,0,0,0,0,25
7,8,5,5,19,0,0,0,0,44
7,8,5,12,5,5,13,0,0,55
7,8,5,14,20,9,14,7,0,84
7,8,5,18,1,15,0,0,0,54
7,8,5,18,1,15,5,4,0,63
7,8,5,18,1,15,5,19,0,78
7,8,5,18,1,15,9,14,7,84
7,8,5,18,11,9,14,0,0,72
7,8,5,18,11,9,14,19,0,91
7,8,5,19,19,0,0,0,0,58
7,8,5,20,3,8,15,15,0,81
7,8,5,20,20,9,0,0,0,69
7,8,5,20,20,15,0,0,0,75
7,8,5,20,20,15,5,4,0,84
7,8,5,20,20,15,5,19,0,99
7,8,5,20,20,15,9,14,7,105
7,8,5,20,20,15,9,26,5,115
7,8,5,20,20,15,19,0,0,94
7,8,9,0,0,0,0,0,0,24
7,8,9,2,12,9,0,0,0,47
7,8,9,2,12,9,19,0,0,66
7,8,25,12,12,0,0,0,0,64
7,8,9,12,12,9,5,0,0,62
7,8,9,12,12,9,5,19,0,81
7,8,25,12,12,19,0,0,0,83
7,8,9,19,0,0,0,0,0,43
7,8,9,26,9,20,5,0,0,84
7,8,15,12,5,0,0,0,0,47
7,8,15,15,13,0,0,0,0,58
7,8,15,18,11,8,1,18,0,86
7,8,15,19,20,0,0,0,0,69
7,8,15,19,20,4,15,13,0,101
7,8,15,19,20,5,4,0,0,78
7,8,15,19,20,5,18,0,0,92
7,8,15,19,20,5,19,19,0,112
7,8,15,19,20,6,9,19,8,111
7,8,15,19,20,8,15,15,4,111
7,8,15,19,20,25,0,0,0,94
7,8,15,19,20,9,5,18,0,101
7,8,15,19,20,9,5,19,20,122
7,8,15,19,20,9,12,25,0,115
7,8,15,19,20,9,14,7,0,99
7,8,15,19,20,9,19,8,0,105
7,8,15,19,20,9,19,13,0,110
7,8,15,19,20,12,1,14,4,100
7,8,15,19,20,12,5,19,19,124
7,8,15,19,20,12,5,20,0,106
7,8,15,19,20,12,25,0,0,106
7,8,15,19,20,12,9,5,18,113
7,8,15,19,20,12,9,6,25,121
7,8,15,19,20,12,9,11,5,106
7,8,15,19,20,12,9,12,25,127
7,8,15,19,20,19,8,9,16,121
7,8,15,19,20,23,5,5,4,106
7,8,15,21,12,0,0,0,0,63
7,8,15,21,12,5,18,25,0,111
7,8,15,21,12,9,5,0,0,77
7,8,15,21,12,9,19,8,0,99
7,8,15,21,12,19,0,0,0,82
7,8,18,21,19,8,0,0,0,81
7,8,21,18,18,25,0,0,0,97
7,9,2,1,18,15,0,0,0,52
7,9,2,2,1,12,19,0,0,52
7,9,2,2,1,18,0,0,0,39
7,9,2,2,1,18,20,1,19,79
7,9,2,2,5,4,0,0,0,29
7,9,2,2,5,18,0,0,0,43
7,9,2,2,5,18,5,4,0,52
7,9,2,2,5,18,9,14,7,73
7,9,2,2,5,18,9,19,8,79
7,9,2,2,5,18,15,19,5,82
7,9,2,2,5,18,19,0,0,62
7,9,2,2,5,18,20,0,0,63
7,9,2,2,5,20,0,0,0,45
7,9,2,2,5,20,5,4,0,54
7,9,2,2,5,20,9,14,7,75
7,9,2,2,5,20,19,0,0,64
7,9,2,2,5,20,20,5,4,74
7,9,2,2,9,5,18,0,0,52
7,9,2,2,9,14,7,0,0,50
7,9,2,2,12,5,4,0,0,41
7,9,2,2,12,5,19,0,0,56
7,9,2,2,15,12,0,0,0,47
7,9,2,2,15,19,5,0,0,59
7,9,2,2,15,19,5,12,25,96
7,9,2,2,15,19,9,20,25,108
7,9,2,2,15,21,19,0,0,75
7,9,2,2,15,21,19,12,25,112
7,9,2,2,19,9,20,5,0,73
7,9,2,2,19,9,20,5,19,92
7,9,2,2,21,19,0,0,0,60
7,25,2,5,0,0,0,0,0,39
7,9,2,5,4,0,0,0,0,27
7,25,2,5,4,0,0,0,0,43
7,9,2,5,12,0,0,0,0,35
7,9,2,5,12,9,20,5,0,69
7,9,2,5,18,0,0,0,0,41
7,25,2,5,18,0,0,0,0,57
7,9,2,5,18,19,0,0,0,60
7,9,2,5,19,0,0,0,0,42
7,25,2,5,19,0,0,0,0,58
7,9,2,5,20,20,9,14,7,93
7,9,2,9,5,18,0,0,0,50
7,9,2,9,14,7,0,0,0,48
7,25,2,9,14,7,0,0,0,64
7,9,2,9,14,7,12,25,0,85
7,9,2,12,5,8,0,0,0,43
7,9,2,12,5,20,0,0,0,55
7,9,2,12,5,20,19,0,0,74
7,9,2,12,9,0,0,0,0,39
7,9,2,15,9,1,0,0,0,43
7,9,2,19,0,0,0,0,0,37
7,9,2,19,15,14,19,0,0,85
7,9,2,19,20,1,6,6,0,70
7,9,2,21,19,0,0,0,0,58
7,9,2,21,19,5,19,0,0,82
7,9,4,4,1,16,0,0,0,41
7,9,4,4,5,1,0,0,0,30
7,9,4,4,25,0,0,0,0,49
7,9,4,4,25,1,16,0,0,66
7,9,4,4,9,5,4,0,0,42
7,9,4,4,9,5,18,0,0,56
7,9,4,4,9,5,19,0,0,57
7,9,4,4,9,5,19,20,0,77
7,9,4,4,9,6,25,0,0,64
7,9,4,4,25,8,5,1,4,67
7,9,4,4,25,9,14,7,0,79
7,9,4,4,25,9,19,8,0,85
7,9,4,4,9,12,25,0,0,70
7,9,4,4,9,14,5,19,19,90
7,9,4,4,25,16,1,20,5,91
7,9,4,4,25,21,16,0,0,86
7,9,4,7,5,1,0,0,0,33
7,9,4,7,5,5,0,0,0,37
7,9,4,25,5,1,0,0,0,51
7,9,4,10,5,5,0,0,0,40
7,9,4,19,0,0,0,0,0,39
7,9,5,0,0,0,0,0,0,21
7,25,5,0,0,0,0,0,0,37
7,9,5,1,23,1,25,0,0,71
7,9,5,1,23,1,25,19,0,90
7,9,5,4,0,0,0,0,0,25
7,9,5,9,14,7,0,0,0,51
7,9,5,14,0,0,0,0,0,35
7,9,5,19,5,12,0,0,0,57
7,9,6,2,12,1,1,18,0,56
7,9,6,6,7,1,6,6,0,48
7,9,6,20,0,0,0,0,0,42
7,9,6,20,2,15,15,11,0,85
7,9,6,20,5,4,0,0,0,51
7,9,6,20,5,4,12,25,0,88
7,9,6,20,9,5,0,0,0,56
7,9,6,20,9,14,7,0,0,72
7,9,6,20,12,5,19,19,0,97
7,9,6,20,12,9,11,5,0,79
7,9,6,20,12,9,14,7,0,84
7,9,6,20,19,0,0,0,0,61
7,9,6,20,21,18,5,0,0,86
7,9,6,20,23,1,18,5,0,89
7,9,6,20,23,18,1,16,0,100
7,9,7,0,0,0,0,0,0,23
7,9,7,1,0,0,0,0,0,24
7,9,7,1,2,9,20,0,0,55
7,9,7,1,2,25,20,5,0,76
7,9,7,1,2,25,20,5,19,95
7,9,7,1,2,9,20,19,0,74
7,9,7,1,3,25,3,12,5,72
7,9,7,1,4,15,9,4,0,56
7,9,7,1,8,5,18,20,26,101
7,9,7,1,8,5,18,26,0,81
7,9,7,1,13,1,18,5,5,66
7,9,7,1,13,5,20,5,18,85
7,9,7,1,14,20,0,0,0,58
7,9,7,1,14,20,1,12,0,71
7,9,7,1,14,20,5,1,14,78
7,9,7,1,14,20,9,3,0,70
7,9,7,1,14,20,9,14,5,86
7,9,7,1,14,20,9,19,13,99
7,9,7,1,14,20,9,26,5,98
7,9,7,1,19,0,0,0,0,43
7,9,7,1,20,15,14,0,0,73
7,9,7,1,20,15,14,19,0,92
7,9,7,1,22,15,12,20,0,93
7,9,7,1,23,1,20,20,0,88
7,9,7,1,23,1,20,20,19,107
7,9,7,2,1,3,11,0,0,40
7,9,7,5,12,9,18,1,0,68
7,9,7,5,18,9,1,0,0,56
7,9,7,5,18,9,21,13,0,89
7,9,7,6,21,12,0,0,0,62
7,9,7,7,5,0,0,0,0,35
7,9,7,7,5,4,0,0,0,39
7,9,7,7,5,18,0,0,0,53
7,9,7,7,5,20,0,0,0,55
7,9,7,7,9,14,7,0,0,60
7,9,7,7,9,19,8,0,0,66
7,9,7,7,9,20,0,0,0,59
7,9,7,7,12,5,0,0,0,47
7,9,7,7,12,5,4,0,0,51
7,9,7,7,12,5,4,15,13,79
7,9,7,7,12,5,18,0,0,65
7,9,7,7,12,5,18,19,0,84
7,9,7,7,12,5,19,0,0,66
7,9,7,7,12,25,0,0,0,67
7,9,7,7,12,9,5,18,0,74
7,9,7,7,12,9,5,19,20,95
7,9,7,7,12,9,14,7,0,72
7,9,7,7,12,9,19,8,0,78
7,9,7,8,5,0,0,0,0,36
7,9,7,12,5,20,0,0,0,60
7,9,7,12,5,20,19,0,0,79
7,9,7,12,9,1,20,15,0,80
7,9,7,12,15,20,0,0,0,70
7,9,7,12,15,20,19,0,0,89
7,9,7,13,1,14,0,0,0,51
7,9,7,13,1,14,5,19,19,94
7,9,7,13,1,14,9,1,0,61
7,9,7,13,1,14,9,3,0,63
7,9,7,13,1,14,9,19,13,92
7,9,7,13,1,14,9,20,25,105
7,9,7,14,1,20,5,0,0,63
7,9,7,14,9,20,9,22,5,102
7,9,7,15,12,15,0,0,0,65
7,9,7,15,12,15,19,0,0,84
7,9,7,15,20,0,0,0,0,58
7,9,7,15,20,19,0,0,0,77
7,9,7,19,0,0,0,0,0,42
7,9,7,19,13,1,14,0,0,70
7,9,7,19,13,5,14,0,0,74
7,9,7,19,20,5,18,0,0,85
7,9,7,20,18,5,5,0,0,71
7,9,7,21,5,0,0,0,0,49
7,9,7,21,5,19,0,0,0,68
7,9,7,21,14,21,0,0,0,79
7,9,8,5,18,0,0,0,0,47
7,9,9,14,23,1,12,5,0,80
7,9,12,4,0,0,0,0,0,32
7,9,12,4,1,2,12,5,0,52
7,9,12,4,5,4,0,0,0,41
7,9,12,4,5,14,0,0,0,51
7,9,12,4,5,18,19,0,0,74
7,9,12,4,8,1,12,12,0,65
7,9,12,4,8,1,12,12,19,84
7,9,12,4,9,14,7,0,0,62
7,9,12,4,9,14,7,19,0,81
7,9,12,4,19,0,0,0,0,51
7,9,12,4,19,8,9,16,0,84
7,9,12,4,19,13,1,14,0,79
7,9,12,4,19,13,5,14,0,83
7,25,12,5,0,0,0,0,0,49
7,9,12,5,14,25,5,18,0,95
7,9,12,5,14,25,9,5,0,86
7,9,12,5,20,0,0,0,0,53
7,9,12,7,1,9,0,0,0,45
7,9,12,7,1,13,5,19,0,73
7,9,12,7,9,5,0,0,0,49
7,9,12,7,21,25,0,0,0,81
7,9,12,7,21,12,0,0,0,68
7,9,12,7,21,12,9,13,0,90
7,9,12,9,13,0,0,0,0,50
7,9,12,12,1,18,0,0,0,59
7,9,12,12,1,18,15,15,0,89
7,9,12,12,2,9,18,4,0,73
7,9,12,12,5,4,0,0,0,49
7,9,12,12,5,18,0,0,0,63
7,9,12,12,5,18,19,0,0,82
7,9,12,12,6,12,9,18,20,105
7,9,12,12,9,5,4,0,0,58
7,9,12,12,9,5,19,0,0,73
7,9,12,12,25,9,14,7,0,95
7,9,12,12,9,14,7,0,0,70
7,9,12,12,9,15,14,0,0,78
7,9,12,12,9,22,5,18,0,94
7,9,12,12,14,5,20,0,0,79
7,9,12,12,14,5,20,19,0,98
7,9,12,12,15,20,0,0,0,75
7,9,12,12,15,20,1,7,5,88
7,9,12,12,15,20,25,16,5,121
7,9,12,12,19,0,0,0,0,59
7,9,12,12,19,20,15,21,16,131
7,9,12,15,0,0,0,0,0,43
7,9,12,15,21,18,0,0,0,82
7,9,12,16,5,25,0,0,0,74
7,9,12,16,25,0,0,0,0,69
7,9,12,18,1,22,1,7,5,82
7,9,12,19,0,0,0,0,0,47
7,9,12,19,5,0,0,0,0,52
7,9,12,20,0,0,0,0,0,48
7,9,12,20,3,21,16,0,0,88
7,9,12,20,5,14,0,0,0,67
7,9,12,20,8,5,1,4,0,66
7,9,12,20,8,5,1,4,19,85
7,9,12,20,25,0,0,0,0,73
7,9,12,20,19,0,0,0,0,67
7,9,12,20,20,1,9,12,0,90
7,9,12,22,5,18,0,0,0,73
7,9,13,0,0,0,0,0,0,29
7,25,13,0,0,0,0,0,0,45
7,9,13,2,1,12,0,0,0,44
7,9,13,2,1,12,5,4,0,53
7,9,13,2,1,12,9,14,7,74
7,9,13,2,1,12,12,5,4,65
7,9,13,2,1,12,19,0,0,63
7,9,13,2,12,5,20,0,0,68
7,9,13,2,18,9,0,0,0,58
7,9,13,3,18,1,3,11,0,65
7,9,13,3,18,1,3,11,25,90
7,9,13,3,18,1,3,11,19,84
7,9,13,5,12,0,0,0,0,46
7,25,13,5,12,0,0,0,0,62
7,9,13,5,12,19,0,0,0,65
7,25,13,11,8,1,14,1,0,80
7,25,13,11,8,1,14,1,19,99
7,9,13,12,5,20,0,0,0,66
7,9,13,12,5,20,5,4,0,75
7,9,13,12,5,20,25,0,0,91
7,9,13,12,5,20,9,14,7,96
7,9,13,12,5,20,19,0,0,85
7,9,13,13,1,12,0,0,0,55
7,25,13,13,1,12,0,0,0,71
7,9,13,13,1,12,5,4,0,64
7,9,13,13,1,12,19,0,0,74
7,9,13,13,5,0,0,0,0,47
7,9,13,13,5,18,0,0,0,65
7,9,13,13,5,18,16,5,20,106
7,9,13,13,9,3,11,0,0,65
7,9,13,13,9,3,11,5,4,74
7,9,13,13,9,3,11,25,0,90
7,9,13,13,9,3,11,18,25,108
7,9,13,13,9,3,11,19,0,84
7,9,13,13,9,5,0,0,0,56
7,9,13,13,9,5,19,0,0,75
7,9,13,13,15,18,0,0,0,75
7,25,13,14,1,19,9,1,0,89
7,25,13,14,1,19,9,1,12,101
7,25,13,14,1,19,9,3,0,91
7,25,13,14,1,19,20,0,0,99
7,25,13,14,1,19,20,9,3,111
7,25,13,14,1,19,20,19,0,118
7,25,13,14,5,13,9,3,0,89
7,25,13,14,9,3,0,0,0,71
7,25,13,14,9,3,1,12,0,84
7,25,13,14,9,3,19,0,0,90
7,25,13,14,9,20,5,0,0,93
7,25,13,14,15,4,15,14,20,127
7,25,13,14,15,7,5,14,0,100
7,25,13,14,15,7,5,14,5,105
7,25,13,14,15,19,15,16,8,132
7,25,13,14,15,20,9,4,0,107
7,25,13,14,21,18,5,0,0,103
7,25,13,14,21,18,9,14,5,126
7,9,13,16,0,0,0,0,0,45
7,9,13,16,5,4,0,0,0,54
7,9,13,16,5,18,0,0,0,68
7,9,13,16,25,0,0,0,0,70
7,25,13,16,9,5,0,0,0,75
7,9,13,16,9,5,18,0,0,77
7,9,13,16,9,5,19,20,0,98
7,9,13,16,9,14,7,0,0,75
7,9,13,16,19,0,0,0,0,64
7,25,13,19,0,0,0,0,0,64
7,25,13,19,9,1,0,0,0,74
7,25,13,19,12,9,16,0,0,101
7,25,14,0,0,0,0,0,0,46
7,25,14,1,5,3,5,1,0,61
7,25,14,1,5,3,5,21,13,94
7,25,14,1,5,3,9,1,0,65
7,25,14,1,5,3,9,1,14,79
7,25,14,1,5,3,9,3,0,67
7,25,14,1,5,3,9,21,13,98
7,25,14,1,5,3,15,9,4,83
7,25,14,1,5,3,15,12,0,82
7,25,14,1,14,4,5,18,0,88
7,25,14,1,14,4,18,25,0,108
7,25,14,1,18,3,8,25,0,101
7,25,14,1,18,3,8,9,3,88
7,25,14,5,0,0,0,0,0,51
7,25,14,5,3,3,9,1,0,67
7,25,14,5,3,9,1,0,0,64
7,25,14,5,3,9,3,0,0,66
7,25,14,5,3,9,4,1,12,80
7,25,14,5,3,9,4,5,0,72
7,25,14,5,3,9,21,13,0,97
7,25,14,5,3,15,9,4,0,82
7,25,14,5,3,15,12,0,0,81
7,9,14,5,16,0,0,0,0,51
7,9,14,5,20,5,0,0,0,60
7,25,14,5,20,25,16,5,0,117
7,9,14,7,0,0,0,0,0,37
7,9,14,7,1,12,0,0,0,50
7,9,14,7,1,12,12,0,0,62
7,9,14,7,1,12,12,19,0,81
7,9,14,7,1,12,19,0,0,69
7,9,14,7,5,12,5,25,0,84
7,9,14,7,5,12,5,25,19,103
7,9,14,7,5,12,9,0,0,63
7,9,14,7,5,12,25,0,0,79
7,9,14,7,5,12,9,5,19,87
7,9,14,7,5,12,9,19,0,82
7,9,14,7,5,12,12,9,0,75
7,9,14,7,5,12,12,25,0,91
7,9,14,7,5,18,1,4,5,70
7,9,14,7,5,18,5,4,0,69
7,9,14,7,5,18,25,0,0,85
7,9,14,7,5,18,9,14,0,83
7,9,14,7,5,18,9,14,7,90
7,9,14,7,5,18,12,25,0,97
7,9,14,7,5,18,14,21,20,115
7,9,14,7,5,18,15,12,0,87
7,9,14,7,5,18,15,21,19,115
7,9,14,7,5,18,19,0,0,79
7,9,14,7,8,1,13,0,0,59
7,9,14,7,8,1,13,5,4,68
7,9,14,7,8,1,13,19,0,78
7,9,14,7,9,12,9,0,0,67
7,9,14,7,9,12,9,19,0,86
7,9,14,7,9,12,12,9,0,79
7,9,14,7,9,22,1,0,0,69
7,9,14,7,9,22,1,5,0,74
7,9,14,7,9,22,1,12,0,81
7,9,14,7,11,15,0,0,0,63
7,9,14,7,11,15,5,19,0,87
7,9,14,7,12,5,0,0,0,54
7,9,14,7,12,5,19,0,0,73
7,9,14,7,12,25,13,9,0,96
7,9,14,7,12,25,13,21,19,127
7,9,14,7,12,25,14,9,0,97
7,9,14,7,12,13,9,0,0,71
7,9,14,8,15,21,14,4,0,92
7,9,14,8,15,21,19,5,0,98
7,25,14,25,0,0,0,0,0,71
7,25,14,9,1,20,18,25,0,119
7,25,14,9,3,0,0,0,0,58
7,25,14,9,3,19,0,0,0,77
7,9,14,11,0,0,0,0,0,41
7,9,14,11,7,15,5,19,0,87
7,9,14,11,7,15,19,0,0,82
7,9,14,11,19,0,0,0,0,60
7,9,14,13,9,12,12,0,0,76
7,9,14,14,5,4,0,0,0,53
7,9,14,14,5,25,0,0,0,74
7,9,14,14,5,12,0,0,0,61
7,9,14,14,5,18,0,0,0,67
7,9,14,14,5,18,25,0,0,92
7,9,14,14,5,18,9,5,19,100
7,9,14,14,5,18,19,0,0,86
7,9,14,14,5,20,0,0,0,69
7,9,14,14,9,5,18,0,0,76
7,9,14,14,9,5,19,20,0,97
7,9,14,14,9,14,7,0,0,74
7,9,14,14,9,14,7,19,0,93
7,9,14,14,12,5,0,0,0,61
7,25,14,15,2,1,19,5,0,88
7,25,14,15,2,1,19,9,3,95
7,25,14,15,3,18,1,3,25,111
7,25,14,15,5,3,9,1,0,79
7,25,14,15,5,3,9,21,13,112
7,25,14,15,16,1,18,1,0,97
7,25,14,15,16,8,15,18,5,123
7,9,14,15,18,9,20,5,0,97
7,25,14,15,19,16,15,18,5,134
7,25,14,15,21,19,0,0,0,101
7,9,14,19,0,0,0,0,0,49
7,9,14,19,5,14,7,0,0,75
7,9,14,19,5,14,7,19,0,94
7,9,14,23,1,18,4,0,0,76
7,9,14,26,15,0,0,0,0,71
7,9,14,26,15,5,19,0,0,95
7,9,15,3,15,19,15,0,0,83
7,9,15,10,15,19,15,0,0,90
7,25,15,11,21,18,15,0,0,112
7,9,15,18,14,1,20,1,0,85
7,9,16,0,0,0,0,0,0,32
7,25,16,0,0,0,0,0,0,48
7,25,16,5,0,0,0,0,0,53
7,25,16,12,21,18,5,0,0,104
7,25,16,12,21,18,5,19,0,123
7,9,16,15,14,0,0,0,0,61
7,9,16,15,14,19,0,0,0,80
7,9,16,16,5,4,0,0,0,57
7,25,16,16,5,4,0,0,0,73
7,9,16,16,5,18,0,0,0,71
7,25,16,16,5,18,0,0,0,87
7,25,16,16,5,18,25,0,0,112
7,9,16,16,5,18,19,0,0,90
7,25,16,16,5,18,19,0,0,106
7,9,16,16,9,14,7,0,0,78
7,25,16,16,9,14,7,0,0,94
7,9,16,16,15,0,0,0,0,63
7,9,16,19,0,0,0,0,0,51
7,9,16,19,5,9,1,14,0,80
7,25,16,19,5,9,1,14,0,96
7,25,16,19,5,15,21,19,0,127
7,9,16,19,5,18,0,0,0,74
7,9,16,19,25,4,15,13,0,108
7,25,16,19,25,4,15,13,0,124
7,25,16,19,25,4,15,13,19,143
7,9,16,19,9,5,4,0,0,69
7,25,16,19,9,5,4,0,0,85
7,9,16,19,25,6,25,0,0,107
7,25,16,19,25,6,25,0,0,123
7,9,16,19,25,8,5,1,4,94
7,25,16,19,25,8,5,1,4,110
7,9,16,19,25,8,15,15,4,118
7,25,16,19,25,8,15,15,4,134
7,9,16,19,25,9,14,7,0,106
7,25,16,19,25,9,14,7,0,122
7,9,16,19,25,9,19,8,0,112
7,25,16,19,25,9,19,8,0,128
7,9,16,19,25,9,19,13,0,117
7,25,16,19,25,9,19,13,0,133
7,25,16,19,25,9,19,13,19,152
7,9,16,19,25,12,9,11,5,113
7,25,16,19,25,12,9,11,5,129
7,25,16,19,9,14,5,0,0,95
7,9,16,19,9,18,5,0,0,83
7,9,16,19,25,18,25,0,0,119
7,25,16,19,25,18,25,0,0,135
7,25,16,19,9,20,5,0,0,101
7,9,16,19,25,23,5,5,4,113
7,25,16,19,25,23,5,5,4,129
7,25,16,19,25,23,9,19,5,148
7,9,16,19,25,23,15,18,20,152
7,25,16,19,25,23,15,18,20,168
7,9,16,19,15,12,15,7,25,125
7,25,16,19,15,12,15,7,25,141
7,25,16,19,15,21,19,0,0,122
7,25,16,19,20,5,18,0,0,110
7,25,16,19,20,5,18,19,0,129
7,25,16,19,21,13,0,0,0,101
7,25,16,19,21,13,5,4,0,110
7,25,16,19,21,13,9,14,7,131
7,25,16,19,21,13,19,0,0,120
7,9,18,1,6,6,5,0,0,52
7,9,18,1,6,6,5,19,0,71
7,9,18,1,6,6,9,14,5,75
7,9,18,1,6,6,9,19,8,83
7,9,18,1,6,6,15,9,4,75
7,25,18,1,12,0,0,0,0,63
7,25,18,1,12,12,25,0,0,100
7,9,18,1,14,4,15,12,1,81
7,9,18,1,14,4,15,12,5,85
7,25,18,1,14,20,0,0,0,85
7,9,18,1,19,15,12,0,0,81
7,9,18,1,19,15,12,5,0,86
7,9,18,1,19,15,12,5,19,105
7,9,18,1,19,15,12,19,0,100
7,25,18,1,20,5,0,0,0,76
7,25,18,1,20,5,4,0,0,80
7,25,18,1,20,5,19,0,0,95
7,25,18,1,20,9,14,7,0,101
7,25,18,1,20,9,15,14,0,109
7,25,18,1,20,9,15,14,19,128
7,25,18,1,20,15,18,0,0,104
7,25,18,1,20,15,18,25,0,129
7,25,18,1,20,15,18,19,0,123
7,9,18,2,1,0,0,0,0,37
7,9,18,4,0,0,0,0,0,38
7,9,18,4,5,4,0,0,0,47
7,9,18,4,5,18,0,0,0,61
7,9,18,4,5,18,1,7,5,74
7,9,18,4,5,18,9,14,7,91
7,9,18,4,5,18,19,0,0,80
7,9,18,4,9,14,7,0,0,68
7,9,18,4,9,14,7,12,25,105
7,9,18,4,12,5,0,0,0,55
7,9,18,4,12,5,4,0,0,59
7,9,18,4,12,5,18,19,0,92
7,9,18,4,12,5,19,0,0,74
7,9,18,4,12,9,14,7,0,80
7,9,18,4,19,0,0,0,0,57
7,9,18,5,0,0,0,0,0,39
7,25,18,5,0,0,0,0,0,55
7,25,18,5,3,20,15,13,25,131
7,25,18,5,4,0,0,0,0,59
7,25,18,5,14,5,0,0,0,74
7,25,18,5,14,5,19,0,0,93
7,25,18,5,19,0,0,0,0,74
7,25,18,6,1,12,3,15,14,101
7,25,18,9,0,0,0,0,0,59
7,25,18,9,3,0,0,0,0,62
7,25,18,9,14,7,0,0,0,80
7,25,18,9,14,9,4,0,0,86
7,9,18,10,1,0,0,0,0,45
7,9,18,11,9,14,0,0,0,68
7,9,18,12,0,0,0,0,0,46
7,9,18,12,1,14,4,0,0,65
7,9,18,12,3,8,9,12,4,82
7,9,18,12,5,5,14,0,0,70
7,9,18,12,5,18,25,0,0,94
7,9,18,12,6,21,12,12,25,122
7,9,18,12,8,15,15,4,0,88
7,9,18,12,8,15,15,4,19,107
7,9,18,12,25,0,0,0,0,71
7,9,18,12,9,5,0,0,0,60
7,9,18,12,9,5,19,0,0,79
7,9,18,12,9,14,5,19,19,112
7,9,18,12,9,14,7,0,0,76
7,9,18,12,9,19,8,0,0,82
7,9,18,12,9,19,8,12,25,119
7,9,18,12,9,19,13,0,0,87
7,9,18,12,12,9,11,5,0,83
7,9,18,12,19,0,0,0,0,65
7,9,18,14,0,0,0,0,0,48
7,9,18,14,1,12,0,0,0,61
7,9,18,14,5,4,0,0,0,57
7,9,18,14,5,12,0,0,0,65
7,9,18,14,25,0,0,0,0,73
7,9,18,14,9,5,0,0,0,62
7,9,18,14,9,14,7,0,0,78
7,9,18,14,19,0,0,0,0,67
7,9,18,15,0,0,0,0,0,49
7,25,18,15,0,0,0,0,0,65
7,25,18,15,3,1,18,0,0,87
7,25,18,15,3,5,18,1,14,106
7,25,18,15,4,25,14,5,0,113
7,9,18,15,6,12,15,18,5,105
7,25,18,15,7,18,1,16,8,115
7,25,18,15,9,4,1,12,0,91
7,25,18,15,12,9,20,5,0,111
7,25,18,15,12,9,20,8,0,114
7,25,18,15,13,1,0,0,0,79
7,25,18,15,13,1,14,3,25,121
7,25,18,15,13,5,12,5,0,100
7,25,18,15,13,5,20,5,18,126
7,9,18,15,14,0,0,0,0,63
7,25,18,15,14,0,0,0,0,79
7,9,18,15,14,14,25,0,0,102
7,25,18,15,14,14,25,0,0,118
7,9,18,15,14,19,0,0,0,82
7,25,18,15,14,19,0,0,0,98
7,25,18,15,16,12,1,14,5,113
7,9,18,15,19,0,0,0,0,68
7,25,18,15,19,0,0,0,0,84
7,25,18,15,19,3,15,16,5,123
7,25,18,15,19,5,0,0,0,89
7,25,18,15,19,25,14,0,0,123
7,9,18,15,19,15,12,0,0,95
7,9,18,15,19,15,12,19,0,114
7,25,18,15,19,20,1,20,0,125
7,25,18,15,19,20,1,20,19,144
7,9,18,15,21,5,20,20,5,120
7,25,18,15,21,19,0,0,0,105
7,25,18,15,22,1,7,9,0,104
7,25,18,15,22,1,7,21,5,121
7,25,18,15,23,8,5,5,12,118
7,9,18,18,0,0,0,0,0,52
7,9,18,18,9,20,0,0,0,81
7,9,18,18,15,3,11,0,0,81
7,9,18,19,5,0,0,0,0,58
7,9,18,19,8,0,0,0,0,61
7,9,18,19,8,5,19,0,0,85
7,9,18,19,12,5,0,0,0,70
7,9,18,20,0,0,0,0,0,54
7,9,18,20,5,4,0,0,0,63
7,9,18,20,8,0,0,0,0,62
7,9,18,20,8,5,4,0,0,71
7,9,18,20,8,9,14,7,0,92
7,9,18,20,8,12,9,14,5,102
7,9,18,20,8,19,0,0,0,81
7,9,18,20,9,14,7,0,0,84
7,9,18,20,12,9,14,5,0,94
7,9,18,20,15,14,9,1,14,107
7,9,18,20,19,0,0,0,0,73
7,25,18,21,19,0,0,0,0,90
7,9,19,1,14,20,0,0,0,70
7,9,19,1,14,20,19,0,0,89
7,9,19,1,18,13,5,0,0,72
7,9,19,1,18,13,5,19,0,91
7,9,19,5,0,0,0,0,0,40
7,25,19,5,0,0,0,0,0,56
7,9,19,5,12,0,0,0,0,52
7,9,19,5,13,5,14,20,0,92
7,9,19,12,1,0,0,0,0,48
7,9,19,12,5,18,0,0,0,70
7,9,19,13,15,0,0,0,0,63
7,9,19,13,15,19,0,0,0,82
7,9,19,16,9,14,0,0,0,74
7,9,19,20,0,0,0,0,0,55
7,9,19,20,19,0,0,0,0,74
7,9,20,0,0,0,0,0,0,36
7,9,20,1,12,9,14,0,0,72
7,9,20,1,14,5,13,21,11,101
7,9,20,1,14,15,0,0,0,66
7,9,20,1,14,15,19,0,0,85
7,9,20,5,0,0,0,0,0,41
7,25,20,5,0,0,0,0,0,57
7,9,20,5,18,14,5,0,0,78
7,9,20,8,0,0,0,0,0,44
7,9,20,9,13,0,0,0,0,58
7,25,20,12,9,14,7,0,0,94
7,9,20,15,14,9,14,0,0,88
7,9,20,15,24,9,14,0,0,98
7,25,20,18,1,19,8,0,0,98
7,9,20,20,5,18,0,0,0,79
7,9,20,20,5,18,14,0,0,93
7,9,20,20,5,18,14,19,0,112
7,9,20,20,9,20,8,0,0,93
7,25,20,20,10,1,0,0,0,83
7,9,21,14,20,1,0,0,0,72
7,9,21,19,20,0,0,0,0,76
7,9,22,5,0,0,0,0,0,43
7,25,22,5,0,0,0,0,0,59
7,9,22,5,1,2,12,5,0,63
7,9,22,5,1,23,1,25,0,93
7,9,22,5,1,23,1,25,19,112
7,9,22,5,2,1,3,11,0,60
7,25,22,5,4,0,0,0,0,63
7,9,22,5,25,0,0,0,0,68
7,9,22,5,14,14,5,19,19,114
7,9,22,5,14,19,0,0,0,76
7,9,22,5,18,0,0,0,0,61
7,9,22,5,18,19,0,0,0,80
7,9,22,5,19,0,0,0,0,62
7,25,22,5,19,0,0,0,0,78
7,9,22,5,20,8,0,0,0,71
7,9,22,9,14,0,0,0,0,61
7,9,22,9,14,7,0,0,0,68
7,25,22,9,14,7,0,0,0,84
7,9,26,13,15,0,0,0,0,70
7,9,26,13,15,19,0,0,0,89
7,9,26,26,0,0,0,0,0,68
7,9,26,26,1,18,4,0,0,91
7,9,26,26,1,18,4,19,0,110
7,9,26,26,5,14,0,0,0,87
7,9,26,26,5,14,5,4,0,96
7,9,26,26,5,18,14,0,0,105
7,10,5,4,15,19,20,0,0,80
7,10,5,20,15,19,20,0,0,96
7,10,5,20,15,19,20,19,0,115
7,12,2,0,0,0,0,0,0,21
7,12,5,1,4,0,0,0,0,29
7,12,5,1,13,0,0,0,0,38
7,12,5,1,13,5,4,0,0,47
7,12,5,1,13,5,18,0,0,61
7,12,5,1,13,5,18,19,0,80
7,12,5,1,13,25,0,0,0,63
7,12,5,1,13,9,5,18,0,70
7,12,5,1,13,9,5,19,20,91
7,12,5,1,13,9,12,25,0,84
7,12,5,1,13,9,14,7,0,68
7,12,5,1,13,12,5,19,19,93
7,12,5,1,13,19,0,0,0,57
7,12,5,1,14,0,0,0,0,39
7,12,5,1,14,1,2,12,5,59
7,12,5,1,14,5,4,0,0,48
7,12,5,1,14,5,18,0,0,62
7,12,5,1,14,5,18,19,0,81
7,12,5,1,14,9,14,7,0,69
7,12,5,1,14,9,14,7,19,88
7,12,5,1,14,19,0,0,0,58
7,12,5,1,18,25,0,0,0,68
7,12,5,1,22,5,0,0,0,52
7,12,5,2,1,0,0,0,0,27
7,12,5,2,1,5,0,0,0,32
7,12,5,2,1,12,0,0,0,39
7,12,5,2,5,0,0,0,0,31
7,12,5,2,5,12,5,19,19,86
7,12,5,2,5,19,0,0,0,50
7,12,5,2,25,0,0,0,0,51
7,12,5,2,15,21,19,0,0,81
7,12,5,4,0,0,0,0,0,28
7,12,5,4,5,0,0,0,0,33
7,12,5,4,5,19,0,0,0,52
7,12,5,4,7,5,0,0,0,40
7,12,5,4,25,0,0,0,0,53
7,12,5,4,19,0,0,0,0,47
7,12,5,5,4,0,0,0,0,33
7,12,5,5,4,19,0,0,0,52
7,12,5,5,6,21,12,0,0,68
7,12,5,5,6,21,12,12,25,105
7,12,5,5,9,19,8,12,25,102
7,12,5,5,11,0,0,0,0,40
7,12,5,5,11,5,4,0,0,49
7,12,5,5,11,9,14,7,0,70
7,12,5,5,11,19,0,0,0,59
7,12,5,5,13,1,14,0,0,57
7,12,5,5,13,5,14,0,0,61
7,12,5,5,14,0,0,0,0,43
7,12,5,5,19,0,0,0,0,48
7,12,5,5,19,15,13,5,0,81
7,12,5,5,20,0,0,0,0,49
7,12,5,5,20,5,4,0,0,58
7,12,5,5,20,25,0,0,0,74
7,12,5,5,20,9,5,18,0,81
7,12,5,5,20,9,5,19,20,102
7,12,5,5,20,9,14,7,0,79
7,12,5,5,20,19,0,0,0,68
7,12,5,5,23,15,13,1,14,95
7,12,5,7,0,0,0,0,0,31
7,12,5,7,12,25,0,0,0,68
7,12,5,7,14,5,19,19,0,88
7,12,5,25,0,0,0,0,0,49
7,12,5,25,4,5,0,0,0,58
7,12,5,9,18,0,0,0,0,51
7,12,5,25,19,0,0,0,0,68
7,12,5,9,20,0,0,0,0,53
7,12,5,14,4,15,22,5,18,102
7,12,5,14,5,0,0,0,0,43
7,12,5,14,12,9,11,5,0,75
7,12,5,14,12,9,22,5,20,106
7,12,5,14,15,9,4,0,0,66
7,12,5,14,15,9,4,1,12,79
7,12,5,14,19,0,0,0,0,57
7,12,5,14,20,0,0,0,0,58
7,12,5,19,19,9,20,5,0,96
7,12,5,20,19,3,8,5,18,97
7,12,5,20,20,25,0,0,0,89
7,12,5,23,0,0,0,0,0,47
7,12,9,1,0,0,0,0,0,29
7,12,9,1,4,9,14,0,0,56
7,12,9,1,4,9,14,5,0,61
7,12,9,1,4,9,14,5,19,80
7,12,9,1,4,9,14,19,0,75
7,12,9,1,12,0,0,0,0,41
7,12,9,1,19,0,0,0,0,48
7,12,9,2,0,0,0,0,0,30
7,12,9,2,2,5,18,0,0,55
7,12,9,2,2,5,18,25,0,80
7,12,9,2,2,5,19,20,0,76
7,12,9,2,12,25,0,0,0,67
7,12,9,2,14,5,19,19,0,87
7,12,25,3,0,0,0,0,0,47
7,12,25,3,1,5,13,9,1,76
7,12,25,3,1,5,13,9,3,78
7,12,25,3,1,14,0,0,0,62
7,12,25,3,1,14,19,0,0,81
7,12,25,3,5,13,9,1,0,75
7,12,25,3,5,13,9,3,0,77
7,12,25,3,5,18,1,12,0,83
7,12,25,3,5,18,1,20,5,96
7,12,25,3,5,18,9,3,0,82
7,12,25,3,5,18,9,4,5,88
7,12,25,3,5,18,25,12,0,107
7,12,25,3,5,18,25,12,19,126
7,12,25,3,5,18,9,14,0,93
7,12,25,3,5,18,9,14,5,98
7,12,25,3,5,18,9,14,19,112
7,12,25,3,5,18,9,20,5,104
7,12,25,3,5,18,9,26,5,110
7,12,25,3,5,18,15,12,0,97
7,12,25,3,5,18,15,12,5,102
7,12,25,3,5,18,15,12,19,116
7,12,25,3,5,18,15,19,5,109
7,12,25,3,9,3,0,0,0,59
7,12,25,3,9,4,0,0,0,60
7,12,25,3,9,4,5,0,0,65
7,12,25,3,9,4,9,3,0,72
7,12,25,3,9,4,15,12,0,87
7,12,25,3,25,12,0,0,0,84
7,12,25,3,25,12,19,0,0,103
7,12,25,3,9,14,0,0,0,70
7,12,25,3,9,14,5,19,0,94
7,12,25,3,9,14,9,14,0,93
7,12,25,3,9,14,19,0,0,89
7,12,25,3,25,18,9,26,5,130
7,12,25,3,15,3,9,14,0,88
7,12,25,3,15,3,15,12,12,104
7,12,25,3,15,7,5,14,0,88
7,12,25,3,15,7,5,14,25,113
7,12,25,3,15,7,5,14,19,107
7,12,25,3,15,12,0,0,0,74
7,12,25,3,15,12,1,20,5,100
7,12,25,3,15,12,9,3,0,86
7,12,25,3,15,12,9,4,5,92
7,12,25,3,15,12,25,12,0,111
7,12,25,3,15,12,12,9,3,98
7,12,25,3,15,12,19,0,0,93
7,12,25,3,15,14,5,1,14,96
7,12,25,3,15,14,9,3,19,107
7,12,25,3,15,14,9,14,0,99
7,12,25,3,15,19,5,0,0,86
7,12,25,3,15,19,9,4,5,99
7,12,25,3,15,19,25,12,0,118
7,12,25,3,15,19,25,12,19,137
7,12,25,3,15,19,9,14,0,104
7,12,25,3,15,19,9,14,5,109
7,12,9,4,4,5,18,0,0,59
7,12,9,4,4,5,18,25,0,84
7,12,9,4,5,0,0,0,0,37
7,12,9,4,5,4,0,0,0,41
7,12,9,4,5,12,5,19,19,92
7,12,9,4,5,14,5,19,19,94
7,12,9,4,5,18,0,0,0,55
7,12,9,4,5,18,19,0,0,74
7,12,9,4,5,19,0,0,0,56
7,12,9,4,5,23,15,18,20,113
7,12,9,4,9,14,7,0,0,62
7,12,9,4,9,14,7,12,25,99
7,12,9,6,6,0,0,0,0,40
7,12,9,6,6,25,0,0,0,65
7,12,9,6,6,9,14,7,0,70
7,12,9,6,6,19,0,0,0,59
7,12,9,11,5,0,0,0,0,44
7,12,9,13,0,0,0,0,0,41
7,12,9,13,5,0,0,0,0,46
7,12,9,13,5,4,0,0,0,50
7,12,9,13,5,19,0,0,0,65
7,12,9,13,9,14,7,0,0,71
7,12,9,13,13,5,18,0,0,77
7,12,9,13,13,5,18,5,4,86
7,12,9,13,13,5,18,25,0,102
7,12,9,13,13,5,18,19,0,96
7,12,9,13,16,19,5,0,0,81
7,12,9,13,16,19,5,4,0,85
7,12,9,13,16,19,5,18,0,99
7,12,9,13,16,19,5,18,19,118
7,12,9,13,16,19,5,19,0,100
7,12,9,13,16,19,9,14,7,106
7,12,9,13,19,0,0,0,0,60
7,12,9,14,11,0,0,0,0,53
7,12,9,14,19,5,0,0,0,66
7,12,9,14,20,0,0,0,0,62
7,12,9,14,20,5,4,0,0,71
7,12,9,14,20,9,14,7,0,92
7,12,9,14,20,19,0,0,0,81
7,12,9,15,3,25,20,5,0,96
7,12,9,15,13,1,0,0,0,57
7,12,9,15,13,1,19,0,0,76
7,12,9,15,13,1,20,1,0,78
7,12,9,15,19,1,0,0,0,63
7,12,9,15,19,9,19,0,0,90
7,12,25,15,24,1,12,0,0,96
7,12,25,15,24,1,12,9,3,108
7,12,25,15,24,1,12,9,14,119
7,12,25,15,24,25,12,0,0,120
7,12,25,15,24,25,12,9,3,132
7,12,25,15,24,9,12,9,14,127
7,12,25,15,24,9,13,0,0,105
7,12,25,15,24,9,13,5,0,110
7,12,25,16,8,0,0,0,0,68
7,12,25,16,8,9,3,0,0,80
7,12,25,16,8,19,0,0,0,87
7,12,25,16,20,1,12,0,0,93
7,12,25,16,20,9,3,0,0,92
7,12,25,16,20,9,3,1,12,105
7,12,25,16,20,9,3,19,0,111
7,12,9,18,9,6,15,18,13,107
7,12,9,18,9,14,5,0,0,74
7,12,9,19,11,0,0,0,0,58
7,12,9,19,11,25,0,0,0,83
7,12,9,19,19,0,0,0,0,66
7,12,9,19,19,1,4,5,0,76
7,12,9,19,19,1,4,5,4,80
7,12,9,19,19,1,4,5,18,94
7,12,9,19,19,1,4,5,19,95
7,12,9,19,19,1,14,4,9,94
7,12,9,19,19,1,14,4,15,100
7,12,9,19,19,5,20,20,5,116
7,12,9,19,20,0,0,0,0,67
7,12,9,19,20,5,14,0,0,86
7,12,9,19,20,5,14,5,4,95
7,12,9,19,20,5,14,19,0,105
7,12,9,19,20,5,18,0,0,90
7,12,25,19,20,5,18,0,0,106
7,12,9,19,20,5,18,5,4,99
7,12,9,19,20,5,18,19,0,109
7,12,9,20,3,8,0,0,0,59
7,12,9,20,3,8,5,19,0,83
7,12,9,20,3,8,25,0,0,84
7,12,9,20,20,5,18,0,0,91
7,12,9,20,20,5,18,5,4,100
7,12,9,20,20,5,18,25,0,116
7,12,9,20,20,5,18,19,0,110
7,12,9,20,26,5,19,0,0,98
7,12,9,20,26,25,0,0,0,99
7,12,9,20,26,9,5,18,0,106
7,12,15,1,13,0,0,0,0,48
7,12,15,1,13,9,14,7,0,78
7,12,15,1,13,9,14,7,19,97
7,12,15,1,13,19,0,0,0,67
7,12,15,1,20,0,0,0,0,55
7,12,15,1,20,5,4,0,0,64
7,12,15,1,20,5,18,0,0,78
7,12,15,1,20,5,18,19,0,97
7,12,15,1,20,9,14,7,0,85
7,12,15,1,20,19,0,0,0,74
7,12,15,2,0,0,0,0,0,36
7,12,15,2,1,12,0,0,0,49
7,12,15,2,1,12,9,19,13,90
7,12,15,2,1,12,9,19,20,97
7,12,15,2,1,12,9,20,25,103
7,12,15,2,1,12,9,26,5,89
7,12,15,2,1,12,12,25,0,86
7,12,15,2,1,20,5,0,0,62
7,12,15,2,1,20,5,4,0,66
7,12,15,2,2,25,0,0,0,63
7,12,15,2,2,9,5,18,0,70
7,12,15,2,5,4,0,0,0,45
7,12,15,2,5,6,9,19,8,83
7,12,15,2,5,12,5,20,0,78
7,12,15,2,5,12,9,11,5,78
7,12,15,2,5,19,0,0,0,60
7,12,15,2,25,0,0,0,0,61
7,12,15,2,9,3,1,12,0,61
7,12,15,2,9,14,0,0,0,59
7,12,15,2,9,14,7,0,0,66
7,12,15,2,9,14,19,0,0,78
7,12,15,2,15,9,4,0,0,64
7,12,15,2,15,9,4,19,0,83
7,12,15,2,15,19,5,0,0,75
7,12,15,2,15,19,5,12,25,112
7,12,15,2,15,19,9,20,5,104
7,12,15,2,15,19,9,20,25,124
7,12,15,2,15,21,19,0,0,91
7,12,15,2,15,21,19,12,25,128
7,12,15,2,19,0,0,0,0,55
7,12,15,2,21,12,1,18,0,88
7,12,15,2,21,12,5,0,0,74
7,12,15,2,21,12,5,19,0,93
7,12,15,2,21,12,5,20,0,94
7,12,15,2,21,12,9,14,0,92
7,12,15,2,21,12,9,14,19,111
7,12,15,2,21,12,9,20,5,103
7,12,15,2,21,12,15,9,4,97
7,12,15,2,21,12,15,19,5,108
7,12,15,2,21,12,15,21,19,124
7,12,15,2,21,19,0,0,0,76
7,12,15,3,8,9,4,0,0,58
7,12,15,3,8,9,4,9,1,68
7,12,15,3,8,9,4,19,0,77
7,12,15,3,8,9,14,5,19,92
7,12,15,3,8,9,19,0,0,73
7,12,15,4,0,0,0,0,0,38
7,12,15,5,1,0,0,0,0,40
7,12,15,5,1,12,0,0,0,52
7,12,15,7,7,0,0,0,0,48
7,12,15,7,7,19,0,0,0,67
7,12,15,25,0,0,0,0,0,59
7,12,15,13,0,0,0,0,0,47
7,12,15,13,5,0,0,0,0,52
7,12,15,13,5,12,9,0,0,73
7,12,15,13,5,18,1,0,0,71
7,12,15,13,5,18,1,20,5,96
7,12,15,13,5,18,21,12,5,108
7,12,15,13,5,18,21,12,9,112
7,12,15,13,9,0,0,0,0,56
7,12,15,13,13,5,4,0,0,69
7,12,15,13,13,9,14,7,0,90
7,12,15,13,13,15,24,0,0,99
7,12,15,13,19,0,0,0,0,66
7,12,15,13,21,19,0,0,0,87
7,12,15,14,15,9,14,0,0,86
7,12,15,14,15,9,14,5,0,91
7,12,15,14,15,9,14,19,0,105
7,12,15,15,4,0,0,0,0,53
7,12,15,15,13,0,0,0,0,62
7,12,15,15,13,5,4,0,0,71
7,12,15,15,13,6,21,12,0,101
7,12,15,15,13,25,0,0,0,87
7,12,15,15,13,9,5,18,0,94
7,12,15,15,13,9,5,19,20,115
7,12,15,15,13,9,12,25,0,108
7,12,15,15,13,9,14,7,0,92
7,12,15,15,13,9,14,7,19,111
7,12,15,15,13,12,5,19,19,117
7,12,15,15,13,19,0,0,0,81
7,12,15,15,13,20,8,0,0,90
7,12,15,16,0,0,0,0,0,50
7,12,15,16,14,5,14,0,0,83
7,12,15,16,16,5,4,0,0,75
7,12,15,16,16,5,14,0,0,85
7,12,15,16,16,25,0,0,0,91
7,12,15,16,16,9,14,7,0,96
7,12,15,16,19,0,0,0,0,69
7,12,15,18,0,0,0,0,0,52
7,12,15,18,5,0,0,0,0,57
7,12,15,18,9,1,13,0,0,75
7,12,15,18,9,1,19,0,0,81
7,12,15,18,9,5,4,0,0,70
7,12,15,18,9,5,19,0,0,85
7,12,15,18,9,5,20,20,5,111
7,12,15,18,9,6,25,0,0,92
7,12,15,18,9,6,9,5,4,85
7,12,15,18,9,6,9,5,18,99
7,12,15,18,9,6,9,5,19,100
7,12,15,18,25,6,21,12,0,116
7,12,15,18,25,9,14,7,0,107
7,12,15,18,25,12,5,19,19,132
7,12,15,18,9,15,12,5,0,93
7,12,15,18,9,15,12,5,19,112
7,12,15,18,9,15,19,15,0,110
7,12,15,18,9,15,21,19,0,116
7,12,15,19,19,0,0,0,0,72
7,12,15,19,19,1,5,0,0,78
7,12,15,19,19,1,7,18,1,99
7,12,15,19,19,1,12,0,0,85
7,12,15,19,19,1,12,7,25,117
7,12,15,19,19,1,18,25,0,116
7,12,15,19,19,1,19,0,0,92
7,12,15,19,19,1,20,5,0,98
7,12,15,19,19,1,20,15,18,126
7,12,15,19,19,5,4,0,0,81
7,12,15,19,19,5,13,0,0,90
7,12,15,19,19,5,13,5,0,95
7,12,15,19,19,5,13,5,19,114
7,12,15,19,19,5,13,9,3,102
7,12,15,19,19,5,18,0,0,95
7,12,15,19,19,5,18,19,0,114
7,12,15,19,19,5,19,0,0,96
7,12,15,19,19,25,0,0,0,97
7,12,15,19,19,9,3,0,0,84
7,12,15,19,19,9,5,18,0,104
7,12,15,19,19,9,5,19,0,105
7,12,15,19,19,9,5,19,20,125
7,12,15,19,19,9,12,25,0,118
7,12,15,19,19,9,14,1,19,115
7,12,15,19,19,9,14,7,0,102
7,12,15,19,19,9,19,20,0,120
7,12,15,19,19,9,20,9,3,113
7,12,15,19,19,9,20,9,19,129
7,12,15,19,19,12,5,19,19,127
7,12,15,19,19,15,9,4,0,100
7,12,15,19,20,0,0,0,0,73
7,12,15,19,20,19,0,0,0,92
7,12,15,20,20,1,12,0,0,87
7,12,15,20,20,9,3,0,0,86
7,12,15,20,20,9,4,0,0,87
7,12,15,20,20,9,4,5,19,111
7,12,15,20,20,9,19,0,0,102
7,12,15,20,20,9,19,5,19,126
7,12,15,20,20,9,20,9,19,131
7,12,15,20,21,13,0,0,0,88
7,12,15,21,20,0,0,0,0,75
7,12,15,21,20,5,4,0,0,84
7,12,15,21,20,9,14,7,0,105
7,12,15,21,20,19,0,0,0,94
7,12,15,22,5,0,0,0,0,61
7,12,15,22,5,4,0,0,0,65
7,12,15,22,5,25,0,0,0,86
7,12,15,22,5,12,5,19,19,116
7,12,15,22,5,12,9,11,5,98
7,12,15,22,5,13,1,14,0,89
7,12,15,22,5,13,5,14,0,93
7,12,15,22,5,18,5,19,19,122
7,12,15,22,5,18,19,0,0,98
7,12,15,22,5,19,0,0,0,80
7,12,15,22,9,14,7,0,0,86
7,12,15,23,0,0,0,0,0,57
7,12,15,23,2,1,18,4,0,82
7,12,15,23,2,9,18,4,0,90
7,12,15,23,5,4,0,0,0,66
7,12,15,23,5,18,0,0,0,80
7,12,15,23,5,18,5,4,0,89
7,12,15,23,5,18,5,18,0,103
7,12,15,23,5,18,9,14,7,110
7,12,15,23,5,18,19,0,0,99
7,12,15,23,6,12,25,0,0,100
7,12,15,23,6,12,9,5,19,108
7,12,15,23,9,14,7,0,0,87
7,12,15,23,9,14,7,12,25,124
7,12,15,23,19,0,0,0,0,76
7,12,15,23,23,15,18,13,0,126
7,12,15,23,23,15,18,13,19,145
7,12,15,24,9,14,9,1,19,110
7,12,15,26,5,0,0,0,0,65
7,12,15,26,5,4,0,0,0,69
7,12,15,26,5,18,0,0,0,83
7,12,15,26,5,19,0,0,0,84
7,12,15,26,9,14,7,0,0,90
7,12,15,26,9,14,7,12,25,127
7,12,20,0,0,0,0,0,0,39
7,12,21,2,0,0,0,0,0,42
7,12,21,3,1,5,13,9,1,72
7,12,21,3,1,7,15,14,0,80
7,12,21,3,1,7,15,14,19,99
7,12,21,3,1,19,5,0,0,68
7,12,21,3,1,20,5,0,0,69
7,12,21,3,5,13,9,1,0,71
7,12,21,3,9,3,0,0,0,55
7,12,21,3,9,4,0,0,0,56
7,12,21,3,9,4,5,0,0,61
7,12,21,3,9,4,9,3,0,68
7,12,21,3,9,14,1,0,0,67
7,12,21,3,9,14,5,0,0,71
7,12,21,3,9,14,9,3,0,78
7,12,21,3,9,14,9,21,13,109
7,12,21,3,9,14,21,13,0,100
7,12,21,3,9,14,21,13,19,119
7,12,21,3,11,5,0,0,0,59
7,12,21,3,15,7,5,14,5,89
7,12,21,3,15,14,1,20,5,98
7,12,21,3,15,19,1,14,0,92
7,12,21,3,15,19,1,14,5,97
7,12,21,3,15,19,5,0,0,82
7,12,21,3,15,19,5,19,0,101
7,12,21,3,15,19,9,3,0,89
7,12,21,3,15,19,9,4,0,90
7,12,21,3,15,19,9,4,5,95
7,12,21,3,15,19,9,14,0,100
7,12,21,3,15,19,9,14,5,105
7,12,21,3,15,19,15,14,5,111
7,12,21,5,0,0,0,0,0,45
7,12,21,5,4,0,0,0,0,49
7,12,21,5,25,0,0,0,0,70
7,12,21,5,25,14,5,19,19,127
7,12,21,5,9,14,7,0,0,75
7,12,21,5,12,9,11,5,0,82
7,12,21,5,13,1,11,5,18,93
7,12,21,5,13,1,14,0,0,73
7,12,21,5,16,15,20,0,0,96
7,12,21,5,16,15,20,19,0,115
7,12,21,5,18,0,0,0,0,63
7,12,21,5,18,19,0,0,0,82
7,12,21,5,19,0,0,0,0,64
7,12,21,7,0,0,0,0,0,47
7,12,21,7,7,5,4,0,0,63
7,12,21,7,7,9,14,7,0,84
7,12,21,7,7,12,21,7,0,94
7,12,21,7,19,0,0,0,0,66
7,12,21,8,23,5,9,14,0,99
7,12,21,9,5,18,0,0,0,72
7,12,21,9,5,19,20,0,0,93
7,12,21,9,12,25,0,0,0,86
7,12,21,9,14,5,19,19,0,106
7,12,21,9,14,7,0,0,0,70
7,12,21,9,19,8,0,0,0,76
7,12,21,13,0,0,0,0,0,53
7,12,21,13,1,0,0,0,0,54
7,12,21,13,1,12,0,0,0,66
7,12,21,13,5,0,0,0,0,58
7,12,21,13,5,12,9,11,5,95
7,12,21,13,5,12,12,1,0,83
7,12,21,13,5,19,0,0,0,77
7,12,21,13,12,25,0,0,0,90
7,12,21,13,13,5,18,0,0,89
7,12,21,13,13,5,19,20,0,110
7,12,21,13,13,25,0,0,0,91
7,12,21,13,14,5,19,19,0,110
7,12,21,13,15,19,5,0,0,92
7,12,21,13,15,19,9,20,25,141
7,12,21,13,15,21,19,0,0,108
7,12,21,13,16,0,0,0,0,69
7,12,21,13,16,25,0,0,0,94
7,12,21,13,16,9,5,18,0,101
7,12,21,13,16,9,5,19,20,122
7,12,21,13,16,9,12,25,0,115
7,12,21,13,16,9,19,8,0,105
7,12,21,14,3,8,0,0,0,65
7,12,21,14,3,8,5,4,0,74
7,12,21,14,3,8,5,19,0,89
7,12,21,14,3,8,9,14,7,95
7,12,21,14,9,13,9,5,0,90
7,12,21,15,14,0,0,0,0,69
7,12,21,15,14,19,0,0,0,88
7,12,21,19,9,4,0,0,0,72
7,12,21,19,9,4,5,0,0,77
7,12,21,20,0,0,0,0,0,60
7,12,21,20,1,5,12,0,0,78
7,12,21,20,1,5,15,21,19,121
7,12,21,20,1,13,1,20,5,100
7,12,21,20,1,13,9,3,0,86
7,12,21,20,1,13,9,14,5,102
7,12,21,20,1,18,9,3,0,91
7,12,21,20,3,8,0,0,0,71
7,12,21,20,5,1,12,0,0,78
7,12,21,20,5,9,0,0,0,74
7,12,21,20,5,12,9,14,0,100
7,12,21,20,5,12,9,14,19,119
7,12,21,20,5,14,0,0,0,79
7,12,21,20,5,14,9,14,0,102
7,12,21,20,5,14,15,21,19,134
7,12,21,20,5,14,19,0,0,98
7,12,21,20,5,20,5,9,0,99
7,12,21,20,5,21,19,0,0,105
7,12,21,20,9,13,1,20,5,108
7,12,21,20,9,14,0,0,0,83
7,12,21,20,9,14,1,14,20,118
7,12,21,20,9,14,1,20,5,109
7,12,21,20,9,14,9,26,5,123
7,12,21,20,9,14,15,19,5,122
7,12,21,20,9,14,15,21,19,138
7,12,21,20,9,20,9,15,14,127
7,12,21,20,15,9,4,0,0,88
7,12,21,20,15,19,5,0,0,99
7,12,21,20,19,0,0,0,0,79
7,12,21,20,20,5,4,0,0,89
7,12,21,20,20,5,9,0,0,94
7,12,21,20,20,5,18,0,0,103
7,12,21,20,20,5,18,25,0,128
7,12,21,20,20,9,14,7,0,110
7,12,21,20,20,15,14,0,0,109
7,12,21,20,20,15,14,25,0,134
7,12,21,20,20,15,14,19,0,128
7,13,5,12,9,14,9,20,5,94
7,14,5,9,19,19,0,0,0,73
7,14,5,9,19,19,5,19,0,97
7,14,5,9,19,19,25,0,0,98
7,14,5,9,19,19,9,3,0,85
7,14,5,9,19,19,15,9,4,101
7,14,5,9,19,19,15,19,5,112
7,14,5,19,19,9,3,0,0,76
7,14,5,20,21,13,19,0,0,99
7,14,5,21,0,0,0,0,0,47
7,14,9,4,5,0,0,0,0,39
7,14,15,3,3,8,9,0,0,59
7,14,15,6,6,0,0,0,0,48
7,14,15,13,5,0,0,0,0,54
7,14,15,13,5,4,0,0,0,58
7,14,15,13,5,12,9,11,5,91
7,14,15,13,5,19,0,0,0,73
7,14,15,13,5,19,17,21,5,116
7,14,15,13,9,3,0,0,0,61
7,14,15,13,9,3,1,12,0,74
7,14,15,13,9,4,5,0,0,67
7,14,15,13,9,19,8,0,0,85
7,14,15,13,9,19,20,0,0,97
7,14,15,13,9,19,20,19,0,116
7,14,15,13,15,12,15,7,25,123
7,14,15,13,15,14,0,0,0,78
7,14,15,13,15,14,9,3,0,90
7,14,15,13,15,14,9,3,19,109
7,14,15,13,15,14,19,0,0,97
7,14,15,19,5,19,0,0,0,79
7,14,15,19,9,19,0,0,0,83
7,14,15,19,20,9,3,1,12,100
7,14,15,23,0,0,0,0,0,59
7,14,19,0,0,0,0,0,0,40
7,14,21,19,0,0,0,0,0,61
7,15,2,0,0,0,0,0,0,24
7,15,2,1,3,11,0,0,0,39
7,15,2,1,14,0,0,0,0,39
7,15,2,1,14,7,0,0,0,46
7,15,2,1,14,7,19,0,0,65
7,15,2,1,14,19,0,0,0,58
7,15,2,2,5,0,0,0,0,31
7,15,2,2,5,4,0,0,0,35
7,15,2,2,5,18,0,0,0,49
7,15,2,2,5,20,0,0,0,51
7,15,2,2,5,20,19,0,0,70
7,15,2,2,25,0,0,0,0,51
7,15,2,2,9,14,0,0,0,49
7,15,2,2,9,14,7,0,0,56
7,15,2,2,12,5,0,0,0,43
7,15,2,2,12,5,4,0,0,47
7,15,2,2,12,5,18,0,0,61
7,15,2,2,12,5,18,19,0,80
7,15,2,2,12,5,19,0,0,62
7,15,2,2,12,9,14,7,0,68
7,15,2,5,20,0,0,0,0,49
7,15,2,25,0,0,0,0,0,49
7,15,2,9,5,19,0,0,0,57
7,15,2,9,9,4,0,0,0,46
7,15,2,9,9,6,15,18,13,94
7,15,2,25,12,9,11,5,0,86
7,15,2,9,15,9,4,0,0,61
7,15,2,9,15,9,4,19,0,80
7,15,2,12,5,20,0,0,0,61
7,15,2,12,5,20,5,4,0,70
7,15,2,12,5,20,6,21,12,100
7,15,2,12,5,20,19,0,0,80
7,15,2,12,9,14,0,0,0,59
7,15,2,12,9,14,5,0,0,64
7,15,2,12,9,14,9,19,8,95
7,15,2,12,9,14,9,19,13,100
7,15,2,12,9,14,9,26,5,99
7,15,2,12,9,14,18,25,0,102
7,15,2,12,9,14,19,0,0,78
7,15,2,15,0,0,0,0,0,39
7,15,2,15,5,19,0,0,0,63
7,15,2,15,14,1,20,5,4,83
7,15,2,15,14,5,5,0,0,63
7,15,2,15,14,25,0,0,0,78
7,15,2,15,19,0,0,0,0,58
7,15,2,19,0,0,0,0,0,43
7,15,2,19,20,9,3,11,0,86
7,15,2,21,18,18,1,0,0,82
7,15,3,1,18,20,0,0,0,64
7,15,4,1,23,6,21,12,0,89
7,15,4,3,8,9,12,4,0,62
7,15,4,4,1,13,13,5,4,66
7,15,4,4,1,13,13,9,20,86
7,15,4,4,1,13,14,0,0,58
7,15,4,4,1,13,14,5,4,67
7,15,4,4,1,13,14,9,20,87
7,15,4,4,1,13,14,19,0,77
7,15,4,4,1,13,19,0,0,63
7,15,4,4,5,4,0,0,0,39
7,15,4,4,5,19,19,0,0,73
7,15,4,4,5,19,19,5,19,97
7,15,4,4,9,11,9,14,0,73
7,15,4,4,9,26,5,0,0,70
7,15,4,5,0,0,0,0,0,31
7,15,4,5,12,9,3,8,0,63
7,15,4,5,14,4,1,7,0,57
7,15,4,5,20,0,0,0,0,51
7,15,4,6,1,20,8,5,18,84
7,15,4,8,5,1,4,19,0,63
7,15,4,8,15,15,4,0,0,68
7,15,4,8,15,15,4,19,0,87
7,15,4,11,9,14,0,0,0,60
7,15,4,12,5,19,19,0,0,81
7,15,4,12,5,19,19,12,25,118
7,15,4,12,5,20,0,0,0,63
7,15,4,12,25,0,0,0,0,63
7,15,4,12,9,5,18,0,0,70
7,15,4,12,9,5,19,20,0,91
7,15,4,12,9,11,5,0,0,63
7,15,4,12,9,12,25,0,0,84
7,15,4,12,9,14,5,19,19,104
7,15,4,12,9,14,7,0,0,68
7,15,4,12,9,14,7,19,0,87
7,15,4,13,1,11,5,18,0,74
7,15,4,13,1,11,9,14,7,81
7,15,4,13,1,13,13,1,0,67
7,15,4,13,15,20,8,5,18,105
7,15,4,15,23,14,0,0,0,78
7,15,4,15,23,14,19,0,0,97
7,15,4,16,1,16,1,0,0,60
7,15,4,16,1,18,5,14,20,100
7,15,4,18,15,15,14,0,0,88
7,15,4,18,15,15,14,19,0,107
7,15,4,19,5,14,4,0,0,68
7,15,4,19,5,14,4,19,0,87
7,15,4,19,5,14,20,0,0,84
7,15,4,19,8,9,16,0,0,78
7,15,4,19,8,9,16,19,0,97
7,15,4,19,9,2,0,0,0,56
7,15,4,19,15,14,0,0,0,74
7,15,4,19,15,14,19,0,0,93
7,15,4,23,9,20,0,0,0,78
7,15,4,23,9,20,19,0,0,97
7,15,5,4,21,3,11,0,0,66
7,15,5,12,0,0,0,0,0,39
7,15,5,12,9,19,13,0,0,80
7,15,5,14,0,0,0,0,0,41
7,15,5,18,19,0,0,0,0,64
7,15,5,20,8,9,20,5,0,89
7,15,5,20,8,9,20,5,19,108
7,15,5,20,25,0,0,0,0,72
7,15,5,20,9,1,0,0,0,57
7,15,5,20,9,3,0,0,0,59
7,15,5,20,9,3,1,12,0,72
7,15,6,5,18,0,0,0,0,51
7,15,6,5,18,19,0,0,0,70
7,15,6,6,5,18,0,0,0,57
7,15,6,6,5,18,5,4,0,66
7,15,6,6,5,18,5,18,0,80
7,15,6,6,5,18,9,14,7,87
7,15,6,6,5,18,19,0,0,76
7,15,6,6,12,5,0,0,0,51
7,15,7,5,20,20,9,14,7,104
7,15,7,7,1,0,0,0,0,37
7,15,7,7,1,14,0,0,0,51
7,15,7,7,12,5,0,0,0,53
7,15,7,7,12,5,2,15,24,94
7,15,7,7,12,5,4,0,0,57
7,15,7,7,12,5,18,0,0,71
7,15,7,7,12,5,18,19,0,90
7,15,7,7,12,5,19,0,0,72
7,15,7,7,12,25,0,0,0,73
7,15,7,7,12,9,5,18,0,80
7,15,7,7,12,9,5,19,20,101
7,15,7,7,12,9,14,7,0,78
7,15,7,12,5,20,0,0,0,66
7,15,7,12,5,20,19,0,0,85
7,15,7,13,1,7,15,7,0,72
7,15,7,15,19,0,0,0,0,63
7,15,9,0,0,0,0,0,0,31
7,15,25,0,0,0,0,0,0,47
7,15,9,1,2,1,4,1,0,40
7,15,25,1,26,9,20,5,0,108
7,15,25,9,13,0,0,0,0,69
7,15,25,9,14,0,0,0,0,70
7,15,25,9,19,8,0,0,0,83
7,15,25,12,5,0,0,0,0,64
7,15,9,14,7,19,0,0,0,71
7,15,9,19,0,0,0,0,0,50
7,15,25,19,0,0,0,0,0,66
7,15,9,20,3,8,15,0,0,77
7,15,9,20,5,18,0,0,0,74
7,15,9,20,5,18,5,4,0,83
7,15,9,20,5,18,19,0,0,93
7,15,9,20,18,1,12,0,0,82
7,15,9,20,18,5,0,0,0,74
7,15,9,20,18,5,19,0,0,93
7,15,9,20,18,15,7,5,14,110
7,15,9,20,18,15,21,19,0,124
7,15,12,0,0,0,0,0,0,34
7,15,12,1,3,8,0,0,0,46
7,15,12,1,4,1,18,0,0,58
7,15,12,1,14,4,1,1,19,74
7,15,12,3,15,14,4,1,19,90
7,15,12,4,1,14,7,0,0,60
7,15,12,4,1,14,7,5,4,69
7,15,12,4,1,18,14,0,0,71
7,15,12,4,1,18,14,5,4,80
7,15,12,4,1,18,14,19,0,90
7,15,12,4,2,18,9,3,11,81
7,15,12,4,2,21,7,0,0,68
7,15,12,4,2,21,7,19,0,87
7,15,12,4,3,18,5,19,20,103
7,15,12,4,3,21,16,0,0,78
7,15,12,4,5,25,5,0,0,73
7,15,12,4,5,25,5,19,0,92
7,15,12,4,5,14,5,25,0,87
7,15,12,4,5,14,5,25,5,92
7,15,12,4,5,14,5,18,0,80
7,15,12,4,5,14,5,19,20,101
7,15,12,4,5,14,12,25,0,94
7,15,12,4,5,14,18,15,4,94
7,15,12,4,5,14,20,15,16,108
7,15,12,4,5,18,0,0,0,61
7,15,12,4,5,19,20,0,0,82
7,15,12,4,6,9,14,14,25,106
7,15,12,4,6,9,19,8,0,80
7,15,12,4,8,5,1,4,0,56
7,15,12,4,9,19,8,0,0,74
7,15,12,4,12,5,19,19,0,93
7,15,12,4,12,9,11,5,0,75
7,15,12,4,13,9,14,5,18,97
7,15,12,4,13,9,19,20,0,99
7,15,12,4,14,5,25,0,0,82
7,15,12,4,19,0,0,0,0,57
7,15,12,4,19,5,5,4,0,71
7,15,12,4,19,9,14,14,25,119
7,15,12,4,19,16,9,14,11,107
7,15,12,4,19,20,15,14,5,111
7,15,12,4,20,1,9,12,0,80
7,15,12,4,20,9,20,0,0,87
7,15,12,4,21,18,14,0,0,91
7,15,12,4,21,18,14,5,4,100
7,15,12,4,21,18,14,19,0,110
7,15,12,4,23,5,5,4,0,75
7,15,12,4,23,15,18,11,0,105
7,15,12,5,5,0,0,0,0,44
7,15,12,5,13,0,0,0,0,52
7,15,12,5,13,19,0,0,0,71
7,15,12,5,20,0,0,0,0,59
7,15,12,6,0,0,0,0,0,40
7,15,12,6,4,15,13,0,0,72
7,15,12,6,5,4,0,0,0,49
7,15,12,6,5,18,0,0,0,63
7,15,12,6,5,18,19,0,0,82
7,15,12,6,9,14,7,0,0,70
7,15,12,6,9,14,7,19,0,89
7,15,12,6,19,0,0,0,0,59
7,15,12,7,15,20,8,1,19,104
7,15,12,9,0,0,0,0,0,43
7,15,12,9,1,18,4,9,3,78
7,15,12,9,1,18,4,19,0,85
7,15,12,9,1,20,8,19,0,91
7,15,12,9,12,12,1,0,0,68
7,15,12,11,1,11,18,1,0,76
7,15,12,12,1,14,4,0,0,65
7,15,12,12,1,18,0,0,0,65
7,15,12,12,5,18,0,0,0,69
7,15,12,12,25,0,0,0,0,71
7,15,12,12,9,23,15,7,0,100
7,15,12,12,25,23,15,7,0,116
7,15,12,12,9,23,15,7,7,107
7,15,12,12,9,23,15,7,19,119
7,15,12,12,15,16,0,0,0,77
7,15,12,15,3,8,0,0,0,60
7,15,12,15,5,0,0,0,0,54
7,15,12,15,11,1,0,0,0,61
7,15,12,15,19,8,0,0,0,76
7,15,12,15,19,8,5,0,0,81
7,15,12,15,19,8,5,19,0,100
7,15,12,16,0,0,0,0,0,50
7,15,12,16,5,0,0,0,0,55
7,15,13,1,18,9,0,0,0,63
7,15,13,1,18,20,0,0,0,74
7,15,13,1,19,8,20,1,0,84
7,15,13,1,19,20,1,0,0,76
7,15,13,1,22,5,12,0,0,75
7,15,13,2,1,25,0,0,0,63
7,15,13,2,5,5,14,0,0,61
7,15,13,2,15,0,0,0,0,52
7,15,13,2,15,19,0,0,0,71
7,15,13,2,18,15,15,14,0,99
7,15,13,2,18,15,15,14,19,118
7,15,13,5,0,0,0,0,0,40
7,15,13,5,18,1,12,0,0,71
7,15,13,5,18,1,12,19,0,90
7,15,13,5,18,5,3,0,0,66
7,15,13,5,18,5,12,0,0,75
7,15,13,5,18,5,12,19,0,94
7,15,13,5,18,9,12,0,0,79
7,15,13,5,18,9,12,19,0,98
7,15,13,12,1,8,0,0,0,56
7,15,13,13,5,12,9,14,0,88
7,15,13,13,9,5,18,0,0,80
7,15,13,16,8,15,19,5,19,117
7,15,13,16,8,15,19,9,19,121
7,15,13,21,11,8,9,0,0,84
7,15,13,21,20,9,0,0,0,85
7,15,13,21,20,9,19,0,0,104
7,15,14,0,0,0,0,0,0,36
7,15,14,1,4,0,0,0,0,41
7,15,14,1,4,1,12,0,0,54
7,15,14,1,4,9,1,12,0,63
7,15,14,1,4,9,3,0,0,53
7,15,14,1,4,19,0,0,0,60
7,15,14,1,4,21,3,20,0,85
7,15,14,1,7,9,1,0,0,54
7,15,14,1,7,18,1,0,0,63
7,15,14,1,11,5,0,0,0,53
7,15,14,1,11,9,5,0,0,62
7,15,14,1,12,0,0,0,0,49
7,15,14,1,12,7,9,1,0,66
7,15,14,1,14,7,9,1,0,68
7,15,14,1,14,7,9,1,12,80
7,15,14,1,14,7,9,21,13,101
7,15,14,1,16,15,4,0,0,72
7,15,14,3,1,12,15,0,0,67
7,15,14,4,1,14,7,0,0,62
7,15,14,4,9,20,5,0,0,74
7,15,14,4,15,12,1,0,0,68
7,15,14,4,15,12,1,19,0,87
7,15,14,4,15,12,5,20,0,92
7,15,14,4,15,12,9,5,18,99
7,15,14,5,6,0,0,0,0,47
7,15,14,5,6,19,0,0,0,66
7,15,14,5,25,0,0,0,0,66
7,15,14,5,14,5,19,19,0,98
7,15,14,5,18,0,0,0,0,59
7,15,14,5,18,19,0,0,0,78
7,15,14,5,19,15,13,5,0,93
7,15,14,6,1,12,3,15,14,87
7,15,14,6,1,12,15,14,0,84
7,15,14,6,1,12,15,14,19,103
7,15,14,6,1,14,15,14,0,86
7,15,14,6,1,14,15,14,19,105
7,15,14,7,0,0,0,0,0,43
7,15,14,7,5,4,0,0,0,52
7,15,14,7,9,14,7,0,0,73
7,15,14,7,12,9,11,5,0,80
7,15,14,7,13,1,14,0,0,71
7,15,14,7,19,0,0,0,0,62
7,15,14,25,0,0,0,0,0,61
7,15,14,9,1,0,0,0,0,46
7,15,14,9,1,3,0,0,0,49
7,15,14,9,1,12,0,0,0,58
7,15,14,9,1,12,5,0,0,63
7,15,14,25,1,12,7,9,1,91
7,15,14,9,1,20,9,20,5,100
7,15,14,25,1,21,12,1,24,120
7,15,14,9,4,0,0,0,0,49
7,15,14,25,4,5,1,12,0,83
7,15,14,9,4,9,1,0,0,59
7,15,14,9,4,9,1,12,0,71
7,15,14,25,4,9,1,12,0,87
7,15,14,9,4,9,3,0,0,61
7,15,14,9,4,9,15,9,4,86
7,15,14,9,4,9,15,19,5,97
7,15,14,9,4,9,21,13,0,92
7,15,14,9,6,0,0,0,0,51
7,15,14,9,6,6,0,0,0,57
7,15,14,9,6,6,19,0,0,76
7,15,14,9,6,19,0,0,0,70
7,15,14,9,13,9,3,0,0,70
7,15,14,9,13,9,21,13,0,101
7,15,14,9,13,15,21,19,0,113
7,15,14,9,14,9,4,9,1,82
7,15,14,25,15,3,5,12,5,101
7,15,14,9,15,14,0,0,0,74
7,15,14,25,15,14,3,21,19,133
7,15,14,9,15,14,9,1,0,84
7,15,14,9,15,19,20,1,20,120
7,15,14,25,19,0,0,0,0,80
7,15,14,25,20,8,5,3,1,98
7,15,14,9,20,9,19,0,0,93
7,15,14,9,21,13,0,0,0,79
7,15,14,9,21,13,19,0,0,98
7,15,14,9,21,14,9,1,0,90
7,15,14,11,0,0,0,0,0,47
7,15,14,14,1,0,0,0,0,51
7,15,14,14,5,0,0,0,0,55
7,15,14,15,2,12,1,19,20,105
7,15,14,15,3,1,12,25,24,116
7,15,14,15,3,8,5,13,5,85
7,15,14,15,3,25,20,5,0,104
7,15,14,15,3,25,20,5,19,123
7,15,14,15,3,15,3,3,9,84
7,15,14,15,3,15,5,12,0,86
7,15,14,15,3,15,5,12,5,91
7,15,14,15,5,3,9,21,13,102
7,15,14,15,6,0,0,0,0,57
7,15,14,15,6,19,0,0,0,76
7,15,14,15,13,5,18,5,0,92
7,15,14,15,13,5,18,25,0,112
7,15,14,15,16,8,0,0,0,75
7,15,14,15,16,8,15,18,5,113
7,15,14,15,16,8,19,0,0,94
7,15,14,15,16,12,1,19,13,112
7,15,14,15,16,15,4,0,0,86
7,15,14,15,16,15,4,9,1,96
7,15,14,15,16,15,18,5,0,105
7,15,14,15,16,15,18,5,19,124
7,15,14,15,18,18,8,5,1,101
7,15,14,15,19,15,13,1,12,111
7,15,14,15,19,15,13,5,0,103
7,15,14,15,19,20,25,12,5,132
7,15,14,15,20,8,5,3,1,88
7,15,14,15,20,25,12,0,0,108
7,15,14,15,20,25,16,5,0,117
7,15,14,15,20,15,13,5,0,104
7,15,14,15,26,15,15,9,4,120
7,15,14,26,15,0,0,0,0,77
7,15,15,0,0,0,0,0,0,37
7,15,15,2,5,18,19,0,0,81
7,15,15,4,2,25,0,0,0,68
7,15,15,4,2,25,5,0,0,73
7,15,15,4,2,25,5,19,0,92
7,15,15,4,2,25,19,0,0,87
7,15,15,4,5,18,0,0,0,64
7,15,15,4,5,18,19,0,0,83
7,15,15,4,8,1,16,0,0,66
7,15,15,4,9,5,0,0,0,55
7,15,15,4,9,5,19,0,0,74
7,15,15,4,25,9,19,8,0,102
7,15,15,4,25,9,19,13,0,107
7,15,15,4,25,14,5,19,19,123
7,15,15,4,9,19,8,0,0,77
7,15,15,4,25,19,8,9,16,118
7,15,15,4,12,5,19,19,0,96
7,15,15,4,12,25,0,0,0,78
7,15,15,4,12,9,5,18,0,85
7,15,15,4,12,9,5,19,20,106
7,15,15,4,12,9,11,5,0,78
7,15,15,4,13,5,14,0,0,73
7,15,15,4,14,5,19,19,0,98
7,15,15,4,14,9,7,8,20,99
7,15,15,4,19,0,0,0,0,60
7,15,15,4,19,8,9,16,0,93
7,15,15,4,19,9,18,5,0,92
7,15,15,4,19,15,13,5,0,93
7,15,15,4,23,9,6,5,0,84
7,15,15,4,23,9,12,25,0,110
7,15,15,4,23,9,12,12,0,97
7,15,15,4,23,9,12,12,25,122
7,15,15,4,23,9,12,12,19,116
7,15,15,4,23,9,22,5,19,119
7,15,15,5,25,0,0,0,0,67
7,15,15,6,0,0,0,0,0,43
7,15,15,6,1,8,0,0,0,52
7,15,15,6,2,1,12,12,0,70
7,15,15,6,2,1,12,12,19,89
7,15,15,6,5,4,0,0,0,52
7,15,15,6,5,18,0,0,0,66
7,15,15,6,25,0,0,0,0,68
7,15,15,6,9,5,18,0,0,75
7,15,15,6,9,5,19,20,0,96
7,15,15,6,9,12,25,0,0,89
7,15,15,6,9,14,5,19,19,109
7,15,15,6,9,14,7,0,0,73
7,15,15,6,19,0,0,0,0,62
7,15,15,7,0,0,0,0,0,44
7,15,15,7,12,25,0,0,0,81
7,15,15,7,12,9,5,19,0,89
7,15,15,7,15,12,0,0,0,71
7,15,15,7,15,12,19,0,0,90
7,15,15,7,21,12,0,0,0,77
7,15,15,9,5,18,0,0,0,69
7,15,15,9,5,19,20,0,0,90
7,15,15,11,0,0,0,0,0,48
7,15,15,11,25,0,0,0,0,73
7,15,15,11,19,0,0,0,0,67
7,15,15,12,0,0,0,0,0,49
7,15,15,12,1,8,0,0,0,58
7,15,15,12,4,5,0,0,0,58
7,15,15,12,19,0,0,0,0,68
7,15,15,13,1,0,0,0,0,51
7,15,15,13,2,1,8,0,0,61
7,15,15,13,2,1,8,19,0,80
7,15,15,13,2,1,25,0,0,78
7,15,15,13,2,1,25,19,0,97
7,15,15,14,0,0,0,0,0,51
7,15,15,14,3,8,0,0,0,62
7,15,15,14,4,1,0,0,0,56
7,15,15,14,4,9,5,0,0,69
7,15,15,14,5,25,0,0,0,81
7,15,15,14,5,25,19,0,0,100
7,15,15,14,25,0,0,0,0,76
7,15,15,14,9,5,0,0,0,65
7,15,15,14,9,5,19,0,0,84
7,15,15,14,19,0,0,0,0,70
7,15,15,16,25,0,0,0,0,78
7,15,15,16,9,5,18,0,0,85
7,15,15,16,9,5,19,20,0,106
7,15,15,16,19,0,0,0,0,72
7,15,15,18,1,12,0,0,0,68
7,15,15,18,1,12,19,0,0,87
7,15,15,18,1,14,21,20,0,111
7,15,15,18,15,15,0,0,0,85
7,15,15,19,0,0,0,0,0,56
7,15,15,19,1,14,4,5,18,98
7,15,15,19,5,0,0,0,0,61
7,15,15,19,5,2,5,1,11,80
7,15,15,19,5,2,9,12,12,96
7,15,15,19,5,2,9,18,4,94
7,15,15,19,5,2,15,25,0,103
7,15,15,19,5,2,15,14,5,97
7,15,15,19,5,3,1,16,0,81
7,15,15,19,5,4,0,0,0,65
7,15,15,19,5,6,9,19,8,103
7,15,15,19,5,6,15,15,20,117
7,15,15,19,5,7,9,18,12,107
7,15,15,19,5,7,15,7,0,90
7,15,15,19,5,8,5,18,4,96
7,15,15,19,5,25,0,0,0,86
7,15,15,19,5,12,9,11,5,98
7,15,15,19,5,14,5,3,11,94
7,15,15,19,5,18,25,0,0,104
7,15,15,19,5,18,9,5,19,112
7,15,15,19,5,19,0,0,0,80
7,15,15,19,5,19,11,9,14,114
7,15,15,19,5,23,5,5,4,98
7,15,15,19,5,23,9,14,7,114
7,15,15,19,25,0,0,0,0,81
7,15,15,19,9,5,18,0,0,88
7,15,15,19,9,5,19,20,0,109
7,15,15,19,9,14,7,0,0,86
7,15,15,19,9,19,8,0,0,92
7,15,15,19,9,19,8,12,25,129
7,15,15,20,5,5,0,0,0,67
7,15,15,26,12,5,0,0,0,80
7,15,16,1,11,0,0,0,0,50
7,15,16,8,5,18,0,0,0,69
7,15,16,8,5,18,13,1,14,97
7,15,16,8,5,18,19,0,0,88
7,15,16,21,18,1,0,0,0,78
7,15,18,1,3,3,15,0,0,62
7,15,18,1,12,0,0,0,0,53
7,15,18,1,12,15,7,0,0,75
7,15,18,1,12,19,0,0,0,72
7,15,18,2,0,0,0,0,0,42
7,15,18,2,1,12,0,0,0,55
7,15,18,2,5,12,12,25,0,96
7,15,18,2,5,20,0,0,0,67
7,15,18,2,9,20,0,0,0,71
7,15,18,2,12,5,0,0,0,59
7,15,18,2,12,9,13,5,25,106
7,15,18,2,12,9,13,25,0,101
7,15,18,2,12,9,14,0,0,77
7,15,18,3,5,0,0,0,0,48
7,15,18,3,15,3,11,0,0,72
7,15,18,3,15,3,11,19,0,91
7,15,18,3,18,15,23,0,0,99
7,15,18,4,9,9,4,0,0,66
7,15,18,4,9,15,9,4,0,81
7,15,18,4,15,12,15,2,15,103
7,15,18,4,21,14,9,20,5,113
7,15,18,5,2,9,12,12,0,80
7,15,18,5,4,0,0,0,0,49
7,15,18,5,6,9,19,8,0,87
7,15,18,5,18,0,0,0,0,63
7,15,18,5,19,0,0,0,0,64
7,15,18,5,22,1,14,0,0,82
7,15,18,6,12,25,0,0,0,83
7,15,18,7,5,0,0,0,0,52
7,15,18,7,5,1,2,12,5,72
7,15,18,7,5,4,0,0,0,56
7,15,18,7,5,4,12,25,0,93
7,15,18,7,5,12,5,20,0,89
7,15,18,7,5,15,21,19,0,107
7,15,18,7,5,18,0,0,0,70
7,15,18,7,5,18,5,20,0,95
7,15,18,7,5,18,9,14,0,93
7,15,18,7,5,18,9,14,19,112
7,15,18,7,5,18,19,0,0,89
7,15,18,7,5,20,0,0,0,72
7,15,18,7,5,20,5,4,0,81
7,15,18,7,5,20,19,0,0,91
7,15,18,7,9,1,0,0,0,57
7,15,18,7,9,14,7,0,0,77
7,15,18,7,9,15,0,0,0,71
7,15,18,7,12,9,14,0,0,82
7,15,18,7,15,14,5,9,1,91
7,15,18,7,15,14,5,21,13,115
7,15,18,7,15,14,9,14,0,99
7,15,18,7,15,14,9,19,5,109
7,15,18,7,15,14,9,26,5,116
7,15,18,7,15,14,19,0,0,95
7,15,18,8,5,14,0,0,0,67
7,15,18,8,5,14,19,0,0,86
7,15,18,25,0,0,0,0,0,65
7,15,18,9,3,0,0,0,0,52
7,15,18,9,5,18,0,0,0,72
7,15,18,9,5,19,20,0,0,93
7,15,18,9,12,25,0,0,0,86
7,15,18,9,12,12,1,0,0,74
7,15,18,9,12,12,1,19,0,93
7,15,18,9,12,12,9,1,14,97
7,15,18,9,12,12,9,14,5,101
7,15,18,9,12,12,15,9,4,101
7,15,18,9,14,5,19,19,0,106
7,15,18,11,21,14,0,0,0,86
7,15,18,12,9,14,7,0,0,82
7,15,18,12,15,9,19,0,0,95
7,15,18,13,1,14,4,0,0,72
7,15,18,13,1,14,4,19,0,91
7,15,18,13,1,23,0,0,0,77
7,15,18,13,5,4,0,0,0,62
7,15,18,13,12,5,19,19,0,108
7,15,18,16,0,0,0,0,0,56
7,15,18,16,19,0,0,0,0,75
7,15,18,18,1,0,0,0,0,59
7,15,18,18,1,6,0,0,0,65
7,15,18,18,5,12,0,0,0,75
7,15,18,18,25,0,0,0,0,83
7,15,18,19,5,0,0,0,0,64
7,15,18,19,5,2,9,18,4,97
7,15,18,19,5,3,8,1,20,96
7,15,18,19,5,19,0,0,0,83
7,15,18,19,25,0,0,0,0,84
7,15,18,19,9,5,18,0,0,91
7,15,18,19,9,5,19,20,0,112
7,15,18,19,20,0,0,0,0,79
7,15,19,1,9,14,0,0,0,65
7,15,19,3,8,5,14,0,0,71
7,15,19,3,8,5,14,19,0,90
7,15,19,8,0,0,0,0,0,49
7,15,19,8,1,23,6,21,12,112
7,15,19,8,1,23,11,0,0,84
7,15,19,8,1,23,11,19,0,103
7,15,19,8,4,1,18,14,0,86
7,15,19,8,5,14,9,20,5,102
7,15,19,12,1,18,9,20,5,106
7,15,19,12,5,20,0,0,0,78
7,15,19,12,9,14,7,0,0,83
7,15,19,12,9,14,7,19,0,102
7,15,19,13,15,18,5,0,0,92
7,15,19,16,5,12,5,18,0,97
7,15,19,16,5,12,5,18,19,116
7,15,19,16,5,12,9,19,20,122
7,15,19,16,5,12,9,26,5,114
7,15,19,16,5,12,12,5,18,109
7,15,19,16,5,12,12,25,0,111
7,15,19,16,15,4,1,0,0,77
7,15,19,16,15,4,1,18,0,95
7,15,19,16,15,4,9,14,0,99
7,15,19,16,15,18,20,19,0,129
7,15,19,19,1,13,5,18,0,97
7,15,19,19,1,13,5,18,25,122
7,15,19,19,1,13,5,18,19,116
7,15,19,19,1,14,0,0,0,75
7,15,19,19,1,14,19,0,0,94
7,15,19,19,1,18,4,0,0,83
7,15,19,19,5,16,0,0,0,81
7,15,19,19,25,0,0,0,0,85
7,15,19,19,9,16,0,0,0,85
7,15,19,19,9,16,4,15,13,117
7,15,19,19,9,16,5,4,0,94
7,15,19,19,9,16,5,5,0,95
7,15,19,19,9,16,5,18,0,108
7,15,19,19,9,16,5,18,19,127
7,15,19,19,9,16,25,0,0,110
7,15,19,19,25,16,9,14,0,124
7,15,19,19,25,16,9,14,5,129
7,15,19,19,9,16,9,14,7,115
7,15,19,19,25,16,15,12,0,128
7,15,19,19,25,16,15,12,19,147
7,15,19,19,25,16,15,19,5,140
7,15,19,19,9,16,16,5,4,110
7,15,19,19,9,16,16,5,18,124
7,15,19,19,9,16,18,5,4,112
7,15,19,19,9,16,18,25,0,128
7,15,19,19,9,16,19,0,0,104
7,15,19,19,15,15,14,0,0,104
7,15,19,19,15,15,14,19,0,123
7,15,19,20,5,18,0,0,0,84
7,15,19,20,8,5,18,0,0,92
7,15,20,0,0,0,0,0,0,42
7,15,20,3,8,0,0,0,0,53
7,15,20,3,8,5,4,0,0,62
7,15,20,3,8,25,0,0,0,78
7,15,20,5,0,0,0,0,0,47
7,15,20,5,18,0,0,0,0,65
7,15,20,8,9,3,19,0,0,81
7,15,20,8,9,20,5,0,0,84
7,15,20,8,9,20,5,19,0,103
7,15,20,8,19,0,0,0,0,69
7,15,20,15,19,0,0,0,0,76
7,15,20,18,1,0,0,0,0,61
7,15,20,18,1,10,1,0,0,72
7,15,20,20,1,0,0,0,0,63
7,15,20,20,5,14,0,0,0,81
7,15,21,0,0,0,0,0,0,43
7,15,21,1,3,8,5,0,0,60
7,15,21,1,3,8,5,19,0,79
7,15,21,1,18,5,5,0,0,72
7,15,21,7,5,0,0,0,0,55
7,15,21,7,5,4,0,0,0,59
7,15,21,7,5,18,0,0,0,73
7,15,21,7,5,18,19,0,0,92
7,15,21,7,5,19,0,0,0,74
7,15,21,7,9,14,7,0,0,80
7,15,21,7,9,14,7,12,25,117
7,15,21,10,1,25,0,0,0,79
7,15,21,10,1,20,0,0,0,74
7,15,21,10,15,14,19,0,0,101
7,15,21,12,1,14,0,0,0,70
7,15,21,12,1,18,15,0,0,89
7,15,21,12,1,19,8,0,0,83
7,15,21,12,1,19,8,5,19,107
7,15,21,12,4,9,1,14,0,83
7,15,21,13,9,0,0,0,0,65
7,15,21,13,9,5,18,0,0,88
7,15,21,14,1,21,0,0,0,79
7,15,21,14,4,15,21,0,0,97
7,15,21,16,0,0,0,0,0,59
7,15,21,16,5,14,0,0,0,78
7,15,21,16,9,14,0,0,0,82
7,15,21,18,0,0,0,0,0,61
7,15,21,18,1,13,9,0,0,84
7,15,21,18,1,13,9,19,0,103
7,15,21,18,4,0,0,0,0,65
7,15,21,18,4,5,0,0,0,70
7,15,21,18,4,5,4,0,0,74
7,15,21,18,4,5,19,0,0,89
7,15,21,18,4,6,21,12,0,104
7,15,21,18,4,8,5,1,4,83
7,15,21,18,4,25,0,0,0,90
7,15,21,18,4,9,14,7,0,95
7,15,21,18,4,12,9,11,5,102
7,15,21,18,4,19,0,0,0,84
7,15,21,18,4,23,15,18,13,134
7,15,21,18,25,0,0,0,0,86
7,15,21,18,13,1,14,4,0,93
7,15,21,18,13,1,14,4,19,112
7,15,21,18,13,5,20,0,0,99
7,15,21,18,13,5,20,19,0,118
7,15,21,18,14,1,18,4,0,98
7,15,21,18,15,21,14,21,20,152
7,15,21,19,20,25,0,0,0,107
7,15,21,19,20,9,5,0,0,96
7,15,21,19,20,18,15,21,19,155
7,15,21,20,0,0,0,0,0,63
7,15,21,20,5,18,0,0,0,86
7,15,21,20,25,0,0,0,0,88
7,15,21,20,9,5,18,0,0,95
7,15,21,20,9,5,19,20,0,116
7,15,21,20,9,6,25,0,0,103
7,15,21,20,9,12,25,0,0,109
7,15,21,20,9,14,5,19,19,129
7,15,21,20,9,19,8,0,0,99
7,15,21,20,19,0,0,0,0,82
7,15,21,20,20,5,0,0,0,88
7,15,21,20,23,5,5,4,0,100
7,15,21,20,23,15,18,20,0,139
7,15,22,5,18,14,0,0,0,81
7,15,22,5,18,14,1,9,12,103
7,15,22,5,18,14,5,4,0,90
7,15,22,5,18,14,5,19,19,124
7,15,22,5,18,14,9,14,7,111
7,15,22,5,18,14,15,18,0,114
7,15,22,5,18,14,15,18,19,133
7,15,22,5,18,14,19,0,0,100
7,15,23,1,14,0,0,0,0,60
7,15,23,1,14,5,4,0,0,69
7,15,23,1,14,25,0,0,0,85
7,15,23,1,14,19,0,0,0,79
7,15,23,4,0,0,0,0,0,49
7,15,23,4,25,0,0,0,0,74
7,15,23,4,9,5,0,0,0,63
7,15,23,4,14,9,5,0,0,77
7,15,23,4,14,15,15,11,0,104
7,15,23,4,19,0,0,0,0,68
7,15,23,6,0,0,0,0,0,51
7,15,23,6,5,18,0,0,0,74
7,15,23,9,4,4,9,5,0,76
7,15,23,11,0,0,0,0,0,56
7,15,23,11,5,4,0,0,0,65
7,15,23,11,5,4,12,25,0,102
7,15,23,11,9,20,0,0,0,85
7,15,23,11,19,0,0,0,0,75
7,15,23,12,0,0,0,0,0,57
7,15,23,12,1,14,0,0,0,72
7,15,23,12,1,14,4,0,0,76
7,15,23,14,0,0,0,0,0,59
7,15,23,14,5,4,0,0,0,68
7,15,23,14,9,14,7,0,0,89
7,15,23,14,12,5,20,0,0,96
7,15,23,14,19,0,0,0,0,78
7,15,23,14,19,13,1,14,0,106
7,15,23,14,19,13,5,14,0,110
7,15,23,16,5,14,0,0,0,80
7,15,23,16,9,14,0,0,0,84
7,15,24,5,19,0,0,0,0,70
7,15,26,5,12,12,0,0,0,77
7,15,26,9,12,12,0,0,0,81
7,15,26,26,1,14,0,0,0,89
7,15,26,26,1,18,4,0,0,97
7,16,3,4,0,0,0,0,0,30
7,16,8,0,0,0,0,0,0,31
7,18,5,0,0,0,0,0,0,30
7,18,5,1,2,12,5,0,0,50
7,18,5,1,2,12,25,0,0,70
7,18,5,1,19,5,0,0,0,55
7,18,5,1,19,5,4,0,0,59
7,18,5,1,19,5,18,0,0,73
7,18,5,1,19,5,18,19,0,92
7,18,5,1,19,5,19,0,0,74
7,18,5,1,19,25,0,0,0,75
7,18,5,1,19,9,5,18,0,82
7,18,5,1,19,9,5,19,20,103
7,18,5,1,19,9,12,25,0,96
7,18,5,1,19,9,14,7,0,80
7,18,5,1,20,3,15,1,20,90
7,18,5,1,20,5,14,0,0,70
7,18,5,1,20,5,14,5,4,79
7,18,5,1,20,5,14,19,0,89
7,18,5,1,20,5,19,20,0,95
7,18,5,1,20,8,5,1,4,69
7,18,5,1,20,9,19,8,0,87
7,18,5,1,20,12,25,0,0,88
7,18,5,1,20,14,5,19,19,108
7,18,5,1,22,5,0,0,0,58
7,18,5,1,22,5,4,0,0,62
7,18,5,1,22,5,19,0,0,77
7,18,5,2,5,0,0,0,0,37
7,18,5,2,5,19,0,0,0,56
7,18,5,3,1,12,5,0,0,51
7,18,5,3,5,0,0,0,0,38
7,18,5,3,9,1,14,19,0,76
7,18,5,3,9,14,7,0,0,63
7,18,5,3,9,26,5,19,0,92
7,18,5,3,15,21,5,0,0,74
7,18,5,3,17,21,5,0,0,76
7,18,5,5,0,0,0,0,0,35
7,18,5,5,4,0,0,0,0,39
7,18,5,5,4,25,0,0,0,64
7,18,5,5,4,9,5,18,0,71
7,18,5,5,4,9,5,19,20,92
7,18,5,5,4,25,7,21,20,112
7,18,5,5,4,9,12,25,0,85
7,18,5,5,4,12,5,19,19,94
7,18,5,5,4,19,0,0,0,58
7,18,5,5,4,19,15,13,5,91
7,18,5,5,7,18,5,5,0,70
7,18,5,5,7,18,5,5,19,89
7,18,5,5,9,14,7,0,0,65
7,18,5,5,11,19,0,0,0,65
7,18,5,5,14,1,2,12,5,69
7,18,5,5,14,1,7,5,0,62
7,18,5,5,14,2,1,18,11,81
7,18,5,5,14,2,15,14,5,85
7,18,5,5,14,2,21,7,0,79
7,18,5,5,14,2,21,7,19,98
7,18,5,5,14,2,21,12,0,84
7,18,5,5,14,3,15,1,20,88
7,18,5,5,14,5,4,0,0,58
7,18,5,5,14,5,25,0,0,79
7,18,5,5,14,5,18,0,0,72
7,18,5,5,14,5,18,25,0,97
7,18,5,5,14,5,19,20,0,93
7,18,5,5,14,6,9,19,8,91
7,18,5,5,14,6,12,25,0,92
7,18,5,5,14,7,1,7,5,69
7,18,5,5,14,7,9,12,12,89
7,18,5,5,14,8,5,1,4,67
7,18,5,5,14,8,5,23,0,85
7,18,5,5,14,8,9,4,5,75
7,18,5,5,14,8,15,15,4,91
7,18,5,5,14,8,15,18,14,104
7,18,5,5,14,25,0,0,0,74
7,18,5,5,14,25,1,18,4,97
7,18,5,5,14,9,5,0,0,63
7,18,5,5,14,9,5,18,0,81
7,18,5,5,14,9,5,19,0,82
7,18,5,5,14,9,5,19,20,102
7,18,5,5,14,9,14,7,0,79
7,18,5,5,14,9,14,7,19,98
7,18,5,5,14,9,19,8,0,85
7,18,5,5,14,12,5,5,11,82
7,18,5,5,14,12,5,19,19,104
7,18,5,5,14,12,5,20,0,86
7,18,5,5,14,12,5,20,19,105
7,18,5,5,14,12,25,0,0,86
7,18,5,5,14,12,9,14,7,91
7,18,5,5,14,14,5,19,19,106
7,18,5,5,14,18,15,15,13,110
7,18,5,5,14,19,0,0,0,68
7,18,5,5,14,19,1,14,4,87
7,18,5,5,14,19,9,3,11,91
7,18,5,5,14,19,9,4,5,86
7,18,5,5,14,20,1,9,12,91
7,18,5,5,14,20,8,0,0,77
7,18,5,5,14,20,8,19,0,96
7,18,5,5,14,21,11,0,0,81
7,18,5,5,14,23,1,18,5,96
7,18,5,5,14,23,1,24,0,97
7,18,5,5,14,23,5,5,4,86
7,18,5,5,14,23,9,14,7,102
7,18,5,5,14,23,15,18,20,125
7,18,5,5,19,0,0,0,0,54
7,18,5,5,19,1,7,8,0,70
7,18,5,5,19,5,0,0,0,59
7,18,5,5,19,8,15,3,8,88
7,18,5,5,20,0,0,0,0,55
7,18,5,5,20,5,4,0,0,64
7,18,5,5,20,5,18,0,0,78
7,18,5,5,20,5,18,19,0,97
7,18,5,5,20,9,14,7,0,85
7,18,5,5,20,9,14,7,19,104
7,18,5,5,20,19,0,0,0,74
7,18,5,5,22,5,0,0,0,62
7,18,5,6,6,5,0,0,0,47
7,18,5,6,6,9,5,18,0,74
7,18,5,7,1,12,0,0,0,50
7,18,5,7,1,12,5,0,0,55
7,18,5,7,1,12,15,9,4,78
7,18,5,7,1,18,9,1,14,80
7,18,5,7,1,18,9,14,5,84
7,18,5,7,1,20,9,13,0,80
7,18,5,7,1,21,0,0,0,59
7,18,5,7,5,0,0,0,0,42
7,18,5,7,7,5,0,0,0,49
7,18,5,7,7,12,5,0,0,61
7,18,5,7,15,0,0,0,0,52
7,18,5,7,15,19,0,0,0,71
7,18,5,25,2,1,3,11,0,72
7,18,5,25,2,5,1,18,4,85
7,18,5,25,3,15,1,20,0,94
7,18,5,25,5,4,0,0,0,64
7,18,5,25,5,18,0,0,0,78
7,18,5,25,5,19,20,0,0,99
7,18,5,25,6,9,19,8,0,97
7,18,5,25,6,12,25,0,0,98
7,18,5,25,6,12,9,5,19,106
7,18,5,9,7,5,0,0,0,51
7,18,5,9,7,5,19,0,0,70
7,18,5,25,8,5,14,0,0,82
7,18,5,25,8,5,14,19,0,101
7,18,5,25,8,15,21,14,4,117
7,18,5,25,9,14,7,0,0,85
7,18,5,25,9,19,8,0,0,91
7,18,5,25,12,1,7,0,0,75
7,18,5,25,12,1,7,19,0,94
7,18,5,25,12,25,0,0,0,92
7,18,5,25,12,9,14,7,0,97
7,18,5,9,12,12,1,4,5,73
7,18,5,9,14,0,0,0,0,53
7,18,5,25,14,5,19,19,0,112
7,18,5,9,14,7,0,0,0,60
7,18,5,25,16,1,20,5,0,97
7,18,5,25,19,0,0,0,0,74
7,18,5,9,19,5,14,0,0,77
7,18,5,9,19,5,14,19,0,96
7,18,5,25,19,11,9,14,0,108
7,18,5,25,19,20,15,14,5,128
7,18,5,9,20,0,0,0,0,59
7,18,5,9,20,8,0,0,0,67
7,18,5,25,23,1,3,11,5,98
7,18,5,25,23,1,18,5,0,102
7,18,5,11,9,14,7,0,0,71
7,18,5,12,15,20,0,0,0,77
7,18,5,13,9,1,12,0,0,65
7,18,5,13,9,1,12,5,0,70
7,18,5,13,9,1,12,19,0,84
7,18,5,13,9,15,0,0,0,67
7,18,5,13,12,9,14,0,0,78
7,18,5,13,12,9,14,19,0,97
7,18,5,13,13,25,0,0,0,81
7,18,5,13,13,9,5,0,0,70
7,18,5,13,13,9,5,19,0,89
7,18,5,14,1,4,5,0,0,54
7,18,5,14,1,4,5,19,0,73
7,18,5,14,1,4,9,5,18,81
7,18,5,14,1,4,9,14,0,72
7,18,5,14,1,4,9,14,5,77
7,18,5,14,1,4,15,0,0,64
7,18,5,14,1,20,0,0,0,65
7,18,5,14,1,20,9,20,5,99
7,18,5,14,5,0,0,0,0,49
7,18,5,19,0,0,0,0,0,49
7,18,5,19,9,12,0,0,0,70
7,18,5,19,19,9,2,12,5,96
7,18,5,20,0,0,0,0,0,50
7,18,5,21,14,4,0,0,0,69
7,18,5,23,8,15,21,14,4,115
7,18,5,23,19,15,13,5,0,105
7,18,5,23,19,15,13,5,18,123
7,18,5,23,20,0,0,0,0,73
7,18,5,24,0,0,0,0,0,54
7,18,6,0,0,0,0,0,0,31
7,18,25,0,0,0,0,0,0,50
7,18,9,2,1,14,5,0,0,56
7,18,9,2,2,12,5,0,0,55
7,18,9,2,2,12,5,19,0,74
7,18,9,3,5,0,0,0,0,42
7,18,9,4,0,0,0,0,0,38
7,18,9,4,4,5,4,0,0,51
7,18,9,4,4,5,18,0,0,65
7,18,9,4,4,5,18,19,0,84
7,18,9,4,4,9,14,7,0,72
7,18,9,4,4,12,5,0,0,59
7,18,9,4,4,12,5,4,0,63
7,18,9,4,4,12,5,18,0,77
7,18,9,4,4,12,5,19,0,78
7,18,9,4,4,12,9,14,7,84
7,18,9,4,5,0,0,0,0,43
7,18,25,4,5,0,0,0,0,59
7,18,9,4,5,4,0,0,0,47
7,18,9,4,5,12,9,14,0,78
7,18,9,4,5,19,0,0,0,62
7,18,9,4,9,14,7,0,0,68
7,18,9,4,9,18,15,14,0,94
7,18,9,4,9,18,15,14,19,113
7,18,9,4,12,15,3,11,0,79
7,18,9,4,19,0,0,0,0,57
7,18,9,5,2,5,14,0,0,60
7,18,9,5,3,5,0,0,0,47
7,18,9,5,3,5,4,0,0,51
7,18,9,5,3,5,16,0,0,63
7,18,9,5,6,0,0,0,0,45
7,18,9,5,6,6,21,12,0,84
7,18,9,5,6,12,5,19,19,100
7,18,9,5,6,19,0,0,0,64
7,18,9,5,7,5,0,0,0,51
7,18,9,5,11,15,0,0,0,65
7,18,9,5,19,8,15,3,8,92
7,18,9,5,22,1,2,12,5,81
7,18,9,5,22,1,14,3,5,84
7,18,9,5,22,1,14,20,0,96
7,18,9,5,22,1,14,20,19,115
7,18,9,5,22,5,4,0,0,70
7,18,9,5,22,5,4,12,25,107
7,18,9,5,22,5,18,0,0,84
7,18,9,5,22,5,18,19,0,103
7,18,9,5,22,5,19,0,0,85
7,18,9,5,22,9,14,7,0,91
7,18,9,5,22,15,21,19,0,116
7,18,9,6,6,1,4,5,0,56
7,18,9,6,6,1,4,15,0,66
7,18,9,6,6,1,21,14,0,82
7,18,9,6,6,5,0,0,0,51
7,18,9,6,6,9,14,19,0,88
7,18,9,6,6,15,14,14,5,94
7,18,9,6,6,15,14,19,0,94
7,18,9,6,6,19,0,0,0,65
7,18,9,6,20,0,0,0,0,60
7,18,9,6,20,5,4,0,0,69
7,18,9,6,20,5,18,0,0,83
7,18,9,6,20,5,18,19,0,102
7,18,9,6,20,9,14,7,0,90
7,18,9,6,20,19,0,0,0,79
7,18,9,7,0,0,0,0,0,41
7,18,9,7,7,12,5,19,0,84
7,18,9,7,14,5,20,0,0,80
7,18,9,7,18,9,0,0,0,68
7,18,9,7,18,9,19,0,0,87
7,18,9,7,19,0,0,0,0,60
7,18,9,8,1,19,20,8,1,91
7,18,9,11,5,0,0,0,0,50
7,18,9,12,12,0,0,0,0,58
7,18,9,12,12,1,4,5,0,68
7,18,9,12,12,1,4,5,4,72
7,18,9,12,12,1,4,5,19,87
7,18,9,12,12,1,7,5,0,71
7,18,9,12,12,1,7,5,19,90
7,18,9,12,12,5,0,0,0,63
7,18,25,12,12,5,0,0,0,79
7,18,9,12,12,5,4,0,0,67
7,18,9,12,12,5,5,0,0,68
7,18,9,12,12,5,18,0,0,81
7,18,9,12,12,5,18,19,0,100
7,18,9,12,12,5,19,0,0,82
7,18,9,12,12,25,0,0,0,83
7,18,25,12,12,9,0,0,0,83
7,18,25,12,12,9,4,0,0,87
7,18,9,12,12,9,14,7,0,88
7,18,25,12,12,15,19,0,0,108
7,18,9,12,12,18,15,15,13,119
7,18,9,12,12,19,0,0,0,77
7,18,9,12,12,23,15,18,11,125
7,18,9,12,19,5,0,0,0,70
7,18,9,12,19,5,19,0,0,89
7,18,9,13,1,3,5,0,0,56
7,18,9,13,1,3,5,4,0,60
7,18,9,13,1,3,5,18,0,74
7,18,9,13,1,3,5,18,19,93
7,18,9,13,1,3,5,19,0,75
7,18,9,13,1,3,9,5,18,83
7,18,9,13,1,3,9,14,7,81
7,18,9,13,1,12,11,9,14,94
7,18,9,13,5,0,0,0,0,52
7,18,9,13,5,4,0,0,0,56
7,18,9,13,6,21,12,0,0,86
7,18,9,13,25,0,0,0,0,72
7,18,9,13,9,5,18,0,0,79
7,18,9,13,9,5,19,20,0,100
7,18,9,13,9,12,25,0,0,93
7,18,9,13,9,14,5,19,0,94
7,18,9,13,9,14,5,19,19,113
7,18,9,13,9,14,7,0,0,77
7,18,9,13,12,25,0,0,0,84
7,18,9,13,13,5,0,0,0,65
7,18,9,13,13,5,18,0,0,83
7,18,9,13,13,5,19,20,0,104
7,18,9,13,13,9,19,8,0,96
7,18,9,13,14,5,19,19,0,104
7,18,9,13,15,9,18,5,0,94
7,18,9,13,16,0,0,0,0,63
7,18,9,13,19,9,18,0,0,93
7,18,9,13,19,9,18,5,0,98
7,18,9,14,0,0,0,0,0,48
7,18,9,14,1,7,15,7,0,78
7,18,9,14,3,8,0,0,0,59
7,18,9,14,3,15,13,5,0,84
7,18,9,14,4,0,0,0,0,52
7,18,9,14,4,1,2,12,5,72
7,18,9,14,4,1,12,0,0,65
7,18,9,14,4,5,4,0,0,61
7,18,9,14,4,5,18,0,0,75
7,18,9,14,4,5,18,25,0,100
7,18,9,14,4,5,18,19,0,94
7,18,9,14,4,9,14,7,0,82
7,18,9,14,4,9,14,7,19,101
7,18,9,14,4,19,0,0,0,71
7,18,9,14,7,15,0,0,0,70
7,18,9,14,7,15,12,5,0,87
7,18,9,14,7,15,12,5,5,92
7,18,9,14,7,15,19,0,0,89
7,18,9,14,14,5,4,0,0,71
7,18,9,14,14,5,18,0,0,85
7,18,9,14,14,5,18,19,0,104
7,18,9,14,14,25,0,0,0,87
7,18,9,14,14,9,5,0,0,76
7,18,9,14,14,9,14,7,0,92
7,18,9,14,19,0,0,0,0,67
7,18,9,14,20,0,0,0,0,68
7,18,9,14,20,5,18,0,0,91
7,18,9,14,20,5,18,14,0,105
7,18,9,15,20,0,0,0,0,69
7,18,9,15,20,19,0,0,0,88
7,18,9,15,20,20,5,0,0,94
7,18,9,16,0,0,0,0,0,50
7,18,25,16,1,14,9,1,14,105
7,18,9,16,5,0,0,0,0,55
7,18,25,16,5,0,0,0,0,71
7,18,9,16,5,4,0,0,0,59
7,18,9,16,5,6,21,12,0,94
7,18,9,16,5,25,0,0,0,80
7,18,9,16,5,18,0,0,0,73
7,18,9,16,5,18,19,0,0,92
7,18,9,16,5,19,0,0,0,74
7,18,9,16,7,18,1,19,19,114
7,18,9,16,8,0,0,0,0,58
7,18,25,16,8,0,0,0,0,74
7,18,9,16,8,5,0,0,0,63
7,18,9,16,8,9,20,5,0,92
7,18,25,16,8,9,20,5,0,108
7,18,25,16,8,15,14,0,0,103
7,18,25,16,8,15,14,19,0,122
7,18,9,16,8,21,19,0,0,98
7,18,9,16,25,0,0,0,0,75
7,18,9,16,9,5,18,0,0,82
7,18,9,16,9,5,19,20,0,103
7,18,9,16,9,14,7,0,0,80
7,18,9,16,9,14,7,12,25,117
7,18,9,16,12,5,19,19,0,105
7,18,9,16,13,1,14,0,0,78
7,18,9,16,13,5,14,0,0,82
7,18,9,16,13,5,14,20,0,102
7,18,25,16,15,19,9,19,0,128
7,18,9,16,16,1,12,0,0,79
7,18,9,16,16,5,0,0,0,71
7,18,9,16,16,5,4,0,0,75
7,18,9,16,16,5,18,0,0,89
7,18,9,16,16,5,18,19,0,108
7,18,9,16,16,5,19,0,0,90
7,18,9,16,16,25,0,0,0,91
7,18,9,16,16,9,5,18,0,98
7,18,9,16,16,9,5,19,20,119
7,18,9,16,16,9,14,7,0,96
7,18,9,16,16,9,20,0,0,95
7,18,9,16,16,12,5,0,0,83
7,18,9,16,19,1,3,11,0,84
7,18,9,16,19,1,3,11,19,103
7,18,9,16,20,0,0,0,0,70
7,18,9,17,21,1,9,20,5,107
7,18,9,19,1,9,12,12,5,92
7,18,9,19,1,18,4,0,0,76
7,18,9,19,2,5,20,0,0,80
7,18,25,19,2,15,11,0,0,97
7,18,9,19,5,0,0,0,0,58
7,18,9,19,5,15,21,19,0,113
7,18,9,19,5,20,20,5,0,103
7,18,9,19,5,20,20,5,19,122
7,18,9,19,7,18,9,19,0,106
7,18,9,19,11,9,14,0,0,87
7,18,9,19,11,9,14,19,0,106
7,18,9,19,12,5,4,0,0,74
7,18,9,19,12,25,0,0,0,90
7,18,9,19,12,9,5,18,0,97
7,18,9,19,12,9,5,19,20,118
7,18,9,19,16,9,14,7,0,99
7,18,9,19,19,5,14,0,0,91
7,18,9,19,19,5,14,19,0,110
7,18,9,19,19,5,20,0,0,97
7,18,9,19,19,15,14,19,0,120
7,18,9,19,20,0,0,0,0,73
7,18,9,19,20,2,9,20,5,109
7,18,9,19,20,5,18,0,0,96
7,18,9,19,20,25,0,0,0,98
7,18,9,19,20,12,5,0,0,90
7,18,9,19,20,12,5,19,0,109
7,18,9,19,20,12,25,0,0,110
7,18,9,19,20,12,9,5,18,117
7,18,9,19,20,13,9,12,12,119
7,18,9,19,20,19,0,0,0,92
7,18,9,20,8,0,0,0,0,62
7,18,9,20,8,13,1,14,0,90
7,18,9,20,8,19,0,0,0,81
7,18,9,20,12,5,19,19,0,109
7,18,9,20,18,15,3,11,0,101
7,18,9,20,19,0,0,0,0,73
7,18,9,20,19,20,15,14,5,127
7,18,9,20,20,5,4,0,0,83
7,18,9,20,20,5,14,0,0,93
7,18,9,20,20,5,18,0,0,97
7,18,9,20,20,25,0,0,0,99
7,18,9,20,20,9,5,0,0,88
7,18,9,20,20,9,5,18,0,106
7,18,9,20,20,9,5,19,20,127
7,18,9,20,20,9,12,25,0,120
7,18,9,20,20,9,14,7,0,104
7,18,9,20,20,12,5,0,0,91
7,18,9,22,1,20,9,15,14,115
7,18,9,22,5,20,0,0,0,81
7,18,9,22,5,20,19,0,0,100
7,18,9,22,14,1,0,0,0,71
7,18,9,22,15,9,19,0,0,99
7,18,9,22,15,9,19,5,0,104
7,18,9,26,1,18,4,0,0,83
7,18,9,26,5,12,9,14,0,100
7,18,9,26,26,12,5,0,0,103
7,18,9,26,26,12,5,4,0,107
7,18,9,26,26,12,5,18,0,121
7,18,9,26,26,12,5,18,19,140
7,18,9,26,26,12,5,19,0,122
7,18,9,26,26,12,25,0,0,123
7,18,9,26,26,12,9,5,18,130
7,18,9,26,26,12,9,5,19,131
7,18,9,26,26,12,9,14,7,128
7,18,15,1,14,0,0,0,0,55
7,18,15,1,14,5,4,0,0,64
7,18,15,1,14,5,18,0,0,78
7,18,15,1,14,5,18,19,0,97
7,18,15,1,14,6,21,12,0,94
7,18,15,1,14,9,14,7,0,85
7,18,15,1,14,19,0,0,0,74
7,18,15,1,20,0,0,0,0,61
7,18,15,1,20,19,0,0,0,80
7,18,15,2,9,1,14,0,0,66
7,18,15,3,5,18,0,0,0,66
7,18,15,3,5,18,4,15,13,98
7,18,15,3,5,18,5,19,19,109
7,18,15,3,5,18,25,0,0,91
7,18,15,3,5,18,9,5,19,99
7,18,15,3,5,18,12,25,0,103
7,18,15,3,5,18,19,0,0,85
7,18,15,3,11,12,5,0,0,71
7,18,15,6,6,0,0,0,0,52
7,18,15,7,0,0,0,0,0,47
7,18,15,7,7,5,4,0,0,63
7,18,15,7,7,5,18,0,0,77
7,18,15,7,7,5,18,25,0,102
7,18,15,7,7,25,0,0,0,79
7,18,15,7,7,9,5,18,0,86
7,18,15,7,7,9,5,19,20,107
7,18,15,7,7,9,12,25,0,100
7,18,15,7,7,9,14,7,0,84
7,18,15,7,14,1,18,4,0,84
7,18,15,7,18,1,13,0,0,79
7,18,15,7,18,1,13,19,0,98
7,18,15,7,19,0,0,0,0,66
7,18,15,7,19,8,15,16,0,105
7,18,15,7,19,8,15,16,19,124
7,18,15,9,14,0,0,0,0,63
7,18,15,25,14,5,0,0,0,84
7,18,15,9,14,5,4,0,0,72
7,18,15,9,14,5,18,25,0,111
7,18,15,25,14,5,19,0,0,103
7,18,15,9,14,9,14,7,0,93
7,18,15,9,14,19,0,0,0,82
7,18,15,13,1,0,0,0,0,54
7,18,15,13,1,20,9,3,0,86
7,18,15,13,1,20,9,3,19,105
7,18,15,13,5,20,0,0,0,78
7,18,15,13,9,12,0,0,0,74
7,18,15,13,25,12,0,0,0,90
7,18,15,13,13,5,20,0,0,91
7,18,15,13,13,5,20,19,0,110
7,18,15,13,23,5,12,12,0,105
7,18,15,13,23,5,12,12,19,124
7,18,15,14,4,0,0,0,0,58
7,18,15,14,4,23,5,20,0,106
7,18,15,14,20,0,0,0,0,74
7,18,15,15,6,0,0,0,0,61
7,18,15,15,13,0,0,0,0,68
7,18,15,15,13,5,4,0,0,77
7,18,15,15,13,5,18,0,0,91
7,18,15,15,13,5,18,19,0,110
7,18,15,15,13,25,0,0,0,93
7,18,15,15,13,9,14,7,0,98
7,18,15,15,13,9,19,8,0,104
7,18,15,15,13,12,5,20,0,105
7,18,15,15,13,12,9,14,7,110
7,18,15,15,13,19,0,0,0,87
7,18,15,15,13,19,13,1,14,115
7,18,15,15,13,19,13,5,14,119
7,18,15,15,16,0,0,0,0,71
7,18,15,15,16,5,18,0,0,94
7,18,15,15,19,5,0,0,0,79
7,18,15,15,20,25,0,0,0,100
7,18,15,15,22,5,0,0,0,82
7,18,15,15,22,5,4,0,0,86
7,18,15,15,22,5,18,0,0,100
7,18,15,15,22,5,18,19,0,119
7,18,15,15,22,5,19,0,0,101
7,18,15,15,22,25,0,0,0,102
7,18,15,15,22,9,5,18,0,109
7,18,15,15,22,9,5,19,20,130
7,18,15,15,22,9,14,7,0,107
7,18,15,15,23,0,0,0,0,78
7,18,15,16,5,4,0,0,0,65
7,18,15,16,5,18,0,0,0,79
7,18,15,16,5,18,19,0,0,98
7,18,15,16,5,19,0,0,0,80
7,18,15,16,9,14,7,0,0,86
7,18,15,16,9,14,7,12,25,123
7,18,15,16,16,12,5,0,0,89
7,18,15,18,21,4,9,20,5,117
7,18,15,19,2,5,1,11,0,78
7,18,15,19,2,5,1,11,19,97
7,18,15,19,3,8,5,14,0,89
7,18,15,19,5,18,0,0,0,82
7,18,15,19,5,20,0,0,0,84
7,18,15,19,7,18,1,9,14,108
7,18,15,19,19,1,18,20,0,117
7,18,15,19,19,5,4,0,0,87
7,18,15,19,19,5,14,0,0,97
7,18,15,19,19,5,18,0,0,101
7,18,15,19,19,5,18,19,0,120
7,18,15,19,19,5,19,0,0,102
7,18,15,19,19,5,19,20,0,122
7,18,15,19,19,8,5,1,4,96
7,18,15,19,19,9,6,25,0,118
7,18,15,19,19,9,14,7,0,108
7,18,15,19,19,12,25,0,0,115
7,18,15,19,19,14,5,19,19,135
7,18,15,19,19,15,0,0,0,93
7,18,15,19,19,21,12,1,18,130
7,18,15,19,26,5,0,0,0,90
7,18,15,19,26,25,0,0,0,110
7,18,15,20,0,0,0,0,0,60
7,18,15,20,5,14,0,0,0,79
7,18,15,20,5,19,3,15,0,102
7,18,15,20,5,19,17,21,5,127
7,18,15,20,8,9,14,5,0,96
7,18,15,20,8,9,20,5,0,102
7,18,15,20,19,0,0,0,0,79
7,18,15,20,20,5,19,3,15,122
7,18,15,20,20,25,0,0,0,105
7,18,15,20,20,9,5,18,0,112
7,18,15,20,20,15,0,0,0,95
7,18,15,20,20,15,5,4,0,104
7,18,15,20,20,15,19,0,0,114
7,18,15,20,26,5,14,0,0,105
7,18,15,21,3,8,0,0,0,72
7,18,15,21,3,8,5,4,0,81
7,18,15,21,3,8,5,19,0,96
7,18,15,21,3,8,9,5,18,104
7,18,15,21,3,8,9,12,25,118
7,18,15,21,3,8,9,14,7,102
7,18,15,21,3,8,15,0,0,87
7,18,15,21,6,0,0,0,0,67
7,18,15,21,7,8,0,0,0,76
7,18,15,21,14,4,0,0,0,79
7,18,15,21,14,4,1,7,5,92
7,18,15,21,14,4,5,4,0,88
7,18,15,21,14,4,5,14,0,98
7,18,15,21,14,4,5,18,0,102
7,18,15,21,14,4,5,18,19,121
7,18,15,21,14,4,8,15,7,109
7,18,15,21,14,4,25,0,0,104
7,18,15,21,14,4,9,14,7,109
7,18,15,21,14,4,12,25,0,116
7,18,15,21,14,4,13,1,14,107
7,18,15,21,14,4,14,21,20,134
7,18,15,21,14,4,15,21,20,135
7,18,15,21,14,4,19,5,12,115
7,18,15,21,14,4,23,1,25,128
7,18,15,21,16,0,0,0,0,77
7,18,15,21,16,1,2,12,5,97
7,18,15,21,16,1,7,5,0,90
7,18,15,21,16,5,4,0,0,86
7,18,15,21,16,5,18,0,0,100
7,18,15,21,16,5,18,19,0,119
7,18,15,21,16,9,5,0,0,91
7,18,15,21,16,9,5,19,0,110
7,18,15,21,16,9,14,7,0,107
7,18,15,21,16,9,14,7,19,126
7,18,15,21,16,9,19,20,0,125
7,18,15,21,16,12,5,20,0,114
7,18,15,21,16,13,5,14,20,129
7,18,15,21,16,15,9,4,0,105
7,18,15,21,16,15,9,4,19,124
7,18,15,21,16,19,0,0,0,96
7,18,15,21,16,23,9,19,5,133
7,18,15,21,19,5,0,0,0,85
7,18,15,21,19,5,4,0,0,89
7,18,15,21,19,5,18,0,0,103
7,18,15,21,19,5,18,19,0,122
7,18,15,21,19,5,19,0,0,104
7,18,15,21,19,25,0,0,0,105
7,18,15,21,19,9,14,7,0,110
7,18,15,21,20,0,0,0,0,81
7,18,15,21,20,5,4,0,0,90
7,18,15,21,20,5,18,0,0,104
7,18,15,21,20,5,18,19,0,123
7,18,15,21,20,8,5,1,4,99
7,18,15,21,20,25,0,0,0,106
7,18,15,21,20,9,5,18,0,113
7,18,15,21,20,9,5,19,20,134
7,18,15,21,20,9,14,7,0,111
7,18,15,21,20,9,20,5,0,115
7,18,15,21,20,14,15,12,12,134
7,18,15,21,20,19,0,0,0,100
7,18,15,21,26,5,0,0,0,92
7,18,15,22,5,4,0,0,0,71
7,18,15,22,5,12,0,0,0,79
7,18,15,22,5,12,5,4,0,88
7,18,15,22,5,12,5,18,0,102
7,18,15,22,5,12,5,18,19,121
7,18,15,22,5,12,5,19,19,122
7,18,15,22,5,12,9,14,7,109
7,18,15,22,5,12,12,5,4,100
7,18,15,22,5,12,12,5,18,114
7,18,15,22,5,12,19,0,0,98
7,18,15,22,5,18,19,0,0,104
7,18,15,22,5,20,0,0,0,87
7,18,15,22,25,0,0,0,0,87
7,18,15,23,1,2,12,5,0,83
7,18,15,23,1,14,0,0,0,78
7,18,15,23,5,4,0,0,0,72
7,18,15,23,5,18,0,0,0,86
7,18,15,23,5,18,19,0,0,105
7,18,15,23,9,14,7,0,0,93
7,18,15,23,9,14,7,12,25,130
7,18,15,23,12,0,0,0,0,75
7,18,15,23,12,5,4,0,0,84
7,18,15,23,12,5,18,0,0,98
7,18,15,23,12,5,18,25,0,123
7,18,15,23,12,5,18,19,0,117
7,18,15,23,12,25,0,0,0,100
7,18,15,23,12,9,5,18,0,107
7,18,15,23,12,9,5,19,20,128
7,18,15,23,12,9,14,7,0,105
7,18,15,23,12,19,0,0,0,94
7,18,15,23,14,0,0,0,0,77
7,18,15,23,14,21,16,0,0,114
7,18,15,23,14,21,16,19,0,133
7,18,15,23,19,0,0,0,0,82
7,18,15,23,19,5,0,0,0,87
7,18,15,23,19,15,13,5,0,115
7,18,15,23,20,8,0,0,0,91
7,18,15,23,20,8,6,21,12,130
7,18,15,23,20,8,25,0,0,116
7,18,15,23,20,8,19,0,0,110
7,18,15,23,26,5,0,0,0,94
7,18,15,26,1,18,20,0,0,105
7,18,15,26,5,18,0,0,0,89
7,18,15,26,5,20,0,0,0,91
7,18,18,0,0,0,0,0,0,43
7,18,21,2,0,0,0,0,0,48
7,18,21,2,2,5,4,0,0,59
7,18,21,2,2,5,18,0,0,73
7,18,21,2,2,5,18,25,0,98
7,18,21,2,2,5,18,19,0,92
7,18,21,2,2,25,0,0,0,75
7,18,21,2,2,9,5,18,0,82
7,18,21,2,2,9,5,19,0,83
7,18,21,2,2,9,5,19,20,103
7,18,21,2,2,9,12,25,0,96
7,18,21,2,2,9,14,7,0,80
7,18,21,2,2,12,5,0,0,67
7,18,21,2,8,15,15,4,0,90
7,18,21,2,12,5,19,19,0,103
7,18,21,2,18,15,15,20,0,116
7,18,21,2,19,0,0,0,0,67
7,18,21,2,19,20,1,11,5,104
7,18,21,2,23,15,18,13,0,117
7,18,21,2,23,15,18,13,19,136
7,18,21,3,3,8,5,0,0,65
7,18,21,4,7,5,0,0,0,62
7,18,21,4,7,5,4,0,0,66
7,18,21,4,7,5,6,21,12,101
7,18,21,4,7,5,11,9,14,96
7,18,21,4,7,5,15,14,19,110
7,18,21,4,7,5,18,0,0,80
7,18,21,4,7,5,18,25,0,105
7,18,21,4,7,5,18,19,0,99
7,18,21,4,7,5,19,0,0,81
7,18,21,4,7,9,14,7,0,87
7,18,21,4,7,13,5,14,20,109
7,18,21,5,0,0,0,0,0,51
7,18,21,5,12,0,0,0,0,63
7,18,21,5,12,5,4,0,0,72
7,18,21,5,12,5,18,0,0,86
7,18,21,5,12,5,18,19,0,105
7,18,21,5,12,9,14,7,0,93
7,18,21,5,12,9,14,7,19,112
7,18,21,5,12,12,5,4,0,84
7,18,21,5,12,12,5,18,0,98
7,18,21,5,12,12,5,18,19,117
7,18,21,5,12,12,25,0,0,100
7,18,21,5,12,12,9,14,7,105
7,18,21,5,12,19,0,0,0,82
7,18,21,5,19,15,13,5,0,103
7,18,21,5,19,15,13,5,18,121
7,18,21,6,0,0,0,0,0,52
7,18,21,6,6,0,0,0,0,58
7,18,21,6,6,5,4,0,0,67
7,18,21,6,6,5,18,0,0,81
7,18,21,6,6,5,19,20,0,102
7,18,21,6,6,25,0,0,0,83
7,18,21,6,6,9,5,18,0,90
7,18,21,6,6,9,5,19,20,111
7,18,21,6,6,9,12,25,0,104
7,18,21,6,6,9,14,7,0,88
7,18,21,6,6,9,19,8,0,94
7,18,21,6,6,12,25,0,0,95
7,18,21,6,6,14,5,19,19,115
7,18,21,6,6,19,0,0,0,77
7,18,21,6,20,0,0,0,0,72
7,18,21,6,20,5,4,0,0,81
7,18,21,7,15,21,19,0,0,108
7,18,21,7,18,21,0,0,0,92
7,18,21,7,18,21,19,0,0,111
7,18,21,25,5,18,5,19,0,118
7,18,21,9,6,15,18,13,0,107
7,18,21,9,14,5,0,0,0,74
7,18,21,25,19,0,0,0,0,90
7,18,21,13,0,0,0,0,0,59
7,18,21,13,2,12,5,0,0,78
7,18,21,13,2,12,5,4,0,82
7,18,21,13,2,12,5,18,0,96
7,18,21,13,2,12,5,18,19,115
7,18,21,13,2,12,5,19,0,97
7,18,21,13,2,12,25,0,0,98
7,18,21,13,2,12,9,14,7,103
7,18,21,13,5,0,0,0,0,64
7,18,21,13,5,19,0,0,0,83
7,18,21,13,12,25,0,0,0,96
7,18,21,13,13,5,12,0,0,89
7,18,21,13,13,5,12,19,0,108
7,18,21,13,13,5,18,0,0,95
7,18,21,13,13,5,19,20,0,116
7,18,21,13,13,5,20,0,0,97
7,18,21,13,13,5,20,5,18,120
7,18,21,13,13,5,20,19,0,116
7,18,21,13,14,5,19,19,0,116
7,18,21,13,15,19,5,0,0,98
7,18,21,13,15,21,19,0,0,114
7,18,21,13,16,0,0,0,0,75
7,18,21,13,16,5,4,0,0,84
7,18,21,13,16,8,0,0,0,83
7,18,21,13,16,8,25,0,0,108
7,18,21,13,16,8,9,5,0,97
7,18,21,13,16,8,9,5,19,116
7,18,21,13,16,25,0,0,0,100
7,18,21,13,16,9,5,18,0,107
7,18,21,13,16,9,5,19,20,128
7,18,21,13,16,9,12,25,0,121
7,18,21,13,16,9,14,7,0,105
7,18,21,13,16,9,19,8,0,111
7,18,21,13,16,19,0,0,0,94
7,18,21,14,0,0,0,0,0,60
7,18,21,14,3,8,0,0,0,71
7,18,21,14,4,5,12,0,0,81
7,18,21,14,4,19,9,12,0,104
7,18,21,14,5,18,9,20,5,117
7,18,21,14,7,5,0,0,0,72
7,18,21,14,7,5,19,0,0,91
7,18,21,14,7,25,0,0,0,92
7,18,21,14,7,9,5,18,0,99
7,18,21,14,7,9,5,19,20,120
7,18,21,14,9,15,14,0,0,98
7,18,21,14,9,15,14,19,0,117
7,18,21,14,19,23,5,12,0,119
7,18,21,14,20,0,0,0,0,80
7,18,21,14,20,5,4,0,0,89
7,18,21,14,20,5,18,0,0,103
7,18,21,14,20,5,18,19,0,122
7,18,21,14,20,9,14,7,0,110
7,18,21,14,20,12,5,0,0,97
7,18,21,14,20,12,5,4,0,101
7,18,21,14,20,12,5,19,0,116
7,18,21,14,20,12,9,14,7,122
7,18,21,14,20,19,0,0,0,99
7,18,21,14,26,9,5,0,0,100
7,18,21,16,16,5,20,20,15,138
7,18,21,16,16,15,0,0,0,93
7,18,21,19,8,0,0,0,0,73
7,18,21,19,8,9,5,0,0,87
7,18,21,19,19,0,0,0,0,84
7,18,21,20,3,8,0,0,0,77
7,18,21,20,3,8,5,4,0,86
7,18,21,20,3,8,5,19,0,101
7,18,21,20,3,8,9,14,7,107
7,18,21,20,20,5,14,0,0,105
7,18,24,0,0,0,0,0,0,49
7,20,4,0,0,0,0,0,0,31
7,20,5,1,21,0,0,0,0,54
7,20,8,9,20,5,0,0,0,69
7,21,2,1,20,0,0,0,0,51
7,21,2,2,9,14,7,19,0,81
7,21,2,2,9,14,19,0,0,74
7,21,2,2,15,0,0,0,0,47
7,21,2,5,18,12,1,0,0,66
7,21,2,5,18,14,9,1,0,77
7,21,2,5,18,14,9,25,1,102
7,21,3,11,0,0,0,0,0,42
7,21,3,11,5,4,0,0,0,51
7,21,3,11,9,0,0,0,0,51
7,21,3,11,19,0,0,0,0,61
7,21,4,0,0,0,0,0,0,32
7,21,4,1,13,5,0,0,0,51
7,21,4,4,12,5,0,0,0,53
7,21,4,4,12,5,4,0,0,57
7,21,4,4,12,5,18,0,0,71
7,21,4,4,12,9,14,7,0,78
7,21,4,5,19,0,0,0,0,56
7,21,4,5,19,1,11,5,0,73
7,21,4,5,19,1,11,5,19,92
7,21,4,5,19,9,18,5,0,88
7,21,4,5,23,9,6,5,0,80
7,21,4,7,5,0,0,0,0,44
7,21,4,7,5,15,14,0,0,73
7,21,4,7,5,15,14,5,4,82
7,21,4,7,5,15,14,19,0,92
7,21,4,7,5,20,0,0,0,64
7,21,4,15,11,0,0,0,0,58
7,21,5,0,0,0,0,0,0,33
7,21,5,2,18,5,0,0,0,58
7,21,5,2,21,3,21,0,0,80
7,21,5,10,1,18,9,20,5,96
7,21,5,13,1,12,0,0,0,59
7,21,5,13,21,12,0,0,0,79
7,21,5,14,5,16,5,0,0,73
7,21,5,14,15,14,0,0,0,76
7,21,5,14,15,14,19,0,0,95
7,21,5,16,1,18,4,0,0,72
7,21,5,16,1,18,4,5,0,77
7,21,5,18,4,15,14,0,0,84
7,21,5,18,4,15,14,5,4,93
7,21,5,18,4,15,14,5,18,107
7,21,5,18,4,15,14,19,0,103
7,21,5,18,5,2,1,0,0,59
7,21,5,18,5,26,1,0,0,83
7,21,5,18,7,1,12,0,0,71
7,21,5,18,9,4,15,14,0,93
7,21,5,18,9,4,15,14,19,112
7,21,5,18,9,12,12,1,0,85
7,21,5,18,9,12,12,1,19,104
7,21,5,18,9,19,15,14,0,108
7,21,5,18,9,20,5,0,0,85
7,21,5,18,9,20,5,19,0,104
7,21,5,18,18,5,0,0,0,74
7,21,5,18,18,9,12,1,0,91
7,21,5,18,18,9,12,12,1,103
7,21,5,19,19,0,0,0,0,71
7,21,5,19,19,1,2,12,5,91
7,21,5,19,19,5,4,0,0,80
7,21,5,19,19,5,18,0,0,94
7,21,5,19,19,5,18,19,0,113
7,21,5,19,19,5,19,0,0,95
7,21,5,19,19,9,14,7,0,101
7,21,5,19,19,9,22,5,0,107
7,21,5,19,19,23,15,18,11,138
7,21,5,19,20,5,4,0,0,81
7,21,5,19,20,5,14,0,0,91
7,21,5,19,20,5,18,0,0,95
7,21,5,19,20,9,14,7,0,102
7,21,5,19,20,9,22,5,0,108
7,21,5,19,20,12,5,19,19,127
7,21,5,19,20,19,0,0,0,91
7,21,5,19,20,19,8,9,16,124
7,21,5,19,20,23,9,19,5,128
7,21,5,20,18,5,0,0,0,76
7,21,6,1,0,0,0,0,0,35
7,21,6,6,0,0,0,0,0,40
7,21,6,6,1,23,0,0,0,64
7,21,6,6,1,23,5,4,0,73
7,21,6,6,1,23,9,14,7,94
7,21,6,6,1,23,19,0,0,83
7,21,6,6,5,18,0,0,0,63
7,21,6,6,25,0,0,0,0,65
7,21,6,6,9,14,0,0,0,63
7,21,6,6,19,0,0,0,0,59
7,21,6,15,21,7,8,20,0,105
7,21,7,1,12,0,0,0,0,48
7,21,7,7,12,5,0,0,0,59
7,21,7,7,12,5,4,0,0,63
7,21,7,7,12,5,19,0,0,78
7,21,7,7,12,5,20,0,0,79
7,21,7,7,12,9,14,7,0,84
7,21,7,12,5,20,0,0,0,72
7,21,7,12,5,20,19,0,0,91
7,21,7,12,9,1,0,0,0,57
7,21,7,12,9,15,0,0,0,71
7,21,7,21,0,0,0,0,0,56
7,21,8,18,0,0,0,0,0,54
7,21,9,1,3,0,0,0,0,41
7,21,9,2,0,0,0,0,0,39
7,21,9,2,1,0,0,0,0,40
7,21,9,3,8,5,20,0,0,73
7,21,9,4,0,0,0,0,0,41
7,21,9,4,1,2,12,5,0,61
7,21,9,4,1,7,5,0,0,54
7,21,9,4,1,14,3,5,0,64
7,21,9,4,1,14,3,5,19,83
7,21,9,4,5,2,15,15,11,89
7,21,9,4,5,4,0,0,0,50
7,21,9,4,5,12,5,19,19,101
7,21,9,4,5,12,9,14,5,86
7,21,9,4,5,16,15,19,20,116
7,21,9,4,5,18,0,0,0,64
7,21,9,4,5,18,5,19,19,107
7,21,9,4,5,18,19,0,0,83
7,21,9,4,5,19,0,0,0,65
7,21,9,4,5,19,8,9,16,98
7,21,9,4,5,23,1,25,0,95
7,21,9,4,9,14,7,0,0,71
7,21,9,4,9,14,7,12,25,108
7,21,9,4,13,1,14,0,0,69
7,21,25,4,15,13,0,0,0,85
7,21,9,4,15,14,0,0,0,70
7,21,9,4,15,14,19,0,0,89
7,21,9,4,19,0,0,0,0,60
7,21,9,4,19,9,18,5,0,92
7,21,9,4,23,9,6,5,0,84
7,21,9,4,23,9,12,12,25,122
7,21,25,5,4,0,0,0,0,62
7,21,25,5,18,19,0,0,0,95
7,21,9,7,5,0,0,0,0,49
7,21,9,7,14,5,0,0,0,63
7,21,9,7,14,15,12,0,0,85
7,21,25,9,14,7,0,0,0,83
7,21,9,10,15,0,0,0,0,62
7,21,9,12,4,5,18,0,0,76
7,21,9,12,4,5,18,19,0,95
7,21,9,12,4,8,1,12,12,86
7,21,9,12,4,9,3,0,0,65
7,21,9,12,4,9,20,5,0,87
7,21,9,12,4,18,25,0,0,96
7,21,9,12,4,19,0,0,0,72
7,21,9,12,4,19,8,9,16,105
7,21,9,12,4,19,13,1,14,100
7,21,9,12,4,19,13,5,14,104
7,21,9,12,5,0,0,0,0,54
7,21,9,12,5,4,0,0,0,58
7,21,9,12,5,6,21,12,0,93
7,21,9,12,5,12,5,19,19,109
7,21,9,12,5,18,0,0,0,72
7,21,9,12,5,18,25,0,0,97
7,21,9,12,5,19,0,0,0,73
7,21,9,12,6,1,20,0,0,76
7,21,9,12,25,0,0,0,0,74
7,21,25,12,9,14,5,0,0,93
7,21,9,12,9,14,7,0,0,79
7,21,9,12,12,5,13,0,0,79
7,21,9,12,12,5,13,5,20,104
7,21,9,12,12,5,13,15,20,114
7,21,9,12,12,5,22,1,20,109
7,21,9,12,12,15,3,8,5,92
7,21,9,12,20,0,0,0,0,69
7,21,9,12,20,6,21,12,0,108
7,21,9,12,20,25,0,0,0,94
7,21,9,12,20,9,5,18,0,101
7,21,9,12,20,9,5,19,20,122
7,21,9,12,20,9,12,25,0,115
7,21,9,12,20,12,5,19,19,124
7,21,9,12,20,19,0,0,0,88
7,21,9,12,20,19,9,3,11,111
7,21,9,13,2,1,18,4,0,75
7,21,9,13,16,5,0,0,0,71
7,21,9,13,16,5,19,0,0,90
7,21,9,14,4,5,0,0,0,60
7,21,9,14,5,1,16,9,7,89
7,21,9,14,5,1,19,0,0,76
7,21,9,14,6,15,0,0,0,72
7,21,25,15,20,0,0,0,0,88
7,21,25,15,20,19,0,0,0,107
7,21,9,16,21,18,5,0,0,97
7,21,9,16,21,18,5,19,0,116
7,21,9,18,12,1,14,4,5,91
7,21,9,18,15,0,0,0,0,70
7,21,9,19,1,18,4,19,0,98
7,21,9,19,1,18,13,5,0,93
7,21,9,19,5,4,0,0,0,65
7,21,9,19,5,18,0,0,0,79
7,21,9,19,5,19,0,0,0,80
7,21,9,19,9,14,7,0,0,86
7,21,9,20,1,18,0,0,0,76
7,21,9,20,1,18,9,19,20,124
7,21,9,20,1,18,19,0,0,95
7,21,9,20,7,21,9,20,0,114
7,21,25,20,18,1,19,8,0,119
7,21,25,23,9,18,5,0,0,108
7,21,12,0,0,0,0,0,0,40
7,21,12,1,5,0,0,0,0,46
7,21,12,1,7,19,0,0,0,67
7,21,12,1,13,1,14,0,0,69
7,21,12,1,14,3,8,1,0,67
7,21,12,1,14,4,0,0,0,59
7,21,12,1,18,0,0,0,0,59
7,21,12,1,18,9,19,0,0,87
7,21,12,1,19,0,0,0,0,60
7,21,12,1,19,8,0,0,0,68
7,21,12,3,8,0,0,0,0,51
7,21,12,3,8,5,19,0,0,75
7,21,12,4,0,0,0,0,0,44
7,21,12,4,5,14,0,0,0,63
7,21,12,4,5,14,19,0,0,82
7,21,12,5,0,0,0,0,0,45
7,21,12,5,19,0,0,0,0,64
7,21,12,6,5,4,0,0,0,55
7,21,12,6,25,0,0,0,0,71
7,21,12,6,9,5,18,0,0,78
7,21,12,6,9,5,19,20,0,99
7,21,12,6,9,14,7,0,0,76
7,21,12,6,12,9,11,5,0,83
7,21,12,6,19,0,0,0,0,65
7,21,12,6,19,9,4,5,0,83
7,21,12,6,23,1,18,4,19,111
7,21,12,6,23,5,5,4,0,83
7,21,12,6,23,5,5,4,19,102
7,21,12,7,21,12,0,0,0,80
7,21,12,25,0,0,0,0,0,65
7,21,12,9,14,21,12,1,0,97
7,21,12,9,14,21,12,1,5,102
7,21,12,9,14,21,12,1,18,115
7,21,12,9,19,20,0,0,0,88
7,21,12,9,24,0,0,0,0,73
7,21,12,12,0,0,0,0,0,52
7,21,12,12,1,2,12,5,0,72
7,21,12,12,1,2,12,25,0,92
7,21,12,12,1,7,5,0,0,65
7,21,12,12,5,4,0,0,0,61
7,21,12,12,5,25,0,0,0,82
7,21,12,12,5,25,19,0,0,101
7,21,12,12,5,18,0,0,0,75
7,21,12,12,5,18,25,0,0,100
7,21,12,12,5,18,9,5,19,108
7,21,12,12,5,20,0,0,0,77
7,21,12,12,5,20,9,14,7,107
7,21,12,12,5,20,19,0,0,96
7,21,12,12,25,0,0,0,0,77
7,21,12,12,9,2,12,5,0,80
7,21,12,12,9,2,12,25,0,100
7,21,12,12,9,5,4,0,0,70
7,21,12,12,9,5,19,0,0,85
7,21,12,12,25,7,21,20,0,125
7,21,12,12,25,8,15,12,5,117
7,21,12,12,25,9,14,7,0,107
7,21,12,12,9,14,7,0,0,82
7,21,12,12,9,15,14,0,0,90
7,21,12,12,9,19,8,0,0,88
7,21,12,12,9,19,8,12,25,125
7,21,12,12,12,9,11,5,0,89
7,21,12,12,19,0,0,0,0,71
7,21,12,13,15,8,1,18,0,95
7,21,12,15,14,9,3,0,0,81
7,21,12,15,19,5,0,0,0,79
7,21,12,15,19,9,20,25,0,128
7,21,12,16,0,0,0,0,0,56
7,21,12,16,5,4,0,0,0,65
7,21,12,16,5,18,0,0,0,79
7,21,12,16,5,18,19,0,0,98
7,21,12,16,8,0,0,0,0,64
7,21,12,16,25,0,0,0,0,81
7,21,12,16,9,5,18,0,0,88
7,21,12,16,9,5,19,20,0,109
7,21,12,16,9,14,0,0,0,79
7,21,12,16,9,14,7,0,0,86
7,21,12,16,9,14,7,12,25,123
7,21,12,16,19,0,0,0,0,75
7,21,12,18,1,22,1,7,5,94
7,21,12,19,0,0,0,0,0,59
7,21,12,19,1,3,8,0,0,71
7,21,12,20,0,0,0,0,0,60
7,21,13,2,25,0,0,0,0,68
7,21,13,2,15,9,12,0,0,79
7,21,13,2,15,9,12,19,0,98
7,21,13,2,15,12,9,11,5,95
7,21,13,2,15,15,20,0,0,93
7,21,13,2,15,15,20,19,0,112
7,21,13,2,15,19,0,0,0,77
7,21,13,2,15,20,9,12,0,99
7,21,13,2,15,20,9,12,19,118
7,21,13,3,8,5,23,5,18,103
7,21,13,4,9,7,7,5,18,91
7,21,13,4,18,15,16,0,0,94
7,21,13,4,18,15,16,19,0,113
7,21,13,6,9,5,12,4,0,77
7,21,13,6,12,15,23,5,18,120
7,21,13,8,1,18,0,0,0,68
7,21,13,9,0,0,0,0,0,50
7,21,13,9,8,1,14,0,0,73
7,21,13,12,1,8,0,0,0,62
7,21,13,12,5,19,19,0,0,96
7,21,13,12,25,0,0,0,0,78
7,21,13,12,9,11,5,0,0,78
7,21,13,13,1,0,0,0,0,55
7,21,13,13,1,7,5,0,0,67
7,21,13,13,1,11,5,18,0,89
7,21,13,13,1,11,9,14,7,96
7,21,13,13,1,19,0,0,0,74
7,21,13,13,1,20,1,0,0,76
7,21,13,13,1,20,15,21,19,130
7,21,13,13,5,4,0,0,0,63
7,21,13,13,5,18,0,0,0,77
7,21,13,13,5,18,19,0,0,96
7,21,13,13,25,0,0,0,0,79
7,21,13,13,9,3,0,0,0,66
7,21,13,13,9,5,18,0,0,86
7,21,13,13,9,5,19,20,0,107
7,21,13,13,9,14,5,19,19,120
7,21,13,13,9,14,7,0,0,84
7,21,13,13,9,20,5,0,0,88
7,21,13,13,9,20,5,19,0,107
7,21,13,13,15,19,5,0,0,93
7,21,13,13,15,19,5,19,0,112
7,21,13,13,15,19,9,19,0,116
7,21,13,13,15,19,9,20,25,142
7,21,13,13,15,21,19,0,0,109
7,21,13,16,0,0,0,0,0,57
7,21,13,16,8,5,15,14,0,99
7,21,13,16,8,9,15,14,0,103
7,21,13,16,20,9,15,14,0,115
7,21,13,16,20,9,15,14,19,134
7,21,13,16,20,9,15,21,19,141
7,21,13,16,21,19,0,0,0,97
7,21,13,19,0,0,0,0,0,60
7,21,13,19,8,9,5,12,4,98
7,21,13,19,8,15,5,0,0,88
7,21,13,19,8,15,5,4,0,92
7,21,13,19,8,15,5,19,0,107
7,21,13,19,8,15,9,14,7,113
7,21,13,20,18,5,5,0,0,89
7,21,13,20,18,5,5,19,0,108
7,21,13,23,5,5,4,0,0,78
7,21,13,23,5,5,4,19,0,97
7,21,13,23,15,15,4,0,0,98
7,21,13,23,15,15,4,19,0,117
7,21,14,1,0,0,0,0,0,43
7,21,14,1,18,3,8,25,0,97
7,21,14,1,20,5,0,0,0,68
7,21,14,1,20,5,4,0,0,72
7,21,14,1,20,9,14,7,0,93
7,21,14,1,20,9,15,14,0,101
7,21,14,2,1,18,18,5,12,98
7,21,14,2,5,1,18,5,18,91
7,21,14,2,15,1,20,0,0,80
7,21,14,2,15,1,20,19,0,99
7,21,14,2,18,9,7,8,20,106
7,21,14,3,15,20,20,15,14,129
7,21,14,4,1,0,0,0,0,47
7,21,14,4,1,12,15,23,0,97
7,21,14,4,5,3,11,0,0,65
7,21,14,4,5,12,5,20,0,88
7,21,14,4,5,12,15,23,0,101
7,21,14,4,9,0,0,0,0,55
7,21,14,4,25,0,0,0,0,71
7,21,14,4,9,5,0,0,0,60
7,21,14,4,25,7,21,20,0,119
7,21,14,4,15,7,0,0,0,68
7,21,14,4,15,7,19,0,0,87
7,21,14,5,2,15,0,0,0,64
7,21,14,6,9,7,8,20,0,92
7,21,14,6,9,7,8,20,19,111
7,21,14,6,9,18,5,0,0,80
7,21,14,6,9,18,5,19,0,99
7,21,14,6,12,9,14,20,0,103
7,21,14,6,12,9,14,20,19,122
7,21,14,6,15,21,7,8,20,119
7,21,14,7,0,0,0,0,0,49
7,21,14,7,5,0,0,0,0,54
7,21,14,8,15,21,19,5,0,110
7,21,14,25,1,8,0,0,0,76
7,21,14,25,1,14,7,0,0,89
7,21,14,25,5,8,0,0,0,80
7,21,14,9,20,5,18,0,0,94
7,21,14,10,0,0,0,0,0,52
7,21,14,10,1,0,0,0,0,53
7,21,14,10,1,8,0,0,0,61
7,21,14,11,0,0,0,0,0,53
7,21,14,11,8,15,12,5,0,93
7,21,14,11,8,15,12,5,4,97
7,21,14,11,25,0,0,0,0,78
7,21,14,11,19,0,0,0,0,72
7,21,14,12,0,0,0,0,0,54
7,21,14,12,1,25,5,18,0,103
7,21,14,12,1,25,9,14,7,110
7,21,14,12,5,19,19,0,0,97
7,21,14,12,9,14,5,0,0,82
7,21,14,12,15,3,11,19,0,102
7,21,14,13,1,11,5,18,0,90
7,21,14,13,1,11,9,14,7,97
7,21,14,13,1,14,0,0,0,70
7,21,14,13,5,14,0,0,0,74
7,21,14,13,5,20,1,12,0,93
7,21,14,13,5,20,1,12,19,112
7,21,14,14,1,7,5,0,0,69
7,21,14,14,5,0,0,0,0,61
7,21,14,14,5,4,0,0,0,65
7,21,14,14,5,12,0,0,0,73
7,21,14,14,5,12,19,0,0,92
7,21,14,14,5,14,0,0,0,75
7,21,14,14,5,18,5,19,19,122
7,21,14,14,5,18,25,0,0,104
7,21,14,14,5,18,9,5,19,112
7,21,14,14,5,18,19,0,0,98
7,21,14,14,25,0,0,0,0,81
7,21,14,14,25,2,1,7,0,91
7,21,14,14,9,5,19,0,0,89
7,21,14,14,9,14,7,19,0,105
7,21,14,14,25,19,1,3,11,115
7,21,14,14,21,14,7,0,0,98
7,21,14,15,3,18,1,3,25,107
7,21,14,15,14,7,0,0,0,78
7,21,14,16,1,16,5,18,0,98
7,21,14,16,1,16,5,18,19,117
7,21,14,16,12,1,25,0,0,96
7,21,14,16,12,1,25,19,0,115
7,21,14,16,15,9,14,20,0,116
7,21,14,16,15,9,14,20,19,135
7,21,14,16,15,18,20,0,0,111
7,21,14,16,15,23,4,5,18,123
7,21,14,16,15,23,5,18,0,119
7,21,14,18,1,3,11,0,0,75
7,21,14,18,5,1,3,8,0,77
7,21,14,18,15,15,13,0,0,103
7,21,14,18,15,15,13,19,0,122
7,21,14,18,21,14,14,5,18,132
7,21,14,19,0,0,0,0,0,61
7,21,14,19,5,12,0,0,0,78
7,21,14,19,5,12,19,0,0,97
7,21,14,19,8,9,16,0,0,94
7,21,14,19,8,9,16,19,0,113
7,21,14,19,8,15,16,0,0,100
7,21,14,19,8,15,20,0,0,104
7,21,14,19,8,15,20,19,0,123
7,21,14,19,12,9,14,7,0,103
7,21,14,19,13,1,14,0,0,89
7,21,14,19,13,9,20,8,0,111
7,21,14,19,13,9,20,8,19,130
7,21,14,19,20,5,18,0,0,104
7,21,14,19,20,9,3,11,0,104
7,21,14,19,20,15,3,11,0,110
7,21,14,19,20,15,3,11,19,129
7,21,14,19,20,15,14,5,0,115
7,21,14,20,21,2,0,0,0,85
7,21,14,21,14,7,0,0,0,84
7,21,14,23,1,12,5,0,0,83
7,21,14,23,1,12,5,19,0,102
7,21,14,23,8,1,12,5,0,91
7,21,16,0,0,0,0,0,0,44
7,21,16,16,25,0,0,0,0,85
7,21,16,16,9,5,19,0,0,93
7,21,18,4,6,9,19,8,0,92
7,21,18,4,25,0,0,0,0,75
7,21,18,4,12,5,0,0,0,67
7,21,18,4,23,1,18,1,0,93
7,21,18,7,5,0,0,0,0,58
7,21,18,7,5,4,0,0,0,62
7,21,18,7,5,15,14,0,0,87
7,21,18,7,5,15,14,19,0,106
7,21,18,7,5,19,0,0,0,77
7,21,18,7,9,14,7,0,0,83
7,21,18,7,12,5,0,0,0,70
7,21,18,7,12,5,4,0,0,74
7,21,18,7,12,5,19,0,0,89
7,21,18,7,12,5,20,0,0,90
7,21,18,7,12,5,20,19,0,109
7,21,18,7,12,25,0,0,0,90
7,21,18,7,12,9,14,7,0,95
7,21,18,7,15,25,12,0,0,105
7,21,18,7,15,25,12,5,0,110
7,21,18,7,21,12,9,15,0,110
7,21,18,10,1,14,0,0,0,71
7,21,18,10,21,14,0,0,0,91
7,21,18,11,0,0,0,0,0,57
7,21,18,12,5,0,0,0,0,63
7,21,18,12,5,20,0,0,0,83
7,21,18,12,25,0,0,0,0,83
7,21,18,14,1,18,4,0,0,83
7,21,18,14,1,18,4,19,0,102
7,21,18,14,5,25,19,0,0,109
7,21,18,14,5,20,0,0,0,85
7,21,18,14,5,20,19,0,0,104
7,21,18,14,5,20,20,25,0,130
7,21,18,14,9,1,4,0,0,74
7,21,18,18,0,0,0,0,0,64
7,21,18,18,1,8,0,0,0,73
7,21,18,18,25,0,0,0,0,89
7,21,18,18,9,5,19,0,0,97
7,21,18,19,8,0,0,0,0,73
7,21,18,19,8,5,19,0,0,97
7,21,18,20,0,0,0,0,0,66
7,21,18,20,19,0,0,0,0,85
7,21,18,21,0,0,0,0,0,67
7,21,18,21,19,0,0,0,0,86
7,21,18,21,19,8,9,16,0,119
7,21,18,21,19,8,9,16,19,138
7,21,19,1,9,14,0,0,0,71
7,21,19,5,18,0,0,0,0,70
7,21,19,5,18,9,4,0,0,83
7,21,19,8,0,0,0,0,0,55
7,21,19,8,5,4,0,0,0,64
7,21,19,8,5,18,19,0,0,97
7,21,19,8,5,19,0,0,0,79
7,21,19,8,5,20,0,0,0,80
7,21,19,8,25,0,0,0,0,80
7,21,19,8,9,5,18,0,0,87
7,21,19,8,9,5,19,20,0,108
7,21,19,8,9,12,25,0,0,101
7,21,19,8,9,14,5,19,19,121
7,21,19,8,9,14,7,0,0,85
7,21,19,8,9,14,7,12,25,122
7,21,19,12,1,0,0,0,0,60
7,21,19,12,5,0,0,0,0,64
7,21,19,12,5,5,0,0,0,69
7,21,19,19,5,20,0,0,0,91
7,21,19,19,5,20,5,4,0,100
7,21,19,19,5,20,9,14,7,121
7,21,19,19,5,20,19,0,0,110
7,21,19,19,9,5,4,0,0,84
7,21,19,19,9,5,19,0,0,99
7,21,19,19,25,9,14,7,0,121
7,21,19,20,0,0,0,0,0,67
7,21,19,20,1,2,12,5,0,87
7,21,19,20,1,2,12,5,19,106
7,21,19,20,1,18,4,0,0,90
7,21,19,20,1,20,9,15,14,126
7,21,19,20,1,20,9,22,5,124
7,21,19,20,1,20,15,18,25,146
7,21,19,20,5,4,0,0,0,76
7,21,19,20,6,21,12,0,0,106
7,21,19,20,6,21,12,12,25,143
7,21,19,20,9,5,18,0,0,99
7,21,19,20,9,5,19,20,0,120
7,21,19,20,9,12,25,0,0,113
7,21,19,20,9,14,5,19,19,133
7,21,19,20,9,14,7,0,0,97
7,21,19,20,12,5,19,19,0,122
7,21,19,20,15,0,0,0,0,82
7,21,19,20,15,5,19,0,0,106
7,21,19,20,15,9,19,8,0,118
7,21,19,20,15,19,15,0,0,116
7,21,19,20,19,0,0,0,0,86
7,21,20,2,21,3,11,5,20,110
7,21,20,9,5,18,18,5,26,129
7,21,20,12,5,19,19,0,0,103
7,21,20,12,9,11,5,0,0,85
7,21,20,12,9,14,7,0,0,90
7,21,20,19,0,0,0,0,0,67
7,21,20,19,5,18,0,0,0,90
7,21,20,19,25,0,0,0,0,92
7,21,20,19,9,5,18,0,0,99
7,21,20,19,9,5,19,20,0,120
7,21,20,19,9,12,25,0,0,113
7,21,20,19,9,14,5,19,19,133
7,21,20,20,0,0,0,0,0,68
7,21,20,20,1,0,0,0,0,69
7,21,20,20,1,2,12,5,0,88
7,21,20,20,1,5,0,0,0,74
7,21,20,20,1,18,0,0,0,87
7,21,20,20,1,20,5,0,0,94
7,21,20,20,1,20,5,4,0,98
7,21,20,20,1,20,9,13,0,111
7,21,20,20,1,20,9,15,14,127
7,21,20,20,5,0,0,0,0,73
7,21,20,20,5,4,0,0,0,77
7,21,20,20,5,5,0,0,0,78
7,21,20,20,5,18,0,0,0,91
7,21,20,20,5,18,1,12,0,104
7,21,20,20,5,18,5,4,0,100
7,21,20,20,5,18,9,14,7,121
7,21,20,20,5,18,9,26,5,131
7,21,20,20,5,18,13,1,14,119
7,21,20,20,5,18,19,0,0,110
7,21,20,20,9,0,0,0,0,77
7,21,20,20,25,0,0,0,0,93
7,21,20,20,9,4,5,0,0,86
7,21,20,20,9,5,0,0,0,82
7,21,20,20,9,5,18,0,0,100
7,21,20,20,9,5,19,20,0,121
7,21,20,20,9,6,5,18,0,106
7,21,20,20,9,6,15,18,13,129
7,21,20,20,9,14,5,19,19,134
7,21,20,20,9,14,7,0,0,98
7,21,20,20,12,5,0,0,0,85
7,21,20,20,12,5,4,0,0,89
7,21,20,20,12,5,18,0,0,103
7,21,20,20,12,5,18,19,0,122
7,21,20,20,12,5,19,0,0,104
7,21,20,20,12,9,14,7,0,110
7,21,20,20,21,12,1,0,0,102
7,21,20,20,21,12,1,5,0,107
7,21,20,20,21,12,1,18,0,120
7,21,20,20,21,12,1,20,5,127
7,21,20,20,21,12,5,0,0,106
7,21,20,20,21,12,15,21,19,156
7,21,20,20,21,18,0,0,0,107
7,21,20,20,21,18,1,12,0,120
7,21,20,20,21,18,1,12,19,139
7,21,20,20,21,18,9,14,5,135
7,21,20,20,21,18,9,26,5,147
7,21,20,20,21,19,0,0,0,108
7,21,20,23,5,5,4,0,0,85
7,21,20,23,9,19,5,0,0,104
7,21,20,23,15,18,20,0,0,124
7,21,22,0,0,0,0,0,0,50
7,21,22,1,3,9,14,5,0,82
7,21,22,19,0,0,0,0,0,69
7,21,26,0,0,0,0,0,0,54
7,21,26,5,0,0,0,0,0,59
7,21,26,5,18,1,20,0,0,98
7,21,26,26,12,5,0,0,0,97
7,21,26,26,12,5,4,0,0,101
7,21,26,26,12,5,4,15,13,129
7,21,26,26,12,5,18,0,0,115
7,21,26,26,12,5,18,19,0,134
7,21,26,26,12,5,19,0,0,116
7,21,26,26,12,9,14,7,0,122
7,23,5,4,21,3,0,0,0,63
7,23,5,4,21,3,11,0,0,74
7,23,5,4,21,3,11,19,0,93
7,23,5,4,21,3,19,0,0,82
7,23,5,5,4,0,0,0,0,44
7,23,5,5,15,14,0,0,0,69
7,23,5,12,25,0,0,0,0,72
7,23,5,18,26,9,15,21,0,124
7,23,9,14,5,0,0,0,0,58
7,23,9,14,9,1,4,0,0,67
7,23,25,14,9,1,4,0,0,83
8,3,2,0,0,0,0,0,0,13
8,3,15,14,22,5,18,20,0,105
8,4,2,11,0,0,0,0,0,25
8,4,11,6,0,0,0,0,0,29
8,4,17,18,19,0,0,0,0,66
8,4,23,5,0,0,0,0,0,40
8,5,2,1,13,9,3,0,0,41
8,5,2,4,15,13,1,4,0,52
8,5,2,4,15,13,1,4,19,71
8,5,2,4,15,13,1,18,25,91
8,5,2,4,15,13,3,1,4,55
8,5,2,5,14,0,0,0,0,34
8,5,2,5,14,15,14,0,0,63
8,5,2,5,19,0,0,0,0,39
8,5,2,5,20,1,20,5,0,66
8,5,2,5,20,1,20,5,4,70
8,5,2,5,20,1,20,5,19,85
8,5,2,5,20,5,0,0,0,45
8,5,2,5,20,9,3,0,0,52
8,5,2,5,20,15,13,25,0,93
8,5,2,5,20,21,4,5,0,70
8,5,2,5,20,21,4,5,19,89
8,5,2,15,20,15,13,25,0,103
8,5,2,18,1,9,19,20,19,101
8,5,2,18,1,9,26,5,19,93
8,5,3,1,20,15,13,2,0,67
8,5,3,1,20,15,13,2,19,86
8,5,3,3,15,0,0,0,0,34
8,5,3,8,0,0,0,0,0,24
8,5,3,8,19,8,5,18,0,74
8,5,3,8,19,8,5,18,19,93
8,5,3,11,9,13,1,12,0,62
8,5,3,11,12,5,0,0,0,44
8,5,3,11,12,5,4,0,0,48
8,5,3,11,12,5,18,0,0,62
8,5,3,11,12,5,18,19,0,81
8,5,3,11,12,5,19,0,0,63
8,5,3,11,12,9,14,7,0,69
8,5,3,11,19,0,0,0,0,46
8,5,3,20,1,18,0,0,0,55
8,5,3,20,1,18,5,0,0,60
8,5,3,20,1,18,5,19,0,79
8,5,3,20,5,0,0,0,0,41
8,5,3,20,9,3,0,0,0,48
8,5,3,20,9,3,1,12,0,61
8,5,3,20,9,3,12,25,0,85
8,5,3,20,25,12,9,0,0,82
8,5,3,20,9,22,5,0,0,72
8,5,3,20,15,7,18,1,13,90
8,5,3,20,15,18,5,4,0,78
8,5,3,20,15,18,5,18,0,92
8,5,3,20,15,18,9,14,7,99
8,5,3,20,15,18,9,19,13,110
8,5,3,20,15,18,12,25,0,106
8,5,3,20,15,18,19,0,0,88
8,5,3,20,15,23,1,20,20,115
8,5,4,0,0,0,0,0,0,17
8,5,4,4,12,5,0,0,0,38
8,5,4,4,12,5,18,0,0,56
8,5,4,4,12,5,19,0,0,57
8,5,4,5,0,0,0,0,0,22
8,5,4,5,2,15,0,0,0,39
8,5,4,5,18,0,0,0,0,40
8,5,4,5,18,1,12,0,0,53
8,5,4,5,18,1,20,5,4,70
8,5,4,5,18,9,3,0,0,52
8,5,4,5,18,9,14,0,0,63
8,5,4,5,18,15,19,5,0,79
8,5,4,5,18,19,0,0,0,59
8,5,4,7,5,0,0,0,0,29
8,5,4,7,5,2,5,0,0,36
8,5,4,7,5,2,15,18,14,78
8,5,4,7,5,2,15,20,5,71
8,5,4,7,5,4,0,0,0,33
8,5,4,7,5,8,15,7,0,59
8,5,4,7,5,8,15,7,19,78
8,5,4,7,5,8,15,16,0,68
8,5,4,7,5,8,15,16,19,87
8,5,4,7,5,12,5,19,19,84
8,5,4,7,5,16,9,7,0,61
8,5,4,7,5,16,9,7,19,80
8,5,4,7,5,18,0,0,0,47
8,5,4,7,5,18,15,23,0,85
8,5,4,7,5,18,15,23,19,104
8,5,4,7,5,18,19,0,0,66
8,5,4,7,5,23,5,5,4,66
8,5,4,7,5,23,9,19,5,85
8,5,4,7,5,23,15,15,4,86
8,5,4,7,25,0,0,0,0,49
8,5,4,7,9,5,18,0,0,56
8,5,4,7,9,5,19,20,0,77
8,5,4,7,9,14,7,0,0,54
8,5,4,7,9,14,7,12,25,91
8,5,4,25,16,8,1,14,5,86
8,5,4,15,14,9,3,0,0,58
8,5,4,15,14,9,3,1,12,71
8,5,4,15,14,9,3,19,0,77
8,5,4,15,14,9,19,13,0,87
8,5,4,15,14,9,19,13,19,106
8,5,4,15,14,9,19,20,0,94
8,5,4,15,14,9,19,20,19,113
8,5,4,18,1,12,0,0,0,48
8,5,4,18,15,3,5,12,5,75
8,5,4,18,15,14,0,0,0,64
8,5,4,18,21,13,9,20,5,103
8,5,5,0,0,0,0,0,0,18
8,5,5,4,0,0,0,0,0,22
8,5,5,4,5,4,0,0,0,31
8,5,5,4,5,18,0,0,0,45
8,5,5,4,5,18,19,0,0,64
8,5,5,4,6,21,12,0,0,61
8,5,5,4,6,21,12,12,25,98
8,5,5,4,25,0,0,0,0,47
8,5,5,4,9,12,25,0,0,68
8,5,5,4,9,14,5,19,19,88
8,5,5,4,9,14,7,0,0,52
8,5,5,4,12,5,19,19,0,77
8,5,5,4,19,0,0,0,0,41
8,5,5,8,1,23,0,0,0,50
8,5,5,8,1,23,5,4,0,59
8,5,5,8,1,23,9,14,7,80
8,5,5,8,1,23,19,0,0,69
8,5,5,12,0,0,0,0,0,30
8,5,5,12,2,1,12,12,0,57
8,5,5,12,2,1,12,12,19,76
8,5,5,12,2,1,14,4,0,51
8,5,5,12,3,1,16,0,0,50
8,5,5,12,5,4,0,0,0,39
8,5,5,12,5,18,0,0,0,53
8,5,5,12,5,18,19,0,0,72
8,5,5,12,7,18,9,16,0,80
8,5,5,12,9,14,7,0,0,60
8,5,5,12,9,14,7,19,0,79
8,5,5,12,12,5,19,19,0,85
8,5,5,12,13,1,11,5,18,78
8,5,5,12,16,1,20,8,0,75
8,5,5,12,16,9,5,3,5,68
8,5,5,12,16,12,1,20,5,84
8,5,5,12,16,15,19,20,0,100
8,5,5,12,16,15,19,20,19,119
8,5,5,12,16,18,9,14,20,107
8,5,5,12,19,0,0,0,0,49
8,5,5,12,19,20,18,1,16,104
8,5,5,12,20,1,16,0,0,67
8,5,5,12,20,1,16,19,0,86
8,5,5,12,20,18,5,5,0,78
8,5,5,12,23,15,18,11,0,97
8,5,5,13,18,1,1,4,0,55
8,5,5,13,18,1,1,20,0,71
8,5,5,26,5,0,0,0,0,49
8,5,5,26,5,4,0,0,0,53
8,5,5,26,5,19,0,0,0,68
8,5,5,26,25,0,0,0,0,69
8,5,5,26,9,5,0,0,0,58
8,5,5,26,9,14,7,0,0,74
8,5,6,20,0,0,0,0,0,39
8,5,6,20,5,4,0,0,0,48
8,5,6,20,5,18,19,0,0,81
8,5,6,20,25,0,0,0,0,64
8,5,6,20,9,5,18,0,0,71
8,5,6,20,9,5,19,20,0,92
8,5,6,20,9,12,25,0,0,85
8,5,6,20,9,14,5,19,19,105
8,5,6,20,9,14,7,0,0,69
8,5,6,20,19,0,0,0,0,58
8,5,7,1,18,9,0,0,0,48
8,5,7,1,18,9,19,0,0,67
8,5,7,5,13,15,14,0,0,67
8,5,7,5,13,15,14,9,3,79
8,5,7,9,18,1,19,0,0,67
8,5,7,21,13,5,14,0,0,73
8,5,7,21,13,5,14,5,0,78
8,5,7,21,13,5,14,5,19,97
8,5,7,21,13,5,14,25,0,98
8,5,7,21,13,5,14,15,19,107
8,5,7,21,13,5,14,19,0,92
8,5,8,0,0,0,0,0,0,21
8,5,8,19,0,0,0,0,0,40
8,5,9,0,0,0,0,0,0,22
8,5,9,1,21,0,0,0,0,44
8,5,25,4,1,25,0,0,0,68
8,5,25,4,1,25,19,0,0,87
8,5,25,4,5,7,21,25,0,100
8,5,25,4,5,25,0,0,0,72
8,5,25,4,5,25,19,0,0,91
8,5,9,6,5,18,0,0,0,51
8,5,9,6,5,18,19,0,0,70
8,5,9,7,8,0,0,0,0,37
8,5,25,7,8,0,0,0,0,53
8,5,9,7,8,4,1,25,0,67
8,5,9,7,8,20,0,0,0,57
8,5,9,7,8,20,5,4,0,66
8,5,9,7,8,20,5,14,0,76
8,5,9,7,8,20,5,14,19,95
8,5,9,7,8,20,8,0,0,65
8,5,9,7,8,20,8,19,0,84
8,5,9,7,8,20,19,0,0,76
8,5,9,9,0,0,0,0,0,31
8,5,9,12,0,0,0,0,0,34
8,5,9,12,4,0,0,0,0,38
8,5,9,12,5,4,0,0,0,43
8,5,9,12,25,0,0,0,0,59
8,5,9,12,9,14,7,0,0,64
8,5,9,12,19,0,0,0,0,53
8,5,9,13,9,14,0,0,0,58
8,5,9,13,9,19,8,0,0,71
8,5,9,14,9,5,19,0,0,69
8,5,25,14,14,5,0,0,0,71
8,5,9,14,15,21,19,0,0,91
8,5,9,14,15,21,19,12,25,128
8,5,9,14,20,26,9,20,5,116
8,5,25,16,5,14,0,0,0,73
8,5,9,18,0,0,0,0,0,40
8,5,25,18,1,20,0,0,0,77
8,5,9,18,4,15,13,0,0,72
8,5,9,18,4,15,13,19,0,91
8,5,9,18,5,4,0,0,0,49
8,5,9,18,5,19,19,0,0,83
8,5,9,18,5,19,19,5,19,107
8,5,9,18,9,14,7,0,0,70
8,5,9,18,12,5,19,19,0,95
8,5,9,18,12,15,0,0,0,67
8,5,9,18,12,15,15,13,0,95
8,5,9,18,12,15,15,13,19,114
8,5,9,18,19,0,0,0,0,59
8,5,9,18,19,8,9,16,0,92
8,5,9,18,19,8,9,16,19,111
8,5,9,18,19,11,9,16,0,95
8,5,9,19,8,9,0,0,0,58
8,5,9,19,20,0,0,0,0,61
8,5,9,19,20,5,4,0,0,70
8,5,9,19,20,5,18,0,0,84
8,5,9,19,20,5,18,19,0,103
8,5,9,19,20,9,14,7,0,91
8,5,9,19,20,19,0,0,0,80
8,5,9,20,9,11,9,0,0,71
8,5,9,26,5,0,0,0,0,53
8,5,9,26,5,4,0,0,0,57
8,5,9,26,9,14,7,0,0,78
8,5,10,9,18,1,19,0,0,70
8,5,11,8,19,8,5,18,0,82
8,5,11,8,19,8,5,18,19,101
8,5,11,20,1,18,5,0,0,68
8,5,11,20,1,18,5,19,0,87
8,5,11,20,5,21,19,0,0,89
8,5,11,20,15,7,18,1,13,98
8,5,12,1,19,0,0,0,0,45
8,5,12,2,5,8,0,0,0,40
8,5,12,3,15,0,0,0,0,43
8,5,12,3,15,9,4,0,0,56
8,5,12,3,15,12,15,7,25,102
8,5,12,3,15,19,9,19,0,90
8,5,12,3,15,20,9,3,0,75
8,5,12,4,5,18,0,0,0,52
8,5,12,5,0,0,0,0,0,30
8,5,12,5,14,9,14,0,0,67
8,5,12,5,14,9,15,9,4,81
8,5,12,5,14,14,0,0,0,58
8,5,12,5,16,15,12,5,0,78
8,5,12,5,23,15,21,0,0,89
8,5,12,9,1,3,0,0,0,38
8,5,12,9,1,3,1,12,0,51
8,5,12,9,1,5,1,14,0,55
8,5,12,9,1,19,20,0,0,74
8,5,12,9,1,19,20,9,3,86
8,5,12,9,1,19,20,19,0,93
8,5,12,9,2,21,19,0,0,76
8,5,12,9,3,1,12,0,0,50
8,5,12,9,3,1,12,12,25,87
8,5,12,9,3,5,4,0,0,46
8,5,12,9,3,5,19,0,0,61
8,5,12,9,3,9,14,0,0,60
8,5,12,9,3,9,14,5,0,65
8,5,12,9,3,9,20,25,0,91
8,5,12,9,3,9,20,9,3,78
8,5,12,9,3,12,9,14,5,77
8,5,12,9,3,15,9,4,0,65
8,5,12,9,3,15,9,4,19,84
8,5,12,9,3,15,14,19,0,85
8,5,12,9,3,15,16,20,0,88
8,5,12,9,3,15,16,20,19,107
8,5,12,9,3,20,9,20,5,91
8,5,12,9,4,5,0,0,0,43
8,5,12,9,4,18,15,13,5,89
8,5,12,9,12,9,6,20,0,81
8,5,12,9,14,7,0,0,0,55
8,5,12,9,15,0,0,0,0,49
8,5,12,9,15,4,15,14,0,82
8,5,12,9,15,4,15,18,0,86
8,5,12,9,15,7,18,1,13,88
8,5,12,9,15,9,4,0,0,62
8,5,12,9,15,12,9,20,5,95
8,5,12,9,15,12,15,7,25,108
8,5,12,9,15,16,15,18,5,103
8,5,12,9,15,19,9,19,0,96
8,5,12,9,15,19,20,1,20,109
8,5,12,9,15,20,25,16,5,115
8,5,12,9,15,20,25,16,25,135
8,5,12,9,15,26,15,1,14,105
8,5,12,9,15,26,15,9,3,102
8,5,12,9,16,1,4,0,0,55
8,5,12,9,16,1,4,19,0,74
8,5,12,9,16,15,18,20,0,103
8,5,12,9,16,15,18,20,19,122
8,5,12,9,19,20,15,16,0,104
8,5,12,9,19,20,15,16,19,123
8,5,12,9,21,13,0,0,0,68
8,5,12,9,21,13,19,0,0,87
8,5,12,9,24,0,0,0,0,58
8,5,12,9,24,5,19,0,0,82
8,5,12,9,24,9,14,0,0,81
8,5,12,9,26,9,20,9,3,101
8,5,12,12,2,5,14,20,0,78
8,5,12,12,2,15,18,5,0,77
8,5,12,12,2,15,18,14,0,86
8,5,12,12,2,15,24,0,0,78
8,5,12,12,2,15,24,5,19,102
8,5,12,12,2,18,5,4,0,66
8,5,12,12,2,18,15,20,8,100
8,5,12,12,3,1,20,0,0,61
8,5,12,12,3,1,20,19,0,80
8,5,12,12,4,9,22,5,18,95
8,5,12,12,4,15,7,0,0,63
8,5,12,12,5,2,15,18,5,82
8,5,12,12,5,4,0,0,0,46
8,5,12,12,5,14,5,19,0,80
8,5,12,12,5,18,9,0,0,69
8,5,12,12,5,18,25,0,0,85
8,5,12,12,5,18,9,5,19,93
8,5,12,12,5,18,19,0,0,79
8,5,12,12,6,9,18,5,0,75
8,5,12,12,6,9,18,5,19,94
8,5,12,12,8,1,7,0,0,53
8,5,12,12,8,15,12,5,0,77
8,5,12,12,8,15,12,5,19,96
8,5,12,12,8,15,21,14,4,99
8,5,12,12,25,0,0,0,0,62
8,5,12,12,9,3,1,20,0,70
8,5,12,12,9,3,1,20,5,75
8,5,12,12,9,13,0,0,0,59
8,5,12,12,9,14,7,0,0,67
8,5,12,12,9,15,14,0,0,75
8,5,12,12,9,15,14,19,0,94
8,5,12,12,9,19,8,0,0,73
8,5,12,12,9,19,8,12,25,110
8,5,12,12,11,9,20,5,0,82
8,5,12,12,11,9,20,5,19,101
8,5,12,12,14,5,19,19,0,94
8,5,12,12,15,0,0,0,0,52
8,5,12,12,15,5,4,0,0,61
8,5,12,12,15,5,19,0,0,76
8,5,12,12,15,9,14,7,0,82
8,5,12,12,15,19,0,0,0,71
8,5,12,12,18,15,15,20,0,105
8,5,12,12,19,0,0,0,0,56
8,5,12,12,19,8,9,16,0,89
8,5,12,12,21,15,0,0,0,73
8,5,12,12,21,22,1,0,0,81
8,5,12,12,22,9,14,5,0,87
8,5,12,12,23,1,18,4,0,83
8,5,12,12,23,5,5,4,0,74
8,5,12,13,1,7,5,0,0,51
8,5,12,13,5,4,0,0,0,47
8,5,12,13,5,20,0,0,0,63
8,5,12,13,5,20,5,4,0,72
8,5,12,13,5,20,9,14,7,93
8,5,12,13,5,20,16,15,4,98
8,5,12,13,5,20,19,0,0,82
8,5,12,13,9,14,7,0,0,68
8,5,12,13,9,14,20,8,0,89
8,5,12,13,9,14,20,8,19,108
8,5,12,13,12,5,19,19,0,93
8,5,12,13,19,13,1,14,0,85
8,5,12,13,19,13,5,14,0,89
8,5,12,15,2,9,15,21,19,106
8,5,12,15,4,5,18,13,0,80
8,5,12,15,4,5,19,0,0,68
8,5,12,15,5,0,0,0,0,45
8,5,12,15,13,1,0,0,0,54
8,5,12,15,14,9,14,0,0,77
8,5,12,15,19,9,19,0,0,87
8,5,12,15,20,1,7,5,0,73
8,5,12,15,20,1,7,5,19,92
8,5,12,15,20,9,19,13,0,101
8,5,12,15,20,9,19,13,19,120
8,5,12,15,20,9,26,5,0,100
8,5,12,15,20,15,13,25,0,113
8,5,12,15,20,18,25,0,0,103
8,5,12,15,20,18,9,5,19,111
8,5,12,15,20,19,0,0,0,79
8,5,12,16,0,0,0,0,0,41
8,5,12,16,1,2,12,5,0,61
8,5,12,16,5,4,0,0,0,50
8,5,12,16,5,18,19,0,0,83
8,5,12,16,6,21,12,0,0,80
8,5,12,16,6,21,12,12,25,117
8,5,12,16,9,14,7,0,0,71
8,5,12,16,9,14,7,12,25,108
8,5,12,16,9,14,7,19,0,90
8,5,12,16,12,5,19,19,0,96
8,5,12,16,12,25,0,0,0,78
8,5,12,16,13,1,20,5,0,80
8,5,12,16,13,1,20,5,19,99
8,5,12,16,13,5,5,20,0,84
8,5,12,16,13,5,5,20,19,103
8,5,12,16,19,0,0,0,0,60
8,5,12,16,19,15,13,5,0,93
8,5,12,22,5,4,0,0,0,56
8,5,12,22,5,12,12,0,0,76
8,5,12,22,5,12,12,9,3,88
8,5,12,22,5,18,0,0,0,70
8,5,12,22,5,19,0,0,0,71
8,5,12,22,9,14,0,0,0,70
8,5,12,22,9,14,5,0,0,75
8,5,12,22,9,14,7,0,0,77
8,5,12,22,9,20,5,0,0,81
8,5,12,26,5,12,0,0,0,68
8,5,13,1,3,8,1,20,5,64
8,5,13,1,3,9,20,5,0,64
8,5,13,1,4,0,0,0,0,31
8,5,13,1,7,15,7,0,0,56
8,5,13,1,7,15,7,9,3,68
8,5,13,1,7,15,7,19,0,75
8,5,13,1,7,15,7,21,5,82
8,5,13,1,12,0,0,0,0,39
8,5,13,1,13,5,2,1,0,48
8,5,13,1,13,15,5,2,1,63
8,5,13,1,16,8,5,9,14,79
8,5,13,1,16,15,4,0,0,62
8,5,13,1,19,5,0,0,0,51
8,5,13,1,20,1,12,0,0,60
8,5,13,1,20,5,9,14,0,75
8,5,13,1,20,5,9,14,19,94
8,5,13,1,20,8,5,18,13,91
8,5,13,1,20,9,3,0,0,59
8,5,13,1,20,9,3,19,0,78
8,5,13,1,20,9,4,0,0,60
8,5,13,1,20,9,14,0,0,70
8,5,13,1,20,9,14,5,0,75
8,5,13,1,20,9,14,5,19,94
8,5,13,1,20,9,14,9,3,82
8,5,13,1,20,9,14,19,0,89
8,5,13,1,20,9,20,5,0,81
8,5,13,1,20,9,20,5,19,100
8,5,13,1,20,9,20,9,3,88
8,5,13,1,20,15,2,9,3,76
8,5,13,1,20,15,7,5,14,88
8,5,13,1,20,15,9,4,0,75
8,5,13,1,20,15,9,4,19,94
8,5,13,1,20,15,12,9,14,97
8,5,13,1,20,15,13,1,0,76
8,5,13,1,20,15,13,1,19,95
8,5,13,1,20,15,14,9,3,88
8,5,13,1,20,15,19,5,0,86
8,5,13,1,20,15,19,9,14,104
8,5,13,1,20,15,19,9,19,109
8,5,13,1,20,15,24,9,3,98
8,5,13,1,20,15,26,15,1,104
8,5,13,1,20,21,18,9,1,96
8,5,13,1,20,21,18,9,3,98
8,5,13,5,0,0,0,0,0,31
8,5,13,5,12,25,20,18,1,107
8,5,13,5,14,0,0,0,0,45
8,5,13,5,19,0,0,0,0,50
8,5,13,9,1,0,0,0,0,36
8,5,13,9,1,12,7,9,1,65
8,5,13,9,1,13,2,0,0,51
8,5,13,9,1,20,1,24,25,106
8,5,13,9,1,21,24,9,14,104
8,5,13,9,3,0,0,0,0,38
8,5,13,9,3,1,18,16,0,73
8,5,13,9,3,25,3,12,5,83
8,5,13,9,3,18,1,14,5,76
8,5,13,9,3,18,1,14,25,96
8,5,13,9,4,15,13,5,0,72
8,5,13,9,5,11,20,15,14,100
8,5,13,9,5,16,5,19,0,80
8,5,13,9,6,15,18,13,0,87
8,5,13,9,7,12,25,16,8,103
8,5,13,9,8,4,18,25,0,90
8,5,13,9,13,5,12,21,19,105
8,5,13,9,13,15,18,16,8,105
8,5,13,9,14,0,0,0,0,49
8,5,13,9,14,1,0,0,0,50
8,5,13,9,14,5,0,0,0,54
8,5,13,9,14,5,5,0,0,59
8,5,13,9,14,19,0,0,0,68
8,5,13,9,15,2,15,12,0,79
8,5,13,9,15,12,1,0,0,63
8,5,13,9,15,12,1,19,0,82
8,5,13,9,15,12,9,1,0,72
8,5,13,9,15,12,9,3,0,74
8,5,13,9,15,14,21,19,0,104
8,5,13,9,15,16,5,0,0,71
8,5,13,9,15,16,9,1,0,76
8,5,13,9,15,16,9,3,0,78
8,5,13,9,15,16,19,9,1,95
8,5,13,9,16,5,14,9,19,98
8,5,13,9,16,9,3,0,0,63
8,5,13,9,16,12,1,14,5,83
8,5,13,9,16,12,5,7,25,100
8,5,13,9,16,15,4,0,0,70
8,5,13,9,16,15,4,1,14,85
8,5,13,9,16,15,4,5,0,75
8,5,13,9,16,16,5,0,0,72
8,5,13,9,16,18,9,19,13,110
8,5,13,9,16,20,5,18,0,94
8,5,13,9,16,20,5,18,19,113
8,5,13,9,18,1,13,16,8,91
8,5,13,9,19,5,3,20,0,82
8,5,13,9,19,16,1,19,13,103
8,5,13,9,19,20,9,3,8,94
8,5,13,9,20,5,18,25,0,103
8,5,13,9,20,5,18,9,1,88
8,5,13,9,20,25,16,5,0,101
8,5,13,9,20,25,16,9,3,108
8,5,13,9,20,15,14,5,0,89
8,5,13,9,20,18,15,16,5,109
8,5,13,9,20,18,15,16,25,129
8,5,13,12,0,0,0,0,0,38
8,5,13,12,9,14,5,0,0,66
8,5,13,12,9,14,5,19,0,85
8,5,13,12,15,3,11,0,0,67
8,5,13,12,15,3,11,19,0,86
8,5,13,13,5,4,0,0,0,48
8,5,13,13,5,12,0,0,0,56
8,5,13,13,5,18,0,0,0,62
8,5,13,13,5,18,19,0,0,81
8,5,13,13,9,14,7,0,0,69
8,5,13,15,2,12,1,19,20,95
8,5,13,15,3,25,20,5,0,94
8,5,13,15,3,25,20,5,19,113
8,5,13,15,3,15,5,12,0,76
8,5,13,15,3,15,5,12,5,81
8,5,13,15,3,15,5,12,19,95
8,5,13,15,3,15,14,9,1,83
8,5,13,15,3,18,25,0,0,87
8,5,13,15,4,9,1,0,0,55
8,5,13,15,7,5,14,9,1,77
8,5,13,15,7,5,14,9,3,79
8,5,13,15,7,18,1,13,0,80
8,5,13,15,9,4,0,0,0,54
8,5,13,15,11,15,14,9,1,91
8,5,13,15,12,0,0,0,0,53
8,5,13,15,12,25,13,16,8,115
8,5,13,15,12,25,19,9,14,120
8,5,13,15,12,25,19,9,19,125
8,5,13,15,12,25,20,9,3,110
8,5,13,15,12,25,26,5,0,109
8,5,13,15,12,25,26,5,4,113
8,5,13,15,12,25,26,5,19,128
8,5,13,15,12,15,7,25,0,100
8,5,13,15,13,5,20,5,18,102
8,5,13,15,13,5,20,18,25,122
8,5,13,15,16,1,20,8,25,111
8,5,13,15,16,5,24,9,19,114
8,5,13,15,16,8,1,7,5,78
8,5,13,15,16,8,1,7,25,98
8,5,13,15,16,8,9,12,5,91
8,5,13,15,16,15,4,0,0,76
8,5,13,15,16,20,15,5,0,97
8,5,13,15,18,18,8,5,1,91
8,5,13,15,19,3,15,16,5,99
8,5,13,15,19,3,15,16,25,119
8,5,13,15,19,20,1,20,0,101
8,5,13,15,19,20,1,20,19,120
8,5,13,15,20,15,24,9,3,112
8,5,13,15,20,15,24,9,14,123
8,5,13,15,26,15,15,14,0,111
8,5,13,16,2,21,19,8,0,92
8,5,13,16,5,14,0,0,0,61
8,5,13,16,8,5,18,4,19,96
8,5,13,16,25,0,0,0,0,67
8,5,13,16,9,5,0,0,0,56
8,5,13,16,9,5,18,0,0,74
8,5,13,16,9,5,19,20,0,95
8,5,13,16,12,9,11,5,0,79
8,5,13,16,19,0,0,0,0,61
8,5,13,16,19,5,5,4,0,75
8,5,13,16,19,5,5,4,19,94
8,5,13,16,23,5,5,4,0,79
8,5,13,16,23,5,5,4,19,98
8,5,13,16,23,15,18,20,0,118
8,5,13,19,5,12,6,0,0,68
8,5,13,19,20,9,20,3,8,105
8,5,13,21,12,5,0,0,0,64
8,5,14,1,4,0,0,0,0,32
8,5,14,2,1,14,5,0,0,49
8,5,14,2,1,14,5,19,0,68
8,5,14,2,9,12,12,0,0,62
8,5,14,2,9,20,0,0,0,58
8,5,14,2,9,20,19,0,0,77
8,5,14,3,5,0,0,0,0,35
8,5,14,3,8,2,15,25,0,80
8,5,14,3,8,13,1,14,0,66
8,5,14,3,8,13,5,14,0,70
8,5,14,3,15,15,16,0,0,76
8,5,14,3,15,15,16,19,0,95
8,5,14,3,15,20,5,0,0,70
8,5,14,4,0,0,0,0,0,31
8,5,14,4,5,3,1,14,5,59
8,5,14,4,5,3,25,12,0,76
8,5,14,4,5,3,15,9,3,66
8,5,14,4,5,4,18,1,0,59
8,5,14,4,25,0,0,0,0,56
8,5,14,4,9,1,4,25,19,89
8,5,14,4,12,25,0,0,0,68
8,5,14,4,14,5,19,19,0,88
8,5,14,5,14,0,0,0,0,46
8,5,14,5,17,21,5,14,0,89
8,5,14,5,17,21,5,14,19,108
8,5,14,5,17,21,9,14,0,93
8,5,14,5,17,21,9,14,19,112
8,5,14,6,9,19,8,0,0,69
8,5,14,7,5,0,0,0,0,39
8,5,14,8,1,23,11,0,0,70
8,5,14,8,15,21,19,5,0,95
8,5,14,8,15,21,19,5,19,114
8,5,14,8,21,19,19,25,0,119
8,5,14,25,1,18,4,0,0,75
8,5,14,9,17,21,5,14,0,93
8,5,14,9,17,21,5,14,19,112
8,5,14,9,19,13,0,0,0,68
8,5,14,12,9,11,5,0,0,64
8,5,14,13,15,12,4,25,0,96
8,5,14,14,1,0,0,0,0,42
8,5,14,14,1,5,4,0,0,51
8,5,14,14,1,9,14,7,0,72
8,5,14,14,1,19,0,0,0,61
8,5,14,14,5,18,25,0,0,89
8,5,14,14,5,18,9,5,19,97
8,5,14,14,5,19,0,0,0,65
8,5,14,14,25,0,0,0,0,66
8,5,14,14,9,14,0,0,0,64
8,5,14,14,9,19,8,0,0,77
8,5,14,15,7,5,14,25,0,93
8,5,14,15,20,9,3,0,0,74
8,5,14,16,5,3,11,0,0,62
8,5,14,16,5,3,11,5,4,71
8,5,14,16,5,3,11,19,0,81
8,5,14,16,5,14,0,0,0,62
8,5,14,18,9,5,19,0,0,78
8,5,14,18,25,19,0,0,0,89
8,5,14,18,15,15,19,20,0,114
8,5,14,19,0,0,0,0,0,46
8,5,14,20,0,0,0,0,0,47
8,5,14,20,5,4,0,0,0,56
8,5,14,20,5,18,0,0,0,70
8,5,14,20,9,14,7,0,0,77
8,5,14,20,19,0,0,0,0,66
8,5,14,23,1,18,5,0,0,74
8,5,14,23,9,6,5,0,0,70
8,5,14,23,9,12,5,0,0,76
8,5,14,23,9,19,5,0,0,83
8,5,16,1,18,0,0,0,0,48
8,5,16,1,18,9,14,0,0,71
8,5,16,1,18,9,14,19,0,90
8,5,16,1,20,1,21,24,5,101
8,5,16,1,20,9,3,0,0,62
8,5,16,1,20,9,3,1,12,75
8,5,16,1,20,9,3,1,19,82
8,5,16,1,20,9,3,19,0,81
8,5,16,1,20,9,19,5,0,83
8,5,16,1,20,9,19,5,4,87
8,5,16,1,20,9,20,5,0,84
8,5,16,1,20,9,20,9,19,107
8,5,16,1,20,9,26,5,0,90
8,5,16,1,20,9,26,5,4,94
8,5,16,1,20,9,26,5,19,109
8,5,16,1,20,15,9,4,0,78
8,5,16,1,20,15,13,1,0,79
8,5,16,1,20,15,13,1,19,98
8,5,16,3,1,20,0,0,0,53
8,5,16,3,1,20,19,0,0,72
8,5,16,9,1,12,9,4,0,64
8,5,16,16,5,14,0,0,0,64
8,5,16,16,5,18,0,0,0,68
8,5,16,20,1,3,5,0,0,58
8,5,16,20,1,4,0,0,0,54
8,5,16,20,1,4,9,3,0,66
8,5,16,20,1,4,19,0,0,73
8,5,16,20,1,7,12,15,20,104
8,5,16,20,1,7,15,14,0,86
8,5,16,20,1,7,15,14,19,105
8,5,16,20,1,7,18,9,4,88
8,5,16,20,1,12,0,0,0,62
8,5,16,20,1,14,5,0,0,69
8,5,16,20,1,14,5,19,0,88
8,5,16,20,1,14,15,9,3,91
8,5,16,20,1,14,15,14,5,98
8,5,16,20,1,16,15,4,25,110
8,5,16,20,1,18,3,8,0,79
8,5,16,20,1,18,3,8,25,104
8,5,16,20,1,18,3,8,19,98
8,5,16,20,5,14,5,0,0,73
8,5,16,20,5,18,9,19,0,100
8,5,16,20,25,12,0,0,0,86
8,5,16,20,25,12,5,14,5,110
8,5,16,20,25,12,9,3,0,98
8,5,16,20,9,14,5,0,0,77
8,5,16,20,25,14,5,0,0,93
8,5,16,20,9,20,5,0,0,83
8,5,16,20,9,20,15,12,0,105
8,5,16,20,15,4,5,0,0,73
8,5,16,20,15,9,3,0,0,76
8,5,16,20,15,18,9,20,5,116
8,5,16,20,15,19,5,0,0,88
8,5,16,20,15,19,5,19,0,107
8,5,16,20,15,24,9,4,5,106
8,5,18,0,0,0,0,0,0,31
8,5,18,1,3,12,5,9,4,65
8,5,18,1,12,4,5,4,0,57
8,5,18,1,12,4,5,19,19,91
8,5,18,1,12,4,9,3,0,60
8,5,18,1,12,4,9,14,7,78
8,5,18,1,12,4,9,19,20,96
8,5,18,1,12,4,9,26,5,88
8,5,18,1,12,4,18,25,0,91
8,5,18,1,12,4,19,0,0,67
8,5,18,1,21,4,0,0,0,57
8,5,18,1,21,19,0,0,0,72
8,5,18,2,1,0,0,0,0,34
8,5,18,2,1,7,5,0,0,46
8,5,18,2,1,7,5,4,0,50
8,5,18,2,1,7,5,18,0,64
8,5,18,2,1,7,5,19,0,65
8,5,18,2,1,12,0,0,0,46
8,5,18,2,1,12,9,19,13,87
8,5,18,2,1,12,9,19,20,94
8,5,18,2,1,12,9,26,5,86
8,5,18,2,1,12,19,0,0,65
8,5,18,2,1,14,5,0,0,53
8,5,18,2,1,18,0,0,0,52
8,5,18,2,1,18,25,0,0,77
8,5,18,2,1,18,9,1,0,62
8,5,18,2,1,18,9,1,12,74
8,5,18,2,1,18,9,1,14,76
8,5,18,2,1,18,9,9,1,71
8,5,18,2,1,18,9,19,13,93
8,5,18,2,1,18,9,19,20,100
8,5,18,2,1,18,9,21,13,95
8,5,18,2,1,18,9,26,5,92
8,5,18,2,2,1,14,5,0,55
8,5,18,2,5,4,0,0,0,42
8,5,18,2,5,18,0,0,0,56
8,5,18,2,5,18,7,5,18,86
8,5,18,2,9,3,9,4,5,63
8,5,18,2,9,4,0,0,0,46
8,5,18,2,9,5,18,0,0,65
8,5,18,2,9,5,19,20,0,86
8,5,18,2,9,19,8,0,0,69
8,5,18,2,9,19,20,0,0,81
8,5,18,2,9,22,15,18,5,102
8,5,18,2,12,5,19,19,0,88
8,5,18,2,12,5,20,0,0,70
8,5,18,2,12,9,11,5,0,70
8,5,18,2,13,1,14,0,0,61
8,5,18,2,15,18,9,19,20,114
8,5,18,2,15,18,9,26,5,106
8,5,18,2,15,19,5,0,0,72
8,5,18,2,15,19,9,20,25,121
8,5,18,2,15,21,19,0,0,88
8,5,18,2,18,15,21,7,8,102
8,5,18,2,19,0,0,0,0,52
8,5,18,2,23,9,6,5,0,76
8,5,18,2,23,15,13,1,14,99
8,5,18,3,25,14,9,20,5,107
8,5,18,3,15,7,1,13,25,95
8,5,18,4,0,0,0,0,0,35
8,5,18,4,2,15,25,0,0,77
8,5,18,4,2,15,15,11,0,78
8,5,18,4,5,4,0,0,0,44
8,5,18,4,5,18,9,20,5,92
8,5,18,4,5,18,19,0,0,77
8,5,18,4,5,19,19,0,0,78
8,5,18,4,9,3,0,0,0,47
8,5,18,4,9,3,19,0,0,66
8,5,18,4,9,14,7,0,0,65
8,5,18,4,12,9,11,5,0,72
8,5,18,4,13,1,14,0,0,63
8,5,18,4,13,5,14,0,0,67
8,5,18,4,19,0,0,0,0,54
8,5,18,4,19,8,9,16,0,87
8,5,18,4,19,13,1,14,0,82
8,5,18,4,19,13,5,14,0,86
8,5,18,5,1,2,15,21,20,95
8,5,18,5,1,4,1,25,19,86
8,5,18,5,1,6,20,5,18,86
8,5,18,5,1,7,1,9,14,68
8,5,18,5,1,13,15,14,7,86
8,5,18,5,1,14,5,14,20,90
8,5,18,5,1,20,0,0,0,57
8,5,18,5,1,23,1,25,0,86
8,5,18,5,1,23,1,25,19,105
8,5,18,5,2,25,0,0,0,63
8,5,18,5,4,5,19,0,0,64
8,5,18,5,4,9,20,1,12,82
8,5,18,5,4,9,20,1,19,89
8,5,18,5,4,9,20,25,0,94
8,5,18,5,4,9,21,13,0,83
8,5,18,5,6,15,18,4,19,98
8,5,18,5,6,15,18,5,0,80
8,5,18,5,6,18,15,13,0,88
8,5,18,5,7,5,12,4,0,64
8,5,18,5,7,9,12,4,0,68
8,5,18,5,8,5,14,3,5,71
8,5,18,5,9,14,0,0,0,59
8,5,18,5,9,14,20,15,0,94
8,5,18,5,13,0,0,0,0,49
8,5,18,5,13,5,9,20,0,83
8,5,18,5,14,1,3,8,0,62
8,5,18,5,14,5,19,19,0,93
8,5,18,5,15,6,0,0,0,57
8,5,18,5,15,14,0,0,0,65
8,5,18,5,15,21,20,0,0,92
8,5,18,5,18,9,7,8,20,98
8,5,18,5,19,0,0,0,0,55
8,5,18,5,19,25,0,0,0,80
8,5,18,5,19,9,5,19,0,88
8,5,18,5,20,9,3,0,0,68
8,5,18,5,20,9,3,1,12,81
8,5,18,5,20,9,3,19,0,87
8,5,18,5,20,15,0,0,0,71
8,5,18,5,20,15,3,8,0,82
8,5,18,5,20,15,7,1,0,79
8,5,18,5,20,18,9,24,0,107
8,5,18,5,21,14,4,5,18,98
8,5,18,5,21,14,20,15,0,106
8,5,18,5,21,16,15,14,0,102
8,5,18,5,21,16,20,15,0,108
8,5,18,5,23,9,20,8,0,96
8,5,18,5,26,5,12,4,0,83
8,5,18,25,0,0,0,0,0,56
8,5,18,9,7,1,21,20,0,89
8,5,18,9,12,5,0,0,0,57
8,5,18,9,15,20,0,0,0,75
8,5,18,9,15,20,19,0,0,94
8,5,18,9,19,19,15,14,0,107
8,5,18,9,20,1,2,12,5,80
8,5,18,9,20,1,2,12,25,100
8,5,18,9,20,1,7,5,0,73
8,5,18,9,20,1,7,5,19,92
8,5,18,9,20,1,14,3,5,83
8,5,18,9,20,15,18,0,0,93
8,5,18,9,20,15,18,19,0,112
8,5,18,9,20,18,5,19,19,121
8,5,18,9,20,18,9,24,0,111
8,5,18,12,0,0,0,0,0,43
8,5,18,12,9,14,7,0,0,73
8,5,18,12,19,0,0,0,0,62
8,5,18,13,1,5,0,0,0,50
8,5,18,13,1,5,1,14,0,65
8,5,18,13,1,9,0,0,0,54
8,5,18,13,1,9,3,0,0,57
8,5,18,13,1,14,4,1,4,68
8,5,18,13,5,12,5,0,0,66
8,5,18,13,5,14,5,21,20,109
8,5,18,13,9,0,0,0,0,53
8,5,18,13,9,4,9,14,0,80
8,5,18,13,9,20,1,18,25,117
8,5,18,13,9,20,5,19,19,116
8,5,18,13,9,20,9,1,14,97
8,5,18,13,9,20,9,3,0,85
8,5,18,13,9,20,9,19,8,109
8,5,18,13,9,20,9,19,13,114
8,5,18,13,9,20,9,26,5,113
8,5,18,13,9,20,18,25,0,116
8,5,18,13,9,20,19,0,0,92
8,5,18,13,15,4,1,3,20,87
8,5,18,13,19,0,0,0,0,63
8,5,18,14,0,0,0,0,0,45
8,5,18,14,1,14,9,0,0,69
8,5,18,14,1,14,20,0,0,80
8,5,18,14,9,1,0,0,0,55
8,5,18,14,9,1,5,0,0,60
8,5,18,14,9,1,12,0,0,67
8,5,18,14,9,1,18,25,0,98
8,5,18,14,9,1,18,9,14,96
8,5,18,14,9,1,19,0,0,74
8,5,18,14,9,1,20,5,0,80
8,5,18,14,9,1,20,5,4,84
8,5,18,14,9,1,20,5,19,99
8,5,18,14,9,15,9,4,0,82
8,5,18,14,19,0,0,0,0,64
8,5,18,14,19,5,23,0,0,92
8,5,18,15,1,18,3,8,25,101
8,5,18,15,5,19,0,0,0,70
8,5,18,15,5,19,19,0,0,89
8,5,18,15,8,5,1,4,0,64
8,5,18,15,8,15,15,4,0,88
8,5,18,15,9,3,0,0,0,58
8,5,18,15,9,3,1,12,0,71
8,5,18,15,9,3,9,20,25,112
8,5,18,15,9,3,12,25,0,95
8,5,18,15,9,3,19,0,0,77
8,5,18,15,9,4,0,0,0,59
8,5,18,15,9,6,25,0,0,86
8,5,18,15,9,14,5,0,0,74
8,5,18,15,9,14,5,19,0,93
8,5,18,15,9,14,9,19,13,110
8,5,18,15,9,14,9,26,5,109
8,5,18,15,9,14,19,0,0,88
8,5,18,15,9,19,13,0,0,87
8,5,18,15,9,19,13,19,0,106
8,5,18,15,9,19,20,9,3,106
8,5,18,15,9,26,5,0,0,86
8,5,18,15,9,26,5,4,0,90
8,5,18,15,9,26,5,19,0,105
8,5,18,15,9,26,9,14,7,111
8,5,18,15,12,1,0,0,0,59
8,5,18,15,12,9,11,5,0,83
8,5,18,15,14,2,9,12,12,95
8,5,18,15,14,5,18,0,0,83
8,5,18,15,14,9,20,5,0,94
8,5,18,15,14,18,25,0,0,103
8,5,18,15,14,18,9,5,19,111
8,5,18,15,14,19,0,0,0,79
8,5,18,15,14,19,5,23,0,107
8,5,18,15,15,7,15,14,25,122
8,5,18,15,15,12,15,7,25,120
8,5,18,15,19,8,9,16,0,98
8,5,18,16,0,0,0,0,0,47
8,5,18,16,5,19,0,0,0,71
8,5,18,16,5,19,5,19,0,95
8,5,18,16,5,20,0,0,0,72
8,5,18,16,5,20,9,3,0,84
8,5,18,16,5,20,9,19,13,113
8,5,18,16,5,20,15,9,4,100
8,5,18,17,21,5,9,14,0,97
8,5,18,18,25,0,0,0,0,74
8,5,18,18,9,5,4,0,0,67
8,5,18,18,25,9,14,7,0,104
8,5,18,18,25,13,5,14,20,126
8,5,18,18,9,14,7,5,18,102
8,5,18,19,0,0,0,0,0,50
8,5,18,19,1,12,12,0,0,75
8,5,18,19,5,4,0,0,0,59
8,5,18,19,5,12,6,0,0,73
8,5,18,19,8,9,16,0,0,83
8,5,18,19,9,18,0,0,0,77
8,5,18,20,0,0,0,0,0,51
8,5,18,20,26,5,19,0,0,101
8,5,19,0,0,0,0,0,0,32
8,5,19,9,20,1,14,3,5,84
8,5,19,9,20,1,14,3,25,104
8,5,19,9,20,1,14,20,0,96
8,5,19,9,20,1,20,5,0,87
8,5,19,9,20,1,20,5,4,91
8,5,19,9,20,1,20,5,18,105
8,5,19,9,20,1,20,5,19,106
8,5,19,9,20,1,20,15,18,115
8,5,19,16,5,4,0,0,0,57
8,5,19,16,5,12,0,0,0,65
8,5,19,16,5,18,9,9,4,93
8,5,19,19,9,1,14,19,0,94
8,5,19,19,9,20,5,0,0,85
8,5,19,19,9,20,5,19,0,104
8,5,19,19,15,14,9,20,5,114
8,5,19,20,0,0,0,0,0,52
8,5,19,20,5,18,14,0,0,89
8,5,19,20,5,18,14,1,12,102
8,5,19,20,19,0,0,0,0,71
8,5,20,0,0,0,0,0,0,33
8,5,20,1,5,18,1,0,0,58
8,5,20,1,5,18,1,5,0,63
8,5,20,1,5,18,1,19,0,77
8,5,20,1,5,18,25,0,0,82
8,5,20,1,5,18,9,1,0,67
8,5,20,1,5,18,9,3,0,69
8,5,20,1,5,18,9,15,0,81
8,5,20,1,5,18,9,19,13,98
8,5,20,1,9,18,1,0,0,62
8,5,20,1,9,18,1,9,0,71
8,5,20,1,9,18,1,19,0,81
8,5,20,1,9,18,25,0,0,86
8,5,20,1,9,18,9,1,0,71
8,5,20,1,9,18,9,3,0,73
8,5,20,1,9,18,9,19,13,102
8,5,20,1,9,18,9,19,20,109
8,5,20,3,8,5,12,0,0,61
8,5,20,5,0,0,0,0,0,38
8,5,20,5,18,1,11,9,4,81
8,5,20,5,18,9,3,0,0,68
8,5,20,5,18,9,19,13,0,97
8,5,20,5,18,9,26,5,0,96
8,5,20,5,18,15,0,0,0,71
8,5,20,5,18,15,4,15,24,114
8,5,20,5,18,15,5,3,25,104
8,5,20,5,18,15,5,16,25,117
8,5,20,5,18,15,7,5,14,97
8,5,20,5,18,15,14,25,13,123
8,5,20,5,18,15,16,15,4,106
8,5,20,5,18,15,19,0,0,90
8,5,20,5,18,15,19,5,19,114
8,5,20,5,18,15,19,5,24,119
8,5,20,5,18,15,19,9,19,118
8,5,20,5,18,15,20,9,3,103
8,5,20,8,5,14,0,0,0,60
8,5,20,8,9,14,7,0,0,71
8,5,20,8,19,0,0,0,0,60
8,5,20,13,1,14,1,20,5,87
8,5,20,13,1,14,19,0,0,80
8,5,20,19,0,0,0,0,0,52
8,5,20,20,5,18,0,0,0,76
8,5,20,20,5,18,12,25,0,113
8,5,21,1,21,0,0,0,0,56
8,5,21,3,8,0,0,0,0,45
8,5,21,3,8,19,0,0,0,64
8,5,21,7,8,0,0,0,0,49
8,5,21,7,8,19,0,0,0,68
8,5,21,11,0,0,0,0,0,45
8,5,21,13,9,20,5,0,0,81
8,5,21,18,5,11,1,0,0,69
8,5,21,18,5,20,9,3,0,89
8,5,21,18,9,19,20,9,3,112
8,5,21,22,5,12,0,0,0,73
8,5,22,5,4,0,0,0,0,44
8,5,22,9,0,0,0,0,0,44
8,5,23,1,2,12,5,0,0,56
8,5,23,5,4,0,0,0,0,45
8,5,23,5,12,0,0,0,0,53
8,5,23,5,18,0,0,0,0,59
8,5,23,5,18,19,0,0,0,78
8,5,23,5,20,20,9,20,5,115
8,5,23,7,1,7,0,0,0,51
8,5,23,7,8,0,0,0,0,51
8,5,23,8,1,12,12,0,0,69
8,5,23,8,15,12,5,0,0,76
8,5,23,9,14,7,0,0,0,66
8,5,23,14,0,0,0,0,0,50
8,5,23,19,0,0,0,0,0,55
8,5,23,20,0,0,0,0,0,56
8,5,24,0,0,0,0,0,0,37
8,5,24,1,0,0,0,0,0,38
8,5,24,1,2,1,19,9,3,72
8,5,24,1,2,9,15,19,5,88
8,5,24,1,3,1,14,20,8,84
8,5,24,1,3,5,0,0,0,46
8,5,24,1,3,8,15,18,4,86
8,5,24,1,3,9,4,0,0,54
8,5,24,1,3,15,12,9,3,80
8,5,24,1,3,20,0,0,0,61
8,5,24,1,3,20,9,14,5,89
8,5,24,1,4,0,0,0,0,42
8,5,24,1,4,4,0,0,0,46
8,5,24,1,4,5,0,0,0,47
8,5,24,1,4,5,3,25,12,87
8,5,24,1,4,5,19,0,0,66
8,5,24,1,4,9,3,0,0,54
8,5,24,1,4,9,5,14,5,75
8,5,24,1,4,9,9,14,5,79
8,5,24,1,4,9,25,14,5,95
8,5,24,1,4,19,0,0,0,61
8,5,24,1,6,15,9,12,0,80
8,5,24,1,7,25,14,0,0,84
8,5,24,1,7,12,15,20,0,92
8,5,24,1,7,15,14,0,0,74
8,5,24,1,7,15,14,1,12,87
8,5,24,1,7,15,14,19,0,93
8,5,24,1,7,18,1,13,0,77
8,5,24,1,7,18,1,13,19,96
8,5,24,1,8,5,4,18,1,74
8,5,24,1,13,5,18,0,0,74
8,5,24,1,13,5,18,1,12,87
8,5,24,1,13,5,18,9,3,86
8,5,24,1,13,5,18,15,14,103
8,5,24,1,13,5,20,5,18,99
8,5,24,1,13,9,14,5,0,79
8,5,24,1,13,9,14,5,19,98
8,5,24,1,13,13,9,14,0,87
8,5,24,1,13,13,9,14,5,92
8,5,24,1,13,13,9,14,15,102
8,5,24,1,14,1,12,0,0,65
8,5,24,1,14,4,18,25,0,99
8,5,24,1,14,4,18,9,3,86
8,5,24,1,14,5,0,0,0,57
8,5,24,1,14,5,19,0,0,76
8,5,24,1,14,7,12,5,0,76
8,5,24,1,16,5,4,0,0,63
8,5,24,1,16,12,1,0,0,67
8,5,24,1,16,12,1,18,0,85
8,5,24,1,16,12,1,19,0,86
8,5,24,1,16,12,15,9,4,94
8,5,24,1,16,15,4,0,0,73
8,5,24,1,16,15,4,1,12,86
8,5,24,1,16,15,4,1,14,88
8,5,24,1,16,15,4,25,0,98
8,5,24,1,16,15,4,9,3,85
8,5,24,1,16,15,4,19,0,92
8,5,24,1,18,3,8,0,0,67
8,5,24,1,18,3,8,25,0,92
8,5,24,1,19,3,8,1,0,69
8,5,24,1,19,5,13,5,0,80
8,5,24,1,19,5,13,9,3,87
8,5,24,1,19,20,5,18,0,100
8,5,24,1,19,20,9,3,8,97
8,5,24,1,19,20,9,7,13,106
8,5,24,1,19,20,25,12,5,119
8,5,24,1,20,8,12,15,14,107
8,5,24,1,20,15,13,9,3,98
8,5,24,1,24,15,14,0,0,91
8,5,24,4,18,1,0,0,0,60
8,5,24,5,4,0,0,0,0,46
8,5,24,5,14,5,0,0,0,61
8,5,24,5,18,0,0,0,0,60
8,5,24,5,18,5,9,0,0,74
8,5,24,5,18,5,9,19,0,93
8,5,24,5,18,9,19,0,0,88
8,5,24,5,18,19,0,0,0,79
8,5,24,5,19,0,0,0,0,61
8,5,24,5,19,20,18,15,12,126
8,5,24,25,12,0,0,0,0,74
8,5,24,25,12,5,14,5,0,98
8,5,24,25,12,9,3,0,0,86
8,5,24,25,12,19,0,0,0,93
8,5,24,9,14,5,0,0,0,65
8,5,24,25,14,5,0,0,0,81
8,5,24,9,14,7,0,0,0,67
8,5,24,9,15,12,15,7,25,120
8,5,24,9,19,0,0,0,0,65
8,5,24,9,20,15,12,0,0,93
8,5,24,15,2,9,15,19,5,102
8,5,24,15,4,5,0,0,0,61
8,5,24,15,7,5,14,0,0,78
8,5,24,15,9,3,0,0,0,64
8,5,24,15,25,12,5,14,5,113
8,5,24,15,14,5,0,0,0,71
8,5,24,15,14,5,19,0,0,90
8,5,24,15,14,9,3,0,0,78
8,5,24,15,19,1,14,0,0,86
8,5,24,15,19,1,14,19,0,105
8,5,24,15,19,5,0,0,0,76
8,5,24,15,19,5,19,0,0,95
8,5,24,19,0,0,0,0,0,56
8,5,24,19,21,2,0,0,0,79
8,7,18,14,15,20,9,14,5,110
8,7,20,0,0,0,0,0,0,35
8,7,23,25,0,0,0,0,0,63
8,9,2,1,3,8,9,0,0,40
8,9,2,1,3,8,9,19,0,59
8,9,2,2,9,14,0,0,0,44
8,9,2,5,18,14,1,12,0,69
8,9,2,5,18,14,1,20,5,82
8,9,2,12,1,0,0,0,0,32
8,25,2,15,4,15,14,20,0,103
8,25,2,15,19,9,19,0,0,97
8,25,2,18,9,4,0,0,0,66
8,25,2,18,9,4,1,0,0,67
8,25,2,18,9,4,1,5,0,72
8,25,2,18,9,4,1,12,0,79
8,25,2,18,9,4,9,19,5,99
8,25,2,18,9,4,9,19,13,107
8,25,2,18,9,4,9,19,20,114
8,25,2,18,9,4,9,20,25,120
8,25,2,18,9,4,9,26,5,106
8,25,2,18,9,4,15,21,19,121
8,25,2,18,9,4,19,0,0,85
8,25,2,18,9,19,0,0,0,81
8,25,2,18,9,19,5,19,0,105
8,25,2,18,9,19,20,9,3,113
8,9,3,1,3,15,0,0,0,39
8,9,3,1,20,5,5,0,0,51
8,9,3,3,15,21,7,8,0,74
8,9,3,3,15,21,7,8,19,93
8,9,3,3,21,16,0,0,0,60
8,9,3,3,21,16,5,4,0,69
8,9,3,3,21,16,9,14,7,90
8,9,3,3,21,16,16,5,4,85
8,9,3,3,21,16,19,0,0,79
8,9,3,8,20,0,0,0,0,48
8,9,3,8,21,0,0,0,0,49
8,9,3,11,0,0,0,0,0,31
8,9,3,11,5,25,5,19,0,85
8,9,3,11,5,25,19,0,0,80
8,9,3,11,5,20,0,0,0,56
8,9,3,11,25,0,0,0,0,56
8,9,3,11,9,5,19,0,0,64
8,9,3,11,9,6,9,5,4,64
8,9,3,11,9,19,8,0,0,67
8,9,3,11,15,18,9,5,19,97
8,9,3,11,23,1,25,0,0,80
8,9,3,11,23,1,12,12,0,79
8,9,4,0,0,0,0,0,0,21
8,25,4,0,0,0,0,0,0,37
8,9,4,1,2,12,5,0,0,41
8,9,4,1,7,5,0,0,0,34
8,25,4,1,7,5,0,0,0,50
8,9,4,1,12,7,9,19,13,82
8,9,4,1,12,7,15,19,0,75
8,25,4,1,14,20,15,9,3,99
8,25,4,1,14,20,15,9,14,110
8,9,4,1,20,5,4,0,0,51
8,25,4,1,20,8,15,4,5,90
8,25,4,1,20,9,3,0,0,70
8,25,4,1,20,9,4,0,0,71
8,25,4,1,20,9,4,19,0,90
8,9,4,1,20,9,15,14,0,80
8,25,4,1,20,15,9,4,0,86
8,9,4,4,5,12,19,0,0,61
8,9,4,4,5,14,0,0,0,44
8,9,4,4,5,14,12,25,0,81
8,9,4,5,0,0,0,0,0,26
8,9,4,5,1,23,1,25,0,76
8,9,4,5,1,23,1,25,19,95
8,9,4,5,2,9,14,4,0,55
8,9,4,5,2,15,21,14,4,82
8,9,4,5,4,0,0,0,0,30
8,9,4,5,7,5,12,4,0,54
8,9,4,5,12,0,0,0,0,38
8,9,4,5,12,1,14,4,0,57
8,9,4,5,12,5,19,19,0,81
8,9,4,5,12,9,14,7,0,68
8,9,4,5,15,19,9,20,25,114
8,9,4,5,15,21,19,0,0,81
8,9,4,5,15,21,19,12,25,118
8,9,4,5,15,21,20,0,0,82
8,9,4,5,15,21,20,19,0,101
8,9,4,5,18,0,0,0,0,44
8,9,4,5,18,19,0,0,0,63
8,9,4,5,19,0,0,0,0,45
8,9,4,9,14,7,0,0,0,51
8,9,4,9,14,7,19,0,0,70
8,9,4,12,9,14,7,0,0,63
8,9,4,12,9,14,7,19,0,82
8,9,4,12,9,14,19,0,0,75
8,25,4,14,15,9,4,0,0,79
8,25,4,18,1,3,9,4,0,72
8,25,4,18,1,3,9,4,19,91
8,25,4,18,1,5,0,0,0,61
8,25,4,18,1,5,13,9,1,84
8,25,4,18,1,5,13,9,3,86
8,25,4,18,1,7,15,7,0,85
8,25,4,18,1,7,15,7,25,110
8,25,4,18,1,7,15,7,19,104
8,25,4,18,1,13,9,4,5,87
8,25,4,18,1,13,9,14,5,97
8,25,4,18,1,14,20,0,0,90
8,25,4,18,1,14,20,8,0,98
8,25,4,18,1,14,20,8,19,117
8,25,4,18,1,14,20,19,0,109
8,25,4,18,1,18,3,8,0,85
8,25,4,18,1,19,0,0,0,75
8,25,4,18,1,19,5,0,0,80
8,25,4,18,1,19,5,19,0,99
8,25,4,18,1,20,5,0,0,81
8,25,4,18,1,20,5,4,0,85
8,25,4,18,1,20,5,19,0,100
8,25,4,18,1,20,9,14,7,106
8,25,4,18,1,20,9,15,14,114
8,25,4,18,1,20,15,18,0,109
8,25,4,18,1,20,15,18,19,128
8,25,4,18,1,21,12,0,0,89
8,25,4,18,1,21,12,9,0,98
8,25,4,18,1,21,12,9,3,101
8,25,4,18,1,21,12,9,19,117
8,25,4,18,1,21,12,21,19,129
8,25,4,18,1,26,9,4,5,100
8,25,4,18,1,26,25,12,0,119
8,25,4,18,1,26,9,14,0,105
8,25,4,18,1,26,9,14,5,110
8,25,4,18,1,26,9,14,15,120
8,25,4,18,1,26,15,0,0,97
8,25,4,18,1,26,15,9,3,109
8,25,4,18,1,26,15,14,5,116
8,25,4,18,5,13,9,1,0,83
8,25,4,18,5,13,9,3,0,85
8,25,4,18,9,1,0,0,0,65
8,25,4,18,9,1,4,0,0,69
8,25,4,18,9,1,5,0,0,70
8,25,4,18,9,1,20,18,25,128
8,25,4,18,9,3,0,0,0,67
8,25,4,18,9,4,5,0,0,73
8,25,4,18,9,4,5,19,0,92
8,25,4,18,9,4,19,0,0,87
8,25,4,18,9,6,15,18,13,116
8,25,4,18,9,15,4,9,3,95
8,25,4,18,9,15,14,0,0,93
8,25,4,18,15,0,0,0,0,70
8,25,4,18,15,1,0,0,0,71
8,25,4,18,15,2,15,13,2,102
8,25,4,18,15,3,5,12,5,95
8,25,4,18,15,3,25,19,20,137
8,25,4,18,15,6,15,9,12,112
8,25,4,18,15,6,21,7,5,109
8,25,4,18,15,7,5,12,0,94
8,25,4,18,15,7,5,12,19,113
8,25,4,18,15,7,5,14,0,96
8,25,4,18,15,7,5,14,19,115
8,25,4,18,15,7,15,4,5,101
8,25,4,18,15,9,4,0,0,83
8,25,4,18,15,9,4,19,0,102
8,25,4,18,15,12,0,0,0,82
8,25,4,18,15,12,1,14,20,117
8,25,4,18,15,12,1,19,5,107
8,25,4,18,15,12,25,19,5,131
8,25,4,18,15,12,25,19,20,146
8,25,4,18,15,12,25,20,5,132
8,25,4,18,15,12,9,26,5,122
8,25,4,18,15,12,25,26,5,138
8,25,4,18,15,12,15,7,25,129
8,25,4,18,15,13,5,0,0,88
8,25,4,18,15,13,5,12,0,100
8,25,4,18,15,13,5,12,19,119
8,25,4,18,15,13,9,3,1,96
8,25,4,18,15,14,1,21,20,126
8,25,4,18,15,14,5,0,0,89
8,25,4,18,15,14,9,3,0,96
8,25,4,18,15,14,9,21,13,127
8,25,4,18,15,16,1,3,0,90
8,25,4,18,15,16,1,20,8,115
8,25,4,18,15,16,8,9,4,107
8,25,4,18,15,16,8,9,12,115
8,25,4,18,15,16,9,3,0,98
8,25,4,18,15,16,15,20,0,121
8,25,4,18,15,16,19,0,0,105
8,25,4,18,15,16,19,5,19,129
8,25,4,18,15,16,19,25,0,130
8,25,4,18,15,16,20,9,3,118
8,25,4,18,15,16,21,12,20,139
8,25,4,18,15,19,0,0,0,89
8,25,4,18,15,19,1,12,20,122
8,25,4,18,15,19,5,18,5,117
8,9,4,18,15,19,5,19,0,97
8,9,4,18,15,19,9,19,0,101
8,25,4,18,15,19,11,9,0,109
8,25,4,18,15,19,15,12,0,116
8,25,4,18,15,19,15,12,5,121
8,25,4,18,15,19,15,12,19,135
8,25,4,18,15,19,15,13,1,118
8,25,4,18,15,19,15,13,5,122
8,25,4,18,15,19,20,1,20,130
8,9,4,18,15,20,9,3,0,86
8,25,4,18,15,20,9,3,0,102
8,25,4,18,15,20,25,16,5,136
8,25,4,18,15,20,15,13,25,143
8,25,4,18,15,21,19,0,0,110
8,25,4,18,15,22,1,14,5,112
8,25,4,18,15,24,25,0,0,119
8,25,4,18,15,24,9,4,5,112
8,25,4,18,15,24,25,12,0,131
8,25,4,18,15,24,25,12,19,150
8,25,4,18,15,26,15,1,12,124
8,25,4,18,15,26,15,1,14,126
8,25,4,18,15,26,15,9,3,123
8,25,4,18,15,26,15,15,14,140
8,25,4,18,21,12,1,0,0,89
8,25,4,18,21,18,5,20,0,119
8,25,4,21,18,9,12,9,3,109
8,9,5,0,0,0,0,0,0,22
8,9,5,4,0,0,0,0,0,26
8,9,5,4,5,18,0,0,0,49
8,9,5,9,14,7,0,0,0,52
8,9,5,12,1,13,1,14,0,63
8,9,5,12,1,13,5,14,0,67
8,9,5,12,1,13,15,14,0,77
8,9,5,12,1,14,4,0,0,53
8,9,5,12,4,0,0,0,0,38
8,9,5,12,13,9,20,5,0,81
8,9,5,13,1,12,0,0,0,48
8,25,5,13,1,12,0,0,0,64
8,9,5,13,1,20,5,0,0,61
8,9,5,13,1,20,9,15,14,94
8,9,5,13,19,0,0,0,0,54
8,25,5,14,1,0,0,0,0,53
8,25,5,14,1,4,15,7,0,79
8,25,5,14,1,19,0,0,0,72
8,25,5,14,9,1,0,0,0,62
8,25,5,14,9,3,0,0,0,64
8,25,5,14,9,6,15,18,13,113
8,25,5,14,9,14,5,0,0,80
8,25,5,14,15,9,4,0,0,80
8,9,5,14,26,0,0,0,0,62
8,9,5,18,1,3,9,20,5,78
8,9,5,18,1,18,3,8,0,70
8,9,5,18,1,18,3,8,25,95
8,9,5,18,1,18,3,8,19,89
8,9,5,18,1,20,9,3,0,73
8,9,5,18,1,20,9,3,1,74
8,9,5,18,1,20,9,20,5,95
8,9,5,18,15,4,21,12,5,97
8,9,5,18,15,7,1,13,25,101
8,9,5,18,15,7,18,1,13,94
8,9,5,18,15,12,15,7,25,114
8,9,5,18,15,13,15,14,11,108
8,9,5,18,15,14,0,0,0,69
8,9,5,18,15,19,0,0,0,74
8,9,5,18,21,18,7,25,0,111
8,9,5,19,0,0,0,0,0,41
8,25,5,20,1,12,0,0,0,71
8,25,5,20,15,12,15,7,25,132
8,9,6,1,12,21,20,9,14,100
8,25,7,5,5,14,0,0,0,64
8,25,7,5,9,19,20,0,0,93
8,25,7,5,9,19,20,9,3,105
8,25,7,5,9,19,20,19,0,112
8,25,7,5,14,9,3,19,0,90
8,25,7,5,15,12,15,7,25,119
8,9,7,7,1,9,15,14,0,70
8,9,7,7,12,5,0,0,0,48
8,9,7,7,12,5,4,0,0,52
8,9,7,7,12,5,18,0,0,66
8,9,7,7,12,5,18,25,0,91
8,9,7,7,12,5,18,19,0,85
8,9,7,7,12,5,19,0,0,67
8,9,7,7,12,9,14,7,0,73
8,9,7,8,2,1,12,12,0,59
8,9,7,8,2,1,12,12,19,78
8,9,7,8,2,5,12,9,1,61
8,9,7,8,2,15,1,18,4,72
8,9,7,8,2,15,25,0,0,74
8,9,7,8,2,15,25,19,0,93
8,9,7,8,2,15,18,14,0,81
8,9,7,8,2,18,5,4,0,61
8,9,7,8,2,18,15,23,0,90
8,9,7,8,2,18,15,23,19,109
8,9,7,8,2,21,19,8,0,82
8,9,7,8,3,8,1,9,18,71
8,9,7,8,4,1,4,4,25,70
8,9,7,8,5,18,0,0,0,55
8,9,7,8,5,19,20,0,0,76
8,9,7,8,6,12,9,5,18,82
8,9,7,8,6,12,25,5,18,98
8,9,7,8,8,1,20,0,0,61
8,9,7,8,8,15,12,5,0,72
8,9,7,8,9,19,8,0,0,68
8,9,7,8,10,1,3,11,0,57
8,9,7,8,10,1,3,11,19,76
8,9,7,8,12,25,0,0,0,69
8,9,7,8,12,9,6,5,0,64
8,9,7,8,12,9,7,8,20,88
8,9,7,8,12,9,14,5,0,72
8,9,7,8,12,15,23,0,0,82
8,9,7,8,13,1,14,0,0,60
8,9,7,8,13,15,15,18,0,93
8,9,7,8,13,15,19,20,0,99
8,9,7,8,18,15,1,4,0,70
8,9,7,8,18,15,1,4,19,89
8,9,7,8,19,0,0,0,0,51
8,9,7,8,20,0,0,0,0,52
8,9,7,8,20,1,9,12,0,74
8,9,7,8,20,1,9,12,19,93
8,9,7,8,20,5,4,0,0,61
8,9,7,8,20,8,0,0,0,60
8,9,7,8,20,8,19,0,0,79
8,9,7,8,20,9,14,7,0,82
8,9,7,8,20,15,2,25,0,94
8,9,7,8,20,15,16,0,0,83
8,9,7,8,20,19,0,0,0,71
8,9,7,8,23,1,25,0,0,81
8,9,7,8,23,1,25,19,0,100
8,25,7,9,1,14,20,9,3,96
8,25,7,9,1,19,20,9,3,101
8,25,7,9,5,9,19,20,0,102
8,25,7,9,5,9,19,20,19,121
8,25,7,9,5,14,1,12,0,81
8,25,7,9,5,14,5,0,0,73
8,25,7,9,5,14,5,19,0,92
8,25,7,9,5,14,9,3,0,80
8,25,7,9,5,14,9,3,19,99
8,25,7,9,5,14,9,19,20,116
8,25,7,9,5,14,9,26,5,108
8,25,7,9,15,12,15,7,25,123
8,9,7,18,1,0,0,0,0,43
8,25,7,18,9,3,0,0,0,70
8,25,7,18,9,14,0,0,0,81
8,25,7,18,9,14,5,0,0,86
8,25,7,18,9,19,20,15,18,139
8,25,7,18,15,4,5,9,11,102
8,25,7,18,15,7,18,1,13,112
8,25,7,18,15,12,15,7,25,132
8,25,7,18,15,13,1,0,0,87
8,25,7,18,15,19,20,1,20,133
8,9,7,21,5,18,15,0,0,83
8,9,25,1,11,11,9,14,0,88
8,25,9,14,7,0,0,0,0,63
8,25,9,14,7,12,25,0,0,100
8,9,10,1,3,11,0,0,0,42
8,9,10,1,3,11,5,4,0,51
8,9,10,1,3,11,5,18,0,65
8,9,10,1,3,11,5,18,19,84
8,9,10,1,3,11,9,14,7,72
8,9,10,1,3,11,19,0,0,61
8,9,10,9,14,11,19,0,0,80
8,25,11,5,0,0,0,0,0,49
8,9,11,5,4,0,0,0,0,37
8,9,11,5,18,0,0,0,0,51
8,9,11,5,18,19,0,0,0,70
8,9,11,5,19,0,0,0,0,52
8,9,11,9,14,7,0,0,0,58
8,9,11,21,12,9,0,0,0,70
8,9,12,1,0,0,0,0,0,30
8,25,12,1,3,20,9,3,0,81
8,25,12,1,3,20,9,19,13,110
8,25,12,1,18,3,8,9,3,87
8,9,12,1,18,9,15,21,19,112
8,9,12,1,18,9,20,25,0,102
8,9,12,1,19,13,9,3,0,74
8,25,12,1,19,13,21,19,0,118
8,9,12,2,15,18,14,0,0,78
8,9,12,3,8,0,0,0,0,40
8,9,12,4,9,14,7,0,0,63
8,9,12,4,9,14,7,19,0,82
8,9,12,5,0,0,0,0,0,34
8,25,12,5,0,0,0,0,0,50
8,25,12,5,1,14,0,0,0,65
8,25,12,5,7,0,0,0,0,57
8,9,12,9,0,0,0,0,0,38
8,25,12,9,0,0,0,0,0,54
8,25,12,9,3,0,0,0,0,57
8,25,12,9,3,9,19,13,0,98
8,25,12,9,3,9,19,20,0,105
8,25,12,9,4,19,0,0,0,77
8,25,12,9,19,13,0,0,0,86
8,25,12,9,19,20,0,0,0,93
8,9,12,12,2,5,18,18,25,109
8,9,12,12,2,9,12,12,25,101
8,9,12,12,2,9,18,4,0,74
8,9,12,12,5,4,0,0,0,50
8,9,12,12,5,18,19,0,0,83
8,9,12,12,5,20,0,0,0,66
8,9,12,12,6,15,18,20,0,100
8,9,12,12,9,5,19,20,0,94
8,9,12,12,9,14,5,19,19,107
8,9,12,12,9,14,7,0,0,71
8,9,12,12,13,5,14,0,0,73
8,9,12,12,15,0,0,0,0,56
8,9,12,12,15,1,0,0,0,57
8,9,12,12,15,1,5,4,0,66
8,9,12,12,15,1,9,14,7,87
8,9,12,12,15,1,19,0,0,76
8,9,12,12,15,3,11,0,0,70
8,9,12,12,15,3,11,5,4,79
8,9,12,12,15,3,11,25,0,95
8,9,12,12,15,3,11,19,0,89
8,9,12,12,15,5,4,0,0,65
8,9,12,12,15,9,14,7,0,86
8,9,12,12,15,19,0,0,0,75
8,9,12,12,19,1,12,5,0,78
8,9,12,12,19,9,4,5,19,97
8,9,12,12,19,9,20,5,0,94
8,9,12,12,19,13,1,14,0,88
8,9,12,12,20,15,16,0,0,92
8,9,12,12,20,15,16,19,0,111
8,9,12,12,20,18,15,20,0,114
8,9,12,12,23,1,18,4,0,87
8,9,12,12,23,15,13,1,14,107
8,9,12,12,23,15,18,20,0,117
8,25,12,15,2,1,20,9,3,95
8,25,12,15,7,5,14,25,0,111
8,25,12,15,9,4,0,0,0,73
8,25,12,15,9,19,20,0,0,108
8,25,12,15,12,15,7,25,0,119
8,25,12,15,16,1,20,8,25,130
8,25,12,15,26,15,9,3,0,113
8,25,12,15,26,15,9,19,13,142
8,25,12,15,26,15,9,19,20,149
8,9,12,19,1,0,0,0,0,49
8,9,12,19,1,8,0,0,0,57
8,9,12,20,0,0,0,0,0,49
8,9,12,20,5,4,0,0,0,58
8,9,12,20,9,14,7,0,0,79
8,9,12,20,12,5,19,19,0,104
8,9,12,20,19,0,0,0,0,68
8,9,12,21,13,0,0,0,0,63
8,9,12,21,19,0,0,0,0,69
8,9,13,1,13,1,20,9,1,75
8,9,13,1,20,9,0,0,0,60
8,9,13,1,20,9,1,0,0,61
8,9,13,1,20,9,15,14,0,89
8,9,13,1,20,9,15,14,19,108
8,9,13,1,23,1,14,0,0,69
8,25,13,5,14,1,12,0,0,78
8,9,13,5,14,5,0,0,0,54
8,25,13,5,14,5,1,12,0,83
8,25,13,5,14,5,1,12,19,102
8,25,13,5,14,5,1,14,0,85
8,25,13,5,14,9,1,0,0,75
8,25,13,5,14,9,1,12,0,87
8,25,13,5,14,9,3,0,0,77
8,25,13,5,14,9,21,13,0,108
8,25,13,5,14,9,21,13,19,127
8,25,13,5,14,15,9,4,0,93
8,25,13,5,14,19,0,0,0,84
8,9,13,13,9,14,7,0,0,73
8,25,13,14,0,0,0,0,0,60
8,25,13,14,1,12,0,0,0,73
8,25,13,14,1,12,19,0,0,92
8,25,13,14,1,18,25,0,0,104
8,25,13,14,1,18,9,1,0,89
8,25,13,14,1,18,9,5,19,112
8,25,13,14,1,18,9,21,13,122
8,25,13,14,2,15,15,11,0,103
8,25,13,14,2,15,15,11,19,122
8,9,13,14,5,0,0,0,0,49
8,25,13,14,5,4,0,0,0,69
8,25,13,14,5,18,0,0,0,83
8,25,13,14,9,3,0,0,0,72
8,25,13,14,9,14,7,0,0,90
8,25,13,14,9,19,20,0,0,108
8,25,13,14,9,19,20,19,0,127
8,25,13,14,12,5,19,19,0,115
8,25,13,14,12,9,11,5,0,97
8,25,13,14,15,4,5,0,0,84
8,25,13,14,15,4,25,0,0,104
8,25,13,14,15,4,9,5,19,112
8,25,13,14,15,4,9,19,20,127
8,25,13,14,15,12,15,7,25,134
8,25,13,14,19,0,0,0,0,79
8,25,13,14,23,9,19,5,0,116
8,9,13,16,0,0,0,0,0,46
8,9,13,16,12,5,0,0,0,63
8,9,13,19,5,12,6,0,0,72
8,9,13,23,1,18,4,0,0,76
8,9,13,23,1,18,4,19,0,95
8,9,14,0,0,0,0,0,0,31
8,9,14,1,21,0,0,0,0,53
8,25,14,4,0,0,0,0,0,51
8,9,14,4,2,5,18,18,25,103
8,9,14,4,2,18,1,9,14,79
8,9,14,4,3,1,19,20,0,78
8,9,14,4,4,5,3,11,0,58
8,25,14,4,5,0,0,0,0,56
8,9,14,4,5,18,0,0,0,58
8,25,14,4,5,18,0,0,0,74
8,9,14,4,5,18,5,4,0,67
8,9,14,4,5,18,5,18,0,81
8,9,14,4,5,18,5,18,19,100
8,9,14,4,5,18,5,19,20,102
8,9,14,4,5,18,6,21,12,97
8,9,14,4,5,18,9,14,7,88
8,9,14,4,5,18,12,25,0,95
8,9,14,4,5,18,19,0,0,77
8,9,14,4,7,21,20,0,0,83
8,9,14,4,7,21,20,19,0,102
8,9,14,4,8,1,14,4,0,62
8,9,14,4,8,5,1,4,0,53
8,9,14,4,13,15,19,20,0,102
8,9,14,4,18,1,14,3,5,76
8,9,14,4,19,0,0,0,0,54
8,9,14,4,19,9,7,8,20,98
8,9,14,4,23,1,18,4,0,81
8,9,14,4,23,1,18,4,19,100
8,9,14,5,0,0,0,0,0,36
8,25,14,5,0,0,0,0,0,52
8,9,14,5,25,0,0,0,0,61
8,9,14,7,0,0,0,0,0,38
8,9,14,7,5,0,0,0,0,43
8,9,14,7,5,4,0,0,0,47
8,9,14,7,5,12,5,19,19,98
8,9,14,7,5,12,9,11,5,80
8,9,14,7,5,18,0,0,0,61
8,9,14,7,5,18,19,0,0,80
8,9,14,7,5,19,0,0,0,62
8,9,14,7,5,23,1,25,19,111
8,9,14,7,9,14,7,0,0,68
8,9,14,7,12,5,0,0,0,55
8,9,14,14,5,25,0,0,0,75
8,9,14,14,5,18,0,0,0,68
8,9,14,14,25,0,0,0,0,70
8,9,14,14,9,2,12,5,0,73
8,9,14,14,9,5,4,0,0,63
8,9,14,14,9,5,19,0,0,78
8,9,14,14,25,9,14,7,0,100
8,9,14,15,9,4,0,0,0,59
8,9,14,15,11,9,0,0,0,66
8,9,14,19,0,0,0,0,0,50
8,9,14,20,0,0,0,0,0,51
8,9,14,20,5,4,0,0,0,60
8,9,14,20,5,4,12,25,0,97
8,9,14,20,5,18,0,0,0,74
8,9,14,20,5,18,19,0,0,93
8,9,14,20,9,14,7,0,0,81
8,9,14,20,9,14,7,12,25,118
8,9,14,20,16,18,15,15,6,121
8,9,14,20,19,0,0,0,0,70
8,9,14,20,26,5,9,20,5,116
8,25,15,3,8,15,12,9,3,98
8,9,15,4,15,14,20,0,0,85
8,25,15,7,12,15,19,19,9,129
8,25,15,9,4,0,0,0,0,61
8,25,15,9,4,1,12,0,0,74
8,25,15,9,4,1,14,0,0,76
8,25,15,9,4,5,1,12,0,79
8,25,15,9,4,5,1,14,0,81
8,25,15,9,4,5,19,0,0,85
8,25,15,9,4,19,0,0,0,80
8,25,15,12,9,20,8,9,4,110
8,25,15,13,5,14,20,1,12,113
8,25,15,19,3,9,14,5,0,98
8,25,15,19,3,9,14,5,19,117
8,25,15,19,20,25,12,25,0,149
8,25,15,19,20,25,12,9,3,136
8,25,15,20,8,5,18,5,0,104
8,9,16,0,0,0,0,0,0,33
8,25,16,0,0,0,0,0,0,49
8,25,16,1,3,21,19,9,1,103
8,25,16,1,3,21,19,9,19,121
8,25,16,1,12,7,9,1,0,79
8,25,16,1,12,7,9,3,0,81
8,25,16,1,12,12,1,7,5,87
8,25,16,1,14,20,8,9,1,102
8,25,16,1,14,20,18,21,13,136
8,25,16,1,19,16,9,19,20,133
8,25,16,1,20,5,0,0,0,75
8,25,16,1,20,15,14,0,0,99
8,25,16,1,24,9,1,12,0,96
8,9,16,2,5,18,18,25,0,101
8,9,16,2,15,14,5,0,0,69
8,9,16,2,15,14,5,19,0,88
8,9,16,5,0,0,0,0,0,38
8,25,16,5,0,0,0,0,0,54
8,25,16,5,4,0,0,0,0,58
8,9,16,5,18,0,0,0,0,56
8,25,16,5,18,0,0,0,0,72
8,25,16,5,18,1,3,9,4,89
8,25,16,5,18,2,1,20,1,96
8,25,16,5,18,2,15,12,1,102
8,25,16,5,18,2,15,12,5,106
8,25,16,5,18,3,15,14,5,109
8,25,16,5,18,3,21,2,5,103
8,25,16,5,18,5,13,9,1,100
8,25,16,5,18,5,13,9,3,102
8,25,16,5,18,6,9,14,5,106
8,25,16,5,18,6,15,18,13,124
8,25,16,5,18,7,1,13,25,118
8,25,16,5,18,7,15,12,0,106
8,25,16,5,18,7,15,12,19,125
8,25,16,5,18,9,3,9,14,107
8,25,16,5,18,9,14,0,0,95
8,25,16,5,18,9,20,5,0,106
8,25,16,5,18,14,9,3,0,98
8,25,16,5,18,14,9,11,0,106
8,25,16,5,18,14,15,20,5,126
8,25,16,5,18,15,14,0,0,101
8,25,16,5,18,15,14,19,0,120
8,25,16,5,18,15,15,14,0,116
8,25,16,5,18,15,16,5,0,108
8,25,16,5,18,15,16,5,19,127
8,25,16,5,18,15,16,9,1,113
8,25,16,5,18,15,16,9,3,115
8,25,16,5,18,16,5,18,0,111
8,25,16,5,18,16,14,5,1,108
8,25,16,5,18,16,21,18,5,132
8,25,16,5,18,20,5,12,25,134
8,25,16,5,18,20,25,16,5,138
8,25,16,5,19,0,0,0,0,73
8,25,16,5,20,8,18,1,12,113
8,9,16,6,12,1,19,11,0,82
8,25,16,8,1,0,0,0,0,58
8,25,16,8,1,5,0,0,0,63
8,25,16,8,1,12,0,0,0,70
8,9,16,8,1,12,20,0,0,74
8,9,16,8,1,16,5,0,0,63
8,25,16,8,5,13,1,0,0,76
8,25,16,8,5,13,9,1,0,85
8,25,16,8,5,13,9,1,19,104
8,25,16,8,5,14,0,0,0,76
8,25,16,8,5,14,1,20,5,102
8,25,16,8,5,14,5,4,0,85
8,25,16,8,5,14,9,3,0,88
8,25,16,8,5,14,9,14,7,106
8,25,16,8,5,14,9,19,5,109
8,25,16,8,5,14,9,19,13,117
8,25,16,8,5,14,9,26,5,116
8,25,16,8,5,14,19,0,0,95
8,25,16,8,15,0,0,0,0,72
8,25,16,8,15,16,4,9,1,102
8,25,16,9,14,7,0,0,0,79
8,25,16,9,14,15,19,9,19,134
8,25,16,9,14,15,20,9,3,119
8,9,16,12,5,14,7,20,8,99
8,9,16,12,5,19,19,0,0,88
8,9,16,12,9,11,5,0,0,70
8,9,16,12,9,14,5,0,0,73
8,9,16,12,9,14,5,19,0,92
8,9,16,13,9,0,0,0,0,55
8,9,16,13,15,12,4,0,0,77
8,25,16,14,1,12,5,0,0,81
8,9,16,14,5,19,19,0,0,90
8,9,16,14,5,19,19,5,19,114
8,25,16,14,9,3,0,0,0,75
8,25,16,14,15,2,1,20,5,106
8,25,16,14,15,3,25,19,20,145
8,25,16,14,15,4,25,0,0,107
8,25,16,14,15,5,20,9,3,115
8,25,16,14,15,7,9,1,0,95
8,25,16,14,15,9,4,0,0,91
8,25,16,14,15,9,4,1,12,104
8,25,16,14,15,12,15,7,25,137
8,25,16,14,15,14,5,0,0,97
8,25,16,14,15,19,5,19,0,121
8,25,16,14,15,19,9,19,0,125
8,25,16,14,15,20,9,3,0,110
8,25,16,14,15,20,9,3,19,129
8,25,16,14,15,20,9,19,5,131
8,25,16,14,15,20,9,19,13,139
8,25,16,14,15,20,9,19,20,146
8,25,16,14,15,20,9,26,5,138
8,25,16,14,15,20,15,9,4,126
8,25,16,15,0,0,0,0,0,64
8,25,16,15,1,3,9,4,0,81
8,25,16,15,2,1,18,9,3,97
8,25,16,15,2,1,19,1,12,99
8,25,16,15,2,1,19,5,19,110
8,25,16,15,2,1,19,9,19,114
8,25,16,15,2,12,1,19,20,118
8,25,16,15,2,15,12,5,0,98
8,25,16,15,2,21,12,9,1,109
8,25,16,15,2,21,12,9,3,111
8,25,16,15,3,1,18,16,0,102
8,25,16,15,3,1,21,19,20,128
8,25,16,15,3,8,9,12,0,96
8,25,16,15,3,9,19,20,0,115
8,25,16,15,3,15,14,5,0,101
8,25,16,15,3,15,14,9,4,109
8,25,16,15,3,15,16,25,0,123
8,25,16,15,3,15,20,25,12,139
8,25,16,15,3,18,9,19,25,138
8,25,16,15,3,18,9,20,5,119
8,25,16,15,3,18,9,26,5,125
8,25,16,15,4,5,18,13,0,104
8,25,16,15,4,5,18,13,1,105
8,25,16,15,4,5,18,13,19,123
8,25,16,15,5,4,0,0,0,73
8,25,16,15,5,18,7,9,3,106
8,25,16,15,7,1,5,9,3,89
8,25,16,15,7,1,13,25,0,110
8,25,16,15,7,5,1,0,0,77
8,25,16,15,7,5,1,12,0,89
8,25,16,15,7,5,1,14,0,91
8,25,16,15,7,5,5,0,0,81
8,25,16,15,7,5,9,3,0,88
8,25,16,15,7,5,14,5,0,95
8,25,16,15,7,5,14,9,3,102
8,25,16,15,7,5,15,21,19,131
8,25,16,15,7,5,21,13,0,110
8,25,16,15,7,25,14,0,0,110
8,25,16,15,7,25,14,25,0,135
8,25,16,15,7,25,14,9,3,122
8,25,16,15,8,5,13,9,1,100
8,25,16,15,8,25,1,12,0,110
8,25,16,15,9,4,0,0,0,77
8,25,16,15,9,14,7,0,0,94
8,25,16,15,13,1,14,9,1,102
8,25,16,15,13,1,14,9,3,104
8,25,16,15,13,5,18,1,12,113
8,25,16,15,13,5,18,5,0,105
8,25,16,15,13,5,18,15,14,129
8,25,16,15,13,15,18,16,8,134
8,25,16,15,14,1,19,20,25,143
8,25,16,15,14,5,1,0,0,84
8,25,16,15,14,5,1,19,0,103
8,25,16,15,14,25,13,0,0,116
8,25,16,15,14,25,13,9,3,128
8,25,16,15,14,15,9,1,0,103
8,25,16,15,14,15,9,1,19,122
8,25,16,15,14,15,13,5,0,111
8,25,16,15,14,15,13,9,3,118
8,25,16,15,16,5,16,19,25,145
8,25,16,15,16,8,1,18,5,112
8,25,16,15,16,8,25,7,5,125
8,25,16,15,16,8,25,12,12,137
8,25,16,15,16,8,25,19,5,137
8,25,16,15,16,8,15,18,1,122
8,25,16,15,16,9,1,12,0,102
8,25,16,15,16,25,15,14,0,134
8,25,16,15,16,25,15,14,19,153
8,25,16,15,16,12,1,19,25,137
8,25,16,15,16,12,15,9,4,120
8,25,16,15,16,14,5,1,0,100
8,25,16,15,16,14,5,1,19,119
8,25,16,15,16,14,15,5,1,115
8,25,16,15,16,15,4,9,1,109
8,25,16,15,16,21,19,0,0,120
8,25,16,15,18,9,7,8,20,126
8,25,16,15,18,9,20,0,0,111
8,25,16,15,19,0,0,0,0,83
8,25,16,15,19,1,18,3,1,106
8,25,16,15,19,3,15,16,5,122
8,25,16,15,19,13,9,1,0,106
8,25,16,15,19,16,18,1,25,143
8,25,16,15,19,20,1,19,5,128
8,25,16,15,19,20,1,19,25,148
8,25,16,15,19,20,25,12,5,145
8,25,16,15,19,20,15,13,1,132
8,25,16,15,19,20,15,13,5,136
8,25,16,15,20,1,24,9,1,119
8,25,16,15,20,1,24,9,3,121
8,25,16,15,20,1,24,9,19,137
8,25,16,15,20,8,0,0,0,92
8,25,16,15,20,8,1,13,9,115
8,25,16,15,20,8,5,3,0,100
8,25,16,15,20,8,5,3,1,101
8,25,16,15,20,8,5,3,19,119
8,25,16,15,20,8,5,19,9,125
8,25,16,15,20,25,16,5,0,130
8,25,16,15,20,25,16,9,3,137
8,25,16,15,20,15,14,25,0,138
8,25,16,15,20,15,14,9,1,123
8,25,16,15,20,15,14,9,3,125
8,25,16,15,20,15,14,21,19,153
8,25,16,15,20,15,24,9,3,135
8,25,16,15,20,18,9,3,8,122
8,25,16,15,22,1,12,22,5,126
8,25,16,15,24,5,13,9,1,116
8,25,16,15,24,5,13,9,3,118
8,25,16,15,24,9,1,0,0,98
8,25,16,15,24,9,1,19,0,117
8,25,16,15,24,9,3,0,0,100
8,25,16,15,26,15,1,14,0,120
8,25,16,15,26,15,9,3,0,117
8,9,16,16,1,18,3,8,0,79
8,9,16,16,1,18,3,8,19,98
8,9,16,16,5,4,0,0,0,58
8,25,16,16,5,4,0,0,0,74
8,9,16,16,5,14,0,0,0,68
8,9,16,16,5,18,0,0,0,72
8,9,16,16,5,19,20,0,0,93
8,9,16,16,25,0,0,0,0,74
8,9,16,16,9,1,14,0,0,73
8,9,16,16,9,1,20,5,18,102
8,9,16,16,9,1,20,18,25,122
8,9,16,16,9,3,0,0,0,61
8,9,16,16,9,5,0,0,0,63
8,9,16,16,9,5,4,15,13,95
8,9,16,16,9,5,18,0,0,81
8,9,16,16,9,5,19,0,0,82
8,9,16,16,9,5,19,20,0,102
8,9,16,16,9,14,7,0,0,79
8,9,16,16,9,19,8,0,0,85
8,25,16,16,9,19,8,0,0,101
8,9,16,16,12,5,0,0,0,66
8,9,16,16,15,3,1,13,16,97
8,9,16,16,15,3,5,18,6,96
8,9,16,16,15,3,18,1,19,105
8,9,16,16,15,4,1,13,5,87
8,9,16,16,15,9,4,0,0,77
8,9,16,16,15,12,9,20,5,110
8,9,16,16,15,12,9,20,8,113
8,9,16,16,15,12,15,7,25,123
8,9,16,16,15,16,15,4,0,99
8,9,16,16,15,19,0,0,0,83
8,9,16,16,15,20,15,13,25,137
8,9,16,16,21,18,1,20,5,114
8,9,16,16,21,18,9,1,0,98
8,9,16,16,21,18,9,3,0,100
8,9,16,16,21,18,9,4,0,101
8,9,16,16,21,18,9,20,5,122
8,9,16,16,21,19,0,0,0,89
8,9,16,19,0,0,0,0,0,52
8,9,16,19,8,15,20,0,0,95
8,25,16,19,9,12,15,9,4,117
8,25,16,19,15,4,15,14,20,136
8,9,16,19,20,5,18,0,0,95
8,9,16,19,20,5,18,19,0,114
8,25,16,20,0,0,0,0,0,69
8,25,16,21,18,1,12,0,0,101
8,9,16,23,15,18,20,0,0,109
8,9,18,0,0,0,0,0,0,35
8,9,18,1,2,12,5,0,0,55
8,25,18,1,3,5,19,0,0,79
8,25,18,1,3,5,21,13,0,94
8,25,18,1,3,9,4,0,0,68
8,25,18,1,3,15,9,4,0,83
8,25,18,1,3,15,9,4,19,102
8,9,18,1,7,1,14,1,0,59
8,9,18,1,7,1,14,1,19,78
8,25,18,1,20,5,0,0,0,77
8,25,18,1,24,0,0,0,0,76
8,25,18,1,24,5,19,0,0,100
8,9,18,3,1,18,18,1,0,76
8,9,18,3,9,3,0,0,0,50
8,9,18,3,9,14,0,0,0,61
8,9,18,3,9,14,5,0,0,66
8,9,18,3,9,14,15,21,19,116
8,9,18,3,15,3,5,18,6,85
8,9,18,3,15,19,9,20,25,126
8,9,18,3,21,19,0,0,0,78
8,9,18,5,0,0,0,0,0,40
8,9,18,5,1,2,12,5,0,60
8,9,18,5,4,0,0,0,0,44
8,9,18,5,12,5,19,19,0,95
8,9,18,5,12,9,14,7,0,82
8,9,18,5,12,9,14,7,19,101
8,9,18,5,13,1,14,0,0,68
8,9,18,5,18,0,0,0,0,58
8,9,18,5,18,19,0,0,0,77
8,9,18,9,14,7,0,0,0,65
8,9,18,9,14,7,19,0,0,84
8,9,18,12,9,14,7,0,0,77
8,9,18,13,15,19,0,0,0,82
8,9,18,15,6,21,13,9,0,99
8,9,18,15,25,21,11,9,0,116
8,9,18,15,20,15,19,8,9,121
8,9,18,16,12,5,0,0,0,68
8,9,18,16,12,5,4,0,0,72
8,9,18,16,12,5,19,0,0,87
8,9,18,16,12,9,14,7,0,93
8,9,18,18,9,5,14,20,0,101
8,9,18,19,5,0,0,0,0,59
8,25,18,19,5,0,0,0,0,75
8,9,18,19,5,12,0,0,0,71
8,9,18,19,5,12,5,4,0,80
8,9,18,19,5,12,9,14,7,101
8,9,18,19,5,12,12,5,4,92
8,9,18,19,5,12,19,0,0,90
8,9,18,19,12,5,0,0,0,71
8,9,18,19,12,5,4,0,0,75
8,9,18,19,12,5,19,0,0,90
8,9,18,19,12,9,14,7,0,96
8,25,18,19,20,0,0,0,0,90
8,9,18,19,20,9,5,0,0,88
8,9,18,19,21,20,5,0,0,100
8,9,18,19,21,20,9,5,19,128
8,9,18,19,21,20,9,19,13,136
8,9,18,20,3,8,0,0,0,66
8,9,18,21,4,9,14,1,12,96
8,9,18,21,4,9,14,5,0,88
8,9,18,21,4,9,14,19,0,102
8,9,18,21,14,4,9,14,5,102
8,9,19,8,0,0,0,0,0,44
8,9,19,9,19,0,0,0,0,64
8,9,19,12,15,16,9,20,5,113
8,9,19,14,0,0,0,0,0,50
8,25,19,15,14,0,0,0,0,81
8,25,19,15,14,19,0,0,0,100
8,9,19,16,1,14,9,3,19,98
8,9,19,16,1,14,9,19,13,108
8,9,19,16,9,4,0,0,0,65
8,9,19,16,9,4,9,20,25,119
8,9,19,19,5,4,0,0,0,64
8,9,19,19,5,12,0,0,0,72
8,9,19,19,5,12,6,0,0,78
8,9,19,19,5,18,0,0,0,78
8,9,19,19,5,18,19,0,0,97
8,9,19,19,5,19,0,0,0,79
8,9,19,19,25,0,0,0,0,80
8,9,19,19,9,14,7,0,0,85
8,9,19,19,9,14,7,12,25,122
8,9,19,19,9,14,7,19,0,104
8,25,19,19,15,16,0,0,0,102
8,25,19,19,15,16,19,0,0,121
8,9,19,19,16,18,15,15,6,125
8,9,19,20,0,0,0,0,0,56
8,9,19,20,1,13,9,14,0,93
8,9,19,20,1,13,9,14,5,98
8,9,19,20,1,13,9,14,19,112
8,9,19,20,5,4,0,0,0,65
8,9,19,20,5,18,0,0,0,79
8,25,19,20,5,18,9,1,0,105
8,25,19,20,5,18,9,1,3,108
8,25,19,20,5,18,9,1,19,124
8,25,19,20,5,18,9,3,0,107
8,25,19,20,5,18,9,3,19,126
8,25,19,20,5,18,15,9,4,123
8,25,19,20,5,18,15,14,0,124
8,9,19,20,9,4,9,14,0,92
8,9,19,20,9,4,9,14,5,97
8,9,19,20,9,4,9,14,19,111
8,9,19,20,9,5,0,0,0,70
8,9,19,20,9,14,7,0,0,86
8,9,19,20,9,15,9,4,0,93
8,9,19,20,15,3,25,20,5,124
8,9,19,20,15,7,5,14,0,97
8,9,19,20,15,7,5,14,25,122
8,9,19,20,15,7,5,14,19,116
8,9,19,20,15,7,18,1,13,110
8,9,19,20,15,9,4,0,0,84
8,9,19,20,15,12,15,7,25,130
8,9,19,20,15,14,0,0,0,85
8,9,19,20,15,14,1,12,0,98
8,9,19,20,15,14,5,0,0,90
8,9,19,20,15,14,5,19,0,109
8,9,19,20,15,14,15,13,25,138
8,9,19,20,15,18,25,0,0,114
8,9,19,20,15,18,9,1,12,111
8,9,19,20,15,18,9,1,14,113
8,9,19,20,15,18,9,3,0,101
8,9,19,20,15,18,9,3,19,120
8,9,19,20,15,18,9,5,4,107
8,9,19,20,15,18,9,5,18,121
8,9,19,20,15,18,9,5,19,122
8,9,19,20,15,18,9,6,25,129
8,9,19,20,15,18,9,19,13,130
8,9,19,20,15,18,9,26,5,129
8,9,19,20,15,20,15,13,5,124
8,9,19,20,15,20,15,13,25,144
8,9,19,20,15,26,25,13,5,140
8,9,19,20,15,26,15,9,3,124
8,25,19,20,18,9,3,9,4,115
8,9,19,20,18,9,15,0,0,98
8,9,19,20,18,9,15,14,0,112
8,9,19,20,19,0,0,0,0,75
8,9,20,0,0,0,0,0,0,37
8,9,20,3,8,0,0,0,0,48
8,9,20,3,8,5,4,0,0,57
8,9,20,3,8,5,12,0,0,65
8,9,20,3,8,5,18,0,0,71
8,9,20,3,8,5,18,19,0,90
8,9,20,3,8,5,19,0,0,72
8,9,20,3,8,8,9,11,5,81
8,9,20,3,8,25,0,0,0,73
8,9,20,3,8,9,5,18,0,80
8,9,20,3,8,9,5,19,20,101
8,9,20,3,8,9,12,25,0,94
8,9,20,3,8,9,14,7,0,78
8,25,20,5,0,0,0,0,0,58
8,9,20,8,5,0,0,0,0,50
8,9,20,8,5,18,0,0,0,68
8,9,20,8,5,18,20,15,0,103
8,9,20,12,5,18,9,1,14,96
8,9,20,12,5,19,19,0,0,92
8,9,20,19,0,0,0,0,0,56
8,9,20,20,1,2,12,5,0,77
8,9,20,20,5,18,0,0,0,80
8,9,20,20,5,18,19,0,0,99
8,9,20,20,9,14,7,0,0,87
8,9,22,5,0,0,0,0,0,44
8,9,22,5,4,0,0,0,0,48
8,9,22,5,12,5,19,19,0,99
8,9,22,5,12,9,11,5,0,81
8,9,22,5,18,0,0,0,0,62
8,9,22,5,19,0,0,0,0,63
8,9,22,5,23,1,18,4,0,90
8,9,22,9,14,7,0,0,0,69
8,25,26,15,14,5,0,0,0,93
8,9,26,26,0,0,0,0,0,69
8,9,26,26,9,5,0,0,0,83
8,9,26,26,15,14,5,18,0,121
8,12,4,0,0,0,0,0,0,24
8,12,17,14,0,0,0,0,0,51
8,13,13,0,0,0,0,0,0,34
8,14,25,0,0,0,0,0,0,47
8,15,2,2,5,4,0,0,0,36
8,15,2,2,5,18,0,0,0,50
8,15,2,2,5,20,0,0,0,52
8,15,2,2,25,0,0,0,0,52
8,15,2,2,9,5,19,0,0,60
8,15,2,2,25,9,19,13,0,93
8,15,2,2,25,9,19,20,0,100
8,15,2,2,25,9,19,20,19,119
8,15,2,2,9,12,0,0,0,48
8,15,2,2,25,12,5,19,19,107
8,15,2,2,9,14,7,0,0,57
8,15,2,2,9,14,15,12,12,89
8,15,2,2,9,20,0,0,0,56
8,15,2,2,12,5,0,0,0,44
8,15,2,2,12,5,4,0,0,48
8,15,2,2,12,5,18,0,0,62
8,15,2,2,12,5,18,19,0,81
8,15,2,2,12,5,19,0,0,63
8,15,2,2,12,25,0,0,0,64
8,15,2,2,12,9,14,7,0,69
8,15,2,9,12,5,18,0,0,69
8,15,2,9,20,19,0,0,0,73
8,15,2,12,9,11,5,0,0,62
8,15,2,12,15,2,0,0,0,54
8,15,2,14,1,9,12,0,0,61
8,15,2,14,1,9,12,5,4,70
8,15,2,14,1,9,12,5,18,84
8,15,2,14,1,9,12,19,0,80
8,15,2,14,15,2,0,0,0,56
8,15,2,14,15,2,2,5,4,67
8,15,2,14,15,2,2,5,18,81
8,15,2,14,15,2,19,0,0,75
8,15,2,15,0,0,0,0,0,40
8,15,2,15,5,0,0,0,0,45
8,15,2,15,5,4,0,0,0,49
8,15,2,15,5,19,0,0,0,64
8,15,2,15,9,14,7,0,0,70
8,15,2,15,9,19,13,0,0,81
8,15,2,15,9,19,13,19,0,100
8,15,2,15,19,0,0,0,0,59
8,15,2,19,0,0,0,0,0,44
8,15,2,20,8,18,21,19,8,119
8,15,3,0,0,0,0,0,0,26
8,15,3,3,15,0,0,0,0,44
8,15,3,8,0,0,0,0,0,34
8,15,3,8,8,21,20,8,0,91
8,15,3,11,1,13,15,18,5,89
8,15,3,11,5,4,0,0,0,46
8,15,3,11,5,25,0,0,0,67
8,15,3,11,5,25,19,0,0,86
8,15,3,11,5,12,20,25,0,99
8,15,3,11,5,18,19,0,0,79
8,15,3,11,5,20,0,0,0,62
8,15,3,11,25,0,0,0,0,62
8,15,3,11,12,5,0,0,0,54
8,15,3,11,12,5,4,0,0,58
8,15,3,11,12,9,14,7,0,79
8,15,3,11,13,15,14,5,25,109
8,15,3,11,19,0,0,0,0,56
8,15,3,11,19,8,9,14,0,87
8,15,3,11,19,8,15,16,0,95
8,15,3,11,19,8,15,16,19,114
8,15,3,21,19,0,0,0,0,66
8,15,3,21,19,5,4,0,0,75
8,15,3,21,19,5,19,0,0,90
8,15,3,21,19,9,14,7,0,96
8,15,3,21,19,19,5,4,0,94
8,15,3,21,19,19,5,19,0,109
8,15,3,21,19,19,9,14,7,115
8,15,4,0,0,0,0,0,0,27
8,15,4,1,4,0,0,0,0,32
8,15,4,1,4,4,25,0,0,61
8,15,4,1,4,4,9,5,19,69
8,15,4,1,4,19,0,0,0,51
8,15,4,4,5,14,0,0,0,50
8,15,4,4,5,14,19,0,0,69
8,15,4,4,5,18,0,0,0,54
8,15,4,4,25,0,0,0,0,56
8,15,4,4,9,14,0,0,0,54
8,15,4,4,9,14,19,0,0,73
8,15,4,4,25,16,5,1,11,89
8,15,4,4,12,5,0,0,0,48
8,15,4,5,14,9,14,7,0,76
8,15,4,6,21,12,0,0,0,66
8,15,4,9,5,18,14,1,12,86
8,15,4,13,1,14,0,0,0,55
8,15,4,13,1,14,4,15,4,78
8,15,4,13,5,14,0,0,0,59
8,15,4,15,7,18,1,16,8,92
8,15,4,15,13,5,20,5,18,103
8,15,4,15,19,3,15,16,5,100
8,15,4,19,0,0,0,0,0,46
8,15,4,21,18,5,0,0,0,71
8,15,5,3,1,11,5,0,0,48
8,15,5,3,1,11,5,19,0,67
8,15,5,4,0,0,0,0,0,32
8,15,5,4,15,23,14,0,0,84
8,15,5,4,15,23,14,19,0,103
8,15,5,6,21,12,0,0,0,67
8,15,5,25,0,0,0,0,0,53
8,15,5,9,14,7,0,0,0,58
8,15,5,12,9,11,5,0,0,65
8,15,5,18,0,0,0,0,0,46
8,15,5,18,19,0,0,0,0,65
8,15,5,19,8,9,14,0,0,78
8,15,7,0,0,0,0,0,0,30
8,15,7,1,0,0,0,0,0,31
8,15,7,1,14,19,0,0,0,64
8,15,7,2,1,3,11,0,0,47
8,15,7,2,1,3,11,19,0,66
8,15,7,2,21,19,8,0,0,80
8,15,7,3,8,15,11,5,18,90
8,15,7,3,15,20,5,0,0,73
8,15,7,6,9,19,8,0,0,72
8,15,7,6,9,19,8,5,19,96
8,15,7,6,18,1,13,5,0,73
8,15,7,7,1,19,20,5,18,100
8,15,7,7,5,4,0,0,0,46
8,15,7,7,5,5,0,0,0,47
8,15,7,7,5,18,0,0,0,60
8,15,7,7,5,18,5,12,0,77
8,15,7,7,5,18,25,0,0,85
8,15,7,7,5,18,9,5,19,93
8,15,7,7,5,18,19,0,0,79
8,15,7,7,5,20,0,0,0,62
8,15,7,7,5,20,19,0,0,81
8,15,7,7,25,0,0,0,0,62
8,15,7,7,9,5,0,0,0,51
8,15,7,7,9,14,0,0,0,60
8,15,7,7,9,14,7,0,0,67
8,15,7,7,9,14,19,0,0,79
8,15,7,7,9,19,8,0,0,73
8,15,7,7,9,19,8,12,25,110
8,15,7,7,9,19,13,0,0,78
8,15,7,7,12,5,18,0,0,72
8,15,7,7,19,0,0,0,0,56
8,15,7,8,5,1,4,0,0,48
8,15,7,8,5,18,4,0,0,65
8,15,7,8,9,4,5,0,0,56
8,15,7,8,15,15,4,0,0,72
8,15,7,25,1,18,4,0,0,78
8,15,7,12,9,11,5,0,0,67
8,15,7,12,9,14,7,0,0,72
8,15,7,13,1,3,5,0,0,52
8,15,7,13,1,14,1,25,19,103
8,15,7,13,1,14,5,0,0,63
8,15,7,13,1,14,5,19,0,82
8,15,7,13,5,14,1,25,0,88
8,15,7,13,5,14,1,25,19,107
8,15,7,13,15,12,12,25,0,107
8,15,7,14,15,19,5,0,0,83
8,15,7,14,15,19,5,19,0,102
8,15,7,14,21,20,0,0,0,85
8,15,7,14,21,20,19,0,0,104
8,15,7,15,0,0,0,0,0,45
8,15,7,16,5,14,0,0,0,65
8,15,7,18,5,5,22,5,0,85
8,15,7,19,0,0,0,0,0,49
8,15,7,19,8,5,1,4,0,67
8,15,7,19,8,5,1,4,19,86
8,15,7,19,8,9,16,0,0,82
8,15,7,19,11,9,14,0,0,83
8,15,7,19,20,5,5,18,0,97
8,15,7,19,20,25,0,0,0,94
8,15,7,19,21,3,11,5,18,107
8,15,7,20,9,5,0,0,0,64
8,15,7,20,9,5,4,0,0,68
8,15,7,20,9,5,9,14,7,94
8,15,7,20,9,5,19,0,0,83
8,15,7,20,9,9,14,7,0,89
8,15,7,20,25,9,14,7,0,105
8,15,7,20,15,14,0,0,0,79
8,15,7,23,1,18,4,0,0,76
8,15,7,23,1,19,8,0,0,81
8,15,7,23,1,19,8,5,19,105
8,15,7,23,5,5,4,0,0,67
8,15,7,23,5,5,4,19,0,86
8,15,7,23,15,18,20,0,0,106
8,15,8,14,0,0,0,0,0,45
8,15,8,15,0,0,0,0,0,46
8,15,25,1,19,0,0,0,0,68
8,15,9,3,11,0,0,0,0,46
8,15,9,3,11,5,4,0,0,55
8,15,9,3,11,9,14,7,0,76
8,15,9,3,11,19,0,0,0,65
8,15,9,4,5,14,0,0,0,55
8,15,25,4,5,14,0,0,0,71
8,15,9,4,5,14,5,4,0,64
8,15,25,4,5,14,5,4,0,80
8,15,9,4,5,14,9,14,7,85
8,15,25,4,5,14,9,14,7,101
8,15,9,4,5,14,9,19,8,91
8,15,25,4,5,14,9,19,8,107
8,15,25,4,5,14,9,19,13,112
8,15,9,4,5,14,19,0,0,74
8,15,25,4,5,14,19,0,0,90
8,15,9,8,5,18,5,0,0,68
8,15,25,12,5,19,0,0,0,84
8,15,25,13,1,14,0,0,0,76
8,15,9,14,0,0,0,0,0,46
8,15,25,19,0,0,0,0,0,67
8,15,9,19,5,0,0,0,0,56
8,15,9,19,5,4,0,0,0,60
8,15,9,19,5,19,0,0,0,75
8,15,9,19,9,14,7,0,0,81
8,15,9,19,20,0,0,0,0,71
8,15,9,19,20,1,23,1,25,121
8,15,9,19,20,5,4,0,0,80
8,15,9,19,20,5,18,0,0,94
8,15,9,19,20,5,18,19,0,113
8,15,9,19,20,9,14,7,0,101
8,15,9,19,20,13,1,14,0,99
8,15,9,19,20,19,0,0,0,90
8,15,9,19,20,23,1,25,0,120
8,15,9,20,0,0,0,0,0,52
8,15,10,21,0,0,0,0,0,54
8,15,11,5,0,0,0,0,0,39
8,15,11,5,4,0,0,0,0,43
8,15,11,5,25,0,0,0,0,64
8,15,11,5,25,14,5,19,19,121
8,15,11,5,18,0,0,0,0,57
8,15,11,5,18,5,18,0,0,80
8,15,11,5,18,12,25,0,0,94
8,15,11,5,19,0,0,0,0,58
8,15,11,9,5,18,0,0,0,66
8,15,11,9,5,19,20,0,0,87
8,15,11,9,12,25,0,0,0,80
8,15,11,9,14,5,19,19,0,100
8,15,11,9,14,7,0,0,0,64
8,15,11,25,16,15,11,25,0,126
8,15,11,11,21,0,0,0,0,66
8,15,11,21,13,0,0,0,0,68
8,15,11,21,13,19,0,0,0,87
8,15,12,1,7,15,7,21,5,91
8,15,12,1,14,4,18,25,0,97
8,15,12,1,14,4,18,9,3,84
8,15,12,1,18,4,0,0,0,58
8,15,12,1,18,4,19,0,0,77
8,15,12,3,1,4,0,0,0,43
8,15,12,3,15,4,15,14,20,106
8,15,12,4,0,0,0,0,0,39
8,15,12,4,1,2,12,5,0,59
8,15,12,4,1,12,12,0,0,64
8,15,12,4,1,12,12,19,0,83
8,15,12,4,2,1,3,11,0,56
8,15,12,4,2,1,3,11,19,75
8,15,12,4,5,14,9,20,5,92
8,15,12,4,5,18,19,0,0,81
8,15,12,4,6,1,19,20,0,85
8,15,12,4,6,1,19,20,19,104
8,15,12,4,9,14,7,0,0,69
8,15,12,4,9,14,7,12,25,106
8,15,12,4,9,14,7,19,0,88
8,15,12,4,13,1,14,0,0,67
8,15,12,4,15,21,20,0,0,95
8,15,12,4,15,21,20,19,0,114
8,15,12,4,15,22,5,18,0,99
8,15,12,4,15,22,5,18,19,118
8,15,12,4,19,13,1,14,0,86
8,15,12,4,21,16,0,0,0,76
8,15,12,4,21,16,19,0,0,95
8,15,12,5,1,2,12,5,0,60
8,15,12,5,4,0,0,0,0,44
8,15,12,5,12,5,19,19,0,95
8,15,12,5,13,1,14,0,0,68
8,15,12,5,16,18,15,15,6,110
8,15,12,5,18,0,0,0,0,58
8,15,12,5,19,0,0,0,0,59
8,15,12,5,20,8,14,9,3,94
8,15,12,5,20,8,14,15,19,116
8,15,12,5,23,15,18,20,0,116
8,15,12,7,1,20,5,0,0,68
8,15,12,25,0,0,0,0,0,60
8,15,12,9,1,0,0,0,0,45
8,15,12,9,2,21,20,0,0,87
8,15,12,9,2,21,20,19,0,106
8,15,12,25,4,1,25,0,0,90
8,15,12,9,4,1,25,5,4,83
8,15,12,9,4,1,25,5,18,97
8,15,12,9,4,1,25,19,0,93
8,15,12,25,4,1,25,19,0,109
8,15,12,9,4,1,13,0,0,62
8,15,12,9,5,18,0,0,0,67
8,15,12,9,5,19,0,0,0,68
8,15,12,9,5,19,20,0,0,88
8,15,12,9,12,25,0,0,0,81
8,15,12,9,14,7,0,0,0,65
8,15,12,9,14,9,7,8,20,102
8,15,12,9,19,8,11,5,19,106
8,15,12,9,19,13,0,0,0,76
8,15,12,9,19,13,19,0,0,95
8,15,12,9,19,20,0,0,0,83
8,15,12,9,19,20,9,3,0,95
8,15,12,25,19,20,15,14,5,133
8,15,12,9,19,20,19,0,0,102
8,15,12,25,20,9,4,5,0,98
8,15,12,25,20,9,4,5,19,117
8,15,12,11,0,0,0,0,0,46
8,15,12,11,5,4,0,0,0,55
8,15,12,11,9,14,7,0,0,76
8,15,12,11,19,0,0,0,0,65
8,15,12,12,0,0,0,0,0,47
8,15,12,12,1,0,0,0,0,48
8,15,12,12,1,5,4,0,0,57
8,15,12,12,1,9,14,7,0,78
8,15,12,12,1,9,20,5,0,82
8,15,12,12,1,19,0,0,0,67
8,15,12,12,5,11,5,0,0,68
8,15,12,12,5,18,0,0,0,70
8,15,12,12,5,18,5,4,0,79
8,15,12,12,5,18,9,14,7,100
8,15,12,12,5,18,19,0,0,89
8,15,12,12,9,5,19,0,0,80
8,15,12,12,25,8,15,3,11,109
8,15,12,12,25,12,5,1,6,96
8,15,12,12,9,14,0,0,0,70
8,15,12,12,9,16,5,18,0,95
8,15,12,12,15,0,0,0,0,62
8,15,12,12,15,1,0,0,0,63
8,15,12,12,15,1,5,4,0,72
8,15,12,12,15,1,9,14,7,93
8,15,12,12,15,1,19,0,0,82
8,15,12,12,15,3,11,0,0,76
8,15,12,12,15,5,4,0,0,71
8,15,12,12,15,5,19,0,0,86
8,15,12,12,15,9,14,7,0,92
8,15,12,12,15,14,7,0,0,83
8,15,12,12,15,15,0,0,0,77
8,15,12,12,15,15,5,4,0,86
8,15,12,12,15,15,9,14,7,107
8,15,12,12,15,15,19,0,0,96
8,15,12,12,15,19,0,0,0,81
8,15,12,12,15,23,0,0,0,85
8,15,12,12,15,23,1,18,5,109
8,15,12,12,15,23,5,4,0,94
8,15,12,12,15,23,5,18,0,108
8,15,12,12,15,23,5,19,20,129
8,15,12,12,15,23,9,14,7,115
8,15,12,12,15,23,12,25,0,122
8,15,12,12,15,23,19,0,0,104
8,15,12,13,2,5,18,18,25,116
8,15,12,13,7,1,14,7,0,77
8,15,12,13,9,1,0,0,0,58
8,15,12,13,9,3,0,0,0,60
8,15,12,13,9,21,13,0,0,91
8,15,12,13,9,21,13,19,0,110
8,15,12,13,15,19,0,0,0,82
8,15,12,15,3,1,21,19,20,114
8,15,12,15,3,18,9,14,5,99
8,15,12,15,7,1,13,25,0,96
8,15,12,15,7,25,14,25,0,121
8,15,12,15,7,25,14,9,3,108
8,15,12,15,7,18,1,13,0,89
8,15,12,15,7,18,1,13,19,108
8,15,12,15,7,18,1,16,8,100
8,15,12,15,8,5,4,18,25,110
8,15,12,15,11,21,0,0,0,82
8,15,12,15,12,9,20,8,0,99
8,15,12,15,13,5,20,5,18,111
8,15,12,15,13,15,18,16,8,120
8,15,12,15,16,8,25,20,5,124
8,15,12,15,16,8,15,20,5,114
8,15,12,15,16,20,9,3,0,98
8,15,12,15,19,3,15,16,5,108
8,15,12,15,19,9,4,5,0,87
8,15,12,15,19,20,5,1,14,109
8,15,12,15,19,20,15,13,5,122
8,15,12,15,20,25,16,5,0,116
8,15,12,15,20,25,16,5,19,135
8,15,12,15,20,25,16,9,3,123
8,15,12,15,20,15,14,25,0,124
8,15,12,15,20,15,14,9,1,109
8,15,12,15,20,15,14,9,3,111
8,15,12,15,20,18,9,3,8,108
8,15,12,15,21,18,0,0,0,89
8,15,12,15,26,15,9,3,0,103
8,15,12,16,0,0,0,0,0,51
8,15,12,16,5,14,0,0,0,70
8,15,12,19,0,0,0,0,0,54
8,15,12,19,15,13,0,0,0,82
8,15,12,19,20,5,9,14,19,121
8,15,12,19,20,5,18,0,0,97
8,15,12,19,20,5,18,5,4,106
8,15,12,19,20,5,18,19,0,116
8,15,12,20,19,0,0,0,0,74
8,15,12,23,0,0,0,0,0,58
8,15,13,1,3,1,14,20,8,83
8,15,13,1,7,5,0,0,0,49
8,15,13,1,7,5,4,0,0,53
8,15,13,1,7,5,18,0,0,67
8,15,13,1,7,5,18,19,0,86
8,15,13,1,7,5,19,0,0,68
8,15,13,1,7,9,14,7,0,74
8,15,13,1,7,9,21,13,0,87
8,15,13,1,12,15,9,4,0,77
8,15,13,1,18,4,0,0,0,59
8,15,13,1,18,9,14,5,0,83
8,15,13,1,18,15,9,4,0,83
8,15,13,1,20,15,13,9,3,97
8,15,13,1,24,9,1,12,0,83
8,15,13,1,24,15,14,9,3,102
8,15,13,2,18,5,0,0,0,61
8,15,13,2,18,5,19,0,0,80
8,15,13,2,21,18,7,19,0,103
8,15,13,5,2,15,4,25,0,87
8,15,13,5,2,15,18,14,0,90
8,15,13,5,2,15,21,14,4,97
8,15,13,5,2,18,5,4,0,70
8,15,13,5,2,18,5,4,19,89
8,15,13,5,2,18,5,23,0,89
8,15,13,5,2,21,9,12,4,89
8,15,13,5,3,15,13,5,0,77
8,15,13,5,3,15,13,5,18,95
8,15,13,5,3,18,1,6,20,89
8,15,13,5,3,18,15,6,20,103
8,15,13,5,4,0,0,0,0,45
8,15,13,5,6,1,18,5,18,89
8,15,13,5,6,1,18,13,0,79
8,15,13,5,6,5,12,20,0,84
8,15,13,5,6,15,12,11,0,85
8,15,13,5,6,15,12,11,19,104
8,15,13,5,7,15,5,18,0,86
8,15,13,5,7,18,15,23,14,118
8,15,13,5,25,0,0,0,0,66
8,15,13,5,25,14,5,19,19,123
8,15,13,5,12,1,14,4,0,72
8,15,13,5,12,1,14,4,19,91
8,15,13,5,12,5,19,19,0,96
8,15,13,5,12,5,20,0,0,78
8,15,13,5,12,25,0,0,0,78
8,15,13,5,12,9,5,18,0,85
8,15,13,5,12,9,5,19,20,106
8,15,13,5,12,9,6,5,0,73
8,15,13,5,12,9,11,5,0,78
8,15,13,5,12,9,12,25,0,99
8,15,13,5,12,25,14,0,0,92
8,15,13,5,12,9,14,7,0,83
8,15,13,5,13,1,4,5,0,64
8,15,13,5,13,1,11,5,0,71
8,15,13,5,13,1,11,5,18,89
8,15,13,5,15,9,4,0,0,69
8,15,13,5,15,9,4,1,12,82
8,15,13,5,15,16,1,20,8,101
8,15,13,5,15,19,9,19,0,103
8,15,13,5,15,20,9,3,0,88
8,15,13,5,15,20,25,16,5,122
8,15,13,5,15,23,14,0,0,93
8,15,13,5,15,23,14,5,18,116
8,15,13,5,15,26,15,9,3,109
8,15,13,5,16,12,1,3,5,78
8,15,13,5,18,5,4,0,0,68
8,15,13,5,18,9,14,7,0,89
8,15,13,5,18,9,20,5,0,93
8,15,13,5,18,15,15,13,0,102
8,15,13,5,18,15,15,13,19,121
8,15,13,5,18,19,0,0,0,78
8,15,13,5,19,0,0,0,0,60
8,15,13,5,19,9,3,11,0,83
8,15,13,5,19,9,20,5,0,94
8,15,13,5,19,9,20,5,19,113
8,15,13,5,19,15,13,5,0,93
8,15,13,5,19,16,21,14,0,111
8,15,13,5,19,16,21,14,19,130
8,15,13,5,19,20,1,25,0,106
8,15,13,5,19,20,1,12,12,105
8,15,13,5,19,20,5,18,0,103
8,15,13,5,20,15,23,14,19,132
8,15,13,5,23,1,18,4,0,87
8,15,13,5,23,1,18,4,19,106
8,15,13,5,23,15,18,11,0,108
8,15,13,5,23,15,18,11,19,127
8,15,13,5,23,15,18,20,0,117
8,15,13,25,0,0,0,0,0,61
8,15,13,9,3,9,4,1,12,74
8,15,13,9,3,9,4,5,0,66
8,15,13,9,3,9,4,5,19,85
8,15,13,9,5,18,0,0,0,68
8,15,13,9,5,19,20,0,0,89
8,15,13,9,6,15,18,13,0,97
8,15,13,9,12,5,20,5,0,87
8,15,13,9,12,5,20,9,3,94
8,15,13,9,12,25,0,0,0,82
8,15,13,9,12,9,1,18,25,110
8,15,13,9,12,9,5,19,0,90
8,15,13,9,12,9,19,20,0,105
8,15,13,9,12,9,19,20,19,124
8,15,13,9,12,9,20,5,0,91
8,15,13,9,12,9,26,5,0,97
8,15,13,9,14,1,12,0,0,72
8,15,13,9,14,5,13,0,0,77
8,15,13,9,14,5,19,0,0,83
8,15,13,9,14,5,19,19,0,102
8,15,13,9,14,7,0,0,0,66
8,15,13,9,14,9,1,14,19,102
8,15,13,9,14,9,4,0,0,72
8,15,13,9,14,9,4,19,0,91
8,15,13,9,14,9,5,19,0,92
8,15,13,9,14,9,6,25,0,99
8,15,13,9,14,9,14,5,0,87
8,15,13,9,14,9,26,5,0,99
8,15,13,9,14,9,26,5,4,103
8,15,13,9,14,15,9,4,0,87
8,15,13,9,14,15,9,4,19,106
8,15,13,9,19,8,0,0,0,72
8,15,13,13,1,3,11,0,0,64
8,15,13,13,1,7,5,0,0,62
8,15,13,13,5,0,0,0,0,54
8,15,13,13,15,3,11,0,0,78
8,15,13,13,15,3,11,19,0,97
8,15,13,13,15,19,0,0,0,83
8,15,13,13,15,19,5,19,0,107
8,15,13,15,2,1,18,9,3,84
8,15,13,15,2,18,15,14,20,120
8,15,13,15,3,5,18,3,0,80
8,15,13,15,3,5,18,3,25,105
8,15,13,15,3,25,3,12,5,99
8,15,13,15,3,12,9,14,5,94
8,15,13,15,4,5,18,13,25,116
8,15,13,15,4,25,14,5,0,99
8,15,13,15,4,15,14,20,0,104
8,15,13,15,4,15,24,0,0,94
8,15,13,15,4,18,15,13,5,106
8,15,13,15,4,18,15,13,25,126
8,15,13,15,5,15,9,4,0,84
8,15,13,15,5,15,19,9,19,118
8,15,13,15,5,15,20,5,12,108
8,15,13,15,5,15,20,9,3,103
8,15,13,15,7,1,13,25,0,97
8,15,13,15,7,1,13,9,3,84
8,15,13,15,7,5,14,0,0,77
8,15,13,15,7,5,14,5,0,82
8,15,13,15,7,5,14,25,0,102
8,15,13,15,7,5,14,9,3,89
8,15,13,15,7,12,15,20,0,105
8,15,13,15,7,15,14,5,0,92
8,15,13,15,7,15,14,25,0,112
8,15,13,15,7,18,1,6,20,103
8,15,13,15,7,18,1,16,8,101
8,15,13,15,12,25,19,9,14,130
8,15,13,15,12,25,19,9,19,135
8,15,13,15,12,25,20,9,3,120
8,15,13,15,12,15,7,0,0,85
8,15,13,15,12,15,7,1,12,98
8,15,13,15,12,15,7,25,0,110
8,15,13,15,12,15,7,9,3,97
8,15,13,15,12,15,7,15,14,114
8,15,13,15,12,15,7,19,0,104
8,15,13,15,12,15,7,21,5,111
8,15,13,15,13,5,18,1,12,100
8,15,13,15,13,15,18,16,8,121
8,15,13,15,14,9,4,0,0,78
8,15,13,15,14,25,13,0,0,103
8,15,13,15,14,25,13,25,0,128
8,15,13,15,14,25,13,9,3,115
8,15,13,15,14,25,13,19,0,122
8,15,13,15,14,15,13,25,0,118
8,15,13,15,15,21,19,9,1,116
8,15,13,15,16,1,20,8,25,121
8,15,13,15,16,1,21,19,5,113
8,15,13,15,16,8,5,14,5,99
8,15,13,15,16,8,9,12,5,101
8,15,13,15,16,8,25,12,25,137
8,15,13,15,16,8,15,14,5,109
8,15,13,15,16,8,15,14,25,129
8,15,13,15,16,12,1,19,25,124
8,15,13,15,16,12,1,19,20,119
8,15,13,15,16,15,12,1,18,113
8,15,13,15,16,15,12,9,3,106
8,15,13,15,16,20,5,18,0,110
8,15,13,15,19,0,0,0,0,70
8,15,13,15,19,5,24,0,0,99
8,15,13,15,19,16,15,18,25,144
8,15,13,15,19,20,25,12,25,152
8,15,13,15,20,1,20,9,3,104
8,15,13,15,20,1,24,25,0,121
8,15,13,15,20,1,24,9,1,106
8,15,13,15,20,1,24,9,3,108
8,15,13,15,20,1,24,9,19,124
8,15,13,15,20,8,5,18,13,115
8,15,13,15,20,8,5,20,25,129
8,15,13,15,20,25,16,1,12,125
8,15,13,15,20,25,16,5,0,117
8,15,13,15,20,25,16,25,0,137
8,15,13,15,20,25,16,9,3,124
8,15,13,15,20,15,14,25,0,125
8,15,13,15,20,15,14,9,3,112
8,15,13,15,20,15,16,25,0,127
8,15,13,15,20,15,16,9,3,114
8,15,13,15,21,19,9,1,14,115
8,15,13,18,1,9,0,0,0,64
8,15,13,21,14,3,9,15,0,98
8,15,13,21,14,3,12,5,0,91
8,15,13,21,14,3,21,12,5,112
8,15,13,21,14,3,21,12,9,116
8,15,14,1,14,19,0,0,0,71
8,15,14,3,8,15,0,0,0,63
8,15,14,3,8,15,5,4,0,72
8,15,14,3,8,15,19,0,0,82
8,15,14,4,1,19,0,0,0,61
8,15,14,4,12,5,0,0,0,58
8,15,14,4,12,5,4,0,0,62
8,15,14,4,12,5,19,0,0,77
8,15,14,4,12,9,14,7,0,83
8,15,14,4,21,18,1,14,19,114
8,15,14,5,0,0,0,0,0,42
8,15,14,5,4,0,0,0,0,46
8,15,14,5,25,2,5,5,0,79
8,15,14,5,25,2,5,5,19,98
8,15,14,5,25,2,9,14,4,96
8,15,14,5,25,2,12,15,2,98
8,15,14,5,25,2,21,14,0,104
8,15,14,5,25,2,21,14,19,123
8,15,14,5,25,3,15,13,2,100
8,15,14,5,25,3,21,16,0,107
8,15,14,5,25,4,5,23,0,99
8,15,14,5,25,4,5,23,19,118
8,15,14,5,25,4,18,15,16,120
8,15,14,5,25,5,4,0,0,76
8,15,14,5,25,5,4,12,25,113
8,15,14,5,25,6,1,12,12,98
8,15,14,5,25,6,21,12,0,106
8,15,14,5,25,9,14,7,0,97
8,15,14,5,25,12,5,19,19,122
8,15,14,5,25,12,9,11,5,104
8,15,14,5,25,13,15,15,14,124
8,15,14,5,25,16,15,4,0,102
8,15,14,5,25,16,15,20,0,118
8,15,14,5,25,19,0,0,0,86
8,15,14,5,25,19,21,3,11,121
8,15,14,5,25,23,1,18,5,114
8,15,14,5,25,23,15,18,20,143
8,15,14,5,18,0,0,0,0,60
8,15,14,5,18,19,0,0,0,79
8,15,14,5,19,0,0,0,0,61
8,15,14,5,19,20,0,0,0,81
8,15,14,5,19,20,5,18,0,104
8,15,14,5,19,20,5,19,20,125
8,15,14,5,19,20,5,20,5,111
8,15,14,5,19,20,25,0,0,106
8,15,14,5,19,20,9,5,19,114
8,15,14,5,19,20,12,25,0,118
8,15,14,5,19,20,15,14,5,115
8,15,14,5,23,15,18,20,0,118
8,15,14,5,23,15,18,20,19,137
8,15,14,7,11,15,14,7,0,91
8,15,14,7,19,0,0,0,0,63
8,15,14,9,5,4,0,0,0,55
8,15,14,9,12,25,0,0,0,83
8,15,14,9,14,7,0,0,0,67
8,15,14,11,0,0,0,0,0,48
8,15,14,11,5,4,0,0,0,57
8,15,14,11,5,25,0,0,0,78
8,15,14,11,5,25,19,0,0,97
8,15,14,11,5,18,0,0,0,71
8,15,14,11,5,18,19,0,0,90
8,15,14,11,25,0,0,0,0,73
8,15,14,11,9,5,0,0,0,62
8,15,14,11,9,5,19,0,0,81
8,15,14,11,9,14,7,0,0,78
8,15,14,11,19,0,0,0,0,67
8,15,14,15,18,1,2,12,5,90
8,15,14,15,18,1,2,12,25,110
8,15,14,15,18,1,14,3,5,93
8,15,14,15,18,1,14,4,0,89
8,15,14,15,18,1,14,4,19,108
8,15,14,15,18,1,18,25,0,114
8,15,14,15,18,1,18,9,1,99
8,15,14,15,18,5,4,0,0,79
8,15,14,15,18,5,5,0,0,80
8,15,14,15,18,5,5,19,0,99
8,15,14,15,18,5,18,0,0,93
8,15,14,15,18,5,18,19,0,112
8,15,14,15,18,5,19,19,0,113
8,15,14,15,18,9,6,9,3,97
8,15,14,15,18,9,14,7,0,100
8,15,14,15,18,12,5,19,19,125
8,15,14,15,18,15,21,19,0,125
8,15,14,15,18,19,0,0,0,89
8,15,14,15,18,19,13,1,14,117
8,15,14,15,21,18,5,4,0,100
8,15,14,15,21,18,5,18,0,114
8,15,14,15,21,18,5,18,19,133
8,15,14,15,21,18,9,14,7,121
8,15,14,15,21,18,19,0,0,110
8,15,14,20,0,0,0,0,0,57
8,15,14,20,9,19,8,0,0,93
8,15,14,20,15,21,19,0,0,112
8,15,14,26,15,0,0,0,0,78
8,15,15,3,8,5,19,0,0,73
8,15,15,3,8,9,14,15,15,102
8,15,15,4,0,0,0,0,0,42
8,15,15,4,3,1,16,0,0,62
8,15,15,4,5,4,0,0,0,51
8,15,15,4,6,21,12,0,0,81
8,15,15,4,25,0,0,0,0,67
8,15,15,4,9,5,0,0,0,56
8,15,15,4,9,5,19,0,0,75
8,15,15,4,9,14,7,0,0,72
8,15,15,4,12,5,0,0,0,59
8,15,15,4,12,5,19,19,0,97
8,15,15,4,12,9,11,5,0,79
8,15,15,4,12,21,13,0,0,88
8,15,15,4,12,21,13,19,0,107
8,15,15,4,13,1,14,0,0,70
8,15,15,4,13,5,14,0,0,74
8,15,15,4,13,15,12,4,0,86
8,15,15,4,15,5,19,0,0,81
8,15,15,4,15,15,0,0,0,72
8,15,15,4,15,15,5,4,0,81
8,15,15,4,15,15,9,14,7,102
8,15,15,4,15,15,9,19,13,113
8,15,15,4,15,15,19,0,0,91
8,15,15,4,19,0,0,0,0,61
8,15,15,4,19,8,5,1,6,81
8,15,15,4,19,8,25,0,0,94
8,15,15,4,23,9,14,11,0,99
8,15,15,4,23,9,14,11,19,118
8,15,15,4,23,9,19,5,0,98
8,15,15,4,23,15,18,20,0,118
8,15,15,5,25,0,0,0,0,68
8,15,15,5,25,19,0,0,0,87
8,15,15,6,0,0,0,0,0,44
8,15,15,6,2,5,1,20,0,72
8,15,15,6,2,5,1,20,19,91
8,15,15,6,2,15,21,14,4,100
8,15,15,6,5,4,0,0,0,53
8,15,15,6,5,18,0,0,0,67
8,15,15,6,5,18,19,0,0,86
8,15,15,6,25,0,0,0,0,69
8,15,15,6,9,14,5,19,19,110
8,15,15,6,9,14,7,0,0,74
8,15,15,6,9,19,8,0,0,80
8,15,15,6,12,5,19,19,0,99
8,15,15,6,12,5,20,0,0,81
8,15,15,6,12,9,11,5,0,81
8,15,15,6,13,1,18,11,0,87
8,15,15,6,13,1,18,11,19,106
8,15,15,6,16,18,9,14,20,121
8,15,15,6,18,15,20,0,0,97
8,15,15,6,19,0,0,0,0,63
8,15,15,6,23,15,18,13,0,113
8,15,15,7,1,1,18,19,0,84
8,15,15,25,5,0,0,0,0,68
8,15,15,11,1,0,0,0,0,50
8,15,15,11,1,8,0,0,0,58
8,15,15,11,1,8,19,0,0,77
8,15,15,11,1,18,15,15,14,112
8,15,15,11,1,19,0,0,0,69
8,15,15,11,3,8,5,3,11,79
8,15,15,11,5,4,0,0,0,58
8,15,15,11,5,25,0,0,0,79
8,15,15,11,5,25,19,0,0,98
8,15,15,11,5,18,13,1,14,100
8,15,15,11,5,18,19,0,0,91
8,15,15,11,8,5,1,12,0,75
8,15,15,11,25,0,0,0,0,74
8,15,15,11,9,5,18,0,0,81
8,15,15,11,9,5,19,0,0,82
8,15,15,11,9,5,19,20,0,102
8,15,15,11,9,14,7,0,0,79
8,15,15,11,9,19,8,0,0,85
8,15,15,11,12,1,14,4,0,80
8,15,15,11,12,5,19,19,0,104
8,15,15,11,12,5,20,0,0,86
8,15,15,11,12,5,20,19,0,105
8,15,15,11,12,9,11,5,0,86
8,15,15,11,13,1,11,5,18,97
8,15,15,11,13,1,14,0,0,77
8,15,15,11,14,15,19,5,0,102
8,15,15,11,14,15,19,5,19,121
8,15,15,11,19,8,15,16,0,107
8,15,15,11,19,13,9,20,8,118
8,15,15,11,20,9,16,0,0,94
8,15,15,11,21,13,0,0,0,83
8,15,15,11,21,16,0,0,0,86
8,15,15,11,21,16,19,0,0,105
8,15,15,11,21,16,21,0,0,107
8,15,15,11,23,5,5,4,0,86
8,15,15,11,23,9,19,5,0,105
8,15,15,11,23,15,18,13,0,118
8,15,15,11,23,15,18,13,25,143
8,15,15,11,23,15,18,13,19,137
8,15,15,12,0,0,0,0,0,50
8,15,15,12,1,11,9,14,0,85
8,15,15,12,1,21,12,5,1,90
8,15,15,12,5,5,0,0,0,60
8,15,15,12,5,25,0,0,0,80
8,15,15,12,25,0,0,0,0,75
8,15,15,12,9,5,0,0,0,64
8,15,15,12,9,7,1,14,0,81
8,15,15,12,9,7,1,14,19,100
8,15,15,12,9,8,1,14,0,82
8,15,15,12,15,3,11,0,0,79
8,15,15,13,0,0,0,0,0,51
8,15,15,14,4,5,5,0,0,66
8,15,15,14,4,9,0,0,0,65
8,15,15,16,0,0,0,0,0,54
8,15,15,16,5,4,0,0,0,63
8,15,15,16,5,18,13,1,14,105
8,15,15,16,5,18,19,0,0,96
8,15,15,16,9,14,7,0,0,84
8,15,15,16,12,1,0,0,0,67
8,15,15,16,12,1,19,0,0,86
8,15,15,16,12,5,19,19,0,109
8,15,15,16,12,9,11,5,0,91
8,15,15,16,13,1,11,5,18,102
8,15,15,16,13,1,14,0,0,82
8,15,15,16,13,5,14,0,0,86
8,15,15,16,15,5,0,0,0,74
8,15,15,16,15,5,19,0,0,93
8,15,15,16,15,15,0,0,0,84
8,15,15,16,15,15,19,0,0,103
8,15,15,16,19,0,0,0,0,73
8,15,15,16,19,11,9,18,20,131
8,15,15,16,19,20,5,18,0,116
8,15,15,16,19,20,5,18,19,135
8,15,15,16,19,20,9,3,11,116
8,15,15,16,23,15,15,4,0,111
8,15,15,18,1,8,0,0,0,65
8,15,15,18,1,8,5,4,0,74
8,15,15,18,1,8,9,14,7,95
8,15,15,18,1,8,19,0,0,84
8,15,15,18,1,25,0,0,0,82
8,15,15,18,1,25,5,4,0,91
8,15,15,18,1,25,9,14,7,112
8,15,15,18,1,25,19,0,0,101
8,15,15,18,15,15,0,0,0,86
8,15,15,18,15,15,19,8,0,113
8,15,15,19,5,0,0,0,0,62
8,15,15,19,5,7,15,23,0,107
8,15,15,19,5,7,15,23,19,126
8,15,15,19,7,15,23,0,0,102
8,15,15,19,7,15,23,19,0,121
8,15,15,19,8,0,0,0,0,65
8,15,15,19,9,5,18,19,0,108
8,15,15,20,0,0,0,0,0,58
8,15,15,20,1,25,0,0,0,84
8,15,15,20,3,8,0,0,0,69
8,15,15,20,3,8,5,19,0,93
8,15,15,20,5,4,0,0,0,67
8,15,15,20,5,18,0,0,0,81
8,15,15,20,5,18,19,0,0,100
8,15,15,20,25,0,0,0,0,83
8,15,15,20,9,5,18,0,0,90
8,15,15,20,9,5,19,20,0,111
8,15,15,20,9,14,7,0,0,88
8,15,15,20,9,14,7,12,25,125
8,15,15,20,19,0,0,0,0,77
8,15,15,22,5,0,0,0,0,65
8,15,15,22,5,4,0,0,0,69
8,15,15,22,5,25,0,0,0,90
8,15,15,22,5,19,0,0,0,84
8,15,16,0,0,0,0,0,0,39
8,15,16,1,11,0,0,0,0,51
8,15,16,2,9,14,4,0,0,68
8,15,16,2,9,14,5,0,0,69
8,15,16,2,21,19,8,0,0,89
8,15,16,3,18,5,1,19,5,90
8,15,16,5,4,0,0,0,0,48
8,15,16,5,6,21,12,0,0,83
8,15,16,5,6,21,12,12,25,120
8,15,16,5,6,21,12,19,0,102
8,15,16,5,9,20,5,0,0,78
8,15,16,5,12,5,19,19,0,99
8,15,16,5,18,0,0,0,0,62
8,15,16,5,18,19,0,0,0,81
8,15,16,5,19,0,0,0,0,63
8,15,16,8,5,1,4,0,0,57
8,15,16,8,5,1,4,19,0,76
8,15,16,25,1,18,4,0,0,87
8,15,16,9,14,7,0,0,0,69
8,15,16,9,14,7,12,25,0,106
8,15,16,12,9,20,5,0,0,85
8,15,16,12,9,20,5,19,0,104
8,15,16,12,9,20,9,3,0,92
8,15,16,12,15,12,15,7,25,125
8,15,16,15,6,6,0,0,0,66
8,15,16,16,5,4,0,0,0,64
8,15,16,16,5,18,3,1,18,100
8,15,16,16,5,18,13,1,14,106
8,15,16,16,5,18,19,0,0,97
8,15,16,16,5,20,0,0,0,80
8,15,16,16,25,0,0,0,0,80
8,15,16,16,9,14,7,0,0,85
8,15,16,16,9,14,7,12,25,122
8,15,16,16,9,20,25,0,0,109
8,15,16,16,25,20,15,1,4,120
8,15,16,16,12,5,0,0,0,72
8,15,16,16,12,5,4,0,0,76
8,15,16,16,12,5,19,0,0,91
8,15,16,16,12,9,14,7,0,97
8,15,16,16,15,0,0,0,0,70
8,15,16,19,0,0,0,0,0,58
8,15,16,19,1,3,11,0,0,73
8,15,16,19,1,3,11,19,0,92
8,15,16,19,1,7,5,0,0,71
8,15,16,19,3,15,20,3,8,107
8,15,16,20,8,21,13,2,0,103
8,15,16,20,15,1,4,0,0,79
8,15,16,20,15,1,4,19,0,98
8,15,16,20,18,5,5,0,0,87
8,15,16,22,9,14,5,0,0,89
8,15,18,0,0,0,0,0,0,41
8,15,18,1,0,0,0,0,0,42
8,15,18,1,8,0,0,0,0,50
8,15,18,1,8,19,0,0,0,69
8,15,18,1,12,0,0,0,0,54
8,15,18,1,18,25,0,0,0,85
8,15,18,1,19,0,0,0,0,61
8,15,18,1,20,9,25,5,0,101
8,15,18,1,20,9,15,14,0,100
8,15,18,1,20,15,18,25,0,120
8,15,18,4,1,18,25,0,0,89
8,15,18,4,1,18,9,1,14,88
8,15,18,4,5,0,0,0,0,50
8,15,18,4,5,1,20,5,0,76
8,15,18,4,5,4,0,0,0,54
8,15,18,4,5,9,14,0,0,73
8,15,18,4,5,9,14,19,0,92
8,15,18,4,5,14,9,14,5,92
8,15,18,4,5,15,12,1,0,78
8,15,18,4,5,15,12,21,13,111
8,15,18,4,5,19,0,0,0,69
8,15,18,4,9,14,7,0,0,75
8,15,18,4,15,3,11,0,0,74
8,15,18,5,0,0,0,0,0,46
8,15,18,5,8,15,15,14,4,102
8,15,18,5,8,15,21,14,4,108
8,15,18,25,0,0,0,0,0,66
8,15,18,9,26,15,14,0,0,105
8,15,18,9,26,15,14,1,12,118
8,15,18,9,26,15,14,19,0,124
8,15,18,11,5,25,0,0,0,82
8,15,18,12,1,0,0,0,0,54
8,15,18,13,5,0,0,0,0,59
8,15,18,13,5,20,9,3,0,91
8,15,18,13,9,3,0,0,0,66
8,15,18,13,9,7,15,0,0,85
8,15,18,13,9,15,14,0,0,92
8,15,18,13,9,19,13,0,0,95
8,15,18,13,9,19,20,0,0,102
8,15,18,13,15,7,15,14,0,105
8,15,18,13,15,14,1,12,0,96
8,15,18,13,15,14,5,0,0,88
8,15,18,13,15,14,5,19,0,107
8,15,18,13,15,14,9,3,0,95
8,15,18,13,15,14,9,26,5,123
8,15,18,13,15,14,15,9,4,111
8,15,18,13,15,19,0,0,0,88
8,15,18,14,1,4,1,0,0,61
8,15,18,14,2,5,1,13,0,76
8,15,18,14,2,5,1,13,19,95
8,15,18,14,2,9,12,12,0,90
8,15,18,14,2,9,12,12,19,109
8,15,18,14,2,15,15,11,0,98
8,15,18,14,2,15,15,11,19,117
8,15,18,14,5,4,0,0,0,64
8,15,18,14,5,18,1,8,0,87
8,15,18,14,5,18,15,0,0,93
8,15,18,14,5,20,0,0,0,80
8,15,18,14,5,20,25,0,0,105
8,15,18,14,5,20,19,0,0,99
8,15,18,14,6,1,9,18,0,89
8,15,18,14,6,5,12,19,0,97
8,15,18,14,6,9,19,8,0,97
8,15,18,14,6,21,12,0,0,94
8,15,18,14,7,5,12,4,0,83
8,15,18,14,25,0,0,0,0,80
8,15,18,14,9,5,18,0,0,87
8,15,18,14,9,5,19,20,0,108
8,15,18,14,9,6,25,0,0,95
8,15,18,14,9,6,9,5,4,88
8,15,18,14,25,8,5,1,4,98
8,15,18,14,9,12,25,0,0,101
8,15,18,14,9,14,5,19,19,121
8,15,18,14,9,14,7,0,0,85
8,15,18,14,9,19,8,0,0,91
8,15,18,14,9,19,20,0,0,103
8,15,18,14,9,19,20,19,0,122
8,15,18,14,9,20,15,0,0,99
8,15,18,14,11,5,3,11,0,85
8,15,18,14,12,5,19,19,0,110
8,15,18,14,12,5,20,0,0,92
8,15,18,14,12,9,11,5,0,92
8,15,18,14,13,15,21,20,8,132
8,15,18,14,15,20,9,14,5,118
8,15,18,14,16,9,16,5,0,101
8,15,18,14,16,9,16,5,19,120
8,15,18,14,16,12,1,14,20,118
8,15,18,14,16,15,21,20,0,127
8,15,18,14,16,15,21,20,19,146
8,15,18,14,19,0,0,0,0,74
8,15,18,14,19,12,1,20,5,112
8,15,18,14,19,13,1,14,0,102
8,15,18,14,19,20,1,25,0,120
8,15,18,14,19,20,15,14,5,128
8,15,18,14,20,1,9,12,0,97
8,15,18,14,20,1,9,12,19,116
8,15,18,14,20,8,21,13,2,119
8,15,18,14,20,9,16,0,0,100
8,15,18,14,23,5,5,4,0,92
8,15,18,14,23,15,15,4,0,112
8,15,18,14,23,15,18,11,0,122
8,15,18,14,23,15,18,13,0,124
8,15,18,14,23,15,18,13,19,143
8,15,18,14,23,15,18,20,0,131
8,15,18,14,23,15,18,20,19,150
8,15,18,14,23,18,1,3,11,111
8,15,18,15,7,18,1,16,8,106
8,15,18,15,11,1,11,1,0,80
8,15,18,15,12,0,0,0,0,68
8,15,18,15,12,15,7,5,0,95
8,15,18,15,12,15,7,5,18,113
8,15,18,15,12,15,7,5,19,114
8,15,18,15,12,15,7,25,0,115
8,15,18,15,12,15,7,9,1,100
8,15,18,15,12,15,7,9,3,102
8,15,18,15,12,15,7,21,5,116
8,15,18,15,13,5,20,5,18,117
8,15,18,15,13,5,20,18,25,137
8,15,18,15,16,9,20,15,0,116
8,15,18,15,16,20,5,18,0,115
8,15,18,15,16,20,5,18,25,140
8,15,18,15,19,3,15,16,5,114
8,15,18,15,19,3,15,16,25,134
8,15,18,15,20,5,12,25,0,118
8,15,18,15,20,5,12,9,3,105
8,15,18,18,1,8,0,0,0,68
8,15,18,18,1,25,0,0,0,85
8,15,18,18,1,12,0,0,0,72
8,15,18,18,5,14,20,0,0,98
8,15,18,18,5,21,13,0,0,98
8,15,18,18,25,0,0,0,0,84
8,15,18,18,9,2,12,5,0,87
8,15,18,18,9,2,12,5,19,106
8,15,18,18,9,2,12,25,0,107
8,15,18,18,9,4,0,0,0,72
8,15,18,18,9,4,9,20,25,126
8,15,18,18,9,4,12,25,0,109
8,15,18,18,9,6,25,0,0,99
8,15,18,18,9,6,9,3,0,86
8,15,18,18,9,6,9,5,4,92
8,15,18,18,9,6,9,5,19,107
8,15,18,18,15,18,0,0,0,92
8,15,18,18,15,18,6,21,12,131
8,15,18,18,15,18,9,19,8,128
8,15,18,18,15,18,9,19,20,140
8,15,18,18,15,18,9,26,5,132
8,15,18,18,15,18,15,21,19,147
8,15,18,18,15,18,19,0,0,111
8,15,18,19,0,0,0,0,0,60
8,15,18,19,5,0,0,0,0,65
8,15,18,19,5,2,1,3,11,82
8,15,18,19,5,2,1,14,5,87
8,15,18,19,5,2,5,1,14,87
8,15,18,19,5,2,15,25,0,107
8,15,18,19,5,2,15,24,0,106
8,15,18,19,5,2,21,19,8,115
8,15,18,19,5,3,1,18,0,87
8,15,18,19,5,3,1,18,19,106
8,15,18,19,5,3,1,18,20,107
8,15,18,19,5,4,0,0,0,69
8,15,18,19,5,4,15,13,0,97
8,15,18,19,5,5,19,19,0,108
8,15,18,19,5,6,1,9,18,99
8,15,18,19,5,6,9,19,8,107
8,15,18,19,5,6,12,25,0,108
8,15,18,19,5,6,15,15,20,121
8,15,18,19,5,7,1,20,5,98
8,15,18,19,5,8,1,9,18,101
8,15,18,19,5,8,5,1,4,83
8,15,18,19,5,8,5,1,12,91
8,15,18,19,5,8,5,5,12,95
8,15,18,19,5,8,5,18,4,100
8,15,18,19,5,8,9,4,5,91
8,15,18,19,5,8,15,15,4,107
8,15,18,19,5,8,15,15,6,109
8,15,18,19,5,9,5,18,0,97
8,15,18,19,5,9,5,19,20,118
8,15,18,19,5,12,5,19,19,120
8,15,18,19,5,12,25,0,0,102
8,15,18,19,5,12,9,11,5,102
8,15,18,19,5,12,15,1,4,97
8,15,18,19,5,12,15,3,11,106
8,15,18,19,5,13,1,14,0,93
8,15,18,19,5,13,5,14,0,97
8,15,18,19,5,13,9,14,20,121
8,15,18,19,5,14,1,9,12,101
8,15,18,19,5,16,9,16,5,111
8,15,18,19,5,16,12,1,25,119
8,15,18,19,5,16,15,14,4,114
8,15,18,19,5,16,15,24,0,120
8,15,18,19,5,18,0,0,0,83
8,15,18,19,5,19,0,0,0,84
8,15,18,19,5,19,8,9,20,121
8,15,18,19,5,19,8,15,5,112
8,15,18,19,5,20,1,9,12,107
8,15,18,19,5,20,18,5,5,113
8,15,18,19,5,23,1,25,0,114
8,15,18,19,5,23,5,5,4,102
8,15,18,19,5,23,8,9,16,121
8,15,18,19,5,23,15,15,4,122
8,15,18,19,25,0,0,0,0,85
8,15,18,19,9,5,18,0,0,92
8,15,18,19,9,5,19,20,0,113
8,15,18,19,9,6,25,0,0,100
8,15,18,19,25,9,19,13,0,126
8,15,18,19,9,12,25,0,0,106
8,15,18,19,9,14,5,19,19,126
8,15,18,19,9,14,7,0,0,90
8,15,18,19,20,5,0,0,0,85
8,15,18,19,20,5,19,0,0,104
8,15,18,19,20,19,0,0,0,99
8,15,18,20,1,20,9,15,14,120
8,15,18,20,1,20,9,22,5,118
8,15,18,20,1,20,15,18,0,115
8,15,18,20,1,20,15,18,25,140
8,15,18,20,5,19,9,1,14,109
8,15,18,20,25,1,18,4,0,109
8,15,18,20,9,20,5,0,0,95
8,15,18,20,15,18,9,21,13,137
8,15,18,20,21,12,1,14,0,109
8,15,19,1,14,14,1,0,0,72
8,15,19,1,14,14,1,5,4,81
8,15,19,1,14,14,1,8,0,80
8,15,19,1,14,14,1,19,0,91
8,15,19,5,2,9,18,4,0,80
8,15,19,5,3,15,3,11,0,79
8,15,19,5,4,0,0,0,0,51
8,15,19,5,12,0,0,0,0,59
8,15,19,5,12,5,19,19,0,102
8,15,19,5,12,9,11,5,0,84
8,15,19,5,12,19,0,0,0,78
8,15,19,5,13,1,14,0,0,75
8,15,19,5,14,0,0,0,0,61
8,15,19,5,16,9,16,5,0,93
8,15,19,5,19,0,0,0,0,66
8,15,19,9,5,18,0,0,0,74
8,15,19,9,5,18,25,0,0,99
8,15,19,9,5,18,9,5,19,107
8,15,19,9,5,18,19,0,0,93
8,15,19,9,14,7,0,0,0,72
8,15,19,16,0,0,0,0,0,58
8,15,19,16,9,3,5,0,0,75
8,15,19,16,9,3,5,19,0,94
8,15,19,16,9,20,1,0,0,88
8,15,19,16,9,20,1,7,5,100
8,15,19,16,9,20,1,12,0,100
8,15,19,16,9,20,1,12,19,119
8,15,19,16,9,20,1,14,20,122
8,15,19,16,9,20,1,20,5,113
8,15,19,16,9,20,9,1,0,97
8,15,19,16,9,20,9,21,13,130
8,15,19,16,9,20,9,26,5,127
8,15,19,16,15,4,1,18,0,96
8,15,19,16,15,4,1,18,19,115
8,15,19,19,0,0,0,0,0,61
8,15,19,20,1,7,5,0,0,75
8,15,19,20,1,7,5,4,0,79
8,15,19,20,1,7,5,18,0,93
8,15,19,20,1,7,5,19,0,94
8,15,19,20,1,7,9,14,7,100
8,15,19,20,1,12,0,0,0,75
8,15,19,20,1,19,0,0,0,82
8,15,19,20,5,4,0,0,0,71
8,15,19,20,5,12,0,0,0,79
8,15,19,20,5,12,5,4,0,88
8,15,19,20,5,12,5,18,0,102
8,15,19,20,5,12,5,18,19,121
8,15,19,20,5,12,9,14,7,109
8,15,19,20,5,12,12,5,18,114
8,15,19,20,5,12,18,25,0,122
8,15,19,20,5,12,19,0,0,98
8,15,19,20,5,18,0,0,0,85
8,15,19,20,5,19,19,0,0,105
8,15,19,20,5,19,19,5,4,114
8,15,19,20,5,19,19,5,19,129
8,15,19,20,9,5,0,0,0,76
8,15,19,20,9,12,5,0,0,88
8,15,19,20,9,12,5,25,0,113
8,15,19,20,9,12,5,12,25,125
8,15,19,20,9,12,5,19,0,107
8,15,19,20,9,12,9,20,25,137
8,15,19,20,9,12,9,26,5,123
8,15,19,20,9,14,7,0,0,92
8,15,19,20,12,5,0,0,0,79
8,15,19,20,12,5,18,0,0,97
8,15,19,20,12,5,18,19,0,116
8,15,19,20,12,5,19,19,0,117
8,15,19,20,12,25,0,0,0,99
8,15,19,20,18,25,0,0,0,105
8,15,19,20,19,0,0,0,0,81
8,15,19,20,19,8,9,16,0,114
8,15,20,0,0,0,0,0,0,43
8,15,20,2,5,4,0,0,0,54
8,15,20,2,5,4,19,0,0,73
8,15,20,2,12,15,15,4,0,91
8,15,20,2,12,15,15,4,19,110
8,15,20,2,15,24,0,0,0,84
8,15,20,2,15,24,5,19,0,108
8,15,20,3,1,11,5,0,0,63
8,15,20,3,1,11,5,19,0,82
8,15,20,3,8,0,0,0,0,54
8,15,20,3,8,1,0,0,0,55
8,15,20,3,8,5,4,0,0,63
8,15,20,3,8,5,19,0,0,78
8,15,20,3,8,9,14,7,0,84
8,15,20,3,8,16,15,20,0,105
8,15,20,3,8,16,15,20,19,124
8,15,20,4,15,7,0,0,0,69
8,15,20,4,15,7,7,5,4,85
8,15,20,4,15,7,7,5,18,99
8,15,20,4,15,7,19,0,0,88
8,15,20,5,0,0,0,0,0,48
8,15,20,5,12,0,0,0,0,60
8,15,20,5,12,4,15,13,0,92
8,15,20,5,12,8,15,15,4,102
8,15,20,5,12,9,5,18,0,92
8,15,20,5,12,9,5,18,19,111
8,15,20,5,12,9,26,5,0,100
8,15,20,5,12,12,5,19,19,115
8,15,20,5,12,13,1,14,0,88
8,15,20,5,12,13,5,14,0,92
8,15,20,5,12,19,0,0,0,79
8,15,20,5,12,23,1,18,4,106
8,15,20,6,15,15,20,0,0,99
8,15,20,6,15,15,20,5,4,108
8,15,20,6,15,15,20,19,0,118
8,15,20,8,5,1,4,0,0,61
8,15,20,8,5,1,4,5,4,70
8,15,20,8,5,1,4,19,0,80
8,15,20,8,15,21,19,5,0,111
8,15,20,8,15,21,19,5,19,130
8,15,20,9,0,0,0,0,0,52
8,15,20,11,5,25,0,0,0,84
8,15,20,12,25,0,0,0,0,80
8,15,20,12,9,14,5,0,0,83
8,15,20,12,9,14,5,19,0,102
8,15,20,13,5,12,20,0,0,93
8,15,20,14,5,19,19,0,0,100
8,15,20,14,5,19,19,5,19,124
8,15,20,16,12,1,20,5,0,97
8,15,20,16,15,20,0,0,0,94
8,15,20,16,18,5,19,19,0,120
8,15,20,18,15,4,0,0,0,80
8,15,20,18,15,4,19,0,0,99
8,15,20,19,0,0,0,0,0,62
8,15,20,19,8,15,20,0,0,105
8,15,20,19,8,15,20,19,0,124
8,15,20,19,16,21,18,19,0,136
8,15,20,20,1,0,0,0,0,64
8,15,20,20,5,4,0,0,0,72
8,15,20,20,5,18,0,0,0,86
8,15,20,20,5,18,25,0,0,111
8,15,20,20,5,19,20,0,0,107
8,15,20,20,9,5,0,0,0,77
8,15,20,20,9,14,7,0,0,93
8,15,20,20,9,19,8,0,0,99
8,15,20,20,12,5,0,0,0,80
8,15,20,26,15,14,5,0,0,103
8,15,21,2,1,18,1,0,0,66
8,15,21,4,1,8,0,0,0,57
8,15,21,4,1,8,19,0,0,76
8,15,21,7,8,2,1,14,4,80
8,15,21,7,8,5,18,0,0,82
8,15,21,7,8,9,20,5,0,93
8,15,21,8,5,18,5,0,0,80
8,15,21,12,5,20,0,0,0,81
8,15,21,12,20,0,0,0,0,76
8,15,21,13,15,21,19,0,0,112
8,15,21,14,3,5,0,0,0,66
8,15,21,14,4,5,4,0,0,71
8,15,21,14,4,5,18,0,0,85
8,15,21,14,4,5,18,19,0,104
8,15,21,14,4,6,9,19,8,104
8,15,21,14,4,25,0,0,0,87
8,15,21,14,4,9,14,7,0,92
8,15,21,14,4,9,19,8,0,98
8,15,21,14,4,12,9,11,5,99
8,15,21,14,4,13,1,14,0,90
8,15,21,14,4,19,0,0,0,81
8,15,21,14,19,11,21,12,12,133
8,15,21,18,0,0,0,0,0,62
8,15,21,18,6,21,12,0,0,101
8,15,21,18,7,12,1,19,19,120
8,15,21,18,9,0,0,0,0,71
8,15,21,18,9,19,0,0,0,90
8,15,21,18,12,5,19,19,0,117
8,15,21,18,12,25,0,0,0,99
8,15,21,18,12,15,14,7,0,110
8,15,21,19,1,7,5,0,0,76
8,15,21,19,1,12,0,0,0,76
8,15,21,19,5,2,1,12,12,95
8,15,21,19,5,2,15,1,20,106
8,15,21,19,5,2,15,25,0,110
8,15,21,19,5,2,15,25,19,129
8,15,21,19,5,2,15,20,5,110
8,15,21,19,5,2,21,7,0,98
8,15,21,19,5,3,1,18,12,102
8,15,21,19,5,3,15,1,20,107
8,15,21,19,5,4,0,0,0,72
8,15,21,19,5,6,1,19,20,114
8,15,21,19,5,6,12,25,0,111
8,15,21,19,5,6,21,12,0,107
8,15,21,19,5,6,21,12,19,126
8,15,21,19,5,8,15,12,4,107
8,15,21,19,5,11,5,5,16,105
8,15,21,19,5,11,5,16,20,120
8,15,21,19,5,12,0,0,0,80
8,15,21,19,5,12,5,4,0,89
8,15,21,19,5,12,5,5,11,101
8,15,21,19,5,12,5,19,19,123
8,15,21,19,5,12,5,20,0,105
8,15,21,19,5,12,9,14,5,108
8,15,21,19,5,12,9,14,7,110
8,15,21,19,5,12,12,5,4,101
8,15,21,19,5,12,19,0,0,99
8,15,21,19,5,13,1,9,4,95
8,15,21,19,5,13,1,14,0,96
8,15,21,19,5,13,1,20,5,107
8,15,21,19,5,13,5,14,0,100
8,15,21,19,5,18,15,15,13,129
8,15,21,19,5,18,19,0,0,105
8,15,21,19,5,19,0,0,0,87
8,15,21,19,5,19,1,20,0,108
8,15,21,19,5,19,9,20,0,116
8,15,21,19,5,19,9,20,19,135
8,15,21,19,5,20,15,16,0,119
8,15,21,19,5,20,15,16,19,138
8,15,21,19,5,23,1,18,4,114
8,15,21,19,5,23,1,18,13,123
8,15,21,19,5,23,5,1,18,115
8,15,21,19,5,23,9,6,5,111
8,15,21,19,5,23,9,22,5,127
8,15,21,19,5,23,15,18,11,135
8,15,21,19,25,0,0,0,0,88
8,15,21,19,9,14,7,0,0,93
8,15,21,19,9,14,7,19,0,112
8,15,21,19,12,9,14,7,0,105
8,15,21,19,19,0,0,0,0,82
8,15,21,19,20,25,0,0,0,108
8,15,21,20,0,0,0,0,0,64
8,15,21,20,9,14,7,0,0,94
8,15,21,20,15,21,0,0,0,100
8,15,21,22,1,18,9,0,0,94
8,15,21,22,5,0,0,0,0,71
8,15,22,5,4,1,14,3,5,77
8,15,22,5,12,0,0,0,0,62
8,15,22,5,12,5,4,0,0,71
8,15,22,5,12,5,18,0,0,85
8,15,22,5,12,9,14,7,0,92
8,15,22,5,12,12,5,4,0,83
8,15,22,5,12,12,5,18,0,97
8,15,22,5,12,12,9,14,7,104
8,15,22,5,12,19,0,0,0,81
8,15,22,5,18,0,0,0,0,68
8,15,22,5,18,3,1,18,0,90
8,15,22,5,18,5,4,0,0,77
8,15,22,5,18,5,18,0,0,91
8,15,22,5,18,5,18,19,0,110
8,15,22,5,18,9,14,7,0,98
8,15,22,5,18,12,25,0,0,105
8,15,22,5,18,16,15,18,20,137
8,15,22,5,18,19,0,0,0,87
8,15,23,1,4,10,9,0,0,70
8,15,23,1,18,4,9,20,5,103
8,15,23,2,5,9,20,0,0,82
8,15,23,4,1,8,0,0,0,59
8,15,23,4,1,8,19,0,0,78
8,15,23,4,5,18,0,0,0,73
8,15,23,4,25,0,0,0,0,75
8,15,23,4,9,5,0,0,0,64
8,15,23,4,9,5,4,0,0,68
8,15,23,4,9,5,19,0,0,83
8,15,23,4,25,9,14,7,0,105
8,15,23,5,12,0,0,0,0,63
8,15,23,5,22,5,18,0,0,96
8,15,23,6,0,0,0,0,0,52
8,15,23,6,6,0,0,0,0,58
8,15,23,6,6,19,0,0,0,77
8,15,23,6,9,14,7,0,0,82
8,15,23,6,19,0,0,0,0,71
8,15,23,7,1,20,5,19,0,98
8,15,23,9,19,8,0,0,0,82
8,15,23,9,20,26,0,0,0,101
8,15,23,9,20,26,5,18,0,124
8,15,23,9,20,26,5,18,19,143
8,15,23,11,0,0,0,0,0,57
8,15,23,11,5,4,0,0,0,66
8,15,23,11,5,18,0,0,0,80
8,15,23,11,9,14,7,0,0,87
8,15,23,11,9,20,0,0,0,86
8,15,23,11,19,0,0,0,0,76
8,15,23,12,0,0,0,0,0,58
8,15,23,12,5,4,0,0,0,67
8,15,23,12,5,18,0,0,0,81
8,15,23,12,5,18,19,0,0,100
8,15,23,12,5,20,0,0,0,83
8,15,23,12,5,20,19,0,0,102
8,15,23,12,9,14,7,0,0,88
8,15,23,12,9,14,7,12,25,125
8,15,23,12,9,20,5,0,0,92
8,15,23,12,19,0,0,0,0,77
8,15,23,19,0,0,0,0,0,65
8,15,23,19,1,2,15,21,20,124
8,15,23,19,15,0,0,0,0,80
8,15,23,19,15,5,22,5,18,130
8,15,23,19,15,21,18,0,0,119
8,15,23,20,15,23,4,9,5,122
8,15,24,0,0,0,0,0,0,47
8,16,9,20,1,12,0,0,0,66
8,18,4,23,18,5,0,0,0,76
8,18,19,0,0,0,0,0,0,45
8,18,26,14,0,0,0,0,0,66
8,19,9,5,14,0,0,0,0,55
8,19,21,1,14,0,0,0,0,63
8,20,5,12,0,0,0,0,0,45
8,21,2,0,0,0,0,0,0,31
8,21,2,2,0,0,0,0,0,33
8,21,2,2,1,0,0,0,0,34
8,21,2,2,1,2,15,15,0,66
8,21,2,2,5,4,0,0,0,42
8,21,2,2,5,18,0,0,0,56
8,21,2,2,25,0,0,0,0,58
8,21,2,2,9,5,19,0,0,66
8,21,2,2,9,14,7,0,0,63
8,21,2,2,12,25,0,0,0,70
8,21,2,2,15,2,0,0,0,50
8,21,2,2,21,2,0,0,0,56
8,21,2,2,21,2,15,15,0,86
8,21,2,2,21,2,19,0,0,75
8,21,2,3,1,16,0,0,0,51
8,21,2,3,1,16,19,0,0,70
8,21,2,13,1,11,5,18,0,79
8,21,2,13,1,11,9,14,7,86
8,21,2,14,5,18,9,20,5,102
8,21,2,18,9,19,0,0,0,77
8,21,2,18,9,19,5,19,0,101
8,21,2,18,9,19,20,9,3,109
8,21,2,19,0,0,0,0,0,50
8,21,2,19,8,9,0,0,0,67
8,21,3,3,1,20,15,15,14,100
8,21,3,8,5,14,0,0,0,59
8,21,3,8,15,0,0,0,0,55
8,21,3,11,0,0,0,0,0,43
8,21,3,11,1,2,1,3,11,61
8,21,3,11,12,5,0,0,0,60
8,21,3,11,12,5,19,0,0,79
8,21,3,11,13,21,3,11,0,91
8,21,3,11,19,0,0,0,0,62
8,21,3,11,19,20,5,18,0,105
8,21,3,11,19,20,5,18,25,130
8,21,3,11,19,20,5,18,19,124
8,21,4,4,5,18,15,14,0,89
8,21,4,4,12,5,0,0,0,54
8,21,4,4,12,5,4,0,0,58
8,21,4,4,12,5,4,15,13,86
8,21,4,4,12,5,18,0,0,72
8,21,4,4,12,5,18,19,0,91
8,21,4,4,12,5,19,0,0,73
8,21,4,4,12,9,14,7,0,79
8,21,4,4,15,3,11,0,0,66
8,21,4,4,18,15,21,14,0,105
8,21,4,4,21,16,0,0,0,74
8,21,4,19,15,14,9,20,5,115
8,21,5,4,0,0,0,0,0,38
8,21,5,6,21,12,0,0,0,73
8,21,5,8,21,5,20,12,0,100
8,21,5,12,5,19,19,0,0,89
8,21,5,13,21,12,0,0,0,80
8,21,5,18,0,0,0,0,0,52
8,21,5,19,0,0,0,0,0,53
8,21,6,6,1,11,5,18,0,76
8,21,6,6,3,1,16,0,0,61
8,21,6,6,5,4,0,0,0,50
8,21,6,6,5,18,0,0,0,64
8,21,6,6,25,0,0,0,0,66
8,21,6,6,9,5,18,0,0,73
8,21,6,6,9,5,19,20,0,94
8,21,6,6,9,12,25,0,0,87
8,21,6,6,9,14,5,19,19,107
8,21,6,6,9,14,7,0,0,71
8,21,6,6,9,14,7,12,25,108
8,21,6,6,9,19,8,0,0,77
8,21,6,6,9,19,8,12,25,114
8,21,6,6,12,5,0,0,0,58
8,21,6,6,12,5,18,0,0,76
8,21,6,6,19,0,0,0,0,60
8,21,7,0,0,0,0,0,0,36
8,21,7,5,12,25,0,0,0,78
8,21,7,5,12,9,20,5,0,87
8,21,7,5,14,5,19,19,0,98
8,21,7,5,15,21,19,0,0,96
8,21,7,5,15,21,19,12,25,133
8,21,7,5,19,20,0,0,0,80
8,21,7,7,1,2,12,5,0,63
8,21,7,7,5,4,0,0,0,52
8,21,7,7,5,18,0,0,0,66
8,21,7,7,5,18,25,0,0,91
8,21,7,7,5,18,19,0,0,85
8,21,7,7,9,14,7,0,0,73
8,21,7,7,9,14,7,12,25,110
8,21,7,7,12,5,0,0,0,60
8,21,7,25,0,0,0,0,0,61
8,21,7,13,1,20,5,5,0,80
8,21,7,15,14,9,19,0,0,93
8,21,7,19,0,0,0,0,0,55
8,21,7,19,15,13,5,0,0,88
8,21,7,21,5,14,15,20,19,130
8,21,8,0,0,0,0,0,0,37
8,21,9,1,0,0,0,0,0,39
8,21,9,3,0,0,0,0,0,41
8,21,9,12,5,0,0,0,0,55
8,21,9,16,9,12,0,0,0,75
8,21,9,16,9,12,5,19,0,99
8,21,9,16,9,12,12,1,0,88
8,21,9,16,9,12,19,0,0,94
8,21,9,19,1,3,8,5,0,74
8,21,9,19,3,15,25,15,12,127
8,21,9,19,8,5,18,0,0,88
8,21,9,19,17,21,9,12,0,116
8,21,9,19,19,9,5,18,0,108
8,21,9,20,1,9,14,0,0,82
8,21,9,20,18,5,0,0,0,81
8,21,11,5,0,0,0,0,0,45
8,21,12,1,0,0,0,0,0,42
8,21,12,1,19,0,0,0,0,61
8,21,12,3,8,0,0,0,0,52
8,21,12,3,8,25,0,0,0,77
8,21,12,4,5,5,0,0,0,55
8,21,12,25,0,0,0,0,0,66
8,21,12,11,0,0,0,0,0,52
8,21,12,11,1,7,5,0,0,65
8,21,12,11,5,4,0,0,0,61
8,21,12,11,25,0,0,0,0,77
8,21,12,11,9,5,18,0,0,84
8,21,12,11,9,5,19,20,0,105
8,21,12,11,9,12,25,0,0,98
8,21,12,11,9,14,5,19,19,118
8,21,12,11,9,14,7,0,0,82
8,21,12,11,9,14,7,12,25,119
8,21,12,11,19,0,0,0,0,71
8,21,12,12,5,4,0,0,0,62
8,21,12,12,5,18,0,0,0,76
8,21,12,12,5,18,19,0,0,95
8,21,12,12,9,14,7,0,0,83
8,21,12,12,15,0,0,0,0,68
8,21,12,12,15,1,0,0,0,69
8,21,12,12,15,1,5,4,0,78
8,21,12,12,15,1,9,14,7,99
8,21,12,12,15,1,19,0,0,88
8,21,12,12,15,3,11,0,0,82
8,21,12,12,15,5,4,0,0,77
8,21,12,12,15,5,19,0,0,92
8,21,12,12,15,9,14,7,0,98
8,21,12,12,15,15,0,0,0,83
8,21,12,12,15,15,5,4,0,92
8,21,12,12,15,15,9,14,7,113
8,21,12,12,15,15,19,0,0,102
8,21,12,12,15,19,0,0,0,87
8,21,12,12,19,0,0,0,0,72
8,21,12,15,9,19,20,0,0,104
8,21,12,19,9,20,5,0,0,94
8,21,12,19,20,5,18,0,0,103
8,21,12,21,0,0,0,0,0,62
8,21,12,22,5,18,0,0,0,86
8,21,12,23,15,18,20,0,0,117
8,21,13,1,14,0,0,0,0,57
8,21,13,1,14,1,20,5,0,83
8,21,13,1,14,5,0,0,0,62
8,21,13,1,14,5,12,25,0,99
8,21,13,1,14,5,18,0,0,80
8,21,13,1,14,5,19,20,0,101
8,21,13,1,14,8,15,15,4,99
8,21,13,1,14,9,3,19,0,88
8,21,13,1,14,9,6,25,0,97
8,21,13,1,14,9,19,5,0,90
8,21,13,1,14,9,19,5,4,94
8,21,13,1,14,9,19,5,18,108
8,21,13,1,14,9,19,5,19,109
8,21,13,1,14,9,19,8,0,93
8,21,13,1,14,9,19,13,0,98
8,21,13,1,14,9,19,13,19,117
8,21,13,1,14,9,19,20,0,105
8,21,13,1,14,9,19,20,19,124
8,21,13,1,14,9,20,25,0,111
8,21,13,1,14,9,26,5,0,97
8,21,13,1,14,9,26,5,4,101
8,21,13,1,14,9,26,5,18,115
8,21,13,1,14,9,26,5,19,116
8,21,13,1,14,11,9,14,4,95
8,21,13,1,14,12,25,0,0,94
8,21,13,1,14,12,9,11,5,94
8,21,13,1,14,14,5,19,19,114
8,21,13,1,14,15,9,4,0,85
8,21,13,1,14,15,9,4,19,104
8,21,13,1,14,19,0,0,0,76
8,21,13,1,20,5,0,0,0,68
8,21,13,1,20,5,19,0,0,87
8,21,13,1,20,9,15,14,0,101
8,21,13,2,12,5,2,5,5,73
8,21,13,2,12,5,4,0,0,65
8,21,13,2,12,5,18,0,0,79
8,21,13,2,12,5,18,19,0,98
8,21,13,2,12,5,19,0,0,80
8,21,13,2,12,5,19,19,5,104
8,21,13,2,12,5,19,19,15,114
8,21,13,2,12,5,19,20,0,100
8,21,13,2,12,25,0,0,0,81
8,21,13,2,12,9,5,0,0,70
8,21,13,2,12,9,14,7,0,86
8,21,13,2,15,0,0,0,0,59
8,21,13,2,21,7,0,0,0,72
8,21,13,2,21,7,7,5,4,88
8,21,13,2,21,7,7,5,18,102
8,21,13,2,21,7,19,0,0,91
8,21,13,2,21,26,26,0,0,117
8,21,13,4,9,14,7,5,18,99
8,21,13,4,18,21,13,0,0,98
8,21,13,4,18,21,13,19,0,117
8,21,13,5,3,20,0,0,0,70
8,21,13,5,3,20,1,14,20,105
8,21,13,5,3,20,1,20,5,96
8,21,13,5,3,20,9,22,5,106
8,21,13,5,18,1,12,0,0,78
8,21,13,5,18,1,12,19,0,97
8,21,13,5,18,9,0,0,0,74
8,21,13,5,18,13,5,18,9,110
8,21,13,5,18,21,19,0,0,105
8,21,13,5,20,0,0,0,0,67
8,21,13,5,20,20,5,5,0,97
8,21,13,5,20,20,25,0,0,112
8,21,13,8,21,13,0,0,0,84
8,21,13,9,3,0,0,0,0,54
8,21,13,9,4,0,0,0,0,55
8,21,13,9,4,1,20,5,0,81
8,21,13,9,4,6,9,5,4,79
8,21,13,9,4,6,9,5,19,94
8,21,13,9,4,9,6,25,0,95
8,21,13,9,4,9,20,25,0,109
8,21,13,9,4,12,25,0,0,92
8,21,13,9,4,14,5,19,19,112
8,21,13,9,4,15,18,0,0,88
8,21,13,9,4,15,18,19,0,107
8,21,13,9,6,25,0,0,0,82
8,21,13,9,6,9,3,0,0,69
8,21,13,9,6,9,5,4,0,75
8,21,13,9,6,21,19,5,0,102
8,21,13,9,12,9,1,14,20,107
8,21,13,9,12,9,1,20,5,98
8,21,13,9,12,9,6,9,3,90
8,21,13,9,12,9,19,0,0,91
8,21,13,9,12,9,20,25,0,117
8,21,13,9,14,0,0,0,0,65
8,21,13,9,20,0,0,0,0,71
8,21,13,9,20,5,0,0,0,76
8,21,13,9,20,21,18,5,0,115
8,21,13,12,9,5,0,0,0,68
8,21,13,13,1,2,12,5,0,75
8,21,13,13,1,21,12,0,0,89
8,21,13,13,5,4,0,0,0,64
8,21,13,13,5,12,5,18,0,95
8,21,13,13,5,18,0,0,0,78
8,21,13,13,5,18,9,0,0,87
8,21,13,13,5,18,19,0,0,97
8,21,13,13,9,5,0,0,0,69
8,21,13,13,9,14,7,0,0,85
8,21,13,13,9,14,7,12,25,122
8,21,13,13,15,3,11,0,0,84
8,21,13,13,15,3,11,25,0,109
8,21,13,13,15,3,11,19,0,103
8,21,13,13,21,13,0,0,0,89
8,21,13,13,21,19,0,0,0,95
8,21,13,13,21,19,5,19,0,119
8,21,13,15,14,7,15,21,19,133
8,21,13,15,18,0,0,0,0,75
8,21,13,15,18,1,12,0,0,88
8,21,13,15,18,5,4,0,0,84
8,21,13,15,18,5,18,0,0,98
8,21,13,15,18,5,18,19,0,117
8,21,13,15,18,6,21,12,0,114
8,21,13,15,18,9,6,9,3,102
8,21,13,15,18,9,14,7,0,105
8,21,13,15,18,9,19,13,0,116
8,21,13,15,18,9,19,20,0,123
8,21,13,15,18,9,19,20,19,142
8,21,13,15,18,9,26,5,0,115
8,21,13,15,18,12,5,19,19,130
8,21,13,15,18,15,21,19,0,130
8,21,13,15,18,19,0,0,0,94
8,21,13,15,18,19,15,13,5,127
8,21,13,15,21,18,0,0,0,96
8,21,13,15,21,18,1,12,0,109
8,21,13,15,21,18,5,4,0,105
8,21,13,15,21,18,6,21,12,135
8,21,13,15,21,18,9,14,7,126
8,21,13,15,21,18,9,19,20,144
8,21,13,15,21,18,9,26,5,136
8,21,13,15,21,18,19,0,0,115
8,21,13,15,21,19,0,0,0,97
8,21,13,16,2,1,3,11,0,75
8,21,13,16,2,1,3,11,19,94
8,21,13,16,5,4,0,0,0,67
8,21,13,16,8,5,4,0,0,75
8,21,13,16,8,9,14,7,0,96
8,21,13,16,8,19,0,0,0,85
8,21,13,16,25,0,0,0,0,83
8,21,13,16,9,5,18,0,0,90
8,21,13,16,9,5,19,0,0,91
8,21,13,16,9,5,19,20,0,111
8,21,13,16,9,14,5,19,19,124
8,21,13,16,9,14,7,0,0,88
8,21,13,16,12,5,19,19,0,113
8,21,13,16,19,0,0,0,0,77
8,21,13,16,20,25,0,0,0,103
8,21,13,19,20,18,21,13,0,133
8,21,13,21,12,5,14,5,0,99
8,21,13,21,12,15,14,0,0,104
8,21,13,21,12,15,14,5,0,109
8,21,13,21,19,0,0,0,0,82
8,21,13,21,19,5,19,0,0,106
8,21,13,21,19,12,9,11,5,119
8,21,14,3,8,0,0,0,0,54
8,21,14,3,8,2,1,3,11,71
8,21,14,3,8,5,4,0,0,63
8,21,14,3,8,5,19,0,0,78
8,21,14,3,8,5,20,0,0,79
8,21,14,3,8,25,0,0,0,79
8,21,14,3,8,9,14,7,0,84
8,21,14,4,0,0,0,0,0,47
8,21,14,4,5,18,0,0,0,70
8,21,14,4,9,0,0,0,0,56
8,21,14,4,18,5,4,0,0,74
8,21,14,4,18,5,4,1,12,87
8,21,14,4,18,5,4,5,18,97
8,21,14,4,18,5,4,19,0,93
8,21,14,4,18,5,4,20,8,102
8,21,14,6,25,19,8,0,0,101
8,21,14,7,1,18,0,0,0,69
8,21,14,7,1,18,9,3,0,81
8,21,14,7,1,18,9,20,5,103
8,21,14,7,5,18,5,4,0,82
8,21,14,7,5,18,5,18,0,96
8,21,14,7,5,18,9,14,7,103
8,21,14,7,5,18,12,25,0,110
8,21,14,7,5,18,19,0,0,92
8,21,14,7,18,25,0,0,0,93
8,21,14,7,18,9,5,18,0,100
8,21,14,7,18,9,5,19,20,121
8,21,14,7,18,9,6,25,0,108
8,21,14,7,18,9,12,25,0,114
8,21,14,8,0,0,0,0,0,51
8,21,14,11,5,18,5,4,0,86
8,21,14,11,5,18,9,14,7,107
8,21,14,11,5,18,19,0,0,96
8,21,14,11,25,0,0,0,0,79
8,21,14,11,9,5,19,0,0,87
8,21,14,11,19,0,0,0,0,73
8,21,14,14,5,18,0,0,0,80
8,21,14,19,0,0,0,0,0,62
8,21,14,20,1,2,12,5,0,83
8,21,14,20,1,23,1,25,0,113
8,21,14,20,5,4,0,0,0,72
8,21,14,20,5,4,12,25,0,109
8,21,14,20,9,12,9,20,5,118
8,21,14,20,9,14,7,0,0,93
8,21,14,20,9,14,7,19,0,112
8,21,14,20,18,5,19,19,0,124
8,21,14,20,19,13,1,14,0,110
8,21,14,20,19,13,5,14,0,114
8,21,16,0,0,0,0,0,0,45
8,21,16,16,1,8,0,0,0,70
8,21,16,16,1,8,19,0,0,89
8,21,16,16,15,20,0,0,0,96
8,21,16,16,15,20,8,0,0,104
8,21,18,3,8,5,15,14,0,92
8,21,18,4,5,14,0,0,0,70
8,21,18,4,9,5,19,0,0,84
8,21,18,4,9,19,0,0,0,79
8,21,18,4,12,5,0,0,0,68
8,21,18,4,12,5,4,0,0,72
8,21,18,4,12,5,13,1,14,96
8,21,18,4,12,5,18,0,0,86
8,21,18,4,12,5,18,19,0,105
8,21,18,4,12,5,19,0,0,87
8,21,18,4,12,9,14,7,0,93
8,21,18,4,19,0,0,0,0,70
8,21,18,5,0,0,0,0,0,52
8,21,18,5,5,11,0,0,0,68
8,21,18,6,0,0,0,0,0,53
8,21,18,7,9,12,1,0,0,76
8,21,18,11,1,18,21,0,0,98
8,21,18,11,12,5,0,0,0,75
8,21,18,12,0,0,0,0,0,59
8,21,18,12,2,1,20,0,0,82
8,21,18,12,5,4,0,0,0,68
8,21,18,12,5,25,19,0,0,108
8,21,18,12,5,13,5,14,20,116
8,21,18,12,5,18,0,0,0,82
8,21,18,12,5,18,19,0,0,101
8,21,18,12,25,0,0,0,0,84
8,21,18,12,9,5,19,0,0,92
8,21,18,12,9,14,7,0,0,89
8,21,18,12,9,14,7,19,0,108
8,21,18,12,16,9,20,0,0,104
8,21,18,12,19,0,0,0,0,78
8,21,18,12,23,9,14,4,0,109
8,21,18,18,0,0,0,0,0,65
8,21,18,18,1,8,0,0,0,74
8,21,18,18,1,8,5,4,0,83
8,21,18,18,1,8,9,14,7,104
8,21,18,18,1,8,19,0,0,93
8,21,18,18,1,25,0,0,0,91
8,21,18,18,1,25,5,4,0,100
8,21,18,18,1,25,9,14,7,121
8,21,18,18,1,25,19,0,0,110
8,21,18,18,5,18,0,0,0,88
8,21,18,18,25,0,0,0,0,90
8,21,18,18,9,3,1,14,5,97
8,21,18,18,9,3,1,14,15,107
8,21,18,18,9,4,12,25,0,115
8,21,18,18,9,5,4,0,0,83
8,21,18,18,9,5,4,12,25,120
8,21,18,18,9,5,18,0,0,97
8,21,18,18,9,5,18,19,0,116
8,21,18,18,9,5,19,0,0,98
8,21,18,18,25,9,14,7,0,120
8,21,18,18,9,19,15,13,5,126
8,21,18,18,15,3,11,0,0,94
8,21,18,18,15,15,0,0,0,95
8,21,18,18,15,15,19,8,0,122
8,21,18,19,20,19,0,0,0,105
8,21,18,20,0,0,0,0,0,67
8,21,18,20,1,2,12,5,0,87
8,21,18,20,5,4,0,0,0,76
8,21,18,20,5,18,0,0,0,90
8,21,18,20,5,18,19,0,0,109
8,21,18,20,6,21,12,0,0,106
8,21,18,20,6,21,12,12,25,143
8,21,18,20,9,14,7,0,0,97
8,21,18,20,12,5,0,0,0,84
8,21,18,20,12,5,4,0,0,88
8,21,18,20,12,5,19,0,0,103
8,21,18,20,12,5,19,19,0,122
8,21,18,20,12,9,14,7,0,109
8,21,18,20,19,0,0,0,0,86
8,21,18,20,19,15,13,5,0,119
8,21,19,2,1,14,4,0,0,69
8,21,19,2,1,14,4,5,4,78
8,21,19,2,1,14,4,5,18,92
8,21,19,2,1,14,4,12,25,106
8,21,19,2,1,14,4,18,25,112
8,21,19,2,1,14,4,19,0,88
8,21,19,3,1,18,12,0,0,82
8,21,19,5,0,0,0,0,0,53
8,21,19,8,0,0,0,0,0,56
8,21,19,8,1,2,25,0,0,84
8,21,19,8,1,2,12,5,0,76
8,21,19,8,3,12,15,20,8,114
8,21,19,8,5,4,0,0,0,65
8,21,19,8,5,4,12,25,0,102
8,21,19,8,5,5,14,0,0,80
8,21,19,8,5,12,0,0,0,73
8,21,19,8,5,18,0,0,0,79
8,21,19,8,5,19,0,0,0,80
8,21,19,8,6,21,12,0,0,95
8,21,19,8,6,21,12,12,25,132
8,21,19,8,9,14,7,0,0,86
8,21,19,8,9,14,7,12,25,123
8,21,19,8,9,15,14,0,0,94
8,21,19,8,15,0,0,0,0,71
8,21,19,8,16,21,16,16,25,150
8,21,19,8,20,0,0,0,0,76
8,21,19,11,1,14,1,23,0,98
8,21,19,11,5,4,0,0,0,68
8,21,19,11,5,14,5,4,0,87
8,21,19,11,5,18,0,0,0,82
8,21,19,11,5,18,19,0,0,101
8,21,19,11,9,5,18,0,0,91
8,21,19,11,9,5,19,0,0,92
8,21,19,11,9,5,19,20,0,112
8,21,19,11,9,12,25,0,0,105
8,21,19,11,9,14,5,19,19,125
8,21,19,11,9,14,7,0,0,89
8,21,19,11,9,14,7,19,0,108
8,21,19,11,12,9,11,5,0,96
8,21,19,11,18,15,15,20,0,127
8,21,19,11,19,0,0,0,0,78
8,21,19,11,23,15,18,20,0,135
8,21,19,15,0,0,0,0,0,63
8,21,19,16,5,12,0,0,0,81
8,21,19,16,9,12,0,0,0,85
8,21,19,19,1,18,19,0,0,105
8,21,19,19,25,0,0,0,0,92
8,21,19,19,25,4,15,13,0,124
8,21,19,19,9,5,19,0,0,100
8,21,19,19,25,14,5,19,19,149
8,21,19,20,0,0,0,0,0,68
8,21,19,20,9,14,7,0,0,98
8,21,19,20,9,14,7,19,0,117
8,21,19,20,12,5,0,0,0,85
8,21,19,20,12,5,3,1,16,105
8,21,19,20,12,5,4,0,0,89
8,21,19,20,12,5,18,0,0,103
8,21,19,20,12,5,18,19,0,122
8,21,19,20,12,5,19,0,0,104
8,21,19,20,12,9,14,7,0,110
8,21,19,23,9,6,5,0,0,91
8,21,19,23,9,6,5,19,0,110
8,21,19,23,9,22,5,19,0,126
8,21,20,3,8,0,0,0,0,60
8,21,20,3,8,5,4,0,0,69
8,21,20,3,8,5,18,0,0,83
8,21,20,3,8,5,19,0,0,84
8,21,20,3,8,5,20,0,0,85
8,21,20,3,8,9,5,0,0,74
8,21,20,3,8,9,14,7,0,90
8,21,20,8,15,12,4,0,0,88
8,21,20,8,15,12,4,5,18,111
8,21,20,9,1,0,0,0,0,59
8,21,20,11,5,5,16,5,18,109
8,21,20,12,5,20,0,0,0,86
8,21,20,12,9,11,5,0,0,86
8,21,20,13,5,14,20,0,0,101
8,21,20,13,5,14,20,19,0,120
8,21,20,18,5,0,0,0,0,72
8,21,20,19,0,0,0,0,0,68
8,21,20,20,5,4,0,0,0,78
8,21,20,20,9,14,7,0,0,99
8,21,20,20,15,14,9,14,7,128
8,21,20,21,11,8,20,21,0,130
8,21,20,21,11,20,21,0,0,122
8,21,20,21,14,7,0,0,0,91
8,21,20,26,16,1,0,0,0,92
8,21,20,26,16,1,8,0,0,100
8,21,20,26,16,1,8,19,0,119
8,21,20,26,16,1,19,0,0,111
8,21,21,18,4,5,18,0,0,95
8,21,22,5,12,25,11,0,0,104
8,21,24,20,5,18,0,0,0,96
8,21,26,15,15,18,0,0,0,103
8,21,26,26,0,0,0,0,0,81
8,21,26,26,1,0,0,0,0,82
8,21,26,26,1,5,4,0,0,91
8,21,26,26,1,8,0,0,0,90
8,21,26,26,1,8,5,4,0,99
8,21,26,26,1,8,9,14,7,120
8,21,26,26,1,8,19,0,0,109
8,21,26,26,1,9,14,7,0,112
8,21,26,26,1,18,4,0,0,104
8,21,26,26,1,19,0,0,0,101
8,21,26,26,25,0,0,0,0,106
8,22,25,0,0,0,0,0,0,55
8,23,25,0,0,0,0,0,0,56
8,23,25,12,0,0,0,0,0,68
8,23,20,0,0,0,0,0,0,51
9,2,5,18,9,1,14,19,0,77
9,2,5,18,9,20,5,0,0,68
9,2,5,24,0,0,0,0,0,40
9,2,5,24,5,19,0,0,0,64
9,2,9,3,5,19,0,0,0,47
9,2,9,4,0,0,0,0,0,24
9,2,9,4,5,13,0,0,0,42
9,2,9,4,9,14,5,0,0,52
9,2,9,12,9,20,25,0,0,86
9,2,9,19,0,0,0,0,0,39
9,2,9,19,2,9,12,12,0,74
9,2,9,19,5,19,0,0,0,63
9,2,12,5,0,0,0,0,0,28
25,2,12,5,14,20,0,0,0,78
9,2,15,7,1,9,14,5,0,62
9,2,15,12,9,21,13,0,0,81
9,2,15,20,1,0,0,0,0,47
9,2,21,16,18,15,6,5,14,106
9,3,5,0,0,0,0,0,0,17
9,3,5,2,5,18,7,0,0,49
9,3,5,2,5,18,7,19,0,68
9,3,5,2,12,9,14,11,0,65
9,3,5,2,12,9,14,11,19,84
9,3,5,2,15,1,20,0,0,55
9,3,5,2,15,1,20,5,18,78
9,3,5,2,15,1,20,19,0,74
9,3,5,2,15,14,5,0,0,53
9,3,5,2,15,21,14,4,0,73
9,3,5,2,15,24,0,0,0,58
9,3,5,2,15,24,5,19,0,82
9,3,5,3,1,16,0,0,0,37
9,3,5,3,1,16,19,0,0,56
9,3,5,3,18,1,6,20,0,65
9,3,5,4,0,0,0,0,0,21
9,3,5,6,1,12,12,0,0,48
9,3,5,6,1,12,12,19,0,67
9,3,5,6,9,19,8,0,0,59
9,3,5,6,9,19,8,5,19,83
9,3,5,8,15,21,19,5,0,85
9,3,5,8,15,21,19,5,19,104
9,3,5,11,8,1,14,1,0,52
9,3,5,11,8,1,14,1,19,71
9,3,5,12,5,1,6,0,0,41
9,3,5,12,5,19,19,0,0,72
9,3,5,12,9,11,5,0,0,54
9,3,5,13,1,14,0,0,0,45
9,3,5,13,5,14,0,0,0,49
9,3,5,16,9,3,11,0,0,56
9,3,5,17,21,1,11,5,0,72
9,3,5,18,15,15,20,0,0,85
9,3,5,18,19,0,0,0,0,54
9,3,5,19,0,0,0,0,0,36
9,3,5,19,11,1,20,5,0,73
9,3,5,19,11,1,20,5,4,77
9,3,5,19,16,1,18,0,0,71
9,3,5,23,15,18,11,0,0,84
9,3,8,0,0,0,0,0,0,20
9,3,8,5,2,21,0,0,0,48
9,3,8,9,2,21,0,0,0,52
9,3,8,14,5,21,13,15,14,102
9,3,8,14,5,21,20,9,3,92
9,3,8,14,9,20,5,0,0,68
9,3,8,14,9,20,5,19,0,87
9,3,8,14,15,12,9,20,5,95
9,3,8,14,15,12,15,7,25,108
9,3,8,15,0,0,0,0,0,35
9,3,8,15,7,12,1,14,0,69
9,3,8,15,18,0,0,0,0,53
9,3,8,15,18,15,21,19,0,108
9,3,8,15,18,18,8,5,1,85
9,3,8,15,18,19,0,0,0,72
9,3,8,19,0,0,0,0,0,39
9,3,8,20,8,0,0,0,0,48
9,3,8,20,8,25,1,12,0,86
9,3,8,20,8,25,9,1,14,97
9,3,8,20,8,25,9,3,0,85
9,3,8,20,8,25,9,19,13,114
9,3,8,20,8,25,15,9,4,101
9,3,8,20,8,25,19,0,0,92
9,3,8,20,8,21,12,9,14,104
9,3,8,20,8,21,19,0,0,88
9,3,8,21,0,0,0,0,0,41
9,3,8,21,12,12,5,0,0,70
9,3,25,0,0,0,0,0,0,37
9,3,9,1,14,0,0,0,0,36
9,3,9,3,1,0,0,0,0,25
9,3,9,3,12,5,0,0,0,41
9,3,9,3,12,5,4,0,0,45
9,3,9,3,12,5,19,0,0,60
25,3,9,5,0,0,0,0,0,42
9,3,9,5,18,0,0,0,0,44
9,3,9,5,19,20,0,0,0,65
9,3,9,12,25,0,0,0,0,58
9,3,9,14,5,19,19,0,0,78
9,3,9,14,5,19,19,5,19,102
9,3,9,14,7,0,0,0,0,42
9,3,9,14,7,19,0,0,0,61
9,3,9,20,25,0,0,0,0,66
9,3,11,0,0,0,0,0,0,23
9,3,11,5,18,0,0,0,0,46
9,3,11,5,18,19,0,0,0,65
9,3,11,25,0,0,0,0,0,48
9,3,11,9,5,18,0,0,0,55
9,3,11,9,5,19,20,0,0,76
9,3,11,9,12,25,0,0,0,69
9,3,11,9,14,5,19,19,0,89
9,3,11,12,5,0,0,0,0,40
25,3,12,1,4,0,0,0,0,45
25,3,12,5,16,5,4,0,0,70
25,3,12,5,16,9,14,7,0,91
25,3,12,5,16,20,0,0,0,81
9,3,15,4,0,0,0,0,0,31
9,3,15,14,5,19,0,0,0,65
9,3,15,14,9,3,0,0,0,53
9,3,15,14,9,3,1,12,0,66
9,3,15,14,9,3,9,20,25,107
9,3,15,14,9,19,13,0,0,82
9,3,15,14,9,26,5,0,0,81
9,3,15,14,15,4,21,12,5,98
9,3,15,14,15,4,21,12,25,118
9,3,15,14,15,12,15,7,25,115
9,3,15,14,15,19,20,1,19,115
9,3,15,14,15,20,25,16,5,122
9,3,15,14,19,0,0,0,0,60
9,3,15,14,22,0,0,0,0,63
9,3,15,14,22,5,18,20,0,106
9,3,15,19,9,1,14,0,0,70
9,3,15,19,20,5,9,4,0,84
9,3,15,19,20,5,9,14,5,99
9,3,15,20,25,16,5,0,0,93
9,3,19,0,0,0,0,0,0,31
9,3,20,5,18,9,3,0,0,67
9,3,20,5,18,9,3,1,12,80
9,3,20,5,18,9,3,19,0,86
9,3,20,5,18,9,14,5,0,83
9,3,20,5,18,15,4,5,0,79
9,3,20,5,18,15,9,4,0,83
9,3,20,5,18,15,21,19,0,110
9,3,20,5,18,21,19,0,0,95
9,3,20,5,18,21,19,5,19,119
9,3,20,9,3,0,0,0,0,44
9,3,20,21,1,20,5,0,0,79
9,3,20,21,19,0,0,0,0,72
9,3,20,21,19,5,19,0,0,96
9,4,3,21,5,0,0,0,0,42
9,4,4,1,20,0,0,0,0,38
9,4,4,8,9,0,0,0,0,34
9,4,5,0,0,0,0,0,0,18
9,4,5,1,5,4,0,0,0,28
9,4,5,1,6,21,12,0,0,58
9,4,5,1,9,19,20,9,3,79
9,4,5,1,12,0,0,0,0,31
9,4,5,1,12,5,19,19,0,74
9,4,5,1,12,25,0,0,0,56
9,4,5,1,12,9,19,5,0,64
9,4,5,1,12,9,19,5,4,68
9,4,5,1,12,9,19,5,18,82
9,4,5,1,12,9,19,5,19,83
9,4,5,1,12,9,19,13,0,72
9,4,5,1,12,9,19,13,19,91
9,4,5,1,12,9,19,20,0,79
9,4,5,1,12,9,19,20,19,98
9,4,5,1,12,9,20,25,0,85
9,4,5,1,12,9,26,5,0,71
9,4,5,1,12,9,26,5,4,75
9,4,5,1,12,9,26,5,18,89
9,4,5,1,12,9,26,5,19,90
9,4,5,1,12,12,5,19,19,86
9,4,5,1,12,12,25,0,0,68
9,4,5,1,12,14,5,19,19,88
9,4,5,1,12,15,7,25,0,78
9,4,5,1,12,15,7,21,5,79
9,4,5,1,12,19,0,0,0,50
9,4,5,1,19,0,0,0,0,38
9,4,5,1,20,1,0,0,0,40
9,4,5,1,20,5,0,0,0,44
9,4,5,1,20,5,4,0,0,48
9,4,5,1,20,5,19,0,0,63
9,4,5,1,20,9,14,7,0,69
9,4,5,1,20,9,15,14,0,77
9,4,5,1,20,9,15,14,19,96
9,4,5,1,20,9,22,5,0,75
9,4,5,1,20,21,13,0,0,73
9,4,5,5,0,0,0,0,0,23
9,4,5,5,6,9,24,5,0,67
9,4,5,9,19,20,0,0,0,66
9,4,5,13,0,0,0,0,0,31
9,4,5,13,19,0,0,0,0,50
9,4,5,14,3,5,0,0,0,40
9,4,5,14,20,0,0,0,0,52
9,4,5,14,20,9,3,0,0,64
9,4,5,14,20,9,3,1,12,77
9,4,5,14,20,9,5,19,0,85
9,4,5,14,20,9,6,5,18,90
9,4,5,14,20,9,6,25,0,92
9,4,5,14,20,9,6,9,3,79
9,4,5,14,20,9,19,13,0,93
9,4,5,14,20,9,20,25,0,106
9,4,5,15,0,0,0,0,0,33
9,4,5,15,7,5,14,25,0,84
9,4,5,15,7,12,25,16,8,101
9,4,5,15,7,18,1,13,0,72
9,4,5,15,7,18,1,13,19,91
9,4,5,15,7,18,1,16,8,83
9,4,5,15,12,1,20,18,25,109
9,4,5,15,12,5,3,20,0,73
9,4,5,15,12,15,7,25,0,92
9,4,5,15,12,15,7,9,3,79
9,4,5,15,12,15,7,21,5,93
9,4,5,15,13,1,14,9,1,71
9,4,5,15,13,15,20,15,18,114
9,4,5,15,15,7,9,19,20,103
9,4,5,15,16,8,15,14,5,91
9,4,5,15,20,25,16,5,0,99
9,4,5,19,0,0,0,0,0,37
9,4,5,19,9,1,0,0,0,47
9,4,5,19,20,0,0,0,0,57
9,4,5,20,1,0,0,0,0,39
9,4,7,1,8,0,0,0,0,29
9,4,9,1,19,13,0,0,0,55
9,4,9,3,0,0,0,0,0,25
9,4,9,7,2,15,0,0,0,46
9,4,25,12,0,0,0,0,0,50
9,4,25,12,5,18,0,0,0,73
9,4,25,12,9,1,14,0,0,74
9,4,25,12,9,19,13,0,0,91
9,4,25,12,9,19,20,0,0,98
9,4,25,12,9,19,20,19,0,117
9,4,25,12,9,26,5,0,0,90
9,4,25,12,12,0,0,0,0,62
9,4,25,12,12,5,18,0,0,85
9,4,25,12,12,9,1,0,0,72
9,4,25,12,12,9,1,14,0,86
9,4,25,12,12,9,3,0,0,74
9,4,25,12,12,9,3,1,12,87
9,4,25,12,12,9,15,14,0,100
9,4,25,12,12,9,19,20,0,110
9,4,25,12,12,9,19,20,19,129
9,4,25,12,12,9,21,13,0,105
9,4,25,12,12,19,0,0,0,81
9,4,25,12,19,0,0,0,0,69
9,4,9,14,0,0,0,0,0,36
9,4,9,15,2,12,1,19,20,91
9,4,9,15,3,25,0,0,0,65
9,4,9,15,3,9,5,19,0,73
9,4,9,15,3,18,1,19,25,103
9,4,9,15,7,18,1,13,0,76
9,4,9,15,7,18,1,16,8,87
9,4,9,15,12,1,12,9,1,72
9,4,9,15,12,1,20,18,25,113
9,4,9,15,12,5,3,20,0,77
9,4,9,15,12,5,3,20,19,96
9,4,9,15,12,25,19,9,14,116
9,4,9,15,13,0,0,0,0,50
9,4,9,15,13,1,20,9,3,83
9,4,9,15,13,5,12,15,14,96
9,4,9,15,13,5,20,5,18,98
9,4,9,15,13,19,0,0,0,69
9,4,9,15,14,0,0,0,0,51
9,4,9,15,16,1,20,8,25,107
9,4,9,15,16,8,15,14,5,95
9,4,9,15,16,12,1,19,13,98
9,4,9,15,19,15,13,5,0,89
9,4,9,15,19,16,1,19,13,105
9,4,9,15,20,0,0,0,0,57
9,4,9,15,20,3,25,0,0,85
9,4,9,15,20,3,9,5,19,93
9,4,9,15,20,9,3,0,0,69
9,4,9,15,20,9,3,1,12,82
9,4,9,15,20,9,3,15,14,98
9,4,9,15,20,25,16,5,0,103
9,4,9,15,20,25,16,9,3,110
9,4,9,15,20,9,19,5,0,90
9,4,9,15,20,9,19,5,4,94
9,4,9,15,20,9,19,8,0,93
9,4,9,15,20,9,19,13,0,98
9,4,9,15,20,9,19,13,19,117
9,4,9,15,20,9,26,5,0,97
9,4,9,15,20,9,26,5,4,101
9,4,9,15,20,18,25,0,0,100
9,4,9,15,20,19,0,0,0,76
9,4,9,15,26,15,13,5,0,96
9,4,9,20,5,0,0,0,0,47
9,4,9,20,15,12,0,0,0,69
9,4,9,21,13,0,0,0,0,56
9,4,12,5,0,0,0,0,0,30
9,4,12,5,2,25,0,0,0,57
9,4,12,5,4,0,0,0,0,34
9,4,12,5,6,21,12,0,0,69
9,4,12,5,8,15,15,4,0,72
9,4,12,5,13,5,14,0,0,62
9,4,12,5,13,5,14,20,0,82
9,4,12,5,14,5,19,19,0,87
9,4,12,5,18,0,0,0,0,48
9,4,12,5,18,19,0,0,0,67
9,4,12,5,19,0,0,0,0,49
9,4,12,5,19,5,20,0,0,74
9,4,12,5,19,8,9,16,0,82
9,4,12,5,19,19,5,0,0,73
9,4,12,5,19,19,5,19,0,92
9,4,12,5,19,20,0,0,0,69
9,4,12,5,20,25,0,0,0,75
9,4,12,25,0,0,0,0,0,50
9,4,12,9,14,7,0,0,0,55
9,4,12,9,19,8,0,0,0,61
9,4,15,3,18,1,19,5,0,74
9,4,15,3,18,1,19,5,19,93
9,4,15,12,0,0,0,0,0,40
9,4,15,12,1,19,20,5,18,103
9,4,15,12,1,19,20,18,5,103
9,4,15,12,1,20,5,18,0,84
9,4,15,12,1,20,5,18,19,103
9,4,15,12,1,20,15,18,0,94
9,4,15,12,1,20,18,25,0,104
9,4,15,12,1,20,18,9,3,91
9,4,15,12,5,20,0,0,0,65
9,4,15,12,9,6,25,0,0,80
9,4,15,12,9,19,5,0,0,73
9,4,15,12,9,19,5,4,0,77
9,4,15,12,9,19,5,18,0,91
9,4,15,12,9,19,5,18,19,110
9,4,15,12,9,19,5,19,0,92
9,4,15,12,9,19,8,0,0,76
9,4,15,12,9,19,9,14,7,98
9,4,15,12,9,19,13,0,0,81
9,4,15,12,9,19,13,19,0,100
9,4,15,12,9,19,20,0,0,88
9,4,15,12,9,19,20,9,3,100
9,4,15,12,9,26,5,0,0,80
9,4,15,12,9,26,5,4,0,84
9,4,15,12,9,26,5,18,0,98
9,4,15,12,9,26,5,18,19,117
9,4,15,12,9,26,5,19,0,99
9,4,15,12,9,26,9,14,7,105
9,4,15,12,15,14,0,0,0,69
9,4,15,12,15,21,19,0,0,95
9,4,15,12,19,0,0,0,0,59
9,4,15,12,21,13,0,0,0,74
9,4,15,14,5,1,12,0,0,60
9,4,15,14,5,9,20,25,0,101
9,4,15,14,5,15,21,19,0,102
9,4,15,18,7,1,14,0,0,68
9,4,15,19,5,0,0,0,0,52
9,4,18,9,1,12,9,14,0,76
9,4,18,9,1,12,9,14,5,81
9,4,18,9,1,12,9,20,5,87
9,4,18,25,12,0,0,0,0,68
9,4,18,15,19,9,19,0,0,93
25,4,19,0,0,0,0,0,0,48
25,5,3,3,8,0,0,0,0,44
25,5,3,3,8,25,0,0,0,69
25,5,3,3,8,19,0,0,0,63
25,5,3,8,0,0,0,0,0,41
25,5,3,8,25,0,0,0,0,66
25,5,3,8,19,0,0,0,0,60
25,5,4,0,0,0,0,0,0,34
25,5,4,4,9,14,7,0,0,68
25,5,4,5,0,0,0,0,0,39
25,5,4,5,18,12,25,0,0,94
25,5,5,3,8,0,0,0,0,46
25,5,5,12,0,0,0,0,0,47
25,5,5,12,1,13,1,14,0,76
25,5,5,12,9,14,0,0,0,70
25,5,5,12,9,14,19,0,0,89
25,5,5,19,0,0,0,0,0,54
25,5,5,21,3,8,0,0,0,67
25,5,5,21,3,11,0,0,0,70
25,5,7,7,0,0,0,0,0,44
25,5,7,7,13,1,14,0,0,72
25,5,7,7,13,5,14,0,0,76
25,5,7,7,19,0,0,0,0,63
25,5,7,21,9,20,1,0,0,88
25,5,12,4,0,0,0,0,0,46
25,5,12,4,18,9,14,0,0,87
25,5,12,4,18,9,14,5,0,92
25,5,12,4,18,9,14,7,0,94
25,5,12,4,18,15,3,11,0,93
25,5,12,5,11,0,0,0,0,58
25,5,12,11,0,0,0,0,0,53
25,5,12,11,19,0,0,0,0,72
25,5,12,12,0,0,0,0,0,54
25,5,12,12,5,4,0,0,0,63
25,5,12,12,5,18,0,0,0,77
25,5,12,12,5,18,19,0,0,96
25,5,12,12,9,14,7,0,0,84
25,5,12,12,15,3,8,0,0,80
25,5,12,12,15,23,0,0,0,92
25,5,12,12,15,23,3,21,16,132
25,5,12,12,15,23,5,4,0,101
25,5,12,12,15,23,5,18,0,115
25,5,12,12,15,23,5,19,20,136
25,5,12,12,15,23,6,9,14,121
25,5,12,12,15,23,25,0,0,117
25,5,12,12,15,23,9,14,7,122
25,5,12,12,15,23,9,19,8,128
25,5,12,12,15,23,12,25,0,129
25,5,12,12,15,23,13,1,14,120
25,5,12,12,15,23,19,0,0,111
25,5,12,12,15,23,20,15,16,143
25,5,12,12,19,0,0,0,0,73
25,5,12,13,5,18,0,0,0,78
25,5,12,16,0,0,0,0,0,58
25,5,12,16,5,4,0,0,0,67
25,5,12,16,5,18,0,0,0,81
25,5,12,16,5,18,19,0,0,100
25,5,12,16,9,14,7,0,0,88
25,5,12,16,19,0,0,0,0,77
25,5,12,20,0,0,0,0,0,62
25,5,12,22,5,18,0,0,0,87
25,5,13,5,12,5,19,19,0,103
25,5,13,5,14,9,20,5,19,115
25,5,13,9,14,7,0,0,0,73
25,5,13,19,3,8,9,11,0,93
25,5,13,19,5,12,0,0,0,79
25,5,14,4,5,18,0,0,0,71
25,5,14,7,5,5,19,0,0,80
25,5,14,9,0,0,0,0,0,53
25,5,14,9,20,5,0,0,0,78
25,5,14,14,5,4,0,0,0,67
25,5,14,14,9,14,7,0,0,88
25,5,14,19,0,0,0,0,0,63
25,5,14,20,1,0,0,0,0,65
25,5,14,20,1,19,0,0,0,84
25,5,14,20,5,0,0,0,0,69
25,5,14,20,5,19,0,0,0,88
25,5,14,20,14,9,20,5,0,112
25,5,15,13,0,0,0,0,0,58
25,5,15,13,1,14,0,0,0,73
25,5,15,13,1,14,5,19,19,116
25,5,15,13,1,14,12,25,0,110
25,5,15,13,1,14,18,25,0,116
25,5,15,13,5,14,0,0,0,77
25,5,15,18,12,9,14,7,0,105
25,5,15,23,15,13,1,14,0,111
25,5,15,23,15,13,5,14,0,115
25,5,16,0,0,0,0,0,0,46
25,5,16,5,12,5,9,3,0,80
25,5,16,5,12,25,0,0,0,88
25,5,16,8,5,4,5,0,0,68
25,5,16,12,25,0,0,0,0,83
9,5,18,0,0,0,0,0,0,32
25,5,18,0,0,0,0,0,0,48
25,5,18,2,0,0,0,0,0,50
25,5,18,2,1,0,0,0,0,51
25,5,18,2,1,12,0,0,0,63
25,5,18,2,1,12,5,19,0,87
25,5,18,2,1,19,0,0,0,70
25,5,18,3,21,13,0,0,0,85
25,5,18,4,0,0,0,0,0,52
25,5,18,5,0,0,0,0,0,53
25,5,18,11,0,0,0,0,0,59
25,5,18,11,5,4,0,0,0,68
25,5,18,11,9,14,7,0,0,89
25,5,18,11,19,0,0,0,0,78
25,5,18,14,0,0,0,0,0,62
25,5,18,20,3,8,21,11,0,111
25,5,18,20,8,0,0,0,0,76
25,5,18,22,1,0,0,0,0,71
25,5,19,0,0,0,0,0,0,49
25,5,19,5,0,0,0,0,0,54
25,5,19,5,19,0,0,0,0,73
25,5,19,8,9,22,1,8,0,97
25,5,19,8,9,22,1,8,19,116
25,5,19,8,9,22,1,19,0,108
25,5,19,8,9,22,15,20,0,123
25,5,19,8,9,22,15,20,8,131
25,5,19,19,5,4,0,0,0,77
25,5,19,19,5,19,0,0,0,92
25,5,19,19,9,14,7,0,0,98
25,5,19,19,15,0,0,0,0,83
25,5,19,20,0,0,0,0,0,69
25,5,19,20,5,18,0,0,0,92
25,5,19,20,5,18,4,1,25,122
25,5,19,20,5,18,5,22,5,124
25,5,19,20,5,18,14,0,0,106
25,5,19,20,25,0,0,0,0,94
25,5,19,20,18,5,5,14,0,111
25,5,19,20,18,5,5,14,19,130
25,5,20,0,0,0,0,0,0,50
25,5,20,1,16,1,0,0,0,68
25,5,20,8,0,0,0,0,0,58
25,5,20,8,5,18,0,0,0,81
25,5,20,9,0,0,0,0,0,59
25,5,20,9,19,0,0,0,0,78
25,5,20,12,9,14,0,0,0,85
25,5,20,12,9,14,7,0,0,92
25,5,20,20,0,0,0,0,0,70
25,5,20,20,5,18,0,0,0,93
25,5,20,20,19,0,0,0,0,89
25,5,20,26,5,18,0,0,0,99
25,5,21,11,0,0,0,0,0,62
25,5,21,11,5,4,0,0,0,71
25,5,21,11,25,0,0,0,0,87
25,5,21,11,9,14,7,0,0,92
25,5,21,11,19,0,0,0,0,81
25,5,22,5,14,0,0,0,0,71
25,5,23,0,0,0,0,0,0,53
25,5,23,19,0,0,0,0,0,72
25,5,24,0,0,0,0,0,0,54
25,5,26,0,0,0,0,0,0,56
25,5,26,26,25,0,0,0,0,107
9,6,5,3,11,19,0,0,0,53
25,6,5,18,5,0,0,0,0,59
9,6,5,18,15,21,19,0,0,93
25,6,5,18,18,5,0,0,0,77
9,6,6,25,0,0,0,0,0,46
9,6,6,9,5,18,0,0,0,53
9,6,6,9,5,19,20,0,0,74
9,6,6,9,14,5,19,19,0,87
9,6,25,0,0,0,0,0,0,40
9,6,9,14,20,0,0,0,0,58
9,6,15,18,13,0,0,0,0,61
9,6,18,5,1,12,0,0,0,51
9,6,18,5,5,0,0,0,0,43
9,6,18,9,20,0,0,0,0,62
9,7,8,12,25,0,0,0,0,61
9,7,9,20,21,18,0,0,0,84
9,7,12,5,19,9,1,0,0,62
9,7,12,15,15,0,0,0,0,58
9,7,12,15,15,19,0,0,0,77
9,7,12,21,0,0,0,0,0,49
9,7,12,21,19,0,0,0,0,68
9,7,14,0,0,0,0,0,0,30
9,7,14,1,13,5,0,0,0,49
9,7,14,1,18,15,0,0,0,64
9,7,14,1,20,9,1,19,0,80
9,7,14,1,22,9,1,0,0,63
9,7,14,1,23,0,0,0,0,54
9,7,14,5,15,21,19,0,0,90
9,7,14,5,19,3,5,14,20,96
9,7,14,9,6,25,0,0,0,70
9,7,14,9,6,9,5,4,0,63
9,7,14,9,6,9,5,19,0,78
9,7,14,9,6,25,9,14,7,100
9,7,14,9,6,15,18,13,0,91
9,7,14,9,6,21,7,5,0,78
9,7,14,9,19,0,0,0,0,58
9,7,14,9,20,1,2,12,5,79
9,7,14,9,20,5,0,0,0,64
9,7,14,9,20,5,4,0,0,68
9,7,14,9,20,5,18,0,0,82
9,7,14,9,20,5,18,19,0,101
9,7,14,9,20,5,19,0,0,83
9,7,14,9,20,9,2,12,5,87
9,7,14,9,20,9,14,7,0,89
9,7,14,9,20,9,15,14,0,97
9,7,14,9,20,9,15,14,19,116
9,7,14,9,20,9,22,5,0,95
9,7,14,9,20,15,18,0,0,92
9,7,14,9,20,15,18,19,0,111
9,7,14,9,20,18,15,14,0,106
9,7,14,9,20,18,15,14,19,125
9,7,14,15,2,12,5,0,0,64
9,7,14,15,2,12,25,0,0,84
9,7,14,15,13,9,14,25,0,106
9,7,14,15,13,9,15,21,19,122
9,7,14,15,18,1,2,12,5,83
9,7,14,15,18,1,13,21,19,117
9,7,14,15,18,1,14,3,5,86
9,7,14,15,18,1,14,20,0,98
9,7,14,15,18,5,0,0,0,68
9,7,14,15,18,5,4,0,0,72
9,7,14,15,18,5,18,0,0,86
9,7,14,15,18,5,18,19,0,105
9,7,14,15,18,5,19,0,0,87
9,7,14,15,18,9,14,7,0,93
9,7,14,15,20,5,0,0,0,70
9,7,14,15,20,21,19,0,0,105
9,7,21,1,14,1,0,0,0,53
9,7,21,1,14,1,19,0,0,72
9,7,21,1,14,9,1,14,0,76
9,7,21,1,14,9,1,14,19,95
9,7,21,1,14,9,4,0,0,65
9,7,21,1,14,15,9,4,0,80
9,8,9,0,0,0,0,0,0,26
9,8,12,5,9,20,5,0,0,68
9,8,18,1,13,0,0,0,0,49
9,8,18,1,13,19,0,0,0,68
25,9,4,19,0,0,0,0,0,57
25,9,5,12,4,0,0,0,0,55
25,9,5,12,4,1,2,12,5,75
25,9,5,12,4,1,14,3,5,78
25,9,5,12,4,5,4,0,0,64
25,9,5,12,4,5,14,0,0,74
25,9,5,12,4,5,18,0,0,78
25,9,5,12,4,5,18,19,0,97
25,9,5,12,4,25,0,0,0,80
25,9,5,12,4,9,14,7,0,85
25,9,5,12,4,19,0,0,0,74
25,9,7,8,0,0,0,0,0,49
9,9,9,0,0,0,0,0,0,27
25,9,11,5,0,0,0,0,0,50
25,9,11,5,19,0,0,0,0,69
25,9,12,12,0,0,0,0,0,58
25,9,12,12,19,0,0,0,0,77
25,9,12,20,0,0,0,0,0,66
25,9,14,3,5,0,0,0,0,56
25,9,14,19,0,0,0,0,0,67
25,9,14,19,20,0,0,0,0,87
9,25,15,0,0,0,0,0,0,49
25,9,16,0,0,0,0,0,0,50
25,9,16,5,0,0,0,0,0,55
25,9,16,5,19,0,0,0,0,74
25,9,16,16,5,4,0,0,0,75
25,9,16,16,5,5,0,0,0,76
25,9,16,16,9,5,0,0,0,80
25,9,16,16,9,5,19,0,0,99
25,9,16,16,9,14,7,0,0,96
25,9,16,19,0,0,0,0,0,69
25,9,18,4,0,0,0,0,0,56
25,9,18,4,19,0,0,0,0,75
25,9,18,11,0,0,0,0,0,63
25,9,18,13,0,0,0,0,0,65
25,9,18,13,9,12,9,11,0,106
25,9,18,14,0,0,0,0,0,66
25,9,18,18,0,0,0,0,0,70
25,9,18,18,5,4,0,0,0,79
25,9,18,18,9,14,7,0,0,100
25,9,18,18,19,0,0,0,0,89
25,9,18,20,8,0,0,0,0,80
25,9,18,20,8,19,0,0,0,99
25,9,19,0,0,0,0,0,0,53
25,9,20,5,0,0,0,0,0,59
9,9,23,9,0,0,0,0,0,50
9,10,9,20,8,1,4,0,0,61
9,10,13,1,0,0,0,0,0,33
9,10,13,1,1,0,0,0,0,34
9,10,15,12,9,20,5,0,0,80
9,10,21,19,19,9,20,5,0,112
9,11,5,2,1,14,1,0,0,43
9,11,5,2,1,14,1,19,0,62
9,11,5,25,14,5,19,19,0,107
9,11,15,14,0,0,0,0,0,49
9,11,15,14,1,0,0,0,0,50
9,11,15,14,19,0,0,0,0,68
9,11,18,1,0,0,0,0,0,39
9,12,5,0,0,0,0,0,0,26
9,12,5,1,3,0,0,0,0,30
9,12,5,1,12,0,0,0,0,39
9,12,5,5,3,20,15,13,25,107
9,12,5,9,20,9,4,5,19,92
25,12,5,13,0,0,0,0,0,55
25,12,5,13,19,0,0,0,0,74
9,12,5,15,3,5,3,1,12,65
9,12,5,15,3,15,12,9,3,83
9,12,5,15,14,0,0,0,0,55
9,12,5,15,19,20,15,13,25,133
9,12,5,15,20,15,13,25,0,114
9,12,5,19,9,20,5,0,0,79
9,12,5,21,13,0,0,0,0,60
9,12,5,21,19,0,0,0,0,66
9,12,5,21,19,5,19,0,0,90
9,12,5,24,0,0,0,0,0,50
9,12,5,24,5,19,0,0,0,74
9,12,9,1,3,21,19,0,0,74
9,12,9,1,4,19,0,0,0,54
9,12,9,1,8,9,0,0,0,48
9,12,9,1,12,0,0,0,0,43
9,12,9,1,21,0,0,0,0,52
9,12,9,3,9,3,0,0,0,45
9,12,9,3,9,14,0,0,0,56
9,12,9,13,1,0,0,0,0,44
9,12,9,15,16,19,15,1,19,115
9,12,9,15,16,21,2,9,3,96
9,12,25,19,9,15,9,4,0,102
9,12,9,20,25,0,0,0,0,75
9,12,11,0,0,0,0,0,0,32
9,12,11,1,14,5,0,0,0,52
9,12,11,19,0,0,0,0,0,51
9,12,12,1,2,9,12,5,0,62
9,12,12,1,13,15,14,0,0,76
9,12,12,1,16,19,5,0,0,74
9,12,12,1,16,19,5,4,0,78
9,12,12,1,16,19,9,14,7,99
9,12,12,1,16,19,9,22,5,105
9,12,12,1,20,9,15,14,0,92
9,12,12,1,20,9,15,14,19,111
9,12,12,1,20,9,22,5,0,90
9,12,12,1,20,9,22,5,19,109
9,12,12,2,18,5,4,0,0,62
9,12,12,5,3,11,0,0,0,52
9,12,12,5,3,20,0,0,0,61
9,12,12,5,7,1,12,0,0,58
9,12,12,5,7,1,12,12,25,95
9,12,12,5,7,1,12,19,0,77
9,12,12,5,7,9,2,12,5,73
9,12,12,5,7,9,2,12,25,93
9,12,12,5,9,19,13,0,0,79
9,12,12,5,9,19,20,0,0,86
9,12,12,5,18,0,0,0,0,56
9,12,12,5,19,19,0,0,0,76
9,12,12,5,19,20,0,0,0,77
9,12,12,6,1,18,5,0,0,63
9,12,12,7,21,9,4,5,0,79
9,12,12,7,21,9,4,5,4,83
9,12,12,8,21,13,15,18,0,108
9,12,12,25,0,0,0,0,0,58
9,12,12,9,2,5,18,1,12,80
9,12,12,9,3,9,20,0,0,74
9,12,12,9,3,9,20,12,25,111
9,12,12,9,7,8,20,5,14,96
9,12,12,9,13,9,20,5,4,93
9,12,12,9,14,7,0,0,0,63
9,12,12,9,14,9,21,13,0,99
9,12,12,9,14,9,21,13,19,118
9,12,12,9,16,5,14,5,0,82
9,12,12,9,17,21,9,4,0,93
9,12,12,9,19,8,0,0,0,69
9,12,12,9,19,9,15,14,0,99
9,12,12,9,20,5,0,0,0,67
9,12,12,9,20,5,18,1,12,98
9,12,12,9,20,5,19,0,0,86
9,12,12,9,20,9,3,0,0,74
9,12,12,9,21,13,0,0,0,76
9,12,12,14,1,20,21,18,5,112
9,12,12,14,5,19,19,0,0,90
9,12,12,14,5,19,19,5,19,114
9,12,12,15,3,1,12,0,0,64
9,12,12,15,3,1,12,12,25,101
9,12,12,15,7,9,3,0,0,67
9,12,12,15,7,9,3,1,12,80
9,12,12,15,7,9,3,19,0,86
9,12,12,15,25,1,12,0,0,86
9,12,12,15,25,1,12,20,25,131
9,12,12,19,0,0,0,0,0,52
9,12,12,20,8,0,0,0,0,61
9,12,12,21,4,5,0,0,0,63
9,12,12,21,4,5,4,0,0,67
9,12,12,21,4,5,4,12,25,104
9,12,12,21,4,5,18,0,0,81
9,12,12,21,4,9,14,7,0,88
9,12,12,21,13,5,0,0,0,72
9,12,12,21,13,5,4,0,0,76
9,12,12,21,13,5,18,0,0,90
9,12,12,21,13,5,19,0,0,91
9,12,12,21,13,9,14,5,0,95
9,12,12,21,13,9,14,5,4,99
9,12,12,21,13,9,14,5,5,100
9,12,12,21,13,9,14,5,18,113
9,12,12,21,13,9,14,5,19,114
9,12,12,21,13,9,14,7,0,97
9,12,12,21,16,9,0,0,0,79
9,12,12,21,18,5,0,0,0,77
9,12,12,21,19,0,0,0,0,73
9,12,12,21,19,9,2,12,5,101
9,12,12,21,19,9,15,14,0,111
9,12,12,21,19,9,15,14,19,130
9,12,12,21,19,9,22,5,0,109
9,12,12,21,19,15,18,0,0,106
9,12,12,21,19,15,18,25,0,131
9,12,12,21,19,20,0,0,0,93
9,12,12,21,19,20,18,5,0,116
9,12,12,21,20,1,20,5,0,100
9,12,12,21,22,9,1,0,0,86
9,12,12,21,22,9,1,12,0,98
9,12,12,21,22,9,1,20,5,111
9,12,12,21,22,9,21,13,0,119
9,12,12,21,22,9,21,13,19,138
9,12,12,21,22,9,22,9,1,117
9,12,13,5,14,9,20,5,0,87
9,12,13,5,14,9,20,5,19,106
9,12,15,20,0,0,0,0,0,56
9,12,20,8,0,0,0,0,0,49
9,12,22,1,9,20,5,0,0,78
9,13,2,1,12,1,14,3,5,60
9,13,2,1,12,13,0,0,0,50
9,13,2,1,12,13,5,4,0,59
9,13,2,1,12,13,5,18,0,73
9,13,2,1,12,13,5,18,19,92
9,13,2,1,12,13,9,14,7,80
9,13,2,1,12,13,19,0,0,69
9,13,2,1,14,0,0,0,0,39
9,13,2,1,14,4,0,0,0,43
9,13,2,1,18,7,5,0,0,55
9,13,2,1,18,11,0,0,0,54
9,13,2,1,18,11,5,4,0,63
9,13,2,1,18,11,9,14,7,84
9,13,2,1,18,11,19,0,0,73
9,13,2,1,18,14,0,0,0,57
9,13,2,1,19,5,0,0,0,49
9,13,2,1,19,5,4,0,0,53
9,13,2,1,20,0,0,0,0,45
9,13,2,1,20,8,5,0,0,58
9,13,2,1,21,2,1,0,0,49
9,13,2,5,0,0,0,0,0,29
9,13,2,5,3,9,12,5,0,58
9,13,2,5,3,9,12,5,19,77
9,13,2,5,3,9,12,9,3,65
9,13,2,5,4,0,0,0,0,33
9,13,2,5,4,4,5,4,0,46
9,13,2,5,4,4,9,14,7,67
9,13,2,5,4,19,0,0,0,52
9,13,2,5,12,12,9,3,0,65
9,13,2,5,18,0,0,0,0,47
9,13,2,5,18,2,5,0,0,54
9,13,2,5,19,5,12,0,0,65
9,13,2,9,2,5,0,0,0,40
9,13,2,9,2,5,4,0,0,44
9,13,2,9,2,5,18,0,0,58
9,13,2,9,2,5,18,19,0,77
9,13,2,9,2,5,19,0,0,59
9,13,2,9,2,9,14,7,0,65
9,13,2,9,18,21,19,19,21,131
9,13,2,9,20,20,5,18,0,96
9,13,2,9,20,20,5,18,19,115
9,13,2,12,1,26,5,0,0,68
9,13,2,12,1,26,5,4,0,72
9,13,2,12,1,26,5,19,0,87
9,13,2,12,1,26,9,14,7,93
9,13,2,15,4,25,0,0,0,68
9,13,2,15,4,9,5,4,0,61
9,13,2,15,4,9,5,19,0,76
9,13,2,15,4,25,9,14,7,98
9,13,2,15,12,4,5,14,0,74
9,13,2,15,12,4,5,14,19,93
9,13,2,15,12,9,19,8,0,87
9,13,2,15,14,4,15,0,0,72
9,13,2,15,14,9,20,25,0,107
9,13,2,15,18,4,5,18,0,84
9,13,2,15,18,4,21,18,5,105
9,13,2,15,19,3,1,20,1,83
9,13,2,15,19,11,0,0,0,69
9,13,2,15,19,15,13,0,0,86
9,13,2,15,19,15,13,5,4,95
9,13,2,15,19,15,13,19,0,105
9,13,2,15,23,5,18,0,0,85
9,13,2,15,23,5,18,5,4,94
9,13,2,15,23,5,18,19,0,104
9,13,2,18,1,3,5,18,25,94
9,13,2,18,1,14,3,8,0,68
9,13,2,18,1,14,7,12,5,81
9,13,2,18,5,1,20,8,5,81
9,13,2,18,5,4,0,0,0,51
9,13,2,18,5,24,0,0,0,71
9,13,2,18,9,3,1,20,5,80
9,13,2,18,9,3,5,19,0,78
9,13,2,18,9,5,18,0,0,74
9,13,2,18,15,3,1,4,15,80
9,13,2,18,15,7,12,9,15,100
9,13,2,18,15,9,14,0,0,80
9,13,2,18,15,23,14,0,0,94
9,13,2,18,15,23,14,5,4,103
9,13,2,18,15,23,14,19,0,113
9,13,2,18,21,5,0,0,0,68
9,13,2,18,21,5,4,0,0,72
9,13,2,18,21,5,19,0,0,87
9,13,2,18,21,9,14,7,0,93
9,13,2,18,21,20,5,0,0,88
9,13,2,18,21,20,5,4,0,92
9,13,2,18,21,20,5,19,0,107
9,13,2,18,21,20,9,14,7,113
9,13,2,21,0,0,0,0,0,45
9,13,2,21,5,0,0,0,0,50
9,13,2,21,5,4,0,0,0,54
9,13,2,21,5,13,5,14,20,102
9,13,2,21,5,19,0,0,0,69
9,13,2,21,9,1,0,0,0,55
9,13,2,21,9,14,7,0,0,75
9,13,2,21,18,19,5,0,0,87
9,13,2,21,18,19,5,4,0,91
9,13,2,21,18,19,9,14,7,112
9,13,2,21,20,5,0,0,0,70
9,13,3,14,20,0,0,0,0,59
9,13,4,20,12,25,0,0,0,83
9,13,5,12,12,5,0,0,0,56
9,13,9,0,0,0,0,0,0,31
9,13,9,4,0,0,0,0,0,35
9,13,9,4,1,26,15,12,0,89
9,13,9,4,1,26,15,12,5,94
9,13,9,4,5,0,0,0,0,40
9,13,9,4,5,19,0,0,0,59
9,13,9,4,9,3,0,0,0,47
9,13,9,4,15,0,0,0,0,50
9,13,9,4,15,7,5,14,0,76
9,13,9,4,19,0,0,0,0,54
9,13,9,14,1,26,15,12,5,104
9,13,9,14,5,0,0,0,0,50
9,13,9,14,5,19,0,0,0,69
9,13,9,14,15,0,0,0,0,60
9,13,9,14,15,21,18,5,1,105
9,13,9,20,0,0,0,0,0,51
9,13,9,20,1,2,12,5,0,71
9,13,9,20,1,14,3,25,0,94
9,13,9,20,1,14,20,0,0,86
9,13,9,20,1,20,5,0,0,77
9,13,9,20,1,20,5,4,0,81
9,13,9,20,1,20,5,5,0,82
9,13,9,20,1,20,5,19,0,96
9,13,9,20,1,20,9,14,7,102
9,13,9,20,1,20,9,15,14,110
9,13,9,20,1,20,9,22,5,108
9,13,9,20,1,20,15,18,0,105
9,13,9,20,1,20,15,18,19,124
9,13,9,20,1,20,18,9,24,123
9,13,13,1,9,12,5,4,0,66
9,13,13,1,14,1,3,12,5,71
9,13,13,1,14,5,0,0,0,55
9,13,13,1,14,5,12,25,0,92
9,13,13,1,14,5,14,3,5,77
9,13,13,1,14,5,14,3,25,97
9,13,13,1,14,5,14,20,0,89
9,13,13,1,14,9,20,25,0,104
9,13,13,1,14,20,12,5,0,87
9,13,13,1,14,20,12,5,4,91
9,13,13,1,18,2,12,5,0,73
9,13,13,1,18,20,9,1,12,96
9,13,13,1,19,11,0,0,0,66
9,13,13,1,20,21,18,5,0,100
9,13,13,1,20,21,18,5,4,104
9,13,13,1,20,21,18,5,19,119
9,13,13,5,4,9,1,3,25,82
9,13,13,5,4,9,1,12,0,66
9,13,13,5,4,9,1,20,5,79
9,13,13,5,12,13,1,14,14,94
9,13,13,5,13,2,5,18,0,78
9,13,13,5,14,19,5,0,0,78
9,13,13,5,14,19,5,12,25,115
9,13,13,5,14,19,5,18,0,96
9,13,13,5,14,19,5,19,20,117
9,13,13,5,14,19,9,20,25,127
9,13,13,5,14,19,9,22,5,109
9,13,13,5,18,4,0,0,0,62
9,13,13,5,18,7,5,0,0,70
9,13,13,5,18,7,5,4,0,74
9,13,13,5,18,7,5,14,20,104
9,13,13,5,18,7,5,19,0,89
9,13,13,5,18,7,9,14,7,95
9,13,13,5,18,9,20,0,0,87
9,13,13,5,18,9,20,5,4,96
9,13,13,5,18,19,5,0,0,82
9,13,13,5,18,19,5,4,0,86
9,13,13,5,18,19,5,19,0,101
9,13,13,5,18,19,9,14,7,107
9,13,13,5,18,19,9,15,14,115
9,13,13,5,18,19,9,22,5,113
9,13,13,5,19,8,0,0,0,67
9,13,13,5,19,8,5,4,0,76
9,13,13,5,19,8,5,19,0,91
9,13,13,5,19,8,9,14,7,97
9,13,13,5,21,2,12,5,19,99
9,13,13,5,23,0,0,0,0,63
9,13,13,9,0,0,0,0,0,44
9,13,13,25,0,0,0,0,0,60
9,13,13,9,5,19,0,0,0,68
9,13,13,9,7,18,1,14,20,104
9,13,13,9,7,18,1,20,5,95
9,13,13,9,14,4,0,0,0,62
9,13,13,9,14,5,14,3,5,85
9,13,13,9,14,5,14,3,25,105
9,13,13,9,14,5,14,20,0,97
9,13,13,9,14,7,12,5,0,82
9,13,13,9,14,7,12,5,4,86
9,13,13,9,14,7,12,5,19,101
9,13,13,9,14,21,20,5,0,104
9,13,13,9,19,0,0,0,0,63
9,13,13,9,19,19,0,0,0,82
9,13,13,9,19,19,9,15,14,120
9,13,13,9,20,0,0,0,0,64
9,13,13,9,20,20,5,4,0,93
9,13,13,9,24,0,0,0,0,68
9,13,13,9,24,1,2,12,5,88
9,13,13,9,24,5,4,0,0,77
9,13,13,9,24,5,19,0,0,92
9,13,13,9,24,9,14,7,0,98
9,13,13,9,24,20,0,0,0,88
9,13,13,9,24,20,9,14,7,118
9,13,13,9,24,20,21,18,5,132
9,13,13,15,2,9,12,5,0,78
9,13,13,15,2,9,12,5,19,97
9,13,13,15,2,9,12,9,1,83
9,13,13,15,4,5,19,20,0,98
9,13,13,15,4,5,19,20,25,123
9,13,13,15,4,9,19,8,0,90
9,13,13,15,12,1,20,5,0,88
9,13,13,15,12,1,20,5,4,92
9,13,13,15,12,1,20,5,19,107
9,13,13,15,12,1,20,15,18,116
9,13,13,15,13,5,14,20,0,102
9,13,13,15,18,1,12,0,0,81
9,13,13,15,18,1,12,12,25,118
9,13,13,15,18,20,1,12,0,101
9,13,13,15,20,5,0,0,0,75
9,13,13,15,20,9,12,5,0,96
9,13,13,15,20,9,22,5,0,106
9,13,13,15,21,14,4,0,0,89
9,13,13,15,22,0,0,0,0,72
9,13,13,15,22,1,2,12,5,92
9,13,13,15,22,1,2,12,25,112
9,13,13,15,22,5,4,0,0,81
9,13,13,21,14,0,0,0,0,70
9,13,13,21,14,4,0,0,0,74
9,13,13,21,14,4,9,20,25,128
9,13,13,21,14,5,0,0,0,75
9,13,13,21,14,5,19,0,0,94
9,13,13,21,14,9,19,5,0,103
9,13,13,21,14,9,19,5,4,107
9,13,13,21,14,9,19,5,18,121
9,13,13,21,14,9,19,5,19,122
9,13,13,21,14,9,19,20,0,118
9,13,13,21,14,9,20,25,0,124
9,13,13,21,14,9,26,5,0,110
9,13,13,21,14,9,26,5,4,114
9,13,13,21,14,9,26,5,18,128
9,13,13,21,14,9,26,5,19,129
9,13,13,21,14,15,7,5,14,111
9,13,13,21,14,15,12,0,0,97
9,13,13,21,18,5,0,0,0,79
9,13,13,21,18,5,4,0,0,83
9,13,13,21,18,5,19,0,0,98
9,13,13,21,18,9,14,7,0,104
9,13,13,21,19,9,3,1,12,100
9,13,13,21,20,1,2,12,5,96
9,13,13,21,20,1,2,12,25,116
9,13,13,21,20,1,20,5,0,102
9,13,13,21,20,5,0,0,0,81
9,13,13,21,20,21,1,12,0,110
9,13,15,14,9,21,13,0,0,94
9,13,16,1,3,1,2,12,5,62
9,13,16,1,3,11,0,0,0,53
9,13,16,1,3,20,5,4,0,71
9,13,16,1,3,20,5,18,0,85
9,13,16,1,3,20,5,18,19,104
9,13,16,1,3,20,6,21,12,101
9,13,16,1,3,20,9,14,7,92
9,13,16,1,3,20,9,15,14,100
9,13,16,1,3,20,9,20,5,96
9,13,16,1,3,20,9,22,5,98
9,13,16,1,3,20,15,18,0,95
9,13,16,1,3,20,15,18,19,114
9,13,16,1,3,20,19,0,0,81
9,13,16,1,3,20,21,1,12,96
9,13,16,1,7,5,19,0,0,70
9,13,16,1,25,1,2,12,5,84
9,13,16,1,9,14,20,0,0,82
9,13,16,1,9,14,20,5,4,91
9,13,16,1,9,14,20,19,0,101
9,13,16,1,9,18,0,0,0,66
9,13,16,1,9,18,5,4,0,75
9,13,16,1,9,18,5,18,0,89
9,13,16,1,9,18,5,18,19,108
9,13,16,1,9,18,9,14,7,96
9,13,16,1,9,18,19,0,0,85
9,13,16,1,12,1,0,0,0,52
9,13,16,1,12,1,3,5,0,60
9,13,16,1,12,1,19,0,0,71
9,13,16,1,12,5,0,0,0,56
9,13,16,1,12,5,4,0,0,60
9,13,16,1,12,5,18,0,0,74
9,13,16,1,12,5,18,19,0,93
9,13,16,1,12,5,19,0,0,75
9,13,16,1,12,9,14,7,0,81
9,13,16,1,12,12,0,0,0,63
9,13,16,1,12,12,9,4,0,76
9,13,16,1,12,13,0,0,0,64
9,13,16,1,12,13,5,4,0,73
9,13,16,1,12,19,25,0,0,95
9,13,16,1,14,1,20,5,0,79
9,13,16,1,14,1,20,5,4,83
9,13,16,1,14,1,20,15,18,107
9,13,16,1,14,5,0,0,0,58
9,13,16,1,14,5,12,0,0,70
9,13,16,1,14,5,12,5,4,79
9,13,16,1,14,5,12,19,0,89
9,13,16,1,16,1,19,5,0,80
9,13,16,1,18,0,0,0,0,57
9,13,16,1,18,9,20,25,0,111
9,13,16,1,18,11,0,0,0,68
9,13,16,1,18,11,5,4,0,77
9,13,16,1,18,11,9,14,7,98
9,13,16,1,18,11,19,0,0,87
9,13,16,1,18,12,0,0,0,69
9,13,16,1,18,12,5,4,0,78
9,13,16,1,18,12,9,14,7,99
9,13,16,1,18,20,0,0,0,77
9,13,16,1,18,20,5,4,0,86
9,13,16,1,18,20,5,18,0,100
9,13,16,1,18,20,5,18,19,119
9,13,16,1,18,20,9,1,12,99
9,13,16,1,18,20,9,14,7,107
9,13,16,1,18,20,9,20,5,111
9,13,16,1,18,20,9,22,5,113
9,13,16,1,18,20,19,0,0,96
9,13,16,1,19,19,5,0,0,82
9,13,16,1,19,19,5,19,0,101
9,13,16,1,19,19,9,15,14,115
9,13,16,1,19,19,9,22,5,113
9,13,16,1,19,20,5,0,0,83
9,13,16,1,19,20,5,4,0,87
9,13,16,1,19,20,5,19,0,102
9,13,16,1,19,20,9,14,7,108
9,13,16,1,19,20,15,0,0,93
9,13,16,1,19,20,15,5,4,102
9,13,16,1,19,20,15,19,0,112
9,13,16,1,19,20,21,18,5,122
9,13,16,1,20,9,2,12,5,87
9,13,16,1,20,9,5,14,20,107
9,13,16,1,22,5,0,0,0,66
9,13,16,1,22,9,4,0,0,74
9,13,16,1,22,9,4,12,25,111
9,13,16,1,23,14,0,0,0,76
9,13,16,1,23,14,5,4,0,85
9,13,16,1,23,14,9,14,7,106
9,13,16,1,23,14,19,0,0,95
9,13,16,5,1,3,8,0,0,55
9,13,16,5,1,3,8,5,4,64
9,13,16,5,1,3,8,5,18,78
9,13,16,5,1,3,8,5,19,79
9,13,16,5,1,18,12,0,0,74
9,13,16,5,1,18,12,5,4,83
9,13,16,5,1,18,12,19,0,93
9,13,16,5,3,3,1,14,20,84
9,13,16,5,4,0,0,0,0,47
9,13,16,5,4,1,14,3,5,70
9,13,16,5,4,5,0,0,0,52
9,13,16,5,4,5,4,0,0,56
9,13,16,5,4,5,18,0,0,70
9,13,16,5,4,5,18,19,0,89
9,13,16,5,4,5,19,0,0,71
9,13,16,5,4,9,2,12,5,75
9,13,16,5,4,9,5,14,20,95
9,13,16,5,4,9,14,7,0,77
9,13,16,5,4,9,20,0,0,76
9,13,16,5,4,9,20,5,0,81
9,13,16,5,4,15,18,0,0,80
9,13,16,5,5,22,9,19,8,106
9,13,16,5,12,0,0,0,0,55
9,13,16,5,12,12,5,4,0,76
9,13,16,5,12,12,5,14,20,106
9,13,16,5,12,12,5,18,0,90
9,13,16,5,12,12,5,18,19,109
9,13,16,5,12,12,9,14,7,97
9,13,16,5,12,12,15,18,0,100
9,13,16,5,12,12,15,18,19,119
9,13,16,5,12,19,0,0,0,74
9,13,16,5,14,0,0,0,0,57
9,13,16,5,14,4,0,0,0,61
9,13,16,5,14,4,5,4,0,70
9,13,16,5,14,4,5,14,20,100
9,13,16,5,14,4,9,14,7,91
9,13,16,5,14,4,19,0,0,80
9,13,16,5,14,14,1,20,5,97
9,13,16,5,14,14,15,21,19,126
9,13,16,5,14,20,0,0,0,77
9,13,16,5,15,16,12,5,0,91
9,13,16,5,18,0,0,0,0,61
9,13,16,5,18,1,14,3,5,84
9,13,16,5,18,1,14,20,0,96
9,13,16,5,18,1,20,5,0,87
9,13,16,5,18,1,20,15,18,115
9,13,16,5,18,5,14,3,5,88
9,13,16,5,18,5,14,20,0,100
9,13,16,5,18,6,0,0,0,67
9,13,16,5,18,6,5,3,20,95
9,13,16,5,18,25,0,0,0,86
9,13,16,5,18,9,1,12,19,102
9,13,16,5,18,9,9,0,0,79
9,13,16,5,18,9,12,0,0,82
9,13,16,5,18,9,12,5,4,91
9,13,16,5,18,9,12,19,0,101
9,13,16,5,18,9,15,21,19,125
9,13,16,5,18,9,19,8,0,97
9,13,16,5,18,9,20,5,0,95
9,13,16,5,18,9,21,13,0,104
9,13,16,5,18,9,21,13,19,123
9,13,16,5,18,13,9,24,20,127
9,13,16,5,18,19,0,0,0,80
9,13,16,5,18,22,9,1,12,105
9,13,16,5,19,20,0,0,0,82
9,13,16,5,19,20,5,18,0,105
9,13,16,5,20,9,3,15,19,109
9,13,16,5,20,9,7,15,0,94
9,13,16,5,20,9,7,15,19,113
9,13,16,5,20,18,1,20,5,107
9,13,16,5,20,18,5,0,0,86
9,13,16,5,20,21,15,19,15,133
9,13,16,5,20,21,15,21,19,139
9,13,16,5,20,21,19,0,0,103
9,13,16,5,20,21,19,5,19,127
9,13,16,6,0,0,0,0,0,44
9,13,16,8,5,5,0,0,0,56
9,13,16,8,5,5,19,0,0,75
9,13,16,9,0,0,0,0,0,47
9,13,16,25,0,0,0,0,0,63
9,13,16,9,3,20,21,18,5,114
9,13,16,9,5,18,3,5,0,78
9,13,16,9,5,19,0,0,0,71
9,13,16,9,5,20,25,0,0,97
9,13,16,9,5,20,9,5,19,105
9,13,16,9,14,7,0,0,0,68
9,13,16,9,14,7,5,0,0,73
9,13,16,9,14,7,5,4,0,77
9,13,16,9,14,7,5,14,20,107
9,13,16,9,14,7,5,18,0,91
9,13,16,9,14,7,5,18,19,110
9,13,16,9,14,7,5,19,0,92
9,13,16,9,14,7,9,14,7,98
9,13,16,9,14,7,19,0,0,87
9,13,16,9,15,21,19,0,0,102
9,13,16,9,15,21,19,12,25,139
9,13,16,9,19,0,0,0,0,66
9,13,16,9,19,8,0,0,0,74
9,13,16,9,19,8,12,25,0,111
9,13,16,9,20,5,15,21,19,127
9,13,16,12,1,14,20,0,0,85
9,13,16,12,1,14,20,5,4,94
9,13,16,12,1,14,20,5,18,108
9,13,16,12,1,14,20,19,0,104
9,13,16,12,1,19,20,9,3,102
9,13,16,12,1,20,5,0,0,76
9,13,16,12,5,1,3,8,0,67
9,13,16,12,5,1,4,0,0,60
9,13,16,12,5,1,4,5,4,69
9,13,16,12,5,1,4,5,18,83
9,13,16,12,5,1,4,19,0,79
9,13,16,12,5,4,7,5,0,71
9,13,16,12,5,4,7,5,4,75
9,13,16,12,5,4,7,5,19,90
9,13,16,12,5,13,5,14,20,107
9,13,16,12,5,20,5,0,0,80
9,13,16,12,5,20,9,15,14,113
9,13,16,12,5,20,9,22,5,111
9,13,16,12,5,24,0,0,0,79
9,13,16,12,25,0,0,0,0,75
9,13,16,12,9,1,2,12,5,79
9,13,16,12,9,1,2,12,25,99
9,13,16,12,9,1,12,0,0,72
9,13,16,12,9,3,1,14,20,97
9,13,16,12,9,3,1,20,5,88
9,13,16,12,9,3,9,20,0,91
9,13,16,12,9,3,9,20,25,116
9,13,16,12,9,5,4,0,0,68
9,13,16,12,9,5,4,12,25,105
9,13,16,12,9,5,19,0,0,83
9,13,16,12,25,9,14,7,0,105
9,13,16,12,9,14,7,0,0,80
9,13,16,12,15,4,5,0,0,74
9,13,16,12,15,4,5,4,0,78
9,13,16,12,15,4,5,14,20,108
9,13,16,12,15,4,5,19,0,93
9,13,16,12,15,4,9,14,7,99
9,13,16,12,15,18,5,0,0,88
9,13,16,12,15,18,5,4,0,92
9,13,16,12,15,18,5,18,0,106
9,13,16,12,15,18,5,18,19,125
9,13,16,12,15,18,5,19,0,107
9,13,16,12,15,18,9,14,7,113
9,13,16,12,15,19,9,15,14,122
9,13,16,12,15,19,9,22,5,120
9,13,16,12,21,13,5,0,0,89
9,13,16,12,21,13,5,4,0,93
9,13,16,12,21,14,7,5,0,97
9,13,16,12,21,22,9,1,0,103
9,13,16,12,21,22,9,21,13,136
9,13,16,15,3,11,5,20,0,92
9,13,16,15,6,15,0,0,0,74
9,13,16,15,9,19,15,14,0,110
9,13,16,15,12,4,5,18,0,92
9,13,16,15,12,9,3,25,0,102
9,13,16,15,12,9,20,5,0,99
9,13,16,15,12,9,20,9,3,106
9,13,16,15,12,12,21,20,5,123
9,13,16,15,14,5,0,0,0,72
9,13,16,15,14,5,4,0,0,76
9,13,16,15,14,5,14,20,0,106
9,13,16,15,14,5,19,0,0,91
9,13,16,15,14,9,14,7,0,97
9,13,16,15,15,18,0,0,0,86
9,13,16,15,16,21,12,1,18,121
9,13,16,15,18,15,21,19,0,126
9,13,16,15,18,20,0,0,0,91
9,13,16,15,18,20,1,14,20,126
9,13,16,15,18,20,5,4,0,100
9,13,16,15,18,20,5,5,0,101
9,13,16,15,18,20,5,18,0,114
9,13,16,15,18,20,5,18,19,133
9,13,16,15,18,20,9,14,7,121
9,13,16,15,18,20,18,1,25,135
9,13,16,15,18,20,19,0,0,110
9,13,16,15,18,20,21,14,5,131
9,13,16,15,19,1,2,12,5,92
9,13,16,15,19,1,12,0,0,85
9,13,16,15,19,5,0,0,0,77
9,13,16,15,19,5,4,0,0,81
9,13,16,15,19,5,18,0,0,95
9,13,16,15,19,5,18,19,0,114
9,13,16,15,19,5,19,0,0,96
9,13,16,15,19,9,14,7,0,102
9,13,16,15,19,20,0,0,0,92
9,13,16,15,19,20,5,4,0,101
9,13,16,15,19,20,5,18,0,115
9,13,16,15,19,20,5,18,19,134
9,13,16,15,19,20,9,14,7,122
9,13,16,15,19,20,15,18,0,125
9,13,16,15,19,20,15,18,19,144
9,13,16,15,19,20,18,9,24,143
9,13,16,15,19,20,19,0,0,111
9,13,16,15,19,20,21,13,5,131
9,13,16,15,19,20,21,18,5,136
9,13,16,15,19,20,21,18,25,156
9,13,16,15,19,21,18,5,0,116
9,13,16,15,20,0,0,0,0,73
9,13,16,15,20,1,2,12,5,93
9,13,16,15,20,5,14,3,5,100
9,13,16,15,20,5,14,3,25,120
9,13,16,15,20,5,14,20,0,112
9,13,16,15,20,5,14,20,19,131
9,13,16,15,21,14,4,0,0,92
9,13,16,15,21,14,4,5,4,101
9,13,16,15,21,14,4,5,18,115
9,13,16,15,21,14,4,19,0,111
9,13,16,15,23,5,18,0,0,99
9,13,16,15,23,5,18,5,4,108
9,13,16,15,23,5,18,19,0,118
9,13,16,18,1,19,1,0,0,77
9,13,16,18,5,3,1,14,20,99
9,13,16,18,5,3,1,20,5,90
9,13,16,18,5,3,9,19,5,97
9,13,16,18,5,7,0,0,0,68
9,13,16,18,5,7,14,0,0,82
9,13,16,18,5,7,14,5,4,91
9,13,16,18,5,7,14,19,0,101
9,13,16,18,5,19,1,0,0,81
9,13,16,18,5,19,1,18,9,108
9,13,16,18,5,19,1,19,0,100
9,13,16,18,5,19,5,0,0,85
9,13,16,18,5,19,5,19,0,104
9,13,16,18,5,19,19,0,0,99
9,13,16,18,5,19,19,1,0,100
9,13,16,18,5,19,19,5,4,108
9,13,16,18,5,19,19,5,18,122
9,13,16,18,5,19,19,5,19,123
9,13,16,18,5,19,19,15,18,132
9,13,16,18,5,19,20,0,0,100
9,13,16,18,5,19,20,5,4,109
9,13,16,18,5,19,20,19,0,119
9,13,16,18,5,22,21,0,0,104
9,13,16,18,9,13,5,0,0,83
9,13,16,18,9,13,5,14,20,117
9,13,16,18,9,13,5,18,25,126
9,13,16,18,9,13,9,19,0,106
9,13,16,18,9,14,20,0,0,99
9,13,16,18,9,14,20,5,4,108
9,13,16,18,9,14,20,5,18,122
9,13,16,18,9,14,20,19,0,118
9,13,16,18,9,19,15,14,0,113
9,13,16,18,9,19,15,14,19,132
9,13,16,18,15,2,1,20,5,99
9,13,16,18,15,2,9,20,25,127
9,13,16,18,15,13,16,20,0,120
9,13,16,18,15,13,16,20,21,141
9,13,16,18,15,15,6,0,0,92
9,13,16,18,15,16,5,18,0,110
9,13,16,18,15,16,18,25,0,130
9,13,16,18,15,22,0,0,0,93
9,13,16,18,15,22,5,0,0,98
9,13,16,18,15,22,5,4,0,102
9,13,16,18,15,22,5,18,0,116
9,13,16,18,15,22,5,18,19,135
9,13,16,18,15,22,5,19,0,117
9,13,16,18,15,22,9,14,7,123
9,13,16,18,15,22,9,19,5,126
9,13,16,18,15,22,9,19,15,136
9,13,16,18,15,22,19,0,0,112
9,13,16,18,21,4,5,14,20,120
9,13,16,19,0,0,0,0,0,57
9,13,16,19,8,9,16,0,0,90
9,13,16,19,15,14,9,20,5,120
9,13,16,21,2,5,18,1,12,97
9,13,16,21,2,5,18,20,25,129
9,13,16,21,2,9,3,0,0,73
9,13,16,21,4,5,14,3,5,90
9,13,16,21,4,5,14,3,25,110
9,13,16,21,4,5,14,20,0,102
9,13,16,21,7,14,0,0,0,80
9,13,16,21,7,14,5,4,0,89
9,13,16,21,7,14,5,18,0,103
9,13,16,21,7,14,5,18,19,122
9,13,16,21,7,14,9,14,7,110
9,13,16,21,7,14,19,0,0,99
9,13,16,21,12,19,5,0,0,95
9,13,16,21,12,19,5,4,0,99
9,13,16,21,12,19,5,19,0,114
9,13,16,21,12,19,9,14,7,120
9,13,16,21,12,19,9,15,14,128
9,13,16,21,12,19,9,22,5,126
9,13,16,21,12,19,15,18,0,123
9,13,16,21,12,19,15,18,25,148
9,13,16,21,14,5,0,0,0,78
9,13,16,21,14,5,12,25,0,115
9,13,16,21,14,9,2,12,5,101
9,13,16,21,14,9,2,12,25,121
9,13,16,21,14,9,20,25,0,127
9,13,16,21,18,5,0,0,0,82
9,13,16,21,18,5,12,25,0,119
9,13,16,21,18,9,6,25,0,117
9,13,16,21,18,9,20,1,14,121
9,13,16,21,18,9,20,25,0,131
9,13,16,21,18,16,12,5,0,110
9,13,16,21,20,0,0,0,0,79
9,13,16,21,20,1,2,12,5,99
9,13,16,21,20,1,2,12,25,119
9,13,16,21,20,5,0,0,0,84
9,13,16,21,20,5,4,0,0,88
9,13,16,21,20,5,4,12,25,125
9,13,16,21,20,5,18,0,0,102
9,13,16,21,20,5,18,19,0,121
9,13,16,21,20,5,19,0,0,103
9,13,16,21,20,9,14,7,0,109
9,13,16,21,20,18,9,4,0,110
9,13,16,21,20,20,9,14,7,129
9,13,16,22,0,0,0,0,0,60
9,13,19,8,9,0,0,0,0,58
9,13,19,15,14,9,3,0,0,82
9,13,21,0,0,0,0,0,0,43
9,13,22,9,1,0,0,0,0,54
9,14,2,1,18,4,7,5,0,60
9,14,2,1,19,19,1,20,0,85
9,14,2,2,18,5,4,0,0,54
9,14,2,4,0,0,0,0,0,29
9,14,2,5,0,0,0,0,0,30
9,14,2,5,1,13,9,14,7,74
9,14,2,5,1,18,9,14,7,79
9,14,2,5,9,14,7,0,0,60
9,14,2,5,9,14,7,19,0,79
9,14,2,5,14,4,9,14,7,78
9,14,2,5,14,20,0,0,0,64
9,14,2,25,0,0,0,0,0,50
9,14,2,25,5,0,0,0,0,55
9,14,2,9,18,20,8,0,0,80
9,14,2,9,20,19,0,0,0,73
9,14,2,12,15,23,0,0,0,75
9,14,2,12,15,23,9,14,7,105
9,14,2,12,15,23,14,0,0,89
9,14,2,15,1,18,4,0,0,63
9,14,2,15,1,18,4,19,0,82
9,14,2,15,4,25,0,0,0,69
9,14,2,15,14,4,0,0,0,58
9,14,2,15,18,14,0,0,0,72
9,14,2,15,21,14,4,0,0,79
9,14,2,15,21,14,4,19,0,98
9,14,2,15,23,0,0,0,0,63
9,14,2,15,23,5,4,0,0,72
9,14,2,18,5,1,4,0,0,53
9,14,2,18,5,1,11,0,0,60
9,14,2,18,5,1,20,8,0,77
9,14,2,18,5,1,20,8,5,82
9,14,2,18,5,4,0,0,0,52
9,14,2,18,5,4,19,0,0,71
9,14,2,18,5,5,4,0,0,57
9,14,2,18,5,5,4,5,18,80
9,14,2,18,5,5,4,19,0,76
9,14,2,18,9,14,7,0,0,73
9,14,2,18,9,14,7,5,18,96
9,14,2,18,15,21,7,8,20,114
9,14,2,21,9,12,20,0,0,87
9,14,2,21,18,14,9,14,7,108
9,14,2,21,18,14,20,0,0,98
9,14,2,21,18,19,20,0,0,103
9,14,2,21,18,19,20,19,0,122
9,14,2,21,19,8,0,0,0,73
9,14,3,1,7,5,0,0,0,39
9,14,3,1,7,5,4,0,0,43
9,14,3,1,7,5,19,0,0,58
9,14,3,1,7,9,14,7,0,64
9,14,3,1,12,22,5,18,0,84
9,14,3,1,12,22,9,14,7,91
9,14,3,1,13,16,0,0,0,56
9,14,3,1,14,4,5,14,20,84
9,14,3,1,14,15,21,19,0,96
9,14,3,1,14,20,0,0,0,61
9,14,3,1,14,20,5,4,0,70
9,14,3,1,14,20,15,14,0,90
9,14,3,1,14,20,19,0,0,80
9,14,3,1,16,1,2,12,5,63
9,14,3,1,16,1,2,12,25,83
9,14,3,1,18,14,0,0,0,59
9,14,3,1,18,14,1,14,20,94
9,14,3,1,18,14,1,20,5,85
9,14,3,1,18,22,5,0,0,72
9,14,3,1,19,0,0,0,0,46
9,14,3,1,19,5,0,0,0,51
9,14,3,1,19,5,4,0,0,55
9,14,3,1,19,5,19,0,0,70
9,14,3,1,19,9,14,7,0,76
9,14,3,1,19,11,0,0,0,57
9,14,3,1,19,20,0,0,0,66
9,14,3,1,21,20,9,15,14,106
9,14,3,1,22,1,20,5,0,75
9,14,3,1,22,1,20,5,4,79
9,14,3,1,22,5,0,0,0,54
9,14,3,1,22,5,18,14,0,86
9,14,3,1,22,15,0,0,0,64
9,14,3,5,4,5,0,0,0,40
9,14,3,5,14,4,0,0,0,49
9,14,3,5,14,4,9,21,13,92
9,14,3,5,14,19,5,0,0,69
9,14,3,5,14,19,5,4,0,73
9,14,3,5,14,19,5,18,0,87
9,14,3,5,14,19,5,19,0,88
9,14,3,5,14,19,9,14,7,94
9,14,3,5,14,19,9,15,14,102
9,14,3,5,14,19,9,22,5,100
9,14,3,5,14,19,15,18,0,97
9,14,3,5,14,19,15,18,25,122
9,14,3,5,14,20,5,18,0,88
9,14,3,5,14,20,9,22,5,101
9,14,3,5,14,20,15,18,0,98
9,14,3,5,14,20,18,5,0,88
9,14,3,5,16,20,0,0,0,67
9,14,3,5,16,20,5,4,0,76
9,14,3,5,16,20,9,14,7,97
9,14,3,5,16,20,9,15,14,105
9,14,3,5,16,20,9,22,5,103
9,14,3,5,16,20,15,18,0,100
9,14,3,5,16,20,15,18,19,119
9,14,3,5,16,20,19,0,0,86
9,14,3,5,18,1,20,5,0,75
9,14,3,5,18,20,1,9,14,93
9,14,3,5,19,19,1,14,20,104
9,14,3,5,19,19,9,15,14,107
9,14,3,5,19,20,0,0,0,70
9,14,3,5,19,20,19,0,0,89
9,14,3,8,0,0,0,0,0,34
9,14,3,8,1,9,14,0,0,58
9,14,3,8,1,13,2,5,18,73
9,14,3,8,1,14,20,0,0,69
9,14,3,8,1,18,9,20,25,107
9,14,3,8,1,19,5,0,0,59
9,14,3,8,5,4,0,0,0,43
9,14,3,8,5,18,0,0,0,57
9,14,3,8,5,19,0,0,0,58
9,14,3,8,5,19,20,0,0,78
9,14,3,8,9,14,7,0,0,64
9,14,3,8,12,9,14,7,0,76
9,14,3,8,13,5,1,12,0,65
9,14,3,8,15,1,3,25,0,78
9,14,3,8,15,1,14,20,0,84
9,14,3,8,15,1,20,5,0,75
9,14,3,8,15,1,20,5,4,79
9,14,3,8,16,9,14,0,0,73
9,14,3,8,21,18,3,8,0,84
9,14,3,8,23,15,18,13,0,103
9,14,3,8,23,15,18,13,19,122
9,14,3,9,4,5,0,0,0,44
9,14,3,9,4,5,14,3,5,66
9,14,3,9,4,5,14,3,25,86
9,14,3,9,4,5,14,20,0,78
9,14,3,9,4,5,14,20,19,97
9,14,3,9,5,14,19,15,0,88
9,14,3,9,16,9,5,14,20,99
9,14,3,9,16,9,20,0,0,80
9,14,3,9,16,9,20,19,0,99
9,14,3,9,16,9,20,21,18,119
9,14,3,9,18,3,12,5,0,73
9,14,3,9,18,3,12,5,20,93
9,14,3,9,19,1,12,0,0,67
9,14,3,9,19,5,0,0,0,59
9,14,3,9,19,5,4,0,0,63
9,14,3,9,19,5,12,25,0,96
9,14,3,9,19,5,19,0,0,78
9,14,3,9,19,9,14,7,0,84
9,14,3,9,19,9,15,14,0,92
9,14,3,9,19,9,15,14,19,111
9,14,3,9,19,9,22,5,0,90
9,14,3,9,19,15,18,0,0,87
9,14,3,9,19,15,18,25,0,112
9,14,3,9,19,15,18,19,0,106
9,14,3,25,19,20,5,4,0,99
9,14,3,9,19,21,18,1,0,94
9,14,3,9,19,21,18,1,12,106
9,14,3,9,19,21,18,5,0,98
9,14,3,9,19,21,18,5,19,117
9,14,3,9,20,1,2,12,5,75
9,14,3,9,20,1,14,20,0,90
9,14,3,9,20,1,14,20,19,109
9,14,3,9,20,1,20,5,0,81
9,14,3,9,20,5,0,0,0,60
9,14,3,9,20,5,4,0,0,64
9,14,3,9,20,5,18,0,0,78
9,14,3,9,20,5,18,19,0,97
9,14,3,9,20,5,19,0,0,79
9,14,3,9,20,9,14,7,0,85
9,14,3,9,20,9,22,5,0,91
9,14,3,9,20,15,18,25,0,113
9,14,3,9,20,18,5,19,19,116
9,14,3,9,22,9,3,0,0,69
9,14,3,9,22,9,12,0,0,78
9,14,3,9,22,9,12,12,25,115
9,14,3,9,22,9,19,13,0,98
9,14,3,12,0,0,0,0,0,38
9,14,3,12,1,19,16,0,0,74
9,14,3,12,1,19,16,5,4,83
9,14,3,12,1,19,16,19,0,93
9,14,3,12,1,22,1,20,5,87
9,14,3,12,1,22,5,0,0,66
9,14,3,12,5,0,0,0,0,43
9,14,3,12,5,13,5,14,20,95
9,14,3,12,9,14,5,0,0,66
9,14,3,12,9,14,5,4,0,70
9,14,3,12,9,14,5,18,0,84
9,14,3,12,9,14,5,18,19,103
9,14,3,12,9,14,5,19,0,85
9,14,3,12,9,14,9,14,7,91
9,14,3,12,9,16,0,0,0,63
9,14,3,12,9,16,16,5,4,88
9,14,3,12,9,16,19,0,0,82
9,14,3,12,15,19,5,0,0,77
9,14,3,12,15,19,5,4,0,81
9,14,3,12,15,19,5,18,0,95
9,14,3,12,15,19,5,18,19,114
9,14,3,12,15,19,5,19,0,96
9,14,3,12,15,19,9,14,7,102
9,14,3,12,15,19,21,18,5,116
9,14,3,12,15,21,4,5,0,83
9,14,3,12,21,4,5,0,0,68
9,14,3,12,21,4,5,4,0,72
9,14,3,12,21,4,5,18,0,86
9,14,3,12,21,4,5,19,0,87
9,14,3,12,21,4,9,14,7,93
9,14,3,12,21,19,1,0,0,79
9,14,3,12,21,19,5,0,0,83
9,14,3,12,21,19,9,15,14,116
9,14,3,12,21,19,9,22,5,114
9,14,3,12,21,19,15,18,25,136
9,14,3,12,21,19,21,19,0,118
9,14,3,15,1,3,8,5,4,62
9,14,3,15,1,3,20,5,4,74
9,14,3,15,3,20,5,4,0,73
9,14,3,15,6,6,9,14,0,76
9,14,3,15,7,0,0,0,0,48
9,14,3,15,7,5,14,20,0,87
9,14,3,15,7,14,9,20,1,92
9,14,3,15,7,14,9,20,5,96
9,14,3,15,7,19,0,0,0,67
9,14,3,15,12,1,14,20,0,88
9,14,3,15,13,2,5,18,0,79
9,14,3,15,13,5,0,0,0,59
9,14,3,15,13,5,18,0,0,77
9,14,3,15,13,5,18,19,0,96
9,14,3,15,13,5,19,0,0,78
9,14,3,15,13,9,14,7,0,84
9,14,3,15,13,9,14,7,19,103
9,14,3,15,13,13,5,14,4,90
9,14,3,15,13,13,15,4,5,91
9,14,3,15,13,16,1,3,20,94
9,14,3,15,13,16,12,5,24,111
9,14,3,15,13,16,20,0,0,90
9,14,3,15,14,3,9,14,14,95
9,14,3,15,14,3,15,3,20,96
9,14,3,15,14,4,9,20,5,93
9,14,3,15,14,5,12,0,0,72
9,14,3,15,14,6,9,18,13,101
9,14,3,15,14,6,15,18,13,107
9,14,3,15,14,25,0,0,0,80
9,14,3,15,14,14,21,0,0,90
9,14,3,15,14,14,21,19,0,109
9,14,3,15,18,0,0,0,0,59
9,14,3,15,18,4,0,0,0,63
9,14,3,15,18,16,0,0,0,75
9,14,3,15,18,16,19,5,0,99
9,14,3,15,18,16,19,5,4,103
9,14,3,15,18,16,19,5,19,118
9,14,3,15,18,18,0,0,0,77
9,14,3,15,18,18,5,3,20,105
9,14,3,15,18,18,21,16,20,134
9,14,3,15,21,16,0,0,0,78
9,14,3,15,21,18,19,5,0,104
9,14,3,18,0,0,0,0,0,44
9,14,3,18,1,0,0,0,0,45
9,14,3,18,1,19,8,0,0,72
9,14,3,18,5,1,19,5,4,78
9,14,3,18,5,1,19,5,18,92
9,14,3,18,5,1,19,5,19,93
9,14,3,18,5,1,20,5,0,75
9,14,3,18,5,5,16,0,0,70
9,14,3,18,5,13,1,20,5,88
9,14,3,18,5,13,5,14,20,101
9,14,3,18,5,16,1,20,5,91
9,14,3,18,5,16,20,0,0,85
9,14,3,18,5,19,20,0,0,88
9,14,3,18,5,20,9,15,14,107
9,14,3,18,5,20,15,18,25,127
9,14,3,18,25,19,20,1,12,121
9,14,3,18,15,19,19,0,0,97
9,14,3,18,15,19,19,5,19,121
9,14,3,18,21,5,14,20,0,104
9,14,3,18,21,19,20,0,0,104
9,14,3,18,21,19,20,5,4,113
9,14,3,18,21,19,20,19,0,123
9,14,3,20,9,18,1,20,5,99
9,14,3,20,18,9,0,0,0,73
9,14,3,21,2,1,20,5,0,75
9,14,3,21,2,1,20,5,4,79
9,14,3,21,2,1,20,5,19,94
9,14,3,21,2,1,20,15,18,103
9,14,3,21,2,5,0,0,0,54
9,14,3,21,2,5,5,0,0,59
9,14,3,21,2,9,0,0,0,58
9,14,3,21,2,15,21,19,0,104
9,14,3,21,2,21,19,0,0,89
9,14,3,21,2,21,19,5,19,113
9,14,3,21,4,1,12,0,0,64
9,14,3,21,4,1,20,5,0,77
9,14,3,21,4,5,19,0,0,75
9,14,3,21,12,3,1,20,5,88
9,14,3,21,12,11,0,0,0,70
9,14,3,21,12,16,0,0,0,75
9,14,3,21,12,16,1,20,5,101
9,14,3,21,12,20,0,0,0,79
9,14,3,21,12,20,21,18,5,123
9,14,3,21,13,2,1,14,20,97
9,14,3,21,13,2,5,14,20,101
9,14,3,21,13,2,5,18,0,85
9,14,3,21,13,2,5,18,19,104
9,14,3,21,14,1,2,12,5,81
9,14,3,21,18,0,0,0,0,65
9,14,3,21,18,1,2,12,5,85
9,14,3,21,18,1,2,12,25,105
9,14,3,21,18,9,15,21,19,129
9,14,3,21,18,13,5,14,20,117
9,14,3,21,18,18,5,4,0,92
9,14,3,21,18,18,5,14,20,122
9,14,3,21,18,18,5,18,0,106
9,14,3,21,18,18,9,14,7,113
9,14,3,21,18,19,0,0,0,84
9,14,3,21,18,19,5,0,0,89
9,14,3,21,18,19,9,15,14,122
9,14,3,21,18,19,9,22,5,120
9,14,3,21,18,20,1,9,14,109
9,14,3,21,18,22,1,20,5,113
9,14,3,21,18,22,5,0,0,92
9,14,3,21,18,22,5,4,0,96
9,14,3,21,18,22,5,19,0,111
9,14,3,21,18,22,9,14,7,117
9,14,3,21,18,22,9,20,25,141
9,14,3,21,18,22,15,21,19,142
9,14,3,21,19,0,0,0,0,66
9,14,3,21,19,5,0,0,0,71
9,14,3,21,19,5,4,0,0,75
9,14,3,21,19,5,19,0,0,90
9,14,3,21,19,9,14,7,0,96
9,14,3,21,19,19,0,0,0,85
9,14,3,21,20,0,0,0,0,67
9,14,3,21,20,5,0,0,0,72
9,14,3,21,20,20,9,14,7,117
9,14,4,1,2,1,0,0,0,31
9,14,4,1,2,1,19,0,0,50
9,14,4,1,7,1,20,5,0,61
9,14,4,1,7,1,20,5,4,65
9,14,4,1,7,1,20,5,19,80
9,14,4,1,7,1,20,15,18,89
9,14,4,1,13,1,7,5,0,54
9,14,4,1,13,9,14,0,0,64
9,14,4,1,13,9,14,5,0,69
9,14,4,1,13,9,14,5,19,88
9,14,4,1,13,9,14,19,0,83
9,14,4,1,14,0,0,0,0,42
9,14,4,1,14,5,0,0,0,47
9,14,4,1,18,20,0,0,0,66
9,14,4,1,26,9,14,0,0,77
9,14,4,1,26,9,14,5,0,82
9,14,4,1,26,15,12,0,0,81
9,14,4,1,26,15,12,5,0,86
9,14,4,5,1,18,0,0,0,51
9,14,4,5,2,20,0,0,0,54
9,14,4,5,2,20,5,4,0,63
9,14,4,5,2,20,9,14,7,84
9,14,4,5,3,5,14,3,5,62
9,14,4,5,3,5,14,3,25,82
9,14,4,5,3,5,14,20,0,74
9,14,4,5,3,12,0,0,0,47
9,14,4,5,3,15,18,21,13,102
9,14,4,5,5,4,0,0,0,41
9,14,4,5,5,4,25,0,0,66
9,14,4,5,6,0,0,0,0,38
9,14,4,5,12,9,2,12,5,72
9,14,4,5,12,9,2,12,25,92
9,14,4,5,13,14,9,6,25,99
9,14,4,5,13,14,9,20,25,113
9,14,4,5,14,5,0,0,0,51
9,14,4,5,14,5,19,0,0,70
9,14,4,5,14,9,26,5,0,86
9,14,4,5,14,20,0,0,0,66
9,14,4,5,14,20,5,4,0,75
9,14,4,5,14,20,5,5,0,76
9,14,4,5,14,20,5,18,0,89
9,14,4,5,14,20,5,18,19,108
9,14,4,5,14,20,9,14,7,96
9,14,4,5,14,20,9,15,14,104
9,14,4,5,14,20,15,18,0,99
9,14,4,5,14,20,15,18,19,118
9,14,4,5,14,20,19,0,0,85
9,14,4,5,14,20,21,18,5,110
9,14,4,5,18,9,20,5,0,84
9,14,4,5,19,5,18,20,0,94
9,14,4,5,22,15,20,5,0,94
9,14,4,5,22,15,20,5,4,98
9,14,4,5,22,15,21,20,0,110
9,14,4,5,23,0,0,0,0,55
9,14,4,5,24,0,0,0,0,56
9,14,4,5,24,1,2,12,5,76
9,14,4,5,24,5,4,0,0,65
9,14,4,5,24,5,18,0,0,79
9,14,4,5,24,5,18,19,0,98
9,14,4,5,24,5,19,0,0,80
9,14,4,5,24,9,3,1,12,81
9,14,4,5,24,9,14,7,0,86
9,14,4,5,24,12,5,19,19,111
9,14,4,9,1,4,5,13,0,59
9,14,4,9,1,14,1,14,19,85
9,14,4,9,1,14,9,20,5,85
9,14,4,9,1,14,19,0,0,70
9,14,4,9,1,18,25,0,0,80
9,14,4,9,3,1,2,12,5,59
9,14,4,9,3,1,12,0,0,52
9,14,4,9,3,1,14,0,0,54
9,14,4,9,3,1,14,19,0,73
9,14,4,9,3,1,14,20,0,74
9,14,4,9,3,1,14,20,19,93
9,14,4,9,3,1,20,5,0,65
9,14,4,9,3,1,20,5,4,69
9,14,4,9,3,1,20,5,19,84
9,14,4,9,3,1,20,15,18,93
9,14,4,9,3,1,22,9,20,91
9,14,4,9,3,5,0,0,0,44
9,14,4,9,3,5,19,0,0,63
9,14,4,9,3,9,1,0,0,49
9,14,4,9,3,9,1,12,0,61
9,14,4,9,3,9,1,19,0,68
9,14,4,9,3,9,2,12,5,67
9,14,4,9,3,9,21,13,0,82
9,14,4,9,3,9,21,13,19,101
9,14,4,9,3,15,0,0,0,54
9,14,4,9,3,20,0,0,0,59
9,14,4,9,3,20,5,4,0,68
9,14,4,9,3,20,5,5,0,69
9,14,4,9,3,20,5,5,19,88
9,14,4,9,3,20,5,18,0,82
9,14,4,9,3,20,5,18,19,101
9,14,4,9,3,20,9,14,7,89
9,14,4,9,3,20,9,15,14,97
9,14,4,9,3,20,9,22,5,95
9,14,4,9,3,20,15,18,0,92
9,14,4,9,3,20,15,18,19,111
9,14,4,9,3,20,19,0,0,78
9,14,4,9,4,9,3,9,1,62
9,14,4,9,5,0,0,0,0,41
9,14,4,9,7,5,14,0,0,62
9,14,4,9,7,5,14,1,0,63
9,14,4,9,7,5,14,1,5,68
9,14,4,9,7,5,14,1,12,75
9,14,4,9,7,5,14,3,5,70
9,14,4,9,7,5,14,3,25,90
9,14,4,9,7,5,14,5,0,67
9,14,4,9,7,5,14,5,19,86
9,14,4,9,7,5,14,19,0,81
9,14,4,9,7,5,14,20,0,82
9,14,4,9,7,5,14,20,19,101
9,14,4,9,7,5,19,0,0,67
9,14,4,9,7,5,19,20,0,87
9,14,4,9,7,9,20,5,19,96
9,14,4,9,7,14,0,0,0,57
9,14,4,9,7,14,1,14,20,92
9,14,4,9,7,14,9,6,25,97
9,14,4,9,7,14,9,20,25,111
9,14,4,9,7,14,12,25,0,94
9,14,4,9,7,15,0,0,0,58
9,14,4,9,7,15,5,19,0,82
9,14,4,9,7,15,7,5,14,84
9,14,4,9,7,15,9,4,0,71
9,14,4,9,7,15,9,4,19,90
9,14,4,9,7,15,19,0,0,77
9,14,4,9,7,15,20,9,3,90
9,14,4,9,7,15,20,9,14,101
9,14,4,9,7,21,18,9,1,92
9,14,4,9,8,21,13,9,14,101
9,14,4,9,9,0,0,0,0,45
9,14,4,25,12,0,0,0,0,64
9,14,4,25,12,9,3,0,0,76
9,14,4,9,13,16,12,5,0,82
9,14,4,9,14,0,0,0,0,50
9,14,4,9,18,5,3,20,0,82
9,14,4,9,18,5,3,20,19,101
9,14,4,9,18,21,2,9,14,100
9,14,4,9,19,8,0,0,0,63
9,14,4,9,19,16,15,19,5,110
9,14,4,9,19,20,1,14,20,110
9,14,4,9,20,3,8,0,0,67
9,14,4,9,20,5,0,0,0,61
9,14,4,9,20,5,4,0,0,65
9,14,4,9,20,5,18,0,0,79
9,14,4,9,20,5,18,19,0,98
9,14,4,9,20,5,19,0,0,80
9,14,4,9,20,9,14,7,0,86
9,14,4,9,21,13,0,0,0,70
9,14,4,9,21,13,19,0,0,89
9,14,4,9,22,0,0,0,0,58
9,14,4,9,22,9,4,0,0,71
9,14,4,9,22,9,4,5,4,80
9,14,4,9,22,9,4,21,1,93
9,14,4,9,22,9,19,9,13,108
9,14,4,14,0,0,0,0,0,41
9,14,4,15,3,9,2,12,5,73
9,14,4,15,3,9,12,5,0,71
9,14,4,15,7,5,14,0,0,68
9,14,4,15,9,14,0,0,0,65
9,14,4,15,12,0,0,0,0,54
9,14,4,15,12,5,0,0,0,59
9,14,4,15,12,5,14,3,5,81
9,14,4,15,12,5,14,20,0,93
9,14,4,15,12,5,19,0,0,78
9,14,4,15,12,25,12,0,0,91
9,14,4,15,12,9,14,0,0,77
9,14,4,15,12,9,14,5,0,82
9,14,4,15,12,15,9,4,0,82
9,14,4,15,12,19,0,0,0,73
9,14,4,15,13,1,2,12,5,75
9,14,4,15,15,18,0,0,0,75
9,14,4,15,15,18,19,0,0,94
9,14,4,15,18,19,5,0,0,84
9,14,4,15,18,19,5,4,0,88
9,14,4,15,18,19,5,5,0,89
9,14,4,15,18,19,5,5,19,108
9,14,4,15,18,19,5,18,0,102
9,14,4,15,18,19,5,18,19,121
9,14,4,15,18,19,5,19,0,103
9,14,4,15,18,19,9,14,7,109
9,14,4,15,18,19,15,18,0,112
9,14,4,15,18,19,15,18,19,131
9,14,4,15,23,0,0,0,0,65
9,14,4,15,23,5,4,0,0,74
9,14,4,15,23,9,14,7,0,95
9,14,4,15,23,19,0,0,0,84
9,14,4,15,24,25,12,0,0,103
9,14,4,15,24,25,12,9,3,115
9,14,4,15,24,25,12,19,0,122
9,14,4,18,1,6,20,0,0,72
9,14,4,18,1,6,20,19,0,91
9,14,4,18,1,16,5,0,0,67
9,14,4,18,1,21,7,8,20,102
9,14,4,18,1,23,1,12,0,82
9,14,4,18,1,23,9,14,7,99
9,14,4,18,1,23,14,0,0,83
9,14,4,18,5,14,3,8,0,75
9,14,4,18,9,0,0,0,0,54
9,14,4,21,2,9,15,21,19,114
9,14,4,21,3,0,0,0,0,51
9,14,4,21,3,5,0,0,0,56
9,14,4,21,3,5,4,0,0,60
9,14,4,21,3,5,4,12,25,97
9,14,4,21,3,5,18,0,0,74
9,14,4,21,3,5,18,19,0,93
9,14,4,21,3,5,19,0,0,75
9,14,4,21,3,9,1,5,0,66
9,14,4,21,3,9,2,12,5,79
9,14,4,21,3,9,14,7,0,81
9,14,4,21,3,9,22,5,0,87
9,14,4,21,3,20,0,0,0,71
9,14,4,21,3,20,5,4,0,80
9,14,4,21,3,20,5,5,0,81
9,14,4,21,3,20,5,5,19,100
9,14,4,21,3,20,9,12,5,97
9,14,4,21,3,20,9,14,7,101
9,14,4,21,3,20,9,15,14,109
9,14,4,21,3,20,9,22,5,107
9,14,4,21,3,20,15,18,0,104
9,14,4,21,3,20,15,18,25,129
9,14,4,21,3,20,15,18,19,123
9,14,4,21,3,20,18,9,12,110
9,14,4,21,3,20,19,0,0,90
9,14,4,21,5,0,0,0,0,53
9,14,4,21,5,4,0,0,0,57
9,14,4,21,5,13,5,14,20,105
9,14,4,21,5,19,0,0,0,72
9,14,4,21,9,14,7,0,0,78
9,14,4,21,9,19,13,0,0,89
9,14,4,21,12,7,5,0,0,72
9,14,4,21,12,7,5,4,0,76
9,14,4,21,12,7,5,14,20,106
9,14,4,21,12,7,5,18,0,90
9,14,4,21,12,7,5,18,19,109
9,14,4,21,12,7,5,19,0,91
9,14,4,21,12,7,9,14,7,97
9,14,4,21,12,9,14,0,0,83
9,14,4,21,12,9,14,5,0,88
9,14,4,21,12,9,14,5,19,107
9,14,4,21,12,9,14,19,0,102
9,14,4,21,12,20,0,0,0,80
9,14,4,21,12,20,15,0,0,95
9,14,4,21,12,20,19,0,0,99
9,14,4,21,13,5,14,20,0,100
9,14,4,21,13,5,14,20,1,101
9,14,4,21,14,1,0,0,0,63
9,14,4,21,18,1,2,12,5,86
9,14,4,21,18,1,14,3,5,89
9,14,4,21,18,1,20,5,0,92
9,14,4,21,18,1,20,5,4,96
9,14,4,21,18,1,20,5,19,111
9,14,4,21,18,5,0,0,0,71
9,14,4,21,18,9,20,5,0,100
9,14,4,21,19,9,1,0,0,77
9,14,4,21,19,9,1,12,0,89
9,14,4,21,19,9,1,20,5,102
9,14,4,21,19,9,15,9,4,104
9,14,4,21,19,9,21,13,0,110
9,14,4,21,19,20,18,25,0,130
9,14,4,21,19,20,18,25,19,149
9,14,4,21,20,9,22,5,0,104
9,14,4,21,22,9,1,5,0,85
9,14,4,21,22,9,1,12,0,92
9,14,4,21,22,9,1,20,5,105
9,14,4,23,5,12,12,0,0,79
9,14,4,23,5,12,12,5,18,102
9,14,4,23,5,12,12,19,0,98
9,14,4,23,5,12,20,0,0,87
9,14,5,0,0,0,0,0,0,28
25,14,5,0,0,0,0,0,0,44
9,14,5,1,18,20,8,0,0,75
9,14,5,1,18,20,8,5,4,84
9,14,5,1,18,20,8,19,0,94
9,14,5,2,18,9,1,3,25,86
9,14,5,2,18,9,1,14,20,92
9,14,5,2,18,9,1,20,5,83
9,14,5,2,18,9,5,20,25,107
9,14,5,2,18,9,15,21,19,112
9,14,5,3,15,14,15,13,25,113
9,14,5,4,9,2,12,5,0,60
9,14,5,4,9,20,1,0,0,62
9,14,5,4,9,20,5,4,0,70
9,14,5,6,6,1,2,12,5,60
9,14,5,6,6,1,2,12,25,80
9,14,5,25,5,0,0,0,0,58
9,14,5,12,1,19,20,9,3,92
9,14,5,12,5,7,1,14,20,87
9,14,5,13,21,12,15,21,19,129
9,14,5,16,20,0,0,0,0,64
9,14,5,16,20,12,25,0,0,101
9,14,5,16,20,14,5,19,19,121
9,14,5,17,21,1,2,12,5,86
9,14,5,17,21,1,12,0,0,79
9,14,5,17,21,1,12,12,25,116
9,14,5,17,21,9,20,25,0,120
9,14,5,18,7,5,20,9,3,90
9,14,5,18,13,0,0,0,0,59
9,14,5,18,13,15,21,19,0,114
9,14,5,18,18,1,2,12,5,84
9,14,5,18,18,1,2,12,25,104
9,14,5,18,18,1,14,3,25,107
9,14,5,18,18,1,14,20,0,99
9,14,5,18,18,1,20,9,3,97
9,14,5,18,18,9,14,7,0,94
9,14,5,18,20,0,0,0,0,66
9,14,5,18,20,1,14,3,5,89
9,14,5,18,20,9,1,0,0,76
9,14,5,18,20,9,1,5,0,81
9,14,5,18,20,9,1,12,0,88
9,14,5,18,20,9,1,19,0,95
9,14,5,18,20,9,15,14,0,104
9,14,5,18,20,12,25,0,0,103
9,14,5,18,20,14,5,19,19,123
9,14,5,18,20,19,0,0,0,85
9,14,5,18,21,4,9,20,5,105
9,14,5,19,3,1,20,5,0,76
9,14,5,19,9,20,5,0,0,81
9,14,5,19,19,9,22,5,0,102
9,14,5,20,8,9,3,1,12,81
9,14,5,21,14,20,0,0,0,83
9,14,5,22,9,4,5,14,20,102
9,14,5,24,1,3,20,0,0,76
9,14,5,24,1,3,20,12,25,113
9,14,5,24,8,1,21,19,20,121
9,14,5,24,9,19,20,0,0,100
9,14,5,24,16,5,18,20,0,111
9,14,5,24,16,5,18,20,19,130
9,14,5,24,16,9,1,20,5,103
9,14,5,24,16,18,5,19,19,129
9,14,5,24,20,1,14,20,0,107
9,14,5,24,20,9,14,3,20,118
9,14,6,1,3,5,0,0,0,38
9,14,6,1,9,18,0,0,0,57
9,14,6,1,12,12,0,0,0,54
9,14,6,1,12,12,9,4,0,67
9,14,6,1,12,12,9,14,7,84
9,14,6,1,13,5,0,0,0,48
9,14,6,1,13,5,4,0,0,52
9,14,6,1,13,25,0,0,0,68
9,14,6,1,13,9,1,0,0,53
9,14,6,1,13,9,5,19,0,76
9,14,6,1,13,9,26,5,0,83
9,14,6,1,13,9,26,5,4,87
9,14,6,1,13,15,21,19,0,98
9,14,6,1,14,3,25,0,0,72
9,14,6,1,14,3,9,5,19,80
9,14,6,1,14,4,0,0,0,48
9,14,6,1,14,4,15,21,19,103
9,14,6,1,14,7,0,0,0,51
9,14,6,1,14,19,0,0,0,63
9,14,6,1,14,20,0,0,0,64
9,14,6,1,14,20,1,0,0,65
9,14,6,1,14,20,1,4,15,84
9,14,6,1,14,20,1,19,0,84
9,14,6,1,14,20,5,0,0,69
9,14,6,1,14,20,5,19,0,88
9,14,6,1,14,20,9,12,5,90
9,14,6,1,14,20,9,14,5,92
9,14,6,1,14,20,9,22,5,100
9,14,6,1,14,20,12,25,0,101
9,14,6,1,14,20,18,25,0,107
9,14,6,1,14,20,19,0,0,83
9,14,6,1,18,3,5,0,0,56
9,14,6,1,18,3,20,0,0,71
9,14,6,1,18,3,20,5,4,80
9,14,6,1,18,3,20,19,0,90
9,14,6,1,18,5,0,0,0,53
9,14,6,1,18,5,19,0,0,72
9,14,6,1,20,21,1,20,5,97
9,14,6,1,21,14,1,0,0,66
9,14,6,1,21,14,1,5,0,71
9,14,6,1,21,14,1,12,0,78
9,14,6,1,21,14,1,19,0,85
9,14,6,1,21,19,20,0,0,90
9,14,6,5,3,20,0,0,0,57
9,14,6,5,3,20,1,14,20,92
9,14,6,5,3,20,5,4,0,66
9,14,6,5,3,20,5,18,0,80
9,14,6,5,3,20,5,18,19,99
9,14,6,5,3,20,9,14,7,87
9,14,6,5,3,20,9,15,14,95
9,14,6,5,3,20,9,22,5,93
9,14,6,5,3,20,15,18,0,90
9,14,6,5,3,20,15,18,19,109
9,14,6,5,3,20,19,0,0,76
9,14,6,5,3,20,21,13,0,91
9,14,6,5,3,21,14,4,0,76
9,14,6,5,5,2,12,5,0,58
9,14,6,5,5,4,0,0,0,43
9,14,6,5,6,20,0,0,0,60
9,14,6,5,6,20,9,14,7,90
9,14,6,5,12,20,0,0,0,66
9,14,6,5,14,9,2,12,5,76
9,14,6,5,15,6,0,0,0,55
9,14,6,5,15,6,6,0,0,61
9,14,6,5,15,6,6,5,4,70
9,14,6,5,15,6,6,19,0,80
9,14,6,5,18,0,0,0,0,52
9,14,6,5,18,1,2,12,5,72
9,14,6,5,18,1,2,12,25,92
9,14,6,5,18,5,14,3,5,79
9,14,6,5,18,5,14,20,0,91
9,14,6,5,18,9,1,12,0,74
9,14,6,5,18,9,2,12,5,80
9,14,6,5,18,9,15,18,0,94
9,14,6,5,18,9,15,18,19,113
9,14,6,5,18,14,0,0,0,66
9,14,6,5,18,14,1,12,0,79
9,14,6,5,18,14,15,19,0,100
9,14,6,5,18,18,5,4,0,79
9,14,6,5,18,18,5,18,0,93
9,14,6,5,18,18,5,18,19,112
9,14,6,5,18,18,9,14,7,100
9,14,6,5,18,19,0,0,0,71
9,14,6,5,18,20,9,12,5,98
9,14,6,5,19,20,0,0,0,73
9,14,6,5,19,20,1,14,20,108
9,14,6,5,19,20,5,4,0,82
9,14,6,5,19,20,5,18,0,96
9,14,6,5,19,20,5,18,19,115
9,14,6,5,19,20,9,14,7,103
9,14,6,5,19,20,9,22,5,109
9,14,6,5,19,20,19,0,0,92
9,14,6,5,21,4,1,20,5,85
9,14,6,9,3,5,20,5,0,71
9,14,6,9,4,5,12,0,0,59
9,14,6,9,4,5,12,9,3,71
9,14,6,9,4,5,12,12,25,96
9,14,6,9,4,5,12,19,0,78
9,14,6,9,5,12,4,5,18,82
9,14,6,9,5,12,4,19,0,78
9,14,6,9,7,8,20,0,0,73
9,14,6,9,7,8,20,5,18,96
9,14,6,9,7,8,20,19,0,92
9,14,6,9,7,21,18,5,4,93
9,14,6,9,12,5,0,0,0,55
9,14,6,9,12,12,0,0,0,62
9,14,6,9,12,12,9,14,7,92
9,14,6,9,12,13,0,0,0,63
9,14,6,9,12,20,5,18,0,93
9,14,6,9,13,1,0,0,0,52
9,14,6,9,13,21,13,0,0,85
9,14,6,9,14,0,0,0,0,52
9,14,6,9,14,9,20,5,0,86
9,14,6,9,14,9,20,5,19,105
9,14,6,9,14,9,20,25,0,106
9,14,6,9,14,9,20,21,13,115
9,14,6,9,18,13,0,0,0,69
9,14,6,9,18,13,1,18,25,113
9,14,6,9,18,13,1,20,5,95
9,14,6,9,18,13,5,4,0,78
9,14,6,9,18,13,9,14,7,99
9,14,6,9,18,13,9,20,25,123
9,14,6,9,18,13,12,25,0,106
9,14,6,9,18,13,19,0,0,88
9,14,6,9,19,19,9,12,5,102
9,14,6,9,20,0,0,0,0,58
9,14,6,9,20,20,5,18,0,101
9,14,6,9,24,0,0,0,0,62
9,14,6,9,24,1,12,0,0,75
9,14,6,9,24,5,4,0,0,71
9,14,6,9,24,5,19,0,0,86
9,14,6,9,24,9,14,7,0,92
9,14,6,9,24,9,15,14,0,100
9,14,6,9,24,9,15,14,19,119
9,14,6,12,0,0,0,0,0,41
9,14,6,12,1,13,5,0,0,60
9,14,6,12,1,13,5,4,0,64
9,14,6,12,1,13,5,18,0,78
9,14,6,12,1,13,5,18,19,97
9,14,6,12,1,13,5,19,0,79
9,14,6,12,1,13,9,14,7,85
9,14,6,12,1,20,5,0,0,67
9,14,6,12,1,20,5,4,0,71
9,14,6,12,1,20,5,18,0,85
9,14,6,12,1,20,5,18,19,104
9,14,6,12,1,20,5,19,0,86
9,14,6,12,1,20,9,12,5,88
9,14,6,12,1,20,9,14,7,92
9,14,6,12,1,20,9,15,14,100
9,14,6,12,1,20,9,22,5,98
9,14,6,12,1,20,15,18,0,95
9,14,6,12,1,20,15,18,19,114
9,14,6,12,1,20,21,19,0,102
9,14,6,12,5,3,20,0,0,69
9,14,6,12,5,3,20,5,4,78
9,14,6,12,5,3,20,15,18,102
9,14,6,12,5,3,20,19,0,88
9,14,6,12,5,19,8,0,0,73
9,14,6,12,5,24,0,0,0,70
9,14,6,12,5,24,5,4,0,79
9,14,6,12,5,24,9,15,14,108
9,14,6,12,5,24,9,22,5,106
9,14,6,12,5,24,21,18,5,114
9,14,6,12,9,3,20,0,0,73
9,14,6,12,9,3,20,5,4,82
9,14,6,12,9,3,20,5,18,96
9,14,6,12,9,3,20,15,18,106
9,14,6,12,9,3,20,19,0,92
9,14,6,12,9,7,8,20,0,85
9,14,6,12,15,15,4,0,0,75
9,14,6,12,15,23,0,0,0,79
9,14,6,12,15,23,9,14,7,109
9,14,6,12,15,23,19,0,0,98
9,14,6,12,21,5,0,0,0,67
9,14,6,12,21,5,14,3,5,89
9,14,6,12,21,5,14,20,0,101
9,14,6,12,21,5,14,20,19,120
9,14,6,12,21,5,14,26,1,108
9,14,6,12,21,24,0,0,0,86
9,14,6,12,21,24,5,19,0,110
9,14,6,12,21,24,9,15,14,124
9,14,6,12,21,24,9,22,5,122
9,14,6,15,0,0,0,0,0,44
9,14,6,15,12,4,0,0,0,60
9,14,6,15,12,4,5,4,0,69
9,14,6,15,12,4,5,18,0,83
9,14,6,15,12,4,5,18,19,102
9,14,6,15,12,4,9,14,7,90
9,14,6,15,12,4,19,0,0,79
9,14,6,15,12,9,1,20,5,91
9,14,6,15,18,13,0,0,0,75
9,14,6,15,18,13,1,12,0,88
9,14,6,15,18,13,1,14,20,110
9,14,6,15,18,13,5,4,0,84
9,14,6,15,18,13,5,18,0,98
9,14,6,15,18,13,5,18,19,117
9,14,6,15,18,13,9,14,7,105
9,14,6,15,18,13,9,20,25,129
9,14,6,15,18,13,15,21,19,130
9,14,6,15,18,13,19,0,0,94
9,14,6,15,18,20,21,14,5,122
9,14,6,15,19,0,0,0,0,63
9,14,6,15,21,7,8,20,0,100
9,14,6,15,21,14,4,0,0,83
9,14,6,18,1,0,0,0,0,48
9,14,6,18,1,3,20,0,0,71
9,14,6,18,1,3,20,5,4,80
9,14,6,18,1,3,20,15,18,104
9,14,6,18,1,3,20,19,0,90
9,14,6,18,1,15,18,1,12,94
9,14,6,18,1,16,15,19,5,103
9,14,6,18,1,18,5,4,0,75
9,14,6,18,1,18,5,4,19,94
9,14,6,18,5,5,0,0,0,57
9,14,6,18,9,14,7,5,0,82
9,14,6,18,9,14,7,5,4,86
9,14,6,18,9,14,7,5,18,100
9,14,6,18,9,14,7,5,19,101
9,14,6,18,21,7,1,12,0,88
9,14,6,18,21,14,9,20,5,116
9,14,6,21,12,1,0,0,0,63
9,14,6,21,12,1,5,0,0,68
9,14,6,21,13,1,20,5,0,89
9,14,6,21,13,1,20,5,4,93
9,14,6,21,13,5,0,0,0,68
9,14,6,21,14,4,0,0,0,68
9,14,6,21,14,5,18,1,12,100
9,14,6,21,18,9,1,20,5,103
9,14,6,21,19,3,1,20,5,98
9,14,6,21,19,5,0,0,0,74
9,14,6,21,19,5,4,0,0,78
9,14,6,21,19,5,4,12,25,115
9,14,6,21,19,5,18,0,0,92
9,14,6,21,19,5,18,19,0,111
9,14,6,21,19,5,19,0,0,93
9,14,6,21,19,9,2,12,5,97
9,14,6,21,19,9,12,5,0,95
9,14,6,21,19,9,14,7,0,99
9,14,6,21,19,9,15,14,0,107
9,14,6,21,19,9,15,14,19,126
9,14,6,21,19,9,22,5,0,105
9,14,6,21,19,15,18,25,0,127
9,14,7,0,0,0,0,0,0,30
9,14,7,1,14,0,0,0,0,45
9,14,7,1,14,7,0,0,0,52
9,14,7,1,14,7,19,0,0,71
9,14,7,1,20,5,0,0,0,56
9,14,7,1,20,5,19,0,0,75
9,14,7,1,20,8,5,18,0,82
9,14,7,1,20,8,5,18,19,101
9,14,7,5,13,0,0,0,0,48
9,14,7,5,14,4,5,18,0,76
9,14,7,5,14,5,0,0,0,54
9,14,7,5,14,25,0,0,0,74
9,14,7,5,14,9,1,18,25,102
9,14,7,5,14,9,1,20,5,84
9,14,7,5,14,9,5,0,0,63
9,14,7,5,14,9,5,18,0,81
9,14,7,5,14,9,15,0,0,73
9,14,7,5,14,9,15,21,19,113
9,14,7,5,14,9,20,0,0,78
9,14,7,5,14,9,20,1,12,91
9,14,7,5,14,9,20,5,0,83
9,14,7,5,14,20,0,0,0,69
9,14,7,5,14,21,0,0,0,70
9,14,7,5,14,21,5,0,0,75
9,14,7,5,14,21,5,19,0,94
9,14,7,5,14,21,9,20,25,124
9,14,7,5,14,21,15,21,19,125
9,14,7,5,19,20,0,0,0,74
9,14,7,5,19,20,1,0,0,75
9,14,7,5,19,20,1,14,20,109
9,14,7,5,19,20,5,4,0,83
9,14,7,5,19,20,5,18,0,97
9,14,7,5,19,20,9,14,7,104
9,14,7,5,19,20,9,15,14,112
9,14,7,5,19,20,9,22,5,110
9,14,7,5,19,20,19,0,0,93
9,14,7,9,14,5,0,0,0,58
9,14,7,9,18,20,0,0,0,77
9,14,7,9,22,5,18,0,0,84
9,14,7,9,22,9,14,7,0,91
9,14,7,12,5,14,15,15,11,102
9,14,7,12,5,19,1,0,0,67
9,14,7,12,15,2,1,20,5,85
9,14,7,12,15,2,5,0,0,64
9,14,7,12,15,2,5,4,0,68
9,14,7,12,15,2,9,14,7,89
9,14,7,12,21,0,0,0,0,63
9,14,7,12,21,20,0,0,0,83
9,14,7,12,21,22,9,1,12,107
9,14,7,12,21,22,9,5,19,118
9,14,7,14,21,5,0,0,0,70
9,14,7,15,9,14,7,0,0,75
9,14,7,15,18,7,5,0,0,75
9,14,7,15,20,0,0,0,0,65
9,14,7,15,20,5,4,0,0,74
9,14,7,15,20,9,14,7,0,95
9,14,7,15,20,13,1,14,0,93
9,14,7,15,20,13,5,14,0,97
9,14,7,15,20,19,0,0,0,84
9,14,7,18,1,6,20,0,0,75
9,14,7,18,1,6,20,5,4,84
9,14,7,18,1,6,20,5,18,98
9,14,7,18,1,6,20,19,0,94
9,14,7,18,1,9,14,0,0,72
9,14,7,18,1,9,14,5,4,81
9,14,7,18,1,9,14,19,0,91
9,14,7,18,1,16,16,12,5,98
9,14,7,18,1,20,5,0,0,74
9,14,7,18,1,20,5,12,25,111
9,14,7,18,1,20,5,19,0,93
9,14,7,18,1,22,5,0,0,76
9,14,7,18,5,1,20,0,0,74
9,14,7,18,5,19,19,0,0,91
9,14,7,18,5,19,19,5,19,115
9,14,7,18,5,22,5,0,0,80
9,14,7,18,15,19,19,0,0,101
9,14,7,18,15,21,16,0,0,100
9,14,7,18,15,21,16,19,0,119
9,14,7,18,15,23,0,0,0,86
9,14,7,18,15,23,9,14,7,116
9,14,7,18,15,23,14,0,0,100
9,14,7,18,15,23,20,8,0,114
9,14,7,18,15,23,20,8,19,133
9,14,7,18,21,5,14,20,0,108
9,14,7,21,5,14,0,0,0,70
9,14,7,21,9,12,20,25,0,117
9,14,7,21,9,14,1,12,0,87
9,14,7,21,12,6,0,0,0,69
9,14,7,21,12,6,5,4,0,78
9,14,7,21,12,6,9,14,7,99
9,14,7,21,12,6,19,0,0,88
9,14,8,1,2,9,12,5,0,60
9,14,8,1,2,9,20,0,0,63
9,14,8,1,2,9,20,5,4,72
9,14,8,1,2,9,20,5,18,86
9,14,8,1,2,9,20,19,0,82
9,14,8,1,12,1,14,20,0,79
9,14,8,1,12,1,14,20,19,98
9,14,8,1,12,1,20,15,18,98
9,14,8,1,12,5,0,0,0,49
9,14,8,1,12,5,4,0,0,53
9,14,8,1,12,5,14,20,0,83
9,14,8,1,12,5,18,0,0,67
9,14,8,1,12,5,18,19,0,86
9,14,8,1,12,5,19,0,0,68
9,14,8,1,12,9,14,7,0,74
9,14,8,1,13,5,0,0,0,50
9,14,8,1,14,3,5,0,0,54
9,14,8,1,18,13,15,14,25,117
9,14,8,1,21,12,0,0,0,65
9,14,8,1,21,12,5,18,0,88
9,14,8,1,21,12,5,18,19,107
9,14,8,1,21,12,19,0,0,84
9,14,8,1,21,19,20,0,0,92
9,14,8,5,1,18,19,5,0,79
9,14,8,5,1,22,5,14,0,78
9,14,8,5,12,4,5,0,0,57
9,14,8,5,12,12,0,0,0,60
9,14,8,5,18,5,0,0,0,59
9,14,8,5,18,5,4,0,0,63
9,14,8,5,18,5,14,3,5,81
9,14,8,5,18,5,14,3,25,101
9,14,8,5,18,5,14,20,0,93
9,14,8,5,18,5,19,0,0,78
9,14,8,5,18,9,14,7,0,84
9,14,8,5,18,9,20,0,0,83
9,14,8,5,18,9,20,5,4,92
9,14,8,5,18,9,20,15,18,116
9,14,8,5,18,9,20,19,0,102
9,14,8,5,18,12,5,0,0,71
9,14,8,5,19,9,15,14,0,93
9,14,8,5,19,9,15,14,19,112
9,14,8,5,19,9,22,5,0,91
9,14,8,9,1,20,5,0,0,66
9,14,8,9,2,9,20,0,0,71
9,14,8,9,2,9,20,5,4,80
9,14,8,9,2,9,20,5,18,94
9,14,8,9,2,9,20,15,18,104
9,14,8,9,2,9,20,19,0,90
9,14,8,9,22,5,0,0,0,67
9,14,8,15,12,4,0,0,0,62
9,14,8,15,12,4,5,18,0,85
9,14,8,15,12,4,9,14,7,92
9,14,8,15,14,5,19,20,0,104
9,14,8,15,15,16,0,0,0,77
9,14,8,21,13,1,14,0,0,80
9,14,8,21,13,1,14,5,0,85
9,14,8,21,13,1,14,12,25,117
9,14,8,21,13,1,20,5,0,91
9,14,8,21,13,5,0,0,0,70
9,14,8,21,13,5,4,0,0,74
9,14,8,21,13,5,18,0,0,88
9,14,8,21,13,5,18,19,0,107
9,14,8,21,13,5,19,0,0,89
9,14,8,21,13,9,14,7,0,95
9,14,9,1,12,0,0,0,0,45
9,14,25,1,12,1,0,0,0,62
9,14,9,13,9,3,1,12,0,70
9,14,9,13,9,3,15,21,19,112
9,14,25,15,9,20,5,0,0,97
9,14,25,15,11,5,0,0,0,79
9,14,9,15,13,5,0,0,0,65
9,14,9,15,13,15,21,19,0,115
9,14,9,15,14,0,0,0,0,61
9,14,9,17,21,5,0,0,0,75
9,14,9,17,21,9,20,25,0,124
9,14,9,17,21,15,21,19,0,125
9,14,9,19,12,5,0,0,0,68
9,14,9,20,0,0,0,0,0,52
9,14,9,20,1,12,0,0,0,65
9,14,9,20,9,1,12,0,0,74
9,14,9,20,9,1,12,5,4,83
9,14,9,20,9,1,12,5,18,97
9,14,9,20,9,1,12,12,25,111
9,14,9,20,9,1,12,19,0,93
9,14,9,20,9,1,14,20,0,96
9,14,9,20,9,1,18,25,0,105
9,14,9,20,9,1,20,5,0,87
9,14,9,20,9,1,20,5,4,91
9,14,9,20,9,1,20,5,19,106
9,14,9,20,9,1,20,15,18,115
9,14,9,20,9,15,0,0,0,76
9,14,9,20,9,15,14,0,0,90
9,14,9,20,9,19,0,0,0,80
9,14,9,20,9,22,5,0,0,88
9,14,10,5,3,20,0,0,0,61
9,14,10,5,3,20,1,14,20,96
9,14,10,5,3,20,5,4,0,70
9,14,10,5,3,20,9,14,7,91
9,14,10,5,3,20,9,15,14,99
9,14,10,5,3,20,9,22,5,97
9,14,10,5,3,20,15,18,0,94
9,14,10,5,3,20,15,18,19,113
9,14,10,5,3,20,19,0,0,80
9,14,10,5,12,12,25,0,0,87
9,14,10,15,9,14,0,0,0,71
9,14,10,15,9,14,20,0,0,91
9,14,10,21,14,3,20,0,0,91
9,14,10,21,18,1,2,12,5,92
9,14,10,21,18,5,0,0,0,77
9,14,10,21,18,5,4,0,0,81
9,14,10,21,18,5,4,12,25,118
9,14,10,21,18,5,18,0,0,95
9,14,10,21,18,5,18,19,0,114
9,14,10,21,18,5,19,0,0,96
9,14,10,21,18,25,0,0,0,97
9,14,10,21,18,9,1,0,0,82
9,14,10,21,18,9,5,19,0,105
9,14,10,21,18,9,14,7,0,102
9,14,10,21,18,9,15,21,19,136
9,14,10,21,19,20,0,0,0,93
9,14,10,21,19,20,9,3,5,110
9,14,10,21,19,20,12,25,0,130
9,14,11,0,0,0,0,0,0,34
9,14,11,2,5,18,18,25,0,102
9,14,11,2,12,15,20,0,0,83
9,14,11,2,12,15,20,19,0,102
9,14,11,2,21,19,8,0,0,84
9,14,11,5,4,0,0,0,0,43
9,14,11,5,14,0,0,0,0,53
9,14,11,5,18,0,0,0,0,57
9,14,11,5,18,19,0,0,0,76
9,14,11,5,20,0,0,0,0,59
9,14,11,6,9,19,8,0,0,76
9,14,11,8,15,12,4,5,18,96
9,14,11,8,15,18,14,0,0,89
9,14,11,8,15,18,14,19,0,108
9,14,11,25,0,0,0,0,0,59
9,14,11,9,5,0,0,0,0,48
9,14,11,9,5,18,0,0,0,66
9,14,11,9,5,19,0,0,0,67
9,14,11,9,5,19,20,0,0,87
9,14,11,9,14,4,12,5,0,78
9,14,11,9,14,5,19,19,0,100
9,14,11,9,14,7,0,0,0,64
9,14,11,9,14,7,19,0,0,83
9,14,11,9,19,8,0,0,0,70
9,14,11,10,5,20,0,0,0,69
9,14,11,12,5,0,0,0,0,51
9,14,11,12,5,19,0,0,0,70
9,14,11,12,5,19,19,0,0,89
9,14,11,12,9,11,5,0,0,71
9,14,11,12,9,14,7,0,0,76
9,14,11,12,9,14,7,19,0,95
9,14,11,13,1,11,5,18,0,82
9,14,11,13,1,11,9,14,7,89
9,14,11,13,1,14,0,0,0,62
9,14,11,14,9,20,0,0,0,77
9,14,11,14,15,20,0,0,0,83
9,14,11,15,19,0,0,0,0,68
9,14,11,15,19,9,0,0,0,77
9,14,11,16,15,20,0,0,0,85
9,14,11,16,15,20,19,0,0,104
9,14,11,18,15,15,20,0,0,102
9,14,11,19,0,0,0,0,0,53
9,14,11,19,8,5,4,0,0,70
9,14,11,19,20,1,9,14,0,97
9,14,11,19,20,1,14,4,0,92
9,14,11,19,20,1,14,4,19,111
9,14,11,19,20,15,14,5,0,107
9,14,11,23,5,5,4,0,0,71
9,14,11,23,5,12,12,0,0,86
9,14,11,23,5,12,12,19,0,105
9,14,11,23,15,15,4,0,0,91
9,14,11,23,15,15,4,19,0,110
9,14,11,23,18,9,20,5,18,127
9,14,12,1,3,5,0,0,0,44
9,14,12,1,3,5,4,0,0,48
9,14,12,1,3,5,19,0,0,63
9,14,12,1,3,9,14,7,0,69
9,14,12,1,7,1,18,25,0,87
9,14,12,1,25,0,0,0,0,61
9,14,12,1,9,4,0,0,0,49
9,14,12,1,25,5,4,0,0,70
9,14,12,1,25,5,18,0,0,84
9,14,12,1,25,5,18,19,0,103
9,14,12,1,25,9,14,7,0,91
9,14,12,1,9,11,0,0,0,56
9,14,12,1,25,19,0,0,0,80
9,14,12,1,11,5,0,0,0,52
9,14,12,1,14,4,0,0,0,54
9,14,12,1,14,4,5,18,0,77
9,14,12,1,14,4,5,18,19,96
9,14,12,1,14,4,9,19,8,90
9,14,12,1,14,4,19,0,0,73
9,14,12,1,18,4,0,0,0,58
9,14,12,1,21,20,0,0,0,77
9,14,12,1,23,0,0,0,0,59
9,14,12,1,23,18,25,0,0,102
9,14,12,5,1,7,21,5,0,74
9,14,12,5,1,7,21,5,4,78
9,14,12,5,1,7,21,5,18,92
9,14,12,5,1,11,0,0,0,52
9,14,12,5,1,11,1,7,5,65
9,14,12,5,19,19,0,0,0,78
9,14,12,5,20,0,0,0,0,60
9,14,12,5,20,19,0,0,0,79
9,14,12,5,20,20,9,14,7,110
9,14,12,25,0,0,0,0,0,60
9,14,12,9,5,18,0,0,0,67
9,14,12,9,5,18,19,0,0,86
9,14,12,9,7,8,20,5,14,98
9,14,12,25,9,14,7,0,0,90
9,14,12,9,11,5,0,0,0,60
9,14,12,9,14,5,0,0,0,63
9,14,12,15,15,11,0,0,0,76
9,14,12,15,15,11,5,18,0,99
9,14,12,15,15,11,9,14,7,106
9,14,13,1,20,5,0,0,0,62
9,14,13,1,20,5,19,0,0,81
9,14,13,5,1,20,0,0,0,62
9,14,13,5,1,20,19,0,0,81
9,14,13,5,19,8,0,0,0,68
9,14,13,5,19,8,5,4,0,77
9,14,13,5,19,8,5,19,0,92
9,14,13,5,19,8,9,14,7,98
9,14,13,5,23,0,0,0,0,64
9,14,13,9,7,18,1,14,20,105
9,14,13,9,24,20,21,18,5,133
9,14,13,15,18,5,0,0,0,74
9,14,13,15,19,20,0,0,0,90
9,14,14,1,7,5,0,0,0,50
9,14,14,1,18,4,19,0,0,79
9,14,14,1,20,5,0,0,0,63
9,14,14,1,20,5,12,25,0,100
9,14,14,1,20,9,19,13,0,99
9,14,14,1,20,9,22,5,0,94
9,14,14,1,20,21,18,1,12,110
9,14,14,5,0,0,0,0,0,42
9,14,14,5,4,0,0,0,0,46
9,14,14,5,9,20,25,0,0,96
9,14,14,5,18,12,25,0,0,97
9,14,14,5,18,13,15,18,5,111
9,14,14,5,18,13,15,19,20,127
9,14,14,5,18,14,5,19,19,117
9,14,14,5,18,19,0,0,0,79
9,14,14,5,18,19,15,12,5,111
9,14,14,5,18,22,1,20,5,108
9,14,14,5,18,22,5,0,0,87
9,14,14,5,18,22,5,4,0,91
9,14,14,5,18,22,5,19,0,106
9,14,14,5,18,22,9,14,7,112
9,14,14,5,19,20,0,0,0,81
9,14,14,5,20,0,0,0,0,62
9,14,14,8,15,12,4,5,18,99
9,14,14,25,1,18,4,0,0,85
9,14,14,9,14,7,0,0,0,67
9,14,14,9,14,7,19,0,0,86
9,14,14,9,20,5,14,3,25,113
9,14,14,11,5,5,16,5,18,97
9,14,14,12,5,19,19,0,0,92
9,14,14,15,3,5,14,3,5,82
9,14,14,15,3,5,14,3,25,102
9,14,14,15,3,5,14,20,0,94
9,14,14,15,3,5,14,20,19,113
9,14,14,15,3,21,9,20,25,130
9,14,14,15,3,21,15,21,19,131
9,14,14,15,4,1,20,5,0,82
9,14,14,15,13,9,14,5,0,93
9,14,14,15,22,1,14,20,0,109
9,14,14,15,22,1,20,5,0,100
9,14,14,15,22,1,20,5,4,104
9,14,14,15,22,1,20,5,19,119
9,14,14,15,22,1,20,15,18,128
9,14,14,15,24,9,15,21,19,140
9,14,14,19,0,0,0,0,0,56
9,14,14,21,1,20,5,0,0,84
9,14,14,21,5,14,4,15,0,96
9,14,14,21,5,14,4,15,19,115
9,14,15,2,12,1,19,20,0,92
9,14,15,2,22,9,15,21,19,126
9,14,15,3,1,18,16,9,14,99
9,14,15,3,25,20,5,0,0,91
9,14,15,3,21,12,1,0,0,75
9,14,15,3,21,12,1,14,20,109
9,14,15,3,21,12,1,18,0,93
9,14,15,3,21,12,1,20,5,100
9,14,15,3,21,12,21,13,0,108
9,14,15,3,21,12,21,13,19,127
9,14,15,4,9,1,20,5,0,77
9,14,15,4,15,18,1,20,5,101
9,14,15,4,15,18,15,21,19,130
9,14,15,7,5,14,0,0,0,64
9,14,15,7,5,14,9,3,0,76
9,14,15,7,5,14,15,21,19,119
9,14,15,7,12,9,1,0,0,67
9,14,15,12,9,20,8,0,0,87
9,14,15,13,1,0,0,0,0,52
9,14,15,13,9,14,15,21,19,129
9,14,15,13,25,15,13,1,0,105
9,14,15,13,25,24,15,13,1,129
9,14,15,14,5,0,0,0,0,57
9,14,15,16,9,14,1,20,5,103
9,14,15,16,9,14,5,0,0,82
9,14,15,16,21,12,5,14,20,126
9,14,15,18,2,0,0,0,0,58
9,14,15,18,4,5,18,12,25,120
9,14,15,18,7,0,0,0,0,63
9,14,15,18,7,1,14,9,3,90
9,14,15,18,14,1,20,5,0,96
9,14,15,19,3,15,16,25,0,116
9,14,15,19,9,3,0,0,0,69
9,14,15,19,9,14,0,0,0,80
9,14,15,19,9,14,5,0,0,85
9,14,15,19,9,14,9,3,0,92
9,14,15,19,9,20,5,0,0,91
9,14,15,19,9,20,5,19,0,110
9,14,15,19,9,20,15,12,0,113
9,14,15,19,9,20,15,12,19,132
9,14,15,20,18,15,16,9,3,119
9,14,15,23,5,18,0,0,0,84
9,14,15,24,9,4,9,26,5,115
9,14,16,1,25,13,5,14,20,117
9,14,16,1,18,6,9,20,0,93
9,14,16,1,20,9,5,14,20,108
9,14,16,8,1,19,5,0,0,72
9,14,16,8,1,19,5,19,0,91
9,14,16,15,12,25,7,15,14,127
9,14,16,15,18,20,0,0,0,92
9,14,16,15,21,18,0,0,0,93
9,14,16,15,21,18,5,4,0,102
9,14,16,15,21,18,9,14,7,123
9,14,16,15,21,18,19,0,0,112
9,14,16,21,19,8,0,0,0,87
9,14,16,21,20,0,0,0,0,80
9,14,16,21,20,6,9,12,5,112
9,14,16,21,20,19,0,0,0,99
9,14,16,21,20,20,5,4,0,109
9,14,16,21,20,20,9,14,7,130
9,14,17,9,12,1,2,0,0,64
9,14,17,21,5,19,20,0,0,105
9,14,17,21,5,19,20,19,0,124
9,14,17,21,9,5,20,0,0,95
9,14,17,21,9,5,20,5,4,104
9,14,17,21,9,5,20,12,25,132
9,14,17,21,9,5,20,19,0,114
9,14,17,21,9,12,9,14,5,110
9,14,17,21,9,14,1,20,5,110
9,14,17,21,9,18,1,14,20,123
9,14,17,21,9,18,5,0,0,93
9,14,17,21,9,18,5,4,0,97
9,14,17,21,9,18,5,14,20,127
9,14,17,21,9,18,5,18,0,111
9,14,17,21,9,18,5,18,19,130
9,14,17,21,9,18,5,19,0,112
9,14,17,21,9,18,25,0,0,113
9,14,17,21,9,18,9,5,19,121
9,14,17,21,9,18,9,14,7,118
9,14,17,21,9,19,9,20,0,118
9,14,17,21,9,19,9,20,5,123
9,14,18,1,4,9,9,0,0,64
9,14,18,1,4,9,21,19,0,95
9,14,18,1,9,12,0,0,0,63
9,14,18,5,1,12,9,20,25,113
9,14,18,9,7,7,5,4,0,73
9,14,18,9,7,7,5,18,0,87
9,14,18,9,7,8,20,5,4,94
9,14,18,9,14,7,0,0,0,71
9,14,18,15,0,0,0,0,0,56
9,14,18,15,1,4,0,0,0,61
9,14,18,15,1,4,5,18,0,84
9,14,18,15,1,4,19,0,0,80
9,14,18,15,12,0,0,0,0,68
9,14,18,15,12,12,0,0,0,80
9,14,18,15,12,12,9,14,7,110
9,14,18,15,15,20,5,4,0,100
9,14,18,21,2,0,0,0,0,64
9,14,18,21,14,0,0,0,0,76
9,14,18,21,14,14,9,14,7,120
9,14,18,21,16,20,9,15,14,136
9,14,18,21,19,8,0,0,0,89
9,14,18,21,19,8,5,19,0,113
9,14,18,21,19,8,9,14,7,119
9,14,19,1,3,11,0,0,0,57
9,14,19,1,6,5,20,25,0,99
9,14,19,1,13,5,0,0,0,61
9,14,19,1,14,1,2,12,5,77
9,14,19,1,14,5,0,0,0,62
9,14,19,1,14,5,12,25,0,99
9,14,19,1,14,5,18,0,0,80
9,14,19,1,14,5,19,20,0,101
9,14,19,1,14,9,1,20,5,92
9,14,19,1,14,9,5,0,0,71
9,14,19,1,14,9,6,25,0,97
9,14,19,1,14,9,20,25,0,111
9,14,19,1,16,9,5,14,20,107
9,14,19,1,16,15,18,25,0,117
9,14,19,1,20,9,1,20,5,98
9,14,19,1,20,9,5,20,25,122
9,14,19,3,1,16,5,0,0,67
9,14,19,3,1,16,5,19,0,86
9,14,19,3,9,2,9,12,5,82
9,14,19,3,9,5,14,3,5,81
9,14,19,3,9,5,14,20,0,93
9,14,19,3,9,15,21,19,0,109
9,14,19,3,15,14,3,5,0,82
9,14,19,3,18,9,2,5,0,79
9,14,19,3,18,9,2,5,4,83
9,14,19,3,18,9,2,5,18,97
9,14,19,3,18,9,2,5,19,98
9,14,19,3,18,9,16,20,0,108
9,14,19,3,18,15,12,12,0,102
9,14,19,3,18,15,12,12,19,121
9,14,19,3,21,12,16,0,0,94
9,14,19,3,21,12,16,5,4,103
9,14,19,3,21,12,16,19,0,113
9,14,19,5,1,0,0,0,0,48
9,14,19,5,1,13,0,0,0,61
9,14,19,5,1,13,5,18,0,84
9,14,19,5,1,13,19,0,0,80
9,14,19,5,1,18,3,8,0,77
9,14,19,5,3,1,2,12,5,70
9,14,19,5,3,20,0,0,0,70
9,14,19,5,3,20,1,14,0,85
9,14,19,5,3,20,1,18,25,114
9,14,19,5,3,20,5,1,14,90
9,14,19,5,3,20,5,4,0,79
9,14,19,5,3,20,9,12,5,96
9,14,19,5,3,20,9,14,5,98
9,14,19,5,3,20,9,15,14,108
9,14,19,5,3,20,19,0,0,89
9,14,19,5,3,21,18,5,0,94
9,14,19,5,5,0,0,0,0,52
9,14,19,5,5,9,14,7,0,82
9,14,19,5,5,18,0,0,0,70
9,14,19,5,12,2,5,18,7,91
9,14,19,5,14,19,1,20,5,106
9,14,19,5,14,19,5,0,0,85
9,14,19,5,14,19,5,4,0,89
9,14,19,5,14,19,9,14,7,110
9,14,19,5,16,0,0,0,0,63
9,14,19,5,17,21,5,14,20,124
9,14,19,5,18,20,0,0,0,85
9,14,19,5,18,20,5,4,0,94
9,14,19,5,18,20,5,18,0,108
9,14,19,5,18,20,5,18,19,127
9,14,19,5,18,20,9,14,7,115
9,14,19,5,18,20,9,15,14,123
9,14,19,5,18,20,9,22,5,121
9,14,19,5,18,20,19,0,0,104
9,14,19,5,18,22,5,0,0,92
9,14,19,5,19,19,9,15,14,123
9,14,19,5,19,19,15,18,0,118
9,14,19,5,20,0,0,0,0,67
9,14,19,5,20,19,0,0,0,86
9,14,19,5,20,20,5,4,0,96
9,14,19,5,20,20,5,18,0,110
9,14,19,5,20,20,5,18,19,129
9,14,19,5,20,20,9,14,7,117
9,14,19,8,1,4,5,0,0,60
9,14,19,8,1,22,5,0,0,78
9,14,19,8,5,1,20,8,0,84
9,14,19,8,5,1,20,8,5,89
9,14,19,8,5,1,20,8,19,103
9,14,19,8,5,12,12,0,0,79
9,14,19,8,9,14,9,14,7,103
9,14,19,8,9,16,0,0,0,75
9,14,19,8,15,5,0,0,0,70
9,14,19,8,15,15,20,0,0,100
9,14,19,8,15,18,5,0,0,88
9,14,19,8,18,9,14,5,0,96
9,14,19,8,18,9,14,5,4,100
9,14,19,8,18,9,14,5,19,115
9,14,19,9,4,5,0,0,0,60
9,14,19,9,4,5,14,20,0,94
9,14,19,9,4,5,18,0,0,78
9,14,19,9,4,5,18,19,0,97
9,14,19,9,4,5,19,0,0,79
9,14,19,9,4,9,1,20,5,90
9,14,19,9,4,9,15,21,19,119
9,14,19,9,7,8,20,0,0,86
9,14,19,9,7,8,20,5,4,95
9,14,19,9,7,8,20,19,0,105
9,14,19,9,7,14,5,0,0,77
9,14,19,9,7,14,5,19,0,96
9,14,19,9,7,14,9,1,0,82
9,14,19,9,7,14,9,1,19,101
9,14,19,9,14,3,5,18,5,96
9,14,19,9,14,5,23,0,0,93
9,14,19,9,14,11,9,14,7,106
9,14,19,9,14,21,1,14,20,121
9,14,19,9,14,21,1,20,5,112
9,14,19,9,16,9,4,0,0,80
9,14,19,9,16,9,4,12,25,117
9,14,19,9,16,9,4,21,19,120
9,14,19,9,16,9,5,14,20,115
9,14,19,9,19,20,0,0,0,90
9,14,19,9,19,20,5,4,0,99
9,14,19,9,19,20,5,14,20,129
9,14,19,9,19,20,5,18,0,113
9,14,19,9,19,20,5,18,19,132
9,14,19,9,19,20,9,14,7,120
9,14,19,9,19,20,9,22,5,126
9,14,19,9,19,20,19,0,0,109
9,14,19,9,19,20,21,18,5,134
9,14,19,9,20,5,0,0,0,76
9,14,19,9,20,9,15,14,0,109
9,14,19,14,1,18,5,0,0,80
9,14,19,14,1,18,5,4,0,84
9,14,19,14,1,18,5,18,0,98
9,14,19,14,1,18,5,18,19,117
9,14,19,14,1,18,5,19,0,99
9,14,19,14,1,18,9,14,7,105
9,14,19,15,3,9,1,12,0,82
9,14,19,15,3,9,1,20,5,95
9,14,19,15,6,1,18,0,0,82
9,14,19,15,12,0,0,0,0,69
9,14,19,15,12,1,20,5,0,95
9,14,19,15,12,1,20,5,4,99
9,14,19,15,12,1,20,5,19,114
9,14,19,15,12,5,0,0,0,74
9,14,19,15,12,5,14,3,5,96
9,14,19,15,12,5,14,3,25,116
9,14,19,15,12,5,14,20,0,108
9,14,19,15,12,5,14,20,19,127
9,14,19,15,12,5,19,0,0,93
9,14,19,15,12,9,4,0,0,82
9,14,19,15,12,9,20,5,0,103
9,14,19,15,12,21,2,12,5,109
9,14,19,15,12,21,2,12,25,129
9,14,19,15,12,22,5,14,20,130
9,14,19,15,13,14,9,1,0,94
9,14,19,15,13,14,9,1,3,97
9,14,19,15,13,14,9,1,19,113
9,14,19,15,13,21,3,8,0,102
9,14,19,15,15,20,8,0,0,100
9,14,19,15,18,2,0,0,0,77
9,14,19,15,18,2,5,14,20,116
9,14,19,15,18,4,9,4,0,92
9,14,19,15,21,12,0,0,0,90
9,14,19,15,21,12,5,4,0,99
9,14,19,15,21,12,9,14,7,120
9,14,19,15,21,12,19,0,0,109
9,14,19,16,0,0,0,0,0,58
9,14,19,16,1,11,5,0,0,75
9,14,19,16,1,14,0,0,0,73
9,14,19,16,1,14,14,5,4,96
9,14,19,16,1,14,19,0,0,92
9,14,19,16,5,1,11,0,0,75
9,14,19,16,5,3,20,0,0,86
9,14,19,16,5,3,20,5,4,95
9,14,19,16,5,3,20,15,18,119
9,14,19,16,5,3,20,19,0,105
9,14,19,16,5,18,7,5,0,93
9,14,19,16,5,18,19,5,0,105
9,14,19,16,8,5,18,5,0,94
9,14,19,16,8,5,18,5,4,98
9,14,19,16,8,5,18,5,19,113
9,14,19,16,9,14,14,5,0,100
9,14,19,16,9,18,1,14,20,120
9,14,19,16,9,18,1,20,5,111
9,14,19,16,9,18,5,0,0,90
9,14,19,16,9,18,5,4,0,94
9,14,19,16,9,18,5,18,0,108
9,14,19,16,9,18,5,18,19,127
9,14,19,16,9,18,5,19,0,109
9,14,19,16,9,18,9,14,7,115
9,14,19,16,9,18,9,20,0,114
9,14,19,16,9,18,9,20,19,133
9,14,19,16,15,11,5,0,0,89
9,14,19,16,15,11,5,14,0,103
9,14,19,16,18,5,9,20,8,118
9,14,19,20,1,2,12,5,0,82
9,14,19,20,1,12,0,0,0,75
9,14,19,20,1,12,12,0,0,87
9,14,19,20,1,12,12,5,4,96
9,14,19,20,1,12,12,5,18,110
9,14,19,20,1,12,12,19,0,106
9,14,19,20,1,12,19,0,0,94
9,14,19,20,1,13,16,0,0,92
9,14,19,20,1,14,3,5,0,85
9,14,19,20,1,14,3,5,4,89
9,14,19,20,1,14,3,5,19,104
9,14,19,20,1,14,3,25,0,105
9,14,19,20,1,14,20,0,0,97
9,14,19,20,1,14,20,5,18,120
9,14,19,20,1,14,20,12,25,134
9,14,19,20,1,14,20,19,0,116
9,14,19,20,1,18,0,0,0,81
9,14,19,20,1,18,18,5,4,108
9,14,19,20,1,18,19,0,0,100
9,14,19,20,1,20,5,0,0,88
9,14,19,20,1,20,5,4,0,92
9,14,19,20,1,20,5,19,0,107
9,14,19,20,1,20,9,14,7,113
9,14,19,20,5,1,4,0,0,72
9,14,19,20,5,1,13,0,0,81
9,14,19,20,5,5,16,0,0,88
9,14,19,20,5,16,0,0,0,83
9,14,19,20,5,16,19,0,0,102
9,14,19,20,9,7,1,14,20,113
9,14,19,20,9,7,1,20,5,104
9,14,19,20,9,12,0,0,0,83
9,14,19,20,25,12,5,0,0,104
9,14,19,20,9,12,12,0,0,95
9,14,19,20,9,12,12,5,4,104
9,14,19,20,9,12,12,5,18,118
9,14,19,20,9,12,12,19,0,114
9,14,19,20,9,12,19,0,0,102
9,14,19,20,9,14,3,20,0,108
9,14,19,20,9,14,3,20,19,127
9,14,19,20,9,20,15,18,0,124
9,14,19,20,9,20,15,18,25,149
9,14,19,20,9,20,21,5,0,117
9,14,19,20,9,20,21,20,5,137
9,14,19,20,15,16,0,0,0,93
9,14,19,20,15,18,5,0,0,100
9,14,19,20,18,0,0,0,0,80
9,14,19,20,18,15,11,5,0,111
9,14,19,20,18,15,11,5,19,130
9,14,19,20,18,21,3,20,0,124
9,14,19,20,18,21,3,20,19,143
9,14,19,21,1,22,9,20,25,140
9,14,19,21,3,3,1,20,5,95
9,14,19,21,3,3,5,19,19,112
9,14,19,21,3,11,5,14,0,96
9,14,19,21,5,0,0,0,0,68
9,14,19,21,5,20,21,4,5,118
9,14,19,21,12,1,0,0,0,76
9,14,19,21,12,1,5,0,0,81
9,14,19,21,12,1,14,3,5,98
9,14,19,21,12,1,14,20,0,110
9,14,19,21,12,1,14,20,19,129
9,14,19,21,12,1,18,0,0,94
9,14,19,21,12,1,18,25,0,119
9,14,19,21,12,1,18,12,25,131
9,14,19,21,12,1,18,19,0,113
9,14,19,21,12,1,20,5,0,101
9,14,19,21,12,1,20,5,4,105
9,14,19,21,12,1,20,5,19,120
9,14,19,21,12,1,20,15,18,129
9,14,19,21,12,9,14,0,0,98
9,14,19,21,12,9,14,19,0,117
9,14,19,21,12,9,26,5,0,115
9,14,19,21,12,19,5,0,0,99
9,14,19,21,12,19,9,20,25,148
9,14,19,21,12,20,0,0,0,95
9,14,19,21,12,20,1,14,20,130
9,14,19,21,12,20,5,4,0,104
9,14,19,21,12,20,5,18,0,118
9,14,19,21,12,20,5,18,19,137
9,14,19,21,12,20,9,14,7,125
9,14,19,21,12,20,19,0,0,114
9,14,19,21,13,5,0,0,0,81
9,14,19,21,14,11,0,0,0,88
9,14,19,21,16,5,18,0,0,102
9,14,19,21,18,1,2,12,5,101
9,14,19,21,18,1,14,3,5,104
9,14,19,21,18,1,14,20,0,116
9,14,19,21,18,1,14,20,19,135
9,14,19,21,18,5,0,0,0,86
9,14,19,21,18,5,4,0,0,90
9,14,19,21,18,5,4,19,0,109
9,14,19,21,18,5,5,0,0,91
9,14,19,21,18,5,18,0,0,104
9,14,19,21,18,5,18,19,0,123
9,14,19,21,18,5,19,0,0,105
9,14,19,21,18,7,5,0,0,93
9,14,19,21,18,7,5,14,20,127
9,14,19,21,18,9,14,7,0,111
9,14,19,21,18,18,5,3,20,127
9,14,19,21,19,16,5,3,20,126
9,14,19,23,1,13,16,0,0,95
9,14,19,23,1,20,8,5,0,99
9,14,19,23,1,20,8,5,4,103
9,14,19,23,1,20,8,5,19,118
9,14,19,23,5,12,12,0,0,94
9,14,19,23,5,16,20,0,0,106
9,14,19,23,9,14,7,0,0,95
9,14,19,23,9,14,7,5,18,118
9,14,20,1,0,0,0,0,0,44
9,14,20,1,3,20,0,0,0,67
9,14,20,1,3,20,9,12,5,93
9,14,20,1,3,20,12,25,0,104
9,14,20,1,7,12,9,0,0,72
9,14,20,1,7,12,9,15,0,87
9,14,20,1,7,12,9,15,19,106
9,14,20,1,9,12,0,0,0,65
9,14,20,1,11,5,0,0,0,60
9,14,20,1,11,5,18,0,0,78
9,14,20,1,11,5,19,0,0,79
9,14,20,1,14,7,12,5,0,82
9,14,20,1,18,9,1,0,0,72
9,14,20,1,18,19,1,0,0,82
9,14,20,1,18,19,1,19,0,101
9,14,20,1,18,19,9,1,0,91
9,14,20,1,18,19,9,1,19,110
9,14,20,1,18,19,9,19,20,129
9,14,20,1,24,1,2,12,5,88
9,14,20,5,2,18,5,4,0,77
9,14,20,5,7,5,18,0,0,78
9,14,20,5,7,5,18,19,0,97
9,14,20,5,7,18,1,12,0,86
9,14,20,5,7,18,1,12,19,105
9,14,20,5,7,18,1,14,4,92
9,14,20,5,7,18,1,14,20,108
9,14,20,5,7,18,1,16,8,98
9,14,20,5,7,18,1,20,5,99
9,14,20,5,7,18,9,20,25,127
9,14,20,5,9,14,4,0,0,75
9,14,20,5,12,0,0,0,0,60
9,14,20,5,12,12,5,3,20,100
9,14,20,5,14,1,2,12,5,82
9,14,20,5,14,1,14,3,25,105
9,14,20,5,14,4,0,0,0,66
9,14,20,5,14,4,1,14,20,101
9,14,20,5,14,4,5,4,0,75
9,14,20,5,14,4,5,4,19,94
9,14,20,5,14,4,5,18,0,89
9,14,20,5,14,4,5,18,19,108
9,14,20,5,14,4,9,14,7,96
9,14,20,5,14,4,9,20,0,95
9,14,20,5,14,4,19,0,0,85
9,14,20,5,14,9,2,12,5,90
9,14,20,5,14,19,0,0,0,81
9,14,20,5,14,19,1,20,5,107
9,14,20,5,14,19,5,0,0,86
9,14,20,5,14,19,5,12,25,123
9,14,20,5,14,19,5,18,0,104
9,14,20,5,14,19,5,19,20,125
9,14,20,5,14,19,9,6,25,121
9,14,20,5,14,19,9,15,14,119
9,14,20,5,14,19,9,20,25,135
9,14,20,5,14,19,9,22,5,117
9,14,20,5,14,20,0,0,0,82
9,14,20,5,14,20,5,4,0,91
9,14,20,5,14,20,9,15,14,120
9,14,20,5,14,20,9,22,5,118
9,14,20,5,14,20,12,25,0,119
9,14,20,5,14,20,19,0,0,101
9,14,20,5,18,0,0,0,0,66
9,14,20,5,18,1,3,18,1,89
9,14,20,5,18,1,3,20,0,90
9,14,20,5,18,1,3,20,19,109
9,14,20,5,18,1,7,5,0,79
9,14,20,5,18,1,12,1,18,98
9,14,20,5,18,1,12,12,0,91
9,14,20,5,18,1,12,12,25,116
9,14,20,5,18,1,18,3,8,96
9,14,20,5,18,1,18,13,25,123
9,14,20,5,18,1,24,1,12,104
9,14,20,5,18,1,24,5,19,115
9,14,20,5,18,1,24,9,19,119
9,14,20,5,18,2,1,14,11,94
9,14,20,5,18,2,5,4,0,77
9,14,20,5,18,2,15,4,25,112
9,14,20,5,18,2,18,5,4,95
9,14,20,5,18,3,1,12,5,87
9,14,20,5,18,3,1,12,13,95
9,14,20,5,18,3,5,4,5,83
9,14,20,5,18,3,5,16,20,110
9,14,20,5,18,3,5,19,19,112
9,14,20,5,18,3,9,20,25,123
9,14,20,5,18,3,12,21,2,104
9,14,20,5,18,3,15,13,0,97
9,14,20,5,18,3,15,13,5,102
9,14,20,5,18,3,15,13,19,116
9,14,20,5,18,3,18,15,16,118
9,14,20,5,18,3,21,18,0,108
9,14,20,5,18,3,21,18,12,120
9,14,20,5,18,3,21,20,0,110
9,14,20,5,18,3,21,20,19,129
9,14,20,5,18,4,1,19,8,98
9,14,20,5,18,4,1,20,1,92
9,14,20,5,18,4,5,1,12,88
9,14,20,5,18,4,9,3,20,102
9,14,20,5,18,4,9,14,5,98
9,14,20,5,18,4,15,13,5,103
9,14,20,5,18,5,1,20,0,92
9,14,20,5,18,5,19,19,0,109
9,14,20,5,18,5,19,19,5,114
9,14,20,5,18,5,19,20,0,110
9,14,20,5,18,5,19,20,19,129
9,14,20,5,18,6,1,3,5,81
9,14,20,5,18,6,5,18,5,100
9,14,20,5,18,6,9,12,5,98
9,14,20,5,18,6,9,18,13,112
9,14,20,5,18,6,12,15,23,122
9,14,20,5,18,6,12,21,24,129
9,14,20,5,18,6,15,12,4,103
9,14,20,5,18,6,18,5,20,115
9,14,20,5,18,6,21,19,5,117
9,14,20,5,18,7,1,14,7,95
9,14,20,5,18,7,9,12,20,114
9,14,20,5,18,7,18,15,23,129
9,14,20,5,18,8,25,1,12,112
9,14,20,5,18,9,5,21,18,119
9,14,20,5,18,9,13,19,0,107
9,14,20,5,18,9,15,18,19,127
9,14,20,5,18,10,0,0,0,76
9,14,20,5,18,10,5,3,20,104
9,14,20,5,18,10,15,9,14,114
9,14,20,5,18,11,14,9,20,120
9,14,20,5,18,11,14,15,20,126
9,14,20,5,18,11,14,15,23,129
9,14,20,5,18,12,1,3,5,87
9,14,20,5,18,12,1,25,0,104
9,14,20,5,18,12,1,9,4,92
9,14,20,5,18,12,1,9,14,102
9,14,20,5,18,12,1,25,19,123
9,14,20,5,18,12,1,11,5,95
9,14,20,5,18,12,1,16,0,95
9,14,20,5,18,12,1,16,19,114
9,14,20,5,18,12,1,18,4,101
9,14,20,5,18,12,5,1,6,90
9,14,20,5,18,12,9,5,0,92
9,14,20,5,18,12,9,14,5,106
9,14,20,5,18,12,9,14,11,112
9,14,20,5,18,12,9,19,16,122
9,14,20,5,18,12,15,1,14,108
9,14,20,5,18,12,15,3,11,107
9,14,20,5,18,12,15,12,9,114
9,14,20,5,18,12,15,15,16,124
9,14,20,5,18,12,15,16,5,114
9,14,20,5,18,12,15,20,0,113
9,14,20,5,18,12,21,4,5,108
9,14,20,5,18,13,1,20,0,100
9,14,20,5,18,13,1,26,5,111
9,14,20,5,18,13,5,1,14,99
9,14,20,5,18,13,5,4,5,93
9,14,20,5,18,13,5,5,20,109
9,14,20,5,18,13,5,12,12,108
9,14,20,5,18,13,5,12,20,116
9,14,20,5,18,13,5,14,20,118
9,14,20,5,18,13,5,19,8,111
9,14,20,5,18,13,5,20,0,104
9,14,20,5,18,13,5,23,0,107
9,14,20,5,18,13,9,14,5,107
9,14,20,5,18,13,9,19,5,112
9,14,20,5,18,13,9,20,0,108
9,14,20,5,18,13,9,20,19,127
9,14,20,5,18,13,9,24,0,112
9,14,20,5,18,13,9,24,20,132
9,14,20,5,18,13,13,5,20,117
9,14,20,5,18,13,21,18,5,123
9,14,20,5,18,14,0,0,0,80
9,14,20,5,18,14,1,12,0,93
9,14,20,5,18,14,1,12,19,112
9,14,20,5,18,14,1,20,0,101
9,14,20,5,18,14,1,20,12,113
9,14,20,5,18,14,5,0,0,85
9,14,20,5,18,14,5,3,20,108
9,14,20,5,18,14,5,4,0,89
9,14,20,5,18,14,5,5,0,90
9,14,20,5,18,14,5,5,19,109
9,14,20,5,18,14,5,19,0,104
9,14,20,5,18,14,5,20,0,105
9,14,20,5,18,14,9,14,7,110
9,14,20,5,18,14,9,19,20,128
9,14,20,5,18,14,9,20,25,134
9,14,20,5,18,14,15,4,5,104
9,14,20,5,18,14,19,0,0,99
9,14,20,5,18,16,1,7,5,95
9,14,20,5,18,16,1,12,5,100
9,14,20,5,18,16,1,19,19,121
9,14,20,5,18,16,1,22,5,110
9,14,20,5,18,16,5,1,12,100
9,14,20,5,18,16,5,12,0,99
9,14,20,5,18,16,12,1,25,120
9,14,20,5,18,16,12,5,1,100
9,14,20,5,18,16,12,5,4,103
9,14,20,5,18,16,15,12,5,114
9,14,20,5,18,16,15,14,5,116
9,14,20,5,18,16,15,19,5,121
9,14,20,5,18,16,15,21,18,136
9,14,20,5,18,16,18,5,20,125
9,14,20,5,18,18,1,3,5,93
9,14,20,5,18,18,1,14,0,99
9,14,20,5,18,18,5,4,0,93
9,14,20,5,18,18,5,14,1,104
9,14,20,5,18,18,5,18,0,107
9,14,20,5,18,18,5,24,0,113
9,14,20,5,18,18,9,14,7,114
9,14,20,5,18,18,15,1,4,104
9,14,20,5,18,18,15,7,0,106
9,14,20,5,18,18,15,15,13,127
9,14,20,5,18,18,15,23,0,122
9,14,20,5,18,18,21,12,5,122
9,14,20,5,18,18,21,14,0,119
9,14,20,5,18,18,21,16,20,141
9,14,20,5,18,19,0,0,0,85
9,14,20,5,18,19,1,12,5,103
9,14,20,5,18,19,5,1,13,104
9,14,20,5,18,19,5,3,20,113
9,14,20,5,18,19,5,18,20,128
9,14,20,5,18,19,5,20,0,110
9,14,20,5,18,19,5,24,0,114
9,14,20,5,18,19,8,15,16,124
9,14,20,5,18,19,8,15,20,128
9,14,20,5,18,19,15,9,12,121
9,14,20,5,18,19,15,12,5,117
9,14,20,5,18,19,15,23,0,123
9,14,20,5,18,20,1,12,11,110
9,14,20,5,18,20,1,19,11,117
9,14,20,5,18,20,5,1,13,105
9,14,20,5,18,20,5,1,18,110
9,14,20,5,18,20,5,18,13,122
9,14,20,5,18,20,5,24,0,115
9,14,20,5,18,20,9,5,0,100
9,14,20,5,18,20,9,5,4,104
9,14,20,5,18,20,9,5,19,119
9,14,20,5,18,20,9,12,12,119
9,14,20,5,18,20,15,12,12,125
9,14,20,5,18,20,15,14,5,120
9,14,20,5,18,20,15,23,14,138
9,14,20,5,18,20,18,5,5,114
9,14,20,5,18,20,23,9,14,132
9,14,20,5,18,22,1,12,0,101
9,14,20,5,18,22,1,12,19,120
9,14,20,5,18,22,1,18,25,132
9,14,20,5,18,22,5,9,14,116
9,14,20,5,18,22,5,14,5,112
9,14,20,5,18,22,5,14,20,127
9,14,20,5,18,22,5,18,20,131
9,14,20,5,18,22,9,5,23,125
9,14,20,5,18,23,1,18,0,108
9,14,20,5,18,23,5,4,0,98
9,14,20,5,18,23,5,12,4,110
9,14,20,5,18,23,9,14,4,116
9,14,20,5,18,23,9,19,8,125
9,14,20,5,18,23,15,18,4,126
9,14,20,5,18,23,15,18,11,133
9,14,20,5,18,23,15,22,5,131
9,14,20,5,18,23,18,1,16,124
9,14,20,5,18,26,15,14,5,126
9,14,20,5,19,20,1,3,25,116
9,14,20,5,19,20,1,20,5,113
9,14,20,5,19,20,9,14,5,115
9,14,20,5,24,9,14,5,0,100
9,14,20,5,24,20,0,0,0,92
9,14,20,5,24,20,9,14,5,120
9,14,20,5,24,20,21,18,5,136
9,14,20,8,18,1,12,0,0,82
9,14,20,8,18,1,12,12,0,94
9,14,20,8,18,1,12,12,19,113
9,14,20,8,18,1,12,19,0,101
9,14,20,8,18,15,14,5,0,103
9,14,20,8,18,15,14,5,4,107
9,14,20,8,18,15,14,5,19,122
9,14,20,8,18,15,14,7,0,105
9,14,20,8,18,15,23,0,0,107
9,14,20,8,18,21,19,20,0,129
9,14,20,9,0,0,0,0,0,52
9,14,20,9,1,12,12,25,0,102
9,14,20,9,3,5,0,0,0,60
9,14,20,9,12,0,0,0,0,64
9,14,20,9,12,12,0,0,0,76
9,14,20,9,13,1,0,0,0,66
9,14,20,9,13,1,3,25,0,94
9,14,20,9,13,1,4,15,0,85
9,14,20,9,13,1,4,15,19,104
9,14,20,9,13,1,5,0,0,71
9,14,20,9,13,1,12,0,0,78
9,14,20,9,13,1,19,0,0,85
9,14,20,9,13,1,20,5,0,91
9,14,20,9,13,1,20,5,4,95
9,14,20,9,13,1,20,5,18,109
9,14,20,9,13,1,20,5,19,110
9,14,20,9,13,5,0,0,0,70
9,14,20,9,13,9,19,20,0,113
9,14,20,9,13,9,19,20,5,118
9,14,20,9,13,9,20,25,0,119
9,14,20,9,13,15,21,19,0,120
9,14,20,9,14,3,20,0,0,89
9,14,20,9,14,5,0,0,0,71
9,14,20,9,14,5,19,0,0,90
9,14,20,9,18,5,0,0,0,75
9,14,20,9,19,0,0,0,0,71
9,14,20,9,19,25,0,0,0,96
9,14,20,9,20,12,5,0,0,89
9,14,20,9,20,12,5,4,0,93
9,14,20,9,20,12,5,19,0,108
9,14,20,9,20,12,9,14,7,114
9,14,20,9,20,21,12,5,0,110
9,14,20,9,20,21,12,5,4,114
9,14,20,9,20,21,12,5,19,129
9,14,20,12,0,0,0,0,0,55
9,14,20,14,12,0,0,0,0,69
9,14,20,15,0,0,0,0,0,58
9,14,20,15,5,4,0,0,0,67
9,14,20,15,13,2,0,0,0,73
9,14,20,15,13,2,5,4,0,82
9,14,20,15,13,2,9,14,7,103
9,14,20,15,13,2,19,0,0,92
9,14,20,15,14,1,2,12,5,92
9,14,20,15,14,1,3,9,0,85
9,14,20,15,14,1,3,15,0,91
9,14,20,15,14,1,3,15,19,110
9,14,20,15,14,1,20,5,0,98
9,14,20,15,14,1,20,5,4,102
9,14,20,15,14,1,20,5,19,117
9,14,20,15,14,1,20,15,18,126
9,14,20,15,14,5,0,0,0,77
9,14,20,15,14,5,4,0,0,81
9,14,20,15,14,5,18,0,0,95
9,14,20,15,14,5,18,19,0,114
9,14,20,15,14,5,19,0,0,96
9,14,20,15,14,9,14,7,0,102
9,14,20,15,15,20,8,5,4,110
9,14,20,15,18,19,9,15,14,133
9,14,20,15,18,20,0,0,0,96
9,14,20,15,18,20,5,4,0,105
9,14,20,15,18,20,9,14,7,126
9,14,20,15,18,20,9,15,14,134
9,14,20,15,18,20,19,0,0,115
9,14,20,15,18,20,21,19,0,136
9,14,20,15,21,18,9,19,20,145
9,14,20,15,23,5,18,0,0,104
9,14,20,15,23,14,0,0,0,95
9,14,20,18,0,0,0,0,0,61
9,14,20,18,1,0,0,0,0,62
9,14,20,18,1,2,18,5,4,91
9,14,20,18,1,3,9,20,25,119
9,14,20,18,1,4,1,0,0,67
9,14,20,18,1,4,1,25,0,92
9,14,20,18,1,4,15,0,0,81
9,14,20,18,1,4,15,19,0,100
9,14,20,18,1,4,15,19,19,119
9,14,20,18,1,9,12,0,0,83
9,14,20,18,1,9,20,0,0,91
9,14,20,18,1,12,9,14,5,102
9,14,20,18,1,14,5,20,0,101
9,14,20,18,1,14,19,0,0,95
9,14,20,18,1,14,20,0,0,96
9,14,20,18,1,14,20,19,0,115
9,14,20,18,1,15,18,1,12,108
9,14,20,18,1,16,0,0,0,78
9,14,20,18,1,16,1,9,18,106
9,14,20,18,1,16,9,1,12,100
9,14,20,18,1,19,8,15,16,120
9,14,20,18,1,20,5,0,0,87
9,14,20,18,5,1,20,0,0,87
9,14,20,18,5,1,20,5,4,96
9,14,20,18,5,1,20,19,0,106
9,14,20,18,5,14,3,8,0,91
9,14,20,18,5,16,9,4,0,95
9,14,20,18,9,3,1,3,25,102
9,14,20,18,9,3,1,20,5,99
9,14,20,18,9,7,1,14,20,112
9,14,20,18,9,7,15,0,0,92
9,14,20,18,9,7,21,5,0,103
9,14,20,18,9,7,21,5,4,107
9,14,20,18,9,7,21,5,18,121
9,14,20,18,9,7,21,5,19,122
9,14,20,18,9,14,3,5,0,92
9,14,20,18,9,14,5,0,0,89
9,14,20,18,9,14,19,5,0,108
9,14,20,18,9,14,19,9,3,115
9,14,20,18,15,0,0,0,0,76
9,14,20,18,15,4,0,0,0,80
9,14,20,18,15,4,4,5,14,103
9,14,20,18,15,4,21,3,5,109
9,14,20,18,15,4,21,3,20,124
9,14,20,18,15,6,25,0,0,107
9,14,20,18,15,6,9,5,4,100
9,14,20,18,15,6,9,5,18,114
9,14,20,18,15,6,9,5,19,115
9,14,20,18,15,6,12,5,24,123
9,14,20,18,15,9,20,19,0,124
9,14,20,18,15,9,20,21,19,145
9,14,20,18,15,10,5,3,20,114
9,14,20,18,15,13,9,20,0,118
9,14,20,18,15,13,9,20,19,137
9,14,20,18,15,14,0,0,0,90
9,14,20,18,15,14,19,0,0,109
9,14,20,18,15,18,19,1,12,126
9,14,20,18,15,18,19,5,0,118
9,14,20,18,15,19,0,0,0,95
9,14,20,18,15,19,21,13,5,134
9,14,20,18,15,22,5,18,20,141
9,14,20,18,21,4,5,0,0,91
9,14,20,18,21,4,5,4,0,95
9,14,20,18,21,4,5,18,0,109
9,14,20,18,21,4,5,18,19,128
9,14,20,18,21,4,5,19,0,110
9,14,20,18,21,4,9,14,7,116
9,14,20,18,21,14,11,0,0,107
9,14,20,18,21,19,0,0,0,101
9,14,20,18,21,19,5,0,0,106
9,14,20,18,21,19,9,15,14,139
9,14,20,18,21,19,9,22,5,137
9,14,20,18,21,19,15,0,0,116
9,14,20,18,21,19,20,0,0,121
9,14,20,18,21,19,20,5,4,130
9,14,20,18,21,19,20,19,0,140
9,14,20,19,22,0,0,0,0,84
9,14,20,21,2,1,20,5,0,92
9,14,20,21,2,1,20,5,4,96
9,14,20,21,2,1,20,5,19,111
9,14,20,21,2,1,20,15,18,120
9,14,20,21,2,5,0,0,0,71
9,14,20,21,5,0,0,0,0,69
9,14,20,21,5,14,20,0,0,103
9,14,20,21,9,3,9,20,25,130
9,14,20,21,9,20,0,0,0,93
9,14,20,21,9,20,5,4,0,102
9,14,20,21,9,20,9,14,7,123
9,14,20,21,9,20,9,15,14,131
9,14,20,21,9,20,9,22,5,129
9,14,20,21,9,20,15,0,0,108
9,14,20,21,9,20,19,0,0,112
9,14,20,21,13,5,19,3,5,109
9,14,20,21,14,5,0,0,0,83
9,14,20,21,18,14,0,0,0,96
9,14,20,21,18,14,5,4,0,105
9,14,20,21,18,14,9,14,7,126
9,14,20,21,18,14,19,0,0,115
9,14,20,21,19,5,0,0,0,88
9,14,20,23,9,14,5,0,0,94
9,14,20,23,9,14,5,4,0,98
9,14,20,23,9,14,5,19,0,113
9,14,20,23,9,14,9,14,7,119
9,14,20,23,9,19,20,0,0,114
9,14,20,23,9,19,20,5,4,123
9,14,20,23,9,19,20,19,0,133
9,14,21,11,19,8,21,11,0,114
9,14,21,12,1,0,0,0,0,57
9,14,21,12,1,19,5,0,0,81
9,14,21,12,1,19,5,19,0,100
9,14,21,12,9,14,0,0,0,79
9,14,21,12,9,14,19,0,0,98
9,14,21,12,15,9,4,0,0,84
9,14,21,13,2,18,1,20,5,103
9,14,21,14,3,20,0,0,0,81
9,14,21,14,3,20,9,15,14,119
9,14,21,14,3,20,21,13,0,115
9,14,21,14,4,1,2,12,5,82
9,14,21,14,4,1,14,20,0,97
9,14,21,14,4,1,20,5,0,88
9,14,21,14,4,1,20,5,4,92
9,14,21,14,4,1,20,5,19,107
9,14,21,14,4,1,20,15,18,116
9,14,21,18,2,1,14,5,0,84
9,14,21,18,5,0,0,0,0,67
9,14,21,18,5,4,0,0,0,71
9,14,21,18,5,13,5,14,20,119
9,14,21,18,5,19,0,0,0,86
9,14,21,18,9,14,7,0,0,92
9,14,21,18,14,0,0,0,0,76
9,14,21,18,14,5,4,0,0,85
9,14,21,18,14,9,14,7,0,106
9,14,21,18,14,13,5,14,20,128
9,14,21,18,14,19,0,0,0,95
9,14,21,19,9,20,1,20,5,118
9,14,21,19,20,0,0,0,0,83
9,14,21,19,20,9,15,14,0,121
9,14,21,20,9,12,5,0,0,90
9,14,21,20,9,12,5,12,25,127
9,14,21,20,9,12,9,20,25,139
9,14,22,0,0,0,0,0,0,45
9,14,22,1,4,1,2,12,5,70
9,14,22,1,4,5,0,0,0,55
9,14,22,1,4,5,4,0,0,59
9,14,22,1,4,5,18,0,0,73
9,14,22,1,4,5,18,19,0,92
9,14,22,1,4,5,19,0,0,74
9,14,22,1,4,9,14,7,0,80
9,14,22,1,12,9,4,0,0,71
9,14,22,1,12,9,4,3,25,99
9,14,22,1,12,9,4,5,4,80
9,14,22,1,12,9,4,12,25,108
9,14,22,1,12,9,4,19,0,90
9,14,22,1,12,21,5,4,0,88
9,14,22,1,18,9,1,14,20,108
9,14,22,1,18,9,5,4,0,82
9,14,22,1,18,19,0,0,0,83
9,14,22,1,19,9,15,14,0,103
9,14,22,1,19,9,15,14,19,122
9,14,22,1,19,9,22,5,0,101
9,14,22,5,3,11,5,4,0,73
9,14,22,5,3,20,0,0,0,73
9,14,22,5,3,20,5,4,0,82
9,14,22,5,3,20,9,15,14,111
9,14,22,5,3,20,9,22,5,109
9,14,22,5,3,20,15,18,0,106
9,14,22,5,9,7,8,0,0,74
9,14,22,5,9,7,8,5,4,83
9,14,22,5,9,7,8,5,18,97
9,14,22,5,9,7,8,19,0,93
9,14,22,5,9,7,12,5,0,83
9,14,22,5,9,7,12,5,4,87
9,14,22,5,9,7,12,5,18,101
9,14,22,5,9,7,12,5,19,102
9,14,22,5,9,12,0,0,0,71
9,14,22,5,9,14,0,0,0,73
9,14,22,5,14,5,13,5,0,87
9,14,22,5,14,9,5,14,20,112
9,14,22,5,14,9,20,0,0,93
9,14,22,5,14,20,0,0,0,84
9,14,22,5,14,20,1,18,25,128
9,14,22,5,14,20,5,4,0,93
9,14,22,5,14,20,5,18,0,107
9,14,22,5,14,20,5,18,19,126
9,14,22,5,14,20,6,21,12,123
9,14,22,5,14,20,9,14,7,114
9,14,22,5,14,20,9,15,14,122
9,14,22,5,14,20,9,22,5,120
9,14,22,5,14,20,15,18,0,117
9,14,22,5,14,20,15,18,25,142
9,14,22,5,14,20,15,18,19,136
9,14,22,5,14,20,19,0,0,103
9,14,22,5,18,9,20,25,0,122
9,14,22,5,18,19,5,0,0,92
9,14,22,5,18,19,5,4,0,96
9,14,22,5,18,19,5,12,25,129
9,14,22,5,18,19,5,19,0,111
9,14,22,5,18,19,9,14,7,117
9,14,22,5,18,19,9,15,14,125
9,14,22,5,18,19,9,22,5,123
9,14,22,5,18,19,15,18,0,120
9,14,22,5,18,20,0,0,0,88
9,14,22,5,18,20,1,14,20,123
9,14,22,5,18,20,1,19,5,113
9,14,22,5,18,20,5,4,0,97
9,14,22,5,18,20,5,14,4,111
9,14,22,5,18,20,5,18,0,111
9,14,22,5,18,20,5,18,19,130
9,14,22,5,18,20,9,12,5,114
9,14,22,5,18,20,9,14,0,111
9,14,22,5,18,20,9,14,7,118
9,14,22,5,18,20,9,22,5,124
9,14,22,5,18,20,15,18,0,121
9,14,22,5,18,20,15,18,19,140
9,14,22,5,18,20,19,0,0,107
9,14,22,5,19,20,0,0,0,89
9,14,22,5,19,20,5,4,0,98
9,14,22,5,19,20,9,14,7,119
9,14,22,5,19,20,9,15,14,127
9,14,22,5,19,20,15,18,0,122
9,14,22,5,19,20,15,18,19,141
9,14,22,5,19,20,19,0,0,108
9,14,22,5,19,20,21,18,5,133
9,14,22,9,1,2,12,5,0,74
9,14,22,9,1,2,12,25,0,94
9,14,22,9,3,20,0,0,0,77
9,14,22,9,3,20,5,4,0,86
9,14,22,9,3,20,9,22,5,113
9,14,22,9,4,9,1,0,0,68
9,14,22,9,4,9,15,21,19,122
9,14,22,9,7,15,18,0,0,94
9,14,22,9,7,15,21,18,0,115
9,14,22,9,12,5,0,0,0,71
9,14,22,9,12,12,1,7,5,91
9,14,22,9,14,1,20,5,0,94
9,14,22,9,15,12,1,3,25,110
9,14,22,9,15,12,1,20,5,107
9,14,22,9,15,21,19,0,0,109
9,14,22,9,18,9,12,5,0,98
9,14,22,9,19,3,1,20,5,102
9,14,22,9,19,3,9,4,0,89
9,14,22,9,19,5,4,0,0,82
9,14,22,9,19,9,2,12,5,101
9,14,22,9,19,9,2,12,25,121
9,14,22,9,19,9,15,14,0,111
9,14,22,9,20,1,2,12,5,94
9,14,22,9,20,1,12,0,0,87
9,14,22,9,20,1,14,20,0,109
9,14,22,9,20,5,0,0,0,79
9,14,22,9,20,5,4,0,0,83
9,14,22,9,20,5,5,0,0,84
9,14,22,9,20,5,5,19,0,103
9,14,22,9,20,5,18,0,0,97
9,14,22,9,20,5,18,19,0,116
9,14,22,9,20,5,19,0,0,98
9,14,22,9,20,9,1,20,5,109
9,14,22,9,20,9,14,7,0,104
9,14,22,9,20,18,5,19,19,135
9,14,22,9,22,9,4,0,0,89
9,14,22,15,3,1,2,12,5,83
9,14,22,15,3,1,14,20,0,98
9,14,22,15,3,1,20,5,0,89
9,14,22,15,3,1,20,5,4,93
9,14,22,15,3,1,20,5,19,108
9,14,22,15,3,1,20,15,18,117
9,14,22,15,25,0,0,0,0,85
9,14,22,15,9,3,5,0,0,77
9,14,22,15,9,3,5,4,0,81
9,14,22,15,9,3,5,19,0,96
9,14,22,15,9,3,9,14,7,102
9,14,22,15,11,5,0,0,0,76
9,14,22,15,11,5,4,0,0,80
9,14,22,15,11,5,18,0,0,94
9,14,22,15,11,5,18,19,0,113
9,14,22,15,11,5,19,0,0,95
9,14,22,15,11,9,14,7,0,101
9,14,22,15,12,21,3,5,12,113
9,14,22,15,12,21,3,18,1,115
9,14,22,15,12,21,3,18,5,119
9,14,22,15,12,21,20,5,0,118
9,14,22,15,12,21,20,5,4,122
9,14,22,15,12,21,20,5,19,137
9,14,22,15,12,22,5,0,0,99
9,14,22,15,12,22,5,4,0,103
9,14,22,15,12,22,5,14,20,133
9,14,22,15,12,22,5,18,0,117
9,14,22,15,12,22,5,18,19,136
9,14,22,15,12,22,5,19,0,118
9,14,22,15,12,22,9,14,7,124
9,14,22,20,0,0,0,0,0,65
9,14,22,21,12,7,1,18,0,104
9,14,23,1,12,5,0,0,0,64
9,14,23,1,12,12,0,0,0,71
9,14,23,1,12,12,5,4,0,80
9,14,23,1,12,12,9,14,7,101
9,14,23,1,12,12,19,0,0,90
9,14,23,1,18,4,0,0,0,69
9,14,23,1,18,4,12,25,0,106
9,14,23,1,18,4,19,0,0,88
9,14,23,5,1,22,5,0,0,79
9,14,23,5,1,22,5,4,0,83
9,14,23,5,1,22,5,19,0,98
9,14,23,5,1,22,9,14,7,104
9,14,23,5,4,7,5,4,0,71
9,14,23,5,5,4,0,0,0,60
9,14,23,5,9,7,8,20,0,95
9,14,23,8,5,5,12,0,0,76
9,14,23,9,3,11,0,0,0,69
9,14,23,9,14,4,0,0,0,73
9,14,23,9,14,4,9,14,7,103
9,14,23,9,14,4,19,0,0,92
9,14,23,9,20,0,0,0,0,75
9,14,23,9,20,8,0,0,0,83
9,14,23,15,18,11,0,0,0,90
9,14,23,15,18,11,19,0,0,109
9,14,23,15,18,14,0,0,0,93
9,14,23,15,21,14,4,0,0,100
9,14,23,15,22,5,0,0,0,88
9,14,23,15,22,5,14,0,0,102
9,14,23,18,1,16,0,0,0,81
9,14,23,18,1,16,16,5,4,106
9,14,23,18,1,16,19,0,0,100
9,14,23,18,1,16,20,0,0,101
9,14,23,18,5,1,20,8,5,103
9,14,23,18,9,20,0,0,0,93
9,14,23,18,9,20,20,5,14,132
9,14,23,18,15,21,7,8,20,135
25,15,2,2,15,0,0,0,0,59
25,15,2,2,15,5,19,0,0,83
25,15,2,2,15,19,0,0,0,78
25,15,2,9,0,0,0,0,0,51
25,15,2,19,0,0,0,0,0,61
25,15,3,3,15,0,0,0,0,61
25,15,3,8,5,12,0,0,0,68
25,15,3,11,0,0,0,0,0,54
25,15,3,11,5,4,0,0,0,63
25,15,3,11,5,12,0,0,0,71
25,15,3,11,5,18,14,21,20,132
25,15,3,11,9,14,7,0,0,84
25,15,3,11,19,0,0,0,0,73
9,15,3,19,0,0,0,0,0,46
25,15,4,0,0,0,0,0,0,44
9,15,4,1,12,0,0,0,0,41
9,15,4,1,20,5,0,0,0,54
9,15,4,1,20,5,4,0,0,58
9,15,4,1,20,5,19,0,0,73
9,15,4,1,20,9,14,7,0,79
9,15,4,1,20,9,15,14,0,87
9,15,4,1,20,9,15,14,19,106
9,15,4,5,0,0,0,0,0,33
25,15,4,5,0,0,0,0,0,49
25,15,4,5,12,0,0,0,0,61
25,15,4,5,12,5,4,0,0,70
25,15,4,5,12,5,18,0,0,84
25,15,4,5,12,5,18,19,0,103
25,15,4,5,12,9,14,7,0,91
25,15,4,5,12,9,19,20,0,109
25,15,4,5,12,12,5,4,0,82
25,15,4,5,12,12,5,18,0,96
25,15,4,5,12,12,5,18,19,115
25,15,4,5,12,12,9,14,7,103
25,15,4,5,12,19,0,0,0,80
25,15,4,8,0,0,0,0,0,52
9,15,4,8,25,4,18,9,3,95
9,15,4,8,25,4,18,9,14,106
25,15,4,8,19,0,0,0,0,71
9,15,4,9,3,0,0,0,0,40
9,15,4,9,4,0,0,0,0,41
9,15,4,9,4,5,0,0,0,46
9,15,4,9,4,5,19,0,0,65
9,15,4,9,4,19,0,0,0,60
9,15,4,9,13,5,20,18,25,118
9,15,4,9,14,0,0,0,0,51
9,15,4,9,14,1,20,5,0,77
9,15,4,9,14,1,20,5,4,81
9,15,4,9,14,1,20,5,19,96
9,15,4,9,14,5,0,0,0,56
9,15,4,9,14,5,19,0,0,75
9,15,4,9,14,9,21,13,0,94
9,15,4,9,14,19,0,0,0,70
9,15,4,25,18,9,20,5,0,105
9,15,4,9,19,13,0,0,0,69
9,15,4,9,19,13,19,0,0,88
9,15,4,9,20,5,0,0,0,62
9,15,4,9,26,5,0,0,0,68
9,15,4,9,26,5,4,0,0,72
9,15,4,9,26,5,18,0,0,86
9,15,4,9,26,5,18,19,0,105
9,15,4,9,26,5,19,0,0,87
9,15,4,9,26,9,14,7,0,93
25,15,4,12,5,0,0,0,0,61
25,15,4,12,5,4,0,0,0,65
25,15,4,12,5,18,0,0,0,79
25,15,4,12,5,18,19,0,0,98
25,15,4,12,5,19,0,0,0,80
25,15,4,12,9,14,7,0,0,86
9,15,4,15,0,0,0,0,0,43
9,15,4,15,4,5,18,13,1,84
9,15,4,15,6,15,18,13,0,95
9,15,4,15,6,15,18,13,19,114
9,15,4,15,12,19,0,0,0,74
9,15,4,15,13,5,20,18,25,124
9,15,4,15,14,9,21,13,0,100
9,15,4,15,16,8,15,18,0,100
9,15,4,15,16,8,15,18,19,119
9,15,4,15,16,19,9,14,0,101
9,15,4,15,16,19,9,14,19,120
9,15,4,15,19,15,0,0,0,77
9,15,4,15,21,19,0,0,0,83
9,15,4,15,24,25,0,0,0,92
25,15,4,19,0,0,0,0,0,63
25,15,5,0,0,0,0,0,0,45
25,15,7,1,19,0,0,0,0,67
25,15,7,1,19,1,14,1,0,83
25,15,7,5,5,0,0,0,0,57
25,15,7,5,5,9,19,13,0,98
25,15,7,5,5,19,0,0,0,76
25,15,7,8,0,0,0,0,0,55
25,15,7,8,15,21,18,20,0,129
25,15,7,8,15,21,18,20,19,148
25,15,7,8,19,0,0,0,0,74
25,15,7,8,21,18,20,0,0,114
25,15,7,8,21,18,20,19,0,133
25,15,7,9,14,9,0,0,0,79
25,15,7,9,14,9,19,0,0,98
25,15,7,9,14,19,0,0,0,89
25,15,7,9,19,0,0,0,0,75
25,15,7,15,9,20,5,0,0,96
25,15,7,21,18,20,0,0,0,106
25,15,7,21,18,20,19,0,0,125
25,15,8,9,13,2,5,0,0,77
25,15,8,9,13,2,9,0,0,81
25,15,8,9,13,2,9,14,0,95
25,15,8,9,13,2,9,14,5,100
25,15,8,15,21,18,20,0,0,122
25,15,9,0,0,0,0,0,0,49
25,15,25,0,0,0,0,0,0,65
25,15,9,3,11,0,0,0,0,63
25,15,9,3,11,19,0,0,0,82
25,15,25,15,0,0,0,0,0,80
25,15,10,1,14,0,0,0,0,65
25,15,10,1,14,1,0,0,0,66
25,15,11,0,0,0,0,0,0,51
25,15,11,1,7,5,0,0,0,64
25,15,11,5,0,0,0,0,0,56
25,15,11,5,1,2,12,5,0,76
25,15,11,5,1,7,5,0,0,69
25,15,11,5,4,0,0,0,0,60
25,15,11,5,12,0,0,0,0,68
25,15,11,5,12,4,15,13,0,100
25,15,11,5,12,5,19,19,0,111
25,15,11,5,12,9,19,8,0,104
25,15,11,5,12,9,19,13,0,109
25,15,11,5,12,18,25,0,0,111
25,15,11,5,12,19,0,0,0,87
25,15,11,5,13,1,20,5,0,95
25,15,11,5,13,1,20,5,19,114
25,15,11,5,18,0,0,0,0,74
25,15,11,5,19,0,0,0,0,75
25,15,11,5,23,9,19,5,0,112
25,15,11,5,23,15,15,4,0,113
25,15,11,25,0,0,0,0,0,76
25,15,11,9,14,7,0,0,0,81
25,15,11,15,26,21,14,1,0,128
25,15,11,15,26,21,14,1,19,147
25,15,11,19,0,0,0,0,0,70
25,15,12,4,5,14,0,0,0,75
25,15,12,4,18,9,14,7,0,104
9,15,12,9,20,5,0,0,0,70
9,15,12,9,20,5,19,0,0,89
25,15,12,11,0,0,0,0,0,63
25,15,12,11,5,4,0,0,0,72
25,15,12,11,25,0,0,0,0,88
25,15,12,11,9,5,18,0,0,95
25,15,12,11,9,5,19,20,0,116
25,15,12,11,9,14,5,19,19,129
25,15,12,11,12,5,19,19,0,118
25,15,12,11,19,0,0,0,0,82
25,15,13,0,0,0,0,0,0,53
25,15,13,5,18,0,0,0,0,76
25,15,13,9,13,0,0,0,0,75
25,15,13,9,14,0,0,0,0,76
9,15,14,0,0,0,0,0,0,38
25,15,14,0,0,0,0,0,0,54
25,15,14,3,15,16,9,14,0,111
25,15,14,4,0,0,0,0,0,58
25,15,14,4,5,18,0,0,0,81
25,15,14,4,13,15,19,20,0,125
25,15,14,4,23,1,18,4,0,104
25,15,14,9,0,0,0,0,0,63
25,15,14,9,3,0,0,0,0,66
9,15,14,9,3,1,12,0,0,63
9,15,14,9,3,9,20,25,0,104
9,15,14,9,3,19,0,0,0,69
25,15,14,9,19,0,0,0,0,82
9,15,14,9,19,1,2,12,5,86
9,15,14,9,19,5,0,0,0,71
9,15,14,9,19,5,4,0,0,75
9,15,14,9,19,5,18,0,0,89
9,15,14,9,19,5,19,0,0,90
9,15,14,9,19,9,14,7,0,96
9,15,14,9,21,13,0,0,0,81
9,15,14,9,21,13,19,0,0,100
9,15,14,9,26,1,2,12,5,93
9,15,14,9,26,5,4,0,0,82
9,15,14,9,26,5,18,0,0,96
9,15,14,9,26,5,18,19,0,115
9,15,14,9,26,5,19,0,0,97
9,15,14,9,26,9,14,7,0,103
25,15,14,11,5,18,0,0,0,88
25,15,14,14,5,18,0,0,0,91
25,15,14,14,9,5,0,0,0,82
9,15,14,15,7,5,14,0,0,79
9,15,14,15,7,5,14,9,3,91
9,15,14,15,7,5,14,19,0,98
9,15,14,15,13,5,18,0,0,89
9,15,14,15,13,5,18,19,0,108
9,15,14,15,14,5,0,0,0,72
9,15,14,15,14,5,19,0,0,91
9,15,14,15,16,1,21,19,5,115
9,15,14,15,16,8,15,18,5,115
9,15,14,19,0,0,0,0,0,57
25,15,14,19,9,4,5,0,0,91
25,15,14,20,0,0,0,0,0,74
25,15,15,11,0,0,0,0,0,66
25,15,15,16,0,0,0,0,0,71
9,15,18,0,0,0,0,0,0,42
25,15,18,0,0,0,0,0,0,58
25,15,18,5,0,0,0,0,0,63
25,15,18,5,19,0,0,0,0,82
25,15,18,5,20,9,13,5,0,110
25,15,18,11,5,18,19,0,0,111
25,15,18,12,9,14,0,0,0,93
9,15,18,20,14,0,0,0,0,76
25,15,20,0,0,0,0,0,0,60
9,15,20,1,3,9,19,13,0,89
25,15,20,1,3,9,19,13,0,105
9,15,20,1,3,9,19,13,19,108
9,15,20,1,3,9,19,20,0,96
25,15,20,1,3,9,26,5,0,104
9,15,20,1,19,0,0,0,0,64
25,15,20,5,0,0,0,0,0,65
9,15,20,9,26,5,0,0,0,84
9,15,20,9,26,5,4,0,0,88
9,15,20,9,26,9,14,7,0,109
25,15,21,0,0,0,0,0,0,61
25,15,21,4,0,0,0,0,0,65
25,15,21,4,5,14,0,0,0,84
25,15,21,4,9,20,8,0,0,102
25,15,21,6,6,0,0,0,0,73
25,15,21,12,0,0,0,0,0,73
25,15,21,14,7,5,18,19,0,124
25,15,21,14,7,5,19,20,0,126
25,15,21,14,7,9,19,8,0,118
25,15,21,14,7,12,5,20,0,119
25,15,21,14,7,12,25,0,0,119
25,15,21,14,7,12,9,14,7,124
25,15,21,14,7,14,5,19,19,139
25,15,21,14,7,19,0,0,0,101
25,15,21,14,7,19,20,5,18,144
25,15,21,14,7,20,8,0,0,110
25,15,21,14,7,21,14,0,0,117
25,15,21,14,11,5,18,0,0,109
25,15,21,14,11,5,18,19,0,128
25,15,21,16,0,0,0,0,0,77
25,15,21,16,15,14,0,0,0,106
25,15,21,16,15,14,19,0,0,125
9,15,21,18,0,0,0,0,0,63
25,15,21,18,0,0,0,0,0,79
25,15,21,18,5,0,0,0,0,84
25,15,21,18,14,0,0,0,0,93
25,15,21,18,19,0,0,0,0,98
25,15,21,18,19,5,12,0,0,115
25,15,21,18,19,5,12,6,0,121
25,15,21,18,20,0,0,0,0,99
9,15,21,19,0,0,0,0,0,64
25,15,21,19,0,0,0,0,0,80
25,15,21,19,5,0,0,0,0,85
25,15,21,19,20,9,18,0,0,127
25,15,21,20,8,0,0,0,0,89
25,15,21,20,8,5,14,0,0,108
25,15,21,20,8,5,14,5,4,117
25,15,21,20,8,5,14,19,0,127
25,15,21,20,8,5,19,0,0,113
25,15,21,20,8,6,21,12,0,128
25,15,21,20,8,8,5,1,4,107
25,15,21,20,8,8,5,9,4,115
25,15,21,20,8,8,15,15,4,131
25,15,21,20,8,25,0,0,0,114
25,15,21,20,8,9,12,25,0,135
25,15,21,20,8,12,5,19,19,144
25,15,21,20,8,12,25,0,0,126
25,15,21,20,8,12,9,11,5,126
25,15,21,20,8,19,0,0,0,108
25,15,21,20,8,19,15,13,5,141
25,15,21,20,8,20,9,4,5,127
25,15,21,20,8,23,15,18,20,165
25,15,21,22,5,0,0,0,0,88
25,15,21,23,1,18,4,0,0,107
25,15,21,23,1,18,4,19,0,126
25,15,21,26,5,0,0,0,0,92
25,15,22,5,14,0,0,0,0,81
25,15,23,0,0,0,0,0,0,63
9,15,23,1,14,19,0,0,0,81
25,15,23,4,5,14,0,0,0,86
25,15,23,5,0,0,0,0,0,68
25,15,23,5,4,0,0,0,0,72
25,15,23,5,19,0,0,0,0,87
25,15,23,9,5,0,0,0,0,77
25,15,23,9,5,19,0,0,0,96
25,15,23,9,14,7,0,0,0,93
25,15,23,12,0,0,0,0,0,75
25,15,23,12,5,4,0,0,0,84
25,15,23,12,5,25,0,0,0,105
25,15,23,12,5,18,0,0,0,98
25,15,23,12,5,18,19,0,0,117
25,15,23,12,9,14,7,0,0,105
25,15,23,12,18,9,14,7,0,123
25,15,23,12,19,0,0,0,0,94
25,15,23,19,0,0,0,0,0,82
9,15,23,20,0,0,0,0,0,67
25,15,23,20,0,0,0,0,0,83
25,15,24,0,0,0,0,0,0,64
9,16,5,3,1,3,0,0,0,37
9,16,5,3,1,3,19,0,0,56
25,16,5,18,9,20,5,0,0,98
25,16,5,18,9,20,5,19,0,117
9,16,8,0,0,0,0,0,0,33
9,16,9,4,0,0,0,0,0,38
9,16,9,12,0,0,0,0,0,46
9,16,9,12,9,16,9,12,0,92
9,16,15,3,18,1,19,0,0,81
25,16,15,3,18,1,19,0,0,97
9,16,15,13,5,1,0,0,0,59
9,16,15,13,15,5,1,19,0,93
9,16,15,13,15,5,9,14,0,96
9,16,18,0,0,0,0,0,0,43
9,16,19,5,1,14,4,0,0,68
9,16,19,5,9,20,25,0,0,103
25,16,19,9,12,15,9,4,0,109
9,16,19,15,0,0,0,0,0,59
9,17,19,0,0,0,0,0,0,45
9,18,2,9,19,0,0,0,0,57
25,18,2,11,0,0,0,0,0,56
9,18,3,8,9,14,0,0,0,61
9,18,5,4,0,0,0,0,0,36
9,18,5,6,21,12,0,0,0,71
9,18,5,6,21,12,12,25,0,108
9,18,5,12,5,19,19,0,0,87
9,18,5,14,1,18,3,8,0,76
9,18,5,14,9,3,0,0,0,58
9,18,5,14,9,3,1,0,0,59
9,18,5,14,9,3,1,12,0,71
9,18,5,14,9,3,9,19,13,99
9,18,5,14,9,3,9,19,20,106
9,18,5,14,9,3,15,14,0,87
9,18,5,14,9,3,19,0,0,77
9,18,5,14,9,3,21,13,0,92
9,18,5,15,19,0,0,0,0,66
9,18,5,19,0,0,0,0,0,51
9,18,9,1,14,0,0,0,0,51
9,18,9,4,0,0,0,0,0,40
9,18,9,4,1,12,0,0,0,53
9,18,9,4,1,12,7,9,1,70
9,18,9,4,1,20,5,0,0,66
9,18,9,4,5,13,9,1,0,68
9,18,9,4,5,15,21,19,0,100
9,18,9,4,5,19,0,0,0,64
9,18,9,4,5,19,3,5,0,72
9,18,9,4,9,1,12,0,0,62
9,18,9,4,9,1,14,0,0,64
9,18,9,4,9,1,20,5,0,75
9,18,9,4,9,3,0,0,0,52
9,18,9,4,9,3,1,12,0,65
9,18,9,4,9,14,0,0,0,63
9,18,9,4,9,14,5,0,0,68
9,18,9,4,9,15,21,19,0,104
9,18,9,4,9,20,5,0,0,74
9,18,9,4,9,21,13,0,0,83
9,18,9,4,9,21,13,19,0,102
9,18,9,4,9,26,5,0,0,80
9,18,9,4,9,26,5,4,0,84
9,18,9,4,9,26,9,14,7,105
9,18,9,4,15,0,0,0,0,55
9,18,9,4,15,3,5,12,5,80
9,18,9,4,15,3,25,20,5,108
9,18,9,4,15,12,9,14,5,95
9,18,9,4,15,14,3,21,19,112
9,18,9,4,15,20,15,13,5,108
9,18,9,4,15,20,15,13,25,128
9,18,9,4,15,21,19,0,0,95
9,18,9,4,19,0,0,0,0,59
9,18,9,14,7,0,0,0,0,57
9,18,9,19,1,20,5,0,0,81
9,18,9,19,1,20,5,4,0,85
9,18,9,19,1,20,9,15,14,114
9,18,9,19,3,15,16,5,0,94
9,18,9,19,5,4,0,0,0,64
9,18,9,19,5,19,0,0,0,79
9,18,9,19,9,14,0,0,0,78
9,18,9,19,9,14,7,0,0,85
9,18,9,19,12,9,11,5,0,92
9,18,9,19,18,15,15,20,0,123
9,18,9,20,9,3,0,0,0,68
9,18,9,20,9,19,0,0,0,84
9,18,9,20,9,19,5,19,0,108
9,18,11,0,0,0,0,0,0,38
9,18,11,5,4,0,0,0,0,47
9,18,11,9,14,7,0,0,0,68
9,18,11,19,0,0,0,0,0,57
9,18,11,19,15,13,5,0,0,90
9,18,11,19,15,13,5,12,25,127
9,18,15,11,0,0,0,0,0,53
9,18,15,11,15,0,0,0,0,68
9,18,15,14,0,0,0,0,0,56
9,18,15,14,2,1,3,11,0,73
9,18,15,14,2,1,18,11,0,88
9,18,15,14,2,1,18,11,19,107
9,18,15,14,2,15,21,14,4,112
9,18,15,14,2,21,19,8,0,106
9,18,15,14,3,12,1,4,0,76
9,18,15,14,3,12,1,4,19,95
9,18,15,14,5,0,0,0,0,61
9,18,15,14,5,4,0,0,0,65
9,18,15,14,5,18,0,0,0,79
9,18,15,14,5,18,19,0,0,98
9,18,15,14,5,19,0,0,0,80
9,18,15,14,8,1,18,4,0,87
9,18,15,14,8,5,1,4,0,74
9,18,15,14,8,5,1,4,19,93
9,18,15,14,25,0,0,0,0,81
9,18,15,14,9,3,0,0,0,68
9,18,15,14,9,3,1,12,0,81
9,18,15,14,9,3,5,0,0,73
9,18,15,14,9,5,19,0,0,89
9,18,15,14,9,14,7,0,0,86
9,18,15,14,9,14,7,19,0,105
9,18,15,14,9,19,8,0,0,92
9,18,15,14,9,19,13,0,0,97
9,18,15,14,9,19,20,0,0,104
9,18,15,14,9,19,20,19,0,123
9,18,15,14,9,26,5,0,0,96
9,18,15,14,9,26,5,4,0,100
9,18,15,14,9,26,5,19,0,115
9,18,15,14,12,5,19,19,0,111
9,18,15,14,12,25,0,0,0,93
9,18,15,14,12,9,11,5,0,93
9,18,15,14,13,1,11,5,18,104
9,18,15,14,13,1,14,0,0,84
9,18,15,14,13,5,14,0,0,88
9,18,15,14,14,5,19,19,0,113
9,18,15,14,19,8,15,4,0,102
9,18,15,14,19,8,15,20,0,118
9,18,15,14,19,9,4,5,4,97
9,18,15,14,19,13,9,20,8,125
9,18,15,14,19,20,15,14,5,129
9,18,15,14,23,1,18,5,0,103
9,18,15,14,23,1,18,5,19,122
9,18,15,14,23,5,5,4,0,93
9,18,15,14,23,5,5,4,19,112
9,18,15,14,23,15,15,4,0,113
9,18,15,14,23,15,15,4,19,132
9,18,15,14,23,15,18,11,0,123
9,18,15,14,23,15,18,11,19,142
9,18,15,14,23,15,18,20,0,132
9,18,15,21,19,0,0,0,0,82
9,18,16,5,0,0,0,0,0,48
9,18,18,1,4,9,1,14,20,94
9,18,18,1,4,9,1,20,5,85
9,18,18,1,20,5,0,0,0,71
9,18,18,5,1,12,0,0,0,63
9,18,18,5,1,12,9,20,25,117
9,18,18,5,4,0,0,0,0,54
9,18,18,5,4,5,14,20,1,94
9,18,18,5,7,0,0,0,0,57
9,18,18,5,7,21,12,1,18,109
9,18,18,5,12,1,20,5,0,88
9,18,18,5,12,1,20,5,4,92
9,18,18,5,16,1,9,18,0,94
9,18,18,5,16,20,9,15,14,124
9,18,18,8,1,20,9,15,14,112
9,18,18,9,4,5,0,0,0,63
9,18,18,9,4,5,14,20,1,98
9,18,18,9,7,1,2,12,5,81
9,18,18,9,7,1,2,12,25,101
9,18,18,9,7,1,14,20,0,96
9,18,18,9,7,1,20,5,0,87
9,18,18,9,7,1,20,5,4,91
9,18,18,9,7,1,20,5,19,106
9,18,18,9,7,1,20,15,18,115
9,18,18,9,7,21,15,21,19,137
9,18,18,9,19,9,2,12,5,101
9,18,18,9,19,9,15,14,0,111
9,18,18,9,19,15,18,0,0,106
9,18,18,9,19,15,18,25,0,131
9,18,18,9,20,1,2,12,5,94
9,18,18,9,20,1,2,12,25,114
9,18,18,9,20,1,14,3,25,117
9,18,18,9,20,1,14,20,0,109
9,18,18,9,20,1,14,20,19,128
9,18,18,9,20,1,20,5,0,100
9,18,18,9,20,1,20,5,4,104
9,18,18,9,20,1,20,5,19,119
9,18,18,9,20,1,20,15,18,128
9,18,18,9,20,5,0,0,0,79
9,18,18,15,7,1,20,5,0,93
9,18,18,15,18,1,20,5,0,104
9,18,18,15,18,1,20,5,4,108
9,18,18,21,7,1,20,5,0,99
9,18,18,21,16,20,0,0,0,102
9,18,18,21,16,20,5,4,0,111
9,18,18,21,16,20,9,14,7,132
9,18,18,21,16,20,9,15,14,140
9,18,18,21,16,20,9,22,5,138
9,18,18,21,16,20,19,0,0,121
9,19,2,1,0,0,0,0,0,31
9,19,2,1,19,0,0,0,0,50
9,19,3,8,1,5,13,9,1,68
9,19,3,8,1,5,13,9,3,70
9,19,3,8,1,18,0,0,0,58
9,19,3,8,3,8,9,1,0,60
9,19,3,8,5,13,9,1,0,67
9,19,3,8,5,13,9,1,19,86
9,19,3,8,5,13,9,3,0,69
9,19,3,8,9,1,3,0,0,52
9,19,3,8,9,1,4,9,3,65
9,19,3,8,9,1,12,0,0,61
9,19,3,8,9,1,20,9,3,81
9,19,3,8,9,21,13,0,0,82
9,19,3,8,21,18,25,0,0,103
9,19,3,8,21,18,9,1,0,88
9,19,3,15,19,5,0,0,0,70
9,19,5,0,0,0,0,0,0,33
9,19,5,4,0,0,0,0,0,37
9,19,5,14,5,18,7,9,3,89
9,19,5,14,20,18,15,16,5,121
9,19,5,18,9,14,5,0,0,79
9,19,5,18,9,20,5,0,0,85
9,19,8,0,0,0,0,0,0,36
9,19,8,9,13,5,0,0,0,63
9,19,8,16,9,14,7,15,0,97
9,19,8,19,8,1,11,11,21,107
9,19,9,3,12,5,0,0,0,57
9,19,9,4,9,1,0,0,0,51
9,19,9,4,9,15,9,4,0,78
9,19,9,4,9,15,19,5,0,89
9,19,9,4,9,21,13,0,0,84
9,19,9,4,15,9,4,0,0,69
9,19,9,14,7,12,1,19,19,109
9,19,9,26,5,0,0,0,0,68
9,19,12,1,14,4,5,4,0,68
9,19,12,1,14,4,5,18,0,82
9,19,12,1,14,4,5,18,19,101
9,19,12,1,14,4,25,0,0,84
9,19,12,1,14,4,9,3,0,71
9,19,12,1,14,4,9,14,7,89
9,19,12,1,14,4,9,19,8,95
9,19,12,1,14,4,13,1,14,87
9,19,12,1,14,4,13,5,14,91
9,19,12,1,14,4,18,25,0,102
9,19,12,1,14,4,19,0,0,78
9,19,12,5,4,0,0,0,0,49
9,19,12,5,12,5,19,19,0,100
9,19,12,5,13,1,14,0,0,73
9,19,12,5,19,0,0,0,0,64
9,19,12,5,19,13,1,14,0,92
9,19,12,5,19,13,5,14,0,96
9,19,12,5,20,0,0,0,0,65
9,19,12,5,20,5,4,0,0,74
9,19,12,5,20,19,0,0,0,84
9,19,12,5,23,1,18,4,0,91
9,19,12,9,14,7,0,0,0,70
9,19,12,15,20,0,0,0,0,75
9,19,12,19,0,0,0,0,0,59
9,19,13,0,0,0,0,0,0,41
9,19,13,1,5,12,9,1,14,83
9,19,13,1,12,0,0,0,0,54
9,19,13,1,20,9,3,0,0,74
9,19,13,1,20,9,3,1,12,87
9,19,13,4,15,13,0,0,0,73
9,19,13,25,0,0,0,0,0,66
9,19,13,19,0,0,0,0,0,60
9,19,14,1,4,0,0,0,0,47
9,19,14,20,0,0,0,0,0,62
9,19,15,1,12,12,25,12,0,105
9,19,15,1,13,9,4,0,0,70
9,19,15,1,13,9,4,5,0,75
9,19,15,1,13,25,12,0,0,94
9,19,15,1,16,9,15,12,5,101
9,19,15,1,21,18,15,18,5,121
9,19,15,2,1,18,0,0,0,64
9,19,15,2,1,18,5,0,0,69
9,19,15,2,1,18,5,19,0,88
9,19,15,2,1,18,9,3,0,76
9,19,15,2,1,18,9,19,13,105
9,19,15,2,1,18,19,0,0,83
9,19,15,2,1,19,5,0,0,70
9,19,15,2,1,20,8,0,0,74
9,19,15,2,1,20,8,9,3,86
9,19,15,2,1,20,8,19,0,93
9,19,15,2,15,18,14,25,12,129
9,19,15,2,18,15,14,20,0,112
9,19,15,2,21,20,1,14,5,106
9,19,15,2,21,20,5,14,5,110
9,19,15,2,21,20,25,12,0,123
9,19,15,3,1,18,16,9,3,93
9,19,15,3,5,18,3,1,12,85
9,19,15,3,5,18,3,25,0,97
9,19,15,3,8,1,19,13,0,87
9,19,15,3,8,5,9,13,0,81
9,19,15,3,8,5,9,13,19,100
9,19,15,3,8,5,12,1,0,72
9,19,15,3,8,9,13,1,12,89
9,19,15,3,8,9,13,5,0,81
9,19,15,3,8,9,13,5,19,100
9,19,15,3,8,12,15,18,0,99
9,19,15,3,8,15,18,0,0,87
9,19,15,3,8,15,18,5,0,92
9,19,15,3,8,15,18,5,19,111
9,19,15,3,8,15,18,9,3,99
9,19,15,3,8,15,18,19,0,106
9,19,15,3,8,18,15,14,0,101
9,19,15,3,8,18,15,14,5,106
9,19,15,3,8,18,15,14,25,126
9,19,15,3,8,18,15,14,19,120
9,19,15,3,25,1,14,9,3,98
9,19,15,3,25,1,14,9,4,99
9,19,15,3,25,1,14,9,14,109
9,19,15,3,25,1,14,15,0,101
9,19,15,3,25,3,12,9,3,98
9,19,15,3,25,13,5,14,5,108
9,19,15,3,25,20,9,3,0,103
9,19,15,3,9,20,18,9,3,105
9,19,15,3,12,9,14,1,12,94
9,19,15,3,12,9,14,5,0,86
9,19,15,3,12,9,14,5,19,105
9,19,15,3,12,9,14,9,3,93
9,19,15,3,15,12,1,0,0,74
9,19,15,3,15,12,9,3,0,85
9,19,15,3,15,12,15,14,0,102
9,19,15,3,15,18,9,1,0,89
9,19,15,3,18,1,3,25,0,93
9,19,15,3,18,1,20,0,0,85
9,19,15,3,18,1,20,9,3,97
9,19,15,3,18,25,13,1,12,115
9,19,15,3,18,25,13,5,0,107
9,19,15,3,18,25,13,9,3,114
9,19,15,4,5,6,0,0,0,58
9,19,15,4,9,1,26,15,0,98
9,19,15,4,15,13,9,3,0,87
9,19,15,4,15,13,15,14,0,104
9,19,15,4,15,13,15,21,19,130
9,19,15,4,15,13,21,13,0,109
9,19,15,4,15,14,20,0,0,96
9,19,15,4,15,19,5,0,0,86
9,19,15,4,18,9,14,0,0,88
9,19,15,4,18,15,13,5,0,98
9,19,15,4,21,18,5,14,5,110
9,19,15,5,13,15,4,9,14,103
9,19,15,5,14,26,25,13,5,131
9,19,15,5,18,21,3,9,3,102
9,19,15,6,12,15,18,0,0,94
9,19,15,7,1,13,0,0,0,64
9,19,15,7,1,13,5,20,5,94
9,19,15,7,1,13,25,0,0,89
9,19,15,7,1,13,9,3,0,76
9,19,15,7,1,13,9,5,19,97
9,19,15,7,1,13,15,21,19,119
9,19,15,7,5,14,0,0,0,69
9,19,15,7,5,14,5,9,3,86
9,19,15,7,5,14,25,0,0,94
9,19,15,7,5,14,9,3,0,81
9,19,15,7,5,14,9,5,19,102
9,19,15,7,5,14,15,21,19,124
9,19,15,7,25,14,15,21,19,144
9,19,15,7,25,18,5,0,0,98
9,19,15,7,12,15,19,19,0,115
9,19,15,7,15,14,0,0,0,79
9,19,15,7,15,14,1,12,0,92
9,19,15,7,15,14,1,12,19,111
9,19,15,7,15,14,5,0,0,84
9,19,15,7,15,14,5,19,0,103
9,19,15,7,15,14,25,0,0,104
9,19,15,7,15,14,9,3,0,91
9,19,15,7,15,14,9,3,19,110
9,19,15,7,15,14,9,5,19,112
9,19,15,7,15,14,9,19,13,120
9,19,15,7,15,14,19,0,0,98
9,19,15,7,18,1,6,20,0,95
9,19,15,7,18,1,13,0,0,82
9,19,15,7,18,1,13,19,0,101
9,19,15,7,18,1,16,8,0,93
9,19,15,7,18,1,16,8,25,118
9,19,15,7,18,1,16,8,19,112
9,19,15,7,18,9,22,0,0,99
9,19,15,7,18,9,22,19,0,118
9,19,15,8,1,12,9,14,5,92
9,19,15,8,5,12,0,0,0,68
9,19,15,8,5,12,19,0,0,87
9,19,15,8,5,24,25,12,0,117
9,19,15,8,25,4,18,9,3,110
9,19,15,8,25,5,20,0,0,101
9,19,15,8,25,5,20,1,12,114
9,19,15,8,25,5,20,19,0,120
9,19,15,8,21,13,5,0,0,90
9,19,15,9,13,13,21,14,5,118
9,19,15,9,14,4,15,12,5,102
9,19,15,9,15,14,15,14,5,115
9,19,15,11,15,14,20,1,14,118
9,19,15,11,21,18,20,9,3,125
9,19,15,12,1,2,12,5,0,75
9,19,15,12,1,20,5,0,0,81
9,19,15,12,1,20,5,4,0,85
9,19,15,12,1,20,5,19,0,100
9,19,15,12,1,20,9,14,7,106
9,19,15,12,1,20,9,15,14,114
9,19,15,12,1,20,9,22,5,112
9,19,15,12,1,20,15,18,0,109
9,19,15,12,1,20,15,18,19,128
9,19,15,12,5,1,4,0,0,65
9,19,15,12,5,1,4,19,0,84
9,19,15,12,5,20,20,5,0,105
9,19,15,12,5,24,0,0,0,84
9,19,15,12,9,14,5,0,0,83
9,19,15,12,9,14,5,19,0,102
9,19,15,12,25,19,9,14,0,122
9,19,15,12,25,19,9,19,0,127
9,19,15,12,14,0,0,0,0,69
9,19,15,12,15,7,0,0,0,77
9,19,15,12,15,7,25,0,0,102
9,19,15,12,15,7,15,21,19,132
9,19,15,12,15,7,19,0,0,96
9,19,15,12,15,7,21,5,0,103
9,19,15,12,15,7,21,5,19,122
9,19,15,13,5,18,0,0,0,79
9,19,15,13,5,18,1,19,5,104
9,19,15,13,5,18,5,0,0,84
9,19,15,13,5,18,25,0,0,104
9,19,15,13,5,18,9,3,0,91
9,19,15,13,5,18,9,4,5,97
9,19,15,13,5,18,9,19,13,120
9,19,15,13,5,18,9,26,5,119
9,19,15,13,5,18,15,21,19,134
9,19,15,13,5,18,19,0,0,98
9,19,15,13,5,20,18,25,0,124
9,19,15,13,5,20,18,9,3,111
9,19,15,13,15,18,16,8,0,113
9,19,15,13,15,18,16,8,19,132
9,19,15,14,0,0,0,0,0,57
9,19,15,14,5,16,8,0,0,86
9,19,15,14,5,18,7,9,3,99
9,19,15,14,9,1,26,9,4,106
9,19,15,14,25,13,0,0,0,95
9,19,15,14,25,13,25,0,0,120
9,19,15,14,25,13,9,3,0,107
9,19,15,14,9,20,18,9,12,125
9,19,15,14,9,20,18,15,0,119
9,19,15,14,15,13,25,0,0,110
9,19,15,14,15,13,9,3,0,97
9,19,15,14,15,13,9,5,19,118
9,19,15,14,15,13,15,21,19,140
9,19,15,15,3,20,1,14,5,101
9,19,15,15,12,5,9,3,0,87
9,19,15,16,1,3,8,0,0,71
9,19,15,16,1,3,8,19,0,90
9,19,15,16,1,7,0,0,0,67
9,19,15,16,1,20,8,25,0,113
9,19,15,16,5,3,20,9,3,99
9,19,15,16,5,4,9,14,0,91
9,19,15,16,5,4,9,14,5,96
9,19,15,16,5,14,20,25,12,135
9,19,15,16,8,1,14,1,12,95
9,19,15,16,8,1,14,5,0,87
9,19,15,16,8,1,19,1,12,100
9,19,15,16,8,5,14,5,0,91
9,19,15,16,8,25,12,12,25,141
9,19,15,16,8,15,14,5,0,101
9,19,15,16,8,15,18,9,1,110
9,19,15,16,8,15,20,1,12,115
9,19,15,16,8,15,20,5,0,107
9,19,15,16,8,15,20,5,19,126
9,19,15,16,25,3,14,1,12,114
9,19,15,16,25,3,14,9,3,113
9,19,15,16,25,18,5,0,0,107
9,19,15,16,12,5,18,5,0,99
9,19,15,16,12,5,20,8,0,104
9,19,15,16,12,5,20,8,19,123
9,19,15,16,12,5,21,18,5,120
9,19,15,16,15,4,0,0,0,78
9,19,15,16,15,4,1,14,0,93
9,19,15,16,15,4,1,14,19,112
9,19,15,16,15,4,15,21,19,133
9,19,15,16,15,4,19,0,0,97
9,19,15,16,15,12,25,0,0,111
9,19,15,16,15,12,9,20,5,120
9,19,15,16,15,12,9,20,25,140
9,19,15,16,15,18,0,0,0,92
9,19,15,16,15,18,9,3,0,104
9,19,15,16,18,5,14,5,0,101
9,19,15,16,18,5,14,5,19,120
9,19,15,16,18,15,16,25,12,145
9,19,15,16,20,9,3,0,0,91
9,19,15,18,3,9,14,15,12,114
9,19,15,18,8,25,20,8,13,135
9,19,15,18,9,20,8,13,0,111
9,19,15,18,18,15,16,9,3,122
9,19,15,18,20,0,0,0,0,81
9,19,15,19,3,5,12,5,0,87
9,19,15,19,3,5,12,5,19,106
9,19,15,19,3,15,16,5,0,101
9,19,15,19,5,9,19,20,0,115
9,19,15,19,5,18,9,14,5,113
9,19,15,19,13,15,20,9,3,122
9,19,15,19,16,9,14,0,0,101
9,19,15,19,16,9,14,19,0,120
9,19,15,19,16,15,18,5,0,116
9,19,15,19,16,15,18,25,0,136
9,19,15,19,16,15,18,9,3,123
9,19,15,19,20,1,3,25,0,111
9,19,15,19,20,1,19,25,0,127
9,19,15,19,20,1,20,9,3,115
9,19,15,19,20,5,18,0,0,105
9,19,15,19,20,5,18,5,0,110
9,19,15,19,20,5,18,9,3,117
9,19,15,19,21,12,20,1,13,129
9,19,15,20,1,3,0,0,0,67
9,19,15,20,1,3,8,0,0,75
9,19,15,20,1,3,8,19,0,94
9,19,15,20,1,3,20,9,3,99
9,19,15,20,5,12,5,19,0,104
9,19,15,20,5,12,25,0,0,105
9,19,15,20,5,18,5,0,0,91
9,19,15,20,5,18,9,3,0,98
9,19,15,20,8,5,18,1,12,107
9,19,15,20,8,5,18,5,0,99
9,19,15,20,8,5,18,5,19,118
9,19,15,20,8,5,18,13,0,107
9,19,15,20,8,5,18,13,19,126
9,19,15,20,9,13,1,12,0,98
9,19,15,20,9,13,9,3,0,97
9,19,15,20,25,16,5,0,0,109
9,19,15,20,25,16,5,19,0,128
9,19,15,20,25,16,9,3,0,116
9,19,15,20,15,13,5,0,0,96
9,19,15,20,15,13,15,21,19,146
9,19,15,20,15,14,5,0,0,97
9,19,15,20,15,14,5,19,0,116
9,19,15,20,15,14,25,0,0,117
9,19,15,20,15,14,9,1,0,102
9,19,15,20,15,14,9,3,0,104
9,19,15,20,15,16,5,0,0,99
9,19,15,20,15,16,5,19,0,118
9,19,15,20,15,16,25,0,0,119
9,19,15,20,15,16,9,3,0,106
9,19,15,20,15,16,9,5,19,127
9,19,15,20,15,16,9,19,13,135
9,19,15,20,18,15,14,0,0,110
9,19,15,20,18,15,14,9,3,122
9,19,15,20,18,15,16,5,0,117
9,19,15,20,18,15,16,25,0,137
9,19,15,20,18,15,16,9,3,124
9,19,15,20,18,15,16,9,12,133
9,19,15,22,1,12,9,14,5,106
9,19,15,24,1,26,9,14,5,122
9,19,15,24,1,26,15,12,5,126
9,19,15,24,25,12,5,14,5,128
9,19,15,24,9,13,5,0,0,94
9,19,15,26,25,13,5,0,0,112
9,19,15,26,25,13,5,19,0,131
9,19,15,26,25,13,9,3,0,119
9,19,15,26,15,15,9,4,0,112
9,19,16,1,7,8,21,12,0,93
9,19,16,18,1,25,14,9,11,122
9,19,16,18,1,22,14,9,11,119
9,19,19,5,9,19,0,0,0,80
9,19,19,9,20,5,0,0,0,81
9,19,19,21,1,2,12,5,0,88
9,19,19,21,1,2,12,25,0,108
9,19,19,21,1,14,3,5,0,91
9,19,19,21,1,14,3,5,19,110
9,19,19,21,1,14,20,0,0,103
9,19,19,21,5,0,0,0,0,73
9,19,19,21,5,4,0,0,0,77
9,19,19,21,5,12,5,19,19,128
9,19,19,21,5,18,0,0,0,91
9,19,19,21,5,18,19,0,0,110
9,19,19,21,5,19,0,0,0,92
9,19,19,21,9,14,7,0,0,98
9,19,20,0,0,0,0,0,0,48
9,19,20,1,14,1,0,0,0,64
9,19,20,5,18,0,0,0,0,71
9,19,20,8,13,0,0,0,0,69
9,19,20,8,13,1,12,0,0,82
9,19,20,8,13,9,0,0,0,78
9,19,20,8,13,9,1,12,0,91
9,19,20,8,13,9,1,14,19,112
9,19,20,8,13,9,1,20,5,104
9,19,20,8,13,9,3,0,0,81
9,19,20,8,13,9,3,19,0,100
9,19,20,8,13,9,19,20,0,117
9,19,20,8,13,15,9,4,0,97
9,19,20,8,13,21,19,0,0,109
9,19,20,8,13,21,19,5,19,133
9,19,20,9,3,0,0,0,0,60
9,19,20,12,5,0,0,0,0,65
9,19,20,12,5,19,0,0,0,84
9,19,20,15,11,5,0,0,0,79
9,19,21,18,5,20,0,0,0,92
9,19,21,18,5,20,9,14,5,120
9,19,21,18,15,9,4,0,0,95
9,19,26,0,0,0,0,0,0,54
9,20,3,8,5,4,0,0,0,49
9,20,3,8,5,19,0,0,0,64
9,20,3,8,25,0,0,0,0,65
9,20,3,8,9,5,18,0,0,72
9,20,3,8,9,5,19,20,0,93
9,20,3,8,9,12,25,0,0,86
9,20,3,8,9,14,5,19,19,106
9,20,3,8,9,14,7,0,0,70
9,20,3,8,9,14,7,12,25,107
9,20,3,8,9,14,7,19,0,89
9,20,3,8,12,5,19,19,0,95
9,20,3,8,16,18,15,15,6,110
9,20,3,8,18,5,5,4,0,72
9,20,3,8,23,5,5,4,0,77
9,20,3,8,23,15,15,4,0,97
9,20,3,26,5,0,0,0,0,63
9,20,4,0,0,0,0,0,0,33
9,20,5,0,0,0,0,0,0,34
9,20,5,12,0,0,0,0,0,46
9,20,5,13,0,0,0,0,0,47
9,20,5,13,5,4,0,0,0,56
9,20,5,13,25,0,0,0,0,72
9,20,5,13,9,14,7,0,0,77
9,20,5,13,9,19,5,0,0,80
9,20,5,13,9,26,5,0,0,87
9,20,5,13,9,26,5,4,0,91
9,20,5,13,9,26,5,18,0,105
9,20,5,13,9,26,5,18,19,124
9,20,5,13,9,26,5,19,0,106
9,20,5,13,9,26,9,14,7,112
9,20,5,13,19,0,0,0,0,66
9,20,5,18,0,0,0,0,0,52
9,20,5,18,1,2,12,5,0,72
9,20,5,18,1,14,3,5,0,75
9,20,5,18,1,14,3,5,19,94
9,20,5,18,1,14,3,25,0,95
9,20,5,18,1,14,20,0,0,87
9,20,5,18,1,20,5,0,0,78
9,20,5,18,1,20,5,4,0,82
9,20,5,18,1,20,5,12,25,115
9,20,5,18,1,20,5,19,0,97
9,20,5,18,1,20,9,14,7,103
9,20,5,18,1,20,9,15,14,111
9,20,5,18,1,20,9,22,5,109
9,20,5,18,1,20,15,18,0,106
9,20,5,18,1,20,15,18,19,125
9,20,5,18,19,0,0,0,0,71
9,20,5,18,21,13,0,0,0,86
9,20,8,1,7,9,14,5,0,73
9,20,8,1,14,4,0,0,0,56
9,20,8,5,18,0,0,0,0,60
9,20,8,5,18,14,5,19,19,117
9,20,8,15,13,9,9,4,0,87
9,20,25,0,0,0,0,0,0,54
9,20,9,14,5,18,1,3,25,104
9,20,9,14,5,18,1,14,20,110
9,20,9,14,5,18,1,18,25,119
9,20,9,14,5,18,1,20,5,101
9,20,9,14,5,18,9,20,5,109
9,20,9,14,5,18,15,21,19,130
9,20,9,15,14,0,0,0,0,67
9,20,9,15,21,19,0,0,0,93
9,20,9,19,0,0,0,0,0,57
9,20,12,12,0,0,0,0,0,53
9,20,13,15,0,0,0,0,0,57
9,20,15,12,0,0,0,0,0,56
9,20,15,14,9,4,9,4,0,84
9,20,15,21,2,15,21,0,0,103
9,20,15,21,19,0,0,0,0,84
9,20,19,5,12,6,0,0,0,71
9,20,19,25,0,0,0,0,0,73
25,20,20,5,18,0,0,0,0,88
25,20,20,5,18,2,9,1,0,100
25,20,20,5,18,2,9,1,19,119
25,20,20,5,18,2,9,3,0,102
25,20,20,5,18,2,9,20,5,124
25,20,20,5,18,2,9,21,13,133
25,20,20,5,18,2,15,21,19,145
25,20,20,5,18,9,20,5,0,122
9,20,20,18,9,1,0,0,0,77
25,20,20,18,9,1,0,0,0,93
25,20,20,18,9,1,19,0,0,112
25,20,20,18,9,3,0,0,0,95
25,20,20,18,9,15,21,19,0,147
25,20,20,18,9,21,13,0,0,126
25,20,20,18,9,21,13,19,0,145
9,20,21,18,9,20,5,0,0,102
9,20,26,5,2,21,0,0,0,83
25,21,3,1,0,0,0,0,0,50
25,21,3,3,1,19,0,0,0,72
25,21,3,3,8,0,0,0,0,60
25,21,3,8,0,0,0,0,0,57
25,21,3,11,0,0,0,0,0,60
25,21,3,11,5,4,0,0,0,69
25,21,3,11,5,12,0,0,0,77
25,21,3,11,5,18,0,0,0,83
25,21,3,11,25,0,0,0,0,85
25,21,3,11,9,5,18,0,0,92
25,21,3,11,9,5,19,20,0,113
25,21,3,11,9,14,7,0,0,90
25,21,3,11,12,5,0,0,0,77
25,21,3,11,19,0,0,0,0,79
9,21,4,19,0,0,0,0,0,53
25,21,6,20,0,0,0,0,0,72
25,21,7,0,0,0,0,0,0,53
25,21,7,1,4,1,0,0,0,59
25,21,7,1,19,0,0,0,0,73
25,21,7,15,19,12,1,22,19,141
25,21,8,0,0,0,0,0,0,54
25,21,11,1,20,1,0,0,0,79
25,21,11,5,0,0,0,0,0,62
25,21,11,11,5,4,0,0,0,77
25,21,11,11,5,12,0,0,0,85
25,21,11,11,9,14,7,0,0,98
25,21,11,19,0,0,0,0,0,76
25,21,12,1,14,19,0,0,0,92
25,21,12,5,2,12,15,3,11,106
25,21,12,5,19,0,0,0,0,82
25,21,12,5,20,9,4,5,19,120
9,21,12,9,4,1,14,0,0,70
9,21,13,0,0,0,0,0,0,43
25,21,13,0,0,0,0,0,0,59
25,21,13,13,25,0,0,0,0,97
25,21,13,13,9,5,18,0,0,104
25,21,13,13,9,5,19,0,0,105
25,21,13,13,9,5,19,20,0,125
25,21,14,7,1,14,0,0,0,82
25,21,14,11,5,18,0,0,0,94
25,21,16,15,14,0,0,0,0,91
25,21,16,15,14,19,0,0,0,110
25,21,16,16,9,5,0,0,0,92
25,21,16,16,9,5,19,0,0,111
25,21,17,21,9,12,12,1,0,118
25,21,17,21,9,12,12,1,19,137
9,21,18,1,14,20,0,0,0,83
25,21,18,20,1,0,0,0,0,85
25,21,18,20,19,0,0,0,0,103
25,21,19,0,0,0,0,0,0,65
25,21,19,4,18,21,13,0,0,121
25,21,20,21,0,0,0,0,0,87
9,21,21,19,0,0,0,0,0,70
25,21,26,12,9,11,0,0,0,104
25,21,26,12,21,11,0,0,0,116
9,22,5,0,0,0,0,0,0,36
9,22,25,2,5,12,12,19,0,106
9,22,25,2,5,18,18,25,0,124
9,22,9,5,4,0,0,0,0,49
9,22,9,5,19,0,0,0,0,64
9,22,25,6,12,15,23,5,18,135
9,22,25,12,9,11,5,0,0,93
9,22,9,14,0,0,0,0,0,54
9,22,25,23,5,5,4,0,0,93
9,22,25,23,15,15,4,0,0,113
9,22,25,23,15,18,20,0,0,132
9,22,15,18,25,2,9,12,12,124
9,22,15,18,9,5,4,0,0,82
9,22,15,18,9,5,19,0,0,97
9,22,15,18,25,12,9,11,5,126
9,22,15,18,9,14,5,0,0,92
9,22,15,18,9,14,5,19,19,130
9,22,15,18,9,19,20,0,0,112
9,22,15,18,25,20,25,16,5,155
9,22,15,18,25,23,15,15,4,146
9,22,18,1,25,0,0,0,0,75
9,22,18,5,19,19,5,0,0,97
9,23,2,5,12,12,19,0,0,82
9,23,2,5,18,18,25,0,0,100
9,23,5,1,18,20,8,0,0,84
9,23,6,12,15,23,5,18,0,111
9,23,9,19,0,0,0,0,0,60
25,23,9,19,0,0,0,0,0,76
9,23,15,18,20,8,0,0,0,93
9,23,15,21,14,4,0,0,0,86
9,23,21,18,3,8,5,0,0,87
9,23,21,18,20,8,5,14,0,118
9,23,23,15,15,4,0,0,0,89
9,23,23,15,18,20,0,0,0,108
9,24,9,1,19,0,0,0,0,62
9,24,15,4,9,1,14,0,0,76
9,24,15,4,9,3,0,0,0,64
9,24,15,4,9,4,0,0,0,65
9,24,15,4,9,4,19,0,0,84
9,24,15,18,1,19,0,0,0,86
9,24,20,12,5,0,0,0,0,70
9,24,20,12,5,19,0,0,0,89
9,26,2,1,0,0,0,0,0,38
9,26,3,8,1,11,0,0,0,58
9,26,5,0,0,0,0,0,0,40
9,26,5,18,0,0,0,0,0,58
9,26,9,14,7,0,0,0,0,65
9,26,12,5,0,0,0,0,0,52
9,26,15,20,5,0,0,0,0,75
9,26,20,12,5,0,0,0,0,72
9,26,21,13,9,0,0,0,0,78
9,26,22,15,26,3,8,9,11,129
9,26,26,1,18,4,0,0,0,84
9,26,26,1,18,4,19,0,0,103
9,26,26,1,20,0,0,0,0,82
10,3,20,0,0,0,0,0,0,33
10,3,20,14,0,0,0,0,0,47
10,5,2,1,20,0,0,0,0,38
10,5,2,5,12,0,0,0,0,34
10,5,2,5,12,19,0,0,0,53
10,5,3,15,18,1,12,0,0,64
10,5,3,15,18,9,14,0,0,74
10,5,3,15,18,9,26,5,0,91
10,5,4,3,15,3,11,0,0,51
10,5,4,4,9,14,7,0,0,53
10,5,4,4,15,3,11,0,0,52
10,5,5,0,0,0,0,0,0,20
10,5,5,4,0,0,0,0,0,24
10,5,5,9,14,7,0,0,0,50
10,5,5,12,0,0,0,0,0,32
10,5,5,16,0,0,0,0,0,36
10,5,5,16,5,4,0,0,0,45
10,5,5,16,5,18,19,0,0,78
10,5,5,16,9,14,7,0,0,66
10,5,5,16,14,5,25,0,0,80
10,5,5,16,14,5,25,19,0,99
10,5,5,18,0,0,0,0,0,38
10,5,5,18,5,4,0,0,0,47
10,5,5,18,5,18,0,0,0,61
10,5,5,18,5,18,19,0,0,80
10,5,5,18,25,0,0,0,0,63
10,5,5,18,9,14,7,0,0,68
10,5,5,18,9,14,7,12,25,105
10,5,5,18,16,18,15,15,6,108
10,5,5,18,19,0,0,0,0,57
10,5,5,19,0,0,0,0,0,39
10,5,5,20,5,5,0,0,0,50
10,5,5,26,0,0,0,0,0,46
10,5,6,0,0,0,0,0,0,21
10,5,6,5,0,0,0,0,0,26
10,5,6,5,19,0,0,0,0,45
10,5,7,0,0,0,0,0,0,22
10,5,8,1,4,0,0,0,0,28
10,5,8,1,4,19,0,0,0,47
10,5,8,21,16,0,0,0,0,60
10,5,8,21,19,0,0,0,0,63
10,5,10,21,14,1,0,0,0,61
10,5,10,21,14,1,12,0,0,73
10,5,10,21,14,1,20,15,18,114
10,5,10,21,14,5,0,0,0,65
10,5,10,21,14,5,12,25,0,102
10,5,10,21,14,9,20,25,0,114
10,5,10,21,14,9,20,9,19,117
10,5,10,21,14,21,13,0,0,94
10,5,10,21,14,21,13,19,0,113
10,5,11,25,12,12,0,0,0,75
10,5,12,1,2,0,0,0,0,30
10,5,12,5,18,1,14,7,0,72
10,5,12,9,2,0,0,0,0,38
10,5,12,9,3,11,0,0,0,50
10,5,12,12,0,0,0,0,0,39
10,5,12,12,1,2,0,0,0,42
10,5,12,12,1,2,1,0,0,43
10,5,12,12,1,2,1,19,0,62
10,5,12,12,5,4,0,0,0,48
10,5,12,12,25,0,0,0,0,64
10,5,12,12,9,2,0,0,0,50
10,5,12,12,25,2,5,1,14,86
10,5,12,12,9,3,1,0,0,52
10,5,12,12,25,4,15,13,0,96
10,5,12,12,9,5,4,0,0,57
10,5,12,12,9,5,19,0,0,72
10,5,12,12,9,6,25,0,0,79
10,5,12,12,9,6,9,5,4,72
10,5,12,12,9,6,9,5,19,87
10,5,12,12,25,6,9,19,8,106
10,5,12,12,25,9,14,7,0,94
10,5,12,12,25,12,5,1,6,88
10,5,12,12,9,12,25,0,0,85
10,5,12,12,25,12,9,11,5,101
10,5,12,12,9,14,7,0,0,69
10,5,12,12,25,18,15,12,12,121
10,5,12,12,15,0,0,0,0,54
10,5,12,12,15,9,4,0,0,67
10,5,12,12,19,0,0,0,0,58
10,5,12,15,20,15,14,7,0,98
10,5,12,19,11,5,0,0,0,62
10,5,12,21,20,15,14,7,0,104
10,5,12,21,20,15,14,7,19,123
10,5,13,1,4,1,18,0,0,52
10,5,13,1,4,1,18,19,0,71
10,5,13,2,5,0,0,0,0,35
10,5,13,2,12,5,0,0,0,47
10,5,13,9,4,1,18,0,0,60
10,5,13,9,4,1,18,19,0,79
10,5,13,13,9,5,4,0,0,59
10,5,13,13,9,5,19,0,0,74
10,5,13,13,25,9,14,7,0,96
10,5,13,13,9,12,25,0,0,87
10,5,13,13,9,14,5,19,19,107
10,5,14,5,17,21,5,14,0,91
10,5,14,11,9,14,0,0,0,63
10,5,14,14,5,18,9,26,5,106
10,5,14,14,5,20,0,0,0,68
10,5,14,14,5,20,9,14,7,98
10,5,14,14,5,20,19,0,0,87
10,5,14,14,9,5,18,0,0,75
10,5,14,14,9,5,19,0,0,76
10,5,14,15,1,18,0,0,0,63
10,5,15,6,1,9,12,0,0,58
10,5,15,14,0,0,0,0,0,44
10,5,15,16,1,18,4,0,0,69
10,5,15,16,1,18,4,5,4,78
10,5,15,16,1,18,4,5,18,92
10,5,15,16,1,18,4,25,0,94
10,5,15,16,1,18,4,19,0,88
10,5,17,21,5,18,9,20,25,130
10,5,17,21,9,18,9,20,25,134
10,5,18,2,9,12,0,0,0,56
10,5,18,2,15,1,0,0,0,51
10,5,18,2,15,1,19,0,0,70
10,5,18,5,5,4,0,0,0,47
10,5,18,5,5,4,19,0,0,66
10,5,18,5,13,9,1,4,0,65
10,5,18,5,13,9,1,4,19,84
10,5,18,6,1,12,3,15,14,84
10,5,18,9,2,0,0,0,0,44
10,5,18,9,3,1,14,0,0,60
10,5,18,9,4,0,0,0,0,46
10,5,18,9,4,19,0,0,0,65
10,5,18,11,0,0,0,0,0,44
10,5,18,11,5,4,0,0,0,53
10,5,18,11,5,18,0,0,0,67
10,5,18,11,5,18,19,0,0,86
10,5,18,11,25,0,0,0,0,69
10,5,18,11,9,5,18,0,0,76
10,5,18,11,9,5,19,0,0,77
10,5,18,11,9,5,19,20,0,97
10,5,18,11,9,12,25,0,0,90
10,5,18,11,9,14,0,0,0,67
10,5,18,11,9,14,5,4,0,76
10,5,18,11,9,14,5,19,19,110
10,5,18,11,9,14,7,0,0,74
10,5,18,11,9,14,7,12,25,111
10,5,18,11,9,14,7,19,0,93
10,5,18,11,9,14,19,0,0,86
10,5,18,11,9,19,8,0,0,80
10,5,18,11,19,0,0,0,0,63
10,5,18,11,19,15,13,5,0,96
10,5,18,11,23,1,20,5,18,111
10,5,18,12,0,0,0,0,0,45
10,5,18,13,0,0,0,0,0,46
10,5,18,13,15,14,1,12,0,88
10,5,18,13,15,15,14,1,12,103
10,5,18,14,9,5,0,0,0,61
10,5,18,15,2,15,1,13,19,98
10,5,18,15,16,9,7,1,0,81
10,5,18,17,21,5,0,0,0,76
10,5,18,17,21,5,4,0,0,80
10,5,18,17,21,5,18,0,0,94
10,5,18,17,21,9,14,7,0,101
10,5,18,18,5,5,4,0,0,65
10,5,18,18,5,5,4,19,0,84
10,5,18,18,9,3,1,14,0,78
10,5,18,18,25,3,1,14,0,94
10,5,18,18,9,3,1,14,19,97
10,5,18,18,25,3,1,14,19,113
10,5,18,18,9,4,0,0,0,64
10,5,18,18,9,4,19,0,0,83
10,5,18,18,25,9,19,13,0,117
10,5,18,19,5,25,5,4,0,91
10,5,18,19,5,25,19,0,0,101
10,5,18,20,0,0,0,0,0,53
10,5,18,22,9,1,0,0,0,65
10,5,18,22,9,14,0,0,0,78
10,5,18,22,9,14,1,0,0,79
10,5,18,22,9,14,5,0,0,83
10,5,19,16,5,18,0,0,0,73
10,5,19,19,1,11,5,5,4,79
10,5,19,19,1,13,25,0,0,92
10,5,19,19,1,13,9,5,19,100
10,5,19,19,1,14,20,0,0,88
10,5,19,19,5,4,0,0,0,62
10,5,19,19,5,19,0,0,0,77
10,5,19,19,9,14,7,0,0,83
10,5,19,19,21,18,0,0,0,92
10,5,19,20,0,0,0,0,0,54
10,5,19,20,2,15,15,11,0,97
10,5,19,20,5,4,0,0,0,63
10,5,19,20,5,5,0,0,0,64
10,5,19,20,5,18,0,0,0,77
10,5,19,20,5,18,19,0,0,96
10,5,19,20,6,21,12,0,0,93
10,5,19,20,9,14,7,0,0,84
10,5,19,20,9,14,7,12,25,121
10,5,19,20,9,14,7,19,0,103
10,5,19,20,16,18,15,15,6,124
10,5,19,20,19,0,0,0,0,73
10,5,19,20,23,9,19,5,0,110
10,5,19,20,23,15,18,4,0,114
10,5,19,21,9,19,20,0,0,103
10,5,19,21,9,20,19,0,0,103
10,5,20,1,22,1,20,15,18,112
10,5,20,2,5,1,4,0,0,47
10,5,20,2,5,1,4,19,0,66
10,5,20,5,0,0,0,0,0,40
10,5,20,5,19,0,0,0,0,59
10,5,20,12,9,14,5,18,0,93
10,5,20,12,9,14,5,18,19,112
10,5,20,15,14,0,0,0,0,64
10,5,20,15,14,19,0,0,0,83
10,5,20,16,15,18,20,0,0,104
10,5,20,16,15,18,20,19,0,123
10,5,20,19,0,0,0,0,0,54
10,5,20,19,1,13,0,0,0,68
10,5,20,19,1,13,19,0,0,87
10,5,20,19,15,13,0,0,0,82
10,5,20,19,15,13,19,0,0,101
10,5,20,19,20,18,5,1,13,111
10,5,20,20,1,7,5,0,0,68
10,5,20,20,1,20,15,18,5,114
10,5,20,20,1,20,21,18,1,116
10,5,20,20,5,1,21,0,0,82
10,5,20,20,5,4,0,0,0,64
10,5,20,20,5,18,0,0,0,78
10,5,20,20,25,0,0,0,0,80
10,5,20,20,9,5,4,0,0,73
10,5,20,20,9,5,18,0,0,87
10,5,20,20,9,5,19,0,0,88
10,5,20,20,9,5,19,20,0,108
10,5,20,20,25,8,5,1,4,98
10,5,20,20,25,9,14,7,0,110
10,5,20,20,9,14,5,19,19,121
10,5,20,20,9,14,7,0,0,85
10,5,20,20,9,14,7,12,25,122
10,5,20,20,9,19,15,14,0,112
10,5,20,20,9,19,15,14,19,131
10,5,20,20,25,23,9,19,5,136
10,5,20,20,15,14,0,0,0,84
10,5,20,20,15,14,19,0,0,103
10,5,20,20,18,21,0,0,0,94
10,5,20,23,1,18,5,0,0,82
10,5,21,24,0,0,0,0,0,60
10,5,23,2,9,18,4,0,0,71
10,5,23,2,21,19,8,0,0,88
10,5,23,5,4,0,0,0,0,47
10,5,23,5,12,5,4,0,0,64
10,5,23,5,12,5,18,0,0,78
10,5,23,5,12,5,18,19,0,97
10,5,23,5,12,6,9,19,8,97
10,5,23,5,12,25,0,0,0,80
10,5,23,5,12,9,14,7,0,85
10,5,23,5,12,12,5,4,0,76
10,5,23,5,12,12,5,18,0,90
10,5,23,5,12,12,5,18,25,115
10,5,23,5,12,12,5,18,19,109
10,5,23,5,12,12,5,19,19,110
10,5,23,5,12,12,25,0,0,92
10,5,23,5,12,12,9,11,5,92
10,5,23,5,12,12,9,14,7,97
10,5,23,5,12,18,25,0,0,98
10,5,23,5,12,18,9,5,19,106
10,5,23,5,12,19,0,0,0,74
10,5,23,5,12,23,5,5,4,92
10,5,23,6,9,19,8,0,0,80
10,5,23,6,9,19,8,5,19,104
10,5,23,9,14,7,0,0,0,68
10,5,23,9,19,0,0,0,0,66
10,5,26,1,9,12,0,0,0,63
10,5,26,1,9,12,19,0,0,82
10,5,26,5,2,5,12,19,0,84
10,5,26,5,11,9,20,5,0,91
10,5,26,9,1,8,0,0,0,59
10,8,5,5,12,0,0,0,0,40
10,8,15,15,12,0,0,0,0,60
10,8,15,23,0,0,0,0,0,56
10,9,2,0,0,0,0,0,0,21
10,9,2,2,0,0,0,0,0,23
10,9,2,2,1,0,0,0,0,24
10,9,2,2,1,8,0,0,0,32
10,9,2,2,5,4,0,0,0,32
10,9,2,2,5,8,0,0,0,36
10,9,2,2,5,18,0,0,0,46
10,9,2,2,5,18,19,0,0,65
10,9,2,2,25,0,0,0,0,48
10,9,2,2,9,14,7,0,0,53
10,9,2,2,9,14,7,19,0,72
10,9,2,2,15,14,19,0,0,71
10,9,2,2,15,15,13,0,0,66
10,9,2,2,15,15,13,19,0,85
10,9,2,2,19,0,0,0,0,42
10,9,2,5,0,0,0,0,0,26
10,9,2,5,4,0,0,0,0,30
10,9,2,5,18,0,0,0,0,44
10,9,2,5,18,19,0,0,0,63
10,9,2,5,19,0,0,0,0,45
10,9,2,8,5,1,4,0,0,39
10,9,2,9,0,0,0,0,0,30
10,9,2,9,14,7,0,0,0,51
10,9,2,9,14,7,12,25,0,88
10,9,2,13,1,14,0,0,0,49
10,9,2,13,5,14,0,0,0,53
10,9,2,15,1,0,0,0,0,37
10,9,2,15,25,1,0,0,0,62
10,9,2,19,0,0,0,0,0,40
10,9,2,19,20,1,25,0,0,86
10,9,3,1,13,1,0,0,0,37
10,9,3,1,13,1,19,0,0,56
10,9,3,1,18,1,0,0,0,42
10,9,6,6,0,0,0,0,0,31
10,9,6,6,25,0,0,0,0,56
10,9,6,6,9,5,19,0,0,64
10,9,6,6,12,5,0,0,0,48
10,9,6,6,19,0,0,0,0,50
10,9,7,0,0,0,0,0,0,26
10,9,7,1,2,15,15,0,0,59
10,9,7,1,2,15,15,19,0,78
10,9,7,1,13,1,18,5,5,69
10,9,7,7,5,4,0,0,0,42
10,9,7,7,5,18,5,4,0,65
10,9,7,7,5,18,5,18,0,79
10,9,7,7,5,18,13,1,14,84
10,9,7,7,5,18,19,0,0,75
10,9,7,7,5,20,0,0,0,58
10,9,7,7,5,20,25,0,0,83
10,9,7,7,25,0,0,0,0,58
10,9,7,7,9,14,5,19,19,99
10,9,7,7,9,14,7,0,0,63
10,9,7,7,9,19,8,0,0,69
10,9,7,7,9,20,0,0,0,62
10,9,7,7,12,5,0,0,0,50
10,9,7,7,12,5,4,0,0,54
10,9,7,7,12,5,18,0,0,68
10,9,7,7,12,5,19,0,0,69
10,9,7,7,12,25,0,0,0,70
10,9,7,7,12,9,5,18,0,77
10,9,7,7,12,9,5,19,20,98
10,9,7,7,12,9,14,7,0,75
10,9,7,7,21,13,2,15,2,86
10,9,7,12,9,11,5,0,0,63
10,9,7,13,1,14,0,0,0,54
10,9,7,13,5,14,0,0,0,58
10,9,7,15,20,5,0,0,0,66
10,9,7,19,0,0,0,0,0,45
10,9,7,19,1,23,0,0,0,69
10,9,7,19,1,23,5,4,0,78
10,9,7,19,1,23,9,14,7,99
10,9,7,19,1,23,14,0,0,83
10,9,7,19,1,23,19,0,0,88
10,9,8,1,4,0,0,0,0,32
10,9,8,1,4,19,0,0,0,51
10,9,11,21,14,7,21,0,0,93
10,9,12,12,1,18,15,15,0,92
10,9,12,12,5,20,0,0,0,68
10,9,12,12,6,12,9,18,20,108
10,9,12,12,9,14,7,0,0,73
10,9,12,12,9,15,14,0,0,81
10,9,12,12,9,15,14,19,0,100
10,9,12,12,19,0,0,0,0,62
10,9,12,20,0,0,0,0,0,51
10,9,12,20,5,4,0,0,0,60
10,9,12,20,5,5,0,0,0,61
10,9,12,20,5,18,0,0,0,74
10,9,12,20,5,18,19,0,0,93
10,9,12,20,9,14,7,0,0,81
10,9,12,20,9,19,8,0,0,87
10,9,12,20,19,0,0,0,0,70
10,9,13,2,1,14,7,0,0,56
10,9,13,2,5,18,10,1,23,91
10,9,13,2,15,0,0,0,0,49
10,9,13,3,18,1,3,11,0,68
10,9,13,9,7,1,11,9,0,69
10,9,13,9,14,25,0,0,0,80
10,9,13,10,1,13,0,0,0,56
10,9,13,10,1,13,19,0,0,75
10,9,13,10,21,13,19,0,0,95
10,9,13,13,5,18,0,0,0,68
10,9,13,13,9,5,4,0,0,63
10,9,13,13,9,5,19,0,0,78
10,9,13,13,25,9,14,7,0,100
10,9,13,13,9,14,25,0,0,93
10,9,13,13,25,23,5,5,4,107
10,25,13,15,12,4,0,0,0,79
10,9,13,16,0,0,0,0,0,48
10,9,13,16,5,18,0,0,0,71
10,9,13,16,5,19,20,0,0,92
10,9,13,16,25,0,0,0,0,73
10,9,13,16,12,25,0,0,0,85
10,9,13,16,14,5,19,19,0,105
10,9,13,19,5,4,7,5,0,72
10,9,13,19,15,14,0,0,0,80
10,9,14,0,0,0,0,0,0,33
10,9,14,1,0,0,0,0,0,34
10,9,14,3,1,13,1,19,0,70
10,9,14,3,8,1,15,0,0,60
10,9,14,5,20,5,0,0,0,63
10,9,14,7,0,0,0,0,0,40
10,9,14,7,1,12,0,0,0,53
10,9,14,7,1,12,12,0,0,65
10,9,14,7,1,12,12,19,0,84
10,9,14,7,1,12,19,0,0,72
10,9,14,7,2,1,9,0,0,52
10,9,14,7,2,1,14,7,0,64
10,25,14,7,9,14,5,0,0,84
10,9,14,7,11,15,0,0,0,66
10,9,14,7,11,15,5,19,0,90
10,9,14,7,12,5,0,0,0,57
10,9,14,7,12,5,2,15,2,76
10,9,14,7,12,5,4,0,0,61
10,9,14,7,12,5,18,0,0,75
10,9,14,7,12,5,18,19,0,94
10,9,14,7,12,5,19,0,0,76
10,9,14,7,12,5,20,0,0,77
10,9,14,7,12,25,0,0,0,77
10,9,14,7,12,9,5,18,0,84
10,9,14,7,12,9,5,19,20,105
10,9,14,7,12,9,14,7,0,82
10,9,14,7,15,0,0,0,0,55
10,9,14,7,15,4,15,13,0,87
10,9,14,7,15,5,4,0,0,64
10,9,14,7,15,5,19,0,0,79
10,9,14,7,15,9,14,7,0,85
10,9,14,7,15,9,19,8,0,91
10,9,14,7,15,9,19,13,0,96
10,9,14,7,15,9,19,13,19,115
10,9,14,7,15,9,19,20,0,103
10,9,14,7,15,9,19,20,19,122
10,9,14,7,21,0,0,0,0,61
10,9,14,10,9,12,9,0,0,73
10,9,14,11,0,0,0,0,0,44
10,9,14,11,5,4,0,0,0,53
10,9,14,11,5,18,0,0,0,67
10,9,14,11,5,18,19,0,0,86
10,9,14,11,5,20,0,0,0,69
10,9,14,11,9,14,7,0,0,74
10,9,14,11,12,5,0,0,0,61
10,9,14,11,19,0,0,0,0,63
10,9,14,14,0,0,0,0,0,47
10,9,14,14,5,5,0,0,0,57
10,9,14,14,5,19,20,1,14,106
10,9,14,14,9,0,0,0,0,56
10,9,14,14,9,5,19,0,0,80
10,9,14,14,9,25,5,8,0,94
10,9,14,14,9,23,9,14,11,113
10,9,14,14,25,23,9,14,11,129
10,9,14,14,19,0,0,0,0,66
10,9,14,18,9,11,9,0,0,80
10,9,14,18,9,11,19,8,1,99
10,9,14,19,0,0,0,0,0,52
10,9,14,19,8,1,0,0,0,61
10,9,14,19,8,1,14,7,0,82
10,9,14,19,9,14,7,0,0,82
10,9,14,24,5,4,0,0,0,66
10,9,14,24,5,19,0,0,0,81
10,9,14,24,9,14,7,0,0,87
10,9,16,9,10,1,16,1,0,72
10,9,16,9,10,1,16,1,19,91
10,9,16,16,5,18,0,0,0,74
10,9,17,21,9,0,0,0,0,66
10,9,18,2,12,5,0,0,0,56
10,9,18,7,1,0,0,0,0,45
10,9,18,7,1,8,0,0,0,53
10,9,18,9,0,0,0,0,0,46
10,9,18,11,9,14,5,20,0,96
10,9,19,8,5,14,7,0,0,72
10,9,19,13,0,0,0,0,0,51
10,9,19,13,19,0,0,0,0,70
10,9,19,19,15,13,0,0,0,85
10,9,20,5,14,4,18,1,0,81
10,9,20,9,0,0,0,0,0,48
10,9,20,14,5,25,0,0,0,83
10,9,20,14,5,25,5,4,0,92
10,9,20,14,5,25,9,14,7,113
10,9,20,14,5,25,13,1,14,111
10,9,20,14,5,25,19,0,0,102
10,9,20,14,5,21,18,0,0,97
10,9,20,14,5,21,19,5,0,103
10,9,20,18,15,0,0,0,0,72
10,9,20,20,5,18,0,0,0,82
10,9,20,20,5,18,2,21,7,112
10,9,20,20,5,18,5,4,0,91
10,9,20,20,5,18,25,0,0,107
10,9,20,20,5,18,9,14,7,112
10,9,20,20,5,18,19,0,0,101
10,9,21,10,9,20,19,21,0,119
10,9,21,10,9,20,19,21,19,138
10,9,21,10,21,20,19,21,0,131
10,9,21,10,21,20,19,21,19,150
10,9,22,1,0,0,0,0,0,42
10,9,22,1,20,13,1,0,0,76
10,9,22,5,0,0,0,0,0,46
10,9,22,5,1,19,19,0,0,85
10,9,22,5,4,0,0,0,0,50
10,9,22,5,18,0,0,0,0,64
10,9,22,5,18,19,0,0,0,83
10,9,22,5,19,0,0,0,0,65
10,9,22,9,14,7,0,0,0,71
10,9,24,9,5,0,0,0,0,57
10,9,26,25,1,0,0,0,0,71
10,9,26,25,1,8,0,0,0,79
10,9,26,26,5,14,0,0,0,90
10,14,4,0,0,0,0,0,0,28
10,14,20,0,0,0,0,0,0,44
10,15,2,1,4,5,0,0,0,37
10,15,2,1,18,2,5,0,0,53
10,15,2,1,20,9,15,14,0,86
10,15,2,2,5,4,0,0,0,38
10,15,2,2,5,18,0,0,0,52
10,15,2,2,5,18,25,0,0,77
10,15,2,2,5,18,9,5,19,85
10,15,2,2,5,18,19,0,0,71
10,15,2,2,5,20,0,0,0,54
10,15,2,2,9,14,7,0,0,59
10,15,2,2,9,19,8,0,0,65
10,15,2,2,12,5,0,0,0,46
10,15,2,8,15,12,4,5,18,89
10,15,2,12,5,19,19,0,0,82
10,15,2,12,15,20,19,0,0,93
10,15,2,13,1,14,0,0,0,55
10,15,2,13,1,19,20,5,18,103
10,15,2,13,5,14,0,0,0,59
10,15,2,13,15,14,7,5,18,99
10,15,2,14,1,13,5,0,0,60
10,15,2,14,1,13,5,19,0,79
10,15,2,15,0,0,0,0,0,42
10,15,2,19,0,0,0,0,0,46
10,15,2,19,9,20,5,0,0,80
10,15,2,19,13,9,20,8,0,96
10,15,2,19,15,14,0,0,0,75
10,15,3,1,14,20,0,0,0,63
10,15,3,1,20,15,18,25,0,107
10,15,3,8,0,0,0,0,0,36
10,15,3,8,5,14,0,0,0,55
10,15,3,11,5,25,0,0,0,69
10,15,3,11,5,25,4,15,13,101
10,15,3,11,5,25,5,4,0,78
10,15,3,11,5,25,9,14,7,99
10,15,3,11,5,25,9,19,8,105
10,15,3,11,5,25,9,19,13,110
10,15,3,11,5,25,19,0,0,88
10,15,3,11,5,18,0,0,0,62
10,15,3,11,5,20,20,5,0,89
10,15,3,11,5,20,20,5,19,108
10,15,3,11,15,19,0,0,0,73
10,15,3,11,19,0,0,0,0,58
10,15,3,11,19,20,18,1,16,113
10,15,3,11,20,5,12,5,7,88
10,15,3,15,17,21,5,0,0,86
10,15,3,15,17,21,9,0,0,90
10,15,3,15,19,5,0,0,0,67
10,15,3,15,19,5,12,25,0,104
10,15,3,15,19,9,20,25,0,116
10,15,3,15,20,5,0,0,0,68
10,15,3,20,5,12,5,7,0,77
10,15,3,21,0,0,0,0,0,49
10,15,3,21,12,1,18,0,0,80
10,15,3,21,12,1,18,12,25,117
10,15,3,21,12,1,20,15,18,115
10,15,3,21,13,0,0,0,0,62
10,15,3,21,13,1,0,0,0,63
10,15,3,21,14,4,0,0,0,67
10,15,3,21,14,4,9,20,25,121
10,15,3,21,14,4,12,25,0,104
10,15,3,21,14,4,18,25,0,110
10,15,3,21,14,15,0,0,0,78
10,15,3,21,14,15,9,20,25,132
10,15,4,5,12,0,0,0,0,46
10,15,4,5,12,18,0,0,0,64
10,15,5,2,21,19,8,0,0,80
10,15,5,25,5,19,0,0,0,79
10,15,5,23,15,15,4,0,0,87
10,15,7,0,0,0,0,0,0,32
10,15,7,7,5,4,0,0,0,48
10,15,7,7,5,18,0,0,0,62
10,15,7,7,5,18,19,0,0,81
10,15,7,7,9,14,7,0,0,69
10,15,7,7,9,14,7,19,0,88
10,15,7,7,12,5,0,0,0,56
10,15,7,7,12,5,4,0,0,60
10,15,7,7,12,5,18,0,0,74
10,15,7,7,12,5,18,19,0,93
10,15,7,7,12,5,19,0,0,75
10,15,7,7,12,5,20,25,0,101
10,15,7,7,12,25,0,0,0,76
10,15,7,7,12,9,14,7,0,81
10,15,7,19,0,0,0,0,0,51
10,15,7,20,18,15,20,0,0,105
10,15,8,14,2,15,1,20,0,85
10,15,8,14,2,15,1,20,19,104
10,15,8,14,9,14,0,0,0,70
10,15,8,14,14,25,4,15,13,118
10,15,25,1,14,3,5,19,0,92
10,15,25,1,14,3,25,0,0,93
10,15,25,1,14,20,0,0,0,85
10,15,9,5,0,0,0,0,0,39
10,15,25,5,4,0,0,0,0,59
10,15,25,6,21,12,0,0,0,89
10,15,25,6,21,12,12,5,18,124
10,15,25,6,21,12,12,25,0,126
10,15,25,8,15,16,0,0,0,89
10,15,25,8,15,21,19,5,0,118
10,15,25,9,14,7,0,0,0,80
10,15,25,12,5,1,6,0,0,74
10,15,25,12,5,19,19,0,0,105
10,15,25,12,5,19,19,12,25,142
10,15,25,12,5,20,0,0,0,87
10,15,9,14,0,0,0,0,0,48
10,15,9,14,1,2,12,5,0,68
10,15,9,14,1,14,20,0,0,83
10,15,9,14,4,5,18,0,0,75
10,15,9,14,4,5,18,19,0,94
10,15,9,14,5,4,0,0,0,57
10,15,9,14,5,18,5,4,0,80
10,15,9,14,5,18,25,0,0,96
10,15,9,14,5,18,9,5,19,104
10,15,9,14,5,18,9,14,7,101
10,15,9,14,5,18,19,0,0,90
10,15,9,14,8,1,14,4,0,75
10,15,9,14,9,14,7,0,0,78
10,15,9,14,9,14,7,12,25,115
10,15,9,14,9,14,7,19,0,97
10,15,9,14,19,0,0,0,0,67
10,15,9,14,20,0,0,0,0,68
10,15,9,14,20,1,7,5,0,81
10,15,9,14,20,5,4,0,0,77
10,15,9,14,20,5,4,12,25,114
10,15,9,14,20,5,18,0,0,91
10,15,9,14,20,5,18,19,0,110
10,15,9,14,20,25,0,0,0,93
10,15,9,14,20,9,14,7,0,98
10,15,9,14,20,9,19,20,0,116
10,15,9,14,20,12,5,19,19,123
10,15,9,14,20,12,25,0,0,105
10,15,9,14,20,18,5,19,19,129
10,15,9,14,20,19,0,0,0,87
10,15,9,14,20,21,18,5,0,112
10,15,9,14,20,21,18,5,4,116
10,15,9,14,20,21,18,5,19,131
10,15,9,14,20,23,5,5,4,105
10,15,9,14,20,23,15,15,4,125
10,15,9,14,20,23,15,18,13,137
10,15,25,15,21,19,12,25,0,142
10,15,25,16,15,16,0,0,0,97
10,15,25,16,15,16,16,5,4,122
10,15,25,16,15,16,16,5,18,136
10,15,25,16,15,16,19,0,0,116
10,15,25,16,18,15,15,6,0,120
10,15,25,18,9,4,4,5,14,104
10,15,25,18,9,4,5,0,0,86
10,15,25,18,9,4,5,18,0,104
10,15,25,18,9,4,5,18,19,123
10,15,25,18,9,4,5,19,0,105
10,15,25,18,9,4,9,14,7,111
10,15,25,18,15,4,5,0,0,92
10,15,25,19,0,0,0,0,0,69
10,15,25,19,15,13,5,0,0,102
10,15,9,19,20,0,0,0,0,73
10,15,9,19,20,5,4,0,0,82
10,15,25,19,20,9,3,11,0,112
10,15,25,19,20,9,3,11,19,131
10,15,9,19,20,9,14,7,0,103
10,15,9,19,20,12,5,19,19,128
10,15,9,19,20,19,0,0,0,92
10,15,25,23,5,5,4,0,0,87
10,15,10,15,2,1,0,0,0,53
10,15,10,15,2,1,19,0,0,72
10,15,11,5,0,0,0,0,0,41
10,15,11,5,2,15,15,11,0,84
10,15,11,5,4,0,0,0,0,45
10,15,11,5,25,0,0,0,0,66
10,15,11,5,12,5,19,19,0,96
10,15,11,5,12,5,20,0,0,78
10,15,11,5,16,18,15,15,6,111
10,15,11,5,18,0,0,0,0,59
10,15,11,5,18,19,0,0,0,78
10,15,11,5,19,0,0,0,0,60
10,15,11,5,19,13,9,20,8,110
10,15,11,5,19,15,13,5,0,93
10,15,11,5,19,20,5,18,0,103
10,15,11,5,19,20,5,18,19,122
10,15,11,25,0,0,0,0,0,61
10,15,11,9,5,18,0,0,0,68
10,15,11,9,5,19,20,0,0,89
10,15,11,9,14,7,0,0,0,66
10,15,11,9,14,7,12,25,0,103
10,15,11,9,19,8,0,0,0,72
10,15,11,9,19,20,0,0,0,84
10,15,11,20,1,12,5,7,0,81
10,15,11,21,12,0,0,0,0,69
10,15,12,5,0,0,0,0,0,42
10,15,12,5,19,0,0,0,0,61
10,15,12,12,0,0,0,0,0,49
10,15,12,12,5,25,13,1,14,107
10,15,12,12,25,0,0,0,0,74
10,15,12,12,9,5,4,0,0,67
10,15,12,12,9,5,18,0,0,81
10,15,12,12,25,5,18,0,0,97
10,15,12,12,9,5,19,0,0,82
10,15,12,12,9,5,19,20,0,102
10,15,12,12,9,6,25,0,0,89
10,15,12,12,9,6,9,5,4,82
10,15,12,12,9,6,9,5,19,97
10,15,12,12,25,8,5,1,4,92
10,15,12,12,25,9,14,7,0,104
10,15,12,12,9,12,25,0,0,95
10,15,12,12,9,13,5,14,20,110
10,15,12,12,9,14,5,19,19,115
10,15,12,12,25,20,1,9,12,116
10,15,12,12,9,20,25,0,0,103
10,15,12,12,9,20,9,5,19,111
10,15,12,12,9,20,18,25,0,121
10,15,12,12,15,16,0,0,0,80
10,15,12,12,15,16,5,4,0,89
10,15,12,20,0,0,0,0,0,57
10,15,12,20,5,4,0,0,0,66
10,15,12,20,5,18,0,0,0,80
10,15,12,20,5,18,19,0,0,99
10,15,12,20,8,5,1,4,0,75
10,15,12,20,25,0,0,0,0,82
10,15,12,20,9,5,18,0,0,89
10,15,12,20,9,5,19,20,0,110
10,15,12,20,9,12,25,0,0,103
10,15,12,20,9,14,5,19,19,123
10,15,12,20,9,14,7,0,0,87
10,15,12,20,9,14,7,12,25,124
10,15,12,20,12,5,19,19,0,112
10,15,12,20,16,18,15,15,6,127
10,15,12,20,19,0,0,0,0,76
10,15,13,15,14,0,0,0,0,67
10,15,14,1,8,19,0,0,0,67
10,15,14,4,12,1,0,0,0,56
10,15,14,7,0,0,0,0,0,46
10,15,14,7,12,5,13,0,0,76
10,15,14,7,12,5,18,25,0,106
10,15,14,7,12,5,21,18,0,102
10,15,14,7,12,5,21,18,19,121
10,15,14,14,9,3,11,0,0,76
10,15,14,14,15,3,11,0,0,82
10,15,14,17,21,5,0,0,0,82
10,15,14,17,21,9,12,12,5,115
10,15,14,17,21,9,12,19,0,117
10,15,14,22,1,12,9,26,5,114
10,15,15,11,0,0,0,0,0,51
10,15,15,11,5,18,9,5,0,88
10,15,15,12,1,0,0,0,0,53
10,15,15,13,0,0,0,0,0,53
10,15,18,1,13,0,0,0,0,57
10,15,18,1,13,19,0,0,0,76
10,15,18,4,1,14,9,20,5,96
10,15,18,4,1,14,15,14,0,91
10,15,18,4,5,14,0,0,0,66
10,15,18,5,5,0,0,0,0,53
10,15,18,14,1,4,1,0,0,63
10,15,18,14,1,4,1,19,0,82
10,15,18,15,16,15,0,0,0,89
10,15,18,15,16,15,19,0,0,108
10,15,18,18,1,13,0,0,0,75
10,15,18,21,13,0,0,0,0,77
10,15,18,21,13,19,0,0,0,96
10,15,19,5,6,9,20,5,0,89
10,15,19,5,9,20,5,0,0,83
10,15,19,5,16,8,19,0,0,92
10,15,19,8,5,4,0,0,0,61
10,15,19,8,5,18,0,0,0,75
10,15,19,8,5,18,19,0,0,94
10,15,19,8,5,19,0,0,0,76
10,15,19,8,9,14,7,0,0,82
10,15,19,11,9,14,0,0,0,78
10,15,19,19,0,0,0,0,0,63
10,15,19,19,1,11,5,5,4,89
10,15,19,19,5,18,0,0,0,86
10,15,19,19,5,19,0,0,0,87
10,15,19,20,12,5,0,0,0,81
10,15,19,20,12,5,4,0,0,85
10,15,19,20,12,5,18,0,0,99
10,15,19,20,12,5,18,19,0,118
10,15,19,20,12,5,19,0,0,100
10,15,19,20,12,9,14,7,0,106
10,15,20,0,0,0,0,0,0,45
10,15,20,1,0,0,0,0,0,46
10,15,20,1,19,0,0,0,0,65
10,15,20,1,20,9,15,14,0,104
10,15,20,9,19,1,18,21,0,113
10,15,20,9,19,9,0,0,0,82
10,15,20,19,0,0,0,0,0,64
10,15,20,20,5,4,0,0,0,74
10,15,20,20,5,18,0,0,0,88
10,15,20,20,5,18,19,0,0,107
10,15,20,20,25,0,0,0,0,90
10,15,20,20,9,14,7,0,0,95
10,15,20,20,9,14,7,19,0,114
10,15,21,1,12,0,0,0,0,59
10,15,21,1,12,19,0,0,0,78
10,15,21,2,1,18,2,0,0,69
10,15,21,7,0,0,0,0,0,53
10,15,21,7,8,0,0,0,0,61
10,15,21,7,19,0,0,0,0,72
10,15,21,9,19,1,14,3,5,97
10,15,21,11,0,0,0,0,0,57
10,15,21,11,5,4,0,0,0,66
10,15,21,11,5,18,25,0,0,105
10,15,21,11,9,14,7,0,0,87
10,15,21,11,19,0,0,0,0,76
10,15,21,12,0,0,0,0,0,58
10,15,21,12,5,1,14,0,0,78
10,15,21,12,5,19,0,0,0,82
10,15,21,14,3,5,0,0,0,68
10,15,21,14,3,5,4,0,0,72
10,15,21,14,3,5,19,0,0,87
10,15,21,14,3,25,0,0,0,88
10,15,21,14,3,9,5,18,0,95
10,15,21,14,3,9,5,19,20,116
10,15,21,14,3,9,14,7,0,93
10,15,21,18,0,0,0,0,0,64
10,15,21,18,14,0,0,0,0,78
10,15,21,18,14,1,12,0,0,91
10,15,21,18,14,1,12,5,4,100
10,15,21,18,14,1,12,19,0,110
10,15,21,18,14,5,25,0,0,108
10,15,21,18,14,5,25,5,4,117
10,15,21,18,14,5,25,5,18,131
10,15,21,18,14,5,25,19,0,127
10,15,21,18,14,15,0,0,0,93
10,15,21,18,19,0,0,0,0,83
10,15,21,19,20,0,0,0,0,85
10,15,21,19,20,5,4,0,0,94
10,15,21,19,20,5,18,0,0,108
10,15,21,19,20,5,18,19,0,127
10,15,21,19,20,9,14,7,0,115
10,15,21,19,20,19,0,0,0,104
10,15,21,20,5,19,0,0,0,90
10,15,22,25,0,0,0,0,0,72
10,15,22,9,1,12,9,19,20,117
10,15,22,9,1,12,9,20,25,123
10,15,22,9,1,12,9,26,5,109
10,15,22,9,1,12,12,25,0,106
10,15,22,9,1,12,20,25,0,114
10,15,22,9,12,1,2,5,0,76
10,15,23,0,0,0,0,0,0,48
10,15,23,1,18,0,0,0,0,67
10,15,23,1,18,9,0,0,0,76
10,15,23,1,18,19,0,0,0,86
10,15,23,5,4,0,0,0,0,57
10,15,23,5,12,0,0,0,0,65
10,15,23,5,18,0,0,0,0,71
10,15,23,5,18,25,0,0,0,96
10,15,23,9,14,7,0,0,0,78
10,15,23,12,0,0,0,0,0,60
10,15,23,12,5,4,0,0,0,69
10,15,23,12,5,18,0,0,0,83
10,15,23,12,25,0,0,0,0,85
10,15,23,12,9,5,18,0,0,92
10,15,23,12,9,5,19,20,0,113
10,15,23,12,9,19,8,0,0,96
10,15,23,12,15,16,0,0,0,91
10,15,23,12,19,0,0,0,0,79
10,15,23,16,25,0,0,0,0,89
10,15,23,19,0,0,0,0,0,67
10,15,23,19,5,18,0,0,0,90
10,15,23,20,5,18,0,0,0,91
10,21,2,1,18,2,0,0,0,54
10,21,2,1,18,4,25,0,0,81
10,21,2,1,18,20,1,19,0,92
10,21,2,1,18,20,5,19,0,96
10,21,2,1,19,0,0,0,0,53
10,21,2,1,20,5,0,0,0,59
10,21,2,2,1,8,0,0,0,44
10,21,2,2,1,8,19,0,0,63
10,21,2,2,5,0,0,0,0,40
10,21,2,5,0,0,0,0,0,38
10,21,2,5,18,15,21,19,0,111
10,21,2,5,19,0,0,0,0,57
10,21,2,8,1,8,0,0,0,50
10,21,2,8,1,8,19,0,0,69
10,21,2,9,12,1,14,3,5,77
10,21,2,9,12,1,14,3,25,97
10,21,2,9,12,1,14,20,0,89
10,21,2,9,12,1,18,0,0,73
10,21,2,9,12,1,20,5,4,84
10,21,2,9,12,1,20,5,19,99
10,21,2,9,12,1,20,9,15,99
10,21,2,9,12,5,1,12,0,72
10,21,2,9,12,5,1,14,0,74
10,21,2,9,12,5,5,0,0,64
10,21,2,9,12,5,5,19,0,83
10,21,2,9,12,5,19,0,0,78
10,21,2,9,12,9,0,0,0,63
10,21,2,9,12,9,19,20,0,102
10,21,2,9,12,9,26,5,0,94
10,21,2,9,12,21,19,0,0,94
10,21,2,21,19,0,0,0,0,73
10,21,3,8,1,18,20,0,0,81
10,21,3,11,0,0,0,0,0,45
10,21,3,11,9,5,19,0,0,78
10,21,3,21,14,4,9,20,25,127
10,21,4,1,9,19,5,18,0,87
10,21,4,1,19,5,19,0,0,79
10,21,4,3,15,3,11,0,0,67
10,21,4,4,5,18,0,0,0,62
10,21,4,4,5,18,5,4,0,71
10,21,4,4,5,18,9,14,7,92
10,21,4,4,5,18,19,0,0,81
10,21,4,4,15,3,11,0,0,68
10,21,4,5,24,0,0,0,0,64
10,21,4,7,5,1,2,12,5,67
10,21,4,7,5,4,0,0,0,51
10,21,4,7,5,12,5,19,19,102
10,21,4,7,5,12,9,11,5,84
10,21,4,7,5,13,5,14,20,99
10,21,4,7,5,18,0,0,0,65
10,21,4,7,5,18,19,0,0,84
10,21,4,7,5,19,8,9,16,99
10,21,4,7,9,14,7,0,0,72
10,21,4,7,9,14,7,12,25,109
10,21,4,7,13,1,20,9,3,88
10,21,4,7,13,5,14,20,19,113
10,21,4,7,13,5,20,9,3,92
10,21,4,7,19,8,9,16,0,94
10,21,4,9,3,1,2,12,5,67
10,21,4,9,3,1,12,0,0,60
10,21,4,9,3,1,20,1,0,69
10,21,4,9,3,1,20,5,0,73
10,21,4,9,3,1,20,9,15,92
10,21,4,9,3,1,20,15,18,101
10,21,4,9,3,5,0,0,0,52
10,21,4,9,3,5,19,0,0,71
10,21,4,9,3,9,1,0,0,57
10,21,4,9,3,9,1,12,0,69
10,21,4,9,3,9,15,21,19,111
10,21,4,9,3,9,21,13,0,90
10,21,4,15,0,0,0,0,0,50
10,21,4,15,7,9,0,0,0,66
10,21,4,15,9,19,20,0,0,98
10,21,4,15,9,19,20,19,0,117
10,21,4,15,11,1,0,0,0,62
10,21,4,15,11,1,19,0,0,81
10,21,4,15,19,0,0,0,0,69
10,21,5,3,5,19,0,0,0,63
10,21,5,18,7,5,14,0,0,80
10,21,6,6,5,18,0,0,0,66
10,21,6,20,9,0,0,0,0,66
10,21,6,20,19,0,0,0,0,76
10,21,7,0,0,0,0,0,0,38
10,21,7,1,12,0,0,0,0,51
10,21,7,1,12,5,0,0,0,56
10,21,7,1,20,5,0,0,0,64
10,21,7,1,20,5,4,0,0,68
10,21,7,1,20,9,15,14,0,97
10,21,7,5,18,0,0,0,0,61
10,21,7,5,18,21,13,0,0,95
10,21,7,6,21,12,0,0,0,77
10,21,7,6,21,12,19,0,0,96
10,21,7,7,5,4,0,0,0,54
10,21,7,7,5,18,0,0,0,68
10,21,7,7,9,14,7,0,0,75
10,21,7,7,9,14,19,0,0,87
10,21,7,7,9,14,19,5,19,111
10,21,7,7,12,5,0,0,0,62
10,21,7,7,12,5,4,0,0,66
10,21,7,7,12,5,18,0,0,80
10,21,7,7,12,5,18,25,0,105
10,21,7,7,12,5,18,19,0,99
10,21,7,7,12,5,19,0,0,81
10,21,7,7,12,9,14,7,0,87
10,21,7,7,12,9,14,7,19,106
10,21,7,8,5,1,4,0,0,56
10,21,7,8,5,1,4,19,0,75
10,21,7,12,1,14,4,9,14,92
10,21,7,12,1,18,0,0,0,69
10,21,7,12,15,14,5,0,0,84
10,21,7,19,0,0,0,0,0,57
10,21,7,19,6,21,12,0,0,96
10,21,7,21,12,1,0,0,0,72
10,21,7,21,12,1,18,0,0,90
10,21,7,21,12,1,18,25,0,115
10,21,7,21,12,1,18,19,0,109
10,21,7,21,12,1,20,5,0,97
10,21,7,21,12,1,20,5,4,101
10,21,7,21,12,1,20,5,19,116
10,21,7,21,12,21,13,0,0,105
10,21,7,21,13,0,0,0,0,72
10,21,7,21,13,19,0,0,0,91
10,21,8,1,0,0,0,0,0,40
10,21,9,3,5,0,0,0,0,48
10,21,9,3,5,4,0,0,0,52
10,21,9,3,5,6,21,12,0,87
10,21,9,3,5,8,5,1,4,66
10,21,9,3,5,12,5,19,19,103
10,21,9,3,5,18,0,0,0,66
10,21,9,3,5,18,19,0,0,85
10,21,9,3,5,19,0,0,0,67
10,21,9,3,25,0,0,0,0,68
10,21,9,3,9,5,18,0,0,75
10,21,9,3,9,5,19,20,0,96
10,21,9,3,9,12,25,0,0,89
10,21,9,3,9,14,5,19,19,109
10,21,9,3,9,14,7,0,0,73
10,21,9,19,5,0,0,0,0,64
10,21,10,9,20,19,21,0,0,110
10,21,10,9,20,19,21,19,0,129
10,21,10,21,0,0,0,0,0,62
10,21,10,21,2,5,0,0,0,69
10,21,10,21,2,5,19,0,0,88
10,21,10,21,9,19,13,0,0,103
10,21,10,21,9,19,13,19,0,122
10,21,10,21,9,19,20,0,0,110
10,21,10,21,9,19,20,19,0,129
10,21,10,21,19,0,0,0,0,81
10,21,10,21,20,19,21,0,0,122
10,21,10,21,20,19,21,19,0,141
10,21,11,5,0,0,0,0,0,47
10,21,11,5,2,15,24,0,0,88
10,21,11,5,2,15,24,5,19,112
10,21,11,5,4,0,0,0,0,51
10,21,11,9,14,7,0,0,0,72
10,21,12,1,3,5,15,21,19,107
10,21,12,5,16,0,0,0,0,64
10,21,12,5,16,19,0,0,0,83
10,21,12,9,1,14,20,15,0,102
10,21,12,9,4,0,0,0,0,56
10,21,12,9,4,1,14,0,0,71
10,21,12,9,5,14,9,20,5,105
10,21,12,9,5,14,14,5,19,109
10,21,12,9,5,20,20,0,0,97
10,21,12,9,15,20,20,0,0,107
10,21,12,15,9,4,0,0,0,71
10,21,12,15,9,4,9,1,14,95
10,21,12,15,12,5,0,0,0,75
10,21,12,15,12,9,4,9,14,106
10,21,12,15,12,9,14,0,0,93
10,21,12,15,12,9,14,5,0,98
10,21,13,1,18,20,0,0,0,83
10,21,13,2,1,0,0,0,0,47
10,21,13,2,1,12,0,0,0,59
10,21,13,2,1,12,19,0,0,78
10,21,13,2,25,0,0,0,0,71
10,21,13,2,9,5,0,0,0,60
10,21,13,2,12,5,0,0,0,63
10,21,13,2,12,5,4,0,0,67
10,21,13,2,12,5,18,0,0,81
10,21,13,2,12,5,18,19,0,100
10,21,13,2,12,5,19,0,0,82
10,21,13,2,12,25,0,0,0,83
10,21,13,2,12,9,14,7,0,88
10,21,13,2,15,9,19,13,0,102
10,21,13,2,15,19,0,0,0,80
10,21,13,2,21,3,11,0,0,81
10,21,13,2,21,3,11,19,0,100
10,21,13,5,12,12,5,0,0,78
10,21,13,5,14,20,0,0,0,83
10,21,13,5,14,20,15,21,19,138
10,21,13,6,18,21,0,0,0,89
10,21,13,9,12,12,9,20,5,111
10,21,13,13,1,0,0,0,0,58
10,21,13,16,1,2,12,5,0,80
10,21,13,16,5,4,0,0,0,69
10,21,13,16,5,18,0,0,0,83
10,21,13,16,5,18,9,19,13,124
10,21,13,16,5,18,19,0,0,102
10,21,13,16,25,0,0,0,0,85
10,21,13,16,9,5,18,0,0,92
10,21,13,16,9,5,19,20,0,113
10,21,13,16,9,12,25,0,0,106
10,21,13,16,9,14,5,19,19,126
10,21,13,16,9,14,7,0,0,90
10,21,13,16,9,14,7,12,25,127
10,21,13,16,14,5,19,19,0,117
10,21,13,16,15,6,6,0,0,87
10,21,13,16,15,6,6,19,0,106
10,21,13,16,18,15,3,11,0,107
10,21,13,16,18,15,3,11,19,126
10,21,13,16,19,0,0,0,0,79
10,21,13,16,19,5,5,4,0,93
10,21,13,16,19,15,13,5,0,112
10,21,13,16,19,21,9,20,0,129
10,21,13,16,19,21,9,20,19,148
10,21,14,3,1,20,0,0,0,69
10,21,14,3,9,6,15,18,13,109
10,21,14,3,9,20,5,0,0,82
10,21,14,3,15,5,19,0,0,87
10,21,14,3,15,21,19,0,0,103
10,21,14,3,20,9,15,14,19,125
10,21,14,3,20,9,22,5,0,104
10,21,14,3,20,12,25,0,0,105
10,21,14,3,20,15,18,0,0,101
10,21,14,3,20,21,18,1,12,120
10,21,14,3,20,21,18,5,0,112
10,21,14,3,20,21,18,5,19,131
10,21,14,4,25,0,0,0,0,74
10,21,14,4,9,5,0,0,0,63
10,21,14,4,9,5,4,0,0,67
10,21,14,4,9,5,19,0,0,82
10,21,14,4,25,9,14,7,0,104
10,21,14,5,1,20,9,14,7,101
10,21,14,5,3,20,15,13,25,126
10,21,14,5,6,9,19,8,0,92
10,21,14,7,12,5,0,0,0,69
10,21,14,7,12,5,4,0,0,73
10,21,14,7,12,5,7,25,13,114
10,21,14,7,12,5,19,0,0,88
10,21,14,7,12,9,0,0,0,73
10,21,14,7,12,25,0,0,0,89
10,21,14,7,12,9,5,18,0,96
10,21,14,7,12,9,5,19,20,117
10,21,14,9,15,18,1,20,5,113
10,21,14,9,15,18,9,20,25,141
10,21,14,9,15,18,19,0,0,106
10,21,14,9,16,5,18,0,0,93
10,21,14,9,16,5,18,19,0,112
10,21,14,11,0,0,0,0,0,56
10,21,14,11,2,15,1,18,4,96
10,21,14,11,5,4,0,0,0,65
10,21,14,11,5,18,9,19,8,115
10,21,14,11,5,20,0,0,0,81
10,21,14,11,5,20,5,4,0,90
10,21,14,11,5,20,5,5,18,109
10,21,14,11,5,20,5,18,0,104
10,21,14,11,5,20,5,18,19,123
10,21,14,11,5,20,9,14,7,111
10,21,14,11,5,20,19,0,0,100
10,21,14,11,5,20,20,5,18,124
10,21,14,11,25,0,0,0,0,81
10,21,14,11,25,1,18,4,0,104
10,21,14,11,25,1,18,4,19,123
10,21,14,11,9,5,0,0,0,70
10,21,14,11,9,5,18,0,0,88
10,21,14,11,9,5,19,0,0,89
10,21,14,11,9,5,19,20,0,109
10,21,14,11,9,14,7,0,0,86
10,21,14,11,13,1,14,0,0,84
10,21,14,11,13,5,14,0,0,88
10,21,14,11,19,0,0,0,0,75
10,21,14,20,0,0,0,0,0,65
10,21,14,20,1,19,0,0,0,85
10,21,14,20,15,0,0,0,0,80
10,21,14,20,15,19,0,0,0,99
10,21,16,1,18,4,0,0,0,70
10,21,16,1,20,9,0,0,0,77
10,21,16,5,0,0,0,0,0,52
10,21,16,5,19,0,0,0,0,71
10,21,16,15,14,0,0,0,0,76
10,21,16,15,14,19,0,0,0,95
10,21,18,1,12,0,0,0,0,62
10,21,18,1,12,12,25,0,0,99
10,21,18,1,13,5,14,20,0,102
10,21,18,1,13,5,14,20,1,103
10,21,18,1,14,20,0,0,0,84
10,21,18,1,14,20,19,0,0,103
10,21,18,1,18,1,0,0,0,69
10,21,18,1,18,5,0,0,0,73
10,21,18,1,20,0,0,0,0,70
10,21,18,1,20,1,0,0,0,71
10,21,18,1,20,9,15,14,0,108
10,21,18,1,20,9,22,5,0,106
10,21,18,1,20,15,18,0,0,103
10,21,18,1,20,15,18,25,0,128
10,21,18,1,20,19,0,0,0,89
10,21,18,5,0,0,0,0,0,54
10,21,18,5,12,0,0,0,0,66
10,21,18,5,12,19,0,0,0,85
10,21,18,5,22,9,19,0,0,104
10,21,18,9,0,0,0,0,0,58
10,21,18,25,0,0,0,0,0,74
10,21,18,9,4,9,3,0,0,74
10,21,18,9,4,9,3,1,12,87
10,21,18,9,4,9,3,21,19,114
10,21,18,9,5,19,0,0,0,82
10,21,18,25,12,5,19,19,0,129
10,21,18,25,13,1,14,0,0,102
10,21,18,25,13,5,14,0,0,106
10,21,18,9,14,7,0,0,0,79
10,21,18,9,19,0,0,0,0,77
10,21,18,9,19,16,0,0,0,93
10,21,18,9,19,20,0,0,0,97
10,21,18,9,19,20,9,3,0,109
10,21,18,9,19,20,19,0,0,116
10,21,18,25,23,15,13,1,14,140
10,21,18,25,23,15,13,5,14,144
10,21,18,15,18,0,0,0,0,82
10,21,18,15,18,19,0,0,0,101
10,21,18,21,16,1,9,20,5,121
10,21,19,0,0,0,0,0,0,50
10,21,19,12,9,11,0,0,0,82
10,21,19,12,20,5,4,0,0,91
10,21,19,19,1,12,0,0,0,82
10,21,19,19,5,12,0,0,0,86
10,21,19,19,8,5,12,12,0,106
10,21,19,19,9,15,14,0,0,107
10,21,19,19,9,22,5,0,0,105
10,21,19,19,9,22,5,19,0,124
10,21,19,19,15,18,25,0,0,127
10,21,19,20,5,4,0,0,0,79
10,21,19,20,5,18,19,0,0,112
10,21,19,20,5,19,20,0,0,114
10,21,19,20,9,3,5,4,0,91
10,21,19,20,9,3,5,18,0,105
10,21,19,20,9,3,5,19,0,106
10,21,19,20,9,3,9,1,12,104
10,21,19,20,9,3,9,1,18,110
10,21,19,20,9,3,9,5,18,114
10,21,19,20,9,3,9,5,19,115
10,21,19,20,9,3,9,14,7,112
10,21,19,20,9,3,15,0,0,97
10,21,19,20,9,3,15,1,20,118
10,21,19,20,9,6,25,0,0,110
10,21,19,20,9,6,9,5,4,103
10,21,19,20,9,6,9,5,18,117
10,21,19,20,9,6,9,5,19,118
10,21,19,20,9,14,7,0,0,100
10,21,19,20,12,5,0,0,0,87
10,21,19,20,12,5,4,0,0,91
10,21,19,20,12,5,18,0,0,105
10,21,19,20,12,5,19,0,0,106
10,21,19,20,12,25,0,0,0,107
10,21,19,20,12,9,14,7,0,112
10,21,19,20,13,5,14,20,0,122
10,21,19,20,13,5,14,20,19,141
10,21,19,20,14,5,19,19,0,127
10,21,19,20,15,0,0,0,0,85
10,21,19,20,19,0,0,0,0,89
10,21,20,0,0,0,0,0,0,51
10,21,20,5,12,9,11,5,0,93
10,21,20,5,19,0,0,0,0,75
10,21,20,11,1,0,0,0,0,63
10,21,20,19,0,0,0,0,0,70
10,21,20,20,5,4,0,0,0,80
10,21,20,20,25,0,0,0,0,96
10,21,20,20,9,5,4,0,0,89
10,21,20,20,9,5,19,0,0,104
10,21,20,20,25,9,14,7,0,126
10,21,20,20,9,14,7,0,0,101
10,21,20,20,9,14,7,12,25,138
10,21,22,0,0,0,0,0,0,53
10,21,22,5,14,1,12,19,0,104
10,21,22,5,14,1,20,5,0,98
10,21,22,5,14,9,12,5,0,98
10,21,22,5,14,9,12,5,19,117
10,21,22,5,14,9,12,9,1,103
10,21,22,5,14,20,0,0,0,92
10,21,22,5,14,20,21,4,5,122
10,21,22,9,1,0,0,0,0,63
10,21,22,9,20,5,0,0,0,87
10,21,23,9,19,5,0,0,0,87
10,21,24,20,1,0,0,0,0,76
10,21,24,20,1,16,15,19,5,131
11,5,2,1,2,0,0,0,0,21
11,5,2,1,2,19,0,0,0,40
11,5,2,1,18,0,0,0,0,37
11,5,2,1,18,19,0,0,0,56
11,5,2,2,25,0,0,0,0,45
11,5,2,2,9,5,0,0,0,34
11,5,2,2,9,5,19,0,0,53
11,5,2,2,15,3,11,0,0,49
11,5,2,2,15,3,11,19,0,68
11,5,2,2,21,3,11,0,0,55
11,5,2,2,21,3,11,19,0,74
11,5,2,25,1,18,0,0,0,62
11,5,2,12,1,8,0,0,0,39
11,5,2,12,1,8,19,0,0,58
11,5,2,15,2,0,0,0,0,35
11,5,2,15,2,19,0,0,0,54
11,5,3,8,5,12,0,0,0,44
11,5,3,11,0,0,0,0,0,30
11,5,3,11,5,4,0,0,0,39
11,5,3,11,25,0,0,0,0,55
11,5,3,11,9,14,7,0,0,60
11,5,3,11,12,5,0,0,0,47
11,5,3,11,12,5,4,0,0,51
11,5,3,11,12,5,19,0,0,66
11,5,3,11,12,9,14,7,0,72
11,5,3,11,19,0,0,0,0,49
11,5,3,11,19,25,0,0,0,74
11,5,3,11,19,9,5,19,0,82
11,5,4,0,0,0,0,0,0,20
11,5,4,4,1,8,0,0,0,33
11,5,4,4,1,8,19,0,0,52
11,5,4,7,5,0,0,0,0,32
11,5,4,7,5,4,0,0,0,36
11,5,4,7,5,18,0,0,0,50
11,5,4,7,5,18,5,5,0,60
11,5,4,7,5,18,5,5,19,79
11,5,4,7,5,19,0,0,0,51
11,5,4,7,25,0,0,0,0,52
11,5,4,7,9,14,7,0,0,57
11,5,4,10,1,22,5,0,0,58
11,5,4,12,15,3,11,0,0,61
11,5,5,3,8,0,0,0,0,32
11,5,5,6,0,0,0,0,0,27
11,5,5,6,19,0,0,0,0,46
11,5,5,11,0,0,0,0,0,32
11,5,5,11,5,4,0,0,0,41
11,5,5,11,5,18,0,0,0,55
11,5,5,11,5,18,19,0,0,74
11,5,5,11,9,14,7,0,0,62
11,5,5,11,19,0,0,0,0,51
11,5,5,12,1,7,5,0,0,46
11,5,5,12,1,7,5,19,0,65
11,5,5,12,2,1,3,11,0,50
11,5,5,12,2,9,12,12,0,68
11,5,5,12,2,9,18,4,0,66
11,5,5,12,2,12,15,3,11,76
11,5,5,12,2,15,1,20,0,71
11,5,5,12,2,15,1,20,19,90
11,5,5,12,4,18,1,7,0,63
11,5,5,12,5,4,0,0,0,42
11,5,5,12,6,1,20,0,0,60
11,5,5,12,8,1,12,5,0,59
11,5,5,12,8,1,12,5,4,63
11,5,5,12,8,1,12,5,19,78
11,5,5,12,8,1,21,12,0,75
11,5,5,12,8,1,21,12,19,94
11,5,5,12,9,14,7,0,0,63
11,5,5,12,9,22,9,14,5,92
11,5,5,12,12,5,19,19,0,88
11,5,5,12,13,1,14,0,0,61
11,5,5,12,18,1,11,5,0,68
11,5,5,12,19,0,0,0,0,52
11,5,5,12,19,15,14,0,0,81
11,5,5,12,19,15,14,19,0,100
11,5,5,12,22,1,20,0,0,76
11,5,5,14,1,0,0,0,0,36
11,5,5,14,5,4,0,0,0,44
11,5,5,14,5,18,19,0,0,77
11,5,5,14,5,19,20,0,0,79
11,5,5,14,9,14,7,0,0,65
11,5,5,14,12,25,0,0,0,72
11,5,5,14,14,5,19,19,0,92
11,5,5,14,19,0,0,0,0,54
11,5,5,16,0,0,0,0,0,37
11,5,5,16,1,2,12,5,0,57
11,5,5,16,5,18,0,0,0,60
11,5,5,16,5,18,5,19,19,103
11,5,5,16,5,18,9,14,7,90
11,5,5,16,5,18,19,0,0,79
11,5,5,16,9,14,7,0,0,67
11,5,5,16,9,14,7,19,0,86
11,5,5,16,14,5,20,0,0,76
11,5,5,16,19,0,0,0,0,56
11,5,5,16,19,1,11,5,0,73
11,5,5,16,19,1,11,5,19,92
11,5,5,16,19,1,11,25,0,93
11,5,5,18,9,5,0,0,0,53
11,5,5,18,15,7,21,5,0,87
11,5,5,19,0,0,0,0,0,40
11,5,5,19,8,15,14,4,0,81
11,5,5,19,8,15,14,4,19,100
11,5,5,19,12,9,16,0,0,77
11,5,5,19,20,0,0,0,0,60
11,5,5,19,20,5,18,0,0,83
11,5,5,19,20,5,18,19,0,102
11,5,5,20,0,0,0,0,0,41
11,5,5,20,19,0,0,0,0,60
11,5,5,22,5,0,0,0,0,48
11,5,5,22,5,19,0,0,0,67
11,5,6,0,0,0,0,0,0,22
11,5,6,6,5,12,0,0,0,45
11,5,6,6,9,25,5,8,0,75
11,5,6,9,1,20,15,9,4,80
11,5,6,9,6,18,5,12,0,72
11,5,6,9,18,0,0,0,0,49
11,5,6,9,18,9,3,0,0,61
11,5,6,9,18,19,0,0,0,68
11,5,6,19,0,0,0,0,0,41
11,5,7,5,12,5,18,0,0,63
11,5,7,5,12,5,18,19,0,82
11,5,7,6,21,12,0,0,0,62
11,5,7,12,5,18,0,0,0,58
11,5,7,12,5,18,19,0,0,77
11,5,7,12,9,14,7,0,0,65
11,5,7,12,9,14,7,19,0,84
11,5,7,19,0,0,0,0,0,42
11,5,8,1,25,1,0,0,0,51
11,5,8,9,12,12,1,8,0,66
11,5,8,9,12,12,15,20,8,100
11,5,8,15,5,9,20,5,0,78
11,5,25,1,7,5,0,0,0,54
11,5,25,1,11,9,0,0,0,62
11,5,25,2,15,1,18,4,0,81
11,5,25,2,15,1,18,4,19,100
11,5,25,2,21,20,20,15,14,133
11,5,25,3,1,18,4,0,0,67
11,5,25,3,1,18,4,19,0,86
11,5,25,5,4,0,0,0,0,50
11,5,25,5,18,0,0,0,0,64
11,5,25,8,15,12,5,0,0,81
11,5,25,8,15,12,5,19,0,100
11,5,25,9,14,7,0,0,0,71
11,5,25,12,5,19,19,0,0,96
11,5,25,12,5,20,0,0,0,78
11,5,25,12,15,3,11,0,0,82
11,5,25,13,1,14,0,0,0,69
11,5,25,13,5,14,0,0,0,73
11,5,25,13,15,22,5,0,0,96
11,5,25,14,15,20,5,0,0,95
11,5,25,14,15,20,5,4,0,99
11,5,25,14,15,20,5,18,0,113
11,5,25,14,15,20,5,18,19,132
11,5,25,14,15,20,5,19,0,114
11,5,25,14,15,20,9,14,7,120
11,5,25,16,1,4,0,0,0,62
11,5,25,16,1,4,19,0,0,81
11,5,25,16,18,5,19,19,0,118
11,5,25,16,21,14,3,8,0,103
11,5,9,18,19,0,0,0,0,62
11,5,25,19,0,0,0,0,0,60
11,5,25,19,5,1,20,0,0,86
11,5,25,19,5,1,20,5,18,109
11,5,25,19,5,20,0,0,0,85
11,5,25,19,5,20,19,0,0,104
11,5,25,19,12,15,20,0,0,107
11,5,25,19,13,9,20,8,0,110
11,5,9,19,20,0,0,0,0,64
11,5,9,19,20,5,18,0,0,87
11,5,25,19,20,5,18,0,0,103
11,5,9,19,20,5,18,19,0,106
11,5,25,19,20,5,18,19,0,122
11,5,25,19,20,15,14,5,0,114
11,5,25,19,20,15,14,5,4,118
11,5,25,19,20,15,14,5,19,133
11,5,25,19,20,18,15,11,5,129
11,5,9,20,12,15,1,0,0,73
11,5,9,20,12,15,1,19,0,92
11,5,25,23,1,25,0,0,0,90
11,5,25,23,1,25,19,0,0,109
11,5,25,23,4,0,0,0,0,68
11,5,25,23,15,18,4,0,0,101
11,5,25,23,15,18,4,19,0,120
11,5,25,23,18,4,0,0,0,86
11,5,11,15,20,5,14,5,0,86
11,5,11,21,14,1,0,0,0,63
11,5,12,3,8,9,14,0,0,62
11,5,12,3,8,25,14,0,0,78
11,5,12,4,0,0,0,0,0,32
11,5,12,4,5,18,0,0,0,55
11,5,12,5,2,5,0,0,0,40
11,5,12,5,3,20,15,13,5,89
11,5,12,5,8,0,0,0,0,41
11,5,12,5,11,0,0,0,0,44
11,5,12,5,16,0,0,0,0,49
11,5,12,5,16,19,0,0,0,68
11,5,12,9,1,0,0,0,0,38
11,5,12,25,16,8,9,20,5,111
11,5,12,11,0,0,0,0,0,39
11,5,12,12,5,7,0,0,0,52
11,5,12,12,5,7,11,0,0,63
11,5,12,12,5,20,0,0,0,65
11,5,12,12,9,3,11,0,0,63
11,5,12,12,9,5,19,0,0,73
11,5,12,12,9,15,14,0,0,78
11,5,12,12,25,19,0,0,0,84
11,5,12,12,15,3,11,0,0,69
11,5,12,15,9,4,0,0,0,56
11,5,12,15,9,4,1,12,0,69
11,5,12,15,9,4,19,0,0,75
11,5,12,15,20,15,13,25,0,116
11,5,12,15,23,14,1,0,0,81
11,5,12,16,0,0,0,0,0,44
11,5,12,16,5,4,0,0,0,53
11,5,12,16,5,18,0,0,0,67
11,5,12,16,6,9,19,8,0,86
11,5,12,16,25,0,0,0,0,69
11,5,12,16,9,5,0,0,0,58
11,5,12,16,9,5,19,0,0,77
11,5,12,16,9,14,7,0,0,74
11,5,12,16,19,0,0,0,0,63
11,5,12,16,23,1,18,5,0,91
11,5,12,16,23,15,18,20,0,120
11,5,12,19,15,14,19,0,0,95
11,5,12,20,5,18,0,0,0,71
11,5,12,20,5,18,19,0,0,90
11,5,12,20,25,0,0,0,0,73
11,5,12,20,9,3,19,0,0,79
11,5,12,20,9,5,0,0,0,62
11,5,12,20,19,0,0,0,0,67
11,5,12,22,9,14,19,0,0,92
11,5,13,1,12,0,0,0,0,42
11,5,13,1,14,3,8,1,0,56
11,5,13,2,0,0,0,0,0,31
11,5,13,5,12,9,14,0,0,69
11,5,13,16,1,19,0,0,0,65
11,5,13,16,25,0,0,0,0,70
11,5,13,16,9,20,5,0,0,79
11,5,13,16,12,5,0,0,0,62
11,5,13,16,19,0,0,0,0,64
11,5,13,16,20,0,0,0,0,65
11,5,13,16,20,11,5,14,0,95
11,5,13,16,20,19,0,0,0,84
11,5,14,1,6,0,0,0,0,37
11,5,14,1,6,19,0,0,0,56
11,5,14,1,18,5,8,0,0,62
11,5,14,3,8,0,0,0,0,41
11,5,14,3,8,5,19,0,0,65
11,5,14,4,0,0,0,0,0,34
11,5,14,4,9,18,0,0,0,61
11,5,14,4,25,18,0,0,0,77
11,5,14,4,14,1,0,0,0,49
11,5,14,4,15,0,0,0,0,49
11,5,14,4,15,9,19,20,0,97
11,5,14,4,15,19,0,0,0,68
11,5,14,5,13,1,0,0,0,49
11,5,14,25,1,14,19,0,0,89
11,5,14,25,20,5,0,0,0,80
11,5,14,12,15,18,5,0,0,80
11,5,14,13,1,18,11,0,0,73
11,5,14,13,16,25,0,0,0,84
11,5,14,14,5,4,0,0,0,53
11,5,14,14,5,12,0,0,0,61
11,5,14,14,5,12,5,4,0,70
11,5,14,14,5,12,9,14,7,91
11,5,14,14,5,12,12,0,0,73
11,5,14,14,5,12,12,5,4,82
11,5,14,14,5,12,13,1,14,89
11,5,14,14,5,12,19,0,0,80
11,5,14,14,9,14,7,0,0,74
11,5,14,14,9,14,7,19,0,93
11,5,14,14,15,0,0,0,0,59
11,5,14,15,0,0,0,0,0,45
11,5,14,15,7,5,14,25,0,96
11,5,14,15,19,0,0,0,0,64
11,5,14,15,19,9,19,0,0,92
11,5,14,15,19,9,19,5,19,116
11,5,14,15,20,9,3,0,0,77
11,5,14,15,20,9,19,13,0,106
11,5,14,15,20,9,19,20,0,113
11,5,14,15,20,15,24,9,14,127
11,5,14,15,20,18,15,14,0,112
11,5,14,15,20,18,15,14,19,131
11,5,14,19,0,0,0,0,0,49
11,5,14,19,3,15,6,6,0,79
11,5,14,19,16,1,3,0,0,69
11,5,14,19,16,5,3,11,0,84
11,5,14,20,5,0,0,0,0,55
11,5,14,20,12,5,0,0,0,67
11,5,14,20,12,5,4,7,5,83
11,5,14,20,18,15,7,15,14,119
11,5,15,21,20,0,0,0,0,72
11,5,16,0,0,0,0,0,0,32
11,5,16,8,1,12,9,14,0,76
11,5,16,8,1,12,9,14,19,95
11,5,16,8,9,18,0,0,0,67
11,5,16,9,0,0,0,0,0,41
11,5,16,9,19,0,0,0,0,60
11,5,16,16,5,4,0,0,0,57
11,5,16,16,5,14,0,0,0,67
11,5,16,16,9,14,7,0,0,78
11,5,16,19,0,0,0,0,0,51
11,5,16,20,0,0,0,0,0,52
11,5,18,1,3,5,12,5,0,60
11,5,18,1,3,9,0,0,0,47
11,5,18,1,12,9,20,5,0,81
11,5,18,1,13,9,3,0,0,60
11,5,18,1,13,9,3,19,0,79
11,5,18,1,14,1,0,0,0,50
11,5,18,1,19,9,14,0,0,77
11,5,18,1,19,9,14,5,0,82
11,5,18,1,20,0,0,0,0,55
11,5,18,1,20,9,14,0,0,78
11,5,18,1,20,9,14,19,0,97
11,5,18,1,20,9,20,9,19,112
11,5,18,1,20,15,3,14,9,96
11,5,18,1,20,15,4,5,0,79
11,5,18,1,20,15,9,4,0,83
11,5,18,1,20,15,13,1,0,84
11,5,18,1,20,15,13,1,19,103
11,5,18,1,20,15,13,5,0,88
11,5,18,1,20,15,19,5,0,94
11,5,18,1,20,15,19,5,19,113
11,5,18,1,20,15,19,9,3,101
11,5,18,1,20,15,19,9,19,117
11,5,18,1,20,15,20,9,3,102
11,5,18,1,20,20,15,0,0,90
11,5,18,1,21,14,9,15,14,108
11,5,18,2,0,0,0,0,0,36
11,5,18,2,1,25,1,0,0,63
11,5,18,2,5,4,0,0,0,45
11,5,18,2,9,14,7,0,0,66
11,5,18,2,19,0,0,0,0,55
11,5,18,2,19,20,15,14,5,109
11,5,18,3,8,5,18,0,0,68
11,5,18,3,8,9,5,6,0,65
11,5,18,3,8,9,5,6,19,84
11,5,18,3,8,9,5,6,20,85
11,5,18,3,8,15,15,0,0,75
11,5,18,3,8,21,7,0,0,73
11,5,18,3,8,21,14,11,0,91
11,5,18,5,3,20,15,13,25,115
11,5,18,5,12,0,0,0,0,51
11,5,18,6,0,0,0,0,0,40
11,5,18,6,5,4,0,0,0,49
11,5,18,6,9,14,7,0,0,70
11,5,18,6,12,1,16,0,0,69
11,5,18,6,12,15,16,0,0,83
11,5,18,6,19,0,0,0,0,59
11,5,18,6,21,6,6,12,5,90
11,5,18,25,7,13,1,0,0,80
11,5,18,25,7,13,1,20,1,101
11,5,18,25,11,5,9,15,14,113
11,5,18,25,19,20,9,3,0,110
11,5,18,25,19,20,9,3,19,129
11,5,18,12,0,0,0,0,0,46
11,5,18,13,5,19,0,0,0,71
11,5,18,13,5,19,9,3,0,83
11,5,18,13,5,19,9,20,5,105
11,5,18,13,5,19,19,0,0,90
11,5,18,13,5,19,19,5,19,114
11,5,18,13,9,19,0,0,0,75
11,5,18,13,9,19,5,19,0,99
11,5,18,14,5,0,0,0,0,53
11,5,18,14,5,4,0,0,0,57
11,5,18,14,5,12,0,0,0,65
11,5,18,14,5,12,5,4,0,74
11,5,18,14,5,12,9,14,7,95
11,5,18,14,5,12,12,1,0,78
11,5,18,14,5,12,12,5,4,86
11,5,18,14,5,12,12,25,0,102
11,5,18,14,5,12,19,0,0,84
11,5,18,14,5,18,0,0,0,71
11,5,18,14,5,19,0,0,0,72
11,5,18,14,5,20,20,25,0,118
11,5,18,14,9,14,7,0,0,78
11,5,18,14,9,19,8,0,0,84
11,5,18,14,9,20,5,0,0,82
11,5,18,14,9,20,5,19,0,101
11,5,18,14,15,9,0,0,0,72
11,5,18,14,15,19,0,0,0,82
11,5,18,15,0,0,0,0,0,49
11,5,18,15,7,5,14,0,0,75
11,5,18,15,7,5,14,19,0,94
11,5,18,15,12,9,20,5,0,95
11,5,18,15,19,0,0,0,0,68
11,5,18,15,19,5,14,5,0,92
11,5,18,15,19,5,14,5,19,111
11,5,18,15,19,9,14,5,0,96
11,5,18,15,19,9,14,5,19,115
11,5,18,16,12,21,14,11,0,108
11,5,18,18,9,1,19,0,0,81
11,5,18,18,9,5,19,0,0,85
11,5,18,18,9,20,5,0,0,86
11,5,18,19,0,0,0,0,0,53
11,5,18,19,1,14,14,5,0,87
11,5,18,19,5,25,19,0,0,102
11,5,18,19,12,1,13,0,0,79
11,5,18,19,12,15,19,8,0,107
11,5,18,19,13,1,19,8,0,94
11,5,18,21,7,13,1,0,0,76
11,5,18,21,7,13,1,20,1,97
11,5,18,21,9,14,7,0,0,85
11,5,18,22,5,0,0,0,0,61
11,5,18,23,8,1,13,0,0,79
11,5,19,1,18,0,0,0,0,54
11,5,19,12,5,16,0,0,0,68
11,5,19,19,5,0,0,0,0,59
11,5,19,20,18,5,12,0,0,90
11,5,19,20,18,5,12,19,0,109
11,5,20,1,0,0,0,0,0,37
11,5,20,1,12,0,0,0,0,49
11,5,20,1,16,1,14,7,0,75
11,5,20,1,20,9,14,0,0,80
11,5,20,1,26,9,14,5,0,91
11,5,20,3,8,0,0,0,0,47
11,5,20,3,8,5,19,0,0,71
11,5,20,3,8,25,0,0,0,72
11,5,20,3,8,21,16,0,0,84
11,5,20,3,8,21,16,19,0,103
11,5,20,5,14,0,0,0,0,55
11,5,20,5,14,5,0,0,0,60
11,5,20,5,14,5,19,0,0,79
11,5,20,8,9,2,0,0,0,55
11,5,20,8,9,2,8,0,0,63
11,5,20,25,12,0,0,0,0,73
11,5,20,9,13,9,4,0,0,71
11,5,20,9,13,9,4,5,0,76
11,5,20,9,13,9,14,0,0,81
11,5,20,9,13,9,14,5,0,86
11,5,20,9,14,5,0,0,0,64
11,5,20,9,16,1,20,5,0,87
11,5,20,9,16,9,3,0,0,73
11,5,20,13,9,5,0,0,0,63
11,5,20,15,0,0,0,0,0,51
11,5,20,15,7,5,14,0,0,77
11,5,20,15,7,5,14,9,3,89
11,5,20,15,12,0,0,0,0,63
11,5,20,15,12,5,0,0,0,68
11,5,20,15,12,25,19,5,19,131
11,5,20,15,12,25,19,9,19,135
11,5,20,15,12,25,20,9,3,120
11,5,20,15,12,19,0,0,0,82
11,5,20,15,14,5,0,0,0,70
11,5,20,15,14,5,13,9,1,93
11,5,20,15,14,5,19,0,0,89
11,5,20,15,14,9,3,0,0,77
11,5,20,15,14,9,13,9,4,100
11,5,20,15,14,9,13,9,14,110
11,5,20,15,14,9,26,5,0,105
11,5,20,15,14,21,18,9,1,114
11,5,20,15,19,5,0,0,0,75
11,5,20,15,19,5,19,0,0,94
11,5,20,15,19,9,4,5,0,88
11,5,20,15,19,9,19,0,0,98
11,5,20,15,20,9,3,0,0,83
11,5,20,15,24,9,13,5,0,102
11,5,20,20,5,0,0,0,0,61
11,5,20,20,9,14,7,0,0,86
11,5,20,20,12,5,0,0,0,73
11,5,20,20,12,5,6,21,12,112
11,5,20,20,12,5,18,0,0,91
11,5,20,20,12,5,19,0,0,92
11,5,20,20,18,9,14,0,0,97
11,5,20,21,2,1,0,0,0,60
11,5,20,21,2,1,8,0,0,68
11,5,20,21,2,1,8,19,0,87
11,5,20,21,2,15,20,8,0,102
11,5,20,21,16,1,0,0,0,74
11,5,20,23,1,25,0,0,0,85
11,5,21,16,0,0,0,0,0,53
11,5,21,18,2,15,15,13,0,100
11,5,22,1,12,9,14,0,0,74
11,5,22,1,26,9,14,7,15,110
11,5,22,5,12,0,0,0,0,55
11,5,22,5,12,8,5,1,4,73
11,5,22,5,12,19,0,0,0,74
11,5,22,5,18,0,0,0,0,61
11,5,22,9,12,19,0,0,0,78
11,5,22,21,20,26,1,8,0,114
11,5,22,21,20,26,15,20,8,148
11,5,24,0,0,0,0,0,0,40
11,5,24,5,19,0,0,0,0,64
11,5,24,25,0,0,0,0,0,65
11,7,6,0,0,0,0,0,0,24
11,7,18,0,0,0,0,0,0,36
11,8,5,4,1,0,0,0,0,29
11,8,5,4,1,8,0,0,0,37
11,8,5,4,1,8,19,0,0,56
11,8,5,4,1,19,0,0,0,48
11,8,5,4,9,22,1,0,0,60
11,8,5,4,9,22,1,12,0,72
11,8,5,4,9,22,1,20,5,85
11,8,5,4,9,22,5,0,0,64
11,8,5,4,9,22,5,19,0,83
11,8,5,4,9,22,9,1,8,77
11,8,5,4,9,22,9,1,12,81
11,8,5,12,12,1,0,0,0,49
11,8,5,12,12,9,14,0,0,71
11,8,5,16,5,19,8,0,0,72
11,8,5,19,1,18,9,0,0,71
11,8,5,20,0,0,0,0,0,44
11,8,5,20,8,0,0,0,0,52
11,8,5,20,8,19,0,0,0,71
11,8,5,20,19,0,0,0,0,63
11,8,9,0,0,0,0,0,0,28
11,8,9,12,1,20,0,0,0,61
11,8,9,18,0,0,0,0,0,46
11,8,9,18,11,1,0,0,0,58
11,8,9,18,11,1,8,0,0,66
11,8,9,18,11,1,8,19,0,85
11,8,9,19,0,0,0,0,0,47
11,8,15,4,10,1,0,0,0,49
11,8,15,10,1,8,0,0,0,53
11,8,15,11,1,0,0,0,0,46
11,8,15,20,0,0,0,0,0,54
11,8,15,21,13,0,0,0,0,68
11,8,15,21,13,19,0,0,0,87
11,8,21,0,0,0,0,0,0,40
11,8,21,2,2,5,18,0,0,67
11,8,21,4,0,0,0,0,0,44
11,8,21,12,1,0,0,0,0,53
11,8,21,12,4,1,0,0,0,57
11,8,21,19,11,8,21,19,0,118
11,8,21,20,2,1,0,0,0,63
11,8,21,20,21,11,20,21,0,133
11,8,22,1,20,0,0,0,0,62
11,9,2,2,5,0,0,0,0,29
11,9,2,2,5,8,0,0,0,37
11,9,2,2,5,8,19,0,0,56
11,9,2,2,5,18,0,0,0,47
11,9,2,2,5,19,0,0,0,48
11,9,2,2,12,5,0,0,0,41
11,9,2,2,12,5,4,0,0,45
11,9,2,2,12,5,18,0,0,59
11,9,2,2,12,5,19,0,0,60
11,9,2,2,12,9,14,7,0,66
11,9,2,2,21,20,26,0,0,91
11,9,2,2,21,20,26,9,13,113
11,9,2,5,0,0,0,0,0,27
11,9,2,5,9,19,0,0,0,55
11,9,2,5,19,0,0,0,0,46
11,9,2,25,0,0,0,0,0,47
11,9,2,9,20,11,1,0,0,63
11,9,2,9,20,26,0,0,0,77
11,9,2,9,20,26,5,4,0,86
11,9,2,9,20,26,5,18,0,100
11,9,2,9,20,26,5,18,19,119
11,9,2,9,20,26,5,19,0,101
11,9,2,9,20,26,9,14,7,107
11,9,2,12,1,0,0,0,0,35
11,9,2,12,1,8,0,0,0,43
11,9,2,12,1,8,19,0,0,62
11,9,2,12,1,19,0,0,0,54
11,9,2,15,19,8,0,0,0,64
11,9,2,15,19,8,5,4,0,73
11,9,2,15,19,8,5,19,0,88
11,9,2,15,19,8,9,14,7,94
11,9,2,19,5,25,0,0,0,71
11,9,3,8,5,12,0,0,0,48
11,9,3,11,0,0,0,0,0,34
11,9,3,11,1,2,12,5,0,54
11,9,3,11,2,1,3,11,0,51
11,9,3,11,2,1,3,11,19,70
11,9,3,11,2,1,12,12,0,61
11,9,3,11,2,15,1,18,4,74
11,9,3,11,4,15,23,14,0,90
11,9,3,11,5,4,0,0,0,43
11,9,3,11,5,5,0,0,0,44
11,9,3,11,5,18,0,0,0,57
11,9,3,11,5,18,19,0,0,76
11,9,3,11,25,0,0,0,0,59
11,9,3,11,9,5,18,0,0,66
11,9,3,11,9,5,19,20,0,87
11,9,3,11,9,14,7,0,0,64
11,9,3,11,9,19,8,0,0,70
11,9,3,11,12,5,19,19,0,89
11,9,3,11,15,6,6,0,0,61
11,9,3,11,15,6,6,19,0,80
11,9,3,11,15,21,20,0,0,90
11,9,3,11,16,12,1,20,5,88
11,9,3,11,19,0,0,0,0,53
11,9,3,11,19,5,25,19,0,102
11,9,3,11,19,8,1,23,0,85
11,9,3,11,19,8,1,23,19,104
11,9,3,11,19,9,5,19,0,86
11,9,3,11,19,20,1,14,4,92
11,9,3,11,20,1,9,12,0,76
11,9,3,11,21,16,0,0,0,71
11,9,3,11,21,16,19,0,0,90
11,9,3,11,23,8,5,5,12,87
11,9,3,11,24,9,1,0,0,68
11,9,4,1,14,7,0,0,0,46
11,9,4,3,15,20,5,0,0,67
11,9,4,4,5,4,0,0,0,37
11,9,4,4,5,18,19,0,0,70
11,9,4,4,25,0,0,0,0,53
11,9,4,4,9,5,0,0,0,42
11,9,4,4,9,5,18,0,0,60
11,9,4,4,9,5,19,0,0,61
11,9,4,4,9,14,7,0,0,58
11,9,4,4,9,14,7,12,25,95
11,9,4,4,9,19,8,0,0,64
11,9,4,4,12,5,0,0,0,45
11,9,4,4,15,0,0,0,0,43
11,9,4,4,15,5,19,0,0,67
11,9,4,4,15,19,0,0,0,62
11,9,4,4,21,19,8,5,19,100
11,9,4,4,21,19,8,9,14,99
11,9,4,8,15,15,4,0,0,66
11,9,4,12,5,20,0,0,0,61
11,9,4,12,9,11,5,0,0,61
11,9,4,12,9,14,7,0,0,66
11,9,4,14,1,16,0,0,0,55
11,9,4,14,1,16,5,4,0,64
11,9,4,14,1,16,5,5,0,65
11,9,4,14,1,16,5,18,0,78
11,9,4,14,1,16,5,18,19,97
11,9,4,14,1,16,9,14,7,85
11,9,4,14,1,16,16,5,5,81
11,9,4,14,1,16,16,5,18,94
11,9,4,14,1,16,19,0,0,74
11,9,4,14,5,25,0,0,0,68
11,9,4,14,5,25,19,0,0,87
11,9,4,19,11,9,14,0,0,77
11,9,4,19,11,9,14,19,0,96
11,9,4,19,13,1,14,0,0,71
11,9,4,22,9,4,0,0,0,59
11,9,4,22,9,4,19,0,0,78
11,9,5,0,0,0,0,0,0,25
11,25,5,0,0,0,0,0,0,41
11,9,5,6,5,11,9,12,0,68
11,9,5,6,19,0,0,0,0,50
11,9,5,25,5,0,0,0,0,55
11,9,5,11,9,5,0,0,0,50
11,9,5,12,2,1,19,1,0,60
11,9,5,12,2,1,19,1,19,79
11,9,5,12,2,1,19,9,0,68
11,9,5,12,2,1,19,25,0,84
11,9,5,18,19,0,0,0,0,62
11,9,5,19,5,12,7,21,18,107
11,9,5,19,5,18,9,20,5,101
11,9,5,19,20,5,18,19,0,106
11,9,5,19,20,12,5,19,19,119
11,9,6,19,0,0,0,0,0,45
11,9,25,1,19,0,0,0,0,65
11,9,25,9,0,0,0,0,0,54
11,9,11,1,18,0,0,0,0,50
11,9,11,1,23,1,5,15,0,76
11,9,11,5,0,0,0,0,0,36
11,25,11,5,0,0,0,0,0,52
11,9,11,5,19,0,0,0,0,55
11,9,11,11,9,0,0,0,0,51
11,9,11,15,9,0,0,0,0,55
11,9,11,15,18,9,0,0,0,73
11,9,11,21,0,0,0,0,0,52
11,9,11,21,5,12,0,0,0,69
11,9,11,21,13,15,14,0,0,94
11,9,12,0,0,0,0,0,0,32
11,9,12,1,4,10,1,0,0,48
11,9,12,1,13,16,5,18,5,90
11,9,12,4,5,5,0,0,0,46
11,9,12,4,5,18,11,9,14,93
11,9,12,5,8,0,0,0,0,45
11,9,12,5,25,19,0,0,0,81
11,9,12,5,18,7,0,0,0,62
11,9,12,8,9,7,0,0,0,56
11,9,12,9,1,18,5,0,0,65
11,25,12,9,5,19,0,0,0,81
11,9,12,9,10,0,0,0,0,51
11,25,12,9,11,5,3,0,0,76
11,25,12,9,11,5,19,0,0,92
11,9,12,9,13,0,0,0,0,54
11,9,12,9,13,19,0,0,0,73
11,25,12,9,14,0,0,0,0,71
11,25,12,9,20,5,0,0,0,82
11,25,12,9,24,0,0,0,0,81
11,9,12,12,0,0,0,0,0,44
11,9,12,12,1,2,12,5,0,64
11,9,12,12,1,4,1,18,0,68
11,9,12,12,1,19,0,0,0,64
11,9,12,12,3,1,12,6,0,66
11,9,12,12,3,18,15,16,0,96
11,9,12,12,3,21,0,0,0,68
11,9,12,12,4,5,5,0,0,58
11,9,12,12,4,5,5,18,0,76
11,9,12,12,4,5,5,18,19,95
11,9,12,12,4,5,5,19,0,77
11,9,12,12,5,4,0,0,0,53
11,9,12,12,5,18,0,0,0,67
11,9,12,12,5,18,19,0,0,86
11,9,12,12,5,19,5,0,0,73
11,9,12,12,9,3,11,0,0,67
11,9,12,12,9,3,11,19,0,86
11,9,12,12,9,5,19,0,0,77
11,9,12,12,9,6,9,19,8,95
11,9,12,12,9,7,0,0,0,60
11,9,12,12,9,14,7,0,0,74
11,9,12,12,9,14,7,12,25,111
11,9,12,12,9,14,7,19,0,93
11,9,12,12,9,14,9,20,5,101
11,9,12,12,10,15,25,0,0,94
11,9,12,12,10,15,25,19,0,113
11,9,12,12,15,3,8,0,0,70
11,9,12,12,15,3,11,0,0,73
11,9,12,12,15,3,11,19,0,92
11,9,12,12,15,7,9,5,0,80
11,9,12,12,15,23,0,0,0,82
11,9,12,12,19,0,0,0,0,63
11,9,12,12,23,5,5,4,0,81
11,9,12,12,23,15,18,20,0,120
11,9,12,14,5,4,0,0,0,55
11,9,12,14,5,25,5,0,0,81
11,9,12,14,8,15,12,5,0,86
11,9,12,14,9,14,7,0,0,76
11,9,12,14,13,1,14,0,0,74
11,9,12,14,18,9,2,0,0,75
11,9,12,14,19,0,0,0,0,65
11,9,12,14,19,20,9,3,11,108
11,9,12,14,20,18,5,5,0,94
11,9,12,15,0,0,0,0,0,47
11,25,12,15,0,0,0,0,0,63
11,9,12,15,2,1,18,0,0,68
11,9,12,15,2,1,18,19,0,87
11,9,12,15,2,1,21,4,0,75
11,9,12,15,2,9,20,0,0,78
11,9,12,15,2,25,20,5,0,99
11,9,12,15,2,25,20,5,19,118
11,9,12,15,2,9,20,19,0,97
11,9,12,15,2,12,15,3,11,90
11,9,12,15,2,21,3,11,0,84
11,9,12,15,3,25,3,12,5,95
11,9,12,15,3,21,18,9,5,103
11,9,12,15,4,25,14,5,0,95
11,25,12,15,5,0,0,0,0,68
11,9,12,15,7,1,21,19,19,114
11,9,12,15,7,18,1,9,14,96
11,9,12,15,7,18,1,13,0,86
11,9,12,15,7,18,1,13,19,105
11,9,12,15,8,5,18,20,26,124
11,9,12,15,8,13,0,0,0,68
11,9,12,15,10,15,21,12,5,110
11,9,12,15,12,9,14,5,0,87
11,9,12,15,12,9,20,5,18,111
11,9,12,15,12,9,20,18,5,111
11,9,12,15,12,21,13,5,14,112
11,9,12,15,13,0,0,0,0,60
11,9,12,15,13,5,20,5,18,108
11,9,12,15,13,5,20,18,5,108
11,9,12,15,13,15,12,5,0,92
11,9,12,15,13,15,12,5,19,111
11,9,12,15,16,15,9,19,5,111
11,9,12,15,16,15,21,14,4,117
11,9,12,15,18,1,4,0,0,70
11,9,12,15,18,1,4,19,0,89
11,9,12,15,19,0,0,0,0,66
11,9,12,15,19,20,5,18,5,114
11,9,12,15,20,15,14,0,0,96
11,9,12,15,20,15,14,19,0,115
11,9,12,15,22,1,18,0,0,88
11,9,12,15,22,15,12,20,0,116
11,9,12,15,22,15,12,20,19,135
11,9,12,15,23,1,18,5,0,94
11,9,12,15,23,1,20,20,0,111
11,9,12,15,23,1,20,20,19,130
11,9,12,15,23,15,18,4,0,107
11,9,12,16,0,0,0,0,0,48
11,9,12,20,0,0,0,0,0,52
11,9,12,20,5,4,0,0,0,61
11,9,12,20,5,18,0,0,0,75
11,9,12,20,5,18,19,0,0,94
11,9,12,20,25,0,0,0,0,77
11,9,12,20,9,5,0,0,0,66
11,9,12,20,9,5,19,0,0,85
11,9,12,20,9,14,7,0,0,82
11,9,12,20,9,14,7,19,0,101
11,9,12,20,12,9,11,5,0,89
11,9,12,20,19,0,0,0,0,71
11,9,12,21,3,11,0,0,0,67
11,25,13,1,20,9,15,14,0,108
11,25,13,2,1,12,15,14,0,93
11,9,13,2,1,14,7,0,0,57
11,9,13,2,5,18,12,9,14,93
11,9,13,2,15,0,0,0,0,50
11,9,13,3,8,5,5,0,0,54
11,9,13,3,8,5,5,19,0,73
11,9,13,3,8,9,0,0,0,53
11,9,13,3,8,9,19,0,0,72
11,9,13,9,7,1,25,15,0,90
11,9,13,13,5,18,0,0,0,69
11,9,13,13,15,0,0,0,0,61
11,9,13,14,5,12,0,0,0,64
11,25,13,14,5,12,0,0,0,80
11,25,13,15,7,18,1,13,0,103
11,25,13,15,7,18,1,13,19,122
11,25,13,15,7,18,1,16,8,114
11,9,13,15,14,15,0,0,0,77
11,9,13,15,14,15,5,4,0,86
11,9,13,15,14,15,19,0,0,96
11,9,14,0,0,0,0,0,0,34
11,9,14,1,0,0,0,0,0,35
11,9,14,1,2,21,12,21,0,91
11,9,14,1,8,0,0,0,0,43
11,9,14,1,19,0,0,0,0,54
11,9,14,1,19,5,0,0,0,59
11,9,14,1,19,5,19,0,0,78
11,9,14,2,15,15,20,0,0,86
11,9,14,2,15,20,0,0,0,71
11,9,14,2,15,20,5,0,0,76
11,9,14,3,8,9,14,0,0,68
11,9,14,3,15,2,0,0,0,54
11,9,14,4,1,12,0,0,0,51
11,9,14,4,5,19,20,0,0,82
11,9,14,4,8,5,1,18,20,90
11,9,14,4,10,1,12,0,0,61
11,9,14,4,12,5,0,0,0,55
11,9,14,4,12,5,4,0,0,59
11,9,14,4,12,5,18,0,0,73
11,9,14,4,12,5,18,19,0,92
11,9,14,4,12,5,19,0,0,74
11,9,14,4,12,5,19,19,0,93
11,9,14,4,12,25,0,0,0,75
11,9,14,4,12,9,5,18,0,82
11,9,14,4,12,9,5,19,20,103
11,9,14,4,12,9,12,25,0,96
11,9,14,4,12,9,14,7,0,80
11,9,14,4,12,9,14,7,19,99
11,9,14,4,14,5,19,19,0,95
11,9,14,4,18,5,4,0,0,65
11,9,14,4,18,5,4,12,25,102
11,9,14,4,18,5,4,19,0,84
11,9,14,4,18,5,14,4,0,79
11,9,14,4,19,0,0,0,0,57
11,9,14,5,0,0,0,0,0,39
11,9,14,5,13,1,0,0,0,53
11,9,14,5,13,1,19,0,0,72
11,9,14,5,13,1,20,9,3,85
11,9,14,5,16,15,24,0,0,94
11,9,14,5,19,0,0,0,0,58
11,9,14,5,19,3,15,16,5,97
11,9,14,5,19,5,19,0,0,82
11,9,14,5,19,9,3,0,0,70
11,9,14,5,19,9,3,19,0,89
11,9,14,5,19,9,19,0,0,86
11,9,14,5,19,15,4,9,3,89
11,9,14,5,20,9,3,0,0,71
11,9,14,5,20,9,3,1,12,84
11,9,14,5,20,9,3,19,0,90
11,9,14,5,20,9,14,0,0,82
11,9,14,5,20,9,14,19,0,101
11,9,14,5,20,15,13,5,18,110
11,9,14,5,20,15,19,9,19,121
11,9,14,6,15,12,11,0,0,78
11,9,14,6,15,12,11,19,0,97
11,9,14,7,2,9,18,4,0,74
11,9,14,7,2,9,18,4,19,93
11,9,14,7,2,15,12,20,0,90
11,9,14,7,2,15,12,20,19,109
11,9,14,7,3,15,2,0,0,61
11,9,14,7,3,18,1,6,20,89
11,9,14,7,3,21,16,0,0,81
11,9,14,7,3,21,16,19,0,100
11,9,14,7,4,15,13,0,0,73
11,9,14,7,4,15,13,5,4,82
11,9,14,7,4,15,13,19,0,92
11,9,14,7,5,4,0,0,0,50
11,9,14,7,6,9,19,8,0,83
11,9,14,7,8,5,1,4,0,59
11,9,14,7,8,15,15,4,0,83
11,9,14,7,8,15,15,4,19,102
11,9,14,7,9,14,7,0,0,71
11,9,14,7,11,12,9,16,0,89
11,9,14,7,12,5,19,19,0,96
11,9,14,7,12,5,20,0,0,78
11,9,14,7,12,5,20,19,0,97
11,9,14,7,12,25,0,0,0,78
11,9,14,7,12,9,5,18,0,85
11,9,14,7,12,9,5,19,20,106
11,9,14,7,12,9,11,5,0,78
11,9,14,7,12,9,12,25,0,99
11,9,14,7,12,9,14,7,0,83
11,9,14,7,13,1,11,5,18,89
11,9,14,7,16,9,5,3,5,79
11,9,14,7,16,9,14,0,0,80
11,9,14,7,16,9,14,19,0,99
11,9,14,7,16,15,19,20,0,111
11,9,14,7,16,15,19,20,19,130
11,9,14,7,18,15,23,0,0,97
11,9,14,7,19,8,9,16,0,93
11,9,14,7,19,8,9,16,19,112
11,9,14,7,19,9,4,5,0,78
11,9,14,7,19,9,4,5,19,97
11,9,14,7,19,9,26,5,0,100
11,9,14,7,19,13,1,14,0,88
11,9,14,7,19,14,1,11,5,91
11,9,14,7,23,5,5,4,0,78
11,9,14,7,23,15,15,4,19,117
11,9,14,8,9,14,0,0,0,65
11,9,14,9,3,0,0,0,0,46
11,9,14,9,14,0,0,0,0,57
11,9,14,9,14,15,7,5,14,98
11,9,14,9,14,19,0,0,0,76
11,9,14,11,0,0,0,0,0,45
11,9,14,11,1,2,12,5,0,65
11,9,14,11,1,10,15,21,0,92
11,9,14,11,1,10,15,21,19,111
11,9,14,11,3,15,21,7,8,99
11,9,14,11,5,4,0,0,0,54
11,9,14,11,5,18,0,0,0,68
11,9,14,11,8,1,2,0,0,56
11,9,14,11,8,1,21,19,20,114
11,9,14,11,8,15,19,20,0,107
11,9,14,11,25,0,0,0,0,70
11,9,14,11,9,5,18,0,0,77
11,9,14,11,9,5,19,20,0,98
11,9,14,11,9,12,25,0,0,91
11,9,14,11,9,14,5,19,19,111
11,9,14,11,9,14,7,0,0,75
11,9,14,11,12,5,0,0,0,62
11,9,14,11,12,5,4,0,0,66
11,9,14,11,12,25,0,0,0,82
11,9,14,11,19,0,0,0,0,64
11,9,14,11,19,2,21,19,8,114
11,9,14,12,5,19,19,0,0,89
11,9,14,14,5,18,25,0,0,96
11,9,14,14,15,18,0,0,0,81
11,9,14,15,0,0,0,0,0,49
11,9,14,15,12,15,7,25,0,108
11,9,14,15,14,5,0,0,0,68
11,9,14,15,15,0,0,0,0,64
11,9,14,15,15,19,0,0,0,83
11,9,14,15,16,12,1,19,13,110
11,9,14,15,19,0,0,0,0,68
11,9,14,15,19,16,15,18,5,122
11,9,14,15,20,0,0,0,0,69
11,9,14,19,0,0,0,0,0,53
11,9,14,19,5,14,0,0,0,72
11,9,14,19,6,15,12,11,0,97
11,9,14,19,8,9,16,0,0,86
11,9,14,19,8,9,16,19,0,105
11,9,14,19,13,1,14,12,25,118
11,9,14,19,13,5,14,0,0,85
11,9,14,19,23,15,13,1,14,119
11,9,14,19,23,15,13,5,14,123
11,9,14,20,1,18,0,0,0,73
11,9,14,20,12,1,7,5,0,79
11,9,14,20,18,1,0,0,0,73
11,9,14,20,18,25,0,0,0,97
11,9,14,21,18,1,0,0,0,74
11,25,14,21,18,5,14,9,3,120
11,25,14,21,18,9,14,0,0,112
11,25,14,21,18,9,14,5,0,117
11,9,15,5,1,0,0,0,0,41
11,9,15,14,15,20,15,13,25,137
11,25,15,15,4,12,5,0,0,87
11,25,15,15,4,12,5,4,0,91
11,25,15,15,4,12,9,14,7,112
11,9,15,19,11,0,0,0,0,65
11,9,15,19,11,19,0,0,0,84
11,9,15,20,15,13,5,0,0,88
11,9,15,20,15,13,25,0,0,108
11,9,15,20,15,13,9,5,19,116
11,9,16,1,7,5,0,0,0,49
11,9,16,5,0,0,0,0,0,41
11,9,16,6,5,12,0,0,0,59
11,25,16,8,15,19,5,19,0,118
11,25,16,8,15,19,9,19,0,122
11,25,16,8,15,20,9,3,0,107
11,9,16,16,1,7,5,0,0,65
11,9,16,16,5,4,0,0,0,61
11,9,16,16,5,5,14,0,0,76
11,9,16,16,5,14,0,0,0,71
11,9,16,16,5,18,5,4,0,84
11,9,16,16,5,18,5,18,0,98
11,9,16,16,5,18,9,14,7,105
11,9,16,16,5,18,19,0,0,94
11,9,16,16,9,14,0,0,0,75
11,9,16,16,9,14,7,0,0,82
11,9,16,16,21,18,0,0,0,91
11,9,16,19,5,25,0,0,0,85
11,9,16,19,11,9,14,0,0,89
11,9,16,19,11,9,14,19,0,108
11,9,16,21,11,1,0,0,0,69
11,9,18,0,0,0,0,0,0,38
11,9,18,2,9,5,19,0,0,73
11,25,18,9,1,12,0,0,0,76
11,25,18,9,5,12,12,5,0,97
11,25,18,9,5,19,0,0,0,87
11,9,18,9,7,1,13,9,0,77
11,9,18,9,7,1,13,9,19,96
11,9,18,9,13,15,14,0,0,89
11,25,18,9,14,5,0,0,0,82
11,25,18,9,15,19,0,0,0,97
11,9,18,11,5,18,0,0,0,72
11,9,18,11,25,1,18,4,0,97
11,9,18,11,9,6,25,0,0,89
11,9,18,11,9,14,7,0,0,79
11,9,18,11,12,9,11,5,0,86
11,9,18,11,13,5,14,0,0,81
11,9,18,11,19,0,0,0,0,68
11,9,18,11,20,15,14,0,0,98
11,9,18,11,20,15,23,14,0,121
11,9,18,11,23,1,18,4,0,95
11,9,18,13,5,19,19,0,0,94
11,9,18,13,5,19,19,5,19,118
11,9,18,13,5,23,0,0,0,79
11,9,18,14,0,0,0,0,0,52
11,9,18,14,5,4,0,0,0,61
11,9,18,14,9,14,7,0,0,82
11,9,18,14,19,0,0,0,0,71
11,9,18,15,13,2,15,0,0,83
11,9,18,16,1,14,0,0,0,69
11,9,18,19,0,0,0,0,0,57
11,9,18,19,3,8,5,19,0,92
11,9,18,19,5,14,0,0,0,76
11,9,18,20,12,5,0,0,0,75
11,9,18,20,12,5,4,0,0,79
11,9,18,20,12,5,19,0,0,94
11,9,18,22,5,0,0,0,0,65
11,9,18,22,5,18,0,0,0,83
11,9,19,1,5,14,7,0,0,66
11,9,19,1,14,0,0,0,0,54
11,9,19,1,14,7,0,0,0,61
11,9,19,3,8,5,14,0,0,69
11,25,19,3,8,20,25,0,0,111
11,9,19,8,5,14,0,0,0,66
11,9,19,8,25,0,0,0,0,72
11,9,19,8,11,1,0,0,0,59
11,9,19,8,11,1,19,0,0,78
11,9,19,8,11,5,0,0,0,63
11,9,19,8,11,5,19,0,0,82
11,9,19,8,15,14,0,0,0,76
11,9,19,11,1,4,5,5,0,65
11,9,19,11,1,20,15,13,0,99
11,9,19,11,9,20,15,13,0,107
11,9,19,13,1,20,0,0,0,73
11,9,19,13,1,20,19,0,0,92
11,9,19,13,5,20,9,3,0,89
11,9,19,13,5,20,19,0,0,96
11,9,19,18,1,0,0,0,0,58
11,9,19,19,1,2,12,5,0,78
11,9,19,19,1,2,12,25,0,98
11,9,19,19,1,7,5,0,0,71
11,9,19,19,1,18,0,0,0,77
11,9,19,19,5,4,0,0,0,67
11,9,19,19,5,18,0,0,0,81
11,9,19,19,5,18,19,0,0,100
11,9,19,19,5,19,0,0,0,82
11,9,19,19,25,0,0,0,0,83
11,9,19,19,9,14,7,0,0,88
11,9,19,19,9,14,7,12,25,125
11,9,19,19,16,18,15,15,6,128
11,9,19,19,23,9,19,5,0,114
11,9,19,20,0,0,0,0,0,59
11,9,19,20,6,21,12,0,0,98
11,9,19,20,6,21,12,19,0,117
11,9,19,20,19,0,0,0,0,78
11,9,19,20,22,1,5,14,0,101
11,9,19,23,1,0,0,0,0,63
11,9,19,23,1,8,0,0,0,71
11,9,20,1,2,0,0,0,0,43
11,9,20,1,2,9,0,0,0,52
11,9,20,1,2,9,19,0,0,71
11,9,20,1,18,0,0,0,0,59
11,9,20,2,1,7,0,0,0,50
11,9,20,3,1,20,0,0,0,64
11,9,20,3,8,5,14,5,20,95
11,9,20,3,8,5,14,25,0,95
11,9,20,3,8,5,14,18,25,113
11,9,20,3,8,5,14,19,0,89
11,9,20,3,8,9,5,0,0,65
11,9,20,3,8,9,14,7,0,81
11,9,20,5,0,0,0,0,0,45
11,9,20,5,4,0,0,0,0,49
11,9,20,5,6,12,9,5,18,95
11,9,20,5,12,9,11,5,0,82
11,9,20,5,14,7,5,0,0,71
11,9,20,5,18,0,0,0,0,63
11,9,20,5,18,19,0,0,0,82
11,9,20,5,19,0,0,0,0,64
11,25,20,5,19,0,0,0,0,80
11,9,20,8,0,0,0,0,0,48
11,9,20,8,1,18,1,0,0,68
11,9,20,8,1,18,1,19,0,87
11,9,20,8,5,0,0,0,0,53
11,25,20,8,5,0,0,0,0,69
11,9,20,8,5,4,0,0,0,57
11,25,20,8,5,4,0,0,0,73
11,9,20,8,5,19,0,0,0,72
11,25,20,8,5,19,0,0,0,88
11,9,20,8,9,14,7,0,0,78
11,25,20,8,9,14,7,0,0,94
11,9,20,8,12,5,19,19,0,103
11,9,20,8,15,7,21,5,0,96
11,9,20,8,19,0,0,0,0,67
11,9,20,9,14,7,0,0,0,70
11,9,20,9,19,8,0,0,0,76
11,9,20,25,19,15,12,0,0,111
11,9,20,12,9,14,7,0,0,82
11,9,20,12,9,14,7,19,0,101
11,9,20,13,1,14,0,0,0,68
11,9,20,13,21,4,7,1,18,104
11,25,20,15,15,14,0,0,0,100
11,9,20,19,0,0,0,0,0,59
11,9,20,19,3,8,0,0,0,70
11,9,20,19,3,8,5,19,0,94
11,9,20,19,3,8,25,0,0,95
11,9,20,20,1,18,0,0,0,79
11,9,20,20,5,4,0,0,0,69
11,9,20,20,5,12,0,0,0,77
11,9,20,20,5,14,0,0,0,79
11,9,20,20,5,14,4,15,13,111
11,9,20,20,5,14,5,4,0,88
11,9,20,20,5,14,9,14,7,109
11,9,20,20,5,14,9,19,8,115
11,9,20,20,5,14,19,0,0,98
11,9,20,20,5,18,0,0,0,83
11,9,20,20,5,18,5,5,14,107
11,9,20,20,8,15,7,5,0,95
11,9,20,20,9,5,19,0,0,93
11,9,20,20,9,14,7,0,0,90
11,9,20,20,9,19,15,12,0,115
11,9,20,20,25,19,15,12,0,131
11,9,20,20,9,23,1,11,5,109
11,9,20,20,12,5,0,0,0,77
11,9,20,20,12,5,4,0,0,81
11,9,20,20,12,5,18,0,0,95
11,9,20,20,12,5,19,0,0,96
11,9,20,20,12,5,19,20,0,116
11,9,20,20,12,25,0,0,0,97
11,9,20,20,12,9,14,7,0,102
11,9,20,20,12,9,19,8,0,108
11,9,20,20,15,3,11,0,0,89
11,9,20,20,15,15,12,0,0,102
11,9,20,20,21,12,0,0,0,93
11,25,21,0,0,0,0,0,0,57
11,25,21,14,7,0,0,0,0,78
11,9,21,20,12,5,0,0,0,78
11,9,22,1,0,0,0,0,0,43
11,9,22,1,19,0,0,0,0,62
11,9,22,5,18,0,0,0,0,65
11,9,22,9,11,9,22,9,0,102
11,9,23,1,3,8,0,0,0,55
11,9,23,9,0,0,0,0,0,52
11,9,23,9,11,9,23,9,0,104
11,9,23,9,19,0,0,0,0,71
11,12,5,1,7,12,5,0,0,53
11,12,5,1,7,12,5,19,0,72
11,12,5,5,14,5,2,15,3,72
11,12,5,5,14,5,2,15,11,80
11,12,5,9,7,0,0,0,0,44
11,12,5,9,14,9,20,5,0,85
11,12,5,14,4,21,19,9,3,98
11,12,5,16,8,20,0,0,0,72
11,12,5,16,8,20,9,3,0,84
11,12,5,16,8,20,9,19,13,113
11,12,5,16,8,20,19,0,0,91
11,12,5,16,20,9,3,0,0,76
11,12,5,19,8,1,0,0,0,56
11,12,5,26,13,5,18,0,0,90
11,12,9,3,11,0,0,0,0,46
11,12,9,3,11,5,20,0,0,71
11,12,9,5,7,0,0,0,0,44
11,12,9,14,15,0,0,0,0,61
11,12,9,16,0,0,0,0,0,48
11,12,9,16,2,15,11,0,0,76
11,12,9,16,4,1,3,8,19,83
11,12,9,16,4,1,19,0,0,72
11,12,9,16,6,9,19,8,0,90
11,12,9,16,8,1,1,19,0,77
11,12,9,16,16,5,0,0,0,69
11,12,9,16,16,5,14,0,0,83
11,12,9,19,13,15,9,0,0,88
11,12,9,19,13,15,19,0,0,98
11,12,9,19,20,5,18,0,0,94
11,12,9,19,20,5,18,19,0,113
11,12,25,19,20,18,15,14,19,153
11,12,14,0,0,0,0,0,0,37
11,12,15,5,19,19,5,0,0,86
11,12,15,13,0,0,0,0,0,51
11,12,15,14,7,0,0,0,0,59
11,12,15,14,7,19,0,0,0,78
11,12,15,15,3,8,0,0,0,64
11,12,15,15,6,0,0,0,0,59
11,12,15,15,6,19,0,0,0,78
11,12,15,15,20,3,8,0,0,84
11,12,15,16,0,0,0,0,0,54
11,12,15,16,19,0,0,0,0,73
11,12,15,19,8,0,0,0,0,65
11,12,15,19,19,5,0,0,0,81
11,12,15,23,5,20,0,0,0,86
11,12,21,3,11,5,18,0,0,81
11,12,21,4,7,5,0,0,0,60
11,12,21,4,7,5,4,0,0,64
11,12,21,4,7,5,19,0,0,79
11,12,21,4,7,9,14,7,0,85
11,12,21,7,5,19,0,0,0,75
11,12,21,14,11,0,0,0,0,69
11,12,21,20,26,0,0,0,0,90
11,12,21,20,26,5,19,0,0,114
11,12,21,20,26,25,0,0,0,115
11,12,21,20,26,9,5,18,0,122
11,12,21,20,26,9,5,19,20,143
11,12,22,1,0,0,0,0,0,46
11,13,5,12,0,0,0,0,0,41
11,13,5,20,0,0,0,0,0,49
11,13,15,12,5,0,0,0,0,56
11,14,5,1,4,0,0,0,0,35
11,14,5,1,4,1,2,12,5,55
11,14,5,1,4,5,4,0,0,44
11,14,5,1,4,5,18,0,0,58
11,14,5,1,4,5,18,19,0,77
11,14,5,1,4,9,14,7,0,65
11,14,5,1,4,19,0,0,0,54
11,14,5,2,5,12,9,20,5,83
11,14,5,5,0,0,0,0,0,35
11,14,5,5,2,18,21,19,8,103
11,14,5,5,3,1,16,0,0,55
11,14,5,5,3,1,16,19,0,74
11,14,5,5,4,0,0,0,0,39
11,14,5,5,8,15,12,5,0,75
11,14,5,5,8,15,12,5,19,94
11,14,5,5,9,14,7,0,0,65
11,14,5,5,12,0,0,0,0,47
11,14,5,5,12,5,4,0,0,56
11,14,5,5,12,5,18,0,0,70
11,14,5,5,12,5,18,19,0,89
11,14,5,5,12,5,20,0,0,72
11,14,5,5,12,9,14,7,0,77
11,14,5,5,12,19,0,0,0,66
11,14,5,5,16,1,4,0,0,56
11,14,5,5,16,1,4,19,0,75
11,14,5,5,16,1,14,0,0,66
11,14,5,5,16,1,14,19,0,85
11,14,5,5,16,9,5,3,5,73
11,14,5,5,19,0,0,0,0,54
11,14,5,5,19,20,15,14,5,108
11,14,5,12,12,0,0,0,0,54
11,14,5,12,12,5,4,0,0,63
11,14,5,12,12,9,14,7,0,84
11,14,5,12,12,19,0,0,0,73
11,14,5,12,20,0,0,0,0,62
11,14,5,19,19,5,20,19,0,112
11,14,5,20,0,0,0,0,0,50
11,14,5,20,3,8,0,0,0,61
11,14,5,22,5,12,0,0,0,69
11,14,5,23,0,0,0,0,0,53
11,14,5,26,0,0,0,0,0,56
11,14,5,26,9,0,0,0,0,65
11,14,9,1,26,0,0,0,0,61
11,14,25,1,26,0,0,0,0,77
11,14,9,1,26,9,0,0,0,70
11,14,25,1,26,9,0,0,0,86
11,14,9,3,11,5,18,0,0,71
11,14,9,3,11,5,18,5,4,80
11,14,9,3,11,5,18,19,0,90
11,14,9,3,11,14,1,3,11,77
11,14,9,6,5,0,0,0,0,45
11,14,9,6,5,4,0,0,0,49
11,14,9,6,5,6,21,12,0,84
11,14,9,6,5,12,5,19,19,100
11,14,9,6,5,12,9,11,5,82
11,14,9,6,5,13,1,14,0,73
11,14,9,6,5,18,0,0,0,63
11,14,9,6,5,18,5,19,20,107
11,14,9,6,5,18,19,0,0,82
11,14,9,6,5,19,0,0,0,64
11,14,9,6,5,23,1,25,0,94
11,14,9,6,9,14,7,0,0,70
11,14,9,6,9,14,7,19,0,89
11,14,9,7,8,20,1,7,5,82
11,14,9,7,8,20,5,4,0,78
11,14,9,7,8,20,5,19,19,112
11,14,9,7,8,20,9,14,7,99
11,14,9,7,8,20,12,25,0,106
11,14,9,7,8,20,19,0,0,88
11,14,9,19,8,0,0,0,0,61
11,14,9,19,8,5,19,0,0,85
11,14,25,19,14,1,0,0,0,84
11,14,9,20,0,0,0,0,0,54
11,14,9,20,2,1,3,11,0,71
11,14,9,20,3,8,0,0,0,65
11,14,9,20,19,0,0,0,0,73
11,14,9,20,19,20,5,18,0,116
11,14,9,20,20,1,2,12,5,94
11,14,9,20,20,5,4,0,0,83
11,14,9,20,20,5,18,19,0,116
11,14,9,20,20,9,5,0,0,88
11,14,9,20,20,9,14,7,0,104
11,14,9,20,20,9,14,7,19,123
11,14,9,20,20,12,5,0,0,91
11,14,9,20,23,5,1,18,0,101
11,14,9,20,23,5,1,18,19,120
11,14,9,20,23,5,5,4,0,91
11,14,9,20,23,15,18,11,0,121
11,14,9,22,5,0,0,0,0,61
11,14,9,22,5,4,0,0,0,65
11,14,9,22,5,25,0,0,0,86
11,14,9,22,5,19,0,0,0,80
11,14,15,2,0,0,0,0,0,42
11,14,15,2,2,5,4,0,0,53
11,14,15,2,2,5,18,0,0,67
11,14,15,2,2,25,0,0,0,69
11,14,15,2,2,9,5,18,0,76
11,14,15,2,2,9,5,19,20,97
11,14,15,2,2,9,14,7,0,74
11,14,15,2,2,12,5,0,0,61
11,14,15,2,2,12,5,4,0,65
11,14,15,2,2,12,5,18,0,79
11,14,15,2,2,12,25,0,0,81
11,14,15,2,2,12,9,5,18,88
11,14,15,2,2,12,9,14,7,86
11,14,15,2,11,5,18,18,25,119
11,14,15,2,12,9,11,5,0,79
11,14,15,2,19,0,0,0,0,61
11,14,15,2,19,20,9,3,11,104
11,14,15,2,19,20,15,14,5,115
11,14,15,2,21,12,1,18,0,94
11,14,15,2,23,5,5,4,0,79
11,14,15,2,23,15,15,4,0,99
11,14,15,3,11,0,0,0,0,54
11,14,15,3,11,1,23,1,25,104
11,14,15,3,11,4,15,23,14,110
11,14,15,3,11,5,4,0,0,63
11,14,15,3,11,5,18,0,0,77
11,14,15,3,11,5,18,19,0,96
11,14,15,3,11,9,14,7,0,84
11,14,15,3,11,9,14,7,19,103
11,14,15,3,11,12,5,19,19,109
11,14,15,3,11,15,6,6,0,81
11,14,15,3,11,15,6,6,19,100
11,14,15,3,11,15,21,20,0,110
11,14,15,3,11,15,21,20,19,129
11,14,15,3,11,19,0,0,0,73
11,14,15,3,11,21,16,0,0,91
11,14,15,9,20,0,0,0,0,69
11,14,15,12,12,5,4,0,0,73
11,14,15,12,12,5,18,0,0,87
11,14,15,12,12,5,18,19,0,106
11,14,15,12,12,25,0,0,0,89
11,14,15,12,12,9,14,7,0,94
11,14,15,12,12,19,0,0,0,83
11,14,15,16,0,0,0,0,0,56
11,14,15,16,9,20,5,0,0,90
11,14,15,16,16,5,4,0,0,81
11,14,15,16,16,5,18,0,0,95
11,14,15,16,16,25,0,0,0,97
11,14,15,16,16,9,5,0,0,86
11,14,15,16,19,0,0,0,0,75
11,14,15,16,23,5,5,4,0,93
11,14,15,18,8,1,1,14,0,82
11,14,15,18,8,13,14,0,0,93
11,14,15,18,18,0,0,0,0,76
11,14,15,19,16,0,0,0,0,75
11,14,15,19,16,5,4,0,0,84
11,14,15,19,16,19,0,0,0,94
11,14,15,20,0,0,0,0,0,60
11,14,15,20,2,5,18,18,25,128
11,14,15,20,7,18,1,19,19,124
11,14,15,20,8,5,1,4,0,78
11,14,15,20,8,15,12,5,0,100
11,14,15,20,8,15,12,5,19,119
11,14,15,20,8,15,18,14,0,115
11,14,15,20,12,5,19,19,0,115
11,14,15,20,12,9,11,5,0,97
11,14,15,20,18,15,15,20,0,128
11,14,15,20,19,0,0,0,0,79
11,14,15,20,20,5,4,0,0,89
11,14,15,20,20,5,18,0,0,103
11,14,15,20,20,5,18,19,0,122
11,14,15,20,20,25,0,0,0,105
11,14,15,20,20,9,5,18,0,112
11,14,15,20,20,9,5,19,20,133
11,14,15,20,20,9,12,25,0,126
11,14,15,20,20,9,14,7,0,110
11,14,15,20,23,5,5,4,0,97
11,14,15,20,23,5,5,4,19,116
11,14,15,20,23,15,18,11,0,127
11,14,15,20,23,15,18,20,0,136
11,14,15,21,20,0,0,0,0,81
11,14,15,21,20,5,4,0,0,90
11,14,15,21,20,9,14,7,0,111
11,14,15,21,20,19,0,0,0,100
11,14,15,23,0,0,0,0,0,63
11,14,15,23,1,2,12,5,0,83
11,14,15,23,5,0,0,0,0,68
11,14,15,23,5,18,0,0,0,86
11,14,15,23,5,18,19,0,0,105
11,14,15,23,5,20,8,0,0,96
11,14,15,23,8,15,23,0,0,109
11,14,15,23,8,15,23,19,0,128
11,14,15,23,9,14,7,0,0,93
11,14,15,23,9,14,7,5,18,116
11,14,15,23,9,14,7,12,25,130
11,14,15,23,9,14,7,19,0,112
11,14,15,23,12,5,4,7,5,96
11,14,15,23,14,0,0,0,0,77
11,14,15,23,14,19,0,0,0,96
11,14,15,23,16,5,18,20,19,141
11,14,15,23,19,0,0,0,0,82
11,14,21,2,0,0,0,0,0,48
11,14,21,2,2,25,0,0,0,75
11,14,21,2,2,9,5,18,0,82
11,14,21,2,2,9,5,19,20,103
11,14,21,2,2,12,25,0,0,87
11,14,21,2,12,5,20,0,0,85
11,14,21,3,11,12,5,0,0,77
11,14,21,3,11,12,5,4,0,81
11,14,21,3,11,12,5,18,0,95
11,14,21,3,11,12,5,18,19,114
11,14,21,3,11,12,5,19,0,96
11,14,21,3,11,12,25,0,0,97
11,14,21,3,11,12,9,5,18,104
11,14,21,3,11,12,9,14,7,102
11,14,21,3,11,19,0,0,0,79
11,14,21,6,6,5,0,0,0,63
11,14,21,12,12,9,14,7,0,100
11,14,21,18,0,0,0,0,0,64
11,14,21,18,12,0,0,0,0,76
11,14,21,18,12,5,4,0,0,85
11,14,21,18,12,25,0,0,0,101
11,14,21,18,12,9,5,18,0,108
11,14,21,18,12,9,5,19,20,129
11,14,21,18,12,9,14,0,0,99
11,14,21,18,12,9,14,7,0,106
11,14,21,18,12,19,0,0,0,95
11,14,21,18,18,25,0,0,0,107
11,14,21,18,19,0,0,0,0,83
11,14,21,20,20,25,0,0,0,111
11,15,2,0,0,0,0,0,0,28
11,15,2,1,14,0,0,0,0,43
11,15,2,1,14,7,0,0,0,50
11,15,2,5,12,12,9,20,5,91
11,15,2,9,18,4,0,0,0,59
11,15,2,15,0,0,0,0,0,43
11,15,2,15,12,4,0,0,0,59
11,15,2,15,12,4,19,0,0,78
11,15,2,15,14,7,0,0,0,64
11,15,2,19,0,0,0,0,0,47
11,15,2,21,0,0,0,0,0,49
11,15,4,1,0,0,0,0,0,31
11,15,4,1,11,5,18,0,0,65
11,15,4,1,11,9,19,20,0,90
11,15,4,1,11,11,5,4,0,62
11,15,4,1,11,11,9,14,7,83
11,15,4,1,11,18,25,0,0,85
11,15,4,11,15,4,0,0,0,60
11,15,4,15,7,21,0,0,0,73
11,15,4,18,15,0,0,0,0,63
11,15,4,21,18,9,20,5,0,103
11,15,5,12,0,0,0,0,0,43
11,15,5,12,19,0,0,0,0,62
11,15,5,14,5,14,9,20,5,98
11,15,6,6,0,0,0,0,0,38
11,15,6,20,0,0,0,0,0,52
11,15,6,20,1,0,0,0,0,53
11,15,6,20,7,1,18,0,0,78
11,15,6,20,7,1,18,9,0,87
11,15,7,1,9,0,0,0,0,43
11,15,7,1,19,9,14,0,0,76
11,15,8,5,11,15,8,5,0,78
11,15,8,5,13,16,0,0,0,68
11,15,8,12,18,1,2,9,0,76
11,15,8,12,19,0,0,0,0,65
11,15,8,21,1,0,0,0,0,56
11,15,9,0,0,0,0,0,0,35
11,15,25,1,14,0,0,0,0,66
11,15,25,5,13,19,8,9,0,105
11,15,9,12,0,0,0,0,0,47
11,15,9,12,1,0,0,0,0,48
11,15,9,12,15,14,0,0,0,76
11,15,9,13,5,19,9,19,0,100
11,15,9,14,5,19,0,0,0,73
11,15,9,14,15,14,0,0,0,78
11,15,9,14,15,14,9,1,0,88
11,15,10,1,14,7,0,0,0,58
11,15,10,9,13,1,0,0,0,59
11,15,10,9,18,9,0,0,0,72
11,15,11,1,11,15,0,0,0,64
11,15,11,1,13,0,0,0,0,51
11,15,11,1,13,1,0,0,0,52
11,15,11,1,14,0,0,0,0,52
11,15,11,1,14,5,5,0,0,62
11,15,11,1,14,5,5,19,0,81
11,15,11,5,18,2,15,15,13,105
11,15,11,9,1,0,0,0,0,47
11,15,11,9,12,0,0,0,0,58
11,15,11,9,12,1,0,0,0,59
11,15,11,9,15,0,0,0,0,61
11,15,11,12,1,19,0,0,0,69
11,15,11,12,1,19,19,0,0,88
11,15,11,15,2,5,8,0,0,67
11,15,11,15,15,14,0,0,0,81
11,15,11,15,16,21,0,0,0,89
11,15,11,15,19,0,0,0,0,71
11,15,11,15,23,1,9,0,0,85
11,15,11,18,1,0,0,0,0,56
11,15,11,19,1,7,8,25,26,123
11,15,11,19,1,7,25,26,0,115
11,15,11,19,20,1,4,0,0,81
11,15,11,20,1,9,20,5,0,92
11,15,11,21,0,0,0,0,0,58
11,15,11,21,13,0,0,0,0,71
11,15,11,21,13,9,14,0,0,94
11,15,12,1,3,8,0,0,0,50
11,15,12,1,3,11,25,0,0,78
11,15,12,1,19,0,0,0,0,58
11,15,12,1,20,20,1,13,0,93
11,15,12,2,1,19,9,0,0,69
11,15,12,2,1,19,9,19,0,88
11,15,12,2,1,19,19,9,0,88
11,15,12,5,1,0,0,0,0,44
11,15,12,5,18,15,7,1,0,84
11,15,12,8,15,26,0,0,0,87
11,15,12,8,15,26,5,19,0,111
11,15,12,8,15,26,25,0,0,112
11,15,12,9,14,19,11,9,0,100
11,15,12,9,14,19,11,25,0,116
11,15,12,11,8,15,19,0,0,91
11,15,12,11,8,15,19,5,19,115
11,15,12,11,8,15,19,25,0,116
11,15,12,11,8,15,26,0,0,98
11,15,12,11,8,15,26,5,19,122
11,15,12,11,8,15,26,25,0,123
11,15,12,11,11,1,0,0,0,61
11,15,12,11,15,26,0,0,0,90
11,15,12,11,15,26,5,19,0,114
11,15,12,11,15,26,25,0,0,115
11,15,12,12,1,19,20,0,0,90
11,15,12,12,1,19,20,5,18,113
11,15,12,15,0,0,0,0,0,53
11,15,12,15,2,9,1,0,0,65
11,15,12,15,2,9,15,14,0,93
11,15,12,15,2,21,19,0,0,95
11,15,12,15,11,15,12,15,0,106
11,15,12,15,19,0,0,0,0,72
11,15,12,19,11,9,20,5,0,102
11,15,12,19,21,14,0,0,0,92
11,15,12,20,21,14,14,1,0,108
11,15,12,20,21,14,14,15,18,140
11,15,13,1,18,3,8,0,0,69
11,15,13,1,20,9,11,0,0,80
11,15,13,1,20,9,11,19,0,99
11,15,13,2,21,0,0,0,0,62
11,15,13,9,14,21,20,5,18,126
11,15,13,9,20,1,4,10,9,92
11,15,13,9,20,1,10,9,0,88
11,15,13,13,5,20,10,5,0,92
11,15,13,13,15,19,0,0,0,86
11,15,13,16,5,14,9,0,0,83
11,15,13,16,15,23,0,0,0,93
11,15,13,20,15,11,0,0,0,85
11,15,14,0,0,0,0,0,0,40
11,15,14,1,11,0,0,0,0,52
11,15,14,4,15,0,0,0,0,59
11,15,14,6,25,20,0,0,0,91
11,15,14,7,15,14,9,0,0,85
11,15,14,7,21,0,0,0,0,68
11,15,14,9,12,9,20,5,0,95
11,15,14,9,13,5,20,5,18,110
11,15,14,9,14,9,0,0,0,72
11,15,14,9,15,12,15,7,25,123
11,15,14,9,19,3,15,16,5,107
11,15,14,10,1,11,0,0,0,62
11,15,14,11,0,0,0,0,0,51
11,15,14,11,5,4,0,0,0,60
11,15,14,11,9,14,7,0,0,81
11,15,14,11,19,0,0,0,0,70
11,15,14,15,8,9,11,9,0,92
11,15,14,19,5,1,12,0,0,77
11,15,14,20,1,11,9,1,0,82
11,15,14,20,1,11,9,15,14,110
11,15,15,4,15,15,0,0,0,75
11,15,15,4,15,15,19,0,0,94
11,15,15,11,0,0,0,0,0,52
11,15,15,11,1,0,0,0,0,53
11,15,15,11,5,18,5,5,0,85
11,15,15,11,5,18,25,0,0,100
11,15,15,11,25,0,0,0,0,77
11,15,15,11,9,5,0,0,0,66
11,15,15,11,9,5,18,0,0,84
11,15,15,11,9,5,19,20,0,105
11,15,15,11,9,14,5,19,19,118
11,15,15,11,18,9,0,0,0,79
11,15,15,11,19,0,0,0,0,71
11,15,15,12,1,8,0,0,0,62
11,15,15,12,1,21,0,0,0,75
11,15,15,12,5,20,1,8,0,87
11,15,15,12,9,13,1,14,0,90
11,15,15,13,2,1,18,0,0,75
11,15,15,13,11,9,5,0,0,79
11,15,15,14,20,9,0,0,0,84
11,15,15,16,2,18,9,5,6,97
11,15,15,18,1,10,15,14,7,106
11,15,15,18,8,13,14,0,0,94
11,15,15,18,11,1,0,0,0,71
11,15,15,19,9,14,0,0,0,83
11,15,15,20,3,8,1,0,0,73
11,15,15,20,3,8,1,18,0,91
11,15,16,0,0,0,0,0,0,42
11,15,16,5,3,0,0,0,0,50
11,15,16,5,3,11,0,0,0,61
11,15,16,5,3,11,19,0,0,80
11,15,16,5,11,0,0,0,0,58
11,15,16,5,11,19,0,0,0,77
11,15,16,6,18,9,14,7,0,96
11,15,16,8,0,0,0,0,0,50
11,15,16,8,19,0,0,0,0,69
11,15,16,9,0,0,0,0,0,51
11,15,16,9,19,0,0,0,0,70
11,15,16,10,5,0,0,0,0,57
11,15,16,10,5,19,0,0,0,76
11,15,16,16,1,0,0,0,0,59
11,15,16,16,1,19,0,0,0,78
11,15,16,16,5,14,0,0,0,77
11,15,16,16,9,5,0,0,0,72
11,15,16,16,9,5,19,0,0,91
11,15,16,16,9,20,5,0,0,92
11,15,16,19,0,0,0,0,0,61
11,15,18,0,0,0,0,0,0,44
11,15,18,1,4,10,9,0,0,68
11,15,18,1,9,0,0,0,0,54
11,15,18,1,9,20,0,0,0,74
11,15,18,1,11,1,14,0,0,71
11,15,18,1,18,9,0,0,0,72
11,15,18,1,20,0,0,0,0,65
11,15,18,1,20,19,0,0,0,84
11,15,18,4,1,24,0,0,0,73
11,15,18,5,1,14,19,0,0,83
11,15,18,5,3,0,0,0,0,52
11,15,18,5,3,9,0,0,0,61
11,15,18,5,18,15,0,0,0,82
11,15,18,6,2,1,12,12,0,77
11,15,18,8,13,14,0,0,0,79
11,15,18,9,13,1,11,15,0,93
11,15,18,25,13,2,15,9,0,108
11,15,18,25,13,2,15,19,0,118
11,15,18,9,14,0,0,0,0,67
11,15,18,13,1,0,0,0,0,58
11,15,18,14,20,15,14,4,5,116
11,15,18,14,20,21,14,14,1,128
11,15,18,15,13,9,11,1,0,93
11,15,18,15,13,9,11,15,0,107
11,15,18,15,14,1,0,0,0,74
11,15,18,15,22,1,0,0,0,82
11,15,18,18,5,12,0,0,0,79
11,15,18,18,9,7,1,14,0,93
11,15,18,18,9,7,21,13,0,112
11,15,18,19,0,0,0,0,0,63
11,15,18,19,1,11,15,6,6,102
11,15,18,19,1,11,15,23,0,113
11,15,18,21,14,0,0,0,0,79
11,15,18,21,14,1,0,0,0,80
11,15,18,21,14,1,19,0,0,99
11,15,18,21,14,25,0,0,0,104
11,15,18,26,5,3,0,0,0,78
11,15,19,8,1,0,0,0,0,54
11,15,19,8,1,18,5,0,0,77
11,15,19,8,5,18,0,0,0,76
11,15,19,8,5,18,5,4,0,85
11,15,19,8,5,18,9,14,7,106
11,15,19,8,5,18,19,0,0,95
11,15,19,9,14,0,0,0,0,68
11,15,19,15,14,7,0,0,0,81
11,15,19,15,19,0,0,0,0,79
11,15,19,15,20,15,24,9,14,142
11,15,19,23,9,20,5,0,0,102
11,15,20,1,12,0,0,0,0,59
11,15,20,25,12,5,0,0,0,88
11,15,20,25,12,15,19,0,0,117
11,15,20,15,0,0,0,0,0,61
11,15,20,15,9,20,5,0,0,95
11,15,20,15,19,0,0,0,0,80
11,15,20,15,23,0,0,0,0,84
11,15,20,15,23,5,4,0,0,93
11,15,20,15,23,5,18,0,0,107
11,15,20,15,23,5,18,19,0,126
11,15,20,15,23,9,14,7,0,114
11,15,20,15,23,19,0,0,0,103
11,15,20,20,1,2,15,9,0,93
11,15,20,20,1,2,15,19,0,103
11,15,20,20,9,7,9,20,5,116
11,15,20,21,11,21,0,0,0,99
11,15,20,23,1,12,0,0,0,82
11,15,20,23,1,12,5,5,0,92
11,15,20,23,1,12,9,0,0,91
11,15,21,0,0,0,0,0,0,47
11,15,21,12,1,14,0,0,0,74
11,15,21,13,9,19,0,0,0,88
11,15,21,13,25,19,0,0,0,104
11,15,21,13,9,19,5,19,0,112
11,15,21,13,25,19,5,19,0,128
11,15,21,13,9,19,19,0,0,107
11,15,21,13,25,19,19,0,0,123
11,15,21,13,9,19,19,5,19,131
11,15,21,13,25,19,19,5,19,147
11,15,21,16,18,5,25,0,0,111
11,15,21,16,18,5,25,19,0,130
11,15,21,16,18,15,8,0,0,104
11,15,21,18,2,1,19,8,0,95
11,15,21,18,15,9,0,0,0,89
11,15,21,18,15,19,0,0,0,99
11,15,21,19,9,14,0,0,0,89
11,15,21,19,19,9,14,0,0,108
11,15,21,19,19,15,0,0,0,100
11,15,21,19,19,15,19,0,0,119
11,15,21,26,1,0,0,0,0,74
11,15,22,9,12,0,0,0,0,69
11,15,23,2,9,18,4,0,0,82
11,15,23,8,1,9,0,0,0,67
11,15,23,20,15,23,0,0,0,107
11,15,23,20,15,23,5,4,0,116
11,15,23,20,15,23,5,18,0,130
11,15,23,20,15,23,5,18,19,149
11,15,23,20,15,23,9,14,7,137
11,15,23,20,15,23,19,0,0,126
11,15,26,15,0,0,0,0,0,67
11,15,26,21,11,1,0,0,0,85
11,16,3,0,0,0,0,0,0,30
11,16,8,0,0,0,0,0,0,35
11,18,5,1,20,9,3,0,0,67
11,18,5,5,16,0,0,0,0,55
11,18,5,5,16,19,0,0,0,74
11,18,5,5,19,5,0,0,0,63
11,18,5,9,12,0,0,0,0,55
11,18,5,9,19,20,12,5,0,99
11,18,5,9,20,26,13,1,14,117
11,18,5,12,15,19,0,0,0,80
11,18,5,13,12,9,14,19,0,101
11,18,5,14,7,0,0,0,0,55
11,18,5,15,19,15,20,5,0,108
11,18,5,16,9,19,0,0,0,78
11,18,5,16,12,1,3,8,0,74
11,18,5,16,12,5,3,8,0,78
11,18,5,21,20,26,5,18,19,143
11,18,5,21,26,5,18,0,0,104
11,18,5,21,26,5,18,19,0,123
11,18,9,5,11,5,18,0,0,77
11,18,9,11,15,18,9,1,14,106
11,18,9,12,12,0,0,0,0,62
11,18,9,12,12,19,0,0,0,81
11,18,9,13,13,5,18,0,0,87
11,18,9,13,13,5,18,19,0,106
11,18,9,14,1,0,0,0,0,53
11,18,25,15,12,9,20,5,0,115
11,18,25,15,12,9,20,5,19,134
11,18,25,15,12,9,20,8,0,118
11,18,25,15,12,9,20,8,19,137
11,18,25,16,19,9,19,0,0,117
11,18,25,16,20,9,3,0,0,102
11,18,25,16,20,15,12,0,0,117
11,18,25,16,20,15,14,0,0,119
11,18,25,16,20,15,14,19,0,138
11,18,9,19,5,19,0,0,0,81
11,18,9,19,16,9,5,19,0,106
11,18,9,20,1,18,3,8,25,113
11,18,9,20,15,14,0,0,0,87
11,18,9,20,18,9,13,1,0,99
11,18,9,22,21,0,0,0,0,81
11,18,14,1,0,0,0,0,0,44
11,18,15,2,25,12,15,9,0,107
11,18,15,2,25,12,15,19,0,117
11,18,15,3,11,5,20,0,0,83
11,18,15,8,14,11,9,20,5,111
11,18,15,13,5,0,0,0,0,62
11,18,15,13,5,19,11,9,0,101
11,18,15,13,5,19,11,25,0,117
11,18,15,13,15,7,18,1,13,111
11,18,15,13,19,11,15,16,0,118
11,18,15,14,1,0,0,0,0,59
11,18,15,14,5,0,0,0,0,63
11,18,15,14,5,14,0,0,0,77
11,18,15,14,5,18,0,0,0,81
11,18,15,14,15,18,0,0,0,91
11,18,15,14,21,18,0,0,0,97
11,18,15,15,14,0,0,0,0,73
11,18,15,15,14,9,0,0,0,82
11,18,15,15,14,19,0,0,0,92
11,18,15,19,1,0,0,0,0,64
11,18,15,21,3,8,11,1,0,88
11,18,15,21,19,8,11,1,0,104
11,18,19,0,0,0,0,0,0,48
11,18,21,2,9,0,0,0,0,61
11,18,21,2,9,19,0,0,0,80
11,18,21,2,21,20,0,0,0,93
11,18,21,2,21,20,19,0,0,112
11,18,21,12,12,5,18,0,0,97
11,18,21,12,12,5,18,19,0,116
11,18,21,13,8,15,18,14,0,118
11,18,21,13,13,8,15,18,14,131
11,18,26,25,19,26,20,15,6,166
11,19,9,0,0,0,0,0,0,39
11,20,8,9,2,8,0,0,0,58
11,21,2,2,1,0,0,0,0,37
11,21,2,15,14,7,0,0,0,70
11,21,2,21,11,12,9,15,14,116
11,21,3,8,5,14,0,0,0,62
11,21,3,8,5,14,19,0,0,81
11,21,4,9,26,5,0,0,0,76
11,21,4,15,0,0,0,0,0,51
11,21,4,15,19,0,0,0,0,70
11,21,4,21,0,0,0,0,0,57
11,21,4,21,19,0,0,0,0,76
11,21,4,26,21,0,0,0,0,83
11,21,4,26,21,19,0,0,0,102
11,21,5,0,0,0,0,0,0,37
11,21,5,8,0,0,0,0,0,45
11,21,5,9,0,0,0,0,0,46
11,21,5,19,0,0,0,0,0,56
11,21,6,6,9,5,8,0,0,66
11,21,6,9,25,5,8,0,0,85
11,21,7,5,0,0,0,0,0,44
11,21,7,5,12,0,0,0,0,56
11,21,7,5,12,8,15,6,0,85
11,21,7,5,12,19,0,0,0,75
11,21,9,3,8,21,1,0,0,74
11,21,10,1,23,9,1,11,0,87
11,21,11,1,14,7,0,0,0,65
11,21,11,5,18,9,0,0,0,75
11,21,11,15,12,9,14,5,0,98
11,21,11,18,9,0,0,0,0,70
11,21,11,18,9,19,0,0,0,89
11,21,11,21,0,0,0,0,0,64
11,21,11,21,9,0,0,0,0,73
11,21,11,21,16,1,0,0,0,81
11,21,12,1,3,11,0,0,0,59
11,21,12,1,9,20,5,0,0,79
11,21,12,1,11,0,0,0,0,56
11,21,12,1,11,9,0,0,0,65
11,21,12,1,11,9,19,13,0,97
11,21,12,1,11,19,0,0,0,75
11,21,12,1,14,0,0,0,0,59
11,21,12,1,14,7,0,0,0,66
11,21,12,4,9,16,0,0,0,73
11,21,12,9,13,9,20,0,0,95
11,21,12,11,1,18,14,9,0,97
11,21,12,12,1,9,20,5,0,91
11,21,12,13,5,20,0,0,0,82
11,21,12,20,21,18,19,0,0,122
11,21,13,1,18,1,0,0,0,65
11,21,13,1,18,9,0,0,0,73
11,21,13,2,1,12,15,9,0,84
11,21,13,2,9,0,0,0,0,56
11,21,13,2,21,11,0,0,0,79
11,21,13,8,1,18,0,0,0,72
11,21,13,9,19,0,0,0,0,73
11,21,13,25,19,0,0,0,0,89
11,21,13,25,19,5,19,0,0,113
11,21,13,9,19,19,0,0,0,92
11,21,13,9,19,19,5,19,0,116
11,21,13,11,21,13,0,0,0,90
11,21,13,13,5,12,19,0,0,94
11,21,13,13,9,14,15,19,20,135
11,21,13,17,21,1,20,0,0,104
11,21,13,17,21,1,20,19,0,123
11,21,13,18,1,8,0,0,0,72
11,21,13,19,8,1,23,0,0,96
11,21,14,1,9,0,0,0,0,56
11,21,14,4,1,12,9,14,9,95
11,21,14,11,0,0,0,0,0,57
11,21,14,11,21,18,0,0,0,96
11,21,14,23,1,18,9,0,0,97
11,21,14,26,9,20,5,0,0,106
11,21,14,26,9,20,5,19,0,125
11,21,16,8,1,18,0,0,0,75
11,21,16,16,5,18,0,0,0,87
11,21,18,1,10,15,14,7,0,97
11,21,18,2,1,19,8,0,0,80
11,21,18,2,1,19,8,5,4,89
11,21,18,2,1,19,8,5,19,104
11,21,18,3,8,9,14,5,0,89
11,21,18,7,1,14,19,0,0,91
11,21,18,9,11,1,20,1,0,92
11,21,18,13,2,21,18,18,1,123
11,21,18,14,0,0,0,0,0,64
11,21,18,18,1,10,15,14,7,115
11,21,18,19,3,8,0,0,0,80
11,21,18,20,1,0,0,0,0,71
11,21,18,20,1,19,0,0,0,90
11,21,18,20,15,19,9,19,0,132
11,21,18,21,0,0,0,0,0,71
11,21,18,21,13,1,0,0,0,85
11,21,18,21,13,1,25,1,0,111
11,21,18,21,14,7,0,0,0,92
11,21,18,22,5,25,0,0,0,102
11,21,18,22,5,25,15,18,0,135
11,21,19,1,0,0,0,0,0,52
11,21,19,1,13,0,0,0,0,65
11,21,19,8,1,0,0,0,0,60
11,21,19,9,13,1,14,19,5,112
11,21,19,11,9,20,5,0,0,96
11,21,19,11,15,19,0,0,0,96
11,21,19,11,21,19,0,0,0,102
11,21,19,19,15,0,0,0,0,85
11,21,19,19,15,19,0,0,0,104
11,21,19,20,9,0,0,0,0,80
11,21,19,21,13,0,0,0,0,85
11,21,20,3,8,1,0,0,0,64
11,21,20,20,1,0,0,0,0,73
11,21,20,20,1,2,0,0,0,75
11,21,20,20,1,18,0,0,0,91
11,21,20,20,1,21,18,0,0,112
11,21,22,1,19,26,0,0,0,100
11,21,22,1,19,26,15,11,0,126
11,22,5,20,3,8,0,0,0,69
11,22,5,20,3,8,5,4,0,78
11,22,5,20,3,8,5,19,0,93
11,22,5,20,3,8,9,14,7,99
11,22,9,14,20,0,0,0,0,76
11,22,9,14,20,5,18,0,0,99
11,22,21,20,26,1,0,0,0,101
11,22,21,20,26,1,8,0,0,109
11,23,5,12,1,0,0,0,0,52
11,23,8,18,0,0,0,0,0,60
11,23,9,14,20,18,1,0,0,96
12,2,6,0,0,0,0,0,0,20
12,2,9,14,9,20,0,0,0,66
12,2,23,0,0,0,0,0,0,37
12,3,15,14,22,5,18,20,0,109
12,3,19,25,13,2,15,12,0,101
12,4,9,14,6,15,0,0,0,60
12,5,2,2,1,14,0,0,0,36
12,5,2,2,5,11,0,0,0,37
12,5,2,5,14,0,0,0,0,38
12,5,2,5,14,19,0,0,0,57
12,5,2,5,19,0,0,0,0,43
12,5,2,8,1,6,20,0,0,54
12,5,2,11,21,3,8,5,14,81
12,5,2,18,1,14,3,8,15,78
12,5,3,1,13,1,0,0,0,35
12,5,3,1,14,9,9,4,0,57
12,5,3,1,14,9,14,5,0,63
12,5,3,1,14,15,18,9,3,80
12,5,3,8,1,25,9,13,0,76
12,5,3,8,1,25,9,13,19,95
12,5,3,8,5,0,0,0,0,33
12,5,3,8,5,4,0,0,0,37
12,5,3,8,5,18,0,0,0,51
12,5,3,8,5,18,5,4,0,60
12,5,3,8,5,18,5,18,0,74
12,5,3,8,5,18,25,0,0,76
12,5,3,8,5,18,9,5,19,84
12,5,3,8,5,18,9,14,7,81
12,5,3,8,5,18,15,21,19,106
12,5,3,8,5,18,19,0,0,70
12,5,3,8,5,19,0,0,0,52
12,5,3,8,9,14,7,0,0,58
12,5,3,8,15,19,1,0,0,63
12,5,3,8,23,5,0,0,0,56
12,5,3,9,4,5,9,14,5,66
12,5,3,9,4,9,15,9,4,70
12,5,3,25,20,8,0,0,0,73
12,5,3,9,20,8,1,12,0,70
12,5,3,25,20,8,9,0,0,82
12,5,3,9,20,8,9,3,0,69
12,5,3,25,20,8,9,4,0,86
12,5,3,9,20,8,9,14,0,80
12,5,3,9,20,8,9,14,19,99
12,5,3,25,20,8,15,9,0,97
12,5,3,9,20,8,15,9,4,85
12,5,3,25,20,8,15,9,4,101
12,5,3,25,20,8,21,19,0,113
12,5,3,11,0,0,0,0,0,31
12,5,3,11,5,18,0,0,0,54
12,5,3,15,14,20,9,20,5,103
12,5,3,20,0,0,0,0,0,40
12,5,3,20,5,18,14,0,0,77
12,5,3,20,5,18,14,19,0,96
12,5,3,20,8,9,0,0,0,57
12,5,3,20,9,3,1,0,0,53
12,5,3,20,9,14,0,0,0,63
12,5,3,20,9,14,19,0,0,82
12,5,3,20,9,15,14,0,0,78
12,5,3,20,9,15,14,19,0,97
12,5,3,20,15,18,0,0,0,73
12,5,3,20,15,18,1,20,5,99
12,5,3,20,15,18,9,1,12,95
12,5,3,20,15,18,19,0,0,92
12,5,3,20,15,20,25,16,5,121
12,5,3,20,18,5,19,19,0,101
12,5,3,20,18,9,3,5,0,75
12,5,3,20,21,1,12,0,0,74
12,5,3,20,21,1,18,25,0,105
12,5,3,20,21,18,5,0,0,84
12,5,3,20,21,18,5,4,0,88
12,5,3,20,21,18,5,5,0,89
12,5,3,20,21,18,5,18,0,102
12,5,3,20,21,18,5,18,19,121
12,5,3,20,21,18,5,19,0,103
12,5,3,20,21,18,5,19,19,122
12,5,3,20,21,18,9,14,7,109
12,5,3,20,21,18,14,0,0,93
12,5,4,5,0,0,0,0,0,26
12,5,4,5,14,0,0,0,0,40
12,5,4,5,18,9,20,5,0,78
12,5,4,7,5,0,0,0,0,33
12,5,4,7,5,4,0,0,0,37
12,5,4,7,5,12,5,19,19,88
12,5,4,7,5,13,1,14,0,61
12,5,4,7,5,13,5,14,20,85
12,5,4,7,5,18,4,15,13,83
12,5,4,7,5,18,5,4,0,60
12,5,4,7,5,18,9,14,7,81
12,5,4,7,5,18,19,0,0,70
12,5,4,7,5,19,0,0,0,52
12,5,4,7,5,20,0,0,0,53
12,5,4,7,25,0,0,0,0,53
12,5,4,7,9,5,18,0,0,60
12,5,4,7,9,5,19,20,0,81
12,5,4,7,9,14,7,0,0,58
12,5,4,7,13,5,14,20,0,80
12,5,4,15,12,0,0,0,0,48
12,5,4,19,0,0,0,0,0,40
12,5,5,1,14,7,12,5,0,61
12,5,5,2,15,1,18,4,0,62
12,5,5,2,15,1,18,4,19,81
12,5,5,3,8,0,0,0,0,33
12,5,5,3,8,4,15,13,0,65
12,5,5,3,8,5,4,0,0,42
12,5,5,3,8,5,18,0,0,56
12,5,5,3,8,5,18,25,0,81
12,5,5,3,8,5,19,0,0,57
12,5,5,3,8,9,14,7,0,63
12,5,5,3,8,11,9,14,0,67
12,5,5,3,8,12,9,11,5,70
12,5,5,3,8,13,1,14,0,61
12,5,5,3,8,23,15,18,20,109
12,5,5,4,0,0,0,0,0,26
12,5,5,6,0,0,0,0,0,28
12,5,5,6,1,14,7,0,0,50
12,5,5,6,1,14,7,5,0,55
12,5,5,6,20,1,9,12,0,70
12,5,5,6,21,12,0,0,0,61
12,5,5,6,21,12,12,25,0,98
12,5,5,7,20,5,0,0,0,54
12,5,5,11,0,0,0,0,0,33
12,5,5,11,25,0,0,0,0,58
12,5,5,11,9,19,8,0,0,69
12,5,5,11,19,0,0,0,0,52
12,5,5,12,1,14,5,0,0,54
12,5,5,12,1,14,7,0,0,56
12,5,5,16,0,0,0,0,0,38
12,5,5,16,9,20,0,0,0,67
12,5,5,18,0,0,0,0,0,40
12,5,5,18,5,4,0,0,0,49
12,5,5,18,6,9,19,8,0,82
12,5,5,18,25,0,0,0,0,65
12,5,5,18,9,5,18,0,0,72
12,5,5,18,9,5,19,20,0,93
12,5,5,18,9,12,25,0,0,86
12,5,5,18,9,14,5,19,19,106
12,5,5,18,9,14,7,0,0,70
12,5,5,18,9,14,7,12,25,107
12,5,5,18,9,19,8,0,0,76
12,5,5,18,14,5,19,19,0,97
12,5,5,18,15,23,1,25,0,104
12,5,5,18,19,0,0,0,0,59
12,5,5,19,0,0,0,0,0,41
12,5,5,19,5,18,0,0,0,64
12,5,5,19,8,25,25,0,0,99
12,5,5,19,9,14,7,0,0,71
12,5,5,19,15,13,5,0,0,74
12,5,5,19,15,13,5,12,25,111
12,5,5,20,12,5,0,0,0,59
12,5,5,20,13,1,14,0,0,70
12,5,5,20,13,5,14,0,0,74
12,5,5,20,19,0,0,0,0,61
12,5,5,23,1,25,0,0,0,71
12,5,5,23,1,25,19,0,0,90
12,5,5,23,1,14,0,0,0,60
12,5,5,23,1,18,4,0,0,68
12,5,5,23,1,18,4,12,25,105
12,5,5,23,1,18,4,19,0,87
12,5,5,23,9,12,12,0,0,78
12,5,6,19,5,12,0,0,0,59
12,5,6,19,5,14,0,0,0,61
12,5,6,20,0,0,0,0,0,43
12,5,6,20,5,18,0,0,0,66
12,5,6,20,5,19,20,0,0,87
12,5,6,20,9,5,19,0,0,76
12,5,6,20,9,19,8,0,0,79
12,5,6,20,9,19,13,0,0,84
12,5,6,20,9,19,13,19,0,103
12,5,6,20,9,19,20,19,0,110
12,5,6,20,13,5,14,20,19,114
12,5,6,20,13,15,19,20,0,110
12,5,6,20,14,5,19,19,0,100
12,5,6,20,15,22,5,18,0,103
12,5,6,20,15,22,5,18,19,122
12,5,6,20,19,0,0,0,0,62
12,5,6,20,23,1,18,4,0,89
12,5,6,20,23,1,18,4,19,108
12,5,6,20,23,9,14,7,0,96
12,5,7,0,0,0,0,0,0,24
12,5,7,1,3,25,0,0,0,53
12,5,7,1,3,9,5,19,0,61
12,5,7,1,12,0,0,0,0,37
12,5,7,1,12,5,19,5,0,66
12,5,7,1,12,5,19,5,19,85
12,5,7,1,12,9,19,5,0,70
12,5,7,1,12,9,19,5,4,74
12,5,7,1,12,9,19,5,19,89
12,5,7,1,12,9,19,13,0,78
12,5,7,1,12,9,19,13,19,97
12,5,7,1,12,9,19,20,0,85
12,5,7,1,12,9,19,20,19,104
12,5,7,1,12,9,20,25,0,91
12,5,7,1,12,9,26,5,0,77
12,5,7,1,12,9,26,5,4,81
12,5,7,1,12,9,26,5,19,96
12,5,7,1,12,12,25,0,0,74
12,5,7,1,12,14,5,19,19,94
12,5,7,1,12,19,0,0,0,56
12,5,7,1,14,20,9,14,5,87
12,5,7,1,20,1,18,25,0,89
12,5,7,1,20,5,0,0,0,50
12,5,7,1,20,5,4,0,0,54
12,5,7,1,20,5,5,0,0,55
12,5,7,1,20,5,5,19,0,74
12,5,7,1,20,5,19,0,0,69
12,5,7,1,20,9,0,0,0,54
12,5,7,1,20,9,14,5,0,73
12,5,7,1,20,9,14,7,0,75
12,5,7,1,20,9,15,14,0,83
12,5,7,1,20,9,15,14,19,102
12,5,7,1,20,9,22,5,0,81
12,5,7,1,20,15,0,0,0,60
12,5,7,1,20,15,18,0,0,78
12,5,7,1,20,15,18,25,0,103
12,5,7,1,20,15,18,19,0,97
12,5,7,1,20,15,19,0,0,79
12,5,7,1,20,21,18,5,0,89
12,5,7,1,20,21,19,0,0,85
12,5,7,2,1,18,0,0,0,45
12,5,7,5,0,0,0,0,0,29
12,5,7,5,14,4,0,0,0,47
12,5,7,5,14,4,1,0,0,48
12,5,7,5,14,4,1,18,25,91
12,5,7,5,14,4,9,3,0,59
12,5,7,5,14,4,9,19,20,95
12,5,7,5,14,4,9,26,5,87
12,5,7,5,14,4,18,25,0,90
12,5,7,5,14,4,19,0,0,66
12,5,7,5,18,5,20,5,0,77
12,5,7,5,18,9,20,25,0,101
12,5,7,5,18,19,0,0,0,66
12,5,7,5,19,0,0,0,0,48
12,5,7,7,5,4,0,0,0,40
12,5,7,7,5,18,0,0,0,54
12,5,7,7,25,0,0,0,0,56
12,5,7,7,9,5,18,0,0,63
12,5,7,7,9,5,18,15,0,78
12,5,7,7,9,5,19,20,0,84
12,5,7,7,9,14,0,0,0,54
12,5,7,7,9,14,5,19,19,97
12,5,7,7,9,14,7,0,0,61
12,5,7,7,9,14,7,5,4,70
12,5,7,7,9,14,7,19,0,80
12,5,7,7,9,14,19,0,0,73
12,5,7,8,15,18,14,19,0,98
12,5,7,9,2,12,5,0,0,52
12,5,7,9,2,12,25,0,0,72
12,5,7,9,6,5,18,0,0,62
12,5,7,9,6,9,3,0,0,51
12,5,7,9,15,14,0,0,0,62
12,5,7,9,15,14,1,18,25,106
12,5,7,9,15,14,5,4,0,71
12,5,7,9,15,14,5,18,0,85
12,5,7,9,15,14,18,25,0,105
12,5,7,9,15,14,19,0,0,81
12,5,7,9,19,12,1,20,5,90
12,5,7,9,19,20,0,0,0,72
12,5,7,9,19,20,5,18,0,95
12,5,7,9,19,20,19,0,0,91
12,5,7,9,20,0,0,0,0,53
12,5,7,9,20,9,13,0,0,75
12,5,7,9,20,9,13,5,0,80
12,5,7,9,20,9,13,21,13,109
12,5,7,9,20,19,0,0,0,72
12,5,7,12,5,14,0,0,0,55
12,5,7,12,5,19,19,0,0,79
12,5,7,12,5,20,0,0,0,61
12,5,7,12,9,11,5,0,0,61
12,5,7,13,1,14,0,0,0,52
12,5,7,13,5,14,0,0,0,56
12,5,7,15,1,0,0,0,0,40
12,5,7,15,14,7,0,0,0,60
12,5,7,15,14,7,19,0,0,79
12,5,7,16,9,5,3,5,0,62
12,5,7,16,21,12,12,0,0,85
12,5,7,16,21,12,12,5,18,108
12,5,7,18,5,20,5,0,0,72
12,5,7,18,15,15,13,0,0,85
12,5,7,18,15,15,13,19,0,104
12,5,7,18,15,16,5,0,0,78
12,5,7,19,0,0,0,0,0,43
12,5,7,21,1,0,0,0,0,46
12,5,7,21,1,14,0,0,0,60
12,5,7,21,12,5,9,1,14,86
12,5,7,21,13,5,0,0,0,63
12,5,7,21,13,5,12,9,14,98
12,5,7,21,13,5,14,0,0,77
12,5,7,21,13,5,19,0,0,82
12,5,7,21,13,9,14,0,0,81
12,5,7,21,13,9,14,19,0,100
12,5,7,23,15,18,11,0,0,91
12,5,7,23,15,18,11,19,0,110
12,5,8,1,25,0,0,0,0,51
12,5,8,1,25,9,13,0,0,73
12,5,8,1,25,9,13,19,0,92
12,5,8,13,5,18,0,0,0,61
12,5,8,18,13,1,14,0,0,71
12,5,8,18,13,5,14,0,0,75
12,5,8,18,19,0,0,0,0,62
12,5,8,18,19,13,1,14,0,90
12,5,8,18,19,13,5,14,0,94
12,5,8,21,1,0,0,0,0,47
12,5,8,21,1,19,0,0,0,66
12,5,9,0,0,0,0,0,0,26
12,5,9,6,9,20,5,0,0,66
12,5,9,7,5,18,0,0,0,56
12,5,25,12,1,14,4,0,0,73
12,5,9,13,20,25,16,5,0,105
12,5,9,15,3,15,13,5,0,77
12,5,9,15,13,25,15,13,1,108
12,5,25,19,0,0,0,0,0,61
12,5,25,19,9,14,7,0,0,91
12,5,9,19,19,0,0,0,0,64
12,5,9,19,20,5,18,0,0,88
12,5,9,19,20,5,18,5,4,97
12,5,9,19,20,5,18,5,18,111
12,5,9,19,20,5,18,19,0,107
12,5,9,19,21,18,1,2,5,92
12,5,9,19,21,18,5,0,0,89
12,5,9,19,21,18,5,4,0,93
12,5,9,19,21,18,5,12,25,126
12,5,9,19,21,18,5,19,0,108
12,5,9,20,13,15,20,9,6,109
12,5,9,20,13,15,20,9,22,125
12,5,11,1,3,8,0,0,0,40
12,5,11,1,14,1,9,0,0,53
12,5,11,1,14,5,0,0,0,48
12,5,11,5,0,0,0,0,0,33
12,5,11,8,1,0,0,0,0,37
12,5,11,25,20,8,9,0,0,90
12,5,11,25,20,8,15,9,0,105
12,5,11,25,20,8,15,19,0,115
12,5,11,25,20,8,21,19,0,121
12,5,11,11,5,18,0,0,0,62
12,5,11,19,0,0,0,0,0,47
12,5,11,21,0,0,0,0,0,49
12,5,11,22,1,18,0,0,0,69
12,5,11,22,1,18,19,0,0,88
12,5,12,23,5,12,0,0,0,69
12,5,13,1,14,18,25,0,0,88
12,5,13,1,14,19,0,0,0,64
12,5,13,5,0,0,0,0,0,35
12,5,13,5,12,0,0,0,0,47
12,5,13,13,1,0,0,0,0,44
12,5,13,13,1,19,0,0,0,63
12,5,13,13,1,20,1,0,0,65
12,5,13,13,1,20,9,26,5,104
12,5,13,13,9,14,7,0,0,73
12,5,13,13,9,14,7,19,0,92
12,5,13,13,9,20,9,19,0,100
12,5,13,13,15,3,25,20,5,111
12,5,13,14,1,4,0,0,0,49
12,5,13,14,9,19,3,9,0,84
12,5,13,14,9,19,3,21,19,115
12,5,13,15,7,18,1,0,0,71
12,5,13,15,12,15,7,25,0,104
12,5,13,15,14,1,4,5,0,69
12,5,13,15,14,1,4,5,19,88
12,5,13,15,14,1,4,15,0,79
12,5,13,15,14,6,9,19,8,101
12,5,13,15,14,25,0,0,0,84
12,5,13,15,14,9,19,8,0,95
12,5,13,15,14,12,9,11,5,96
12,5,13,15,14,19,0,0,0,78
12,5,13,15,14,23,5,5,4,96
12,5,13,15,14,23,15,15,4,116
12,5,13,16,9,18,1,0,0,74
12,5,13,16,9,18,1,19,0,93
12,5,13,21,18,0,0,0,0,69
12,5,13,21,18,5,19,0,0,93
12,5,13,21,18,9,4,0,0,82
12,5,13,21,18,9,14,5,0,97
12,5,13,21,18,12,9,11,5,106
12,5,13,21,18,15,9,4,0,97
12,5,13,21,18,15,9,4,19,116
12,5,13,21,18,19,0,0,0,88
12,5,14,1,4,0,0,0,0,36
12,5,14,3,8,0,0,0,0,42
12,5,14,3,8,5,15,14,0,76
12,5,14,4,0,0,0,0,0,35
12,5,14,4,1,2,12,5,0,55
12,5,14,4,5,4,0,0,0,44
12,5,14,4,5,5,0,0,0,45
12,5,14,4,5,18,0,0,0,58
12,5,14,4,5,18,19,0,0,77
12,5,14,4,9,14,7,0,0,65
12,5,14,4,19,0,0,0,0,54
12,5,14,5,0,0,0,0,0,36
12,5,14,7,0,0,0,0,0,38
12,5,14,7,5,18,0,0,0,61
12,5,14,7,5,19,20,0,0,82
12,5,14,7,20,8,0,0,0,66
12,5,14,7,20,8,5,14,0,85
12,5,14,7,20,8,5,14,19,104
12,5,14,7,20,8,5,18,0,89
12,5,14,7,20,8,6,21,12,105
12,5,14,7,20,8,25,0,0,91
12,5,14,7,20,8,9,5,18,98
12,5,14,7,20,8,9,12,25,112
12,5,14,7,20,8,12,25,0,103
12,5,14,7,20,8,13,1,14,94
12,5,14,7,20,8,19,0,0,85
12,5,14,9,1,20,5,0,0,66
12,5,14,9,5,14,3,5,0,67
12,5,14,9,5,14,3,5,19,86
12,5,14,9,5,14,3,25,0,87
12,5,14,9,5,14,20,0,0,79
12,5,14,9,5,14,20,12,25,116
12,5,14,9,6,25,0,0,0,71
12,5,14,9,14,9,19,20,19,121
12,5,14,9,19,0,0,0,0,59
12,5,14,9,20,25,0,0,0,85
12,5,14,9,20,9,3,0,0,72
12,5,14,9,20,9,5,19,0,93
12,5,14,9,20,9,15,14,0,98
12,5,14,9,20,9,22,5,0,96
12,5,14,9,20,9,22,5,19,115
12,5,14,9,20,21,4,5,0,90
12,5,14,14,9,12,9,20,5,100
12,5,14,14,15,23,0,0,0,83
12,5,14,15,19,0,0,0,0,65
12,5,14,19,0,0,0,0,0,50
12,5,14,19,5,0,0,0,0,55
12,5,14,19,5,4,0,0,0,59
12,5,14,19,5,19,0,0,0,74
12,5,14,19,9,14,7,0,0,80
12,5,14,19,12,5,19,19,0,105
12,5,14,19,12,9,11,5,0,87
12,5,14,19,13,1,14,0,0,78
12,5,14,19,13,5,14,0,0,82
12,5,14,20,0,0,0,0,0,51
12,5,14,20,1,14,4,15,0,85
12,5,14,20,8,0,0,0,0,59
12,5,14,20,8,23,1,25,19,127
12,5,14,20,9,3,0,0,0,63
12,5,14,20,9,3,5,12,0,80
12,5,14,20,9,3,5,12,19,99
12,5,14,20,9,3,12,5,0,80
12,5,14,20,9,3,21,12,1,97
12,5,14,20,9,3,21,12,5,101
12,5,14,20,9,6,15,18,13,112
12,5,14,20,9,7,15,0,0,82
12,5,14,20,9,12,0,0,0,72
12,5,14,20,9,12,5,0,0,77
12,5,14,20,9,12,19,0,0,91
12,5,14,20,9,14,5,18,0,97
12,5,14,20,9,19,3,0,0,82
12,5,14,20,9,19,3,15,0,97
12,5,14,20,9,19,3,21,19,122
12,5,14,20,9,19,11,0,0,90
12,5,14,20,9,19,11,19,0,109
12,5,14,20,9,20,21,4,5,110
12,5,14,20,15,0,0,0,0,66
12,5,14,20,15,9,4,0,0,79
12,5,14,20,15,18,0,0,0,84
12,5,14,20,15,19,0,0,0,85
12,5,14,20,15,21,19,0,0,106
12,5,14,22,15,9,0,0,0,77
12,5,14,22,15,25,0,0,0,93
12,5,15,4,9,3,9,4,0,61
12,5,15,14,3,9,20,15,0,93
12,5,15,14,5,19,0,0,0,70
12,5,15,14,9,14,5,12,25,111
12,5,15,14,9,14,5,19,0,93
12,5,15,14,9,20,5,0,0,80
12,5,15,16,1,18,4,0,0,71
12,5,15,16,1,18,4,5,0,76
12,5,15,16,1,18,4,19,0,90
12,5,15,20,1,18,4,0,0,75
12,5,15,20,1,18,4,19,0,94
12,5,16,0,0,0,0,0,0,33
12,5,16,1,0,0,0,0,0,34
12,5,16,1,4,9,4,0,0,51
12,5,16,1,4,15,9,4,0,66
12,5,16,1,7,5,0,0,0,46
12,5,16,1,12,0,0,0,0,46
12,5,16,5,18,0,0,0,0,56
12,5,16,5,18,4,15,13,0,88
12,5,16,5,18,5,4,0,0,65
12,5,16,5,18,15,0,0,0,71
12,5,16,5,18,19,0,0,0,75
12,5,16,9,4,0,0,0,0,46
12,5,16,9,4,5,14,5,0,70
12,5,16,9,4,9,14,0,0,69
12,5,16,9,4,9,14,5,0,74
12,5,16,9,4,9,20,25,0,100
12,5,16,9,4,12,25,0,0,83
12,5,16,9,4,15,9,4,0,74
12,5,16,9,4,15,19,5,19,104
12,5,16,9,4,15,19,9,19,108
12,5,16,9,4,15,20,5,0,86
12,5,16,9,4,15,20,9,3,93
12,5,16,9,19,13,15,9,4,102
12,5,16,15,3,25,20,1,0,97
12,5,16,15,3,25,20,5,0,101
12,5,16,15,18,9,4,0,0,79
12,5,16,15,18,9,4,5,0,84
12,5,16,15,18,9,4,19,0,98
12,5,16,15,18,9,14,5,0,94
12,5,16,15,20,8,18,9,24,127
12,5,16,16,25,0,0,0,0,74
12,5,16,18,1,0,0,0,0,52
12,5,16,18,1,12,9,1,14,88
12,5,16,18,5,0,0,0,0,56
12,5,16,18,25,0,0,0,0,76
12,5,16,18,9,3,0,0,0,63
12,5,16,18,9,4,0,0,0,64
12,5,16,18,9,14,5,0,0,79
12,5,16,18,15,9,4,0,0,79
12,5,16,18,15,12,15,7,25,125
12,5,16,18,15,13,1,0,0,80
12,5,16,18,15,19,5,0,0,90
12,5,16,18,15,19,5,4,0,94
12,5,16,18,15,19,5,18,25,133
12,5,16,18,15,19,25,0,0,110
12,5,16,18,15,19,9,5,4,103
12,5,16,18,15,19,9,5,19,118
12,5,16,18,15,19,9,19,0,113
12,5,16,18,15,19,9,20,25,139
12,5,16,18,15,20,9,3,0,98
12,5,16,18,15,21,19,0,0,106
12,5,16,18,15,21,19,12,25,143
12,5,16,19,1,18,9,1,0,81
12,5,16,19,25,0,0,0,0,77
12,5,16,20,0,0,0,0,0,53
12,5,16,20,1,0,0,0,0,54
12,5,16,20,5,14,5,0,0,77
12,5,16,20,5,18,1,0,0,77
12,5,16,20,9,4,0,0,0,66
12,5,16,20,9,6,15,18,13,114
12,5,16,20,25,14,9,20,5,126
12,5,16,20,9,20,5,0,0,87
12,5,16,20,15,2,15,19,0,104
12,5,16,20,15,6,15,18,13,120
12,5,16,20,15,12,15,7,25,127
12,5,16,20,15,13,5,0,0,86
12,5,16,20,15,14,5,13,1,101
12,5,16,20,15,14,9,3,0,94
12,5,16,20,15,14,19,0,0,101
12,5,16,20,15,19,15,13,5,120
12,5,16,20,15,20,5,14,5,112
12,5,16,20,21,19,0,0,0,93
12,5,17,21,5,1,18,0,0,79
12,5,18,5,0,0,0,0,0,40
12,5,18,14,1,5,15,9,4,83
12,5,18,15,20,0,0,0,0,70
12,5,18,16,0,0,0,0,0,51
12,5,18,18,5,20,0,0,0,78
12,5,19,2,9,1,14,19,0,81
12,5,19,3,8,5,0,0,0,52
12,5,19,5,0,0,0,0,0,41
12,5,19,5,4,0,0,0,0,45
12,5,19,9,25,0,0,0,0,70
12,5,19,9,15,14,0,0,0,74
12,5,19,9,15,14,1,12,0,87
12,5,19,9,15,14,5,4,0,83
12,5,19,9,15,14,19,0,0,93
12,5,19,19,0,0,0,0,0,55
12,5,19,19,5,5,0,0,0,65
12,5,19,19,5,5,19,0,0,84
12,5,19,19,5,14,0,0,0,74
12,5,19,19,5,14,5,4,0,83
12,5,19,19,5,14,5,18,0,97
12,5,19,19,5,14,9,14,7,104
12,5,19,19,5,14,19,0,0,93
12,5,19,19,5,19,0,0,0,79
12,5,19,19,5,19,20,0,0,99
12,5,19,19,9,22,5,0,0,91
12,5,19,19,14,0,0,0,0,69
12,5,19,19,14,5,19,19,0,112
12,5,19,19,15,14,0,0,0,84
12,5,19,19,15,14,5,4,0,93
12,5,19,19,15,14,9,14,7,114
12,5,19,19,15,14,19,0,0,103
12,5,19,19,15,18,0,0,0,88
12,5,19,19,15,18,19,0,0,107
12,5,19,20,5,0,0,0,0,61
12,5,19,20,18,1,4,0,0,79
12,5,20,0,0,0,0,0,0,37
12,5,20,3,8,5,4,0,0,57
12,5,20,3,8,5,19,0,0,72
12,5,20,3,8,25,0,0,0,73
12,5,20,3,8,9,14,7,0,78
12,5,20,4,15,23,14,0,0,93
12,5,20,4,15,23,14,19,0,112
12,5,20,5,0,0,0,0,0,42
12,5,20,7,1,13,5,0,0,63
12,5,20,8,1,12,0,0,0,58
12,5,20,8,1,12,9,20,25,112
12,5,20,8,1,12,9,26,5,98
12,5,20,8,1,12,12,25,0,95
12,5,20,8,1,12,19,0,0,77
12,5,20,8,1,18,7,25,0,96
12,5,20,8,1,18,7,9,3,83
12,5,20,8,1,18,7,21,19,111
12,5,20,8,5,19,0,0,0,69
12,5,20,8,25,0,0,0,0,70
12,5,20,15,6,6,0,0,0,64
12,5,20,15,18,1,20,5,0,96
12,5,20,18,9,19,20,0,0,103
12,5,20,19,0,0,0,0,0,56
12,5,20,20,1,2,12,5,0,77
12,5,20,20,5,4,0,0,0,66
12,5,20,20,5,14,0,0,0,76
12,5,20,20,5,18,0,0,0,80
12,5,20,20,5,18,5,4,0,89
12,5,20,20,5,18,5,18,0,103
12,5,20,20,5,18,5,18,19,122
12,5,20,20,5,18,5,20,0,105
12,5,20,20,5,18,7,1,5,93
12,5,20,20,5,18,9,14,0,103
12,5,20,20,5,18,9,14,7,110
12,5,20,20,5,18,13,1,14,108
12,5,20,20,5,18,13,5,14,112
12,5,20,20,5,18,14,0,0,94
12,5,20,20,5,18,19,0,0,99
12,5,20,20,5,18,19,5,20,124
12,5,20,20,5,18,21,18,5,124
12,5,20,20,9,7,1,0,0,74
12,5,20,20,9,14,7,0,0,87
12,5,20,20,18,9,14,0,0,98
12,5,20,20,18,21,18,5,0,119
12,5,20,20,21,3,5,0,0,86
12,5,20,20,21,3,5,19,0,105
12,5,20,21,1,18,5,0,0,82
12,5,20,21,16,0,0,0,0,74
12,5,20,21,16,19,0,0,0,93
12,5,21,0,0,0,0,0,0,38
12,5,21,3,1,5,13,9,1,70
12,5,21,3,1,5,13,9,3,72
12,5,21,3,1,21,18,9,14,104
12,5,21,3,5,13,9,1,0,69
12,5,21,3,5,13,9,1,19,88
12,5,21,3,5,13,9,3,0,71
12,5,21,3,8,0,0,0,0,49
12,5,21,3,8,5,13,9,1,77
12,5,21,3,9,3,0,0,0,53
12,5,21,3,25,12,0,0,0,78
12,5,21,3,9,14,0,0,0,64
12,5,21,3,9,14,5,0,0,69
12,5,21,3,9,14,5,19,0,88
12,5,21,3,9,14,19,0,0,83
12,5,21,3,9,19,13,0,0,82
12,5,21,3,9,20,5,0,0,75
12,5,21,3,9,20,5,19,0,94
12,5,21,3,9,20,9,3,0,82
12,5,21,3,9,20,9,19,0,98
12,5,21,3,9,20,9,20,5,104
12,5,21,3,9,20,15,9,4,98
12,5,21,3,15,0,0,0,0,56
12,5,21,3,15,3,25,1,14,99
12,5,21,3,15,3,9,19,13,100
12,5,21,3,15,3,25,20,5,109
12,5,21,3,15,9,4,0,0,69
12,5,21,3,15,12,9,14,5,96
12,5,21,3,15,13,1,0,0,70
12,5,21,3,15,13,1,19,0,89
12,5,21,3,15,14,5,19,0,94
12,5,21,3,15,14,15,9,4,98
12,5,21,3,15,16,21,19,0,112
12,5,21,3,15,18,25,24,0,123
12,5,21,3,15,19,9,19,0,103
12,5,21,3,15,20,9,3,0,88
12,5,21,3,15,20,15,13,5,109
12,5,21,3,15,20,15,13,25,129
12,5,21,3,15,21,19,0,0,96
12,5,21,3,15,24,5,14,5,104
12,5,21,4,0,0,0,0,0,42
12,5,21,4,5,19,0,0,0,66
12,5,21,4,19,0,0,0,0,61
12,5,21,11,0,0,0,0,0,49
12,5,21,11,1,5,13,9,1,78
12,5,21,11,1,5,13,9,3,80
12,5,21,11,5,13,9,1,0,77
12,5,21,11,5,13,9,1,19,96
12,5,21,11,5,13,9,3,0,79
12,5,21,11,5,13,9,3,19,98
12,5,21,11,5,13,9,4,0,80
12,5,21,11,5,13,15,9,4,95
12,5,21,11,15,3,25,20,5,117
12,5,21,11,15,13,1,0,0,78
12,5,21,11,15,13,1,19,0,97
12,5,21,11,15,14,0,0,0,78
12,5,21,11,15,14,19,0,0,97
12,5,21,11,15,19,5,19,0,107
12,5,21,11,15,19,9,19,0,111
12,5,21,11,15,20,9,3,0,96
12,5,21,11,15,20,15,13,25,137
12,5,21,13,1,0,0,0,0,52
12,5,21,14,7,0,0,0,0,59
12,5,22,1,0,0,0,0,0,40
12,5,22,1,4,5,0,0,0,49
12,5,22,1,14,3,5,0,0,62
12,5,22,1,14,3,25,0,0,82
12,5,22,1,14,20,5,4,0,83
12,5,22,1,14,20,5,18,1,98
12,5,22,1,14,20,5,18,19,116
12,5,22,1,14,20,9,14,7,104
12,5,22,1,14,20,15,0,0,89
12,5,22,1,14,20,19,0,0,93
12,5,22,1,20,9,15,14,0,98
12,5,22,1,20,15,18,0,0,93
12,5,22,1,20,15,18,5,19,117
12,5,22,1,20,15,18,19,0,112
12,5,22,5,0,0,0,0,0,44
12,5,22,5,3,8,5,0,0,60
12,5,22,5,5,0,0,0,0,49
12,5,22,5,5,4,0,0,0,53
12,5,22,5,5,9,14,7,0,79
12,5,22,5,5,19,0,0,0,68
12,5,22,5,6,21,12,0,0,83
12,5,22,5,12,0,0,0,0,56
12,5,22,5,12,5,4,0,0,65
12,5,22,5,12,5,18,0,0,79
12,5,22,5,12,5,18,19,0,98
12,5,22,5,12,9,14,7,0,86
12,5,22,5,12,9,19,8,0,92
12,5,22,5,12,9,19,13,0,97
12,5,22,5,12,12,5,4,0,77
12,5,22,5,12,12,5,18,19,110
12,5,22,5,12,12,5,19,20,112
12,5,22,5,12,12,25,0,0,93
12,5,22,5,12,12,9,14,7,98
12,5,22,5,12,13,1,14,0,84
12,5,22,5,12,14,5,19,19,113
12,5,22,5,12,19,0,0,0,75
12,5,22,5,18,1,7,5,0,75
12,5,22,5,18,1,7,5,4,79
12,5,22,5,18,1,7,5,19,94
12,5,22,5,18,5,4,0,0,71
12,5,22,5,18,5,18,0,0,85
12,5,22,5,18,5,20,0,0,87
12,5,22,5,18,5,20,19,0,106
12,5,22,5,18,12,9,11,5,99
12,5,22,5,18,13,1,14,0,90
12,5,22,5,18,19,0,0,0,81
12,5,22,5,18,23,15,15,4,119
12,5,22,5,19,5,12,0,0,80
12,5,22,5,20,0,0,0,0,64
12,5,22,9,1,2,12,5,0,68
12,5,22,9,1,20,8,1,14,92
12,5,22,9,1,20,9,15,14,107
12,5,22,9,5,4,0,0,0,57
12,5,22,9,5,18,0,0,0,71
12,5,22,9,5,18,19,0,0,90
12,5,22,9,5,19,0,0,0,72
12,5,22,9,7,1,2,12,5,75
12,5,22,9,7,1,20,5,0,81
12,5,22,9,7,1,20,5,4,85
12,5,22,9,7,1,20,5,19,100
12,5,22,9,7,1,20,15,18,109
12,5,22,25,9,14,7,0,0,94
12,5,22,25,9,19,20,0,0,112
12,5,22,25,14,5,0,0,0,83
12,5,22,9,14,5,18,0,0,85
12,5,22,9,14,9,14,7,0,92
12,5,22,25,14,9,20,5,0,112
12,5,22,9,18,0,0,0,0,66
12,5,22,9,18,1,20,5,0,92
12,5,22,9,18,1,20,5,19,111
12,5,22,9,18,1,20,9,3,99
12,5,22,9,20,1,14,20,0,103
12,5,22,9,20,1,20,5,0,94
12,5,22,9,20,1,20,5,4,98
12,5,22,9,20,1,20,5,19,113
12,5,22,9,20,1,20,15,18,122
12,5,22,9,20,5,18,0,0,91
12,5,22,9,20,25,0,0,0,93
12,5,22,9,20,9,5,19,0,101
12,5,22,15,0,0,0,0,0,54
12,5,22,15,4,15,16,1,0,90
12,5,22,15,7,25,18,5,0,109
12,5,22,21,12,9,3,0,0,84
12,5,22,21,12,9,14,0,0,95
12,5,22,21,12,9,14,9,3,107
12,5,22,21,12,9,14,19,0,114
12,5,22,21,12,15,19,5,0,111
12,5,22,21,12,15,19,5,19,130
12,5,23,4,0,0,0,0,0,44
12,5,23,4,5,18,0,0,0,67
12,5,23,4,5,19,20,0,0,88
12,5,23,4,12,25,0,0,0,81
12,5,23,4,14,5,19,19,0,101
12,5,23,4,19,20,5,18,0,106
12,5,23,5,0,0,0,0,0,45
12,5,23,9,14,7,0,0,0,70
12,5,23,9,19,5,19,0,0,92
12,5,23,9,19,9,20,5,0,102
12,5,23,9,19,9,20,5,19,121
12,5,23,9,19,19,15,14,0,116
12,5,23,9,19,19,15,14,19,135
12,5,23,9,19,20,0,0,0,88
12,5,23,14,9,20,5,0,0,88
12,5,23,20,8,0,0,0,0,68
12,5,23,20,25,0,0,0,0,85
12,5,24,0,0,0,0,0,0,41
12,5,24,5,13,5,0,0,0,64
12,5,24,5,13,5,19,0,0,83
12,5,24,5,13,9,3,0,0,71
12,5,24,5,19,0,0,0,0,65
12,5,24,9,1,0,0,0,0,51
12,5,24,9,3,0,0,0,0,53
12,5,24,9,3,1,0,0,0,54
12,5,24,9,3,1,12,0,0,66
12,5,24,9,3,1,12,9,3,78
12,5,24,9,3,1,12,12,25,103
12,5,24,9,3,15,7,0,0,75
12,5,24,9,3,15,14,0,0,82
12,5,24,9,3,15,14,19,0,101
12,5,26,0,0,0,0,0,0,43
12,5,26,5,19,0,0,0,0,67
12,5,26,26,25,0,0,0,0,94
12,5,26,26,9,5,0,0,0,83
12,5,26,26,9,5,19,0,0,102
12,7,20,8,0,0,0,0,0,47
12,8,2,0,0,0,0,0,0,22
12,8,5,18,26,9,20,5,0,103
12,8,9,1,13,2,1,0,0,46
12,9,2,1,13,5,14,20,0,76
12,9,2,1,14,20,0,0,0,58
12,9,2,1,18,4,0,0,0,46
12,9,2,1,20,5,0,0,0,49
12,9,2,1,20,5,4,0,0,53
12,9,2,1,20,9,14,7,0,74
12,9,2,1,20,9,15,14,0,82
12,9,2,1,20,9,15,14,19,101
12,9,2,1,20,15,18,25,0,102
12,9,2,2,1,18,4,0,0,48
12,9,2,2,5,4,0,0,0,34
12,9,2,2,5,18,0,0,0,48
12,9,2,2,5,18,19,0,0,67
12,9,2,2,5,20,0,0,0,50
12,9,2,2,9,14,7,0,0,55
12,9,2,2,18,1,0,0,0,44
12,9,2,5,3,3,8,9,15,66
12,9,2,5,3,3,9,15,0,58
12,9,2,5,3,3,9,15,19,77
12,9,2,5,12,0,0,0,0,40
12,9,2,5,12,1,14,20,0,75
12,9,2,5,12,1,14,20,19,94
12,9,2,5,12,5,4,0,0,49
12,9,2,5,12,5,5,0,0,50
12,9,2,5,12,5,5,19,0,69
12,9,2,5,12,5,18,0,0,63
12,9,2,5,12,5,18,19,0,82
12,9,2,5,12,9,14,7,0,70
12,9,2,5,12,9,19,20,0,88
12,9,2,5,12,9,19,20,19,107
12,9,2,5,12,12,1,14,20,87
12,9,2,5,12,12,1,18,25,96
12,9,2,5,12,12,1,20,5,78
12,9,2,5,12,12,5,4,0,61
12,9,2,5,12,12,5,5,0,62
12,9,2,5,12,12,5,5,19,81
12,9,2,5,12,12,5,18,0,75
12,9,2,5,12,12,5,18,19,94
12,9,2,5,12,12,9,14,7,82
12,9,2,5,12,12,9,19,20,100
12,9,2,5,12,12,15,21,19,107
12,9,2,5,12,15,21,19,0,95
12,9,2,5,12,19,0,0,0,59
12,9,2,5,18,1,12,12,25,96
12,9,2,5,18,1,12,19,0,78
12,9,2,5,18,1,20,5,0,72
12,9,2,5,18,1,20,5,4,76
12,9,2,5,18,1,20,5,19,91
12,9,2,5,18,9,1,14,19,89
12,9,2,5,18,19,0,0,0,65
12,9,2,5,18,20,9,5,19,99
12,9,2,5,18,20,9,14,5,94
12,9,2,5,18,21,13,0,0,80
12,9,2,7,5,20,0,0,0,55
12,9,2,25,1,14,19,0,0,82
12,9,2,9,4,9,2,9,0,56
12,9,2,9,4,9,14,1,12,72
12,9,2,9,4,15,0,0,0,51
12,9,2,9,4,15,19,0,0,70
12,9,2,9,14,9,20,0,0,75
12,9,2,9,20,21,13,0,0,86
12,9,2,11,5,14,0,0,0,53
12,9,2,11,9,14,0,0,0,57
12,9,2,12,1,2,0,0,0,38
12,9,2,12,1,2,19,0,0,57
12,9,2,18,0,0,0,0,0,41
12,9,2,18,1,9,18,9,5,83
12,9,2,18,1,12,0,0,0,54
12,9,2,18,1,18,25,0,0,85
12,9,2,18,1,18,9,1,14,84
12,9,2,18,1,18,9,5,19,93
12,9,2,18,1,18,9,9,0,78
12,9,2,18,1,18,9,21,19,109
12,9,2,18,1,19,0,0,0,61
12,9,2,18,1,20,5,0,0,67
12,9,2,18,1,20,5,4,0,71
12,9,2,18,1,20,5,19,0,86
12,9,2,18,1,20,9,14,7,92
12,9,2,18,1,20,9,15,14,100
12,9,2,18,1,20,15,18,25,120
12,9,2,18,5,20,20,9,0,95
12,9,2,18,5,20,20,15,0,101
12,9,2,18,5,20,20,15,19,120
12,9,2,18,9,0,0,0,0,50
12,9,2,18,9,6,15,18,13,102
12,9,2,18,9,19,0,0,0,69
12,9,2,19,0,0,0,0,0,42
12,25,3,0,0,0,0,0,0,40
12,25,3,1,5,14,9,4,0,73
12,9,3,1,18,5,15,12,0,75
12,9,3,3,1,0,0,0,0,28
12,9,3,5,0,0,0,0,0,29
12,25,3,5,1,0,0,0,0,46
12,25,3,5,1,12,0,0,0,58
12,25,3,5,5,0,0,0,0,50
12,25,3,5,5,19,0,0,0,69
12,9,3,5,14,3,5,0,0,51
12,9,3,5,14,3,5,4,0,55
12,9,3,5,14,3,5,5,0,56
12,9,3,5,14,3,5,5,19,75
12,9,3,5,14,3,5,18,0,69
12,9,3,5,14,3,5,18,19,88
12,9,3,5,14,3,5,19,0,70
12,9,3,5,14,3,9,14,7,76
12,9,3,5,14,19,5,0,0,67
12,9,3,5,14,19,5,4,0,71
12,9,3,5,14,19,5,5,0,72
12,9,3,5,14,19,5,5,19,91
12,9,3,5,14,19,5,18,0,85
12,9,3,5,14,19,5,18,19,104
12,9,3,5,14,19,5,19,0,86
12,9,3,5,14,19,9,14,7,92
12,9,3,5,14,19,15,18,0,95
12,9,3,5,14,19,15,18,19,114
12,9,3,5,14,19,21,18,5,106
12,9,3,5,14,20,5,0,0,68
12,9,3,5,14,20,9,0,0,72
12,9,3,5,20,0,0,0,0,49
12,25,3,5,21,13,19,0,0,98
12,9,3,8,0,0,0,0,0,32
12,25,3,8,0,0,0,0,0,48
12,9,3,8,1,13,0,0,0,46
12,9,3,8,1,14,15,19,0,81
12,9,3,8,5,5,0,0,0,42
12,25,3,8,5,5,0,0,0,58
12,9,3,8,5,5,19,0,0,61
12,25,3,8,5,5,19,0,0,77
12,9,3,8,5,14,0,0,0,51
12,9,3,8,5,14,5,4,0,60
12,9,3,8,5,14,25,0,0,76
12,9,3,8,5,14,9,1,14,75
12,9,3,8,5,14,9,3,0,63
12,9,3,8,5,14,9,14,0,74
12,9,3,8,5,14,9,14,7,81
12,9,3,8,5,14,9,14,19,93
12,9,3,8,5,14,9,19,5,84
12,9,3,8,5,14,9,19,13,92
12,9,3,8,5,14,9,19,20,99
12,9,3,8,5,14,9,26,5,91
12,9,3,8,5,14,15,9,4,79
12,9,3,8,5,14,15,19,5,90
12,9,3,8,5,14,15,21,19,106
12,9,3,8,5,14,19,0,0,70
12,9,3,8,5,19,0,0,0,56
12,9,3,8,9,0,0,0,0,41
12,9,3,8,9,19,0,0,0,60
12,25,3,8,14,9,19,5,19,114
12,9,3,8,20,5,4,0,0,61
12,9,3,8,20,9,14,7,0,82
12,9,3,8,20,12,25,0,0,89
12,9,3,8,20,19,0,0,0,71
12,9,3,8,23,1,11,5,0,72
12,25,3,9,4,0,0,0,0,53
12,25,3,9,14,5,0,0,0,68
12,9,3,9,20,0,0,0,0,53
12,9,3,9,20,12,25,0,0,90
12,9,3,9,20,14,5,19,19,110
12,9,3,11,5,4,0,0,0,44
12,9,3,11,5,18,0,0,0,58
12,9,3,11,5,18,9,19,8,94
12,9,3,11,5,18,15,21,19,113
12,9,3,11,5,18,19,0,0,77
12,9,3,11,5,20,25,0,0,85
12,9,3,11,9,14,7,19,0,84
12,9,3,11,16,5,14,14,25,109
12,9,3,11,19,0,0,0,0,54
12,9,3,11,19,16,9,20,0,99
12,9,3,11,19,16,9,20,19,118
12,25,3,15,4,15,9,4,0,87
12,25,3,15,16,5,14,5,0,95
12,25,3,15,16,5,14,5,19,114
12,25,3,15,16,9,14,0,0,94
12,25,3,15,16,15,4,0,0,90
12,25,3,15,16,15,4,5,0,95
12,25,3,15,16,15,4,19,0,109
12,9,3,15,18,9,3,5,0,74
12,9,3,15,18,9,3,5,19,93
12,25,3,15,18,9,14,5,0,101
12,9,3,15,18,14,0,0,0,71
12,9,3,15,18,14,5,0,0,76
12,9,3,15,18,15,21,19,0,112
12,25,3,15,19,9,4,0,0,87
12,9,3,15,21,18,0,0,0,78
12,25,3,20,9,4,0,0,0,73
12,9,3,20,15,18,0,0,0,77
12,9,3,20,15,18,9,1,14,101
12,9,3,20,15,18,19,0,0,96
12,9,3,21,18,9,0,0,0,72
12,9,3,21,18,25,0,0,0,88
12,9,4,0,0,0,0,0,0,25
12,9,4,1,18,19,0,0,0,63
12,9,4,4,5,4,0,0,0,38
12,9,4,4,5,18,0,0,0,52
12,9,4,4,5,18,15,14,0,81
12,9,4,4,9,14,7,0,0,59
12,25,4,4,9,20,5,0,0,79
12,25,4,4,9,20,5,19,0,98
12,9,4,6,12,15,23,5,18,104
12,9,4,7,1,20,5,0,0,58
12,9,4,9,1,19,0,0,0,54
12,9,4,9,3,11,5,18,0,71
12,25,4,9,20,5,0,0,0,75
12,9,4,12,5,19,19,0,0,80
12,9,4,12,5,19,19,12,25,117
12,9,4,15,3,1,9,14,5,72
12,9,4,15,19,0,0,0,0,59
12,9,4,19,0,0,0,0,0,44
12,25,5,0,0,0,0,0,0,42
12,9,5,2,9,7,9,20,5,78
12,9,5,2,12,9,3,8,0,60
12,9,5,4,0,0,0,0,0,30
12,9,5,4,5,18,0,0,0,53
12,9,5,6,5,18,0,0,0,55
12,9,5,6,5,19,20,0,0,76
12,9,5,6,12,25,0,0,0,69
12,9,5,6,19,15,13,5,0,84
12,9,5,7,5,4,15,13,0,70
12,9,5,7,5,6,21,12,0,77
12,9,5,7,5,12,5,19,19,93
12,9,5,7,5,12,25,0,0,75
12,9,5,7,5,13,1,14,0,66
12,9,5,7,5,13,5,14,0,70
12,9,5,7,5,18,0,0,0,56
12,9,5,7,5,19,0,0,0,57
12,9,5,7,9,5,18,0,0,65
12,9,5,14,0,0,0,0,0,40
12,9,5,14,1,2,12,5,0,60
12,9,5,14,1,12,0,0,0,53
12,9,5,14,3,21,12,9,0,85
12,9,5,14,3,21,12,21,19,116
12,9,5,14,5,5,0,0,0,50
12,9,5,14,9,3,0,0,0,52
12,9,5,14,9,20,9,19,0,97
12,9,5,14,15,3,5,12,5,80
12,9,5,14,15,18,0,0,0,73
12,9,5,14,19,0,0,0,0,59
12,9,5,14,20,5,18,25,0,108
12,9,5,14,20,5,18,9,1,93
12,9,5,14,20,5,18,9,3,95
12,9,5,16,15,20,0,0,0,77
12,9,5,16,18,15,15,6,0,96
12,9,5,18,0,0,0,0,0,44
12,25,5,18,25,0,0,0,0,85
12,9,5,18,14,5,0,0,0,63
12,9,5,18,14,5,19,0,0,82
12,9,5,18,18,5,0,0,0,67
12,9,5,18,19,0,0,0,0,63
12,9,5,19,0,0,0,0,0,45
12,25,5,19,0,0,0,0,0,61
12,9,5,19,8,0,0,0,0,53
12,9,5,19,16,6,21,14,4,106
12,9,5,19,20,0,0,0,0,65
12,9,5,21,0,0,0,0,0,47
12,9,5,21,5,0,0,0,0,52
12,9,5,21,19,0,0,0,0,66
12,9,5,22,1,1,18,20,0,88
12,9,5,22,5,0,0,0,0,53
12,9,5,22,5,18,0,0,0,71
12,9,5,22,5,19,20,0,0,92
12,9,5,22,18,9,20,5,0,100
12,9,6,5,2,12,15,15,4,80
12,9,6,5,2,15,1,20,0,70
12,9,6,5,2,15,1,20,19,89
12,9,6,5,2,21,15,25,0,95
12,9,6,5,4,1,25,0,0,62
12,9,6,5,4,18,15,16,0,85
12,9,6,5,6,21,12,0,0,71
12,9,6,5,6,21,12,12,25,108
12,9,6,5,7,21,1,18,4,83
12,9,6,5,8,15,12,4,0,71
12,9,6,5,8,15,15,4,0,74
12,9,6,5,25,0,0,0,0,57
12,9,6,5,12,5,1,6,0,56
12,9,6,5,12,5,19,19,0,87
12,9,6,5,12,5,20,0,0,69
12,9,6,5,12,9,11,5,0,69
12,9,6,5,12,9,14,5,0,72
12,9,6,5,12,9,14,5,19,91
12,9,6,5,12,15,14,7,0,80
12,9,6,5,14,0,0,0,0,46
12,9,6,5,18,0,0,0,0,50
12,9,6,5,18,5,14,20,0,89
12,9,6,5,18,15,15,20,0,100
12,9,6,5,18,19,0,0,0,69
12,9,6,5,19,1,22,5,18,97
12,9,6,5,19,15,13,5,0,84
12,9,6,5,19,16,1,14,0,82
12,9,6,5,19,16,1,14,19,101
12,9,6,5,19,20,25,12,5,113
12,9,6,5,20,9,13,5,0,79
12,9,6,5,20,9,13,5,19,98
12,9,6,5,23,1,25,0,0,81
12,9,6,5,23,1,25,19,0,100
12,9,6,5,23,1,18,4,0,78
12,9,6,5,23,15,18,11,0,99
12,9,6,5,23,15,18,11,19,118
12,25,6,11,9,5,0,0,0,68
12,9,6,12,15,4,0,0,0,58
12,9,6,20,0,0,0,0,0,47
12,9,6,20,1,2,12,5,0,67
12,9,6,20,2,15,25,0,0,89
12,9,6,20,5,4,0,0,0,56
12,9,6,20,5,18,0,0,0,70
12,9,6,20,5,18,19,0,0,89
12,9,6,20,7,1,20,5,0,80
12,9,6,20,9,14,7,0,0,77
12,9,6,20,12,5,19,19,0,102
12,9,6,20,13,1,14,0,0,75
12,9,6,20,13,5,14,0,0,79
12,9,6,20,15,6,6,0,0,74
12,9,6,20,15,6,6,19,0,93
12,9,6,20,19,0,0,0,0,66
12,9,7,0,0,0,0,0,0,28
12,9,7,1,2,12,5,0,0,48
12,25,7,1,5,9,4,0,0,63
12,9,7,1,13,5,14,20,0,81
12,9,7,1,13,5,14,20,1,82
12,9,7,1,13,5,14,20,19,100
12,9,7,1,14,0,0,0,0,43
12,9,7,1,14,4,0,0,0,47
12,9,7,1,14,4,19,0,0,66
12,9,7,1,14,19,0,0,0,62
12,9,7,1,19,0,0,0,0,48
12,9,7,1,19,5,0,0,0,53
12,9,7,1,19,5,19,0,0,72
12,9,7,1,20,5,0,0,0,54
12,9,7,1,20,5,4,0,0,58
12,9,7,1,20,5,19,0,0,73
12,9,7,1,20,9,14,7,0,79
12,9,7,1,20,9,15,14,0,87
12,9,7,1,20,9,15,14,19,106
12,9,7,1,20,9,22,5,0,85
12,9,7,1,20,15,18,0,0,82
12,9,7,1,20,15,18,25,0,107
12,9,7,1,20,21,18,5,0,93
12,9,7,1,20,21,18,5,4,97
12,9,7,1,20,21,18,5,19,112
12,9,7,5,0,0,0,0,0,33
12,9,7,5,1,14,3,5,0,56
12,9,7,5,18,0,0,0,0,51
12,9,7,5,18,19,0,0,0,70
12,9,7,7,1,20,0,0,0,56
12,9,7,7,5,0,0,0,0,40
12,9,7,7,5,18,0,0,0,58
12,9,7,8,20,1,2,12,5,76
12,9,7,8,20,1,7,5,0,69
12,9,7,8,20,2,15,1,20,94
12,9,7,8,20,2,21,12,2,93
12,9,7,8,20,5,4,0,0,65
12,9,7,8,20,5,14,0,0,75
12,9,7,8,20,5,14,5,4,84
12,9,7,8,20,5,14,5,18,98
12,9,7,8,20,5,14,19,0,94
12,9,7,8,20,5,18,0,0,79
12,9,7,8,20,5,18,5,4,88
12,9,7,8,20,5,18,19,0,98
12,9,7,8,20,5,19,20,0,100
12,9,7,8,20,6,1,3,5,71
12,9,7,8,20,6,1,19,20,102
12,9,7,8,20,6,21,12,0,95
12,9,7,8,20,8,5,1,4,74
12,9,7,8,20,25,0,0,0,81
12,9,7,8,20,9,14,7,0,86
12,9,7,8,20,9,14,7,19,105
12,9,7,8,20,9,19,8,0,92
12,9,7,8,20,12,5,19,19,111
12,9,7,8,20,12,25,0,0,93
12,9,7,8,20,13,1,14,19,103
12,9,7,8,20,13,5,14,0,88
12,9,7,8,20,14,5,19,19,113
12,9,7,8,20,14,9,14,7,100
12,9,7,8,20,18,15,15,13,117
12,9,7,8,20,19,0,0,0,75
12,9,7,8,20,19,3,15,20,113
12,9,7,8,20,19,8,9,16,108
12,9,7,8,20,19,13,1,14,103
12,9,7,8,20,19,13,5,14,107
12,9,7,8,20,19,15,13,5,108
12,9,7,8,20,23,15,15,4,113
12,9,7,8,20,23,15,18,20,132
12,9,7,14,1,12,15,5,19,94
12,9,7,14,1,20,9,12,5,89
12,9,7,14,5,0,0,0,0,47
12,9,7,14,5,15,21,19,0,102
12,9,7,14,5,19,0,0,0,66
12,9,7,14,9,3,15,12,5,86
12,9,7,14,9,6,25,0,0,82
12,9,7,14,9,6,9,5,4,75
12,9,7,14,9,6,9,5,19,90
12,9,7,14,9,6,15,18,13,103
12,9,7,14,9,14,0,0,0,65
12,9,7,14,9,14,19,0,0,84
12,9,7,14,9,20,5,0,0,76
12,9,7,14,9,20,5,19,0,95
12,9,7,14,9,20,9,3,0,83
12,9,7,14,9,20,9,26,5,111
12,9,7,14,15,14,5,0,0,76
12,9,7,14,15,19,5,0,0,81
12,9,7,14,15,19,9,20,25,130
12,9,7,14,15,21,19,0,0,97
12,9,7,14,21,13,0,0,0,76
12,9,7,14,21,13,19,0,0,95
12,9,7,18,15,9,14,0,0,84
12,9,7,18,15,9,14,5,0,89
12,9,7,18,15,9,14,5,19,108
12,9,7,18,15,9,14,19,0,103
12,9,7,21,12,1,0,0,0,62
12,9,7,21,12,1,5,0,0,67
12,9,7,21,12,1,18,0,0,80
12,9,7,21,12,1,19,0,0,81
12,9,7,21,12,1,20,5,0,87
12,9,7,21,12,1,20,5,4,91
12,9,7,21,12,5,0,0,0,66
12,9,7,21,12,5,19,0,0,85
12,9,7,21,12,9,14,0,0,84
12,9,7,21,12,15,9,4,0,89
12,9,7,21,18,5,0,0,0,72
12,9,7,21,18,5,19,0,0,91
12,9,7,21,18,9,20,5,0,101
12,25,7,21,19,0,0,0,0,84
12,9,7,21,19,20,18,9,14,129
12,9,9,14,0,0,0,0,0,44
12,25,9,14,7,0,0,0,0,67
12,25,9,14,7,12,25,0,0,104
12,25,9,14,7,19,0,0,0,86
12,9,25,21,1,14,0,0,0,82
12,9,10,1,0,0,0,0,0,32
12,9,11,1,2,12,5,0,0,52
12,9,11,5,0,0,0,0,0,37
12,9,11,5,1,2,12,5,0,57
12,9,11,5,4,0,0,0,0,41
12,9,11,5,6,21,12,0,0,76
12,9,11,5,8,15,15,4,0,79
12,9,11,5,12,9,5,18,0,81
12,9,11,5,12,9,5,19,20,102
12,9,11,5,14,0,0,0,0,51
12,25,11,5,14,0,0,0,0,67
12,9,11,5,14,5,4,0,0,60
12,9,11,5,14,5,19,19,0,94
12,9,11,5,14,9,14,7,0,81
12,9,11,5,14,19,0,0,0,70
12,9,11,5,18,0,0,0,0,55
12,9,11,5,18,9,19,8,0,91
12,9,11,5,18,15,21,19,0,110
12,9,11,5,18,19,0,0,0,74
12,9,11,5,19,0,0,0,0,56
12,9,11,5,19,15,13,5,0,89
12,9,11,5,19,20,0,0,0,76
12,9,11,5,23,1,25,19,0,105
12,25,11,5,23,1,11,5,0,93
12,9,11,5,23,1,12,11,0,84
12,9,11,5,23,9,19,5,0,93
12,9,11,9,14,0,0,0,0,55
12,9,11,9,14,7,0,0,0,62
12,9,11,9,14,7,12,25,0,99
12,9,11,9,14,7,19,0,0,81
12,9,11,11,5,18,0,0,0,66
12,9,11,14,15,14,0,0,0,75
12,9,11,21,20,1,0,0,0,74
12,9,12,1,3,5,15,21,19,97
12,9,12,1,3,9,14,0,0,60
12,9,12,1,3,11,25,0,0,73
12,9,12,1,3,19,0,0,0,56
12,9,12,1,3,20,9,4,5,75
12,9,12,5,0,0,0,0,0,38
12,9,12,5,19,0,0,0,0,57
12,9,12,9,1,12,0,0,0,55
12,9,12,9,1,20,5,4,0,72
12,9,12,9,5,4,0,0,0,51
12,9,12,9,5,19,0,0,0,66
12,9,12,25,6,25,0,0,0,89
12,9,12,9,6,15,18,13,0,94
12,9,12,25,12,9,11,5,0,95
12,9,12,25,23,15,15,4,0,115
12,9,12,25,23,15,18,20,0,134
12,9,12,12,0,0,0,0,0,45
12,9,12,12,9,16,21,20,19,130
12,9,12,20,0,0,0,0,0,53
12,9,12,20,5,4,0,0,0,62
12,9,12,20,25,0,0,0,0,78
12,9,12,20,9,14,7,0,0,83
12,9,12,20,9,14,7,12,25,120
12,9,12,20,19,0,0,0,0,72
12,25,13,0,0,0,0,0,0,50
12,9,13,1,3,5,0,0,0,43
12,9,13,1,3,5,12,0,0,55
12,9,13,1,3,5,12,12,5,72
12,9,13,1,3,5,15,21,19,98
12,9,13,1,3,9,14,5,0,66
12,9,13,1,3,9,14,5,19,85
12,9,13,1,3,9,14,9,4,74
12,9,13,1,3,15,9,4,0,66
12,9,13,1,3,15,14,0,0,67
12,9,13,1,3,15,14,19,0,86
12,9,13,1,9,12,0,0,0,56
12,9,13,1,9,12,12,5,0,73
12,9,13,1,14,19,0,0,0,68
12,9,13,1,19,0,0,0,0,54
12,9,13,1,20,9,15,14,0,93
12,9,13,2,0,0,0,0,0,36
12,9,13,2,1,0,0,0,0,37
12,9,13,2,1,12,0,0,0,49
12,9,13,2,1,19,0,0,0,56
12,9,13,2,1,20,0,0,0,57
12,9,13,2,1,20,5,0,0,62
12,9,13,2,1,20,9,15,14,95
12,9,13,2,5,3,0,0,0,44
12,9,13,2,5,3,11,0,0,55
12,9,13,2,5,3,11,19,0,74
12,9,13,2,5,4,0,0,0,45
12,9,13,2,5,18,5,4,0,68
12,9,13,2,5,18,5,18,0,82
12,9,13,2,5,18,5,19,20,103
12,9,13,2,5,18,8,1,13,81
12,9,13,2,5,18,9,14,7,89
12,9,13,2,5,18,12,25,0,96
12,9,13,2,5,18,19,0,0,78
12,9,13,2,9,0,0,0,0,45
12,9,13,2,25,0,0,0,0,61
12,9,13,2,9,3,0,0,0,48
12,9,13,2,9,5,0,0,0,50
12,9,13,2,9,5,18,0,0,68
12,9,13,2,9,5,19,20,0,89
12,9,13,2,9,14,7,0,0,66
12,9,13,2,12,5,19,19,0,91
12,9,13,2,13,5,1,12,0,67
12,9,13,2,15,0,0,0,0,51
12,9,13,2,15,19,0,0,0,70
12,9,13,2,15,21,19,0,0,91
12,9,13,2,19,0,0,0,0,55
12,9,13,2,21,19,0,0,0,76
12,9,13,2,21,19,5,19,0,100
12,9,13,5,0,0,0,0,0,39
12,9,13,5,1,4,5,0,0,49
12,9,13,5,1,4,5,19,0,68
12,9,13,5,2,5,18,18,25,107
12,9,13,5,2,21,19,8,0,89
12,9,13,5,4,0,0,0,0,43
12,9,13,5,25,0,0,0,0,64
12,9,13,5,25,19,0,0,0,83
12,9,13,5,11,9,12,14,0,85
12,9,13,5,11,9,12,14,19,104
12,9,13,5,12,5,19,19,0,94
12,9,13,5,12,9,7,8,20,95
12,9,13,5,12,9,11,5,0,76
12,9,13,5,13,1,14,0,0,67
12,9,13,5,14,0,0,0,0,53
12,9,13,5,14,19,0,0,0,72
12,9,13,5,17,21,1,20,0,98
12,9,13,5,18,0,0,0,0,57
12,9,13,5,18,9,3,11,19,99
12,9,13,5,19,0,0,0,0,58
12,9,13,5,19,20,15,14,5,112
12,9,13,5,20,20,1,0,0,80
12,9,13,5,20,20,9,14,0,102
12,9,13,5,23,1,19,8,0,90
12,9,13,5,23,1,20,5,18,106
12,9,13,5,23,15,15,4,0,96
12,9,13,5,23,15,18,20,0,115
12,9,13,25,0,0,0,0,0,59
12,9,13,9,5,18,0,0,0,66
12,9,13,9,5,19,20,0,0,87
12,9,13,9,14,1,0,0,0,58
12,9,13,9,14,1,12,0,0,70
12,9,13,9,14,1,18,25,0,101
12,9,13,9,14,5,0,0,0,62
12,9,13,9,14,5,19,19,0,100
12,9,13,9,14,7,0,0,0,64
12,9,13,9,20,0,0,0,0,63
12,9,13,9,20,1,2,12,5,83
12,9,13,9,20,1,2,12,25,103
12,9,13,9,20,1,12,0,0,76
12,9,13,9,20,1,18,25,0,107
12,9,13,9,20,1,20,5,0,89
12,9,13,9,20,5,4,0,0,72
12,9,13,9,20,5,4,12,25,109
12,9,13,9,20,5,4,19,0,91
12,9,13,9,20,5,18,0,0,86
12,9,13,9,20,5,18,19,0,105
12,9,13,9,20,5,19,0,0,87
12,9,13,9,20,25,0,0,0,88
12,9,13,9,20,9,14,7,0,93
12,9,13,9,20,9,22,5,0,99
12,9,13,9,20,12,5,19,19,118
12,9,13,9,20,15,18,0,0,96
12,9,13,9,20,19,0,0,0,82
12,9,13,12,9,0,0,0,0,55
12,9,13,13,1,0,0,0,0,48
12,9,13,13,1,20,1,0,0,69
12,9,13,13,5,18,0,0,0,70
12,9,13,13,5,18,19,0,0,89
12,9,13,13,15,3,11,0,0,76
12,9,13,13,21,0,0,0,0,68
12,9,13,14,0,0,0,0,0,48
12,25,13,14,1,5,1,14,0,85
12,25,13,14,1,5,9,4,0,83
12,9,13,14,1,12,0,0,0,61
12,9,13,14,1,14,20,8,0,91
12,9,13,14,5,4,0,0,0,57
12,9,13,14,5,18,0,0,0,71
12,9,13,14,5,18,25,0,0,96
12,9,13,14,5,18,19,0,0,90
12,9,13,14,5,20,9,3,0,85
12,9,13,14,9,1,4,0,0,62
12,9,13,14,9,3,0,0,0,60
12,9,13,14,9,14,7,0,0,78
12,9,13,14,9,20,5,0,0,82
12,9,13,14,15,2,9,15,19,108
12,9,13,14,15,12,15,7,25,122
12,9,13,14,15,16,8,9,12,108
12,9,13,14,19,0,0,0,0,67
12,9,13,15,0,0,0,0,0,49
12,9,13,15,9,4,0,0,0,62
12,9,13,15,14,3,9,20,15,110
12,9,13,15,14,5,14,5,0,87
12,9,13,15,14,5,14,5,19,106
12,9,13,15,14,9,1,4,0,77
12,9,13,15,14,9,14,0,0,86
12,9,13,15,14,9,20,5,0,97
12,9,13,15,14,9,20,5,19,116
12,9,13,15,14,9,20,9,3,104
12,9,13,15,14,9,21,13,0,106
12,9,13,15,19,0,0,0,0,68
12,9,13,15,19,5,0,0,0,73
12,9,13,15,21,19,0,0,0,89
12,9,13,15,21,19,9,14,5,117
12,9,13,16,0,0,0,0,0,50
12,9,13,16,1,0,0,0,0,51
12,9,13,16,1,19,0,0,0,70
12,9,13,16,5,4,0,0,0,59
12,9,13,16,5,18,0,0,0,73
12,9,13,16,5,18,19,0,0,92
12,9,13,16,5,19,20,0,0,94
12,9,13,16,5,20,0,0,0,75
12,9,13,16,5,20,19,0,0,94
12,25,13,16,8,0,0,0,0,74
12,25,13,16,8,1,4,0,0,79
12,25,13,16,8,1,20,9,3,107
12,9,13,16,8,1,21,12,20,112
12,25,13,16,8,5,13,9,1,102
12,25,13,16,8,25,0,0,0,99
12,25,13,16,8,15,9,4,0,102
12,25,13,16,8,15,13,1,0,103
12,25,13,16,8,15,13,1,19,122
12,25,13,16,8,15,21,19,0,129
12,25,13,16,8,19,0,0,0,93
12,25,13,16,8,21,18,9,1,123
12,9,13,16,25,0,0,0,0,75
12,9,13,16,9,4,0,0,0,63
12,9,13,16,9,4,9,20,25,117
12,9,13,16,9,4,12,25,0,100
12,9,13,16,9,12,25,0,0,96
12,9,13,16,9,14,0,0,0,73
12,9,13,16,9,14,5,19,19,116
12,9,13,16,9,14,7,0,0,80
12,9,13,16,9,14,7,12,25,117
12,9,13,16,9,19,8,0,0,86
12,9,13,16,11,9,14,0,0,84
12,9,13,16,11,9,14,19,0,103
12,9,13,16,12,25,0,0,0,87
12,9,13,16,14,5,19,19,0,107
12,9,13,16,19,0,0,0,0,69
12,9,13,16,19,5,25,0,0,99
12,9,13,16,19,25,0,0,0,94
12,9,13,16,19,9,5,18,0,101
12,9,13,16,23,15,18,20,0,126
12,9,13,19,25,0,0,0,0,78
12,9,13,21,0,0,0,0,0,55
12,9,13,21,12,9,0,0,0,76
12,9,13,21,12,9,4,0,0,80
12,9,13,21,12,15,9,4,0,95
12,9,13,21,12,15,9,4,19,114
12,9,13,21,18,9,20,5,0,107
12,9,14,1,2,12,5,0,0,55
12,9,14,1,3,0,0,0,0,39
12,9,14,1,3,5,15,21,19,99
12,9,14,1,3,19,0,0,0,58
12,9,14,1,7,1,0,0,0,44
12,9,14,1,7,5,0,0,0,48
12,9,14,1,7,5,19,0,0,67
12,9,14,1,12,25,12,0,0,85
12,9,14,1,12,15,1,0,0,64
12,9,14,1,12,15,5,0,0,68
12,9,14,1,12,15,12,0,0,75
12,9,14,1,12,15,12,19,0,94
12,9,14,1,12,15,15,12,0,90
12,9,14,1,12,15,15,12,19,109
12,9,14,1,13,1,18,9,14,91
12,9,14,1,18,9,20,5,0,88
12,25,14,3,5,1,14,0,0,74
12,25,14,3,8,1,2,12,5,82
12,9,14,3,8,2,15,12,20,95
12,25,14,3,8,5,4,0,0,71
12,25,14,3,8,5,18,0,0,85
12,25,14,3,8,5,18,19,0,104
12,25,14,3,8,5,19,0,0,86
12,9,14,3,8,5,20,0,0,71
12,25,14,3,8,5,20,0,0,87
12,25,14,3,8,9,14,7,0,92
12,25,14,3,8,9,14,7,19,111
12,9,14,3,8,16,9,14,0,85
12,25,14,3,8,16,9,14,0,101
12,9,14,3,8,16,9,14,19,104
12,25,14,3,9,14,5,0,0,82
12,9,14,3,12,15,20,8,0,93
12,9,14,3,18,21,19,20,1,117
12,9,14,3,20,21,18,5,0,102
12,9,14,3,20,21,19,0,0,98
12,9,14,4,1,14,5,0,0,59
12,9,14,4,1,14,5,19,0,78
12,9,14,4,5,14,19,0,0,77
12,9,14,4,9,5,4,0,0,57
12,9,14,4,9,5,19,0,0,72
12,9,14,4,25,9,14,7,0,94
12,9,14,4,15,9,20,5,0,88
12,9,14,4,23,15,18,13,0,108
12,9,14,5,1,2,12,5,0,60
12,9,14,5,1,7,5,0,0,53
12,9,14,5,1,7,5,4,0,57
12,9,14,5,1,7,5,19,0,72
12,9,14,5,1,12,0,0,0,53
12,9,14,5,1,12,9,20,25,107
12,9,14,5,1,12,12,25,0,90
12,9,14,5,1,13,5,14,20,93
12,9,14,5,1,18,0,0,0,59
12,9,14,5,1,18,25,0,0,84
12,9,14,5,1,18,9,19,5,92
12,9,14,5,1,18,9,20,25,113
12,9,14,5,1,18,9,26,5,99
12,9,14,5,1,18,12,25,0,96
12,9,14,5,1,19,0,0,0,60
12,9,14,5,1,20,5,0,0,66
12,9,14,5,1,20,5,4,0,70
12,9,14,5,1,20,9,15,14,99
12,9,14,5,1,20,21,13,0,95
12,9,14,5,1,20,21,18,5,105
12,9,14,5,2,18,5,4,0,69
12,9,14,5,2,18,5,5,4,74
12,9,14,5,3,21,20,0,0,84
12,9,14,5,3,21,20,19,0,103
12,9,14,5,4,0,0,0,0,44
12,9,14,5,6,5,5,4,0,60
12,9,14,5,6,5,5,4,19,79
12,9,14,5,25,0,0,0,0,65
12,9,14,5,9,6,15,18,13,101
12,9,14,5,12,5,19,19,0,95
12,9,14,5,12,5,20,0,0,77
12,9,14,5,12,9,11,5,0,77
12,9,14,5,13,1,14,0,0,68
12,9,14,5,13,5,14,0,0,72
12,9,14,5,14,0,0,0,0,54
12,9,14,5,14,5,18,0,0,77
12,9,14,5,14,5,20,20,5,104
12,9,14,5,14,6,15,12,4,91
12,9,14,5,14,25,0,0,0,79
12,9,14,5,14,9,26,5,0,94
12,9,14,5,14,9,26,5,18,112
12,9,14,5,14,13,1,14,0,82
12,9,14,5,14,19,0,0,0,73
12,9,14,5,15,12,1,20,5,93
12,9,14,5,18,0,0,0,0,58
12,9,14,5,18,1,14,7,5,85
12,9,14,5,18,12,5,19,19,113
12,9,14,5,18,19,0,0,0,77
12,9,14,5,19,0,0,0,0,59
12,9,14,5,19,9,4,5,19,96
12,9,14,5,19,13,1,14,0,87
12,9,14,5,19,13,5,14,0,91
12,9,14,5,20,5,19,20,0,104
12,9,14,5,21,16,0,0,0,77
12,9,14,5,21,16,19,0,0,96
12,9,14,5,23,15,18,11,0,107
12,9,14,7,0,0,0,0,0,42
12,9,14,7,1,0,0,0,0,43
12,9,14,7,1,12,1,0,0,56
12,9,14,7,1,13,0,0,0,56
12,9,14,7,1,13,19,0,0,75
12,9,14,7,1,19,0,0,0,62
12,9,14,7,2,5,18,18,25,110
12,9,14,7,2,9,18,4,0,75
12,9,14,7,3,15,4,0,0,64
12,9,14,7,3,15,4,19,0,83
12,9,14,7,5,0,0,0,0,47
12,9,14,7,5,12,0,0,0,59
12,9,14,7,5,14,3,5,0,69
12,9,14,7,5,18,0,0,0,65
12,9,14,7,5,18,5,4,0,74
12,9,14,7,5,18,5,18,0,88
12,9,14,7,5,18,5,18,19,107
12,9,14,7,5,18,9,5,0,79
12,9,14,7,5,18,9,5,19,98
12,9,14,7,5,18,9,14,7,95
12,9,14,7,5,18,19,0,0,84
12,9,14,7,5,20,0,0,0,67
12,9,14,7,25,0,0,0,0,67
12,9,14,7,9,5,18,0,0,74
12,9,14,7,9,5,19,20,0,95
12,9,14,7,9,19,13,0,0,83
12,9,14,7,15,0,0,0,0,57
12,9,14,7,15,5,0,0,0,62
12,9,14,7,15,5,19,0,0,81
12,9,14,7,15,20,0,0,0,77
12,9,14,7,19,0,0,0,0,61
12,9,14,7,19,20,5,18,0,104
12,9,14,7,20,15,23,0,0,100
12,9,14,7,21,1,0,0,0,64
12,9,14,7,21,1,5,0,0,69
12,9,14,7,21,1,12,0,0,76
12,9,14,7,21,1,12,5,0,81
12,9,14,7,21,1,12,9,19,104
12,9,14,7,21,1,12,12,25,113
12,9,14,7,21,1,12,19,0,95
12,9,14,7,21,5,20,0,0,88
12,9,14,7,21,9,14,5,0,91
12,9,14,7,21,9,14,5,19,110
12,9,14,7,21,9,14,9,0,95
12,9,14,7,21,9,14,9,19,114
12,9,14,7,21,9,19,20,0,111
12,9,14,7,21,9,19,20,19,130
12,9,14,7,21,12,1,0,0,76
12,9,14,7,21,12,1,5,0,81
12,9,14,7,21,12,1,20,5,101
12,9,14,7,21,12,9,4,0,88
12,9,14,7,21,12,15,9,4,103
12,9,14,7,23,15,18,20,0,118
12,9,14,8,1,0,0,0,0,44
12,9,14,8,1,25,0,0,0,69
12,9,14,25,0,0,0,0,0,60
12,9,14,9,5,0,0,0,0,49
12,9,14,9,5,18,0,0,0,67
12,9,14,9,5,19,20,0,0,88
12,9,14,9,25,1,0,0,0,70
12,9,14,9,13,5,14,20,0,96
12,9,14,9,13,5,14,20,19,115
12,9,14,9,14,0,0,0,0,58
12,9,14,9,14,5,19,19,0,101
12,9,14,9,14,7,0,0,0,65
12,9,14,9,14,7,19,0,0,84
12,9,14,9,14,19,0,0,0,77
12,9,14,25,16,8,9,9,4,106
12,9,14,9,20,9,19,0,0,92
12,9,14,10,1,0,0,0,0,46
12,9,14,10,5,0,0,0,0,50
12,9,14,11,1,2,12,5,0,66
12,9,14,11,1,7,5,0,0,59
12,9,14,11,1,7,5,19,0,78
12,9,14,11,2,15,25,0,0,88
12,9,14,11,2,15,25,19,0,107
12,9,14,11,5,4,0,0,0,55
12,9,14,11,5,4,9,20,0,84
12,9,14,11,5,18,19,0,0,88
12,9,14,11,25,0,0,0,0,71
12,9,14,11,9,5,18,0,0,78
12,9,14,11,9,5,19,20,0,99
12,9,14,11,9,14,7,0,0,76
12,9,14,11,13,1,14,0,0,74
12,9,14,11,13,5,14,0,0,78
12,9,14,11,19,0,0,0,0,65
12,9,14,11,19,13,1,14,0,93
12,9,14,11,19,13,5,14,0,97
12,9,14,11,19,13,9,20,8,115
12,9,14,11,19,20,5,18,0,108
12,9,14,11,21,16,0,0,0,83
12,9,14,11,21,16,19,0,0,102
12,9,14,11,23,15,18,11,0,113
12,9,14,11,23,15,18,11,19,132
12,9,14,12,5,25,0,0,0,77
12,9,14,14,1,5,9,20,5,89
12,9,14,14,5,15,14,0,0,83
12,9,14,14,5,20,19,0,0,93
12,25,14,14,8,1,22,5,14,115
12,9,14,14,19,0,0,0,0,68
12,9,14,15,0,0,0,0,0,50
12,9,14,15,3,21,20,0,0,94
12,9,14,15,3,21,20,19,0,113
12,9,14,15,12,1,20,5,0,88
12,9,14,15,12,5,1,20,5,93
12,9,14,15,12,5,9,3,0,79
12,9,14,15,12,5,9,14,0,90
12,9,14,15,12,5,14,9,3,93
12,9,14,15,12,5,14,9,14,104
12,9,14,15,12,5,21,13,0,101
12,9,14,15,12,5,21,13,19,120
12,9,14,15,12,9,3,0,0,74
12,9,14,15,12,9,14,0,0,85
12,9,14,15,13,5,20,5,18,111
12,9,14,15,14,0,0,0,0,64
12,9,14,15,20,25,16,5,19,135
12,9,14,15,21,19,0,0,0,90
12,9,14,15,24,9,14,0,0,97
12,9,14,15,24,25,14,0,0,113
12,9,14,16,9,14,0,0,0,74
12,9,14,17,21,9,19,8,0,109
12,9,14,19,1,14,7,19,0,95
12,9,14,19,5,5,4,0,0,68
12,9,14,19,5,5,4,19,0,87
12,9,14,19,5,25,0,0,0,84
12,9,14,19,5,25,19,0,0,103
12,9,14,19,20,15,3,11,0,103
12,9,14,19,20,15,3,11,19,122
12,9,14,20,0,0,0,0,0,55
12,9,14,20,5,12,0,0,0,72
12,9,14,20,5,12,5,4,0,81
12,9,14,20,5,12,9,14,7,102
12,9,14,20,5,12,12,5,4,93
12,9,14,20,5,12,19,0,0,91
12,9,14,20,5,14,0,0,0,74
12,9,14,20,5,18,0,0,0,78
12,9,14,20,5,18,14,0,0,92
12,9,14,20,5,18,19,0,0,97
12,9,14,20,25,0,0,0,0,80
12,9,14,20,9,5,0,0,0,69
12,9,14,20,9,5,18,0,0,87
12,9,14,20,9,5,19,20,0,108
12,9,14,20,12,5,19,19,0,110
12,9,14,20,15,12,0,0,0,82
12,9,14,20,15,12,19,0,0,101
12,9,14,20,15,14,9,20,5,118
12,9,14,20,19,0,0,0,0,74
12,9,14,20,19,5,5,4,0,88
12,9,14,20,23,8,9,20,5,120
12,9,14,21,13,19,0,0,0,88
12,9,14,21,18,15,14,0,0,103
12,9,14,21,18,15,14,19,0,122
12,25,14,24,5,19,0,0,0,99
12,25,14,24,12,9,11,5,0,112
12,25,15,3,18,1,20,9,3,106
12,9,15,4,5,18,13,9,1,86
12,25,15,12,25,19,9,19,0,136
12,25,15,12,25,20,9,3,0,121
12,25,15,13,5,18,15,21,19,143
12,9,15,13,25,15,13,1,0,103
12,9,15,14,3,5,4,0,0,62
12,9,15,14,3,5,12,0,0,70
12,9,15,14,5,19,17,21,5,117
12,9,15,14,5,19,19,0,0,93
12,9,15,14,5,19,19,5,19,117
12,9,15,14,5,20,0,0,0,75
12,25,15,14,5,20,9,9,4,113
12,9,15,14,6,9,19,8,0,92
12,9,15,14,8,5,1,18,20,102
12,9,15,14,8,15,15,4,0,92
12,9,15,14,9,19,5,0,0,83
12,9,15,14,9,19,5,4,0,87
12,9,15,14,9,19,5,18,0,101
12,9,15,14,9,19,5,18,19,120
12,9,15,14,9,19,5,19,0,102
12,9,15,14,9,19,9,14,7,108
12,9,15,14,9,19,13,0,0,91
12,9,15,14,9,26,5,0,0,90
12,9,15,14,9,26,5,4,0,94
12,9,15,14,9,26,5,18,0,108
12,9,15,14,9,26,5,18,19,127
12,9,15,14,9,26,5,19,0,109
12,9,15,14,9,26,9,14,7,115
12,9,15,14,12,25,0,0,0,87
12,9,15,14,12,9,11,5,0,87
12,25,15,14,14,1,9,19,5,114
12,9,15,14,14,5,0,0,0,69
12,9,15,14,16,18,15,15,6,120
12,9,15,14,19,8,9,16,0,102
12,25,15,16,8,9,12,0,0,97
12,25,15,16,8,9,12,5,0,102
12,25,15,16,8,9,12,5,4,106
12,25,15,16,8,9,12,9,3,109
12,25,15,16,8,15,2,5,0,98
12,25,15,16,8,15,2,9,3,105
12,25,15,20,18,15,16,5,0,126
12,25,15,20,18,15,16,9,3,133
12,9,16,0,0,0,0,0,0,37
12,9,16,1,0,0,0,0,0,38
12,9,16,1,5,13,9,1,0,66
12,9,16,1,5,13,9,3,0,68
12,9,16,1,18,9,4,0,0,69
12,9,16,1,18,9,20,5,0,90
12,9,16,1,18,15,9,4,0,84
12,9,16,1,18,15,21,19,0,111
12,9,16,1,19,5,0,0,0,62
12,9,16,1,19,5,19,0,0,81
12,9,16,5,3,20,15,13,25,118
12,25,16,5,13,1,14,9,1,96
12,9,16,5,13,9,1,0,0,65
12,9,16,5,13,9,3,0,0,67
12,9,16,9,3,0,0,0,0,49
12,9,16,9,4,0,0,0,0,50
12,9,16,9,4,5,0,0,0,55
12,9,16,9,4,5,19,0,0,74
12,9,16,9,4,9,3,0,0,62
12,9,16,9,4,19,0,0,0,69
12,9,16,9,14,0,0,0,0,60
12,9,16,9,14,19,0,0,0,79
12,9,16,12,5,19,19,0,0,92
12,9,16,12,5,20,0,0,0,74
12,9,16,12,9,11,5,0,0,74
12,9,16,15,2,12,1,19,20,106
12,9,16,15,3,1,9,3,0,68
12,9,16,15,3,5,12,5,0,77
12,9,16,15,3,5,18,5,0,83
12,9,16,15,3,25,20,5,0,105
12,9,16,15,3,25,20,5,19,124
12,9,16,15,7,5,14,9,3,90
12,9,16,15,7,18,1,13,0,91
12,9,16,15,8,5,13,9,1,88
12,9,16,15,9,4,0,0,0,65
12,9,16,15,9,4,1,12,0,78
12,9,16,15,9,4,9,3,0,77
12,9,16,15,9,4,19,0,0,84
12,9,16,15,12,25,19,5,19,132
12,9,16,15,12,25,19,9,19,136
12,9,16,15,12,9,20,9,3,105
12,9,16,15,12,25,20,9,3,121
12,9,16,15,13,1,0,0,0,66
12,9,16,15,13,1,19,0,0,85
12,9,16,15,13,1,20,1,0,87
12,9,16,15,13,25,15,13,1,119
12,9,16,15,13,15,18,16,8,122
12,9,16,15,16,5,24,9,1,107
12,9,16,15,16,8,15,18,5,114
12,9,16,15,16,15,4,0,0,87
12,9,16,15,19,9,19,0,0,99
12,9,16,15,19,15,13,5,0,104
12,9,16,15,19,20,15,13,25,144
12,9,16,15,20,8,25,13,25,143
12,9,16,15,20,25,16,5,0,118
12,9,16,15,20,18,15,16,25,146
12,9,16,15,24,5,14,25,0,120
12,9,16,16,5,4,0,0,0,62
12,9,16,16,5,14,0,0,0,72
12,9,16,16,5,14,5,4,0,81
12,9,16,16,5,14,9,14,7,102
12,9,16,16,5,14,19,0,0,91
12,9,16,16,5,18,0,0,0,76
12,9,16,16,5,18,5,4,0,85
12,9,16,16,5,18,9,14,7,106
12,9,16,16,5,18,19,0,0,95
12,9,16,16,25,0,0,0,0,78
12,9,16,16,9,5,0,0,0,67
12,9,16,16,9,5,18,0,0,85
12,9,16,16,9,5,19,20,0,106
12,9,16,16,9,14,5,19,19,119
12,9,16,16,9,14,7,0,0,83
12,9,16,16,9,14,7,19,0,102
12,9,16,16,9,20,21,4,5,112
12,9,16,16,9,20,21,4,15,122
12,9,16,18,5,1,4,0,0,65
12,9,16,19,1,12,22,5,0,96
12,9,16,19,5,0,0,0,0,61
12,9,16,19,20,9,3,11,0,99
12,9,16,19,20,9,3,11,19,118
12,9,16,21,18,9,1,0,0,86
12,9,16,23,15,18,11,0,0,104
12,9,17,0,0,0,0,0,0,38
12,9,17,21,1,2,12,5,0,79
12,9,17,21,1,13,5,14,0,92
12,9,17,21,1,20,5,0,0,85
12,9,17,21,1,20,5,4,0,89
12,9,17,21,1,20,5,19,0,104
12,9,17,21,1,20,9,14,7,110
12,9,17,21,1,20,9,15,14,118
12,9,17,21,5,6,25,0,0,95
12,9,17,21,5,6,9,5,4,88
12,9,17,21,5,6,9,5,18,102
12,9,17,21,5,6,9,5,19,103
12,9,17,21,5,18,0,0,0,82
12,9,17,21,5,19,3,5,0,91
12,9,17,21,5,20,0,0,0,84
12,9,17,21,5,21,18,0,0,103
12,9,17,21,5,21,18,5,4,112
12,9,17,21,5,21,18,19,0,122
12,9,17,21,9,4,0,0,0,72
12,9,17,21,9,4,1,20,5,98
12,9,17,21,9,4,25,0,0,97
12,9,17,21,9,4,9,19,5,105
12,9,17,21,9,4,9,20,25,126
12,9,17,21,9,4,9,26,5,112
12,9,17,21,9,4,12,25,0,109
12,9,17,21,9,4,19,0,0,91
12,9,17,21,9,4,21,19,0,112
12,9,17,21,9,6,25,0,0,99
12,9,17,21,9,6,9,5,4,92
12,9,17,21,9,6,9,5,18,106
12,9,17,21,9,6,9,5,19,107
12,9,17,21,9,6,15,18,13,120
12,9,17,21,15,18,0,0,0,92
12,9,17,21,15,18,5,4,0,101
12,9,17,21,15,18,5,18,0,115
12,9,17,21,15,18,25,0,0,117
12,9,17,21,15,18,9,3,5,109
12,9,17,21,15,18,9,14,7,122
12,9,17,21,15,18,9,19,8,128
12,9,17,21,15,18,9,19,20,140
12,9,17,21,15,18,19,0,0,111
12,9,18,1,19,0,0,0,0,59
12,9,18,1,20,5,0,0,0,65
12,25,18,1,20,5,0,0,0,81
12,25,18,1,20,5,4,0,0,85
12,25,18,1,20,5,12,25,0,118
12,9,18,1,20,9,15,14,0,98
12,25,18,1,23,1,25,0,0,105
12,9,18,5,0,0,0,0,0,44
12,25,18,5,0,0,0,0,0,60
12,25,18,5,2,9,18,4,0,93
12,25,18,5,2,9,18,4,19,112
12,9,18,5,12,12,1,0,0,69
12,9,18,5,12,12,1,20,5,94
12,9,18,5,12,12,9,14,5,96
12,9,18,5,12,12,15,21,19,123
12,25,18,5,13,1,14,0,0,88
12,25,18,5,19,0,0,0,0,79
12,25,18,5,20,1,9,12,0,102
12,25,18,9,3,0,0,0,0,67
12,25,18,9,3,1,12,0,0,80
12,25,18,9,3,1,12,12,25,117
12,25,18,9,3,8,15,18,4,112
12,25,18,9,3,9,19,5,0,100
12,25,18,9,3,9,19,5,4,104
12,25,18,9,3,9,19,5,19,119
12,25,18,9,3,9,19,13,0,108
12,25,18,9,3,9,19,13,19,127
12,25,18,9,3,9,19,20,0,115
12,25,18,9,3,9,19,20,19,134
12,25,18,9,3,9,26,5,0,107
12,25,18,9,3,9,26,5,4,111
12,25,18,9,3,9,26,5,19,126
12,25,18,9,3,11,5,4,0,87
12,25,18,9,3,11,9,14,7,108
12,25,18,9,3,19,0,0,0,86
12,25,18,9,6,15,18,13,0,116
12,9,18,9,15,4,4,18,1,90
12,9,18,9,16,9,16,5,0,94
12,9,18,9,16,9,16,5,19,113
12,9,18,9,16,15,15,16,0,110
12,25,18,9,19,13,0,0,0,96
12,25,18,9,19,13,19,0,0,115
12,25,18,9,19,20,0,0,0,103
12,25,18,9,19,20,19,0,0,122
12,9,18,15,20,0,0,0,0,74
12,9,18,15,20,8,0,0,0,82
12,9,19,0,0,0,0,0,0,40
12,25,19,1,20,5,0,0,0,82
12,25,19,1,20,5,19,0,0,101
12,25,19,5,0,0,0,0,0,61
12,25,19,5,4,0,0,0,0,65
12,9,19,5,14,20,5,0,0,84
12,9,19,5,18,5,0,0,0,68
12,25,19,5,18,7,9,3,0,98
12,25,19,5,19,0,0,0,0,80
12,9,19,8,0,0,0,0,0,48
12,25,19,9,4,9,14,0,0,92
12,25,19,9,4,9,14,5,0,97
12,9,19,9,5,18,5,0,0,77
12,25,19,9,7,5,14,9,3,103
12,25,19,9,13,5,20,5,18,126
12,25,19,9,14,0,0,0,0,79
12,25,19,9,14,5,0,0,0,84
12,25,19,9,14,5,19,0,0,103
12,25,19,9,14,7,0,0,0,86
12,25,19,9,14,19,0,0,0,98
12,25,19,9,19,0,0,0,0,84
12,9,19,12,5,19,0,0,0,76
12,25,19,15,7,5,14,0,0,97
12,25,19,15,7,5,14,25,0,122
12,25,19,15,7,5,14,9,3,109
12,25,19,15,7,5,14,19,0,116
12,25,19,15,19,15,13,1,12,131
12,25,19,15,19,15,13,5,0,123
12,25,19,15,19,15,13,5,19,142
12,25,19,15,26,25,13,5,0,140
12,25,19,15,26,25,13,5,19,159
12,9,19,16,5,4,0,0,0,65
12,9,19,16,5,18,0,0,0,79
12,9,19,16,5,18,19,0,0,98
12,9,19,16,9,14,7,0,0,86
12,9,19,16,9,14,7,12,25,123
12,9,19,16,15,21,14,4,0,110
12,9,19,16,19,0,0,0,0,75
12,9,19,16,21,14,4,0,0,95
12,25,19,19,1,19,0,0,0,95
12,9,19,19,5,19,0,0,0,83
12,25,19,19,9,3,0,0,0,87
12,9,19,19,15,13,0,0,0,87
12,9,19,19,15,13,5,0,0,92
12,9,19,19,15,13,5,12,25,129
12,9,19,19,15,13,12,25,0,124
12,9,19,20,1,2,12,5,0,80
12,9,19,20,5,4,0,0,0,69
12,9,19,20,5,12,0,0,0,77
12,9,19,20,5,12,19,0,0,96
12,9,19,20,5,14,0,0,0,79
12,9,19,20,5,14,5,4,0,88
12,9,19,20,5,14,5,18,0,102
12,9,19,20,5,14,5,18,19,121
12,9,19,20,5,14,9,14,7,109
12,9,19,20,5,14,19,0,0,98
12,9,19,20,5,18,19,0,0,102
12,9,19,20,6,21,12,0,0,99
12,9,19,20,25,0,0,0,0,85
12,9,19,20,9,14,7,0,0,90
12,9,19,20,9,14,7,19,0,109
12,9,19,20,12,5,19,19,0,115
12,9,19,20,18,5,4,0,0,87
12,9,19,20,19,0,0,0,0,79
12,9,19,20,23,15,18,11,0,127
12,9,20,1,9,0,0,0,0,51
12,9,20,1,14,25,0,0,0,81
12,9,20,1,14,9,5,19,0,89
12,9,20,1,18,7,5,0,0,72
12,9,20,1,19,0,0,0,0,61
12,9,20,1,20,9,15,14,0,100
12,9,20,1,20,21,0,0,0,83
12,9,20,3,8,9,0,0,0,61
12,9,20,3,8,9,19,0,0,80
12,9,20,5,0,0,0,0,0,46
12,25,20,5,0,0,0,0,0,62
12,9,20,5,18,0,0,0,0,64
12,9,20,5,18,1,3,25,0,93
12,9,20,5,18,1,9,12,25,111
12,9,20,5,18,1,12,0,0,77
12,9,20,5,18,1,12,12,25,114
12,9,20,5,18,1,12,19,0,96
12,9,20,5,18,1,18,25,0,108
12,9,20,5,18,1,20,1,0,86
12,9,20,5,18,1,20,5,0,90
12,9,20,5,18,1,20,5,4,94
12,9,20,5,18,1,20,5,19,109
12,9,20,5,18,1,20,9,0,94
12,9,20,5,18,1,20,9,13,107
12,9,20,5,18,1,20,15,0,100
12,9,20,5,18,1,20,15,18,118
12,9,20,5,18,1,20,15,19,119
12,9,20,5,18,1,20,21,19,125
12,25,20,5,18,9,1,14,0,104
12,9,20,5,18,15,19,5,0,103
12,9,20,5,18,19,0,0,0,83
12,9,20,5,19,0,0,0,0,65
12,9,20,8,0,0,0,0,0,49
12,9,20,8,1,5,13,9,1,78
12,9,20,8,1,5,13,9,3,80
12,9,20,8,1,14,15,4,5,88
12,9,20,8,1,18,7,5,0,80
12,9,20,8,1,18,7,5,19,99
12,9,20,8,1,20,5,0,0,75
12,9,20,8,1,20,9,3,0,82
12,9,20,8,5,0,0,0,0,54
12,25,20,8,5,0,0,0,0,70
12,9,20,8,5,12,25,0,0,91
12,9,20,8,5,13,9,1,0,77
12,9,20,8,5,13,9,1,19,96
12,9,20,8,5,13,9,3,0,79
12,9,20,8,5,14,5,19,19,111
12,9,20,8,5,18,0,0,0,72
12,9,20,8,5,18,12,25,0,109
12,9,20,8,5,19,15,13,5,106
12,9,20,8,5,19,20,0,0,93
12,9,20,8,9,0,0,0,0,58
12,9,20,8,25,0,0,0,0,74
12,9,20,8,9,1,19,0,0,78
12,9,20,8,9,1,19,9,19,106
12,9,20,8,9,1,20,5,0,84
12,9,20,8,9,3,0,0,0,61
12,9,20,8,9,6,25,0,0,89
12,9,20,8,9,6,9,5,4,82
12,9,20,8,9,20,5,0,0,83
12,9,20,8,9,21,13,0,0,92
12,9,20,8,9,21,13,19,0,111
12,9,20,8,12,5,19,19,0,104
12,9,20,8,15,0,0,0,0,64
12,9,20,8,15,2,9,9,4,88
12,9,20,8,15,3,25,19,20,131
12,9,20,8,15,4,9,4,0,81
12,9,20,8,15,5,4,0,0,73
12,9,20,8,15,7,0,0,0,71
12,9,20,8,15,7,5,14,25,115
12,9,20,8,15,9,4,0,0,77
12,9,20,8,15,9,4,1,12,90
12,9,20,8,15,9,14,7,0,94
12,9,20,8,15,12,0,0,0,76
12,9,20,8,15,12,1,2,5,84
12,9,20,8,15,12,25,20,5,126
12,9,20,8,15,12,15,7,25,123
12,9,20,8,15,16,8,25,12,125
12,9,20,8,15,16,15,14,5,114
12,9,20,8,15,19,0,0,0,83
12,9,20,8,15,19,5,18,5,111
12,9,20,8,15,19,9,1,14,107
12,9,20,8,15,19,9,9,4,105
12,9,20,8,15,19,9,19,0,111
12,9,20,8,15,19,15,12,0,110
12,9,20,8,15,19,15,12,19,129
12,9,20,8,15,20,9,14,20,127
12,9,20,8,15,20,25,16,5,130
12,9,20,8,15,20,25,16,25,150
12,9,20,8,15,20,15,13,5,117
12,9,20,8,15,20,15,13,25,137
12,9,20,8,15,20,15,14,25,138
12,9,20,8,15,21,19,0,0,104
12,9,20,8,15,24,25,12,0,125
12,9,20,8,15,24,25,12,5,130
12,9,20,8,19,13,1,14,0,96
12,9,20,8,21,18,9,1,0,98
12,9,20,9,0,0,0,0,0,50
12,25,20,9,3,0,0,0,0,69
12,25,20,9,3,1,12,12,25,119
12,9,20,9,7,1,2,12,5,77
12,9,20,9,7,1,14,20,0,92
12,9,20,9,7,1,14,20,19,111
12,9,20,9,7,1,20,5,0,83
12,9,20,9,7,1,20,5,4,87
12,9,20,9,7,1,20,5,19,102
12,9,20,9,7,1,20,15,18,111
12,9,20,9,7,9,15,21,19,121
12,9,20,13,21,19,0,0,0,94
12,9,20,13,21,19,5,19,0,118
12,9,20,15,18,1,12,0,0,87
12,9,20,15,20,5,19,0,0,100
12,9,20,15,20,9,3,0,0,88
12,9,20,18,1,0,0,0,0,60
12,9,20,18,5,0,0,0,0,64
12,9,20,18,5,19,0,0,0,83
12,9,20,19,0,0,0,0,0,60
12,9,20,19,20,5,18,0,0,103
12,25,20,20,1,0,0,0,0,78
12,25,20,20,1,5,0,0,0,83
12,25,20,20,1,19,0,0,0,97
12,9,20,20,5,14,0,0,0,80
12,9,20,20,5,18,0,0,0,84
12,9,20,20,5,18,2,1,7,94
12,9,20,20,5,18,2,21,7,114
12,9,20,20,5,18,5,4,0,93
12,9,20,20,5,18,5,18,0,107
12,9,20,20,5,18,5,18,19,126
12,9,20,20,5,18,25,0,0,109
12,9,20,20,5,18,9,14,7,114
12,9,20,20,5,18,19,0,0,103
12,9,20,20,12,5,18,0,0,96
12,9,20,20,12,5,19,0,0,97
12,9,20,20,12,5,19,20,0,117
12,9,20,20,12,9,14,0,0,96
12,9,20,20,12,9,14,7,0,103
12,9,20,20,12,9,19,8,0,109
12,9,20,20,15,18,1,12,0,107
12,9,20,20,15,18,1,12,19,126
12,9,20,20,18,5,19,19,0,122
12,9,20,21,0,0,0,0,0,62
12,9,20,21,1,20,5,0,0,88
12,9,20,21,9,0,0,0,0,71
12,9,20,21,9,6,15,18,13,123
12,9,20,21,9,20,5,0,0,96
12,9,20,21,9,20,15,9,4,119
12,9,20,21,15,12,9,14,5,117
12,9,20,21,15,12,15,9,4,117
12,9,20,21,18,1,20,5,0,106
12,9,20,21,18,7,25,0,0,112
12,9,20,21,18,7,9,3,0,99
12,9,20,21,18,7,9,3,19,118
12,9,20,21,18,7,9,5,19,120
12,9,20,21,18,7,9,19,13,128
12,9,20,21,18,7,9,19,20,135
12,9,20,21,18,7,9,26,5,127
12,9,20,21,19,0,0,0,0,81
12,9,20,21,21,19,0,0,0,102
12,9,20,26,0,0,0,0,0,67
12,9,22,1,2,12,5,0,0,63
12,9,22,1,2,12,25,0,0,83
12,9,22,5,0,0,0,0,0,48
12,9,22,5,1,2,12,5,0,68
12,9,22,5,2,15,18,14,0,97
12,9,22,5,4,0,0,0,0,52
12,9,22,5,4,15,0,0,0,67
12,9,22,5,25,5,18,0,0,96
12,9,22,5,12,9,5,18,0,92
12,9,22,5,12,9,5,19,20,113
12,9,22,5,12,9,12,25,0,106
12,9,22,5,12,15,14,7,0,96
12,9,22,5,14,0,0,0,0,62
12,9,22,5,14,5,4,0,0,71
12,9,22,5,14,5,18,0,0,85
12,9,22,5,14,5,18,19,0,104
12,9,22,5,14,5,19,19,0,105
12,9,22,5,14,9,14,7,0,92
12,9,22,5,14,19,0,0,0,81
12,9,22,5,18,0,0,0,0,66
12,9,22,5,18,1,14,3,5,89
12,9,22,5,18,5,4,0,0,75
12,9,22,5,18,25,0,0,0,91
12,9,22,5,18,25,4,15,13,123
12,9,22,5,18,9,5,4,0,84
12,9,22,5,18,9,5,19,0,99
12,9,22,5,18,25,13,1,14,119
12,9,22,5,18,25,13,5,14,123
12,9,22,5,18,9,14,7,0,96
12,9,22,5,18,9,19,8,0,102
12,9,22,5,18,12,5,1,6,90
12,9,22,5,18,12,5,19,19,121
12,9,22,5,18,19,0,0,0,85
12,9,22,5,18,23,15,18,20,142
12,9,22,5,19,0,0,0,0,67
12,9,22,5,19,20,0,0,0,87
12,9,22,5,19,20,15,3,11,116
12,9,22,5,20,8,0,0,0,76
12,9,22,5,20,9,14,0,0,91
12,9,22,5,20,18,1,16,0,103
12,9,22,5,20,18,1,16,19,122
12,9,22,5,23,1,18,5,0,95
12,9,22,9,4,0,0,0,0,56
12,9,22,9,4,9,20,25,0,110
12,9,22,9,4,12,25,0,0,93
12,9,22,9,4,14,5,19,19,113
12,9,22,9,5,18,0,0,0,75
12,9,22,25,5,18,0,0,0,91
12,9,22,9,5,18,19,0,0,94
12,9,22,25,5,18,19,0,0,110
12,9,22,9,14,7,0,0,0,73
12,9,22,9,14,7,12,25,0,110
12,9,22,9,14,7,19,0,0,92
12,9,22,9,19,8,12,25,0,116
12,9,22,12,9,8,15,15,4,106
12,9,22,15,18,0,0,0,0,76
12,9,22,18,1,9,19,15,14,119
12,9,22,18,5,0,0,0,0,66
12,9,22,18,5,19,0,0,0,85
12,9,23,1,14,0,0,0,0,59
12,9,24,9,22,5,0,0,0,81
12,9,24,9,22,9,1,0,0,86
12,9,24,9,22,9,1,12,0,98
12,9,24,9,22,9,1,20,5,111
12,9,24,9,22,9,15,21,19,140
12,9,24,9,22,9,21,13,0,119
12,9,24,9,22,9,21,13,19,138
12,25,24,15,19,5,0,0,0,100
12,9,26,1,18,4,19,0,0,89
12,9,26,1,18,25,0,0,0,91
12,25,26,5,0,0,0,0,0,68
12,12,5,18,0,0,0,0,0,47
12,12,25,14,0,0,0,0,0,63
12,14,4,7,0,0,0,0,0,37
12,14,18,0,0,0,0,0,0,44
12,15,2,1,12,0,0,0,0,42
12,15,2,1,18,0,0,0,0,48
12,15,2,1,20,5,0,0,0,55
12,15,2,1,20,5,4,0,0,59
12,15,2,1,20,5,12,25,0,92
12,15,2,1,20,9,15,14,0,88
12,15,2,1,20,9,15,14,19,107
12,15,2,2,5,4,0,0,0,40
12,15,2,2,5,18,19,0,0,73
12,15,2,2,25,0,0,0,0,56
12,15,2,2,9,5,4,0,0,49
12,15,2,2,25,5,18,0,0,79
12,15,2,2,25,5,18,19,0,98
12,15,2,2,9,5,19,0,0,64
12,15,2,2,25,7,15,23,0,101
12,15,2,2,25,7,15,23,19,120
12,15,2,2,25,9,14,7,0,86
12,15,2,2,25,9,19,13,0,97
12,15,2,2,25,9,19,13,19,116
12,15,2,2,25,9,19,20,0,104
12,15,2,2,25,9,19,20,19,123
12,15,2,2,25,13,1,14,0,84
12,15,2,2,25,13,5,14,0,88
12,15,2,2,9,14,7,0,0,61
12,15,2,2,9,19,8,0,0,67
12,15,2,3,15,3,11,0,0,61
12,15,2,3,15,11,20,0,0,78
12,15,2,5,0,0,0,0,0,34
12,15,2,5,3,20,15,13,25,110
12,15,2,5,4,0,0,0,0,38
12,15,2,5,6,9,14,0,0,63
12,15,2,5,6,9,14,19,0,82
12,15,2,5,6,15,15,20,0,90
12,15,2,5,6,15,15,20,19,109
12,15,2,5,12,5,19,19,0,89
12,15,2,5,12,5,20,0,0,71
12,15,2,5,12,9,1,19,0,75
12,15,2,5,12,9,14,0,0,69
12,15,2,5,12,9,14,5,0,74
12,15,2,5,12,9,14,5,19,93
12,15,2,5,19,0,0,0,0,53
12,15,2,6,9,7,0,0,0,51
12,15,2,9,0,0,0,0,0,38
12,15,2,9,6,15,18,13,0,90
12,15,2,9,14,7,0,0,0,59
12,15,2,9,16,5,4,0,0,63
12,15,2,12,15,12,12,25,0,105
12,15,2,15,0,0,0,0,0,44
12,15,2,15,12,1,0,0,0,57
12,15,2,15,12,15,0,0,0,71
12,15,2,15,12,15,19,0,0,90
12,15,2,15,19,0,0,0,0,63
12,15,2,15,19,5,0,0,0,68
12,15,2,15,20,15,13,25,0,117
12,15,2,19,0,0,0,0,0,48
12,15,2,19,3,15,21,19,5,111
12,15,2,19,9,4,5,4,0,70
12,15,2,19,20,5,18,0,0,91
12,15,2,19,20,5,18,19,0,110
12,15,2,19,20,9,3,11,0,91
12,15,2,19,20,9,3,11,19,110
12,15,2,20,1,9,12,0,0,71
12,15,2,21,12,1,18,0,0,81
12,15,2,21,12,1,18,12,25,118
12,15,2,21,12,1,20,5,0,88
12,15,2,21,12,1,20,5,4,92
12,15,2,21,12,5,0,0,0,67
12,15,2,21,12,5,19,0,0,86
12,15,2,21,12,5,20,20,5,112
12,15,2,21,12,9,0,0,0,71
12,15,2,21,12,15,19,5,0,101
12,15,2,21,12,15,21,19,0,117
12,15,2,21,12,21,19,0,0,102
12,15,2,21,19,0,0,0,0,69
12,15,2,23,15,18,13,0,0,98
12,15,2,23,15,18,13,19,0,117
12,15,3,1,0,0,0,0,0,31
12,15,3,1,2,12,5,0,0,50
12,15,3,1,12,0,0,0,0,43
12,15,3,1,12,5,0,0,0,48
12,15,3,1,12,5,4,0,0,52
12,15,3,1,12,5,19,0,0,67
12,15,3,1,12,9,14,7,0,73
12,15,3,1,12,9,19,5,0,76
12,15,3,1,12,9,19,5,4,80
12,15,3,1,12,9,19,5,18,94
12,15,3,1,12,9,19,5,19,95
12,15,3,1,12,9,19,13,0,84
12,15,3,1,12,9,19,13,19,103
12,15,3,1,12,9,19,20,0,91
12,15,3,1,12,9,19,20,19,110
12,15,3,1,12,9,20,5,0,77
12,15,3,1,12,9,20,5,19,96
12,15,3,1,12,9,20,25,0,97
12,15,3,1,12,9,26,5,0,83
12,15,3,1,12,9,26,5,4,87
12,15,3,1,12,9,26,5,18,101
12,15,3,1,12,9,26,5,19,102
12,15,3,1,12,12,5,4,0,64
12,15,3,1,12,12,25,0,0,80
12,15,3,1,12,12,9,14,7,85
12,15,3,1,12,14,5,19,19,100
12,15,3,1,12,19,0,0,0,62
12,15,3,1,14,4,1,0,0,50
12,15,3,1,20,1,2,12,5,71
12,15,3,1,20,5,0,0,0,56
12,15,3,1,20,5,4,0,0,60
12,15,3,1,20,5,18,0,0,74
12,15,3,1,20,5,18,19,0,93
12,15,3,1,20,5,19,0,0,75
12,15,3,1,20,9,14,7,0,81
12,15,3,1,20,9,15,0,0,75
12,15,3,1,20,9,15,14,0,89
12,15,3,1,20,9,15,14,19,108
12,15,3,1,20,9,22,5,0,87
12,15,3,1,20,9,22,5,19,106
12,15,3,1,20,15,18,0,0,84
12,15,3,1,20,15,18,19,0,103
12,15,3,1,20,21,13,0,0,85
12,15,3,5,12,12,1,20,5,85
12,15,3,5,12,12,21,19,0,99
12,15,3,8,1,2,5,18,0,64
12,15,3,8,1,7,5,0,0,51
12,15,3,8,1,7,21,19,0,86
12,15,3,8,1,14,0,0,0,53
12,15,3,8,5,0,0,0,0,43
12,15,3,8,5,20,9,3,0,75
12,15,3,8,9,0,0,0,0,47
12,15,3,8,25,0,0,0,0,63
12,15,3,8,9,1,12,0,0,60
12,15,3,8,15,16,25,18,1,113
12,15,3,8,19,0,0,0,0,57
12,15,3,8,21,19,0,0,0,78
12,15,3,9,0,0,0,0,0,39
12,15,3,9,1,20,9,15,14,98
12,15,3,11,0,0,0,0,0,41
12,15,3,11,1,2,12,5,0,61
12,15,3,11,1,7,5,0,0,54
12,15,3,11,1,7,5,19,0,73
12,15,3,11,2,15,24,0,0,82
12,15,3,11,2,15,24,5,19,106
12,15,3,11,5,4,0,0,0,50
12,15,3,11,5,18,0,0,0,64
12,15,3,11,5,18,13,1,14,92
12,15,3,11,5,18,13,5,14,96
12,15,3,11,5,18,19,0,0,83
12,15,3,11,5,20,0,0,0,66
12,15,3,11,5,20,19,0,0,85
12,15,3,11,6,1,19,20,0,87
12,15,3,11,6,21,12,0,0,80
12,15,3,11,8,15,12,5,0,81
12,15,3,11,9,14,7,0,0,71
12,15,3,11,9,14,7,19,0,90
12,15,3,11,10,1,23,0,0,75
12,15,3,11,10,1,23,19,0,94
12,15,3,11,12,5,19,19,0,96
12,15,3,11,12,5,20,0,0,78
12,15,3,11,13,1,11,5,18,89
12,15,3,11,13,1,14,0,0,69
12,15,3,11,14,21,20,0,0,96
12,15,3,11,14,21,20,19,0,115
12,15,3,11,15,21,20,0,0,97
12,15,3,11,15,21,20,19,0,116
12,15,3,11,16,9,14,0,0,80
12,15,3,11,18,1,13,0,0,73
12,15,3,11,18,1,13,19,0,92
12,15,3,11,18,21,13,0,0,93
12,15,3,11,19,0,0,0,0,60
12,15,3,11,19,13,1,14,0,88
12,15,3,11,19,13,9,20,8,110
12,15,3,11,19,16,9,20,0,105
12,15,3,11,19,20,5,16,0,101
12,15,3,11,19,20,5,16,19,120
12,15,3,11,21,16,0,0,0,78
12,15,3,11,21,16,19,0,0,97
12,15,3,11,23,15,18,11,0,108
12,15,3,14,0,0,0,0,0,44
12,15,3,15,5,4,0,0,0,54
12,15,3,15,5,19,0,0,0,69
12,15,3,15,6,15,3,15,19,103
12,15,3,15,9,14,7,0,0,75
12,15,3,15,9,19,13,0,0,86
12,15,3,15,9,19,13,19,0,105
12,15,3,15,13,1,14,0,0,73
12,15,3,15,13,15,20,5,0,98
12,15,3,15,13,15,20,5,4,102
12,15,3,15,13,15,20,5,19,117
12,15,3,15,13,15,20,15,18,126
12,15,3,15,19,0,0,0,0,64
12,15,3,15,23,5,5,4,0,82
12,15,3,15,23,5,5,4,19,101
12,15,3,21,12,1,18,0,0,82
12,15,3,21,12,1,20,5,0,89
12,15,3,21,12,1,20,5,4,93
12,15,3,21,12,5,0,0,0,68
12,15,3,21,12,5,4,0,0,72
12,15,3,21,12,5,19,0,0,87
12,15,3,21,12,9,0,0,0,72
12,15,3,21,12,15,19,5,0,102
12,15,3,21,12,15,21,19,0,118
12,15,3,21,12,21,19,0,0,103
12,15,3,21,13,0,0,0,0,64
12,15,3,21,13,19,0,0,0,83
12,15,3,21,16,12,5,20,5,109
12,15,3,21,19,0,0,0,0,70
12,15,3,21,19,3,1,0,0,74
12,15,3,21,19,20,0,0,0,90
12,15,3,21,19,20,1,0,0,91
12,15,3,21,19,20,1,5,0,96
12,15,3,21,19,20,1,12,0,103
12,15,3,21,19,20,9,4,0,103
12,15,3,21,19,20,9,14,7,120
12,15,3,21,19,20,19,0,0,109
12,15,3,21,20,9,15,14,0,109
12,15,3,21,20,9,15,14,19,128
12,15,3,21,20,15,18,0,0,104
12,15,3,21,20,15,18,25,0,129
12,15,3,21,20,15,18,9,1,114
12,15,4,5,0,0,0,0,0,36
12,15,4,5,13,1,14,0,0,64
12,15,4,5,14,0,0,0,0,50
12,15,4,5,14,19,0,0,0,69
12,15,4,5,19,0,0,0,0,55
12,15,4,5,19,13,1,14,0,83
12,15,4,5,19,13,5,14,0,87
12,15,4,5,19,20,1,18,0,94
12,15,4,5,19,20,1,18,19,113
12,15,4,5,19,20,15,14,5,109
12,15,4,5,19,20,21,6,6,108
12,15,4,7,5,1,2,12,5,63
12,15,4,7,5,4,0,0,0,47
12,15,4,7,5,6,21,12,0,82
12,15,4,7,5,13,1,14,0,71
12,15,4,7,5,13,5,14,20,95
12,15,4,7,5,16,15,12,5,91
12,15,4,7,5,18,0,0,0,61
12,15,4,7,5,18,4,15,13,93
12,15,4,7,5,18,19,0,0,80
12,15,4,7,5,19,0,0,0,62
12,15,4,7,9,14,7,0,0,68
12,15,4,7,9,14,7,19,0,87
12,15,4,7,13,5,14,20,0,90
12,15,4,7,13,5,14,20,19,109
12,15,4,9,3,21,12,1,0,77
12,15,4,9,3,21,12,5,0,81
12,15,4,9,3,21,12,5,19,100
12,15,5,4,0,0,0,0,0,36
12,15,5,9,12,0,0,0,0,53
12,15,5,9,14,7,0,0,0,62
12,15,5,19,19,0,0,0,0,70
12,15,5,19,19,1,12,0,0,83
12,15,5,19,19,5,19,0,0,94
12,15,5,19,19,9,1,12,0,92
12,15,5,19,19,9,3,0,0,82
12,15,5,19,19,12,1,14,4,101
12,15,5,19,19,15,9,4,0,98
12,15,6,19,20,5,12,12,5,106
12,15,6,20,5,4,0,0,0,62
12,15,6,20,5,18,0,0,0,76
12,15,6,20,5,18,19,0,0,95
12,15,6,20,25,0,0,0,0,78
12,15,6,20,9,5,18,0,0,85
12,15,6,20,9,5,19,20,0,106
12,15,6,20,9,12,25,0,0,99
12,15,6,20,9,14,5,19,19,119
12,15,6,20,12,5,19,19,0,108
12,15,6,20,13,1,14,0,0,81
12,15,6,20,13,5,14,0,0,85
12,15,6,20,19,0,0,0,0,72
12,15,6,20,19,13,1,14,0,100
12,15,6,20,19,13,5,14,0,104
12,15,7,0,0,0,0,0,0,34
12,15,7,1,14,9,14,0,0,72
12,15,7,1,14,19,0,0,0,68
12,15,7,1,15,5,4,9,3,71
12,15,7,1,18,9,20,8,13,103
12,15,7,2,15,15,11,0,0,77
12,15,7,2,15,15,11,19,0,96
12,15,7,3,8,9,16,0,0,70
12,15,7,3,15,3,11,0,0,66
12,15,7,5,0,0,0,0,0,39
12,15,7,5,9,1,0,0,0,49
12,15,7,5,9,15,14,0,0,77
12,15,7,5,18,0,0,0,0,57
12,15,7,5,19,0,0,0,0,58
12,15,7,5,21,13,0,0,0,73
12,15,7,7,1,20,0,0,0,62
12,15,7,7,1,20,19,0,0,81
12,15,7,7,5,4,0,0,0,50
12,15,7,7,5,18,0,0,0,64
12,15,7,7,5,18,19,0,0,83
12,15,7,7,5,20,0,0,0,66
12,15,7,7,5,20,19,0,0,85
12,15,7,7,25,0,0,0,0,66
12,15,7,7,9,1,19,0,0,70
12,15,7,7,9,5,0,0,0,55
12,15,7,7,9,5,18,0,0,73
12,15,7,7,9,5,19,20,0,94
12,15,7,7,9,14,0,0,0,64
12,15,7,7,9,14,5,19,19,107
12,15,7,7,9,14,7,0,0,71
12,15,7,7,9,14,7,19,0,90
12,15,7,7,9,19,8,0,0,77
12,15,7,8,5,1,4,0,0,52
12,15,7,8,5,1,4,5,4,61
12,15,7,25,0,0,0,0,0,59
12,15,7,9,1,0,0,0,0,44
12,15,7,9,1,14,0,0,0,58
12,15,7,9,3,0,0,0,0,46
12,15,7,9,3,1,12,0,0,59
12,15,7,9,3,1,12,12,25,96
12,15,7,9,3,9,1,14,0,70
12,15,7,9,3,9,1,14,19,89
12,15,7,9,3,9,19,5,0,79
12,15,7,9,3,9,19,5,4,83
12,15,7,9,3,9,19,5,19,98
12,15,7,9,3,9,19,13,0,87
12,15,7,9,3,9,19,20,0,94
12,15,7,9,3,9,20,25,0,100
12,15,7,9,3,9,26,5,0,86
12,15,7,9,3,9,26,5,4,90
12,15,7,9,3,9,26,5,19,105
12,15,7,9,3,12,5,19,19,101
12,15,7,9,3,19,0,0,0,65
12,15,7,9,5,0,0,0,0,48
12,15,7,9,5,18,0,0,0,66
12,15,7,9,5,19,20,0,0,87
12,15,7,9,12,25,0,0,0,80
12,15,7,9,14,0,0,0,0,57
12,15,7,9,14,5,19,19,0,100
12,15,7,9,14,19,0,0,0,76
12,15,7,9,15,14,0,0,0,72
12,15,7,9,15,14,19,0,0,91
12,15,7,9,19,0,0,0,0,62
12,15,7,9,19,20,0,0,0,82
12,15,7,9,19,20,9,3,0,94
12,15,7,9,19,20,9,3,19,113
12,15,7,9,21,13,0,0,0,77
12,15,7,10,1,13,0,0,0,58
12,15,7,10,1,13,19,0,0,77
12,15,7,12,5,20,0,0,0,71
12,15,7,12,9,11,5,0,0,71
12,15,7,12,15,7,0,0,0,68
12,15,7,13,1,14,0,0,0,62
12,15,7,14,15,18,13,1,12,107
12,15,7,15,0,0,0,0,0,49
12,15,7,15,3,18,1,3,25,99
12,15,7,15,5,19,0,0,0,73
12,15,7,15,6,6,0,0,0,61
12,15,7,15,7,15,7,21,5,104
12,15,7,15,7,18,1,13,0,88
12,15,7,15,7,18,1,13,19,107
12,15,7,15,7,18,1,16,8,99
12,15,7,15,7,18,9,16,8,107
12,15,7,15,9,0,0,0,0,58
12,15,7,15,12,1,20,18,25,125
12,15,7,15,12,15,7,25,0,108
12,15,7,15,13,1,3,8,0,74
12,15,7,15,13,1,3,8,25,99
12,15,7,15,13,1,3,8,19,93
12,15,7,15,13,1,14,3,25,105
12,15,7,15,13,1,14,9,1,87
12,15,7,15,13,5,20,5,18,110
12,15,7,15,16,5,4,9,1,84
12,15,7,15,16,5,4,9,3,86
12,15,7,15,18,18,8,5,1,99
12,15,7,15,20,8,5,20,5,107
12,15,7,15,20,25,16,5,0,115
12,15,7,15,20,25,16,5,19,134
12,15,7,15,20,25,16,25,0,135
12,15,7,15,21,20,0,0,0,90
12,15,7,16,5,18,3,8,0,84
12,15,7,18,15,12,12,0,0,91
12,15,7,18,15,12,12,5,4,100
12,15,7,18,15,12,12,5,18,114
12,15,7,18,15,12,12,19,0,110
12,15,7,19,0,0,0,0,0,53
12,15,7,19,8,9,16,0,0,86
12,15,7,21,5,0,0,0,0,60
12,15,7,23,1,25,0,0,0,83
12,15,7,23,1,25,19,0,0,102
12,15,7,23,9,19,5,0,0,90
12,15,7,23,15,15,4,0,0,91
12,15,7,23,15,15,4,19,0,110
12,15,7,23,15,18,11,0,0,101
12,15,8,1,14,0,0,0,0,50
12,15,8,15,3,8,0,0,0,61
12,15,8,15,3,11,0,0,0,64
12,15,25,1,12,0,0,0,0,65
12,15,25,1,12,5,18,0,0,88
12,15,25,1,12,5,19,20,0,109
12,15,25,1,12,9,19,13,0,106
12,15,25,1,12,9,19,13,19,125
12,15,25,1,12,9,19,20,19,132
12,15,25,1,12,9,26,5,0,105
12,15,25,1,12,12,25,0,0,102
12,15,25,1,12,14,5,19,19,122
12,15,25,1,12,20,25,0,0,110
12,15,25,1,12,20,9,5,19,118
12,15,9,1,19,9,19,0,0,84
12,15,25,4,0,0,0,0,0,56
12,15,9,13,9,3,0,0,0,61
12,15,9,13,15,12,15,7,25,123
12,15,9,14,0,0,0,0,0,50
12,15,25,14,0,0,0,0,0,66
12,15,9,14,3,12,15,20,8,108
12,15,9,14,5,4,0,0,0,59
12,15,9,14,7,21,1,18,4,101
12,15,9,14,19,0,0,0,0,69
12,15,9,18,0,0,0,0,0,54
12,15,9,20,5,18,0,0,0,79
12,15,9,20,5,18,5,4,0,88
12,15,9,20,5,18,5,18,0,102
12,15,9,20,5,18,5,18,19,121
12,15,9,20,5,18,9,14,7,109
12,15,9,20,5,18,19,0,0,98
12,15,11,1,0,0,0,0,0,39
12,15,11,1,3,1,18,1,0,62
12,15,11,1,15,0,0,0,0,54
12,15,11,1,15,19,5,0,0,78
12,15,11,1,16,1,12,1,0,69
12,15,11,5,0,0,0,0,0,43
12,15,11,5,12,1,14,9,0,79
12,15,11,5,20,0,0,0,0,63
12,15,11,9,5,3,0,0,0,55
12,15,11,19,8,5,14,0,0,84
12,15,12,9,0,0,0,0,0,48
12,15,12,12,0,0,0,0,0,51
12,15,12,12,5,4,0,0,0,60
12,15,12,12,5,18,0,0,0,74
12,15,12,12,5,18,19,0,0,93
12,15,12,12,9,5,19,0,0,84
12,15,12,12,25,7,1,7,0,91
12,15,12,12,25,7,1,7,19,110
12,15,12,12,9,14,7,0,0,81
12,15,12,12,9,14,7,12,25,118
12,15,12,12,9,16,15,16,0,107
12,15,12,12,25,16,15,16,0,123
12,15,12,12,9,16,15,16,19,126
12,15,12,12,25,16,15,16,19,142
12,15,12,12,15,16,0,0,0,82
12,15,12,12,15,16,5,4,0,91
12,15,12,12,15,16,25,0,0,107
12,15,12,12,15,16,9,14,7,112
12,15,12,12,15,16,19,0,0,101
12,15,12,12,19,0,0,0,0,70
12,15,12,12,21,16,0,0,0,88
12,15,13,1,19,20,15,13,5,113
12,15,13,1,20,1,0,0,0,62
12,15,13,1,20,9,14,5,0,89
12,15,13,2,15,25,0,0,0,82
12,15,13,5,9,14,0,0,0,68
12,15,13,5,9,14,19,0,0,87
12,15,13,5,14,20,0,0,0,79
12,15,13,5,14,20,1,0,0,80
12,15,13,5,14,20,19,0,0,98
12,15,13,5,14,20,21,13,0,113
12,15,13,5,14,20,21,13,19,132
12,15,13,9,12,15,13,9,0,98
12,15,13,13,15,3,11,0,0,82
12,15,13,15,14,9,20,5,0,103
12,15,13,20,1,0,0,0,0,61
12,15,14,4,0,0,0,0,0,45
12,15,14,4,15,14,5,18,19,116
12,15,14,5,0,0,0,0,0,46
12,15,14,5,6,21,12,0,0,85
12,15,14,5,12,25,0,0,0,83
12,15,14,5,12,9,5,18,0,90
12,15,14,5,12,9,5,19,20,111
12,15,14,5,12,9,12,25,0,104
12,15,14,5,14,5,19,19,0,103
12,15,14,5,18,0,0,0,0,64
12,15,14,5,18,19,0,0,0,83
12,15,14,5,19,15,13,5,0,98
12,15,14,5,19,15,13,5,19,117
12,15,14,7,0,0,0,0,0,48
12,15,14,7,1,0,0,0,0,49
12,15,14,7,1,3,18,5,0,75
12,15,14,7,1,14,19,0,0,82
12,15,14,7,2,5,1,11,0,67
12,15,14,7,2,5,1,18,4,78
12,15,14,7,2,9,12,12,0,83
12,15,14,7,2,15,1,20,0,86
12,15,14,7,2,15,1,20,19,105
12,15,14,7,2,15,23,0,0,88
12,15,14,7,2,15,23,19,0,107
12,15,14,7,3,12,15,20,8,106
12,15,14,7,5,0,0,0,0,53
12,15,14,7,5,1,18,0,0,72
12,15,14,7,5,4,0,0,0,57
12,15,14,7,5,5,0,0,0,58
12,15,14,7,5,9,14,7,0,83
12,15,14,7,5,18,0,0,0,71
12,15,14,7,5,18,15,14,0,100
12,15,14,7,5,18,15,14,19,119
12,15,14,7,5,18,19,0,0,90
12,15,14,7,5,19,0,0,0,72
12,15,14,7,5,19,20,0,0,92
12,15,14,7,5,22,1,12,0,88
12,15,14,7,5,22,5,0,0,80
12,15,14,7,5,22,9,20,25,129
12,15,14,7,5,22,15,21,19,130
12,15,14,7,6,5,12,20,0,91
12,15,14,7,6,9,14,0,0,77
12,15,14,7,6,21,12,0,0,87
12,15,14,7,8,1,9,18,0,84
12,15,14,7,8,1,9,18,19,103
12,15,14,7,8,1,14,4,0,75
12,15,14,7,8,1,14,4,19,94
12,15,14,7,8,5,1,4,0,66
12,15,14,7,8,5,1,4,19,85
12,15,14,7,8,15,18,14,19,122
12,15,14,7,8,15,21,19,5,116
12,15,14,7,9,3,15,14,5,94
12,15,14,7,9,3,15,18,14,107
12,15,14,7,9,5,19,0,0,81
12,15,14,7,25,9,0,0,0,82
12,15,14,7,9,14,7,0,0,78
12,15,14,7,9,14,7,12,25,115
12,15,14,7,9,14,7,19,0,97
12,15,14,7,9,19,8,0,0,84
12,15,14,7,9,20,21,4,5,107
12,15,14,7,10,1,23,0,0,82
12,15,14,7,10,1,23,19,0,101
12,15,14,7,12,5,7,0,0,72
12,15,14,7,12,5,7,19,0,91
12,15,14,7,12,25,0,0,0,85
12,15,14,7,12,9,3,11,0,83
12,15,14,7,12,9,14,5,0,88
12,15,14,7,12,9,14,5,18,106
12,15,14,7,12,9,14,5,19,107
12,15,14,7,14,5,3,11,0,81
12,15,14,7,14,5,19,19,0,105
12,15,14,7,14,15,19,5,0,101
12,15,14,7,16,15,4,0,0,83
12,15,14,7,18,15,15,20,0,116
12,15,14,7,18,21,14,0,0,101
12,15,14,7,19,8,9,16,0,100
12,15,14,7,19,8,9,16,19,119
12,15,14,7,19,8,15,18,5,113
12,15,14,7,19,8,15,20,0,110
12,15,14,7,19,15,13,5,0,100
12,15,14,7,19,16,21,14,0,118
12,15,14,7,19,16,21,18,0,122
12,15,14,7,19,16,21,18,19,141
12,15,14,7,20,1,9,12,0,90
12,15,14,7,20,9,13,5,0,95
12,15,14,7,20,9,13,5,18,113
12,15,14,7,21,5,0,0,0,74
12,15,14,7,21,5,19,0,0,93
12,15,14,7,21,5,21,18,0,113
12,15,14,7,21,5,21,18,19,132
12,15,14,7,21,12,9,20,5,115
12,15,14,7,23,1,25,0,0,97
12,15,14,7,23,1,25,19,0,116
12,15,14,7,23,1,12,12,0,96
12,15,14,7,23,9,19,5,0,104
12,15,14,7,23,15,15,12,0,113
12,15,14,7,23,15,18,4,0,108
12,15,14,7,23,15,18,11,0,115
12,15,14,7,23,15,18,20,0,124
12,15,14,8,25,14,0,0,0,88
12,15,14,15,21,8,1,18,4,108
12,15,14,17,21,8,1,18,4,110
12,15,14,20,1,18,0,0,0,80
12,15,15,0,0,0,0,0,0,42
12,15,15,2,0,0,0,0,0,44
12,15,15,2,25,0,0,0,0,69
12,15,15,2,9,5,19,0,0,77
12,15,15,2,25,9,19,8,0,105
12,15,15,2,9,12,25,0,0,90
12,15,15,3,8,0,0,0,0,53
12,15,15,4,0,0,0,0,0,46
12,15,15,5,4,0,0,0,0,51
12,15,15,5,25,0,0,0,0,72
12,15,15,5,25,19,0,0,0,91
12,15,15,6,0,0,0,0,0,48
12,15,15,6,1,0,0,0,0,49
12,15,15,6,1,8,0,0,0,57
12,15,15,6,1,8,19,0,0,76
12,15,15,6,1,19,0,0,0,68
12,15,15,6,9,5,0,0,0,62
12,15,15,6,14,5,19,19,0,105
12,15,15,6,19,0,0,0,0,67
12,15,15,9,5,0,0,0,0,56
12,15,15,9,5,19,0,0,0,75
12,15,15,9,14,7,0,0,0,72
12,15,15,11,0,0,0,0,0,53
12,15,15,11,1,8,5,1,4,72
12,15,15,11,4,15,23,14,0,109
12,15,15,11,4,15,23,14,19,128
12,15,15,11,5,4,0,0,0,62
12,15,15,11,5,5,0,0,0,63
12,15,15,11,5,18,0,0,0,76
12,15,15,11,5,18,19,0,0,95
12,15,15,11,25,0,0,0,0,78
12,15,15,11,9,14,7,0,0,83
12,15,15,11,15,21,20,0,0,109
12,15,15,11,15,21,20,19,0,128
12,15,15,11,19,0,0,0,0,72
12,15,15,11,21,13,0,0,0,87
12,15,15,11,21,16,0,0,0,90
12,15,15,11,21,16,19,0,0,109
12,15,15,13,5,4,0,0,0,64
12,15,15,13,5,18,0,0,0,78
12,15,15,13,5,18,25,0,0,103
12,15,15,13,6,9,24,5,18,117
12,15,15,13,9,14,7,0,0,85
12,15,15,13,19,0,0,0,0,74
12,15,15,14,5,25,0,0,0,86
12,15,15,14,5,25,19,0,0,105
12,15,15,14,5,18,25,0,0,104
12,15,15,14,25,0,0,0,0,81
12,15,15,14,25,2,9,14,0,106
12,15,15,14,9,5,18,0,0,88
12,15,15,14,9,5,19,0,0,89
12,15,15,14,9,5,19,20,0,109
12,15,15,14,9,14,5,19,19,122
12,15,15,14,19,0,0,0,0,75
12,15,15,16,0,0,0,0,0,58
12,15,15,16,2,1,3,11,0,75
12,15,15,16,5,0,0,0,0,63
12,15,15,16,5,4,0,0,0,67
12,15,15,16,5,18,0,0,0,81
12,15,15,16,5,18,19,0,0,100
12,15,15,16,6,21,12,0,0,97
12,15,15,16,8,15,12,5,0,98
12,15,15,16,8,15,12,5,4,102
12,15,15,16,8,15,12,5,19,117
12,15,15,16,25,0,0,0,0,83
12,15,15,16,9,5,18,0,0,90
12,15,15,16,9,5,19,20,0,111
12,15,15,16,9,14,7,0,0,88
12,15,15,16,9,19,20,0,0,106
12,15,15,16,12,5,20,0,0,95
12,15,15,16,12,9,11,5,0,95
12,15,15,18,4,0,0,0,0,64
12,15,15,18,25,0,0,0,0,85
12,15,15,19,5,0,0,0,0,66
12,15,15,19,5,2,15,24,0,107
12,15,15,19,5,4,0,0,0,70
12,15,15,19,5,12,5,1,6,90
12,15,15,19,5,12,25,0,0,103
12,15,15,19,5,14,0,0,0,80
12,15,15,19,5,14,5,4,0,89
12,15,15,19,5,14,5,18,0,103
12,15,15,19,5,14,5,18,19,122
12,15,15,19,5,14,5,19,19,123
12,15,15,19,5,14,9,14,7,110
12,15,15,19,5,14,19,0,0,99
12,15,15,19,5,18,0,0,0,84
12,15,15,19,5,19,0,0,0,85
12,15,15,19,5,19,20,0,0,105
12,15,15,19,9,14,7,0,0,91
12,15,15,19,9,19,8,0,0,97
12,15,15,20,0,0,0,0,0,62
12,15,15,20,1,2,12,5,0,82
12,15,15,20,5,4,0,0,0,71
12,15,15,20,5,14,0,0,0,81
12,15,15,20,5,18,0,0,0,85
12,15,15,20,5,18,19,0,0,104
12,15,15,20,9,5,0,0,0,76
12,15,15,20,9,14,7,0,0,92
12,15,15,20,19,0,0,0,0,81
12,15,15,20,19,13,1,14,0,109
12,15,15,20,19,13,1,14,19,128
12,15,15,22,5,18,0,0,0,87
12,15,16,5,4,0,0,0,0,52
12,15,16,5,13,1,14,0,0,76
12,15,16,5,18,0,0,0,0,66
12,15,16,5,18,19,0,0,0,85
12,15,16,8,5,1,22,25,0,104
12,15,16,8,9,9,4,0,0,73
12,15,16,8,9,14,0,0,0,74
12,15,16,8,9,14,5,0,0,79
12,15,16,8,15,4,15,14,20,119
12,15,16,8,15,19,20,5,1,111
12,15,16,9,14,7,0,0,0,73
12,15,16,15,12,9,20,8,0,107
12,15,16,16,1,18,4,0,0,82
12,15,16,16,5,4,0,0,0,68
12,15,16,16,5,18,0,0,0,82
12,15,16,16,5,18,5,4,0,91
12,15,16,16,5,18,9,14,7,112
12,15,16,16,5,18,19,0,0,101
12,15,16,16,5,20,0,0,0,84
12,15,16,16,25,0,0,0,0,84
12,15,16,16,9,5,18,0,0,91
12,15,16,16,9,5,19,20,0,112
12,15,16,16,9,14,7,0,0,89
12,15,16,19,0,0,0,0,0,62
12,15,16,19,5,5,4,0,0,76
12,15,16,19,9,4,5,4,0,84
12,15,16,19,20,9,3,11,0,105
12,15,16,19,20,9,3,11,19,124
12,15,17,0,0,0,0,0,0,44
12,15,17,21,1,3,9,20,25,123
12,15,17,21,1,20,0,0,0,86
12,15,17,21,1,20,19,0,0,105
12,15,17,21,5,14,3,5,0,92
12,15,17,21,5,14,3,25,0,112
12,15,17,21,5,14,20,0,0,104
12,15,17,21,5,14,20,12,25,141
12,15,17,21,9,20,21,18,0,133
12,15,18,0,0,0,0,0,0,45
12,15,18,1,14,4,9,20,5,98
12,15,18,1,14,19,0,0,0,79
12,15,18,1,18,9,9,0,0,82
12,15,18,1,18,9,21,19,0,113
12,15,18,1,20,5,0,0,0,71
12,15,18,3,8,1,0,0,0,57
12,15,18,4,5,4,0,0,0,58
12,15,18,4,25,0,0,0,0,74
12,15,18,4,9,14,7,0,0,79
12,15,18,4,9,14,7,19,0,98
12,15,18,4,11,9,14,0,0,83
12,15,18,4,12,5,19,19,0,104
12,15,18,4,12,5,20,0,0,86
12,15,18,4,12,25,0,0,0,86
12,15,18,4,12,9,5,18,0,93
12,15,18,4,12,9,5,19,20,114
12,15,18,4,12,9,11,5,0,86
12,15,18,4,12,9,12,25,0,107
12,15,18,4,12,9,14,7,0,91
12,15,18,4,12,9,14,7,19,110
12,15,18,4,15,13,1,0,0,78
12,15,18,4,15,13,1,19,0,97
12,15,18,4,15,19,5,19,0,107
12,15,18,4,15,19,9,19,0,111
12,15,18,4,15,20,9,3,0,96
12,15,18,4,19,8,9,16,19,120
12,15,18,4,19,23,9,11,5,116
12,15,18,4,23,15,15,4,0,106
12,15,18,5,1,12,0,0,0,63
12,15,18,5,4,0,0,0,0,54
12,15,18,5,12,0,0,0,0,62
12,15,18,5,12,5,19,19,0,105
12,15,18,5,19,0,0,0,0,69
12,15,18,5,20,9,14,0,0,93
12,15,18,7,14,5,20,20,5,116
12,15,18,7,14,15,14,0,0,95
12,15,18,7,14,15,14,19,0,114
12,15,18,9,3,0,0,0,0,57
12,15,18,9,3,1,0,0,0,58
12,15,18,9,3,1,5,0,0,63
12,15,18,9,3,1,20,5,0,83
12,15,18,9,3,1,20,5,4,87
12,15,18,9,3,1,20,5,19,102
12,15,18,9,3,15,9,4,0,85
12,15,18,9,5,19,0,0,0,78
12,15,18,9,11,5,5,20,0,95
12,15,18,9,11,5,5,20,19,114
12,15,18,9,12,5,20,0,0,91
12,15,18,9,13,5,18,19,0,109
12,15,18,9,14,5,18,19,0,110
12,15,18,9,15,20,0,0,0,89
12,15,18,9,19,5,19,0,0,97
12,15,18,13,5,18,25,0,0,106
12,15,18,14,14,5,19,19,0,116
12,15,18,15,0,0,0,0,0,60
12,15,18,15,19,0,0,0,0,79
12,15,18,18,9,5,19,0,0,96
12,15,18,18,9,11,5,18,0,106
12,15,18,19,0,0,0,0,0,64
12,15,18,21,13,0,0,0,0,79
12,15,19,1,2,12,5,0,0,66
12,15,19,1,14,7,0,0,0,68
12,15,19,5,12,0,0,0,0,63
12,15,19,5,12,9,19,13,0,104
12,15,19,5,12,18,25,0,0,106
12,15,19,5,12,19,0,0,0,82
12,15,19,5,14,7,5,18,0,95
12,15,19,5,18,0,0,0,0,69
12,15,19,5,18,19,0,0,0,88
12,15,19,5,19,0,0,0,0,70
12,15,19,8,0,0,0,0,0,54
12,15,19,9,14,7,0,0,0,76
12,15,19,9,14,7,12,25,0,113
12,15,19,9,14,7,19,0,0,95
12,15,19,19,5,14,9,20,5,118
12,15,19,19,5,18,0,0,0,88
12,15,19,19,5,19,0,0,0,89
12,15,19,19,6,21,12,0,0,104
12,15,19,19,25,0,0,0,0,90
12,15,19,19,9,5,18,0,0,97
12,15,19,19,9,5,19,20,0,118
12,15,19,19,12,5,19,19,0,120
12,15,19,19,16,18,15,15,6,135
12,15,19,20,0,0,0,0,0,66
12,15,19,20,12,9,14,7,0,108
12,15,19,20,14,5,19,19,0,123
12,15,20,1,8,0,0,0,0,56
12,15,20,1,8,19,0,0,0,75
12,15,20,1,14,0,0,0,0,62
12,15,20,1,19,0,0,0,0,67
12,15,20,1,19,5,0,0,0,72
12,15,20,5,0,0,0,0,0,52
12,15,20,5,2,21,19,8,0,102
12,15,20,5,23,15,15,4,0,109
12,15,20,8,0,0,0,0,0,55
12,15,20,8,12,25,0,0,0,92
12,15,20,8,19,15,13,5,0,107
12,15,20,9,3,0,0,0,0,59
12,15,20,9,6,15,18,13,0,108
12,15,20,9,15,14,0,0,0,85
12,15,20,9,15,14,19,0,0,104
12,15,20,9,21,13,0,0,0,90
12,15,20,13,5,14,20,0,0,99
12,15,20,15,0,0,0,0,0,62
12,15,20,15,14,7,0,0,0,83
12,15,20,15,18,0,0,0,0,80
12,15,20,15,19,0,0,0,0,81
12,15,20,15,19,5,19,0,0,105
12,15,20,18,9,20,5,0,0,99
12,15,20,20,5,4,0,0,0,76
12,15,20,20,5,18,0,0,0,90
12,15,20,20,5,18,25,0,0,115
12,15,20,20,5,18,9,5,19,123
12,15,20,20,9,14,7,0,0,97
12,15,20,20,15,0,0,0,0,82
12,15,20,20,15,19,0,0,0,101
12,15,20,21,19,5,19,0,0,111
12,15,20,21,19,9,14,0,0,110
12,15,20,21,19,12,9,11,5,124
12,15,21,3,8,0,0,0,0,59
12,15,21,3,8,5,0,0,0,64
12,15,21,4,0,0,0,0,0,52
12,15,21,4,5,14,0,0,0,71
12,15,21,4,5,14,5,4,0,80
12,15,21,4,5,14,9,14,7,101
12,15,21,4,5,14,19,0,0,90
12,15,21,4,5,18,0,0,0,75
12,15,21,4,5,18,9,14,7,105
12,15,21,4,5,19,20,0,0,96
12,15,21,4,9,19,8,0,0,88
12,15,21,4,12,25,0,0,0,89
12,15,21,4,12,9,5,18,0,96
12,15,21,4,12,9,5,19,20,117
12,15,21,4,13,15,21,20,8,129
12,15,21,4,14,5,19,19,0,109
12,15,21,4,19,16,5,1,11,104
12,15,21,5,25,0,0,0,0,78
12,15,21,7,8,5,5,14,0,87
12,15,21,7,8,19,0,0,0,82
12,15,21,9,5,19,0,0,0,81
12,15,21,9,17,1,0,0,0,75
12,15,21,9,19,9,14,5,0,104
12,15,21,11,0,0,0,0,0,59
12,15,21,11,1,19,0,0,0,79
12,15,21,11,15,21,13,0,0,108
12,15,21,11,15,21,13,9,0,117
12,15,21,12,21,0,0,0,0,81
12,15,21,14,0,0,0,0,0,62
12,15,21,14,4,5,18,0,0,89
12,15,21,14,4,5,18,5,18,112
12,15,21,14,7,5,4,0,0,78
12,15,21,14,7,5,18,0,0,92
12,15,21,14,7,5,18,19,0,111
12,15,21,14,7,5,19,0,0,93
12,15,21,14,7,25,0,0,0,94
12,15,21,14,7,9,14,7,0,99
12,15,21,16,5,0,0,0,0,69
12,15,21,16,5,4,0,0,0,73
12,15,21,16,5,14,0,0,0,83
12,15,21,16,5,19,0,0,0,88
12,15,21,16,9,14,7,0,0,94
12,15,21,16,19,0,0,0,0,83
12,15,21,18,0,0,0,0,0,66
12,15,21,18,4,0,0,0,0,70
12,15,21,18,4,25,0,0,0,95
12,15,21,18,4,9,19,8,0,106
12,15,21,18,5,4,0,0,0,75
12,15,21,18,25,0,0,0,0,91
12,15,21,18,9,14,7,0,0,96
12,15,21,18,9,14,7,12,25,133
12,15,21,18,19,0,0,0,0,85
12,15,21,19,5,0,0,0,0,72
12,15,21,19,5,4,0,0,0,76
12,15,21,19,5,19,0,0,0,91
12,15,21,19,5,23,15,18,20,148
12,15,21,19,25,0,0,0,0,92
12,15,21,19,9,5,18,0,0,99
12,15,21,19,9,5,19,20,0,120
12,15,21,19,9,12,25,0,0,113
12,15,21,19,9,14,5,19,19,133
12,15,21,19,9,14,7,0,0,97
12,15,21,19,20,5,18,0,0,110
12,15,21,20,0,0,0,0,0,68
12,15,21,20,5,4,0,0,0,77
12,15,21,20,5,18,0,0,0,91
12,15,21,20,8,5,18,0,0,99
12,15,21,20,25,0,0,0,0,93
12,15,21,20,9,14,7,0,0,98
12,15,21,20,9,19,8,0,0,104
12,15,21,20,9,19,8,12,25,141
12,15,21,20,18,5,0,0,0,91
12,15,21,20,19,0,0,0,0,87
12,15,21,22,1,18,0,0,0,89
12,15,21,22,5,18,0,0,0,93
12,15,21,22,5,18,5,4,0,102
12,15,21,22,5,18,9,14,7,123
12,15,21,22,5,18,19,0,0,112
12,15,21,22,18,5,4,0,0,97
12,15,21,22,18,5,19,0,0,112
12,15,22,1,2,12,5,0,0,69
12,15,22,1,2,12,25,0,0,89
12,15,22,1,7,5,0,0,0,62
12,15,22,1,7,5,19,0,0,81
12,15,22,1,14,5,14,20,25,128
12,15,22,1,20,0,0,0,0,70
12,15,22,1,20,19,0,0,0,89
12,15,22,5,1,2,12,5,0,74
12,15,22,5,1,2,12,25,0,94
12,15,22,5,2,9,18,4,0,87
12,15,22,5,2,9,18,4,19,106
12,15,22,5,2,21,7,0,0,84
12,15,22,5,2,21,7,19,0,103
12,15,22,5,4,0,0,0,0,58
12,15,22,5,4,1,25,0,0,84
12,15,22,5,5,0,0,0,0,59
12,15,22,5,6,21,12,0,0,93
12,15,22,5,7,18,1,19,19,118
12,15,22,5,8,15,15,4,0,96
12,15,22,5,25,0,0,0,0,79
12,15,22,5,12,1,19,19,0,105
12,15,22,5,12,5,19,19,0,109
12,15,22,5,12,9,5,18,0,98
12,15,22,5,12,9,5,19,0,99
12,15,22,5,12,9,5,19,20,119
12,15,22,5,12,9,12,25,0,112
12,15,22,5,12,9,14,7,0,96
12,15,22,5,12,15,3,11,19,114
12,15,22,5,12,15,18,14,0,113
12,15,22,5,13,1,14,0,0,82
12,15,22,5,13,1,14,19,0,101
12,15,22,5,13,1,20,5,0,93
12,15,22,5,16,15,20,0,0,105
12,15,22,5,16,18,15,15,6,124
12,15,22,5,18,4,15,13,0,104
12,15,22,5,18,5,4,0,0,81
12,15,22,5,18,8,15,15,4,114
12,15,22,5,18,25,0,0,0,97
12,15,22,5,18,12,5,19,19,127
12,15,22,5,18,12,25,0,0,109
12,15,22,5,18,12,9,11,5,109
12,15,22,5,18,19,0,0,0,91
12,15,22,5,18,19,8,9,16,124
12,15,22,5,18,23,9,19,5,128
12,15,22,5,19,0,0,0,0,73
12,15,22,5,19,9,3,11,0,96
12,15,22,5,19,15,13,5,0,106
12,15,22,5,22,9,14,5,0,104
12,15,22,5,22,9,14,5,19,123
12,15,22,5,23,15,18,20,8,138
12,15,22,9,5,18,0,0,0,81
12,15,22,9,5,18,19,0,0,100
12,15,22,9,14,7,12,25,0,116
12,15,23,1,0,0,0,0,0,51
12,15,23,1,2,12,5,0,0,70
12,15,23,1,14,0,0,0,0,65
12,15,23,1,14,3,5,0,0,73
12,15,23,2,1,12,12,0,0,77
12,15,23,2,1,12,12,19,0,96
12,15,23,2,5,12,12,0,0,81
12,15,23,2,15,25,0,0,0,92
12,15,23,2,15,25,19,0,0,111
12,15,23,2,15,18,14,0,0,99
12,15,23,2,18,5,4,0,0,79
12,15,23,2,18,15,23,0,0,108
12,15,23,2,18,15,23,19,0,127
12,15,23,4,1,8,0,0,0,63
12,15,23,4,15,23,14,0,0,106
12,15,23,4,15,23,14,19,0,125
12,15,23,5,4,0,0,0,0,59
12,15,23,5,9,20,5,0,0,89
12,15,23,5,18,1,2,12,5,93
12,15,23,5,18,3,1,19,5,101
12,15,23,5,18,5,4,0,0,82
12,15,23,5,18,5,18,0,0,96
12,15,23,5,18,9,14,7,0,103
12,15,23,5,18,13,15,19,20,140
12,15,23,5,18,19,0,0,0,92
12,15,23,5,19,20,0,0,0,94
12,15,23,25,0,0,0,0,0,75
12,15,23,9,7,9,20,5,0,100
12,15,23,9,14,7,0,0,0,80
12,15,23,9,14,7,19,0,0,99
12,15,23,9,19,8,0,0,0,86
12,15,23,9,19,8,12,25,0,123
12,15,23,12,25,0,0,0,0,87
12,15,23,12,9,5,18,0,0,94
12,15,23,12,9,5,19,20,0,115
12,15,23,12,9,6,5,0,0,82
12,15,23,12,9,6,5,18,0,100
12,15,23,12,9,6,5,19,0,101
12,15,23,12,9,8,5,1,4,89
12,15,23,12,9,8,15,15,4,113
12,15,23,12,9,12,25,0,0,108
12,15,23,12,9,14,5,19,19,128
12,15,23,12,9,22,5,19,0,117
12,15,23,13,5,14,0,0,0,82
12,15,23,13,15,19,20,0,0,117
12,15,23,14,0,0,0,0,0,64
12,15,23,14,5,19,19,0,0,107
12,15,23,14,5,19,19,5,19,131
12,15,23,14,12,25,0,0,0,101
12,15,23,18,9,4,5,18,0,104
12,15,23,19,0,0,0,0,0,69
12,15,23,19,5,0,0,0,0,74
12,15,23,19,5,4,0,0,0,78
12,15,23,19,5,18,0,0,0,92
12,15,23,19,5,19,20,0,0,113
12,15,23,19,9,14,0,0,0,92
12,15,23,19,9,14,7,0,0,99
12,15,23,20,8,0,0,0,0,78
12,15,23,23,15,15,4,0,0,107
12,15,24,5,4,0,0,0,0,60
12,15,24,5,19,0,0,0,0,75
12,15,24,9,1,0,0,0,0,61
12,15,24,9,3,0,0,0,0,63
12,15,24,9,14,7,0,0,0,81
12,15,24,15,3,12,1,19,5,106
12,15,24,15,3,15,19,13,0,116
12,15,24,15,4,15,14,20,0,119
12,15,24,15,4,18,15,13,5,121
12,15,24,15,4,18,15,13,25,141
12,15,24,15,20,9,3,0,0,98
12,15,24,15,20,15,13,25,0,139
12,15,26,5,14,7,5,0,0,84
12,15,26,5,14,7,5,4,0,88
12,15,26,5,14,7,5,18,0,102
12,15,26,5,14,7,5,19,0,103
12,15,26,5,14,7,25,0,0,104
12,16,13,0,0,0,0,0,0,41
12,18,5,3,12,0,0,0,0,50
12,20,18,0,0,0,0,0,0,50
12,21,2,0,0,0,0,0,0,35
12,21,2,2,1,18,4,0,0,60
12,21,2,2,5,18,0,0,0,60
12,21,2,2,5,18,12,25,0,97
12,21,2,2,5,18,19,0,0,79
12,21,2,5,0,0,0,0,0,40
12,21,2,5,19,0,0,0,0,59
12,21,2,18,1,0,0,0,0,54
12,21,2,18,9,3,0,0,0,65
12,21,2,18,9,3,1,12,0,78
12,21,2,18,9,3,1,14,20,100
12,21,2,18,9,3,1,20,5,91
12,21,2,18,9,3,9,20,25,119
12,21,2,18,9,3,15,21,19,120
12,21,2,18,9,6,25,0,0,93
12,21,2,18,9,20,15,18,25,140
12,21,3,0,0,0,0,0,0,36
12,21,3,1,14,9,4,0,0,64
12,21,3,1,18,14,5,0,0,74
12,21,3,1,18,14,5,19,0,93
12,21,3,2,1,14,0,0,0,53
12,21,3,5,14,3,5,0,0,63
12,21,3,5,14,3,5,19,0,82
12,21,3,5,14,3,25,0,0,83
12,21,3,5,14,3,9,5,19,91
12,21,3,5,14,20,0,0,0,75
12,21,3,5,14,20,12,25,0,112
12,21,3,5,18,14,0,0,0,73
12,21,3,5,18,14,1,12,0,86
12,21,3,5,18,14,5,19,0,97
12,21,3,5,18,14,19,0,0,92
12,21,3,5,19,0,0,0,0,60
12,21,3,5,20,0,0,0,0,61
12,21,3,9,2,12,5,0,0,64
12,21,3,9,4,0,0,0,0,49
12,21,3,9,4,1,0,0,0,50
12,21,3,9,4,1,5,0,0,55
12,21,3,9,4,9,20,25,0,103
12,21,3,9,4,12,25,0,0,86
12,21,3,9,4,14,5,19,19,106
12,21,3,9,6,5,5,0,0,61
12,21,3,9,6,5,18,9,14,97
12,21,3,9,6,5,18,19,0,93
12,21,3,9,6,9,3,0,0,63
12,21,3,9,6,15,18,13,0,97
12,21,3,9,6,21,7,1,12,92
12,21,3,9,7,5,14,0,0,71
12,21,3,9,13,5,20,5,18,106
12,21,3,9,14,15,9,4,0,87
12,21,3,9,22,5,5,0,0,77
12,21,3,11,5,4,0,0,0,56
12,21,3,11,5,14,0,0,0,66
12,21,3,11,6,21,12,0,0,86
12,21,3,11,9,5,0,0,0,61
12,21,3,11,9,5,18,0,0,79
12,21,3,11,9,5,19,0,0,80
12,21,3,11,9,5,19,20,0,100
12,21,3,11,9,12,25,0,0,93
12,21,3,11,9,14,5,19,19,113
12,21,3,11,9,14,7,0,0,77
12,21,3,11,12,5,19,19,0,102
12,21,3,11,12,25,0,0,0,84
12,21,3,11,19,0,0,0,0,66
12,21,3,15,13,2,5,0,0,71
12,21,3,18,1,20,9,15,14,113
12,21,3,18,1,20,9,22,5,111
12,21,3,18,5,0,0,0,0,59
12,21,3,18,5,19,0,0,0,78
12,21,3,18,9,6,25,0,0,94
12,21,3,18,9,6,9,3,0,81
12,21,3,18,15,21,19,0,0,109
12,21,3,18,21,13,0,0,0,88
12,21,3,20,1,20,9,15,14,115
12,21,3,20,21,1,12,0,0,90
12,21,3,21,2,18,1,20,5,103
12,21,3,21,12,5,0,0,0,74
12,21,3,21,12,5,14,20,0,108
12,21,3,21,12,12,9,20,5,115
12,21,3,21,13,9,1,0,0,80
12,21,3,21,13,15,14,25,0,124
12,21,4,4,5,14,0,0,0,60
12,21,4,4,25,0,0,0,0,66
12,21,4,5,0,0,0,0,0,42
12,21,4,5,6,9,19,11,0,87
12,21,4,5,19,0,0,0,0,61
12,21,4,9,2,18,25,0,0,91
12,21,4,9,3,0,0,0,0,49
12,21,4,9,3,18,15,21,19,122
12,21,4,12,1,13,9,20,5,97
12,21,4,15,0,0,0,0,0,52
12,21,4,23,9,7,9,20,5,110
12,21,5,0,0,0,0,0,0,38
12,21,5,19,0,0,0,0,0,57
12,21,5,20,9,3,0,0,0,70
12,21,5,20,9,3,19,0,0,89
12,21,6,2,5,18,25,0,0,89
12,21,6,2,5,18,18,25,0,107
12,21,6,6,0,0,0,0,0,45
12,21,6,6,1,19,0,0,0,65
12,21,6,6,5,4,0,0,0,54
12,21,6,6,5,18,0,0,0,68
12,21,6,6,9,14,7,0,0,75
12,21,6,6,19,0,0,0,0,64
12,21,7,5,0,0,0,0,0,45
12,21,7,5,4,0,0,0,0,49
12,21,7,5,9,14,7,0,0,75
12,21,7,5,19,0,0,0,0,64
12,21,7,7,1,7,5,0,0,60
12,21,7,7,1,7,5,19,0,79
12,21,7,7,1,18,0,0,0,66
12,21,7,7,1,18,4,0,0,70
12,21,7,7,5,4,0,0,0,56
12,21,7,7,5,18,0,0,0,70
12,21,7,7,5,18,19,0,0,89
12,21,7,7,9,5,0,0,0,61
12,21,7,7,9,5,19,0,0,80
12,21,7,7,9,14,7,0,0,77
12,21,7,8,4,15,1,14,0,82
12,21,7,9,14,7,0,0,0,70
12,21,7,13,1,18,11,0,0,83
12,21,7,19,0,0,0,0,0,59
12,21,7,19,1,9,12,0,0,81
12,21,7,19,1,9,12,19,0,100
12,21,7,19,15,13,5,0,0,92
12,21,7,21,2,18,15,21,19,136
12,21,7,23,15,18,13,0,0,109
12,21,7,23,15,18,13,19,0,128
12,21,8,9,14,7,1,0,0,72
12,21,9,0,0,0,0,0,0,42
12,21,9,7,9,14,9,0,0,81
12,21,10,1,21,18,9,20,5,117
12,21,10,1,22,18,9,20,5,118
12,21,10,21,12,1,0,0,0,77
12,21,11,5,12,25,0,0,0,86
12,21,11,5,13,9,1,0,0,72
12,21,11,5,14,5,19,19,0,106
12,21,11,5,20,0,0,0,0,69
12,21,11,5,23,1,18,4,0,95
12,21,11,5,23,1,18,13,0,104
12,21,12,1,2,0,0,0,0,48
12,21,12,1,2,9,13,0,0,70
12,21,12,1,2,19,0,0,0,67
12,21,12,1,22,0,0,0,0,68
12,21,12,1,22,9,13,0,0,90
12,21,12,1,22,19,0,0,0,87
12,21,12,12,1,2,9,5,4,78
12,21,12,12,1,2,9,5,19,93
12,21,12,12,1,25,0,0,0,83
12,21,12,12,5,4,0,0,0,66
12,21,12,12,5,18,0,0,0,80
12,21,12,12,9,12,15,15,0,108
12,21,12,12,9,14,7,0,0,87
12,21,12,12,9,14,7,12,25,124
12,21,12,12,19,0,0,0,0,76
12,21,12,21,1,9,0,0,0,76
12,21,12,21,19,0,0,0,0,85
12,21,13,0,0,0,0,0,0,46
12,21,13,1,3,8,5,12,0,75
12,21,13,2,1,7,15,0,0,71
12,21,13,2,1,7,15,19,0,90
12,21,13,2,1,25,1,15,0,90
12,21,13,2,1,14,7,0,0,70
12,21,13,2,1,18,0,0,0,67
12,21,13,2,1,18,19,0,0,86
12,21,13,2,5,18,0,0,0,71
12,21,13,2,5,18,4,1,18,94
12,21,13,2,5,18,4,15,13,103
12,21,13,2,5,18,5,4,0,80
12,21,13,2,5,18,5,18,0,94
12,21,13,2,5,18,5,18,19,113
12,21,13,2,5,18,9,14,7,101
12,21,13,2,5,18,12,25,0,108
12,21,13,2,5,18,13,1,14,99
12,21,13,2,5,18,13,5,14,103
12,21,13,2,5,18,19,0,0,90
12,21,13,2,18,9,3,1,12,91
12,21,13,2,18,9,3,9,4,91
12,21,13,2,18,15,21,19,0,121
12,21,13,2,21,19,0,0,0,88
12,21,13,5,14,1,12,0,0,78
12,21,13,5,14,19,0,0,0,84
12,21,13,5,20,5,18,0,0,94
12,21,13,9,14,1,0,0,0,70
12,21,13,9,14,1,9,18,5,102
12,21,13,9,14,1,14,3,5,92
12,21,13,9,14,1,14,20,0,104
12,21,13,9,14,1,18,5,0,93
12,21,13,9,14,1,18,25,0,113
12,21,13,9,14,1,18,9,1,98
12,21,13,9,14,1,20,5,0,95
12,21,13,9,14,1,20,15,18,123
12,21,13,9,14,5,0,0,0,74
12,21,13,9,14,5,4,0,0,78
12,21,13,9,14,5,19,3,5,101
12,21,13,9,14,9,14,7,0,99
12,21,13,9,14,9,19,13,0,110
12,21,13,9,14,9,19,20,0,117
12,21,13,9,14,9,19,20,5,122
12,21,13,9,14,9,19,20,19,136
12,21,13,9,14,15,21,19,0,124
12,21,13,13,5,0,0,0,0,64
12,21,13,13,25,0,0,0,0,84
12,21,13,13,15,24,0,0,0,98
12,21,13,13,15,24,5,19,0,122
12,21,13,16,0,0,0,0,0,62
12,21,13,16,5,4,0,0,0,71
12,21,13,16,5,14,0,0,0,81
12,21,13,16,5,14,19,0,0,100
12,21,13,16,5,18,0,0,0,85
12,21,13,16,5,18,19,0,0,104
12,21,13,16,5,20,0,0,0,87
12,21,13,16,6,9,19,8,0,104
12,21,13,16,25,0,0,0,0,87
12,21,13,16,9,5,18,0,0,94
12,21,13,16,9,5,19,20,0,115
12,21,13,16,9,12,25,0,0,108
12,21,13,16,9,14,5,19,19,128
12,21,13,16,9,14,7,0,0,92
12,21,13,16,9,14,7,12,25,129
12,21,13,16,9,19,8,0,0,98
12,21,13,16,9,19,8,12,25,135
12,21,13,16,13,1,14,0,0,90
12,21,13,16,13,5,14,0,0,94
12,21,13,16,19,0,0,0,0,81
12,21,13,19,0,0,0,0,0,65
12,21,13,21,20,0,0,0,0,87
12,21,14,1,3,25,0,0,0,76
12,21,14,1,3,9,5,19,0,84
12,21,14,1,18,0,0,0,0,66
12,21,14,1,18,5,0,0,0,71
12,21,14,1,18,25,0,0,0,91
12,21,14,1,18,9,1,14,0,90
12,21,14,1,18,9,1,14,19,109
12,21,14,1,18,9,19,20,0,114
12,21,14,1,18,9,21,13,0,109
12,21,14,1,18,19,0,0,0,85
12,21,14,1,19,0,0,0,0,67
12,21,14,1,20,1,0,0,0,69
12,21,14,1,20,5,0,0,0,73
12,21,14,1,20,5,4,0,0,77
12,21,14,1,20,5,12,25,0,110
12,21,14,1,20,9,3,0,0,80
12,21,14,1,20,9,3,1,12,93
12,21,14,1,20,9,3,19,0,99
12,21,14,1,20,9,15,14,0,106
12,21,14,1,20,9,15,14,19,125
12,21,14,1,20,9,26,5,0,108
12,21,14,1,20,21,13,0,0,102
12,21,14,3,8,0,0,0,0,58
12,21,14,3,8,5,4,0,0,67
12,21,14,3,8,5,15,14,0,92
12,21,14,3,8,5,15,14,19,111
12,21,14,3,8,5,18,0,0,81
12,21,14,3,8,5,18,19,0,100
12,21,14,3,8,5,19,0,0,82
12,21,14,3,8,8,15,15,11,107
12,21,14,3,8,9,14,7,0,88
12,21,14,3,8,12,5,19,19,113
12,21,14,3,8,18,15,15,13,119
12,21,14,3,8,20,9,13,5,105
12,21,14,4,25,6,15,15,20,132
12,21,14,4,18,5,19,19,0,112
12,21,14,5,19,0,0,0,0,71
12,21,14,5,20,0,0,0,0,72
12,21,14,5,20,19,0,0,0,91
12,21,14,5,20,20,5,19,0,116
12,21,14,7,0,0,0,0,0,54
12,21,14,7,1,14,0,0,0,69
12,21,14,7,1,14,19,0,0,88
12,21,14,7,5,0,0,0,0,59
12,21,14,7,5,4,0,0,0,63
12,21,14,7,5,5,0,0,0,64
12,21,14,7,5,5,19,0,0,83
12,21,14,7,5,15,21,19,0,114
12,21,14,7,5,18,0,0,0,77
12,21,14,7,5,18,19,0,0,96
12,21,14,7,5,19,0,0,0,78
12,21,14,7,6,9,19,8,0,96
12,21,14,7,6,21,12,0,0,93
12,21,14,7,9,0,0,0,0,63
12,21,14,7,25,0,0,0,0,79
12,21,14,7,9,5,0,0,0,68
12,21,14,7,25,9,0,0,0,88
12,21,14,7,25,9,19,0,0,107
12,21,14,7,9,14,7,0,0,84
12,21,14,7,9,19,0,0,0,82
12,21,14,7,12,5,19,19,0,109
12,21,14,7,13,15,20,15,18,135
12,21,14,7,15,15,18,0,0,102
12,21,14,7,19,0,0,0,0,73
12,21,14,7,19,9,3,11,0,96
12,21,14,7,23,15,18,13,0,123
12,21,14,7,23,15,18,13,19,142
12,21,14,7,23,15,18,20,0,130
12,21,14,7,23,15,18,20,19,149
12,21,14,25,0,0,0,0,0,72
12,21,14,9,5,18,0,0,0,79
12,21,14,9,5,19,0,0,0,80
12,21,14,9,5,19,20,0,0,100
12,21,14,9,6,15,18,13,0,108
12,21,14,25,9,5,0,0,0,86
12,21,14,9,19,15,12,1,18,121
12,21,14,9,19,20,9,3,5,112
12,21,14,9,20,9,4,1,12,102
12,21,14,11,0,0,0,0,0,58
12,21,14,11,5,18,0,0,0,81
12,21,14,11,5,18,19,0,0,100
12,21,14,11,8,5,1,4,0,76
12,21,14,11,8,5,1,4,19,95
12,21,14,11,19,0,0,0,0,77
12,21,14,15,9,4,0,0,0,75
12,21,14,20,5,4,0,0,0,76
12,21,14,20,9,14,7,0,0,97
12,21,14,20,19,0,0,0,0,86
12,21,14,21,12,1,0,0,0,81
12,21,14,21,12,1,5,0,0,86
12,21,14,21,12,1,18,0,0,99
12,21,14,21,12,1,20,5,0,106
12,21,14,21,12,1,20,5,4,110
12,21,14,21,12,5,0,0,0,85
12,21,14,21,12,5,19,0,0,104
12,21,14,21,12,5,20,0,0,105
12,21,14,21,12,9,20,5,0,114
12,21,16,1,14,1,18,0,0,83
12,21,16,1,14,1,18,19,0,102
12,21,16,1,14,9,14,0,0,87
12,21,16,1,14,9,14,5,0,92
12,21,16,5,15,12,0,0,0,81
12,21,16,5,15,19,5,0,0,93
12,21,16,5,20,9,4,9,14,110
12,21,16,9,3,9,4,5,0,79
12,21,16,9,6,15,18,13,0,110
12,21,16,9,14,0,0,0,0,72
12,21,16,9,14,5,0,0,0,77
12,21,16,9,14,5,19,0,0,96
12,21,16,9,14,9,14,0,0,95
12,21,16,9,14,9,14,5,0,100
12,21,16,9,14,15,19,9,19,134
12,21,16,9,14,15,21,19,0,127
12,21,16,9,14,19,0,0,0,91
12,21,16,9,19,0,0,0,0,77
12,21,16,15,9,4,0,0,0,77
12,21,16,15,13,1,0,0,0,78
12,21,16,15,21,19,0,0,0,104
12,21,16,21,12,9,3,0,0,94
12,21,16,21,12,9,14,0,0,105
12,21,16,21,12,9,14,5,0,110
12,21,16,21,12,9,14,9,3,117
12,21,16,21,12,9,14,19,0,124
12,21,16,21,12,9,14,21,13,139
12,21,16,21,12,15,14,5,0,116
12,21,16,21,12,21,19,0,0,122
12,21,16,21,19,5,19,0,0,113
12,21,18,1,3,1,14,0,0,70
12,21,18,1,12,0,0,0,0,64
12,21,18,3,8,0,0,0,0,62
12,21,18,3,8,5,4,0,0,71
12,21,18,3,8,5,18,0,0,85
12,21,18,3,8,5,18,19,0,104
12,21,18,3,8,5,19,0,0,86
12,21,18,3,8,9,14,7,0,92
12,21,18,3,8,12,9,14,5,102
12,21,18,4,1,14,0,0,0,70
12,21,18,4,1,14,5,0,0,75
12,21,18,4,1,14,5,19,0,94
12,21,18,4,1,14,9,19,13,111
12,21,18,4,1,14,19,0,0,89
12,21,18,5,0,0,0,0,0,56
12,21,18,5,4,0,0,0,0,60
12,21,18,5,6,21,12,0,0,95
12,21,18,5,13,5,14,20,0,108
12,21,18,5,18,0,0,0,0,74
12,21,18,5,18,19,0,0,0,93
12,21,18,5,19,0,0,0,0,75
12,21,18,5,19,15,13,5,0,108
12,21,18,7,0,0,0,0,0,58
12,21,18,7,23,15,18,13,0,127
12,21,18,9,4,0,0,0,0,64
12,21,18,9,4,9,20,25,0,118
12,21,18,9,4,12,25,0,0,101
12,21,18,9,4,14,5,19,19,121
12,21,18,9,14,7,0,0,0,81
12,21,18,9,14,7,12,25,0,118
12,21,18,11,0,0,0,0,0,62
12,21,18,11,5,4,0,0,0,71
12,21,18,11,5,18,0,0,0,85
12,21,18,11,5,18,19,0,0,104
12,21,18,11,25,0,0,0,0,87
12,21,18,11,9,14,7,0,0,92
12,21,18,11,9,14,7,12,25,129
12,21,18,11,19,0,0,0,0,81
12,21,18,18,25,0,0,0,0,94
12,21,18,18,9,5,18,0,0,101
12,21,18,18,9,5,19,0,0,102
12,21,19,3,9,15,21,19,0,119
12,21,19,5,18,0,0,0,0,75
12,21,19,8,0,0,0,0,0,60
12,21,19,8,2,21,18,7,0,108
12,21,19,8,5,4,0,0,0,69
12,21,19,8,5,18,0,0,0,83
12,21,19,8,5,19,0,0,0,84
12,21,19,8,5,19,20,0,0,104
12,21,19,8,25,0,0,0,0,85
12,21,19,8,9,5,18,0,0,92
12,21,19,8,9,5,19,20,0,113
12,21,19,8,9,14,7,0,0,90
12,21,19,8,12,25,0,0,0,97
12,21,19,8,14,5,19,19,0,117
12,21,19,11,25,0,0,0,0,88
12,21,19,15,18,25,0,0,0,110
12,21,19,20,5,4,0,0,0,81
12,21,19,20,5,18,0,0,0,95
12,21,19,20,5,18,5,4,0,104
12,21,19,20,5,18,5,18,0,118
12,21,19,20,5,18,9,14,7,125
12,21,19,20,5,18,19,0,0,114
12,21,19,20,6,21,12,0,0,111
12,21,19,20,6,21,12,12,25,148
12,21,19,20,9,5,18,0,0,104
12,21,19,20,9,5,19,20,0,125
12,21,19,20,9,8,5,1,4,99
12,21,19,20,9,8,15,15,4,123
12,21,19,20,9,12,25,0,0,118
12,21,19,20,9,14,5,19,19,138
12,21,19,20,9,14,7,0,0,102
12,21,19,20,12,5,19,19,0,127
12,21,19,20,12,25,0,0,0,109
12,21,19,20,18,1,0,0,0,91
12,21,19,20,18,1,12,0,0,103
12,21,19,20,18,1,14,20,0,125
12,21,19,20,18,1,20,5,0,116
12,21,19,20,18,1,20,5,4,120
12,21,19,20,18,1,20,5,19,135
12,21,19,20,18,5,0,0,0,95
12,21,19,20,18,5,4,0,0,99
12,21,19,20,18,5,19,0,0,114
12,21,19,20,18,9,3,1,12,115
12,21,19,20,18,9,6,25,0,130
12,21,19,20,18,9,14,5,0,118
12,21,19,20,18,9,14,7,0,120
12,21,19,20,18,9,14,7,19,139
12,21,19,20,18,15,21,19,0,145
12,21,19,20,18,21,13,0,0,124
12,21,19,20,18,21,13,19,0,143
12,21,19,20,19,0,0,0,0,91
12,21,19,21,19,0,0,0,0,92
12,21,19,21,19,5,19,0,0,116
12,21,20,1,3,5,15,21,19,117
12,21,20,1,14,25,0,0,0,93
12,21,20,1,14,9,19,20,0,116
12,21,20,1,14,9,19,20,19,135
12,21,20,1,18,9,15,21,19,136
12,21,20,1,20,9,15,14,0,112
12,21,20,5,0,0,0,0,0,58
12,21,20,5,1,0,0,0,0,59
12,21,20,5,1,12,0,0,0,71
12,21,20,5,3,9,1,0,0,71
12,21,20,5,3,9,21,13,0,104
12,21,20,5,3,9,21,13,19,123
12,21,20,5,4,0,0,0,0,62
12,21,20,5,9,3,0,0,0,70
12,21,20,5,9,14,0,0,0,81
12,21,20,5,9,14,9,26,5,121
12,21,20,5,9,14,19,0,0,100
12,21,20,5,12,5,20,0,0,95
12,21,20,5,13,1,11,5,18,106
12,21,20,5,14,9,19,20,19,139
12,21,20,5,15,0,0,0,0,73
12,21,20,5,15,12,9,14,0,108
12,21,20,5,15,12,9,14,19,127
12,21,20,5,15,12,15,21,19,140
12,21,20,5,15,13,1,0,0,87
12,21,20,5,15,21,19,0,0,113
12,21,20,5,18,0,0,0,0,76
12,21,20,5,19,0,0,0,0,77
12,21,20,5,19,3,5,14,20,119
12,21,20,5,20,9,21,13,0,121
12,21,20,5,20,9,21,13,19,140
12,21,20,5,21,13,0,0,0,92
12,21,20,5,23,1,25,0,0,107
12,21,20,6,9,19,11,0,0,98
12,21,20,8,5,18,1,14,19,118
12,21,20,8,5,18,14,0,0,98
12,21,20,8,5,18,14,19,0,117
12,21,20,8,9,5,18,0,0,93
12,21,20,8,9,5,18,19,0,112
12,21,20,9,1,14,9,4,0,90
12,21,20,9,1,14,15,9,4,105
12,21,20,9,4,9,14,0,0,89
12,21,20,9,4,9,14,5,0,94
12,21,20,9,4,9,14,9,3,101
12,21,20,9,14,7,0,0,0,83
12,21,20,9,14,7,19,0,0,102
12,21,20,9,19,20,0,0,0,101
12,21,20,9,19,20,19,0,0,120
12,21,20,15,19,5,0,0,0,92
12,21,20,18,9,14,0,0,0,94
12,21,20,18,9,14,5,0,0,99
12,21,20,21,12,5,14,3,5,113
12,21,20,21,12,5,14,20,0,125
12,21,22,0,0,0,0,0,0,55
12,21,22,19,0,0,0,0,0,74
12,21,24,1,20,5,0,0,0,83
12,21,24,1,20,5,4,0,0,87
12,21,24,1,20,5,19,0,0,102
12,21,24,1,20,9,14,7,0,108
12,21,24,1,20,9,15,14,0,116
12,21,24,1,20,9,15,14,19,135
12,21,24,5,0,0,0,0,0,62
12,21,24,5,19,0,0,0,0,81
12,21,24,9,22,5,0,0,0,93
12,21,24,21,18,25,0,0,0,121
12,21,24,21,18,9,1,0,0,106
12,21,24,21,18,9,1,14,20,140
12,21,24,21,18,9,1,20,5,131
12,21,24,21,18,9,5,14,20,144
12,21,24,21,18,9,5,19,0,129
12,21,24,21,18,9,5,20,25,155
12,21,24,21,18,9,15,21,19,160
12,21,24,21,18,9,19,20,0,144
12,21,24,21,18,9,20,25,0,150
12,21,24,21,19,0,0,0,0,97
12,23,5,9,0,0,0,0,0,49
12,23,5,9,19,0,0,0,0,68
12,23,15,16,0,0,0,0,0,66
13,2,4,0,0,0,0,0,0,19
13,2,5,21,5,18,0,0,0,64
13,2,9,18,1,0,0,0,0,43
13,2,9,18,1,19,0,0,0,62
13,2,15,18,9,0,0,0,0,57
13,3,3,1,6,6,18,5,25,80
13,3,7,0,0,0,0,0,0,23
13,3,16,8,1,9,12,0,0,62
13,4,14,20,0,0,0,0,0,51
13,4,19,5,0,0,0,0,0,41
13,5,2,15,19,0,0,0,0,54
13,5,3,1,20,5,0,0,0,47
13,5,3,1,20,9,0,0,0,51
13,5,3,3,1,19,0,0,0,44
13,5,3,8,0,0,0,0,0,29
13,5,3,8,1,5,12,0,0,47
13,5,3,8,1,14,1,12,0,57
13,5,3,8,1,14,9,3,0,56
13,5,3,8,1,14,9,3,19,75
13,5,3,8,1,14,9,19,13,85
13,5,3,8,1,14,9,19,20,92
13,5,3,8,1,14,9,26,5,84
13,5,3,8,1,14,20,0,0,64
13,5,3,8,9,20,26,1,8,93
13,5,3,8,15,1,3,1,14,63
13,5,3,11,0,0,0,0,0,32
13,5,3,12,9,26,9,14,5,96
13,5,3,15,4,15,14,20,0,89
13,5,3,15,13,5,20,5,18,97
13,5,3,15,13,5,20,18,25,117
13,5,3,15,14,0,0,0,0,50
13,5,3,15,14,9,3,0,0,62
13,5,3,15,14,9,14,0,0,73
13,5,3,15,14,9,15,9,4,87
13,5,3,15,14,9,21,13,0,93
13,5,3,15,14,9,21,13,19,112
13,5,3,21,13,0,0,0,0,55
13,5,3,21,13,19,0,0,0,74
13,5,3,21,18,9,1,12,0,82
13,5,4,1,9,12,12,15,14,85
13,5,4,1,11,1,0,0,0,35
13,5,4,1,11,1,19,0,0,54
13,5,4,1,12,0,0,0,0,35
13,5,4,1,12,5,4,0,0,44
13,5,4,1,12,5,20,0,0,60
13,5,4,1,12,9,14,7,0,65
13,5,4,1,12,9,19,20,0,83
13,5,4,1,12,9,19,20,19,102
13,5,4,1,12,9,26,5,0,75
13,5,4,1,12,12,1,18,25,91
13,5,4,1,12,12,5,4,0,56
13,5,4,1,12,12,9,3,0,59
13,5,4,1,12,12,9,14,7,77
13,5,4,1,12,12,9,15,14,85
13,5,4,1,12,12,9,19,20,95
13,5,4,1,12,19,0,0,0,54
13,5,4,4,12,5,0,0,0,43
13,5,4,4,12,5,4,0,0,47
13,5,4,4,12,5,18,0,0,61
13,5,4,4,12,5,18,19,0,80
13,5,4,4,12,5,19,0,0,62
13,5,4,4,12,9,14,7,0,68
13,5,4,5,14,1,7,1,14,64
13,5,4,5,22,1,3,0,0,53
13,5,4,5,22,1,3,19,0,72
13,5,4,6,12,25,0,0,0,65
13,5,4,6,12,9,5,19,0,73
13,5,4,9,1,3,25,0,0,60
13,5,4,9,1,3,9,4,0,48
13,5,4,9,1,3,9,5,19,68
13,5,4,9,1,4,0,0,0,36
13,5,4,9,1,5,0,0,0,37
13,5,4,9,1,5,22,1,12,72
13,5,4,9,1,12,0,0,0,44
13,5,4,9,1,12,9,26,5,84
13,5,4,9,1,12,12,25,0,81
13,5,4,9,1,12,19,0,0,63
13,5,4,9,1,14,9,3,0,58
13,5,4,9,1,14,9,19,13,87
13,5,4,9,1,14,9,20,25,100
13,5,4,9,1,14,12,25,0,83
13,5,4,9,1,14,19,0,0,65
13,5,4,9,1,14,20,0,0,66
13,5,4,9,1,14,20,19,0,85
13,5,4,9,1,18,25,0,0,75
13,5,4,9,1,19,0,0,0,51
13,5,4,9,1,20,5,0,0,57
13,5,4,9,1,20,5,4,0,61
13,5,4,9,1,20,5,12,25,94
13,5,4,9,1,20,5,19,0,76
13,5,4,9,1,20,9,14,7,82
13,5,4,9,1,20,9,15,14,90
13,5,4,9,1,20,9,19,5,85
13,5,4,9,1,20,9,22,5,88
13,5,4,9,1,20,9,26,5,92
13,5,4,9,1,20,15,18,0,85
13,5,4,9,1,20,15,18,25,110
13,5,4,9,1,20,15,18,19,104
13,5,4,9,1,20,18,9,24,103
13,5,4,9,3,1,0,0,0,35
13,5,4,9,3,1,2,12,5,54
13,5,4,9,3,1,2,12,25,74
13,5,4,9,3,1,9,4,19,67
13,5,4,9,3,1,12,0,0,47
13,5,4,9,3,1,12,12,25,84
13,5,4,9,3,1,12,19,0,66
13,5,4,9,3,1,14,20,0,69
13,5,4,9,3,1,18,5,19,77
13,5,4,9,3,1,20,5,0,60
13,5,4,9,3,1,20,5,4,64
13,5,4,9,3,1,20,5,19,79
13,5,4,9,3,1,20,15,18,88
13,5,4,9,3,9,14,1,12,70
13,5,4,9,3,9,14,5,0,62
13,5,4,9,3,9,14,5,4,66
13,5,4,9,3,9,14,5,18,80
13,5,4,9,3,9,14,5,19,81
13,5,4,9,3,11,0,0,0,45
13,5,4,9,3,11,19,0,0,64
13,5,4,9,3,15,0,0,0,49
13,5,4,9,3,15,19,0,0,68
13,5,4,9,3,19,0,0,0,53
13,5,4,9,4,9,1,0,0,45
13,5,4,9,4,9,9,0,0,53
13,5,4,9,5,20,25,0,0,81
13,5,4,9,5,22,1,12,19,90
13,5,4,9,6,9,24,5,4,79
13,5,4,9,12,12,5,0,0,60
13,5,4,9,13,14,0,0,0,58
13,5,4,9,13,14,15,0,0,73
13,5,4,9,13,14,15,19,0,92
13,5,4,9,13,14,21,19,0,98
13,5,4,9,14,1,19,0,0,65
13,5,4,9,14,5,0,0,0,50
13,5,4,9,14,15,0,0,0,60
13,5,4,9,15,0,0,0,0,46
13,5,4,9,15,3,18,1,12,80
13,5,4,9,15,3,18,5,0,72
13,5,4,9,15,3,18,9,19,95
13,5,4,9,19,1,14,3,5,73
13,5,4,9,19,5,3,20,0,78
13,5,4,9,20,1,14,3,5,74
13,5,4,9,20,1,14,20,0,86
13,5,4,9,20,1,20,5,0,77
13,5,4,9,20,1,20,5,4,81
13,5,4,9,20,1,20,5,18,95
13,5,4,9,20,1,20,5,19,96
13,5,4,9,20,1,20,9,15,96
13,5,4,9,20,1,20,15,18,105
13,5,4,9,21,13,0,0,0,65
13,5,4,9,21,13,9,19,13,106
13,5,4,9,21,13,9,26,5,105
13,5,4,9,21,13,12,25,0,102
13,5,4,9,21,13,19,0,0,84
13,5,4,9,21,19,0,0,0,71
13,5,4,10,9,4,9,5,0,59
13,5,4,10,9,4,9,5,8,67
13,5,4,12,1,18,0,0,0,53
13,5,4,12,1,18,19,0,0,72
13,5,4,12,5,0,0,0,0,39
13,5,4,12,5,25,0,0,0,64
13,5,4,12,5,25,5,4,0,73
13,5,4,12,5,25,9,14,7,94
13,5,4,12,5,25,19,0,0,83
13,5,4,12,9,5,4,0,0,52
13,5,4,18,5,7,1,12,0,65
13,5,4,18,9,3,11,0,0,63
13,5,4,19,3,8,5,1,20,78
13,5,4,21,12,1,0,0,0,56
13,5,4,21,12,12,1,0,0,68
13,5,4,21,12,12,1,5,0,73
13,5,4,21,12,12,1,18,0,86
13,5,4,21,12,12,1,18,25,111
13,5,4,21,12,12,1,19,0,87
13,5,4,21,12,12,1,20,5,93
13,5,4,21,12,12,15,19,5,106
13,5,4,21,12,12,15,21,19,122
13,5,4,21,19,1,5,0,0,68
13,5,4,21,19,1,12,0,0,75
13,5,4,21,19,1,14,0,0,77
13,5,4,21,19,1,14,19,0,96
13,5,4,21,19,15,9,4,0,90
13,5,4,21,19,15,9,4,19,109
13,5,5,2,15,19,0,0,0,59
13,5,5,3,8,0,0,0,0,34
13,5,5,3,8,5,18,0,0,57
13,5,5,3,8,9,14,7,0,64
13,5,5,4,0,0,0,0,0,27
13,5,5,4,6,21,12,0,0,66
13,5,5,4,12,5,19,19,0,82
13,5,5,4,19,0,0,0,0,46
13,5,5,11,5,14,0,0,0,53
13,5,5,11,5,19,20,0,0,78
13,5,5,11,12,25,0,0,0,71
13,5,5,11,12,9,14,7,0,76
13,5,5,11,14,5,19,19,0,91
13,5,5,18,5,4,0,0,0,50
13,5,5,18,11,1,20,0,0,73
13,5,5,19,5,0,0,0,0,47
13,5,5,20,0,0,0,0,0,43
13,5,5,20,1,2,12,5,0,63
13,5,5,20,5,14,0,0,0,62
13,5,5,20,5,18,0,0,0,66
13,5,5,20,5,18,12,25,0,103
13,5,5,20,5,18,19,0,0,85
13,5,5,20,8,0,0,0,0,51
13,5,5,20,8,5,12,16,0,84
13,5,5,20,9,14,7,0,0,73
13,5,5,20,9,14,7,5,18,96
13,5,5,20,9,14,7,19,0,92
13,5,5,20,12,25,0,0,0,80
13,5,5,20,14,5,19,19,0,100
13,5,5,20,19,0,0,0,0,62
13,5,7,1,1,18,1,0,0,46
13,5,7,1,2,1,18,0,0,47
13,5,7,1,2,1,18,19,0,66
13,5,7,1,2,1,21,4,0,54
13,5,7,1,2,9,20,0,0,57
13,5,7,1,2,25,20,5,0,78
13,5,7,1,2,25,20,5,19,97
13,5,7,1,2,9,20,19,0,76
13,5,7,1,2,21,3,11,0,63
13,5,7,1,2,21,3,11,19,82
13,5,7,1,3,25,3,12,5,74
13,5,7,1,3,9,20,25,0,83
13,5,7,1,3,15,12,15,14,85
13,5,7,1,3,15,19,13,0,76
13,5,7,1,3,21,18,9,5,82
13,5,7,1,4,5,1,20,8,64
13,5,7,1,4,25,14,5,0,74
13,5,7,1,4,25,14,5,19,93
13,5,7,1,4,15,14,20,0,79
13,5,7,1,4,15,14,20,25,104
13,5,7,1,4,15,19,5,0,69
13,5,7,1,5,18,7,0,0,56
13,5,7,1,6,1,18,1,4,56
13,5,7,1,6,15,7,0,0,54
13,5,7,1,8,5,18,20,26,103
13,5,7,1,10,15,21,12,5,89
13,5,7,1,12,5,13,5,0,61
13,5,7,1,12,5,18,7,0,68
13,5,7,1,12,9,20,8,0,75
13,5,7,1,12,9,20,8,19,94
13,5,7,1,12,15,16,1,0,70
13,5,7,1,12,15,16,9,1,79
13,5,7,1,12,15,16,9,3,81
13,5,7,1,12,15,16,19,0,88
13,5,7,1,13,5,18,5,0,67
13,5,7,1,13,5,20,5,18,87
13,5,7,1,13,5,20,18,5,87
13,5,7,1,13,16,5,18,5,83
13,5,7,1,16,8,15,14,5,84
13,5,7,1,16,15,4,0,0,61
13,5,7,1,16,15,4,5,0,66
13,5,7,1,16,15,4,5,19,85
13,5,7,1,16,15,4,19,0,80
13,5,7,1,16,15,12,9,19,97
13,5,7,1,18,1,4,0,0,49
13,5,7,1,18,15,14,0,0,73
13,5,7,1,18,15,14,19,0,92
13,5,7,1,19,3,15,16,5,84
13,5,7,1,19,5,9,19,13,91
13,5,7,1,19,5,13,5,0,68
13,5,7,1,19,16,15,18,5,99
13,5,7,1,19,19,0,0,0,64
13,5,7,1,19,19,5,0,0,69
13,5,7,1,19,19,5,19,0,88
13,5,7,1,20,8,5,18,5,82
13,5,7,1,20,8,5,18,13,90
13,5,7,1,20,25,16,5,0,92
13,5,7,1,20,25,16,25,0,112
13,5,7,1,20,15,14,0,0,75
13,5,7,1,20,15,14,19,0,94
13,5,7,1,20,18,15,14,0,93
13,5,7,1,22,15,12,20,0,95
13,5,7,1,22,15,12,20,19,114
13,5,7,1,23,1,20,20,0,90
13,5,7,1,23,1,20,20,19,109
13,5,7,1,23,5,2,5,18,79
13,5,7,1,23,15,18,4,0,86
13,5,7,1,23,15,18,4,19,105
13,5,7,1,26,15,15,9,4,95
13,5,7,2,15,20,5,0,0,67
13,5,7,5,18,7,0,0,0,55
13,5,7,9,12,12,1,8,0,67
13,5,7,9,12,12,1,8,19,86
13,5,7,9,12,12,15,20,8,101
13,5,7,9,12,16,0,0,0,62
13,5,7,9,12,16,8,0,0,70
13,5,7,9,12,16,8,19,0,89
13,5,7,9,12,16,19,0,0,81
13,5,7,13,8,15,0,0,0,61
13,5,7,15,8,13,0,0,0,61
13,5,7,15,8,13,9,20,0,90
13,5,7,15,8,13,19,0,0,80
13,5,7,15,13,9,20,0,0,82
13,5,7,15,20,1,12,3,0,76
13,5,7,18,9,13,0,0,0,65
13,5,7,18,9,13,9,19,8,101
13,5,7,18,9,13,19,0,0,84
13,5,7,21,9,12,16,0,0,83
13,5,8,1,12,12,1,0,0,52
13,5,8,1,18,9,0,0,0,54
13,5,8,1,18,9,19,0,0,73
13,5,8,1,18,9,19,20,0,93
13,5,8,9,20,26,1,8,0,90
13,5,8,9,20,26,15,20,8,124
13,5,8,13,1,14,4,1,18,77
13,5,8,18,4,1,4,0,0,53
13,5,8,20,1,18,0,0,0,65
13,5,9,7,15,13,9,1,14,86
13,5,9,11,12,5,0,0,0,55
13,5,9,11,12,5,19,0,0,74
13,5,9,12,5,0,0,0,0,44
13,5,9,12,5,18,0,0,0,62
13,5,9,14,0,0,0,0,0,41
13,5,9,14,4,18,5,0,0,68
13,5,9,14,25,0,0,0,0,66
13,5,9,14,9,5,0,0,0,55
13,5,9,14,9,5,19,0,0,74
13,5,9,15,0,0,0,0,0,42
13,5,9,15,2,1,18,0,0,63
13,5,9,15,3,5,14,5,0,69
13,5,9,15,14,9,20,5,0,90
13,5,9,15,19,5,19,0,0,85
13,5,9,15,19,9,19,0,0,89
13,5,9,15,20,1,24,25,0,112
13,5,9,15,20,9,3,0,0,74
13,5,9,19,10,5,0,0,0,61
13,5,9,20,8,0,0,0,0,55
13,5,10,15,18,1,14,1,0,77
13,5,11,9,12,20,1,0,0,71
13,5,11,15,13,5,20,5,18,105
13,5,12,1,4,1,0,0,0,36
13,5,12,1,5,14,1,0,0,51
13,5,12,1,5,14,9,3,0,62
13,5,12,1,7,18,1,0,0,57
13,5,12,1,12,7,9,1,0,60
13,5,12,1,13,0,0,0,0,44
13,5,12,1,13,4,9,13,0,70
13,5,12,1,13,9,14,0,0,67
13,5,12,1,13,9,14,5,0,72
13,5,12,1,13,9,14,5,19,91
13,5,12,1,13,13,4,9,13,83
13,5,12,1,13,13,5,4,0,66
13,5,12,1,13,16,15,4,0,79
13,5,12,1,13,16,15,4,5,84
13,5,12,1,14,5,13,9,1,73
13,5,12,1,14,5,13,9,3,75
13,5,12,1,14,7,5,0,0,57
13,5,12,1,14,7,5,18,0,75
13,5,12,1,14,7,5,19,0,76
13,5,12,1,14,7,5,21,18,96
13,5,12,1,14,9,1,14,0,69
13,5,12,1,14,9,3,0,0,57
13,5,12,1,14,9,3,19,0,76
13,5,12,1,14,9,12,9,14,89
13,5,12,1,14,9,14,0,0,68
13,5,12,1,14,9,14,19,0,87
13,5,12,1,14,9,19,13,0,86
13,5,12,1,14,9,19,13,19,105
13,5,12,1,14,9,19,20,0,93
13,5,12,1,14,9,19,20,19,112
13,5,12,1,14,9,20,5,0,79
13,5,12,1,14,9,20,5,19,98
13,5,12,1,14,9,20,9,3,86
13,5,12,1,14,9,26,5,0,85
13,5,12,1,14,9,26,5,4,89
13,5,12,1,14,9,26,5,19,104
13,5,12,1,14,15,0,0,0,60
13,5,12,1,14,15,7,5,14,86
13,5,12,1,14,15,9,4,0,73
13,5,12,1,14,15,9,4,19,92
13,5,12,1,14,15,13,1,0,74
13,5,12,1,14,15,13,1,19,93
13,5,12,1,14,15,19,5,0,84
13,5,12,1,14,15,19,5,4,88
13,5,12,1,14,15,19,9,19,107
13,5,12,1,14,15,20,9,3,92
13,5,12,1,14,15,21,19,0,100
13,5,12,1,14,20,8,25,0,98
13,5,12,1,14,21,18,5,0,89
13,5,12,1,14,21,18,9,1,94
13,5,12,1,14,21,18,9,3,96
13,5,12,1,16,8,25,18,5,103
13,5,12,1,19,13,1,0,0,64
13,5,12,1,19,13,9,3,0,75
13,5,12,1,19,19,5,19,0,93
13,5,12,1,19,20,15,13,5,103
13,5,12,1,20,15,14,9,14,103
13,5,12,1,20,15,16,5,0,87
13,5,12,1,24,21,13,1,0,90
13,5,12,3,8,0,0,0,0,41
13,5,12,4,5,4,0,0,0,43
13,5,12,4,5,18,19,0,0,76
13,5,12,4,9,14,7,0,0,64
13,5,12,4,18,15,16,0,0,83
13,5,12,4,19,0,0,0,0,53
13,5,12,5,0,0,0,0,0,35
13,5,12,5,2,9,15,19,5,85
13,5,12,5,5,0,0,0,0,40
13,5,12,5,5,19,0,0,0,59
13,5,12,5,14,5,0,0,0,54
13,5,12,5,14,9,3,0,0,61
13,5,12,5,20,9,14,0,0,78
13,5,12,9,1,20,9,14,0,83
13,5,12,9,2,9,15,19,5,89
13,5,12,9,3,0,0,0,0,42
13,5,12,9,3,5,18,1,0,66
13,5,12,9,3,5,18,9,3,77
13,5,12,9,3,5,18,9,19,93
13,5,12,9,3,15,20,15,14,106
13,5,12,9,3,18,1,20,5,86
13,5,12,9,12,9,20,5,0,85
13,5,12,9,12,9,20,5,19,104
13,5,12,9,12,15,20,0,0,86
13,5,12,9,12,15,20,19,0,105
13,5,12,9,14,5,0,0,0,58
13,5,12,9,14,9,20,5,0,87
13,5,12,9,14,9,20,5,19,106
13,5,12,9,15,18,0,0,0,72
13,5,12,9,15,18,1,14,20,107
13,5,12,9,15,18,1,20,5,98
13,5,12,9,15,18,9,19,13,113
13,5,12,9,15,18,9,19,20,120
13,5,12,9,15,18,9,20,25,126
13,5,12,9,19,0,0,0,0,58
13,5,12,9,19,13,1,0,0,72
13,5,12,9,19,13,1,19,0,91
13,5,12,9,19,13,1,20,1,93
13,5,12,9,19,19,25,12,0,114
13,5,12,9,20,5,13,9,1,87
13,5,12,9,20,9,19,0,0,87
13,5,12,9,20,15,19,5,0,98
13,5,12,9,20,21,18,9,1,108
13,5,12,9,20,21,18,9,3,110
13,5,12,11,8,15,21,20,0,105
13,5,12,12,1,8,0,0,0,51
13,5,12,12,1,25,0,0,0,68
13,5,12,12,1,20,5,0,0,68
13,5,12,12,5,4,0,0,0,51
13,5,12,12,5,15,21,19,0,102
13,5,12,12,5,18,0,0,0,65
13,5,12,12,9,3,0,0,0,54
13,5,12,12,9,6,9,3,0,69
13,5,12,12,9,12,9,20,1,93
13,5,12,12,9,12,15,20,0,98
13,5,12,12,9,13,9,4,5,82
13,5,12,12,9,14,7,0,0,72
13,5,12,12,9,20,0,0,0,71
13,5,12,12,9,20,1,0,0,72
13,5,12,12,9,20,1,20,5,97
13,5,12,12,9,20,5,0,0,76
13,5,12,12,9,20,9,3,0,83
13,5,12,12,9,20,21,13,0,105
13,5,12,12,9,20,21,19,0,111
13,5,12,12,15,14,5,0,0,76
13,5,12,12,15,23,0,0,0,80
13,5,12,12,15,23,5,4,0,89
13,5,12,12,15,23,5,18,0,103
13,5,12,12,15,23,5,19,20,124
13,5,12,12,15,23,25,0,0,105
13,5,12,12,15,23,9,14,7,110
13,5,12,12,15,23,12,25,0,117
13,5,12,12,15,23,19,0,0,99
13,5,12,12,19,0,0,0,0,61
13,5,12,12,19,13,1,14,0,89
13,5,12,15,3,15,20,15,14,112
13,5,12,15,4,5,15,14,0,83
13,5,12,15,4,5,15,14,19,102
13,5,12,15,4,9,1,0,0,59
13,5,12,15,4,9,1,12,0,71
13,5,12,15,4,9,1,19,0,78
13,5,12,15,4,9,3,0,0,61
13,5,12,15,4,9,3,1,0,62
13,5,12,15,4,9,3,1,12,74
13,5,12,15,4,9,3,15,14,90
13,5,12,15,4,9,3,19,0,80
13,5,12,15,4,9,5,4,0,67
13,5,12,15,4,9,5,19,0,82
13,5,12,15,4,25,9,14,7,104
13,5,12,15,4,9,15,14,0,87
13,5,12,15,4,9,15,21,19,113
13,5,12,15,4,9,19,5,0,82
13,5,12,15,4,9,19,5,4,86
13,5,12,15,4,9,19,5,19,101
13,5,12,15,4,9,19,13,0,90
13,5,12,15,4,9,19,20,0,97
13,5,12,15,4,9,19,20,19,116
13,5,12,15,4,9,21,13,0,92
13,5,12,15,4,9,26,5,0,89
13,5,12,15,4,9,26,5,4,93
13,5,12,15,4,9,26,5,18,107
13,5,12,15,4,9,26,5,19,108
13,5,12,15,4,18,1,13,0,81
13,5,12,15,4,18,1,13,1,82
13,5,12,15,4,18,1,13,5,86
13,5,12,15,5,0,0,0,0,50
13,5,12,15,7,18,1,13,0,84
13,5,12,15,7,18,1,16,8,95
13,5,12,15,9,4,0,0,0,58
13,5,12,15,9,4,19,0,0,77
13,5,12,15,12,15,7,21,5,105
13,5,12,15,13,1,13,5,0,77
13,5,12,15,13,1,14,5,0,78
13,5,12,15,13,1,14,9,1,83
13,5,12,15,13,1,14,9,3,85
13,5,12,15,14,0,0,0,0,59
13,5,12,15,14,3,21,19,0,102
13,5,12,15,14,7,5,14,1,86
13,5,12,15,14,9,19,20,0,107
13,5,12,15,14,9,20,5,0,93
13,5,12,15,14,12,9,11,5,96
13,5,12,15,14,18,25,0,0,102
13,5,12,15,14,19,0,0,0,78
13,5,12,15,16,8,15,14,5,103
13,5,12,15,16,9,1,14,15,100
13,5,12,15,16,12,1,19,20,113
13,5,12,15,16,15,5,9,1,91
13,5,12,15,16,15,5,9,3,93
13,5,12,15,20,5,0,0,0,70
13,5,12,15,20,18,15,16,5,119
13,5,12,16,5,12,12,0,0,75
13,5,12,19,0,0,0,0,0,49
13,5,12,20,0,0,0,0,0,50
13,5,12,20,1,2,12,5,0,70
13,5,12,20,1,7,5,0,0,63
13,5,12,20,1,7,5,19,0,82
13,5,12,20,4,15,23,14,0,106
13,5,12,20,4,15,23,14,19,125
13,5,12,20,5,4,0,0,0,59
13,5,12,20,5,18,0,0,0,73
13,5,12,20,5,18,19,0,0,92
13,5,12,20,5,20,8,0,0,83
13,5,12,20,9,14,7,0,0,80
13,5,12,20,9,14,7,12,25,117
13,5,12,20,9,20,8,0,0,87
13,5,12,20,15,14,19,0,0,98
13,5,12,20,19,0,0,0,0,69
13,5,12,20,23,1,20,5,18,117
13,5,12,22,9,5,0,0,0,66
13,5,13,0,0,0,0,0,0,31
13,5,13,2,5,18,5,4,0,65
13,5,13,2,5,18,19,0,0,75
13,5,13,2,18,1,3,9,4,68
13,5,13,2,18,1,12,0,0,64
13,5,13,2,18,1,12,12,25,101
13,5,13,2,18,1,14,1,0,67
13,5,13,2,18,1,14,1,12,79
13,5,13,2,18,1,14,5,0,71
13,5,13,2,18,1,14,5,4,75
13,5,13,2,18,1,14,5,19,90
13,5,13,2,18,1,14,9,14,89
13,5,13,2,18,5,20,20,5,101
13,5,13,2,18,5,20,20,15,111
13,5,13,5,14,20,15,0,0,85
13,5,13,5,14,20,15,5,19,109
13,5,13,5,14,20,15,19,0,104
13,5,13,9,14,14,1,0,0,69
13,5,13,15,0,0,0,0,0,46
13,5,13,15,9,18,0,0,0,73
13,5,13,15,9,18,5,0,0,78
13,5,13,15,9,18,9,19,13,114
13,5,13,15,9,18,9,19,20,121
13,5,13,15,9,18,19,0,0,92
13,5,13,15,18,1,2,12,5,84
13,5,13,15,18,1,2,12,25,104
13,5,13,15,18,1,14,4,1,84
13,5,13,15,18,1,20,5,0,90
13,5,13,15,18,4,1,0,0,69
13,5,13,15,18,9,1,0,0,74
13,5,13,15,18,9,1,12,0,86
13,5,13,15,18,9,1,12,19,105
13,5,13,15,18,9,5,4,0,82
13,5,13,15,18,9,5,19,0,97
13,5,13,15,18,9,15,21,19,128
13,5,13,15,18,9,19,5,0,97
13,5,13,15,18,9,19,20,0,112
13,5,13,15,18,9,20,5,18,116
13,5,13,15,18,9,26,5,0,104
13,5,13,15,18,9,26,5,4,108
13,5,13,15,18,9,26,5,18,122
13,5,13,15,18,9,26,5,19,123
13,5,13,15,19,0,0,0,0,65
13,5,13,19,0,0,0,0,0,50
13,5,13,19,1,8,9,2,0,70
13,5,13,19,1,8,9,2,19,89
13,5,14,0,0,0,0,0,0,32
13,5,14,1,3,5,0,0,0,41
13,5,14,1,3,5,4,0,0,45
13,5,14,1,3,5,6,21,12,80
13,5,14,1,3,5,18,0,0,59
13,5,14,1,3,5,18,19,0,78
13,5,14,1,3,5,19,0,0,60
13,5,14,1,3,9,14,7,0,66
13,5,14,1,3,13,5,0,0,54
13,5,14,1,4,0,0,0,0,37
13,5,14,1,4,9,3,0,0,49
13,5,14,1,4,9,15,14,5,80
13,5,14,1,4,19,0,0,0,56
13,5,14,1,7,5,0,0,0,45
13,5,14,1,7,5,18,9,5,77
13,5,14,1,7,5,19,0,0,64
13,5,14,1,12,4,0,0,0,49
13,5,14,1,18,3,8,5,0,67
13,5,14,1,18,3,8,5,19,86
13,5,14,1,20,0,0,0,0,53
13,5,14,1,26,15,14,0,0,88
13,5,14,1,26,15,14,19,0,107
13,5,14,4,1,2,12,5,0,56
13,5,14,4,1,3,9,20,25,94
13,5,14,4,5,4,0,0,0,45
13,5,14,4,5,5,0,0,0,46
13,5,14,4,5,18,0,0,0,59
13,5,14,4,5,18,19,0,0,78
13,5,14,4,9,1,14,20,0,80
13,5,14,4,9,3,1,14,20,83
13,5,14,4,9,3,1,20,5,74
13,5,14,4,9,3,9,20,25,102
13,5,14,4,9,7,15,0,0,67
13,5,14,4,9,7,15,19,0,86
13,5,14,4,9,14,7,0,0,66
13,5,14,4,9,14,7,19,0,85
13,5,14,4,9,16,9,20,5,95
13,5,14,4,13,5,14,20,0,88
13,5,14,4,15,12,5,0,0,68
13,5,14,4,15,26,9,20,5,111
13,5,14,4,19,0,0,0,0,55
13,5,14,5,0,0,0,0,0,37
13,5,14,5,8,21,14,5,0,85
13,5,14,5,22,9,1,14,0,83
13,5,14,6,15,12,11,0,0,76
13,5,14,6,15,12,11,19,0,95
13,5,14,8,1,4,5,14,0,64
13,5,14,8,1,4,5,14,19,83
13,5,14,8,9,18,0,0,0,67
13,5,14,8,9,18,19,0,0,86
13,5,14,25,0,0,0,0,0,57
13,5,14,9,1,12,0,0,0,54
13,5,14,9,1,12,9,19,13,95
13,5,14,9,1,12,9,20,25,108
13,5,14,9,1,12,12,25,0,91
13,5,14,9,1,12,19,0,0,73
13,5,14,9,1,12,20,25,0,99
13,5,14,25,9,5,0,0,0,71
13,5,14,9,12,9,20,5,0,87
13,5,14,9,14,7,5,1,12,80
13,5,14,9,14,7,5,19,0,86
13,5,14,9,14,7,9,3,0,74
13,5,14,9,14,7,9,14,1,86
13,5,14,9,14,7,9,19,13,103
13,5,14,9,14,20,9,14,7,105
13,5,14,9,14,24,0,0,0,79
13,5,14,9,19,3,1,12,0,76
13,5,14,9,19,3,1,20,5,89
13,5,14,9,19,3,9,0,0,72
13,5,14,9,19,3,15,9,4,91
13,5,14,9,19,3,21,19,0,103
13,5,14,9,19,5,0,0,0,65
13,5,14,9,19,15,14,0,0,89
13,5,14,9,19,16,5,18,13,112
13,5,14,9,22,5,18,0,0,86
13,5,14,11,9,14,4,0,0,70
13,5,14,14,15,13,0,0,0,74
13,5,14,14,15,14,0,0,0,75
13,5,14,14,21,5,20,0,0,92
13,5,14,15,7,14,1,20,8,97
13,5,14,15,12,15,7,25,0,106
13,5,14,15,16,1,21,19,5,109
13,5,14,15,18,1,8,19,0,93
13,5,14,15,18,18,8,5,1,97
13,5,14,15,23,0,0,0,0,70
13,5,14,15,24,5,14,9,1,100
13,5,14,19,0,0,0,0,0,51
13,5,14,19,1,5,0,0,0,57
13,5,14,19,1,12,0,0,0,64
13,5,14,19,1,12,9,26,5,104
13,5,14,19,1,19,0,0,0,71
13,5,14,19,3,8,5,14,0,81
13,5,14,19,3,8,5,19,0,86
13,5,14,19,5,0,0,0,0,56
13,5,14,19,5,4,0,0,0,60
13,5,14,19,5,6,21,12,0,95
13,5,14,19,5,12,5,19,19,111
13,5,14,19,5,19,0,0,0,75
13,5,14,19,9,14,7,0,0,81
13,5,14,19,9,19,0,0,0,79
13,5,14,19,11,0,0,0,0,62
13,5,14,19,20,18,21,1,0,111
13,5,14,19,20,18,21,1,12,123
13,5,14,19,20,18,21,5,0,115
13,5,14,19,20,18,21,21,13,144
13,5,14,19,21,1,12,0,0,85
13,5,14,19,21,18,1,12,0,103
13,5,14,19,21,18,1,20,5,116
13,5,14,19,23,5,1,18,0,98
13,5,14,19,23,5,1,18,19,117
13,5,14,20,0,0,0,0,0,52
13,5,14,20,1,0,0,0,0,53
13,5,14,20,1,7,18,1,0,79
13,5,14,20,1,12,0,0,0,65
13,5,14,20,1,12,9,19,0,93
13,5,14,20,1,12,9,19,13,106
13,5,14,20,1,12,9,19,20,113
13,5,14,20,1,12,9,20,25,119
13,5,14,20,1,12,9,26,5,105
13,5,14,20,1,12,12,25,0,102
13,5,14,20,1,18,25,0,0,96
13,5,14,20,1,20,9,15,14,111
13,5,14,20,5,18,25,0,0,100
13,5,14,20,8,1,14,0,0,75
13,5,14,20,8,1,14,5,0,80
13,5,14,20,8,5,14,5,0,84
13,5,14,20,8,5,14,5,19,103
13,5,14,20,8,5,14,15,12,106
13,5,14,20,8,25,12,0,0,97
13,5,14,20,8,15,12,0,0,87
13,5,14,20,8,15,12,19,0,106
13,5,14,20,8,15,14,5,0,94
13,5,14,20,9,3,9,4,5,82
13,5,14,20,9,6,15,18,13,113
13,5,14,20,9,15,14,0,0,90
13,5,14,20,9,15,14,5,4,99
13,5,14,20,9,15,14,5,18,113
13,5,14,20,9,15,14,19,0,109
13,5,14,20,9,19,0,0,0,80
13,5,14,20,15,18,5,4,0,94
13,5,14,20,15,18,9,1,12,107
13,5,14,20,15,18,9,19,13,126
13,5,14,20,15,18,19,0,0,104
13,5,14,20,21,13,0,0,0,86
13,5,14,21,0,0,0,0,0,53
13,5,14,21,9,19,9,5,18,113
13,5,14,21,11,9,0,0,0,73
13,5,14,21,19,0,0,0,0,72
13,5,14,26,9,5,0,0,0,72
13,5,15,21,0,0,0,0,0,54
13,5,15,21,5,4,0,0,0,63
13,5,15,21,9,14,7,0,0,84
13,5,15,21,19,0,0,0,0,73
13,5,15,23,0,0,0,0,0,56
13,5,15,23,5,4,0,0,0,65
13,5,15,23,9,14,7,0,0,86
13,5,15,23,19,0,0,0,0,75
13,5,16,1,3,18,9,14,5,84
13,5,16,8,9,20,9,3,0,83
13,5,16,8,9,20,9,14,5,99
13,5,16,8,9,20,9,19,13,112
13,5,17,0,0,0,0,0,0,35
13,5,18,0,0,0,0,0,0,36
13,5,18,1,12,7,9,1,0,66
13,5,18,1,12,9,14,5,0,77
13,5,18,2,1,2,25,0,0,66
13,5,18,2,18,15,13,9,14,107
13,5,18,3,1,12,0,0,0,52
13,5,18,3,1,16,20,1,12,89
13,5,18,3,1,16,20,1,14,91
13,5,18,3,1,16,20,15,0,91
13,5,18,3,1,16,20,15,12,103
13,5,18,3,1,20,0,0,0,60
13,5,18,3,1,20,21,18,5,104
13,5,18,3,5,13,5,14,20,96
13,5,18,3,5,14,1,18,25,102
13,5,18,3,5,18,5,19,19,105
13,5,18,3,5,18,25,0,0,87
13,5,18,3,5,18,9,5,19,95
13,5,18,3,5,18,9,26,5,102
13,5,18,3,5,18,19,0,0,81
13,5,18,3,8,0,0,0,0,47
13,5,18,3,8,1,14,4,25,91
13,5,18,3,8,1,14,20,19,101
13,5,18,3,8,5,20,0,0,72
13,5,18,3,9,1,2,12,5,68
13,5,18,3,9,1,2,12,25,88
13,5,18,3,9,5,19,0,0,72
13,5,18,3,9,6,25,0,0,79
13,5,18,3,9,6,21,12,0,87
13,5,18,3,9,12,5,19,19,103
13,5,18,3,9,13,5,14,20,100
13,5,18,3,21,18,1,20,5,104
13,5,18,3,21,18,9,1,12,100
13,5,18,3,21,18,9,3,0,90
13,5,18,3,21,18,9,4,0,91
13,5,18,3,21,18,9,4,5,96
13,5,18,3,21,18,9,5,19,111
13,5,18,3,21,18,9,6,25,118
13,5,18,3,21,18,9,26,5,118
13,5,18,3,21,18,15,21,19,133
13,5,18,4,0,0,0,0,0,40
13,5,18,4,5,0,0,0,0,45
13,5,18,4,5,19,0,0,0,64
13,5,18,5,0,0,0,0,0,41
13,5,18,5,4,0,0,0,0,45
13,5,18,5,12,0,0,0,0,53
13,5,18,5,12,25,0,0,0,78
13,5,18,5,12,19,0,0,0,72
13,5,18,5,14,7,21,5,0,88
13,5,18,5,14,7,21,5,4,92
13,5,18,5,14,7,21,5,19,107
13,5,18,5,18,0,0,0,0,59
13,5,18,5,19,0,0,0,0,60
13,5,18,5,19,13,1,14,0,88
13,5,18,5,19,13,5,14,0,92
13,5,18,5,19,20,0,0,0,80
13,5,18,5,19,20,15,14,5,114
13,5,18,5,19,23,9,14,5,111
13,5,18,5,20,18,9,24,0,112
13,5,18,6,15,12,4,0,0,73
13,5,18,6,15,12,11,0,0,80
13,5,18,7,1,14,19,5,18,100
13,5,18,7,5,0,0,0,0,48
13,5,18,7,5,4,0,0,0,52
13,5,18,7,5,14,3,5,0,70
13,5,18,7,5,14,3,5,19,89
13,5,18,7,5,18,0,0,0,66
13,5,18,7,5,18,19,0,0,85
13,5,18,7,5,19,0,0,0,67
13,5,18,7,8,0,0,0,0,51
13,5,18,7,9,14,7,0,0,73
13,5,18,9,1,8,0,0,0,54
13,5,18,9,3,1,18,16,0,83
13,5,18,9,3,5,0,0,0,53
13,5,18,25,3,9,19,13,0,105
13,5,18,9,4,9,1,14,19,92
13,5,18,9,4,9,5,0,0,63
13,5,18,9,4,9,5,13,0,76
13,5,18,9,12,0,0,0,0,57
13,5,18,9,14,7,21,5,0,92
13,5,18,9,14,7,21,5,4,96
13,5,18,9,14,7,21,5,19,111
13,5,18,9,14,15,19,0,0,93
13,5,18,9,19,5,19,0,0,88
13,5,18,9,19,9,19,0,0,92
13,5,18,9,19,13,0,0,0,77
13,5,18,9,19,13,15,9,4,105
13,5,18,9,19,20,0,0,0,84
13,5,18,9,19,20,5,12,5,106
13,5,18,9,19,20,5,13,0,102
13,5,18,9,19,20,5,13,19,121
13,5,18,9,19,20,9,3,0,96
13,5,18,9,20,0,0,0,0,65
13,5,18,9,20,1,2,12,5,85
13,5,18,9,20,5,4,0,0,74
13,5,18,9,20,5,4,12,25,111
13,5,18,9,20,5,18,0,0,88
13,5,18,9,20,6,21,12,0,104
13,5,18,9,20,9,14,7,0,95
13,5,18,9,20,12,5,19,19,120
13,5,18,9,20,15,18,25,0,123
13,5,18,9,20,19,0,0,0,84
13,5,18,11,0,0,0,0,0,47
13,5,18,11,8,5,20,0,0,80
13,5,18,11,9,14,0,0,0,70
13,5,18,11,19,0,0,0,0,66
13,5,18,12,5,19,0,0,0,72
13,5,18,12,5,20,20,5,0,98
13,5,18,12,9,7,15,0,0,79
13,5,18,12,9,14,7,0,0,78
13,5,18,12,9,14,19,0,0,90
13,5,18,12,9,15,14,0,0,86
13,5,18,12,15,14,0,0,0,77
13,5,18,12,15,14,19,0,0,96
13,5,18,12,15,20,0,0,0,83
13,5,18,12,15,20,19,0,0,102
13,5,18,12,19,0,0,0,0,67
13,5,18,13,1,9,4,0,0,63
13,5,18,13,1,9,4,5,14,82
13,5,18,13,1,9,4,19,0,82
13,5,18,13,1,14,0,0,0,64
13,5,18,13,5,14,0,0,0,68
13,5,18,13,15,20,8,5,18,115
13,5,18,15,0,0,0,0,0,51
13,5,18,15,3,5,12,5,0,76
13,5,18,15,3,5,12,9,3,83
13,5,18,15,3,25,20,5,0,104
13,5,18,15,3,18,9,14,5,100
13,5,18,15,4,21,19,0,0,95
13,5,18,15,7,1,13,25,0,97
13,5,18,15,7,5,14,9,3,89
13,5,18,15,7,15,14,25,0,112
13,5,18,15,7,15,14,9,3,99
13,5,18,15,9,19,20,9,3,111
13,5,18,15,16,0,0,0,0,67
13,5,18,15,16,9,1,0,0,77
13,5,18,15,16,9,1,19,0,96
13,5,18,15,16,9,3,0,0,79
13,5,18,15,16,9,4,1,14,95
13,5,18,15,19,0,0,0,0,70
13,5,18,15,19,15,13,1,12,111
13,5,18,15,19,15,13,5,0,103
13,5,18,15,19,20,15,13,5,123
13,5,18,15,20,15,13,25,0,124
13,5,18,15,20,18,15,16,25,145
13,5,18,15,21,19,0,0,0,91
13,5,18,15,24,5,14,5,0,99
13,5,18,15,26,15,9,20,5,126
13,5,18,16,5,15,16,12,5,105
13,5,18,18,9,2,21,19,8,113
13,5,18,18,9,5,18,0,0,86
13,5,18,18,9,5,19,20,0,107
13,5,18,18,9,12,5,19,19,118
13,5,18,18,25,13,1,11,5,109
13,5,18,18,25,13,1,14,0,107
13,5,18,18,25,13,5,14,0,111
13,5,18,18,9,13,5,14,20,115
13,5,18,18,9,14,5,19,19,120
13,5,18,18,25,23,9,14,7,132
13,5,18,18,15,23,5,19,0,116
13,5,18,19,9,15,14,0,0,93
13,5,18,21,9,20,0,0,0,86
13,5,18,21,12,9,14,5,0,97
13,5,18,21,12,9,15,9,4,106
13,5,18,22,1,9,12,0,0,80
13,5,18,23,9,14,9,20,5,116
13,5,18,23,15,13,1,14,0,102
13,5,19,1,0,0,0,0,0,38
13,5,19,1,2,9,20,5,0,74
13,5,19,1,3,15,14,9,3,82
13,5,19,1,4,0,0,0,0,42
13,5,19,1,9,12,0,0,0,59
13,5,19,1,12,0,0,0,0,50
13,5,19,1,12,9,11,5,0,75
13,5,19,1,12,12,25,0,0,87
13,5,19,1,14,7,5,0,0,64
13,5,19,1,18,1,9,3,0,69
13,5,19,1,18,3,8,0,0,67
13,5,19,1,19,0,0,0,0,57
13,5,19,1,24,15,14,9,3,103
13,5,19,3,1,12,0,0,0,53
13,5,19,3,1,12,9,14,5,81
13,5,19,3,1,12,9,19,13,94
13,5,19,3,1,12,19,0,0,72
13,5,19,3,8,1,14,20,0,83
13,5,19,4,1,13,5,19,0,79
13,5,19,5,0,0,0,0,0,42
13,5,19,5,5,13,5,4,0,69
13,5,19,5,5,13,19,0,0,79
13,5,19,5,12,0,0,0,0,54
13,5,19,5,12,1,0,0,0,55
13,5,19,5,12,5,4,0,0,63
13,5,19,5,12,25,0,0,0,79
13,5,19,5,12,18,25,0,0,97
13,5,19,5,13,0,0,0,0,55
13,5,19,5,13,2,18,25,15,115
13,5,19,5,14,14,1,0,0,71
13,5,19,5,14,20,5,18,1,100
13,5,19,5,14,20,5,18,25,124
13,5,19,5,18,1,9,3,0,73
13,5,19,8,0,0,0,0,0,45
13,5,19,8,5,19,0,0,0,69
13,5,19,8,25,0,0,0,0,70
13,5,19,8,9,5,18,0,0,77
13,5,19,8,9,5,19,20,0,98
13,5,19,8,9,14,7,0,0,75
13,5,19,8,21,7,1,0,0,74
13,5,19,8,21,7,1,1,19,94
13,5,19,8,21,7,1,8,0,82
13,5,19,8,21,7,1,14,1,89
13,5,19,8,21,7,7,1,0,81
13,5,19,8,21,7,7,1,8,89
13,5,19,8,21,7,7,5,0,85
13,5,19,8,21,13,13,1,4,97
13,5,19,8,23,15,18,11,0,112
13,5,19,8,23,15,18,11,19,131
13,5,19,9,1,4,0,0,0,51
13,5,19,9,1,12,0,0,0,59
13,5,19,9,1,12,12,25,0,96
13,5,19,9,1,14,0,0,0,61
13,5,19,9,3,0,0,0,0,49
13,5,19,9,3,1,12,12,25,99
13,5,19,25,13,14,9,15,14,127
13,5,19,9,15,14,0,0,0,75
13,5,19,9,20,25,12,0,0,103
13,5,19,9,20,9,14,5,0,94
13,5,19,9,20,9,20,5,0,100
13,5,19,9,22,20,1,0,0,89
13,5,19,11,5,4,0,0,0,57
13,5,19,12,5,14,0,0,0,68
13,5,19,13,5,18,9,1,14,97
13,5,19,13,5,18,9,3,0,85
13,5,19,13,5,18,9,19,5,106
13,5,19,13,5,18,9,19,13,114
13,5,19,13,5,18,9,19,20,121
13,5,19,13,5,18,9,20,5,107
13,5,19,13,5,18,9,26,5,113
13,5,19,14,1,7,5,0,0,64
13,5,19,14,1,12,9,20,25,118
13,5,19,14,1,12,20,25,0,109
13,5,19,14,5,0,0,0,0,56
13,5,19,14,5,19,0,0,0,75
13,5,19,15,0,0,0,0,0,52
13,5,19,15,1,18,9,1,12,93
13,5,19,15,1,18,9,21,13,114
13,5,19,15,2,1,18,0,0,73
13,5,19,15,2,12,1,19,20,106
13,5,19,15,3,1,4,9,1,70
13,5,19,15,3,1,18,16,0,90
13,5,19,15,3,1,18,16,19,109
13,5,19,15,3,15,5,12,5,92
13,5,19,15,3,15,12,1,0,83
13,5,19,15,3,15,12,9,3,94
13,5,19,15,3,15,12,15,14,111
13,5,19,15,4,5,0,0,0,61
13,5,19,15,4,5,18,13,0,92
13,5,19,15,4,5,18,13,19,111
13,5,19,15,4,9,3,0,0,68
13,5,19,15,4,15,14,20,0,105
13,5,19,15,6,21,18,3,1,101
13,5,19,15,7,12,5,1,0,77
13,5,19,15,7,12,5,1,12,89
13,5,19,15,7,12,5,1,19,96
13,5,19,15,7,12,15,5,1,92
13,5,19,15,8,5,16,1,18,100
13,5,19,15,12,1,2,5,0,72
13,5,19,15,12,5,0,0,0,69
13,5,19,15,12,9,20,5,0,98
13,5,19,15,12,15,7,25,0,111
13,5,19,15,12,15,7,9,3,98
13,5,19,15,13,5,18,5,0,93
13,5,19,15,13,5,18,5,19,112
13,5,19,15,13,5,18,9,3,100
13,5,19,15,13,15,18,16,8,122
13,5,19,15,14,0,0,0,0,66
13,5,19,15,14,1,19,1,12,99
13,5,19,15,14,9,3,0,0,78
13,5,19,15,14,15,20,1,12,114
13,5,19,15,14,15,20,21,13,135
13,5,19,15,14,19,0,0,0,85
13,5,19,15,16,1,21,19,5,114
13,5,19,15,16,5,1,11,0,85
13,5,19,15,16,8,9,12,0,97
13,5,19,15,16,8,25,12,0,113
13,5,19,15,16,8,9,12,5,102
13,5,19,15,16,8,25,12,12,125
13,5,19,15,16,8,25,12,19,132
13,5,19,15,16,8,25,20,5,126
13,5,19,15,16,9,3,0,0,80
13,5,19,15,16,12,1,19,20,120
13,5,19,15,16,15,4,9,1,97
13,5,19,15,18,5,3,20,1,99
13,5,19,15,18,8,9,14,0,101
13,5,19,15,18,8,9,14,5,106
13,5,19,15,18,8,9,14,25,126
13,5,19,15,18,18,8,9,14,119
13,5,19,15,19,1,21,18,0,111
13,5,19,15,19,3,1,12,5,92
13,5,19,15,19,5,13,5,0,94
13,5,19,15,19,15,13,1,0,100
13,5,19,15,19,15,13,5,0,104
13,5,19,15,19,15,13,5,19,123
13,5,19,15,19,16,5,18,13,123
13,5,19,15,19,16,15,18,5,125
13,5,19,15,19,20,0,0,0,91
13,5,19,15,19,20,25,12,5,133
13,5,19,15,20,8,5,18,13,116
13,5,19,15,20,8,5,20,0,105
13,5,19,15,20,25,16,5,0,118
13,5,19,15,20,15,14,9,3,113
13,5,19,15,20,18,15,3,8,116
13,5,19,15,20,18,15,14,0,119
13,5,19,15,20,18,15,14,19,138
13,5,19,15,22,1,18,9,1,103
13,5,19,15,24,1,12,9,3,101
13,5,19,15,24,1,12,25,12,126
13,5,19,15,26,15,1,14,0,108
13,5,19,16,9,12,0,0,0,74
13,5,19,16,18,9,19,5,0,104
13,5,19,17,21,9,14,0,0,98
13,5,19,17,21,9,20,0,0,104
13,5,19,17,21,9,20,1,0,105
13,5,19,17,21,9,20,5,19,128
13,5,19,17,21,9,20,19,0,123
13,5,19,19,0,0,0,0,0,56
13,5,19,19,1,7,5,0,0,69
13,5,19,19,1,7,5,4,0,73
13,5,19,19,1,7,5,5,18,92
13,5,19,19,1,7,5,18,25,112
13,5,19,19,1,7,5,19,0,88
13,5,19,19,1,7,9,14,7,94
13,5,19,19,1,12,9,14,5,97
13,5,19,19,1,14,0,0,0,71
13,5,19,19,1,14,19,0,0,90
13,5,19,19,5,0,0,0,0,61
13,5,19,19,5,4,0,0,0,65
13,5,19,19,5,12,9,20,5,107
13,5,19,19,5,14,7,5,18,105
13,5,19,19,5,18,0,0,0,79
13,5,19,19,5,19,0,0,0,80
13,5,19,19,5,20,0,0,0,81
13,5,19,19,25,0,0,0,0,81
13,5,19,19,9,1,8,19,0,93
13,5,19,19,9,5,19,20,0,109
13,5,19,19,9,5,21,18,19,128
13,5,19,19,9,12,25,0,0,102
13,5,19,19,9,14,0,0,0,79
13,5,19,19,9,14,5,19,19,122
13,5,19,19,9,18,5,0,0,88
13,5,19,19,11,9,20,0,0,96
13,5,19,19,13,1,14,0,0,84
13,5,19,19,13,1,20,5,0,95
13,5,19,19,13,1,20,5,19,114
13,5,19,19,13,5,14,0,0,88
13,5,19,19,15,18,0,0,0,89
13,5,19,19,18,15,15,13,0,117
13,5,19,19,20,9,14,0,0,99
13,5,19,19,21,1,7,5,0,90
13,5,19,19,21,1,7,5,19,109
13,5,19,20,0,0,0,0,0,57
13,5,19,20,5,5,0,0,0,67
13,5,19,20,5,5,19,0,0,86
13,5,19,20,5,14,15,0,0,91
13,5,19,20,5,18,0,0,0,80
13,5,19,20,5,19,15,0,0,96
13,5,19,20,5,19,15,5,19,120
13,5,19,20,5,19,15,19,0,115
13,5,19,20,6,21,12,12,0,108
13,5,19,20,9,14,15,0,0,95
13,5,19,20,9,14,15,5,19,119
13,5,19,20,9,14,15,19,0,114
13,5,19,20,9,26,1,0,0,93
13,5,19,20,9,26,1,19,0,112
13,5,19,20,9,26,15,0,0,107
13,5,19,20,9,26,15,5,19,131
13,5,19,20,9,26,15,19,0,126
13,5,19,20,12,5,14,0,0,88
13,5,19,20,15,13,5,0,0,90
13,5,19,20,18,1,14,15,12,117
13,5,20,1,2,1,19,5,19,85
13,5,20,1,2,1,19,9,19,89
13,5,20,1,2,1,20,9,3,74
13,5,20,1,2,9,20,0,0,70
13,5,20,1,2,9,20,19,0,89
13,5,20,1,2,15,12,5,0,73
13,5,20,1,2,15,12,25,0,93
13,5,20,1,2,15,12,9,3,80
13,5,20,1,2,15,12,15,14,97
13,5,20,1,2,15,18,9,3,86
13,5,20,1,2,21,12,1,18,93
13,5,20,1,3,1,16,9,0,68
13,5,20,1,3,1,18,16,9,86
13,5,20,1,3,9,19,13,0,83
13,5,20,1,3,12,1,19,5,79
13,5,20,1,3,14,5,13,5,79
13,5,20,1,3,15,5,12,5,79
13,5,20,1,3,15,14,1,12,84
13,5,20,1,3,15,14,5,0,76
13,5,20,1,3,15,14,9,4,84
13,5,20,1,3,18,25,19,20,124
13,5,20,1,4,0,0,0,0,43
13,5,20,1,5,0,0,0,0,44
13,5,20,1,7,5,0,0,0,51
13,5,20,1,7,5,14,9,3,77
13,5,20,1,7,5,19,0,0,70
13,5,20,1,7,14,1,20,8,89
13,5,20,1,7,14,15,13,25,113
13,5,20,1,7,18,1,13,0,78
13,5,20,1,25,1,7,5,0,77
13,5,20,1,25,5,18,0,0,87
13,5,20,1,12,0,0,0,0,51
13,5,20,1,12,1,23,0,0,75
13,5,20,1,12,5,4,0,0,60
13,5,20,1,12,5,18,0,0,74
13,5,20,1,12,9,14,5,4,83
13,5,20,1,12,9,14,7,0,81
13,5,20,1,12,9,19,5,0,84
13,5,20,1,12,9,19,5,4,88
13,5,20,1,12,9,19,5,19,103
13,5,20,1,12,9,19,13,0,92
13,5,20,1,12,9,19,20,0,99
13,5,20,1,12,9,19,20,19,118
13,5,20,1,12,9,26,5,0,91
13,5,20,1,12,9,26,5,4,95
13,5,20,1,12,9,26,5,19,110
13,5,20,1,12,12,0,0,0,63
13,5,20,1,12,12,1,18,25,107
13,5,20,1,12,12,5,4,0,72
13,5,20,1,12,12,5,18,0,86
13,5,20,1,12,12,9,3,0,75
13,5,20,1,12,12,9,3,19,94
13,5,20,1,12,12,9,4,5,81
13,5,20,1,12,12,9,6,25,103
13,5,20,1,12,12,9,11,0,83
13,5,20,1,12,12,9,11,5,88
13,5,20,1,12,12,9,14,5,91
13,5,20,1,12,12,9,14,7,93
13,5,20,1,12,12,9,19,5,96
13,5,20,1,12,12,9,19,8,99
13,5,20,1,12,12,9,19,13,104
13,5,20,1,12,12,9,19,20,111
13,5,20,1,12,12,9,26,5,103
13,5,20,1,12,12,15,9,4,91
13,5,20,1,12,13,1,18,11,94
13,5,20,1,12,15,7,9,3,85
13,5,20,1,12,15,16,8,0,90
13,5,20,1,12,19,0,0,0,70
13,5,20,1,12,23,1,18,5,98
13,5,20,1,12,23,15,18,11,118
13,5,20,1,13,1,12,5,0,70
13,5,20,1,13,5,18,0,0,75
13,5,20,1,13,5,18,1,12,88
13,5,20,1,13,5,18,5,0,80
13,5,20,1,13,5,18,5,19,99
13,5,20,1,13,5,18,25,0,100
13,5,20,1,13,5,18,9,3,87
13,5,20,1,13,5,18,19,0,94
13,5,20,1,14,9,12,9,3,86
13,5,20,1,14,25,13,0,0,91
13,5,20,1,14,15,9,1,0,78
13,5,20,1,14,15,13,5,14,100
13,5,20,1,14,15,20,1,12,101
13,5,20,1,14,15,20,21,13,122
13,5,20,1,16,8,0,0,0,63
13,5,20,1,16,8,1,19,5,88
13,5,20,1,16,8,25,19,0,107
13,5,20,1,16,8,25,20,5,113
13,5,20,1,16,8,15,14,25,117
13,5,20,1,16,8,15,18,0,96
13,5,20,1,16,8,15,18,19,115
13,5,20,1,16,12,1,19,13,100
13,5,20,1,16,12,1,19,20,107
13,5,20,1,16,12,5,21,18,111
13,5,20,1,16,15,4,9,1,84
13,5,20,1,16,15,18,5,0,93
13,5,20,1,18,1,2,9,3,72
13,5,20,1,18,7,15,14,0,93
13,5,20,1,18,21,12,5,0,95
13,5,20,1,18,21,12,5,19,114
13,5,20,1,19,0,0,0,0,58
13,5,20,1,19,3,15,16,5,97
13,5,20,1,19,15,13,1,0,87
13,5,20,1,19,15,13,1,12,99
13,5,20,1,19,15,13,5,0,91
13,5,20,1,19,16,5,18,13,110
13,5,20,1,19,20,25,12,5,120
13,5,20,1,19,20,15,13,1,107
13,5,20,1,19,20,15,13,5,111
13,5,20,1,20,1,18,19,5,102
13,5,20,1,20,1,18,19,9,106
13,5,20,1,20,1,20,9,3,92
13,5,20,1,20,1,24,9,3,96
13,5,20,1,20,1,24,9,19,112
13,5,20,1,20,5,0,0,0,64
13,5,20,1,20,5,19,0,0,83
13,5,20,1,20,25,16,5,0,105
13,5,20,1,20,25,16,9,3,112
13,5,20,1,20,18,15,16,8,116
13,5,20,1,24,5,14,9,1,92
13,5,20,1,24,25,12,5,13,118
13,5,20,1,24,9,20,5,0,97
13,5,20,1,26,15,1,12,0,93
13,5,20,1,26,15,1,14,0,95
13,5,20,1,26,15,1,14,19,114
13,5,20,1,26,15,5,1,0,86
13,5,20,1,26,15,9,3,0,92
13,5,20,1,26,15,15,14,0,109
13,5,20,5,0,0,0,0,0,43
13,5,20,5,3,15,18,14,0,93
13,5,20,5,4,0,0,0,0,47
13,5,20,5,25,1,18,4,0,91
13,5,20,5,12,0,0,0,0,55
13,5,20,5,12,25,0,0,0,80
13,5,20,5,15,7,18,1,13,97
13,5,20,5,15,18,0,0,0,76
13,5,20,5,15,18,9,3,0,88
13,5,20,5,15,18,9,19,0,104
13,5,20,5,15,18,9,19,13,117
13,5,20,5,15,18,9,19,20,124
13,5,20,5,15,18,9,20,5,110
13,5,20,5,15,18,9,26,5,116
13,5,20,5,15,18,15,9,4,104
13,5,20,5,15,18,15,12,0,103
13,5,20,5,15,18,15,21,19,131
13,5,20,5,15,18,19,0,0,95
13,5,20,5,16,1,0,0,0,60
13,5,20,5,16,1,19,0,0,79
13,5,20,5,18,0,0,0,0,61
13,5,20,5,18,1,2,12,5,81
13,5,20,5,18,1,7,5,0,74
13,5,20,5,18,1,7,5,19,93
13,5,20,5,18,5,4,0,0,70
13,5,20,5,18,7,18,1,13,100
13,5,20,5,18,9,14,7,0,91
13,5,20,5,18,12,5,19,19,116
13,5,20,5,18,13,1,14,0,89
13,5,20,5,18,19,0,0,0,80
13,5,20,5,18,19,8,9,16,113
13,5,20,5,19,0,0,0,0,62
13,5,20,5,19,20,9,3,11,105
13,5,20,5,19,20,18,21,19,140
13,5,20,5,23,1,14,4,0,85
13,5,20,8,1,4,15,14,0,80
13,5,20,8,1,4,15,14,5,85
13,5,20,8,1,4,15,14,19,99
13,5,20,8,1,14,1,12,0,74
13,5,20,8,1,14,1,20,5,87
13,5,20,8,1,14,5,0,0,66
13,5,20,8,1,14,5,19,0,85
13,5,20,8,1,14,15,9,3,88
13,5,20,8,1,14,15,12,0,88
13,5,20,8,1,14,15,12,19,107
13,5,20,8,5,7,12,9,14,93
13,5,20,8,5,14,5,0,0,70
13,5,20,8,5,14,25,12,0,102
13,5,20,8,5,18,0,0,0,69
13,5,20,8,8,5,1,4,0,64
13,5,20,8,9,4,0,0,0,59
13,5,20,8,9,4,5,0,0,64
13,5,20,8,25,12,0,0,0,83
13,5,20,8,25,12,1,12,0,96
13,5,20,8,25,12,1,12,19,115
13,5,20,8,25,12,1,19,5,108
13,5,20,8,25,12,1,20,5,109
13,5,20,8,25,12,5,14,5,107
13,5,20,8,25,12,9,3,0,95
13,5,20,8,25,12,15,12,0,110
13,5,20,8,25,12,19,0,0,102
13,5,20,8,9,14,5,0,0,74
13,5,20,8,9,14,11,19,0,99
13,5,20,8,9,15,14,9,3,96
13,5,20,8,15,0,0,0,0,61
13,5,20,8,15,4,9,3,0,77
13,5,20,8,15,4,9,3,19,96
13,5,20,8,15,4,9,19,5,98
13,5,20,8,15,4,19,0,0,84
13,5,20,8,15,12,0,0,0,73
13,5,20,8,15,14,5,0,0,80
13,5,20,8,15,21,7,8,20,117
13,5,20,8,15,24,25,0,0,110
13,5,20,8,15,24,9,4,5,103
13,5,20,8,15,24,25,12,0,122
13,5,20,8,18,15,14,9,3,105
13,5,20,8,19,0,0,0,0,65
13,5,20,9,3,0,0,0,0,50
13,5,20,9,3,1,9,19,0,79
13,5,20,9,3,1,12,0,0,63
13,5,20,9,3,1,12,19,0,82
13,5,20,9,5,18,0,0,0,70
13,5,20,9,5,18,19,0,0,89
13,5,20,9,6,0,0,0,0,53
13,5,20,9,14,0,0,0,0,61
13,5,20,9,14,7,0,0,0,68
13,5,20,9,19,19,5,0,0,90
13,5,20,9,19,19,5,19,0,109
13,5,20,15,3,8,25,0,0,89
13,5,20,15,3,8,15,21,19,119
13,5,20,15,14,9,3,0,0,79
13,5,20,15,14,25,13,0,0,105
13,5,20,15,14,25,13,25,0,130
13,5,20,15,14,25,13,9,3,117
13,5,20,15,14,25,13,19,0,124
13,5,20,15,16,1,5,0,0,75
13,5,20,15,16,5,19,0,0,93
13,5,20,15,16,9,3,0,0,81
13,5,20,15,16,9,15,14,0,107
13,5,20,15,16,9,19,13,0,110
13,5,20,15,16,15,14,0,0,98
13,5,20,15,16,15,14,19,0,117
13,5,20,15,19,20,5,1,12,110
13,5,20,15,19,20,5,15,14,126
13,5,20,15,24,5,14,25,0,121
13,5,20,18,1,0,0,0,0,57
13,5,20,18,1,12,7,9,1,86
13,5,20,18,1,14,0,0,0,71
13,5,20,18,1,14,1,20,5,97
13,5,20,18,5,0,0,0,0,61
13,5,20,18,5,4,0,0,0,65
13,5,20,18,5,7,18,1,13,100
13,5,20,18,5,12,5,19,19,116
13,5,20,18,5,13,5,0,0,79
13,5,20,18,5,19,0,0,0,80
13,5,20,18,5,19,8,9,16,113
13,5,20,18,5,20,1,0,0,82
13,5,20,18,5,20,5,0,0,86
13,5,20,18,5,20,5,19,0,105
13,5,20,18,5,26,1,0,0,88
13,5,20,18,25,0,0,0,0,81
13,5,20,18,9,1,0,0,0,66
13,5,20,18,9,3,0,0,0,68
13,5,20,18,9,3,1,12,0,81
13,5,20,18,9,3,1,20,5,94
13,5,20,18,9,3,9,1,14,92
13,5,20,18,9,3,9,19,5,101
13,5,20,18,9,3,9,19,13,109
13,5,20,18,9,3,9,19,20,116
13,5,20,18,9,3,9,20,25,122
13,5,20,18,9,3,9,26,5,108
13,5,20,18,9,3,19,0,0,87
13,5,20,18,9,6,25,0,0,96
13,5,20,18,9,6,9,5,4,89
13,5,20,18,9,6,9,5,18,103
13,5,20,18,9,6,9,5,19,104
13,5,20,18,9,14,7,0,0,86
13,5,20,18,9,19,5,0,0,89
13,5,20,18,9,19,20,0,0,104
13,5,20,18,9,19,20,19,0,123
13,5,20,18,9,20,9,19,0,113
13,5,20,18,9,26,5,0,0,96
13,5,20,18,9,26,5,4,0,100
13,5,20,18,9,26,9,14,7,121
13,5,20,18,15,0,0,0,0,71
13,5,20,18,15,3,5,12,5,96
13,5,20,18,15,12,15,7,25,130
13,5,20,18,15,14,0,0,0,85
13,5,20,18,15,14,25,13,0,123
13,5,20,18,15,14,25,13,25,148
13,5,20,18,15,14,15,13,5,118
13,5,20,18,15,16,15,12,5,119
13,5,20,18,15,19,0,0,0,90
13,5,20,18,15,20,15,13,5,124
13,5,20,18,15,20,15,13,25,144
13,5,20,19,0,0,0,0,0,57
13,5,20,20,1,18,0,0,0,77
13,5,20,20,12,5,0,0,0,75
13,5,20,20,12,5,4,0,0,79
13,5,20,20,12,5,19,0,0,94
13,5,20,21,13,16,0,0,0,88
13,5,20,21,13,16,19,0,0,107
13,5,20,21,19,0,0,0,0,78
13,5,20,21,19,9,1,0,0,88
13,5,20,23,1,14,4,0,0,80
13,5,20,26,5,0,0,0,0,69
13,5,21,0,0,0,0,0,0,39
13,5,21,2,12,5,19,0,0,77
13,5,21,14,9,0,0,0,0,62
13,5,21,14,9,5,18,5,0,90
13,5,21,20,5,0,0,0,0,64
13,5,23,0,0,0,0,0,0,41
13,5,23,1,18,4,0,0,0,64
13,5,23,5,4,0,0,0,0,50
13,5,23,5,18,0,0,0,0,64
13,5,23,9,14,7,0,0,0,71
13,5,23,12,0,0,0,0,0,53
13,5,23,12,5,4,0,0,0,62
13,5,23,12,5,18,0,0,0,76
13,5,23,12,5,18,19,0,0,95
13,5,23,12,9,14,7,0,0,83
13,5,23,12,19,0,0,0,0,72
13,5,23,19,0,0,0,0,0,60
13,5,24,9,3,1,12,0,0,67
13,5,24,9,3,1,14,19,0,88
13,5,26,1,9,12,0,0,0,66
13,5,26,1,9,18,0,0,0,72
13,5,26,3,1,12,0,0,0,60
13,5,26,3,1,12,9,14,5,88
13,5,26,3,1,12,19,0,0,79
13,5,26,5,18,5,15,14,0,101
13,5,26,5,18,5,15,14,19,120
13,5,26,5,18,5,21,13,0,106
13,5,26,5,18,5,21,13,19,125
13,5,26,15,0,0,0,0,0,59
13,5,26,17,21,9,20,0,0,111
13,5,26,17,21,9,20,5,0,116
13,5,26,17,21,9,20,5,19,135
13,5,26,17,21,9,20,19,0,130
13,5,26,21,26,1,0,0,0,92
13,5,26,21,26,1,8,0,0,100
13,5,26,21,26,1,8,19,0,119
13,5,26,21,26,1,19,0,0,111
13,5,26,21,26,15,20,0,0,126
13,5,26,21,26,15,20,8,0,134
13,5,26,26,1,14,9,14,5,113
13,5,26,26,1,22,15,3,5,116
13,5,26,26,15,0,0,0,0,85
13,5,26,26,15,12,9,20,8,134
13,5,26,26,15,19,0,0,0,104
13,5,26,26,15,20,9,14,20,148
13,6,4,0,0,0,0,0,0,23
13,7,4,0,0,0,0,0,0,24
13,8,15,0,0,0,0,0,0,36
13,8,15,13,5,20,5,18,0,97
13,8,15,18,18,0,0,0,0,72
13,8,15,19,0,0,0,0,0,55
13,9,2,15,21,14,4,0,0,78
13,9,2,19,0,0,0,0,0,43
13,25,3,0,0,0,0,0,0,41
13,9,3,1,0,0,0,0,0,26
13,9,3,1,3,5,15,21,19,89
13,9,3,1,3,9,15,21,19,93
13,9,3,1,3,9,20,5,0,63
13,9,3,1,19,0,0,0,0,45
13,9,3,1,19,9,26,5,0,85
13,9,3,1,19,20,0,0,0,65
13,9,3,1,19,20,9,14,7,95
13,9,3,1,19,20,19,0,0,84
13,9,3,1,20,5,0,0,0,51
13,9,3,1,20,9,15,14,0,84
13,9,3,1,23,2,5,18,19,93
13,25,3,5,12,5,0,0,0,63
13,25,3,5,12,5,19,0,0,82
13,25,3,5,12,9,1,0,0,68
13,25,3,5,12,9,1,12,0,80
13,25,3,5,12,9,1,14,0,82
13,25,3,5,12,9,15,9,4,95
13,25,3,5,12,9,21,13,0,101
13,9,3,5,12,12,0,0,0,54
13,9,3,5,12,12,1,0,0,55
13,9,3,5,12,12,1,5,0,60
13,9,3,5,12,12,1,18,0,73
13,9,3,5,12,12,5,0,0,59
13,9,3,5,12,12,5,19,0,78
13,9,3,5,12,12,19,0,0,73
13,25,3,5,12,15,9,4,0,86
13,9,3,5,16,12,15,20,0,93
13,9,3,5,18,21,14,0,0,83
13,25,3,5,20,5,0,0,0,71
13,25,3,5,20,9,19,13,0,107
13,25,3,5,20,15,9,4,0,94
13,25,3,5,20,15,13,1,0,95
13,25,3,5,20,15,13,1,19,114
13,25,3,5,20,15,13,5,0,99
13,25,3,5,20,15,21,19,0,121
13,9,3,8,5,4,0,0,0,42
13,9,3,8,5,18,0,0,0,56
13,9,3,8,5,18,25,0,0,81
13,9,3,8,5,19,0,0,0,57
13,9,3,8,9,5,12,0,0,59
13,9,3,8,9,14,7,0,0,63
13,9,3,8,20,0,0,0,0,53
13,9,3,11,5,18,25,0,0,84
13,9,3,11,9,5,19,0,0,69
13,9,3,11,12,5,0,0,0,53
13,9,3,11,12,5,18,0,0,71
13,9,3,11,12,5,19,0,0,72
13,9,3,11,12,5,19,20,0,92
13,9,3,11,19,0,0,0,0,55
13,9,3,15,0,0,0,0,0,40
13,25,3,15,3,25,20,5,0,109
13,25,3,15,4,5,18,13,0,96
13,25,3,15,4,5,18,13,1,97
13,25,3,15,6,12,15,18,1,108
13,25,3,15,8,5,13,9,1,92
13,25,3,15,9,4,0,0,0,69
13,25,3,15,12,0,0,0,0,68
13,25,3,15,12,15,7,25,0,115
13,25,3,15,12,15,7,9,3,102
13,25,3,15,13,25,3,9,14,120
13,9,3,15,14,3,1,22,5,85
13,25,3,15,16,8,1,7,25,113
13,25,3,15,16,8,25,20,5,130
13,25,3,15,16,12,1,19,13,117
13,25,3,15,18,8,9,26,1,118
13,25,3,15,19,5,0,0,0,80
13,25,3,15,19,5,19,0,0,99
13,25,3,15,19,9,14,0,0,98
13,25,3,15,19,9,19,0,0,103
13,25,3,15,19,15,26,9,14,139
13,25,3,15,19,20,1,20,0,116
13,25,3,15,20,9,3,0,0,88
13,25,3,15,20,15,24,9,3,127
13,25,3,15,20,15,24,9,14,138
13,9,3,18,1,0,0,0,0,44
13,9,3,18,1,3,15,0,0,62
13,9,3,18,1,13,15,3,11,86
13,9,3,18,1,14,4,5,18,85
13,9,3,18,1,14,5,18,0,81
13,9,3,18,9,6,25,0,0,83
13,9,3,18,9,6,9,5,4,76
13,9,3,18,9,6,9,5,19,91
13,9,3,18,15,2,1,12,0,73
13,9,3,18,15,2,1,18,0,79
13,9,3,18,15,2,1,18,19,98
13,9,3,18,15,2,5,0,0,65
13,9,3,18,15,2,5,1,13,79
13,9,3,18,15,2,5,19,0,84
13,9,3,18,15,2,9,1,12,82
13,9,3,18,15,2,9,1,14,84
13,9,3,18,15,2,9,3,0,72
13,9,3,18,15,2,9,15,14,98
13,9,3,18,15,2,9,19,13,101
13,9,3,18,15,2,9,21,13,103
13,9,3,18,15,2,15,4,25,104
13,9,3,18,15,2,21,19,0,100
13,9,3,18,15,3,1,18,4,84
13,9,3,18,15,3,8,9,16,94
13,9,3,18,15,3,25,19,20,125
13,9,3,18,15,3,25,20,5,111
13,9,3,18,15,3,15,1,20,97
13,9,3,18,15,3,15,4,5,85
13,9,3,18,15,3,15,16,25,117
13,9,3,18,15,3,15,19,0,95
13,9,3,18,15,3,15,19,13,108
13,9,3,18,15,4,25,14,5,106
13,9,3,18,15,4,15,14,20,111
13,9,3,18,15,4,15,19,5,101
13,9,3,18,15,4,15,20,0,97
13,9,3,18,15,5,18,7,0,88
13,9,3,18,15,6,9,12,13,98
13,9,3,18,15,6,15,18,13,110
13,9,3,18,15,7,1,13,25,104
13,9,3,18,15,7,25,14,5,109
13,9,3,18,15,7,12,9,1,87
13,9,3,18,15,7,18,1,13,97
13,9,3,18,15,8,13,0,0,79
13,9,3,18,15,8,13,19,0,98
13,9,3,18,15,9,14,3,8,92
13,9,3,18,15,10,21,13,16,118
13,9,3,18,15,12,9,20,5,104
13,9,3,18,15,12,9,20,8,107
13,9,3,18,15,12,15,7,25,117
13,9,3,18,15,12,21,24,0,115
13,9,3,18,15,13,5,12,9,97
13,9,3,18,15,13,5,18,5,99
13,9,3,18,15,13,8,15,0,94
13,9,3,18,15,13,8,15,19,113
13,9,3,18,15,13,9,12,0,92
13,9,3,18,15,13,15,12,5,103
13,9,3,18,15,14,0,0,0,72
13,9,3,18,15,14,9,26,5,112
13,9,3,18,15,14,19,0,0,91
13,9,3,18,15,16,8,15,20,117
13,9,3,18,15,16,9,1,0,84
13,9,3,18,15,16,25,12,5,116
13,9,3,18,15,16,9,14,0,97
13,9,3,18,15,16,15,18,5,112
13,9,3,18,15,16,19,25,0,118
13,9,3,18,15,16,19,9,1,103
13,9,3,18,15,16,20,9,3,106
13,9,3,18,15,19,0,0,0,77
13,9,3,18,15,19,5,3,0,85
13,9,3,18,15,19,5,13,5,100
13,9,3,18,15,19,15,13,1,106
13,9,3,18,15,19,15,13,5,110
13,9,3,18,15,19,20,1,20,118
13,9,3,18,15,20,9,1,0,88
13,9,3,18,15,20,9,14,5,106
13,9,3,18,15,20,25,16,5,124
13,9,3,18,15,20,15,13,5,111
13,9,3,18,15,20,15,13,25,131
13,9,3,18,15,20,15,14,5,112
13,9,3,18,15,22,1,24,0,105
13,9,3,18,15,22,15,12,20,127
13,9,3,18,15,23,1,20,20,122
13,9,3,18,15,23,1,22,5,109
13,9,3,18,15,23,15,18,4,118
13,9,3,18,15,26,25,13,1,123
13,9,3,18,15,26,25,13,5,127
13,9,3,18,15,26,15,1,0,100
13,9,3,18,15,26,15,1,12,112
13,9,3,18,15,26,15,1,14,114
13,9,3,18,15,26,15,9,3,111
13,9,3,18,15,26,15,14,5,118
13,9,3,18,15,26,15,15,14,128
13,9,3,18,21,18,7,25,0,114
13,9,3,18,21,18,7,9,3,101
13,25,3,20,5,18,9,3,0,96
13,25,3,20,5,18,9,19,13,125
13,9,3,20,9,15,14,0,0,83
13,25,3,20,15,16,8,9,4,113
13,9,3,20,21,18,1,20,5,110
13,9,4,1,9,18,0,0,0,54
13,9,4,1,9,18,19,0,0,73
13,25,4,1,12,5,9,14,5,88
13,9,4,1,21,20,21,13,14,116
13,9,4,2,1,14,4,0,0,47
13,9,4,2,15,4,25,0,0,72
13,9,4,2,18,1,9,14,0,70
13,9,4,2,18,1,9,14,19,89
13,9,4,3,1,18,16,1,12,77
13,9,4,3,15,21,18,19,5,107
13,9,4,3,21,12,20,0,0,82
13,9,4,3,21,12,20,19,0,101
13,9,4,4,1,25,0,0,0,56
13,9,4,4,1,25,19,0,0,75
13,9,4,4,5,14,0,0,0,49
13,9,4,4,5,14,19,0,0,68
13,9,4,4,5,19,0,0,0,54
13,9,4,4,5,19,20,0,0,74
13,9,4,4,25,0,0,0,0,55
13,9,4,4,9,5,19,0,0,63
13,9,4,4,12,5,4,0,0,51
13,9,4,4,12,5,13,1,14,75
13,9,4,4,12,5,13,5,14,79
13,9,4,4,12,5,18,0,0,65
13,9,4,4,12,5,18,19,0,84
13,9,4,4,12,5,19,0,0,66
13,9,4,4,12,5,23,1,25,96
13,9,4,4,12,9,14,7,0,72
13,9,4,4,12,9,14,7,19,91
13,9,4,4,15,18,19,1,12,95
13,9,4,5,23,9,14,0,0,77
13,9,4,5,23,9,23,9,14,109
13,9,4,6,1,3,9,1,12,58
13,9,4,6,9,5,12,4,19,81
13,9,4,7,5,19,0,0,0,57
13,9,4,7,5,20,0,0,0,58
13,9,4,7,5,20,25,0,0,83
13,9,4,7,5,20,19,0,0,77
13,9,4,7,25,0,0,0,0,58
13,9,4,7,21,20,0,0,0,74
13,9,4,7,21,20,19,0,0,93
13,9,4,9,3,15,1,20,0,74
13,9,4,25,5,1,18,0,0,75
13,9,4,25,5,1,18,19,0,94
13,9,4,9,6,9,5,4,0,59
13,25,4,9,14,5,0,0,0,70
13,9,4,9,14,5,20,20,5,99
13,9,4,9,18,15,14,0,0,82
13,9,4,9,18,15,14,19,0,101
13,9,4,9,19,11,9,18,20,112
13,9,4,12,5,7,0,0,0,50
13,9,4,12,5,7,19,0,0,69
13,9,4,12,9,6,5,0,0,58
13,9,4,12,9,14,5,0,0,66
13,9,4,12,9,14,5,19,0,85
13,9,4,12,9,22,5,19,0,93
13,9,4,13,1,9,14,0,0,63
13,9,4,13,15,14,20,8,0,96
13,9,4,13,15,14,20,8,19,115
13,9,4,13,15,18,14,0,0,86
13,9,4,13,15,19,20,0,0,93
13,9,4,13,15,19,20,19,0,112
13,9,4,14,0,0,0,0,0,40
13,9,4,14,9,7,8,20,0,84
13,9,4,14,9,7,8,20,19,103
13,9,4,14,15,15,14,0,0,84
13,9,4,14,15,15,14,19,0,103
13,9,4,15,3,5,1,14,0,64
13,9,4,16,1,18,5,14,20,100
13,9,4,16,9,20,0,0,0,71
13,9,4,16,15,9,14,20,0,100
13,9,4,16,15,9,14,20,19,119
13,9,4,18,1,14,7,5,0,71
13,9,4,18,1,14,7,5,19,90
13,9,4,18,1,19,8,0,0,72
13,9,4,18,1,19,8,9,3,84
13,9,4,18,1,19,8,9,13,94
13,25,4,18,9,1,19,9,19,117
13,25,4,18,9,1,20,9,3,102
13,9,4,18,9,2,0,0,0,55
13,9,4,18,9,2,2,5,4,66
13,9,4,18,9,2,19,0,0,74
13,9,4,18,9,6,6,0,0,65
13,9,4,18,9,6,6,19,0,84
13,9,4,19,0,0,0,0,0,45
13,9,4,19,3,1,12,5,0,66
13,9,4,19,5,1,19,15,14,99
13,9,4,19,8,9,16,0,0,78
13,9,4,19,8,9,16,19,0,97
13,9,4,19,9,26,5,0,0,85
13,9,4,19,16,1,3,5,0,70
13,9,4,19,16,1,3,5,19,89
13,9,4,19,16,1,14,0,0,76
13,9,4,19,20,0,0,0,0,65
13,9,4,19,20,5,1,4,0,75
13,9,4,19,20,25,12,5,4,111
13,9,4,19,20,15,18,25,0,123
13,9,4,19,20,15,21,20,0,121
13,9,4,19,20,18,5,1,13,102
13,9,4,19,20,18,5,5,20,113
13,9,4,19,20,18,15,11,5,114
13,9,4,19,20,19,0,0,0,84
13,9,4,19,21,13,13,5,18,115
13,9,4,20,1,16,0,0,0,63
13,9,4,20,1,18,19,1,12,97
13,9,4,20,5,18,13,0,0,82
13,9,4,20,5,18,13,19,0,101
13,9,4,20,15,23,14,0,0,98
13,9,4,20,15,23,14,19,0,117
13,9,4,22,5,9,14,0,0,76
13,9,4,22,5,18,19,5,0,95
13,9,4,23,1,25,19,0,0,94
13,9,4,23,1,18,4,0,0,72
13,9,4,23,1,20,3,8,0,81
13,9,4,23,5,5,11,0,0,70
13,9,4,23,5,5,11,12,25,107
13,9,4,23,5,5,11,19,0,89
13,9,4,23,9,6,5,0,0,69
13,9,4,23,9,6,5,4,0,73
13,9,4,23,9,6,5,18,25,112
13,9,4,23,9,6,5,19,0,88
13,9,4,23,9,6,9,14,7,94
13,9,4,23,9,14,20,5,18,115
13,9,4,23,9,14,20,18,25,135
13,9,4,23,9,19,5,0,0,82
13,9,4,23,9,22,5,4,0,89
13,9,4,23,9,22,5,19,0,104
13,9,4,23,9,22,9,14,7,110
13,25,5,3,20,15,13,25,0,119
13,25,5,3,20,15,16,25,0,122
13,25,5,3,20,15,16,9,1,107
13,9,5,11,0,0,0,0,0,38
13,25,5,12,0,0,0,0,0,55
13,25,5,12,1,12,7,9,1,85
13,25,5,12,1,21,24,5,0,106
13,25,5,12,5,13,9,1,0,83
13,25,5,12,9,3,0,0,0,67
13,25,5,12,9,14,0,0,0,78
13,25,5,12,9,14,1,20,5,104
13,25,5,12,9,14,5,0,0,83
13,25,5,12,9,14,5,19,0,102
13,25,5,12,9,14,9,3,0,90
13,25,5,12,9,14,19,0,0,97
13,25,5,12,9,20,9,3,0,96
13,25,5,12,9,20,9,19,0,112
13,25,5,12,15,3,5,12,5,95
13,25,5,12,15,3,25,19,20,137
13,25,5,12,15,3,25,20,5,123
13,25,5,12,15,9,3,0,0,82
13,25,5,12,15,9,4,0,0,83
13,25,5,12,15,13,1,0,0,84
13,25,5,12,15,13,1,19,0,103
13,25,5,12,15,13,1,20,1,105
13,25,5,12,15,13,5,18,5,111
13,25,5,12,15,14,0,0,0,84
13,25,5,12,15,14,1,12,0,97
13,25,5,12,15,14,9,3,0,96
13,25,5,12,15,16,12,1,24,123
13,25,5,12,15,26,15,1,14,126
13,9,5,14,0,0,0,0,0,41
13,9,5,14,19,0,0,0,0,60
13,25,5,14,20,1,19,9,19,125
13,25,5,14,20,5,18,9,3,112
13,25,5,14,20,5,18,15,14,129
13,9,5,18,19,9,20,5,0,98
13,9,6,6,0,0,0,0,0,34
13,9,6,6,5,4,0,0,0,43
13,9,6,6,25,0,0,0,0,59
13,9,6,6,9,5,18,0,0,66
13,9,6,6,9,5,19,20,0,87
13,9,6,6,9,14,5,19,19,100
13,9,6,6,9,14,7,0,0,64
13,9,6,6,19,0,0,0,0,53
13,25,7,0,0,0,0,0,0,45
13,9,7,1,12,5,0,0,0,47
13,25,7,1,12,5,0,0,0,63
13,25,7,1,12,9,4,0,0,71
13,25,7,1,12,15,9,4,0,86
13,9,7,7,0,0,0,0,0,36
13,9,7,7,12,5,0,0,0,53
13,9,7,7,12,5,19,0,0,72
13,9,7,7,19,0,0,0,0,55
13,9,7,8,20,0,0,0,0,57
13,9,7,8,20,5,4,0,0,66
13,9,7,8,20,6,21,12,0,96
13,9,7,8,20,25,0,0,0,82
13,9,7,8,20,9,5,18,0,89
13,9,7,8,20,9,5,19,20,110
13,9,7,8,20,9,12,25,0,103
13,9,7,8,20,12,5,19,19,112
13,9,7,8,20,12,25,0,0,94
13,9,7,8,20,14,20,0,0,91
13,9,7,8,20,19,0,0,0,76
13,9,7,12,9,15,0,0,0,65
13,9,7,13,1,20,9,20,5,97
13,9,7,14,9,1,18,4,0,75
13,9,7,14,15,14,19,0,0,91
13,9,7,18,1,9,14,5,0,76
13,9,7,18,1,9,14,5,19,95
13,9,7,18,1,14,19,0,0,81
13,9,7,18,1,14,20,0,0,82
13,9,7,18,1,14,20,19,0,101
13,9,7,18,1,20,5,0,0,73
13,9,7,18,1,20,5,4,0,77
13,9,7,18,1,20,5,19,0,92
13,9,7,18,1,20,9,14,7,98
13,9,7,18,1,20,9,15,14,106
13,9,7,18,1,20,9,22,5,104
13,9,7,18,1,20,15,18,0,101
13,9,7,18,1,20,15,18,25,126
13,9,7,18,1,20,15,18,19,120
13,9,7,19,0,0,0,0,0,48
13,9,8,1,18,1,9,20,5,84
13,9,8,18,1,2,0,0,0,51
13,9,8,18,1,2,19,0,0,70
13,25,9,1,19,5,19,0,0,91
13,25,9,1,19,9,19,0,0,95
13,25,9,6,5,18,15,21,19,131
13,25,9,15,19,9,19,0,0,109
13,25,9,20,9,19,0,0,0,95
13,9,10,1,11,9,20,5,0,78
13,9,10,12,0,0,0,0,0,44
13,9,10,14,8,5,5,18,0,82
13,9,10,14,8,5,5,18,12,94
13,9,10,14,8,5,5,18,19,101
13,9,11,1,4,15,1,20,5,79
13,9,11,1,4,15,9,19,13,94
13,9,11,1,4,15,19,0,0,72
13,9,11,5,4,0,0,0,0,42
13,9,11,9,5,0,0,0,0,47
13,9,11,9,14,7,0,0,0,63
13,25,11,9,19,19,0,0,0,96
13,9,11,18,1,0,0,0,0,52
13,9,11,18,11,18,1,0,0,81
13,9,11,18,15,14,0,0,0,80
13,9,11,18,15,14,19,0,0,99
13,9,11,22,1,8,0,0,0,64
13,9,11,22,1,8,19,0,0,83
13,9,11,22,5,8,0,0,0,68
13,9,11,22,5,8,19,0,0,87
13,9,11,22,15,20,8,0,0,98
13,9,12,1,3,18,5,0,0,61
13,9,12,1,4,9,0,0,0,48
13,9,12,1,4,25,0,0,0,64
13,9,12,1,4,9,5,19,0,72
13,9,12,1,4,9,19,0,0,67
13,9,12,1,7,5,0,0,0,47
13,9,12,1,7,5,19,0,0,66
13,9,12,1,14,1,9,19,5,83
13,9,12,1,18,9,20,5,0,87
13,9,12,3,8,0,0,0,0,45
13,9,12,3,8,5,4,0,0,54
13,9,12,3,8,5,18,0,0,68
13,9,12,3,8,25,0,0,0,70
13,9,12,3,8,9,7,0,0,61
13,9,12,3,8,9,7,19,0,80
13,9,12,4,0,0,0,0,0,38
13,9,12,4,5,14,0,0,0,57
13,9,12,4,5,14,5,4,0,66
13,9,12,4,5,14,9,14,7,87
13,9,12,4,5,14,19,0,0,76
13,9,12,4,5,18,0,0,0,61
13,9,12,4,5,19,20,0,0,82
13,9,12,4,5,23,0,0,0,66
13,9,12,4,5,23,5,4,0,75
13,9,12,4,5,23,5,18,0,89
13,9,12,4,5,23,25,0,0,91
13,9,12,4,5,23,9,14,7,96
13,9,12,4,5,23,19,0,0,85
13,9,12,4,6,21,12,0,0,77
13,9,12,4,9,19,8,0,0,74
13,9,12,4,12,25,0,0,0,75
13,9,12,4,14,5,19,19,0,95
13,9,12,5,1,7,5,0,0,52
13,9,12,5,1,7,5,19,0,71
13,9,12,5,16,15,19,20,0,109
13,9,12,5,16,15,19,20,19,128
13,9,12,5,18,0,0,0,0,57
13,9,12,5,18,19,0,0,0,76
13,9,12,5,19,9,13,1,0,81
13,9,12,5,19,9,13,15,0,95
13,9,12,5,19,9,13,15,19,114
13,9,12,5,19,20,15,14,5,112
13,9,12,5,23,1,25,0,0,88
13,9,12,6,15,9,12,0,0,76
13,9,12,6,15,9,12,19,0,95
13,9,12,8,1,0,0,0,0,43
13,9,12,9,1,0,0,0,0,44
13,9,12,9,1,18,25,0,0,87
13,9,12,9,1,18,9,1,0,72
13,9,12,9,1,18,9,1,12,84
13,9,12,9,1,18,9,1,19,91
13,9,12,9,1,18,9,21,13,105
13,9,12,9,3,5,0,0,0,51
13,9,12,9,5,21,0,0,0,69
13,9,12,9,5,21,19,0,0,88
13,9,12,9,5,21,24,0,0,93
13,9,12,9,15,12,9,14,5,98
13,9,12,9,15,12,9,20,5,104
13,9,12,9,20,0,0,0,0,63
13,9,12,9,20,1,14,3,25,106
13,9,12,9,20,1,14,20,0,98
13,9,12,9,20,1,14,20,19,117
13,9,12,9,20,1,18,0,0,82
13,9,12,9,20,1,18,25,0,107
13,9,12,9,20,1,20,5,0,89
13,9,12,9,20,1,20,5,4,93
13,9,12,9,20,1,20,5,19,108
13,9,12,9,20,9,1,0,0,73
13,9,12,9,20,9,1,19,0,92
13,9,12,9,20,9,1,20,5,98
13,9,12,9,21,13,0,0,0,77
13,9,12,10,5,5,0,0,0,54
13,9,12,11,0,0,0,0,0,45
13,9,12,11,2,21,19,8,0,95
13,9,12,11,5,4,0,0,0,54
13,9,12,11,5,14,0,0,0,64
13,9,12,11,5,18,0,0,0,68
13,9,12,11,5,18,5,19,19,111
13,9,12,11,5,18,19,0,0,87
13,9,12,11,6,9,19,8,0,87
13,9,12,11,7,18,1,19,19,109
13,9,12,11,8,15,21,19,5,113
13,9,12,11,25,0,0,0,0,70
13,9,12,11,9,5,18,0,0,77
13,9,12,11,9,5,19,20,0,98
13,9,12,11,9,12,25,0,0,91
13,9,12,11,9,14,5,19,19,111
13,9,12,11,9,14,7,0,0,75
13,9,12,11,12,5,19,19,0,100
13,9,12,11,12,9,11,5,0,82
13,9,12,11,13,1,9,4,0,72
13,9,12,11,13,1,9,4,19,91
13,9,12,11,13,1,14,0,0,73
13,9,12,11,13,5,14,0,0,77
13,9,12,11,14,5,19,19,0,102
13,9,12,11,15,0,0,0,0,60
13,9,12,11,19,8,1,11,5,89
13,9,12,11,19,8,5,4,0,81
13,9,12,11,19,8,15,16,0,103
13,9,12,11,19,9,3,11,0,87
13,9,12,11,19,15,16,0,0,95
13,9,12,11,19,15,16,16,25,136
13,9,12,11,19,15,16,19,0,114
13,9,12,11,19,20,15,14,5,118
13,9,12,11,20,15,1,19,20,120
13,9,12,11,23,1,7,15,14,105
13,9,12,11,23,5,5,4,0,82
13,9,12,11,23,5,5,4,19,101
13,9,12,11,23,15,15,4,0,102
13,9,12,11,23,15,15,4,19,121
13,9,12,11,23,15,18,20,0,121
13,9,12,11,23,15,18,20,19,140
13,9,12,12,1,2,12,5,0,66
13,9,12,12,1,7,5,0,0,59
13,9,12,12,1,7,5,19,0,78
13,9,12,12,1,14,1,18,5,85
13,9,12,12,2,15,1,18,4,86
13,9,12,12,3,1,11,5,0,66
13,9,12,12,4,1,13,0,0,64
13,9,12,12,4,1,13,19,0,83
13,9,12,12,4,15,12,12,0,89
13,9,12,12,5,0,0,0,0,51
13,9,12,12,5,4,0,0,0,55
13,9,12,12,5,14,1,18,25,109
13,9,12,12,5,14,9,1,0,75
13,9,12,12,5,14,9,19,20,113
13,9,12,12,5,14,9,21,13,108
13,9,12,12,5,14,14,9,1,89
13,9,12,12,5,16,5,4,0,76
13,9,12,12,5,16,5,4,5,81
13,9,12,12,5,16,5,4,19,95
13,9,12,12,5,16,15,18,5,105
13,9,12,12,5,18,5,19,19,112
13,9,12,12,5,18,9,0,0,78
13,9,12,12,5,18,9,14,7,99
13,9,12,12,5,18,15,12,5,101
13,9,12,12,5,20,19,0,0,90
13,9,12,12,6,5,5,4,0,66
13,9,12,12,6,21,12,0,0,85
13,9,12,12,8,15,21,19,5,114
13,9,12,12,9,1,4,0,0,60
13,9,12,12,9,1,13,16,0,85
13,9,12,12,9,1,18,4,0,78
13,9,12,12,9,1,18,4,19,97
13,9,12,12,9,1,18,5,0,79
13,9,12,12,9,1,18,5,19,98
13,9,12,12,9,1,18,25,0,99
13,9,12,12,9,2,1,18,0,76
13,9,12,12,9,2,1,18,14,90
13,9,12,12,9,2,1,18,19,95
13,9,12,12,9,3,18,15,14,105
13,9,12,12,9,5,13,5,0,78
13,9,12,12,9,5,13,5,19,97
13,9,12,12,9,5,18,0,0,78
13,9,12,12,9,5,18,19,0,97
13,9,12,12,9,6,15,12,4,92
13,9,12,12,9,6,15,18,13,107
13,9,12,12,9,7,1,12,0,75
13,9,12,12,9,7,1,12,19,94
13,9,12,12,9,7,18,1,13,94
13,9,12,12,9,12,5,0,0,72
13,9,12,12,9,12,21,24,0,112
13,9,12,12,9,13,5,0,0,73
13,9,12,12,9,13,5,19,0,92
13,9,12,12,9,13,8,15,0,91
13,9,12,12,9,13,8,15,19,110
13,9,12,12,9,13,15,12,0,95
13,9,12,12,9,13,15,12,5,100
13,9,12,12,9,14,5,0,0,74
13,9,12,12,9,14,5,18,0,92
13,9,12,12,9,14,5,18,25,117
13,9,12,12,9,14,5,18,19,111
13,9,12,12,9,14,5,19,0,93
13,9,12,12,9,14,7,0,0,76
13,9,12,12,9,14,7,19,0,95
13,9,12,12,9,15,8,13,0,91
13,9,12,12,9,15,8,13,19,110
13,9,12,12,9,15,14,0,0,84
13,9,12,12,9,15,14,5,4,93
13,9,12,12,9,15,14,5,18,107
13,9,12,12,9,15,14,19,0,103
13,9,12,12,9,15,14,20,8,112
13,9,12,12,9,16,5,4,0,80
13,9,12,12,9,16,5,4,5,85
13,9,12,12,9,16,5,4,19,99
13,9,12,12,9,16,8,15,20,114
13,9,12,12,9,18,5,13,0,91
13,9,12,12,9,18,5,13,19,110
13,9,12,12,9,19,5,3,0,82
13,9,12,12,9,22,15,12,20,124
13,9,12,12,9,23,1,20,20,119
13,9,12,12,11,5,14,0,0,76
13,9,12,12,13,5,14,0,0,78
13,9,12,12,14,9,1,0,0,70
13,9,12,12,15,3,18,1,20,103
13,9,12,12,15,23,14,5,18,121
13,9,12,12,16,15,14,4,0,95
13,9,12,12,16,15,14,4,19,114
13,9,12,12,16,15,15,12,0,104
13,9,12,12,16,15,19,20,0,116
13,9,12,12,18,1,3,5,0,73
13,9,12,12,18,1,3,5,19,92
13,9,12,12,18,9,14,4,0,91
13,9,12,12,18,25,14,4,0,107
13,9,12,12,18,21,14,0,0,99
13,9,12,12,18,21,14,19,0,118
13,9,12,12,19,9,20,5,0,99
13,9,12,12,19,20,15,3,11,114
13,9,12,12,19,20,15,14,5,119
13,9,12,12,20,1,9,12,0,88
13,9,12,12,23,1,18,4,0,92
13,9,12,12,23,8,5,5,12,99
13,9,12,12,23,15,18,11,0,113
13,9,12,12,23,15,18,11,19,132
13,9,12,14,5,2,0,0,0,55
13,9,12,14,5,2,19,0,0,74
13,25,12,15,4,5,9,0,0,83
13,25,12,15,4,15,14,20,0,118
13,25,12,15,8,25,15,9,4,126
13,9,12,15,13,5,20,5,18,110
13,25,12,15,14,9,20,5,0,113
13,25,12,15,14,9,20,5,19,132
13,25,12,15,14,9,20,9,3,120
13,9,12,15,18,0,0,0,0,67
13,9,12,15,18,4,0,0,0,71
13,9,12,15,18,4,19,0,0,90
13,9,12,16,1,0,0,0,0,51
13,9,12,16,1,19,0,0,0,70
13,9,12,18,5,9,19,0,0,85
13,9,12,18,9,14,4,0,0,79
13,9,12,19,0,0,0,0,0,53
13,9,12,19,5,25,0,0,0,83
13,9,12,19,9,5,0,0,0,67
13,9,12,20,5,4,0,0,0,63
13,9,12,20,5,18,0,0,0,77
13,9,12,20,5,18,19,0,0,96
13,9,12,20,9,5,18,0,0,86
13,9,12,20,9,5,19,20,0,107
13,9,12,20,9,14,7,0,0,84
13,9,12,20,12,9,11,5,0,91
13,9,12,20,15,19,0,0,0,88
13,9,12,20,19,0,0,0,0,73
13,9,12,20,19,9,3,11,0,96
13,9,12,20,23,1,19,20,5,122
13,9,12,22,9,14,5,0,0,84
13,9,12,22,9,14,15,21,19,134
13,9,12,23,5,12,12,0,0,86
13,9,12,26,2,18,1,14,4,99
13,25,13,0,0,0,0,0,0,51
13,25,13,1,18,9,4,0,0,83
13,9,13,2,1,18,0,0,0,56
13,9,13,2,1,18,19,0,0,75
13,9,13,2,12,5,0,0,0,54
13,9,13,5,4,0,0,0,0,44
13,9,13,5,15,0,0,0,0,55
13,9,13,5,15,5,4,0,0,64
13,9,13,5,15,9,14,7,0,85
13,9,13,5,15,19,0,0,0,74
13,9,13,5,18,0,0,0,0,58
13,9,13,5,18,19,0,0,0,77
13,9,13,5,19,0,0,0,0,59
13,9,13,5,19,9,19,0,0,87
13,9,13,5,19,9,19,5,19,111
13,9,13,5,19,20,5,18,0,102
13,9,13,5,20,5,14,5,0,84
13,9,13,5,20,9,3,0,0,72
13,9,13,5,20,9,3,1,12,85
13,9,13,5,20,9,19,13,0,101
13,9,13,5,20,9,20,5,0,94
13,9,13,5,20,9,20,5,19,113
13,9,13,9,1,13,2,9,0,69
13,9,13,9,1,13,2,9,3,72
13,9,13,9,3,0,0,0,0,47
13,9,13,9,3,1,12,0,0,60
13,9,13,9,3,1,12,12,25,97
13,9,13,9,3,9,19,13,0,88
13,9,13,9,3,11,5,4,0,67
13,9,13,9,3,11,5,18,0,81
13,9,13,9,3,11,5,18,19,100
13,9,13,9,3,11,9,14,7,88
13,9,13,9,3,18,25,0,0,90
13,9,13,9,3,18,9,5,19,98
13,9,13,9,3,19,0,0,0,66
13,9,13,9,14,7,0,0,0,65
13,9,13,9,19,8,0,0,0,71
13,9,13,12,25,0,0,0,0,72
13,9,13,13,1,20,9,15,14,107
13,9,13,13,5,4,0,0,0,57
13,9,13,13,5,19,20,0,0,92
13,9,13,13,9,14,7,0,0,78
13,9,13,13,15,3,11,0,0,77
13,9,13,13,15,3,11,25,0,102
13,9,13,13,15,15,4,0,0,82
13,9,13,13,15,21,4,0,0,88
13,9,13,15,4,18,1,13,1,87
13,9,13,15,19,1,19,0,0,89
13,9,13,15,19,9,19,0,0,97
13,9,13,15,19,9,20,5,0,103
13,9,13,15,20,25,16,5,0,116
13,9,13,15,20,25,16,9,3,123
13,9,13,16,0,0,0,0,0,51
13,9,13,19,5,25,0,0,0,84
13,9,13,19,25,0,0,0,0,79
13,9,13,26,25,0,0,0,0,86
13,9,14,1,2,12,5,0,0,56
13,9,14,1,3,9,15,21,19,104
13,9,14,1,3,9,20,25,0,94
13,9,14,1,5,0,0,0,0,42
13,9,14,1,8,0,0,0,0,45
13,25,14,1,8,0,0,0,0,61
13,25,14,1,8,19,0,0,0,80
13,9,14,1,18,0,0,0,0,55
13,9,14,1,18,5,20,0,0,80
13,9,14,1,18,5,20,5,4,89
13,9,14,1,18,5,20,19,0,99
13,9,14,1,18,7,5,14,20,101
13,9,14,1,19,0,0,0,0,56
13,25,14,1,19,0,0,0,0,72
13,9,14,1,20,15,18,25,0,115
13,9,14,1,23,1,25,0,0,86
13,9,14,2,1,18,0,0,0,57
13,9,14,2,21,0,0,0,0,59
13,9,14,3,5,4,0,0,0,48
13,9,14,3,5,13,5,1,20,83
13,9,14,3,5,18,0,0,0,62
13,9,14,3,5,18,19,0,0,81
13,9,14,3,5,19,0,0,0,63
13,9,14,3,8,5,14,0,0,66
13,9,14,3,8,5,18,25,0,95
13,9,14,3,8,9,1,20,5,82
13,9,14,3,25,0,0,0,0,64
13,9,14,3,9,5,18,0,0,71
13,9,14,3,9,5,18,19,0,90
13,9,14,3,9,5,19,20,0,92
13,9,14,3,9,14,7,0,0,69
13,9,14,3,9,14,7,12,25,106
13,9,14,3,9,15,0,0,0,63
13,9,14,4,5,4,0,0,0,49
13,9,14,4,5,4,12,25,0,86
13,9,14,4,5,18,0,0,0,63
13,9,14,4,5,18,19,0,0,82
13,9,14,4,6,21,12,0,0,79
13,9,14,4,6,21,12,12,25,116
13,9,14,4,9,14,7,0,0,70
13,9,14,4,12,5,19,19,0,95
13,9,14,4,12,25,0,0,0,77
13,9,14,4,19,0,0,0,0,59
13,9,14,4,19,5,20,0,0,84
13,9,14,4,19,5,20,19,0,103
13,9,14,4,19,9,7,8,20,103
13,9,14,5,1,2,12,5,0,61
13,9,14,5,4,0,0,0,0,45
13,9,14,5,6,9,5,12,4,77
13,9,14,5,12,1,25,5,18,102
13,9,14,5,15,23,14,5,18,116
13,9,14,5,18,1,12,0,0,72
13,9,14,5,18,1,12,19,0,91
13,9,14,5,18,25,0,0,0,84
13,9,14,5,18,19,0,0,0,78
13,9,14,5,18,22,1,12,0,94
13,9,14,5,19,20,18,1,0,99
13,9,14,5,22,5,18,0,0,86
13,9,14,7,5,0,0,0,0,48
13,9,14,7,5,12,5,14,0,79
13,9,14,7,25,0,0,0,0,68
13,9,14,7,9,5,0,0,0,57
13,9,14,7,9,5,18,0,0,75
13,9,14,7,9,5,19,20,0,96
13,9,14,7,9,14,5,19,19,109
13,9,14,7,12,5,0,0,0,60
13,9,14,7,12,5,4,0,0,64
13,9,14,7,12,5,4,12,25,101
13,9,14,7,12,5,18,0,0,78
13,9,14,7,12,5,18,19,0,97
13,9,14,7,12,5,19,0,0,79
13,9,14,7,12,9,14,7,0,85
13,9,14,7,23,15,18,20,0,119
13,9,14,8,1,7,0,0,0,52
13,9,14,8,1,7,9,3,0,64
13,9,14,8,1,7,9,13,0,74
13,25,14,8,5,5,18,19,0,107
13,9,14,25,0,0,0,0,0,61
13,9,14,25,1,14,9,13,0,98
13,9,14,25,1,14,19,0,0,95
13,9,14,9,1,18,4,0,0,68
13,9,14,9,1,20,5,0,0,71
13,9,14,9,1,20,5,4,0,75
13,9,14,9,1,20,9,14,7,96
13,9,14,9,1,20,15,18,0,99
13,9,14,9,1,20,15,21,19,121
13,9,14,9,1,20,21,18,5,110
13,9,14,9,2,9,11,5,0,72
13,9,14,9,2,9,11,5,19,91
13,9,14,9,2,18,1,9,14,89
13,9,14,9,2,21,19,0,0,87
13,9,14,9,2,21,19,5,19,111
13,9,14,9,3,1,2,0,0,51
13,9,14,9,3,1,2,19,0,70
13,9,14,9,3,1,13,0,0,62
13,9,14,9,3,1,18,0,0,67
13,9,14,9,3,1,18,19,0,86
13,9,14,9,3,12,15,3,11,89
13,9,14,9,4,9,19,11,0,88
13,9,14,9,4,9,19,11,19,107
13,9,14,9,4,18,1,13,1,82
13,9,14,9,4,18,5,19,19,110
13,9,14,9,5,14,9,26,5,104
13,9,14,9,6,25,0,0,0,76
13,9,14,9,6,9,5,4,0,69
13,9,14,9,6,9,5,19,0,84
13,9,14,9,6,25,9,14,7,106
13,9,14,9,7,18,1,14,20,105
13,9,14,9,7,18,15,21,16,122
13,9,14,9,7,21,9,4,5,91
13,9,14,9,11,5,14,0,0,75
13,9,14,9,11,9,14,0,0,79
13,9,14,9,11,9,14,12,25,116
13,9,14,9,11,9,14,19,0,98
13,9,14,9,13,0,0,0,0,58
13,9,14,9,13,1,0,0,0,59
13,9,14,9,13,1,3,9,4,75
13,9,14,9,13,1,12,0,0,71
13,9,14,9,13,1,12,12,25,108
13,9,14,9,13,1,12,19,0,90
13,9,14,9,13,1,24,0,0,83
13,9,14,9,13,1,24,5,19,107
13,9,14,9,13,5,14,20,0,97
13,9,14,9,13,9,0,0,0,67
13,9,14,9,13,9,19,0,0,86
13,9,14,9,13,9,19,5,0,91
13,9,14,9,13,9,19,5,4,95
13,9,14,9,13,9,19,5,18,109
13,9,14,9,13,9,19,5,19,110
13,9,14,9,13,9,19,13,0,99
13,9,14,9,13,9,26,5,0,98
13,9,14,9,13,9,26,5,4,102
13,9,14,9,13,9,26,5,18,116
13,9,14,9,13,9,26,5,19,117
13,9,14,9,13,19,0,0,0,77
13,9,14,9,13,21,13,0,0,92
13,9,14,9,13,21,13,19,0,111
13,9,14,9,13,21,19,0,0,98
13,9,14,9,14,7,0,0,0,66
13,9,14,9,14,7,19,0,0,85
13,9,14,9,14,15,22,5,12,113
13,9,14,9,15,14,0,0,0,74
13,9,14,9,15,14,9,19,13,115
13,9,14,9,15,14,12,25,0,111
13,9,14,9,15,14,19,0,0,93
13,9,14,9,15,21,19,0,0,100
13,9,14,9,16,1,14,9,3,88
13,9,14,9,16,1,18,11,0,91
13,9,14,9,16,9,12,12,0,94
13,9,14,9,16,18,9,3,5,96
13,9,14,9,18,15,2,15,20,115
13,9,14,9,19,0,0,0,0,64
13,9,14,9,19,3,21,12,5,105
13,9,14,9,19,5,4,1,14,88
13,9,14,9,19,8,0,0,0,72
13,9,14,9,19,8,5,4,0,81
13,9,14,9,19,8,5,18,0,95
13,9,14,9,19,8,5,19,0,96
13,9,14,9,19,8,9,14,7,102
13,9,14,9,19,11,9,0,0,84
13,9,14,9,19,11,9,18,20,122
13,9,14,9,19,11,9,19,0,103
13,9,14,9,19,12,21,13,16,126
13,9,14,9,19,20,1,20,5,110
13,9,14,9,19,20,5,18,0,107
13,9,14,9,19,20,5,18,19,126
13,9,14,9,19,20,18,1,12,115
13,9,14,9,19,20,18,5,18,125
13,9,14,9,19,20,18,25,0,127
13,9,14,9,19,21,2,0,0,87
13,9,14,9,20,1,14,20,0,100
13,9,14,9,20,18,1,9,14,107
13,9,14,9,21,13,0,0,0,79
13,9,14,9,21,13,19,0,0,98
13,9,14,9,22,1,14,0,0,82
13,9,14,9,22,1,14,19,0,101
13,9,14,9,22,5,18,0,0,90
13,9,14,9,22,5,18,19,0,109
13,9,14,9,22,5,20,0,0,92
13,9,14,11,0,0,0,0,0,47
13,9,14,11,5,0,0,0,0,52
13,9,14,11,5,18,25,0,0,95
13,9,14,11,5,19,0,0,0,71
13,9,14,11,6,9,19,8,0,89
13,9,14,11,9,19,8,0,0,83
13,9,14,11,19,0,0,0,0,66
13,9,14,14,5,19,15,14,7,110
13,9,14,14,9,5,19,0,0,83
13,9,14,14,9,14,7,0,0,80
13,9,14,14,15,23,0,0,0,88
13,9,14,14,15,23,19,0,0,107
13,9,14,15,9,26,5,0,0,91
13,9,14,15,13,5,20,5,18,112
13,9,14,15,18,1,0,0,0,70
13,9,14,15,18,1,7,5,0,82
13,9,14,15,18,1,20,5,0,95
13,9,14,15,18,3,1,19,0,92
13,9,14,15,18,5,4,0,0,78
13,9,14,15,18,9,14,7,0,99
13,9,14,15,18,9,20,25,0,123
13,9,14,15,18,19,0,0,0,88
13,9,14,15,18,19,8,9,16,121
13,9,14,15,23,0,0,0,0,74
13,25,14,16,1,3,8,20,0,100
13,9,14,19,0,0,0,0,0,55
13,9,14,19,9,20,9,22,5,120
13,9,14,19,20,5,18,19,0,117
13,9,14,19,20,18,5,12,0,110
13,9,14,19,20,18,5,12,19,129
13,9,14,20,0,0,0,0,0,56
13,9,14,20,1,7,5,0,0,69
13,9,14,20,1,7,5,19,0,88
13,9,14,20,2,21,19,8,0,106
13,9,14,20,5,4,0,0,0,65
13,9,14,20,5,18,19,0,0,98
13,9,14,20,25,0,0,0,0,81
13,9,14,20,9,5,18,0,0,88
13,9,14,20,9,5,19,20,0,109
13,9,14,20,9,14,7,0,0,86
13,9,14,20,13,1,11,5,18,104
13,9,14,20,13,1,14,0,0,84
13,9,14,20,13,1,18,11,0,99
13,9,14,20,19,0,0,0,0,75
13,9,14,20,23,5,5,4,0,93
13,9,14,21,5,14,4,0,0,80
13,9,14,21,5,14,4,19,0,99
13,9,14,21,5,20,0,0,0,82
13,9,14,21,5,20,9,3,0,94
13,9,14,21,5,20,9,19,8,118
13,9,14,21,5,20,19,0,0,101
13,9,14,21,13,0,0,0,0,70
13,9,14,21,14,5,20,0,0,96
13,9,14,21,19,0,0,0,0,76
13,9,14,21,19,3,21,12,5,117
13,9,14,21,19,5,19,0,0,100
13,9,14,21,20,1,18,25,0,121
13,9,14,21,20,5,0,0,0,82
13,9,14,21,20,5,4,0,0,86
13,9,14,21,20,5,12,25,0,119
13,9,14,21,20,5,13,5,14,114
13,9,14,21,20,5,18,0,0,100
13,9,14,21,20,5,19,0,0,101
13,9,14,21,20,5,19,20,0,121
13,9,14,21,20,9,1,0,0,87
13,9,14,21,20,9,1,5,0,92
13,9,14,21,20,9,1,12,0,99
13,9,14,21,20,9,14,7,0,107
13,9,14,21,20,9,15,19,5,125
13,9,14,21,20,9,15,21,19,141
13,9,14,22,5,14,4,0,0,81
13,9,14,22,5,18,9,20,5,115
13,9,14,24,5,19,0,0,0,84
13,9,14,24,9,19,8,0,0,96
13,9,14,24,9,19,8,12,25,133
13,9,14,24,19,8,9,16,0,112
13,25,15,2,12,1,19,20,0,107
13,25,15,2,12,1,19,20,19,126
13,9,15,3,1,18,4,9,1,73
13,25,15,3,1,18,4,9,1,89
13,25,15,3,4,9,1,0,0,70
13,25,15,3,5,12,5,0,0,78
13,25,15,3,25,20,5,0,0,106
13,25,15,3,12,15,14,9,3,109
13,25,15,3,12,15,14,21,19,137
13,25,15,3,15,5,12,0,0,88
13,25,15,3,15,5,12,5,0,93
13,25,15,3,15,5,12,15,13,116
13,25,15,3,15,13,13,1,0,98
13,25,15,5,4,5,13,1,0,81
13,25,15,6,9,2,18,9,12,109
13,25,15,7,5,14,0,0,0,79
13,25,15,7,5,14,9,3,0,91
13,25,15,7,5,14,15,21,19,134
13,25,15,7,12,15,2,9,14,112
13,25,15,7,18,1,13,0,0,92
13,25,15,7,18,1,16,8,0,103
13,25,15,7,18,1,16,8,25,128
13,25,15,7,18,1,16,8,19,122
13,25,15,9,4,0,0,0,0,66
13,25,15,9,4,5,13,1,0,85
13,25,15,11,25,13,9,1,0,112
13,25,15,12,5,13,13,1,0,97
13,25,15,12,9,16,15,13,1,119
13,25,15,12,25,19,9,19,0,137
13,9,15,12,9,20,8,9,3,98
13,25,15,12,15,7,25,0,0,112
13,25,15,12,15,7,9,3,0,99
13,25,15,12,15,7,9,5,19,120
13,25,15,12,15,7,9,19,20,135
13,25,15,13,1,0,0,0,0,67
13,25,15,13,1,14,3,25,0,109
13,25,15,13,1,14,20,9,3,113
13,25,15,13,1,19,0,0,0,86
13,25,15,13,1,20,1,0,0,88
13,25,15,13,1,20,15,21,19,142
13,9,15,13,2,15,0,0,0,67
13,25,15,13,5,18,5,0,0,94
13,25,15,13,15,18,16,8,0,123
13,25,15,13,15,20,15,13,25,154
13,25,15,14,5,13,1,0,0,86
13,25,15,14,5,13,5,0,0,90
13,25,15,14,5,21,18,1,12,124
13,25,15,14,5,21,18,5,0,116
13,25,15,14,15,19,21,19,0,141
13,25,15,16,1,20,8,25,0,123
13,25,15,16,1,20,8,9,1,108
13,25,15,16,1,20,8,9,3,110
13,25,15,16,5,0,0,0,0,74
13,25,15,16,5,19,0,0,0,93
13,25,15,16,8,1,14,0,0,92
13,25,15,16,8,15,18,5,0,115
13,25,15,16,25,0,0,0,0,94
13,25,15,16,9,1,0,0,0,79
13,25,15,16,9,1,19,0,0,98
13,25,15,16,9,3,0,0,0,81
13,25,15,16,9,3,1,12,0,94
13,25,15,16,9,5,19,0,0,102
13,25,15,16,12,1,19,13,0,114
13,25,15,16,12,1,19,20,25,146
13,25,15,16,15,12,1,18,0,115
13,25,15,16,15,18,1,4,0,107
13,25,15,16,19,0,0,0,0,88
13,25,15,19,3,15,16,5,0,111
13,25,15,19,3,15,16,5,19,130
13,25,15,19,5,16,20,21,13,147
13,9,15,19,5,19,0,0,0,80
13,25,15,19,5,19,0,0,0,96
13,25,15,19,9,14,0,0,0,95
13,25,15,19,9,14,15,19,5,134
13,25,15,19,9,14,19,0,0,114
13,9,15,19,9,19,0,0,0,84
13,25,15,19,9,19,0,0,0,100
13,25,15,19,9,20,9,3,0,113
13,25,15,19,9,20,9,19,0,129
13,25,15,19,15,20,5,0,0,112
13,25,15,19,15,20,5,19,0,131
13,25,15,19,16,1,19,13,0,121
13,25,15,19,21,20,21,18,5,157
13,25,15,20,1,19,9,19,0,121
13,9,15,20,9,3,0,0,0,69
13,25,15,20,9,3,0,0,0,85
13,9,15,20,9,3,19,0,0,88
13,25,15,20,9,3,19,0,0,104
13,25,15,20,15,13,5,0,0,106
13,25,15,20,15,13,5,19,0,125
13,25,15,20,15,13,25,0,0,126
13,25,15,20,15,13,9,3,0,113
13,25,15,20,15,13,9,5,19,134
13,25,15,20,15,14,25,0,0,127
13,25,15,20,15,14,9,1,0,112
13,25,15,20,15,14,9,1,19,131
13,25,15,20,15,14,9,3,0,114
13,25,15,20,15,14,21,19,0,142
13,25,15,20,18,15,16,8,25,155
13,25,15,23,21,14,0,0,0,111
13,25,15,24,9,14,5,0,0,105
13,9,17,18,1,0,0,0,0,58
13,9,17,21,5,12,5,20,0,102
13,9,17,21,5,12,5,20,19,121
13,9,18,1,2,9,12,5,0,69
13,9,18,1,2,9,12,9,1,74
13,9,18,1,2,12,5,0,0,60
13,25,18,1,2,15,12,1,13,100
13,9,18,1,3,9,4,9,1,67
13,9,18,1,3,12,5,0,0,61
13,9,18,1,3,12,5,4,0,65
13,9,18,1,3,12,5,19,0,80
13,9,18,1,3,12,9,14,7,86
13,9,18,1,3,12,9,19,20,104
13,9,18,1,3,21,12,1,18,96
13,9,18,1,4,15,18,0,0,78
13,9,18,1,4,15,18,19,0,97
13,9,18,1,7,5,0,0,0,53
13,9,18,1,7,5,19,0,0,72
13,9,18,1,7,25,0,0,0,73
13,9,18,1,14,4,15,21,19,114
13,9,18,1,20,5,0,0,0,66
13,9,18,2,1,14,5,0,0,62
13,25,18,3,5,14,5,0,0,83
13,9,18,4,0,0,0,0,0,44
13,9,18,4,1,8,1,0,0,54
13,9,18,4,8,1,0,0,0,53
13,9,18,5,0,0,0,0,0,45
13,9,18,5,4,0,0,0,0,49
13,9,18,5,16,15,9,19,0,104
13,9,18,5,16,15,9,24,0,109
13,9,18,5,19,0,0,0,0,64
13,9,18,5,19,14,9,16,5,108
13,9,18,5,24,0,0,0,0,69
13,9,18,5,24,5,19,0,0,93
13,9,18,9,0,0,0,0,0,49
13,9,18,25,0,0,0,0,0,65
13,9,18,25,1,3,8,9,20,106
13,25,18,9,1,4,0,0,0,70
13,25,18,9,1,4,5,4,0,79
13,25,18,9,1,4,12,25,0,107
13,25,18,9,1,4,19,0,0,89
13,25,18,9,1,4,20,8,0,98
13,25,18,9,1,7,18,1,13,105
13,9,18,9,1,13,14,5,0,82
13,25,18,9,1,16,15,4,0,101
13,25,18,9,1,16,15,4,19,120
13,25,18,9,1,18,3,8,0,95
13,25,18,9,1,18,3,8,25,120
13,25,18,9,1,18,5,0,0,89
13,25,18,9,3,1,19,0,0,88
13,25,18,9,3,5,20,9,14,116
13,25,18,9,3,25,12,0,0,105
13,25,18,9,3,25,12,9,3,117
13,25,18,9,3,9,14,0,0,91
13,25,18,9,3,11,0,0,0,79
13,9,18,9,4,0,0,0,0,53
13,9,18,9,5,18,0,0,0,72
13,9,18,9,5,19,20,0,0,93
13,9,18,9,6,9,3,0,0,67
13,9,18,9,6,9,3,1,12,80
13,9,18,9,11,9,0,0,0,69
13,9,18,9,14,5,19,19,0,106
13,9,18,9,14,7,0,0,0,70
13,25,18,9,14,7,1,0,0,87
13,25,18,9,15,16,15,4,0,115
13,25,18,9,15,16,15,4,19,134
13,25,18,9,15,18,1,13,1,113
13,9,18,9,19,8,0,0,0,76
13,25,18,9,19,20,1,20,5,130
13,25,18,9,19,20,9,3,0,116
13,25,18,9,19,20,9,14,0,127
13,25,18,9,19,20,15,14,5,138
13,9,18,11,0,0,0,0,0,51
13,9,18,11,5,18,0,0,0,74
13,9,18,11,5,19,20,0,0,95
13,9,18,11,25,0,0,0,0,76
13,9,18,11,9,5,18,0,0,83
13,9,18,11,9,5,19,20,0,104
13,9,18,11,9,12,25,0,0,97
13,9,18,11,9,14,5,19,19,117
13,9,18,11,9,19,8,0,0,87
13,9,18,11,12,25,0,0,0,88
13,9,18,11,14,5,19,19,0,108
13,9,18,11,19,0,0,0,0,70
13,9,18,11,19,15,13,5,0,103
13,9,18,12,5,4,0,0,0,61
13,9,18,12,25,0,0,0,0,77
13,9,18,12,9,7,15,0,0,83
13,9,18,12,9,20,15,14,0,110
13,9,18,12,9,20,15,14,19,129
13,25,18,13,5,3,15,9,4,105
13,25,18,13,5,11,9,20,5,119
13,25,18,13,9,3,9,4,0,94
13,25,18,13,9,3,9,14,5,109
13,25,18,13,9,3,15,9,4,109
13,25,18,15,2,1,12,1,14,101
13,25,18,15,14,1,20,5,0,111
13,25,18,15,14,9,3,0,0,97
13,25,18,15,19,9,14,0,0,113
13,25,18,18,8,0,0,0,0,82
13,25,18,18,8,5,4,0,0,91
13,25,18,18,8,25,0,0,0,107
13,25,18,18,8,9,3,0,0,94
13,25,18,18,8,9,14,5,0,110
13,25,18,18,8,15,12,0,0,109
13,25,18,18,8,19,0,0,0,101
13,9,18,18,15,18,0,0,0,91
13,9,18,18,15,18,5,4,0,100
13,9,18,18,15,18,25,0,0,116
13,9,18,18,15,18,9,14,7,121
13,9,18,18,15,18,9,26,5,131
13,9,18,18,15,18,19,0,0,110
13,25,18,19,9,14,1,4,0,103
13,25,18,20,1,12,0,0,0,89
13,9,18,20,8,6,21,12,0,107
13,9,18,20,8,12,5,19,19,123
13,9,18,20,8,19,0,0,0,87
13,9,18,20,8,19,15,13,5,120
13,25,18,20,9,6,15,18,13,137
13,25,18,20,12,5,19,0,0,112
13,25,18,20,15,12,0,0,0,103
13,9,18,22,19,0,0,0,0,81
13,9,18,26,1,0,0,0,0,67
13,9,18,26,1,19,0,0,0,86
13,9,19,1,3,3,5,14,20,87
13,9,19,1,3,3,5,16,20,89
13,9,19,1,3,20,0,0,0,65
13,9,19,1,3,20,5,4,0,74
13,9,19,1,3,20,9,14,7,95
13,9,19,1,3,20,19,0,0,84
13,9,19,1,4,1,16,20,0,83
13,9,19,1,4,1,16,20,19,102
13,9,19,1,4,4,0,0,0,50
13,9,19,1,4,4,5,4,0,59
13,9,19,1,4,4,9,14,7,80
13,9,19,1,4,4,19,0,0,69
13,9,19,1,4,10,21,19,20,116
13,9,19,1,4,18,5,19,20,108
13,9,19,1,4,22,9,3,5,85
13,9,19,1,4,22,9,19,5,101
13,9,19,1,6,6,5,3,20,82
13,9,19,1,6,6,9,18,13,94
13,9,19,1,7,5,14,20,0,88
13,9,19,1,7,5,14,20,19,107
13,9,19,1,9,13,0,0,0,64
13,9,19,1,9,13,5,4,0,73
13,9,19,1,9,13,9,14,7,94
13,9,19,1,9,13,19,0,0,83
13,9,19,1,12,9,7,14,0,84
13,9,19,1,12,12,5,7,5,83
13,9,19,1,12,12,25,0,0,91
13,9,19,1,12,12,9,5,4,84
13,9,19,1,12,12,9,5,19,99
13,9,19,1,12,12,15,20,0,101
13,9,19,1,12,20,5,18,0,97
13,9,19,1,12,20,5,18,19,116
13,9,19,1,14,4,18,25,0,103
13,9,19,1,14,19,23,5,18,121
13,9,19,1,16,16,5,1,18,98
13,9,19,1,16,16,12,25,0,111
13,9,19,1,18,18,1,25,0,104
13,9,19,1,19,19,1,25,0,106
13,9,19,1,19,19,1,25,19,125
13,9,19,1,19,19,5,14,20,119
13,9,19,1,19,19,5,18,20,123
13,9,19,1,19,19,9,7,14,110
13,9,19,1,20,5,0,0,0,67
13,9,19,1,20,15,14,5,0,96
13,9,19,1,20,15,14,5,4,100
13,9,19,1,20,15,14,5,19,115
13,9,19,1,20,20,5,14,4,105
13,9,19,1,21,14,20,5,18,120
13,9,19,1,22,5,18,0,0,87
13,9,19,1,22,5,18,19,0,106
13,9,19,1,23,1,18,4,0,88
13,9,19,1,23,1,18,4,19,107
13,9,19,2,5,1,18,0,0,67
13,9,19,2,5,3,1,13,5,70
13,9,19,2,5,3,15,13,5,84
13,9,19,2,5,4,5,0,0,57
13,9,19,2,5,6,1,12,12,79
13,9,19,2,5,7,1,14,0,70
13,9,19,2,5,7,5,20,0,80
13,9,19,2,5,7,9,14,0,78
13,9,19,2,5,7,9,14,19,97
13,9,19,2,5,7,15,20,0,90
13,9,19,2,5,7,21,14,0,90
13,9,19,2,5,8,1,22,5,84
13,9,19,2,5,12,9,5,6,80
13,9,19,2,5,12,15,22,5,102
13,9,19,2,5,19,5,5,13,90
13,9,19,2,5,19,20,15,23,125
13,9,19,2,5,20,9,4,5,86
13,9,19,2,9,1,19,0,0,72
13,9,19,2,9,1,19,5,4,81
13,9,19,2,9,1,19,5,19,96
13,9,19,2,9,12,12,0,0,76
13,9,19,2,9,12,12,5,4,85
13,9,19,2,9,12,12,19,0,95
13,9,19,2,9,14,4,0,0,70
13,9,19,2,9,14,4,19,0,89
13,9,19,2,9,18,20,8,0,98
13,9,19,2,15,4,5,0,0,67
13,9,19,2,15,4,5,14,0,81
13,9,19,2,15,18,14,0,0,90
13,9,19,2,15,21,14,4,0,97
13,9,19,2,18,1,14,4,0,80
13,9,19,2,18,1,14,4,19,99
13,9,19,2,18,5,23,0,0,89
13,9,19,2,21,9,12,4,0,89
13,9,19,2,21,9,12,4,19,108
13,9,19,2,21,9,12,20,0,105
13,9,19,2,21,19,25,0,0,108
13,9,19,3,0,0,0,0,0,44
13,9,19,3,1,12,0,0,0,57
13,9,19,3,1,12,12,0,0,69
13,9,19,3,1,12,12,5,4,78
13,9,19,3,1,12,12,5,18,92
13,9,19,3,1,12,12,19,0,88
13,9,19,3,1,18,18,25,0,106
13,9,19,3,1,19,20,0,0,84
13,9,19,3,1,19,20,5,4,93
13,9,19,3,1,19,20,19,0,103
13,9,19,3,5,0,0,0,0,49
13,9,19,3,5,7,9,14,5,84
13,9,19,3,8,1,14,3,5,75
13,9,19,3,8,1,14,3,25,95
13,9,19,3,8,1,18,7,5,83
13,9,19,3,8,9,5,6,0,72
13,9,19,3,8,9,5,6,19,91
13,9,19,3,8,9,5,22,5,93
13,9,19,3,8,9,15,0,0,76
13,9,19,3,8,15,9,3,5,84
13,9,19,3,8,15,15,19,5,106
13,9,19,3,8,15,19,5,0,91
13,9,19,3,8,15,19,5,14,105
13,9,19,3,9,2,12,5,0,72
13,9,19,3,9,16,8,5,18,100
13,9,19,3,9,20,5,0,0,78
13,9,19,3,9,20,5,4,0,82
13,9,19,3,9,20,5,19,0,97
13,9,19,3,9,20,9,14,7,103
13,9,19,3,12,1,9,13,0,79
13,9,19,3,12,1,9,13,19,98
13,9,19,3,12,1,19,19,0,95
13,9,19,3,15,4,5,0,0,68
13,9,19,3,15,4,5,4,0,72
13,9,19,3,15,4,5,19,0,87
13,9,19,3,15,9,14,0,0,82
13,9,19,3,15,9,14,5,4,91
13,9,19,3,15,9,14,19,0,101
13,9,19,3,15,12,15,18,0,104
13,9,19,3,15,12,15,18,19,123
13,9,19,3,15,12,15,21,18,125
13,9,19,3,15,13,13,9,20,114
13,9,19,3,15,14,6,5,18,102
13,9,19,3,15,14,22,5,25,125
13,9,19,3,15,15,11,0,0,85
13,9,19,3,15,15,11,5,4,94
13,9,19,3,15,15,11,19,0,104
13,9,19,3,15,16,25,0,0,100
13,9,19,3,15,16,9,5,4,93
13,9,19,3,15,16,9,5,19,108
13,9,19,3,15,21,14,20,0,114
13,9,19,3,15,21,14,20,19,133
13,9,19,3,15,22,5,20,0,106
13,9,19,3,18,5,1,14,20,102
13,9,19,3,18,5,1,20,5,93
13,9,19,3,18,5,4,9,20,100
13,9,19,3,18,5,5,4,0,76
13,9,19,3,18,9,16,20,0,107
13,9,19,3,18,15,16,0,0,93
13,9,19,3,21,5,0,0,0,70
13,9,19,3,21,5,4,0,0,74
13,9,19,3,21,5,19,0,0,89
13,9,19,3,21,9,14,7,0,95
13,9,19,3,21,20,0,0,0,85
13,9,19,3,21,20,19,0,0,104
13,9,19,4,1,20,5,0,0,71
13,9,19,4,1,20,5,4,0,75
13,9,19,4,1,20,5,19,0,90
13,9,19,4,1,20,9,14,7,96
13,9,19,4,1,21,2,0,0,69
13,9,19,4,5,1,12,0,0,63
13,9,19,4,5,1,12,5,18,86
13,9,19,4,5,1,12,19,0,82
13,9,19,4,5,1,12,20,0,83
13,9,19,4,5,3,9,4,5,71
13,9,19,4,5,5,4,0,0,59
13,9,19,4,5,5,4,19,0,78
13,9,19,4,5,5,13,0,0,68
13,9,19,4,5,5,13,5,4,77
13,9,19,4,5,5,13,19,0,87
13,9,19,4,5,6,9,14,5,84
13,9,19,4,5,13,5,1,14,83
13,9,19,4,5,16,1,18,20,105
13,9,19,4,5,18,9,22,5,104
13,9,19,4,5,19,5,18,20,112
13,9,19,4,5,19,9,18,5,101
13,9,19,4,5,22,9,19,5,105
13,9,19,4,9,1,12,0,0,67
13,9,19,4,9,1,12,19,0,86
13,9,19,4,9,4,0,0,0,58
13,9,19,4,9,5,20,0,0,79
13,9,19,4,9,7,8,20,0,89
13,9,19,4,9,18,5,3,20,100
13,9,19,4,9,22,5,4,0,85
13,9,19,4,9,22,9,4,5,94
13,9,19,4,15,0,0,0,0,60
13,9,19,4,15,5,18,0,0,83
13,9,19,4,15,5,18,19,0,102
13,9,19,4,15,5,19,0,0,84
13,9,19,4,15,9,14,7,0,90
13,9,19,4,15,9,14,7,19,109
13,9,19,4,15,14,5,0,0,79
13,9,19,4,15,21,2,20,0,103
13,9,19,4,15,21,2,20,19,122
13,9,19,4,15,23,5,18,0,106
13,9,19,4,18,1,23,0,0,87
13,9,19,4,18,1,23,14,0,101
13,9,19,4,18,1,23,19,0,106
13,9,19,4,18,5,1,4,0,73
13,9,19,4,18,5,23,0,0,91
13,9,19,4,18,9,22,5,0,99
13,9,19,4,18,9,22,5,14,113
13,9,19,4,18,9,22,5,19,118
13,9,19,4,18,15,22,5,0,105
13,9,19,5,0,0,0,0,0,46
13,9,19,5,1,19,5,0,0,71
13,9,19,5,1,19,5,4,0,75
13,9,19,5,1,19,5,19,0,90
13,9,19,5,1,20,0,0,0,67
13,9,19,5,1,20,9,14,7,97
13,9,19,5,1,20,19,0,0,86
13,9,19,5,4,9,20,0,0,79
13,9,19,5,4,9,20,5,4,88
13,9,19,5,4,9,20,19,0,98
13,9,19,5,6,6,5,3,20,86
13,25,19,5,12,0,0,0,0,74
13,25,19,5,12,6,0,0,0,80
13,25,19,5,12,12,0,0,0,86
13,9,19,5,13,16,12,15,25,127
13,9,19,5,14,9,20,5,0,94
13,9,19,5,14,10,15,25,0,110
13,9,19,5,14,18,15,12,0,105
13,9,19,5,14,18,15,12,12,117
13,9,19,5,14,18,15,12,19,124
13,9,19,5,14,20,5,18,0,103
13,9,19,5,14,20,5,18,19,122
13,9,19,5,14,20,18,25,0,123
13,9,19,5,18,0,0,0,0,64
13,9,19,5,18,1,2,12,5,84
13,9,19,5,18,1,2,12,25,104
13,9,19,5,18,4,15,13,0,96
13,9,19,5,18,5,0,0,0,69
13,9,19,5,18,5,18,5,19,111
13,9,19,5,18,8,15,15,4,106
13,9,19,5,18,25,0,0,0,89
13,9,19,5,18,9,5,19,0,97
13,9,19,5,18,9,19,13,0,105
13,9,19,5,18,12,25,0,0,101
13,9,19,5,18,19,0,0,0,83
13,9,19,5,19,0,0,0,0,65
13,9,19,5,19,20,5,5,13,108
13,9,19,5,22,5,14,20,0,107
13,9,19,5,22,5,14,20,19,126
13,9,19,5,24,16,5,14,4,109
13,9,19,6,1,9,20,8,0,85
13,9,19,6,1,9,20,8,19,104
13,9,19,6,1,12,12,0,0,72
13,9,19,6,1,18,5,0,0,71
13,9,19,6,1,20,5,0,0,73
13,9,19,6,1,20,8,5,18,99
13,9,19,6,1,21,12,20,0,101
13,9,19,6,5,1,19,15,18,105
13,9,19,6,5,9,7,14,0,82
13,9,19,6,9,5,12,4,0,77
13,9,19,6,9,5,12,4,19,96
13,9,19,6,9,7,21,18,5,107
13,9,19,6,9,12,5,0,0,73
13,9,19,6,9,12,5,4,0,77
13,9,19,6,9,12,5,19,0,92
13,9,19,6,9,12,9,14,7,98
13,9,19,6,9,18,5,0,0,79
13,9,19,6,9,18,5,4,0,83
13,9,19,6,9,18,5,19,0,98
13,9,19,6,9,18,9,14,7,104
13,9,19,6,9,20,0,0,0,76
13,9,19,6,9,20,19,0,0,95
13,9,19,6,9,20,20,5,4,105
13,9,19,6,15,3,21,19,0,105
13,9,19,6,15,14,4,0,0,80
13,9,19,6,15,18,13,0,0,93
13,9,19,6,15,18,13,5,4,102
13,9,19,6,15,18,13,19,0,112
13,9,19,6,18,1,13,5,0,84
13,9,19,6,18,1,13,5,4,88
13,9,19,6,18,1,13,5,19,103
13,9,19,7,1,21,7,5,0,82
13,9,19,7,1,21,7,5,4,86
13,9,19,7,1,21,7,5,19,101
13,9,19,7,1,22,5,0,0,76
13,9,19,7,25,5,0,0,0,78
13,9,19,7,9,22,5,0,0,84
13,9,19,7,9,22,5,14,0,98
13,9,19,7,9,22,5,19,0,103
13,9,19,7,9,22,9,14,7,109
13,9,19,7,15,0,0,0,0,63
13,9,19,7,15,20,20,5,14,122
13,9,19,7,15,22,5,18,14,122
13,9,19,7,18,1,4,5,0,76
13,9,19,7,18,1,4,5,4,80
13,9,19,7,18,1,6,6,0,79
13,9,19,7,18,1,6,20,0,93
13,9,19,7,18,1,6,20,19,112
13,9,19,7,18,1,22,5,0,94
13,9,19,7,18,5,23,0,0,94
13,9,19,7,18,15,21,14,4,120
13,9,19,7,18,15,23,0,0,104
13,9,19,7,18,15,23,14,0,118
13,9,19,7,18,15,23,19,0,123
13,9,19,7,18,15,23,20,8,132
13,9,19,7,21,1,7,5,0,82
13,9,19,7,21,1,7,5,4,86
13,9,19,7,21,5,19,19,0,112
13,9,19,7,21,7,7,12,5,100
13,9,19,7,21,9,4,5,0,87
13,9,19,7,21,9,4,5,4,91
13,9,19,7,21,9,4,5,18,105
13,9,19,7,21,9,4,5,19,106
13,9,19,7,21,9,19,5,0,102
13,9,19,8,1,14,4,12,5,85
13,9,19,8,1,14,20,5,18,107
13,9,19,8,1,16,0,0,0,66
13,9,19,8,1,16,16,5,14,101
13,9,19,8,1,16,19,0,0,85
13,9,19,8,1,18,1,0,0,69
13,9,19,8,1,22,5,0,0,77
13,9,19,8,5,1,18,0,0,73
13,9,19,8,5,1,18,4,0,77
13,9,19,8,5,1,18,19,0,92
13,9,19,8,9,16,19,0,0,93
13,9,19,8,9,20,0,0,0,78
13,9,19,8,9,20,19,0,0,97
13,9,19,8,13,1,19,8,0,90
13,9,19,8,13,5,5,0,0,72
13,9,19,8,13,15,19,8,0,104
13,9,19,25,0,0,0,0,0,66
13,25,19,9,4,0,0,0,0,70
13,25,19,9,4,5,1,14,0,90
13,25,19,9,4,19,0,0,0,89
13,9,19,9,13,16,21,20,5,125
13,9,19,9,14,3,9,20,5,101
13,9,19,9,14,6,5,18,0,93
13,9,19,9,14,6,5,18,19,112
13,9,19,9,14,6,15,18,13,116
13,9,19,9,14,20,5,14,4,107
13,9,19,9,14,20,5,18,0,107
13,9,19,9,14,20,5,18,19,126
13,9,19,25,15,11,5,0,0,97
13,9,19,25,15,11,5,4,0,101
13,9,19,25,15,11,5,19,0,116
13,9,19,25,15,11,9,14,7,122
13,9,19,9,15,14,5,19,0,103
13,9,19,10,15,9,14,0,0,89
13,9,19,10,15,9,14,5,4,98
13,9,19,10,15,9,14,19,0,108
13,9,19,10,21,4,7,5,0,88
13,9,19,10,21,4,7,5,4,92
13,9,19,10,21,4,7,5,18,106
13,9,19,10,21,4,7,5,19,107
13,9,19,11,1,12,0,0,0,65
13,9,19,11,1,12,19,0,0,84
13,9,19,11,5,5,16,0,0,78
13,9,19,11,5,5,16,19,0,97
13,9,19,11,5,14,0,0,0,71
13,9,19,11,5,16,20,0,0,93
13,9,19,11,25,0,0,0,0,77
13,9,19,11,9,3,11,0,0,75
13,9,19,11,9,3,11,19,0,94
13,9,19,11,9,12,12,0,0,85
13,9,19,11,9,14,0,0,0,75
13,9,19,11,9,14,4,12,5,96
13,9,19,11,14,5,23,0,0,94
13,9,19,11,14,15,23,0,0,104
13,9,19,11,14,15,23,14,0,118
13,9,19,11,14,15,23,19,0,123
13,9,19,12,1,2,5,12,0,73
13,9,19,12,1,2,5,12,19,92
13,9,19,12,1,2,15,18,0,89
13,9,19,12,1,2,15,18,19,108
13,9,19,12,1,25,0,0,0,79
13,9,19,12,1,9,4,0,0,67
13,9,19,12,1,25,5,18,0,102
13,9,19,12,1,25,5,18,19,121
13,9,19,12,1,25,9,14,7,109
13,9,19,12,1,9,14,0,0,77
13,9,19,12,1,25,19,0,0,98
13,9,19,12,5,1,4,0,0,63
13,9,19,12,5,1,4,5,18,86
13,9,19,12,5,1,4,19,0,82
13,9,19,12,5,1,18,0,0,77
13,9,19,12,5,1,18,5,4,86
13,9,19,12,5,1,18,14,0,91
13,9,19,12,5,1,18,14,19,110
13,9,19,12,5,1,18,14,20,111
13,9,19,12,5,4,0,0,0,62
13,9,19,12,5,5,18,5,4,90
13,9,19,12,5,14,0,0,0,72
13,9,19,12,5,19,20,0,0,97
13,9,19,12,25,0,0,0,0,78
13,9,19,12,9,5,0,0,0,67
13,9,19,12,9,5,19,0,0,86
13,9,19,12,9,7,8,20,0,97
13,9,19,12,9,7,8,20,19,116
13,9,19,12,25,9,14,7,0,108
13,9,19,12,9,11,5,0,0,78
13,9,19,12,9,11,5,4,0,82
13,9,19,12,9,11,5,14,0,92
13,9,19,12,9,11,5,18,0,96
13,9,19,12,9,11,5,18,19,115
13,9,19,12,9,11,5,19,0,97
13,9,19,12,9,11,9,14,7,103
13,9,19,12,9,14,0,0,0,76
13,9,19,12,9,16,16,5,14,113
13,9,19,12,9,20,0,0,0,82
13,9,19,12,9,22,5,0,0,89
13,9,19,12,9,22,5,4,0,93
13,9,19,12,9,22,5,19,0,108
13,9,19,12,9,22,9,14,7,114
13,9,19,12,12,5,4,0,0,74
13,9,19,12,15,3,1,20,5,97
13,9,19,12,15,4,7,5,0,84
13,9,19,12,15,4,7,5,4,88
13,9,19,12,15,4,7,5,19,103
13,9,19,12,21,3,11,0,0,88
13,9,19,13,1,4,5,0,0,64
13,9,19,13,1,11,5,0,0,71
13,9,19,13,1,11,5,19,0,90
13,9,19,13,1,11,9,14,7,96
13,9,19,13,1,14,1,7,5,82
13,9,19,13,1,18,11,0,0,84
13,9,19,13,1,18,11,5,4,93
13,9,19,13,1,18,11,19,0,103
13,9,19,13,1,18,18,25,0,116
13,9,19,13,1,20,3,8,0,86
13,9,19,13,1,20,5,0,0,80
13,9,19,13,1,20,5,4,0,84
13,9,19,13,1,20,5,19,0,99
13,9,19,13,1,20,9,14,7,105
13,9,19,13,1,26,5,0,0,86
13,9,19,13,5,1,14,0,0,74
13,9,19,13,5,5,20,0,0,84
13,9,19,13,5,5,20,19,0,103
13,9,19,13,5,20,0,0,0,79
13,9,19,13,5,20,18,5,0,102
13,9,19,13,9,14,4,5,4,90
13,9,19,13,9,14,7,12,5,101
13,9,19,13,15,19,8,0,0,96
13,9,19,13,15,19,8,5,19,120
13,9,19,13,15,20,9,15,14,127
13,9,19,13,15,21,14,20,0,124
13,9,19,13,15,22,5,0,0,96
13,9,19,13,15,22,5,4,0,100
13,9,19,13,15,22,5,19,0,115
13,9,19,13,15,22,9,14,7,121
13,9,19,14,1,13,5,0,0,74
13,9,19,14,1,13,5,4,0,78
13,9,19,14,1,13,5,19,0,93
13,9,19,14,1,13,9,14,7,99
13,9,19,14,15,13,5,4,0,92
13,9,19,14,15,13,5,18,0,106
13,9,19,14,15,13,5,18,19,125
13,9,19,14,21,13,2,5,18,114
13,9,19,15,0,0,0,0,0,56
13,9,19,15,2,5,25,0,0,88
13,9,19,15,3,3,21,16,25,124
13,9,19,15,7,1,13,25,0,102
13,9,19,15,7,1,13,9,3,89
13,9,19,15,7,25,14,5,0,107
13,9,19,15,7,25,14,25,0,127
13,9,19,15,7,25,14,9,3,114
13,25,19,15,9,4,0,0,0,85
13,9,19,15,12,15,7,25,0,115
13,9,19,15,13,1,20,8,0,98
13,9,19,15,14,5,9,19,13,116
13,9,19,15,14,5,9,19,20,123
13,9,19,15,16,5,4,9,1,91
13,9,19,15,18,4,5,18,0,101
13,9,19,15,18,9,5,14,20,122
13,9,19,15,19,0,0,0,0,75
13,9,19,15,19,15,16,8,25,139
13,25,19,15,19,20,0,0,0,111
13,25,19,15,19,20,19,0,0,130
13,9,19,15,24,5,14,5,0,104
13,9,19,15,24,5,14,25,0,124
13,9,19,16,1,3,11,5,4,81
13,9,19,16,1,7,5,0,0,70
13,9,19,16,1,7,5,4,0,74
13,9,19,16,1,7,5,19,0,89
13,9,19,16,1,7,9,14,7,95
13,9,19,16,1,25,0,0,0,83
13,9,19,16,1,9,4,0,0,71
13,9,19,16,1,25,9,14,7,113
13,9,19,16,1,9,14,20,0,101
13,9,19,16,1,9,14,20,19,120
13,9,19,16,1,18,19,5,0,100
13,9,19,16,1,18,19,5,4,104
13,9,19,16,1,18,19,5,19,119
13,9,19,16,1,18,20,0,0,96
13,9,19,16,1,18,20,5,4,105
13,9,19,16,1,18,20,19,0,115
13,9,19,16,1,20,3,8,0,89
13,9,19,16,5,14,0,0,0,76
13,9,19,16,5,14,14,5,4,99
13,9,19,16,5,14,19,0,0,95
13,9,19,16,5,18,21,19,5,125
13,9,19,16,8,18,1,19,5,108
13,9,19,16,9,3,11,0,0,80
13,9,19,16,9,3,11,5,12,97
13,9,19,16,12,1,3,5,0,78
13,9,19,16,12,1,3,5,4,82
13,9,19,16,12,1,3,5,19,97
13,9,19,16,12,1,25,0,0,95
13,9,19,16,12,1,25,5,4,104
13,9,19,16,12,1,25,19,0,114
13,9,19,16,12,1,14,0,0,84
13,9,19,16,12,1,14,19,0,103
13,9,19,16,12,1,14,20,0,104
13,9,19,16,12,1,14,20,19,123
13,9,19,16,12,5,1,4,0,79
13,9,19,16,12,5,1,4,19,98
13,9,19,16,12,5,1,19,5,99
13,9,19,16,12,5,4,0,0,78
13,9,19,16,15,9,14,20,0,115
13,9,19,16,15,9,14,20,19,134
13,9,19,16,15,9,19,5,0,105
13,9,19,16,15,9,19,5,4,109
13,9,19,16,15,9,19,5,19,124
13,9,19,16,15,12,9,3,25,121
13,9,19,16,18,1,9,19,5,109
13,9,19,16,18,9,3,5,0,92
13,9,19,16,18,9,14,20,0,118
13,9,19,16,18,9,14,20,19,137
13,9,19,16,18,9,19,1,12,116
13,9,19,16,18,9,19,5,0,108
13,9,19,16,18,9,19,5,4,112
13,9,19,16,18,9,19,5,18,126
13,9,19,16,18,9,26,1,12,123
13,9,19,16,18,9,26,5,0,115
13,9,19,16,18,9,26,5,4,119
13,9,19,16,18,9,26,5,18,133
13,9,19,16,18,9,26,5,19,134
13,9,19,16,18,15,21,4,0,115
13,9,19,16,21,14,3,8,0,103
13,9,19,16,21,20,0,0,0,98
13,9,19,17,21,15,20,5,0,119
13,9,19,17,21,15,20,5,4,123
13,9,19,17,21,15,20,5,18,137
13,9,19,17,21,15,20,5,19,138
13,9,19,18,1,9,19,5,0,93
13,9,19,18,1,9,19,5,4,97
13,9,19,18,1,9,19,5,19,112
13,9,19,18,1,20,5,0,0,85
13,9,19,18,1,20,5,4,0,89
13,9,19,18,1,20,5,19,0,104
13,9,19,18,1,20,9,14,7,110
13,9,19,18,5,1,4,0,0,69
13,9,19,18,5,1,4,5,4,78
13,9,19,18,5,1,4,5,18,92
13,9,19,18,5,1,4,19,0,88
13,9,19,18,5,1,19,15,14,113
13,9,19,18,5,3,9,20,5,101
13,9,19,18,5,3,11,15,14,107
13,9,19,18,5,6,5,18,0,93
13,9,19,18,5,6,5,18,19,112
13,9,19,18,5,6,15,18,13,116
13,9,19,18,5,12,1,20,5,102
13,9,19,18,5,12,25,0,0,101
13,9,19,18,5,12,9,5,4,94
13,9,19,18,5,12,9,5,19,109
13,9,19,18,5,14,4,5,18,105
13,9,19,18,5,16,5,1,20,106
13,9,19,18,5,16,15,18,20,133
13,9,19,18,5,16,21,20,5,126
13,9,19,18,5,19,21,12,20,136
13,9,19,18,5,23,1,18,4,110
13,9,19,18,8,25,13,5,0,110
13,9,19,18,8,25,13,5,4,114
13,9,19,18,8,25,13,5,18,128
13,9,19,18,15,21,20,5,0,120
13,9,19,18,21,12,5,0,0,97
13,9,19,18,21,12,5,4,0,101
13,9,19,18,21,12,5,18,0,115
13,9,19,18,21,12,5,19,0,116
13,9,19,18,21,12,25,0,0,117
13,9,19,18,21,12,9,14,7,122
13,9,19,18,21,14,0,0,0,94
13,9,19,19,1,2,12,5,0,80
13,9,19,19,1,25,0,0,0,86
13,9,19,19,1,9,4,0,0,74
13,9,19,19,1,25,5,18,0,109
13,9,19,19,1,25,9,14,7,116
13,9,19,19,1,25,19,0,0,105
13,9,19,19,1,12,0,0,0,73
13,9,19,19,1,12,19,0,0,92
13,9,19,19,1,13,16,12,5,107
13,9,19,19,1,14,7,0,0,82
13,9,19,19,1,18,25,0,0,104
13,9,19,19,3,18,9,16,20,126
13,9,19,19,5,1,20,0,0,86
13,9,19,19,5,1,20,5,4,95
13,9,19,19,5,1,20,19,0,105
13,9,19,19,5,4,0,0,0,69
13,9,19,19,5,5,13,0,0,83
13,9,19,19,5,12,0,0,0,77
13,9,19,19,5,12,4,9,14,104
13,9,19,19,5,12,19,0,0,96
13,9,19,19,5,14,4,0,0,83
13,9,19,19,5,14,4,19,0,102
13,9,19,19,5,14,19,5,0,103
13,9,19,19,5,14,19,5,19,122
13,9,19,19,5,14,20,0,0,99
13,9,19,19,5,18,22,5,0,110
13,9,19,19,5,19,0,0,0,84
13,9,19,19,5,20,0,0,0,85
13,9,19,19,5,20,19,0,0,104
13,9,19,19,8,1,16,5,0,90
13,9,19,19,8,1,16,5,4,94
13,9,19,19,8,1,16,5,14,104
13,9,19,19,8,1,16,5,19,109
13,9,19,19,8,9,16,0,0,93
13,9,19,19,8,15,4,0,0,87
13,9,19,19,8,15,15,4,0,102
13,9,19,19,9,2,12,5,0,88
13,9,19,19,9,5,19,0,0,93
13,9,19,19,25,9,19,8,0,121
13,9,19,19,9,12,5,0,0,86
13,9,19,19,9,12,5,5,18,109
13,9,19,19,9,12,5,18,25,129
13,9,19,19,9,12,5,19,0,105
13,9,19,19,9,12,18,25,0,124
13,9,19,19,9,14,5,19,19,126
13,9,19,19,9,14,7,0,0,90
13,9,19,19,9,14,7,12,25,127
13,9,19,19,9,15,14,0,0,98
13,9,19,19,9,15,14,1,12,111
13,9,19,19,9,15,14,5,4,107
13,9,19,19,9,15,14,5,18,121
13,9,19,19,9,15,14,19,0,117
13,9,19,19,9,19,0,0,0,88
13,9,19,19,9,19,5,19,0,112
13,9,19,19,9,19,8,0,0,96
13,9,19,19,9,20,0,0,0,89
13,9,19,19,9,22,5,0,0,96
13,9,19,19,9,22,5,19,0,115
13,9,19,19,13,1,18,11,0,103
13,9,19,19,13,5,14,20,0,112
13,9,19,19,15,18,20,0,0,113
13,9,19,19,15,18,20,5,4,122
13,9,19,19,15,18,20,19,0,132
13,9,19,19,15,21,14,4,0,114
13,9,19,19,15,21,14,4,19,133
13,9,19,19,15,21,20,0,0,116
13,9,19,19,15,21,20,19,0,135
13,9,19,19,16,1,3,5,0,85
13,9,19,19,16,1,3,5,4,89
13,9,19,19,16,1,3,5,19,104
13,9,19,19,16,5,1,11,0,93
13,9,19,19,16,5,1,11,19,112
13,9,19,19,16,5,5,3,8,97
13,9,19,19,16,5,5,4,0,90
13,9,19,19,16,5,12,12,0,105
13,9,19,19,16,5,12,12,19,124
13,9,19,19,16,5,12,20,0,113
13,9,19,19,16,5,14,4,0,99
13,9,19,19,16,5,14,4,19,118
13,9,19,19,16,5,14,20,0,115
13,9,19,19,16,15,11,5,0,107
13,9,19,19,16,15,11,5,14,121
13,9,19,19,20,1,25,0,0,106
13,9,19,19,20,1,18,20,0,119
13,9,19,19,20,1,18,20,19,138
13,9,19,19,20,1,20,5,0,106
13,9,19,19,20,1,20,5,4,110
13,9,19,19,20,1,20,5,18,124
13,9,19,19,20,1,20,5,19,125
13,9,19,19,20,5,5,18,0,108
13,9,19,19,20,5,5,18,19,127
13,9,19,19,20,5,16,0,0,101
13,9,19,19,20,5,16,19,0,120
13,9,19,19,20,25,12,5,0,122
13,9,19,19,20,25,12,5,4,126
13,9,19,19,20,25,12,5,19,141
13,9,19,19,20,15,16,0,0,111
13,9,19,19,20,15,16,19,0,130
13,9,19,19,21,1,4,5,0,91
13,9,19,19,21,9,20,0,0,110
13,9,19,19,21,9,20,5,4,119
13,9,19,19,21,9,20,19,0,129
13,9,19,19,21,14,7,0,0,102
13,9,19,19,21,19,0,0,0,100
13,9,19,19,21,19,5,19,0,124
13,9,19,20,0,0,0,0,0,61
13,25,19,20,0,0,0,0,0,77
13,25,19,20,1,3,1,12,0,94
13,25,19,20,1,3,9,1,12,103
13,25,19,20,1,3,9,14,5,109
13,25,19,20,1,7,15,7,0,107
13,25,19,20,1,7,15,7,25,132
13,25,19,20,1,7,15,7,19,126
13,9,19,20,1,11,5,0,0,78
13,9,19,20,1,11,5,14,0,92
13,9,19,20,1,11,5,18,0,96
13,9,19,20,1,11,5,18,19,115
13,9,19,20,1,11,5,19,0,97
13,9,19,20,1,11,9,14,7,103
13,9,19,20,1,11,9,15,14,111
13,9,19,20,1,12,0,0,0,74
13,9,19,20,1,19,20,5,0,106
13,9,19,20,1,21,7,8,20,118
13,25,19,20,1,24,0,0,0,102
13,9,19,20,2,15,23,0,0,101
13,9,19,20,2,15,23,19,0,120
13,9,19,20,3,15,1,20,0,100
13,9,19,20,5,1,3,8,0,78
13,9,19,20,5,4,0,0,0,70
13,9,19,20,5,12,12,0,0,90
13,9,19,20,5,13,16,5,18,118
13,9,19,20,5,14,4,0,0,84
13,9,19,20,5,14,4,5,4,93
13,9,19,20,5,14,4,19,0,103
13,9,19,20,5,18,5,4,0,93
13,9,19,20,5,18,25,0,0,109
13,25,19,20,5,18,25,0,0,125
13,25,19,20,5,18,9,1,12,122
13,25,19,20,5,18,9,5,19,133
13,9,19,20,5,18,9,14,7,114
13,25,19,20,5,18,9,26,5,140
13,9,19,20,5,18,13,0,0,97
13,9,19,20,5,18,13,5,4,106
13,9,19,20,5,18,13,19,0,116
13,9,19,20,5,18,19,0,0,103
13,25,19,20,5,19,0,0,0,101
13,9,19,20,5,20,3,8,0,97
13,9,19,20,5,21,11,0,0,98
13,9,19,20,6,1,12,12,0,92
13,9,19,20,6,21,12,0,0,100
13,9,19,20,8,9,14,11,0,103
13,9,19,20,8,9,14,11,19,122
13,9,19,20,8,18,5,1,4,97
13,9,19,20,8,18,5,23,0,115
13,9,19,20,8,18,9,6,20,122
13,9,19,20,8,18,9,22,5,123
13,9,19,20,8,18,15,23,0,125
13,9,19,20,8,18,15,23,14,139
13,9,19,20,8,18,15,23,19,144
13,9,19,20,9,3,0,0,0,73
13,25,19,20,9,3,1,12,0,102
13,25,19,20,9,3,9,19,5,122
13,25,19,20,9,3,9,19,13,130
13,25,19,20,9,3,9,20,25,143
13,25,19,20,9,3,9,26,5,129
13,25,19,20,9,3,12,25,0,126
13,9,19,20,9,3,15,0,0,88
13,25,19,20,9,3,19,0,0,108
13,9,19,20,9,4,5,0,0,79
13,9,19,20,9,5,18,0,0,93
13,9,19,20,9,5,19,20,0,114
13,9,19,20,9,6,25,0,0,101
13,25,19,20,9,6,25,0,0,117
13,25,19,20,9,6,9,3,0,104
13,25,19,20,9,6,9,5,4,110
13,25,19,20,9,6,9,5,18,124
13,25,19,20,9,6,9,5,19,125
13,9,19,20,9,7,18,9,0,104
13,9,19,20,9,7,18,9,19,123
13,9,19,20,25,9,19,8,0,122
13,9,19,20,9,12,25,0,0,107
13,9,19,20,9,12,12,5,4,103
13,9,19,20,9,13,5,0,0,88
13,9,19,20,9,13,5,4,0,92
13,9,19,20,9,13,5,19,0,107
13,9,19,20,9,13,9,14,7,113
13,9,19,20,9,14,5,19,19,127
13,9,19,20,9,14,7,0,0,91
13,9,19,20,9,15,14,0,0,99
13,9,19,20,25,16,5,0,0,107
13,9,19,20,25,16,5,4,0,111
13,9,19,20,25,16,5,19,0,126
13,9,19,20,25,16,9,14,7,132
13,25,19,20,9,17,21,5,0,129
13,25,19,20,9,17,21,5,19,148
13,9,19,20,9,20,12,5,0,107
13,9,19,20,9,20,12,5,4,111
13,9,19,20,9,20,12,5,19,126
13,9,19,20,12,5,0,0,0,78
13,9,19,20,12,5,19,19,0,116
13,9,19,20,12,5,20,15,5,118
13,9,19,20,15,12,4,0,0,92
13,9,19,20,15,14,5,0,0,95
13,9,19,20,15,14,21,19,11,141
13,9,19,20,15,15,11,0,0,102
13,9,19,20,15,21,3,8,0,108
13,9,19,20,18,1,3,5,0,88
13,9,19,20,18,1,3,5,4,92
13,9,19,20,18,1,3,5,19,107
13,9,19,20,18,1,9,14,0,103
13,9,19,20,18,1,12,19,0,111
13,9,19,20,18,5,1,20,0,105
13,9,19,20,18,5,1,20,19,124
13,9,19,20,18,25,0,0,0,104
13,9,19,20,18,9,1,12,0,101
13,9,19,20,18,9,1,12,19,120
13,9,19,20,18,9,19,20,0,127
13,9,19,20,18,25,19,20,0,143
13,9,19,20,18,25,19,20,19,162
13,9,19,20,18,15,23,0,0,117
13,9,19,20,18,21,19,20,0,139
13,9,19,20,18,21,19,20,19,158
13,9,19,20,18,21,20,8,0,128
13,9,19,20,21,14,5,0,0,101
13,9,19,20,21,14,5,4,0,105
13,9,19,20,21,14,5,19,0,120
13,9,19,20,21,14,9,14,7,126
13,9,19,20,21,18,5,0,0,105
13,9,19,20,21,18,14,0,0,114
13,9,19,20,21,20,15,18,0,135
13,9,19,20,21,20,15,18,19,154
13,9,19,21,14,9,15,14,0,114
13,9,19,21,14,9,15,14,19,133
13,9,19,21,18,1,0,0,0,81
13,9,19,21,19,1,7,5,0,94
13,9,19,21,19,1,7,5,19,113
13,9,19,21,19,5,0,0,0,86
13,9,19,21,19,5,4,0,0,90
13,9,19,21,19,5,6,21,12,125
13,9,19,21,19,5,18,0,0,104
13,9,19,21,19,5,18,19,0,123
13,9,19,21,19,5,19,0,0,105
13,9,19,21,19,9,14,7,0,111
13,9,19,22,1,12,21,5,0,102
13,9,19,22,1,12,21,5,4,106
13,9,19,22,1,12,21,5,19,121
13,9,19,22,9,4,9,14,7,106
13,9,19,22,15,21,3,8,0,110
13,9,19,23,1,25,0,0,0,90
13,9,19,23,5,4,0,0,0,73
13,9,19,23,5,4,4,5,4,86
13,9,19,23,5,5,14,0,0,88
13,9,19,23,5,14,4,0,0,87
13,9,19,23,5,18,14,0,0,101
13,9,19,23,9,18,5,0,0,96
13,9,19,23,9,18,5,4,0,100
13,9,19,23,9,18,9,14,7,121
13,9,19,23,9,19,4,15,13,124
13,9,19,23,9,19,8,0,0,100
13,9,19,23,15,13,1,14,0,107
13,9,19,23,15,18,4,0,0,101
13,9,19,23,15,18,4,5,4,110
13,9,19,23,15,18,4,19,0,120
13,9,19,23,18,5,19,20,0,126
13,9,19,23,18,9,20,0,0,111
13,9,19,23,18,9,20,5,0,116
13,9,19,23,18,9,20,5,19,135
13,9,19,23,18,15,20,5,0,122
13,9,19,26,15,14,5,0,0,101
13,9,19,26,15,14,5,4,0,105
13,9,19,26,15,14,9,14,7,126
13,25,20,1,3,9,19,13,0,103
13,9,20,1,16,19,9,19,0,106
13,9,20,5,0,0,0,0,0,47
13,9,20,5,16,18,15,15,6,117
13,9,20,5,18,0,0,0,0,65
13,9,20,5,18,5,4,0,0,74
13,9,20,5,18,5,18,0,0,88
13,9,20,5,18,5,18,19,0,107
13,9,20,5,18,7,1,20,5,98
13,9,20,5,18,9,14,7,0,95
13,9,20,5,18,19,0,0,0,84
13,9,20,5,18,23,15,18,20,141
13,9,20,5,19,0,0,0,0,66
13,25,20,8,0,0,0,0,0,66
13,9,20,8,1,14,0,0,0,65
13,9,20,8,5,18,0,0,0,73
13,9,20,8,5,18,19,0,0,92
13,25,20,8,9,3,0,0,0,78
13,25,20,8,9,3,1,12,0,91
13,25,20,8,9,3,9,19,5,111
13,25,20,8,9,3,9,19,13,119
13,25,20,8,9,3,9,19,20,126
13,25,20,8,9,3,9,26,5,118
13,25,20,8,9,6,25,0,0,106
13,25,20,8,9,6,9,5,4,99
13,25,20,8,9,6,9,5,18,113
13,25,20,8,9,19,13,0,0,107
13,25,20,8,9,19,20,0,0,114
13,25,20,8,9,26,5,0,0,106
13,25,20,8,12,1,14,4,0,97
13,25,20,8,13,1,11,5,18,114
13,25,20,8,15,7,5,14,25,132
13,25,20,8,15,7,15,14,25,142
13,25,20,8,15,9,0,0,0,90
13,25,20,8,15,12,0,0,0,93
13,25,20,8,15,12,15,7,25,140
13,25,20,8,15,14,15,13,25,148
13,25,20,8,15,16,5,9,3,114
13,25,20,8,15,16,15,5,13,130
13,25,20,8,15,16,15,5,20,137
13,25,20,8,15,19,0,0,0,100
13,25,20,8,19,0,0,0,0,85
13,25,20,8,21,19,0,0,0,106
13,9,20,25,0,0,0,0,0,67
13,9,20,9,3,9,4,1,12,80
13,9,20,9,3,9,4,5,0,72
13,9,20,9,3,9,4,5,19,91
13,9,20,9,5,18,0,0,0,74
13,9,20,9,5,19,20,0,0,95
13,9,20,9,7,1,2,12,5,78
13,9,20,9,7,1,14,20,0,93
13,9,20,9,7,1,20,5,0,84
13,9,20,9,7,1,20,5,4,88
13,9,20,9,7,1,20,5,19,103
13,9,20,9,7,1,20,15,18,112
13,25,20,9,12,9,4,0,0,92
13,25,20,9,12,15,9,4,0,107
13,9,20,9,14,7,0,0,0,72
13,9,20,9,19,0,0,0,0,70
13,9,20,9,19,5,19,0,0,94
13,9,20,15,7,5,14,0,0,83
13,9,20,15,7,5,14,9,3,95
13,9,20,15,7,5,14,19,0,102
13,9,20,15,13,5,0,0,0,75
13,9,20,15,13,25,3,9,14,121
13,9,20,15,19,5,19,0,0,100
13,9,20,15,19,9,19,0,0,104
13,9,20,15,19,15,13,5,0,109
13,9,20,15,20,9,3,0,0,89
13,9,20,18,1,9,12,12,5,99
13,9,20,18,1,12,0,0,0,73
13,9,20,18,1,20,5,0,0,86
13,9,20,18,5,4,0,0,0,69
13,9,20,18,5,18,0,0,0,83
13,9,20,18,5,19,0,0,0,84
13,9,20,18,5,23,15,18,20,141
13,9,20,18,9,6,15,18,13,121
13,9,20,18,9,14,7,0,0,90
13,9,20,19,21,13,1,20,1,117
13,9,20,19,22,1,8,0,0,92
13,9,20,19,22,1,8,19,0,111
13,9,20,19,22,15,20,8,0,126
13,9,20,20,0,0,0,0,0,62
13,9,20,20,1,20,21,18,0,122
13,9,20,20,5,14,0,0,0,81
13,9,20,20,5,14,5,4,0,90
13,9,20,20,5,14,19,0,0,100
13,9,20,20,5,14,20,0,0,101
13,9,20,20,25,0,0,0,0,87
13,9,20,20,9,13,21,19,0,124
13,9,20,20,12,5,0,0,0,79
13,9,20,20,19,0,0,0,0,81
13,9,20,22,15,20,8,0,0,107
13,9,20,26,22,1,8,0,0,99
13,9,20,26,22,1,8,19,0,118
13,9,20,26,22,15,20,8,0,133
13,9,21,18,21,19,0,0,0,101
13,9,24,0,0,0,0,0,0,46
13,25,24,1,0,0,0,0,0,63
13,9,24,1,2,12,5,0,0,66
13,25,24,1,5,13,9,1,0,91
13,25,24,1,13,15,5,2,1,99
13,9,24,2,12,15,15,4,0,94
13,9,24,5,4,0,0,0,0,55
13,25,24,5,4,5,13,1,0,90
13,25,24,5,4,5,13,1,19,109
13,25,24,5,4,5,13,9,3,101
13,9,24,5,4,12,25,0,0,92
13,9,24,5,4,14,5,19,19,112
13,25,24,5,13,9,1,0,0,90
13,9,24,5,14,0,0,0,0,65
13,9,24,5,18,0,0,0,0,69
13,9,24,5,18,5,19,19,0,112
13,9,24,5,18,19,0,0,0,88
13,9,24,5,19,0,0,0,0,70
13,9,24,8,9,12,12,0,0,87
13,9,24,25,0,0,0,0,0,71
13,9,24,9,2,12,5,0,0,74
13,9,24,9,14,7,0,0,0,76
13,25,24,9,14,15,9,4,0,113
13,9,24,9,20,5,0,0,0,80
13,25,24,15,0,0,0,0,0,77
13,25,24,15,3,25,20,5,0,130
13,25,24,15,3,25,20,5,19,149
13,25,24,15,5,4,5,13,1,105
13,25,24,15,9,4,0,0,0,90
13,25,24,15,9,14,15,13,1,129
13,9,24,15,12,15,7,25,0,120
13,25,24,15,13,1,0,0,0,91
13,25,24,15,13,1,19,0,0,110
13,25,24,15,13,1,20,1,0,112
13,25,24,15,13,25,15,13,1,144
13,9,24,15,16,12,15,9,4,117
13,25,24,15,16,15,4,0,0,112
13,25,24,15,16,15,4,1,14,127
13,25,24,15,16,15,4,9,1,122
13,25,24,15,18,18,8,5,1,127
13,25,24,15,19,16,15,18,5,150
13,25,24,15,20,8,5,3,1,114
13,25,24,15,22,9,18,1,12,139
13,25,24,15,22,9,18,21,19,166
13,9,24,20,0,0,0,0,0,66
13,9,24,20,9,6,15,18,13,127
13,9,24,20,9,12,9,15,14,125
13,9,24,20,9,15,14,0,0,104
13,9,24,20,21,18,5,0,0,110
13,9,24,20,21,18,5,19,0,129
13,9,24,21,16,0,0,0,0,83
13,9,24,21,16,19,0,0,0,102
13,9,26,5,14,0,0,0,0,67
13,9,26,5,14,13,1,19,20,120
13,9,26,5,14,19,0,0,0,86
13,9,26,13,1,26,5,0,0,93
13,25,26,15,14,20,0,0,0,113
13,25,26,15,19,20,15,13,5,151
13,9,26,18,1,3,8,0,0,78
13,9,26,18,1,8,0,0,0,75
13,9,26,26,5,14,0,0,0,93
13,9,26,26,5,14,19,0,0,112
13,9,26,26,5,14,20,15,16,144
13,9,26,26,25,0,0,0,0,99
13,9,26,26,12,5,0,0,0,91
13,9,26,26,12,5,4,0,0,95
13,9,26,26,12,5,18,0,0,109
13,9,26,26,12,5,19,0,0,110
13,9,26,26,12,25,0,0,0,111
13,9,26,26,12,9,14,7,0,116
13,9,26,26,15,14,9,20,5,137
13,11,20,0,0,0,0,0,0,44
13,12,5,3,8,3,8,8,1,61
13,12,24,0,0,0,0,0,0,49
13,13,6,0,0,0,0,0,0,32
13,13,6,4,0,0,0,0,0,36
13,13,13,13,0,0,0,0,0,52
13,14,5,13,0,0,0,0,0,45
13,14,5,13,5,0,0,0,0,50
13,14,5,13,9,3,0,0,0,57
13,14,5,13,15,14,9,3,0,86
13,14,5,13,15,14,9,3,19,105
13,14,5,13,15,14,9,19,13,115
13,14,5,13,15,14,9,19,20,122
13,14,5,13,15,14,9,26,5,114
13,14,5,19,9,3,0,0,0,63
13,14,5,19,20,9,3,0,0,83
13,14,9,1,3,5,15,21,19,100
13,14,9,15,9,4,0,0,0,64
13,15,2,0,0,0,0,0,0,30
13,15,2,1,2,12,5,0,0,50
13,15,2,2,1,2,12,5,0,52
13,15,2,2,5,4,0,0,0,41
13,15,2,2,5,18,0,0,0,55
13,15,2,2,5,18,19,0,0,74
13,15,2,2,25,0,0,0,0,57
13,15,2,2,9,5,0,0,0,46
13,15,2,2,9,14,7,0,0,62
13,15,2,2,9,19,8,0,0,68
13,15,2,2,9,19,8,12,25,105
13,15,2,2,9,19,13,0,0,73
13,15,2,2,9,19,20,0,0,80
13,15,2,2,12,5,0,0,0,49
13,15,2,3,1,16,0,0,0,50
13,15,2,3,1,16,19,0,0,69
13,15,2,5,4,0,0,0,0,39
13,15,2,9,12,5,19,0,0,75
13,15,2,9,12,9,1,0,0,61
13,15,2,9,12,9,1,18,25,104
13,15,2,9,12,9,19,5,0,84
13,15,2,9,12,9,19,5,4,88
13,15,2,9,12,9,19,5,18,102
13,15,2,9,12,9,19,5,19,103
13,15,2,9,12,9,20,25,0,105
13,15,2,9,12,9,26,5,0,91
13,15,2,9,12,9,26,5,4,95
13,15,2,9,12,9,26,5,18,109
13,15,2,9,12,9,26,5,19,110
13,15,2,12,5,0,0,0,0,47
13,15,2,12,9,11,5,0,0,67
13,15,2,15,3,18,1,3,25,95
13,15,2,15,3,18,1,20,0,87
13,15,2,15,3,18,1,20,19,106
13,15,2,15,12,1,20,18,25,121
13,15,2,16,18,15,15,6,0,100
13,15,2,19,0,0,0,0,0,49
13,15,2,19,8,9,16,0,0,82
13,15,2,19,13,1,14,0,0,77
13,15,2,19,13,5,14,0,0,81
13,15,2,19,20,5,18,0,0,92
13,15,2,19,20,5,18,19,0,111
13,15,3,3,1,19,9,14,0,77
13,15,3,3,1,19,9,14,19,96
13,15,3,3,5,14,9,7,15,84
13,15,3,8,1,19,0,0,0,59
13,15,3,8,5,12,0,0,0,56
13,15,3,8,25,0,0,0,0,64
13,15,3,8,9,12,1,0,0,61
13,15,3,8,9,12,1,19,0,80
13,15,3,8,18,1,19,0,0,77
13,15,3,8,21,4,9,0,0,73
13,15,3,11,0,0,0,0,0,42
13,15,3,11,1,2,12,5,0,62
13,15,3,11,1,4,15,0,0,62
13,15,3,11,1,7,5,0,0,55
13,15,3,11,2,9,18,4,0,75
13,15,3,11,5,4,0,0,0,51
13,15,3,11,5,18,0,0,0,65
13,15,3,11,5,18,25,0,0,90
13,15,3,11,5,18,9,5,19,98
13,15,3,11,5,18,14,21,20,120
13,15,3,11,5,18,19,0,0,84
13,15,3,11,5,20,5,18,0,90
13,15,3,11,6,21,12,0,0,81
13,15,3,11,6,21,12,12,25,118
13,15,3,11,9,14,7,0,0,72
13,15,3,11,9,14,7,12,25,109
13,15,3,11,9,19,8,0,0,78
13,15,3,11,19,0,0,0,0,61
13,15,3,11,21,16,0,0,0,79
13,15,3,11,21,16,19,0,0,98
13,15,3,13,1,9,14,0,0,68
13,15,3,15,0,0,0,0,0,46
13,15,3,15,3,11,0,0,0,60
13,15,3,15,13,15,3,15,0,92
13,15,3,21,3,11,0,0,0,66
13,15,4,1,12,0,0,0,0,45
13,15,4,1,12,9,19,13,0,86
13,15,4,1,12,9,19,20,0,93
13,15,4,1,12,9,20,25,0,99
13,15,4,1,12,9,26,5,0,85
13,15,4,1,12,12,25,0,0,82
13,15,4,4,5,18,0,0,0,59
13,15,4,5,12,0,0,0,0,49
13,15,4,5,12,5,4,0,0,58
13,15,4,5,12,5,18,0,0,72
13,15,4,5,12,5,18,19,0,91
13,15,4,5,12,5,19,19,0,92
13,15,4,5,12,9,14,7,0,79
13,15,4,5,12,9,14,7,19,98
13,15,4,5,12,9,19,20,0,97
13,15,4,5,12,9,26,5,0,89
13,15,4,5,12,12,5,4,0,70
13,15,4,5,12,12,5,18,0,84
13,15,4,5,12,12,5,18,19,103
13,15,4,5,12,12,9,14,7,91
13,15,4,5,12,19,0,0,0,68
13,15,4,5,13,19,0,0,0,69
13,15,4,5,18,0,0,0,0,55
13,15,4,5,18,1,14,20,0,90
13,15,4,5,18,1,20,5,0,81
13,15,4,5,18,1,20,5,4,85
13,15,4,5,18,1,20,5,19,100
13,15,4,5,18,1,20,15,0,91
13,15,4,5,18,1,20,15,18,109
13,15,4,5,18,1,20,15,19,110
13,15,4,5,18,14,5,0,0,74
13,15,4,5,18,14,5,18,0,92
13,15,4,5,18,14,5,19,20,113
13,15,4,5,18,14,9,19,5,102
13,15,4,5,18,14,9,19,8,105
13,15,4,5,18,14,9,19,13,110
13,15,4,5,18,14,9,19,20,117
13,15,4,5,18,14,9,20,25,123
13,15,4,5,18,14,9,26,5,109
13,15,4,5,18,14,12,25,0,106
13,15,4,5,18,14,19,0,0,88
13,15,4,5,19,0,0,0,0,56
13,15,4,5,19,20,0,0,0,76
13,15,4,5,19,20,5,18,0,99
13,15,4,5,19,20,5,19,20,120
13,15,4,5,19,20,9,5,19,109
13,15,4,5,19,20,12,25,0,113
13,15,4,7,5,0,0,0,0,44
13,15,4,9,0,0,0,0,0,41
13,15,4,25,0,0,0,0,0,57
13,15,4,9,1,20,9,15,14,100
13,15,4,9,3,1,0,0,0,45
13,15,4,9,3,9,20,25,0,98
13,15,4,9,3,21,13,0,0,78
13,15,4,9,3,21,13,19,0,97
13,15,4,9,6,0,0,0,0,47
13,15,4,9,6,25,0,0,0,72
13,15,4,9,6,9,5,4,0,65
13,15,4,9,6,9,5,18,0,79
13,15,4,9,6,9,5,18,19,98
13,15,4,9,6,9,5,19,0,80
13,15,4,9,6,25,9,14,7,102
13,15,4,9,12,9,0,0,0,62
13,15,4,9,12,12,9,15,14,103
13,15,4,9,15,12,1,18,0,87
13,15,4,9,15,12,9,0,0,77
13,15,4,9,19,8,0,0,0,68
13,15,4,9,19,8,12,25,0,105
13,15,4,9,19,20,0,0,0,80
13,15,4,9,19,20,5,0,0,85
13,15,4,9,19,20,5,19,0,104
13,15,4,9,19,20,18,25,0,123
13,15,4,9,21,19,0,0,0,81
13,15,4,15,0,0,0,0,0,47
13,15,4,21,12,1,0,0,0,66
13,15,4,21,12,1,14,20,0,100
13,15,4,21,12,1,18,0,0,84
13,15,4,21,12,1,18,12,25,121
13,15,4,21,12,1,20,5,0,91
13,15,4,21,12,1,20,5,4,95
13,15,4,21,12,1,20,5,19,110
13,15,4,21,12,1,20,15,18,119
13,15,4,21,12,5,0,0,0,70
13,15,4,21,12,5,19,0,0,89
13,15,4,21,12,5,20,0,0,90
13,15,4,21,12,9,0,0,0,74
13,15,4,21,12,9,26,5,0,105
13,15,4,21,12,15,0,0,0,80
13,15,4,21,12,21,19,0,0,105
13,15,4,21,13,9,20,5,0,100
13,15,4,21,19,0,0,0,0,72
13,15,5,2,12,5,0,0,0,52
13,15,5,3,11,0,0,0,0,47
13,15,5,12,12,15,14,0,0,86
13,15,5,20,0,0,0,0,0,53
13,15,5,21,18,19,0,0,0,91
13,15,6,5,20,20,5,0,0,84
13,15,6,5,20,20,5,19,0,103
13,15,6,6,0,0,0,0,0,40
13,15,6,6,5,20,20,5,0,90
13,15,6,6,5,20,20,5,19,109
13,15,6,6,12,5,0,0,0,57
13,15,6,21,19,19,9,12,0,114
13,15,7,4,1,4,0,0,0,44
13,15,7,7,1,14,0,0,0,57
13,15,7,7,5,4,0,0,0,51
13,15,7,7,25,0,0,0,0,67
13,15,7,7,9,5,19,0,0,75
13,15,7,7,9,14,7,0,0,72
13,15,7,7,9,15,0,0,0,66
13,15,7,8,21,12,0,0,0,76
13,15,7,9,12,1,12,9,1,79
13,15,7,9,20,15,3,9,1,92
13,15,7,15,0,0,0,0,0,50
13,15,7,15,19,0,0,0,0,69
13,15,7,15,20,5,0,0,0,75
13,15,7,19,0,0,0,0,0,54
13,15,7,21,5,25,0,0,0,86
13,15,7,21,12,19,0,0,0,87
13,15,7,21,12,19,8,9,16,120
13,15,8,1,0,0,0,0,0,37
13,15,8,1,2,1,20,0,0,60
13,15,8,1,9,18,0,0,0,64
13,15,8,1,9,18,19,0,0,83
13,15,8,1,12,9,13,0,0,71
13,15,8,1,18,0,0,0,0,55
13,15,8,1,20,18,1,0,0,76
13,15,8,1,23,11,9,20,5,105
13,15,8,5,12,0,0,0,0,53
13,15,8,5,12,9,13,0,0,75
13,15,8,5,12,19,0,0,0,72
13,15,8,14,19,5,5,4,0,83
13,15,8,15,15,8,15,15,0,104
13,15,8,15,19,0,0,0,0,70
13,15,8,21,18,0,0,0,0,75
13,15,8,21,18,19,0,0,0,94
13,15,8,23,1,0,0,0,0,60
13,15,25,0,0,0,0,0,0,53
13,15,9,4,0,0,0,0,0,41
13,15,9,4,5,18,0,0,0,64
13,15,9,4,15,18,5,0,0,79
13,15,9,4,15,18,5,19,0,98
13,15,25,5,14,0,0,0,0,72
13,15,25,5,14,1,14,20,0,107
13,15,25,5,14,5,18,0,0,95
13,15,25,5,14,12,5,19,19,127
13,15,25,5,14,14,5,0,0,91
13,15,9,5,18,0,0,0,0,60
13,15,9,5,19,20,0,0,0,81
13,15,9,5,20,5,18,0,0,85
13,15,9,5,20,25,0,0,0,87
13,15,9,5,20,9,5,19,0,95
13,15,25,9,20,5,0,0,0,87
13,15,9,12,0,0,0,0,0,49
13,15,25,12,0,0,0,0,0,65
13,15,9,12,5,0,0,0,0,54
13,15,25,12,5,0,0,0,0,70
13,15,9,12,5,4,0,0,0,58
13,15,9,12,5,25,0,0,0,79
13,15,9,12,5,18,0,0,0,72
13,15,9,12,5,18,19,0,0,91
13,15,9,12,5,19,0,0,0,73
13,15,9,12,9,14,7,0,0,79
13,15,9,12,9,14,7,12,25,116
13,15,9,12,19,0,0,0,0,68
13,15,9,12,19,15,13,5,0,101
13,15,9,14,5,1,21,0,0,78
13,15,9,15,0,0,0,0,0,52
13,15,25,15,0,0,0,0,0,68
13,15,9,18,5,0,0,0,0,60
13,15,9,18,5,5,4,0,0,69
13,15,9,18,5,9,14,7,0,90
13,15,9,18,5,19,0,0,0,79
13,15,9,18,5,20,20,5,0,105
13,15,9,19,15,14,0,0,0,85
13,15,9,19,20,0,0,0,0,76
13,15,9,19,20,5,14,0,0,95
13,15,9,19,20,5,14,5,4,104
13,15,9,19,20,5,14,5,18,118
13,15,9,19,20,5,14,19,0,114
13,15,9,19,20,5,18,0,0,99
13,15,9,19,20,5,19,20,0,120
13,15,9,19,20,6,21,12,0,115
13,15,9,19,20,25,0,0,0,101
13,15,9,19,20,9,6,25,0,116
13,15,9,19,20,9,19,8,0,112
13,15,9,19,20,12,5,19,19,131
13,15,9,19,20,12,25,0,0,113
13,15,9,19,20,14,5,19,19,133
13,15,9,19,20,21,18,5,0,120
13,15,9,19,20,21,18,5,19,139
13,15,9,20,0,0,0,0,0,57
13,15,9,20,8,5,18,0,0,88
13,15,9,20,25,0,0,0,0,82
13,15,9,20,9,5,18,0,0,89
13,15,9,20,9,5,19,20,0,110
13,15,10,1,18,18,1,0,0,76
13,15,10,1,18,18,1,19,0,95
13,15,10,15,5,19,0,0,0,77
13,15,10,15,19,0,0,0,0,72
13,15,11,1,4,4,1,13,0,62
13,15,11,1,4,15,18,0,0,77
13,15,11,1,13,15,11,1,0,80
13,15,11,5,0,0,0,0,0,44
13,15,11,5,19,0,0,0,0,63
13,15,11,9,0,0,0,0,0,48
13,15,11,25,0,0,0,0,0,64
13,15,11,9,8,1,14,1,0,72
13,15,11,9,8,9,0,0,0,65
13,15,11,19,8,1,0,0,0,67
13,15,11,21,13,0,0,0,0,73
13,15,12,1,12,0,0,0,0,53
13,15,12,1,12,9,20,25,0,107
13,15,12,1,18,0,0,0,0,59
13,15,12,1,18,25,0,0,0,84
13,15,12,1,18,9,20,25,0,113
13,15,12,1,18,19,0,0,0,78
13,15,12,1,19,0,0,0,0,60
13,15,12,1,19,19,5,19,0,103
13,15,12,1,19,19,25,0,0,104
13,15,12,1,19,19,9,5,4,97
13,15,12,1,22,5,0,0,0,68
13,15,12,4,0,0,0,0,0,44
13,15,12,4,1,2,12,5,0,64
13,15,12,4,1,19,12,5,0,81
13,15,12,4,1,22,9,20,5,101
13,15,12,4,2,15,1,18,4,84
13,15,12,4,5,4,0,0,0,53
13,15,12,4,5,18,0,0,0,67
13,15,12,4,5,18,5,4,0,76
13,15,12,4,5,18,25,0,0,92
13,15,12,4,5,18,9,14,7,97
13,15,12,4,5,18,19,0,0,86
13,15,12,4,25,0,0,0,0,69
13,15,12,4,9,5,18,0,0,76
13,15,12,4,9,5,19,20,0,97
13,15,12,4,9,14,5,19,19,110
13,15,12,4,9,14,7,0,0,74
13,15,12,4,9,14,7,19,0,93
13,15,12,4,13,1,4,5,0,67
13,15,12,4,16,18,15,15,6,114
13,15,12,4,19,0,0,0,0,63
13,15,12,4,23,1,18,16,0,102
13,15,12,4,23,1,18,16,19,121
13,15,12,5,2,21,20,0,0,88
13,15,12,5,3,1,19,20,0,88
13,15,12,5,3,21,12,1,0,82
13,15,12,5,3,21,12,1,18,100
13,15,12,5,3,21,12,5,0,86
13,15,12,5,3,21,12,5,19,105
13,15,12,5,8,5,1,4,0,63
13,15,12,5,8,5,1,16,0,75
13,15,12,5,8,9,12,12,0,86
13,15,12,5,8,9,12,12,25,111
13,15,12,5,8,9,12,12,19,105
13,15,12,5,9,19,13,0,0,86
13,15,12,5,12,9,11,5,0,82
13,15,12,5,16,18,15,15,6,115
13,15,12,5,18,0,0,0,0,63
13,15,12,5,19,0,0,0,0,64
13,15,12,5,19,11,9,14,0,98
13,15,12,5,19,11,9,14,19,117
13,15,12,5,19,20,0,0,0,84
13,15,12,5,19,20,5,4,0,93
13,15,12,5,19,20,5,18,0,107
13,15,12,5,19,20,5,18,19,126
13,15,12,5,19,20,6,21,12,123
13,15,12,5,19,20,9,5,0,98
13,15,12,5,19,20,9,14,7,114
13,15,12,5,19,20,19,0,0,103
13,15,12,5,20,0,0,0,0,65
13,15,12,5,23,1,18,16,0,103
13,15,12,25,0,0,0,0,0,65
13,15,12,25,2,4,1,20,5,97
13,15,12,25,2,4,5,14,1,91
13,15,12,25,2,4,9,3,0,83
13,15,12,25,2,4,9,20,5,105
13,15,12,25,2,4,15,21,19,126
13,15,12,9,5,19,0,0,0,73
13,15,12,9,6,25,0,0,0,80
13,15,12,9,6,9,5,4,0,73
13,15,12,9,6,25,9,14,7,110
13,15,12,9,12,1,12,9,1,84
13,15,12,9,13,5,14,0,0,81
13,15,12,9,14,1,18,25,0,107
13,15,12,9,14,5,20,0,0,88
13,15,12,9,14,7,0,0,0,70
13,15,12,25,19,0,0,0,0,84
13,15,12,25,19,9,20,5,0,118
13,15,12,9,20,9,15,14,0,107
13,15,12,11,1,0,0,0,0,52
13,15,12,12,1,0,0,0,0,53
13,15,12,12,1,8,19,0,0,80
13,15,12,12,1,14,4,0,0,71
13,15,12,12,5,0,0,0,0,57
13,15,12,12,5,19,0,0,0,76
13,15,12,12,5,20,15,14,0,106
13,15,12,12,9,3,8,15,16,103
13,15,12,12,25,3,15,20,0,115
13,15,12,12,9,5,14,20,0,100
13,15,12,12,9,6,25,0,0,92
13,15,12,12,9,6,9,5,4,85
13,15,12,12,9,6,9,5,18,99
13,15,12,12,9,6,9,5,19,100
13,15,12,12,25,8,1,23,11,120
13,15,12,12,25,13,1,23,11,125
13,15,12,12,9,19,15,12,0,107
13,15,12,12,9,20,9,5,19,114
13,15,12,12,9,20,21,4,5,111
13,15,12,12,19,0,0,0,0,71
13,15,12,12,21,19,3,0,0,95
13,15,12,12,21,19,3,1,14,110
13,15,12,12,21,19,3,19,0,114
13,15,12,12,21,19,3,21,13,129
13,15,12,12,21,19,11,0,0,103
13,15,12,12,21,19,11,1,14,118
13,15,12,12,21,19,11,19,0,122
13,15,12,13,1,14,0,0,0,68
13,15,12,13,5,14,0,0,0,72
13,15,12,13,21,20,9,1,14,118
13,15,12,15,3,8,19,0,0,85
13,15,12,15,3,11,5,18,0,92
13,15,12,15,9,4,0,0,0,68
13,15,12,15,11,5,18,0,0,89
13,15,12,15,13,16,9,0,0,93
13,15,12,15,19,19,5,0,0,98
13,15,12,15,19,19,5,19,0,117
13,15,12,15,19,19,9,3,0,105
13,15,12,15,19,19,9,14,5,121
13,15,12,15,19,19,15,9,4,121
13,15,12,16,5,0,0,0,0,61
13,15,12,18,15,15,11,5,14,118
13,15,12,19,0,0,0,0,0,59
13,15,12,20,0,0,0,0,0,60
13,15,12,20,5,4,0,0,0,69
13,15,12,20,5,14,0,0,0,79
13,15,12,20,5,14,12,25,0,116
13,15,12,20,5,18,0,0,0,83
13,15,12,20,5,18,19,0,0,102
13,15,12,20,9,14,7,0,0,90
13,15,12,20,15,0,0,0,0,75
13,15,12,20,19,0,0,0,0,79
13,15,12,20,20,5,14,0,0,99
13,15,12,22,9,0,0,0,0,71
13,15,13,0,0,0,0,0,0,41
13,15,13,2,9,14,0,0,0,66
13,15,13,2,12,5,0,0,0,60
13,15,13,5,0,0,0,0,0,46
13,15,13,5,14,20,0,0,0,80
13,15,13,5,14,20,1,0,0,81
13,15,13,5,14,20,1,12,0,93
13,15,13,5,14,20,1,14,25,120
13,15,13,5,14,20,1,18,25,124
13,15,13,5,14,20,12,25,0,117
13,15,13,5,14,20,15,0,0,95
13,15,13,5,14,20,15,5,19,119
13,15,13,5,14,20,15,19,0,114
13,15,13,5,14,20,15,21,19,135
13,15,13,5,14,20,19,0,0,99
13,15,13,5,14,20,21,13,19,133
13,15,13,5,19,0,0,0,0,65
13,15,13,9,15,12,15,7,25,124
13,15,13,9,19,8,0,0,0,77
13,15,13,9,19,13,0,0,0,82
13,15,13,9,19,13,19,0,0,101
13,15,13,9,19,20,0,0,0,89
13,15,13,13,1,0,0,0,0,55
13,15,13,13,1,19,0,0,0,74
13,15,13,13,5,0,0,0,0,59
13,15,13,13,5,18,0,0,0,77
13,15,13,13,5,20,0,0,0,79
13,15,13,13,9,5,19,0,0,87
13,15,13,15,0,0,0,0,0,56
13,15,13,19,0,0,0,0,0,60
13,15,13,19,5,18,0,0,0,83
13,15,13,19,5,18,19,0,0,102
13,15,13,26,5,18,0,0,0,90
13,15,13,26,5,18,19,0,0,109
13,15,14,1,3,5,20,9,14,94
13,15,14,1,3,8,0,0,0,54
13,15,14,1,3,8,1,12,0,67
13,15,14,1,3,8,1,20,5,80
13,15,14,1,3,8,9,19,13,95
13,15,14,1,3,8,9,19,20,102
13,15,14,1,3,8,9,26,5,94
13,15,14,1,3,9,4,0,0,59
13,15,14,1,3,9,4,9,3,71
13,15,14,1,3,9,4,19,0,78
13,15,14,1,3,9,12,12,15,94
13,15,14,1,3,20,0,0,0,66
13,15,14,1,3,20,9,14,0,89
13,15,14,1,3,20,9,14,5,94
13,15,14,1,4,0,0,0,0,47
13,15,14,1,4,1,12,0,0,60
13,15,14,1,4,5,12,16,8,88
13,15,14,1,4,5,19,0,0,71
13,15,14,1,4,9,3,0,0,59
13,15,14,1,4,9,3,1,12,72
13,15,14,1,4,9,19,13,0,88
13,15,14,1,4,9,19,13,19,107
13,15,14,1,4,14,15,3,11,90
13,15,14,1,4,19,0,0,0,66
13,15,14,1,5,14,5,0,0,67
13,15,14,1,12,0,0,0,0,55
13,15,14,1,13,9,4,5,0,74
13,15,14,1,13,9,14,5,0,84
13,15,14,1,14,4,5,18,0,84
13,15,14,1,14,4,18,25,0,104
13,15,14,1,14,4,18,9,3,91
13,15,14,1,16,8,1,19,5,92
13,15,14,1,16,19,1,12,0,91
13,15,14,1,18,3,8,0,0,72
13,15,14,1,18,3,8,1,12,85
13,15,14,1,18,3,8,25,0,97
13,15,14,1,18,3,8,9,3,84
13,15,14,1,18,3,8,15,0,87
13,15,14,1,18,3,8,19,0,91
13,15,14,1,18,4,1,19,0,85
13,15,14,1,19,0,0,0,0,62
13,15,14,1,19,5,0,0,0,67
13,15,14,1,19,20,5,18,0,105
13,15,14,1,19,20,5,18,25,130
13,15,14,1,19,20,9,3,0,94
13,15,14,1,19,20,9,3,19,113
13,15,14,1,20,15,13,9,3,103
13,15,14,1,21,12,0,0,0,76
13,15,14,1,21,12,9,0,0,85
13,15,14,1,21,12,15,19,0,110
13,15,14,1,21,18,1,12,0,95
13,15,14,1,24,0,0,0,0,67
13,15,14,1,24,9,1,12,0,89
13,15,14,1,24,9,12,5,0,93
13,15,14,1,24,15,14,0,0,96
13,15,14,1,24,15,14,9,3,108
13,15,14,1,24,15,14,19,0,115
13,15,14,1,26,9,14,5,0,97
13,15,14,1,26,9,20,5,0,103
13,15,14,1,26,9,20,5,19,122
13,15,14,4,1,9,14,0,0,70
13,15,14,4,1,9,14,5,0,75
13,15,14,4,5,0,0,0,0,51
13,15,14,4,5,7,15,0,0,73
13,15,14,4,5,19,0,0,0,70
13,15,14,4,9,1,12,0,0,68
13,15,14,4,15,0,0,0,0,61
13,15,14,4,15,19,0,0,0,80
13,15,14,4,19,5,5,0,0,75
13,15,14,5,0,0,0,0,0,47
13,15,14,5,3,9,1,14,0,74
13,15,14,5,3,9,15,21,19,114
13,15,14,5,4,21,12,1,0,85
13,15,14,5,25,0,0,0,0,72
13,15,14,5,25,1,7,5,0,85
13,15,14,5,25,2,1,7,0,82
13,15,14,5,25,2,1,7,19,101
13,15,14,5,25,5,4,0,0,81
13,15,14,5,25,5,18,0,0,95
13,15,14,5,25,5,18,19,0,114
13,15,14,5,25,7,18,21,2,120
13,15,14,5,25,9,14,7,0,102
13,15,14,5,25,12,5,19,19,127
13,15,14,5,25,13,1,11,5,102
13,15,14,5,25,13,1,14,0,100
13,15,14,5,25,19,0,0,0,91
13,15,14,5,25,23,9,19,5,128
13,15,14,5,25,23,15,18,20,148
13,15,14,5,12,12,9,14,0,94
13,15,14,5,13,5,0,0,0,65
13,15,14,5,16,9,3,0,0,75
13,15,14,5,18,0,0,0,0,65
13,15,14,5,18,1,12,0,0,78
13,15,14,5,18,1,14,0,0,80
13,15,14,5,18,7,9,3,0,84
13,15,14,5,18,7,9,19,13,113
13,15,14,5,18,7,9,19,20,120
13,15,14,5,18,9,3,0,0,77
13,15,14,5,18,15,14,0,0,94
13,15,14,5,18,15,14,19,0,113
13,15,14,5,18,21,12,1,0,99
13,15,14,5,19,9,1,0,0,76
13,15,14,5,19,20,0,0,0,86
13,15,14,5,20,1,18,25,0,111
13,15,14,5,20,8,0,0,0,75
13,15,14,5,20,9,19,5,0,100
13,15,14,5,20,9,19,5,4,104
13,15,14,5,20,9,19,5,19,119
13,15,14,5,20,9,20,5,0,101
13,15,14,5,20,9,26,5,0,107
13,15,14,5,20,9,26,5,4,111
13,15,14,5,20,9,26,5,19,126
13,15,14,7,0,0,0,0,0,49
13,15,14,7,3,15,18,14,0,99
13,15,14,7,5,5,19,5,0,83
13,15,14,7,5,18,0,0,0,72
13,15,14,7,5,18,5,4,0,81
13,15,14,7,5,18,5,18,0,95
13,15,14,7,5,18,25,0,0,97
13,15,14,7,5,18,9,14,7,102
13,15,14,7,5,18,19,0,0,91
13,15,14,7,12,5,18,0,0,84
13,15,14,7,15,5,0,0,0,69
13,15,14,7,15,5,19,0,0,88
13,15,14,7,15,12,19,0,0,95
13,15,14,7,15,15,19,5,0,103
13,15,14,7,15,19,0,0,0,83
13,15,14,7,18,5,12,0,0,84
13,15,14,7,18,5,12,12,25,121
13,15,14,7,18,5,12,19,0,103
13,15,14,7,19,20,0,0,0,88
13,15,14,25,0,0,0,0,0,67
13,15,14,9,1,12,0,0,0,64
13,15,14,9,3,0,0,0,0,54
13,15,14,9,3,11,5,18,0,88
13,15,14,9,3,11,5,18,19,107
13,15,14,9,5,4,0,0,0,60
13,15,14,9,5,18,0,0,0,74
13,15,14,9,5,19,0,0,0,75
13,15,14,9,11,5,18,0,0,85
13,15,14,9,11,5,18,19,0,104
13,15,14,9,12,1,20,5,4,93
13,15,14,9,12,9,1,12,0,85
13,15,14,9,12,9,15,9,4,100
13,15,14,9,13,5,14,20,0,103
13,15,14,9,19,8,0,0,0,78
13,15,14,9,19,8,5,4,0,87
13,15,14,9,19,8,5,18,0,101
13,15,14,9,19,8,5,19,0,102
13,15,14,9,19,8,9,14,7,108
13,15,14,9,19,13,0,0,0,83
13,15,14,9,19,13,19,0,0,102
13,15,14,9,19,20,0,0,0,90
13,15,14,9,19,20,9,3,0,102
13,15,14,9,19,20,19,0,0,109
13,15,14,9,20,1,18,25,0,115
13,15,14,9,20,9,15,14,0,109
13,15,14,9,20,9,15,14,19,128
13,15,14,9,20,9,22,5,0,107
13,15,14,9,20,15,18,0,0,104
13,15,14,9,20,15,18,5,4,113
13,15,14,9,20,15,18,25,0,129
13,15,14,9,20,15,18,19,0,123
13,15,14,9,20,18,5,19,19,132
13,15,14,9,20,18,9,24,0,122
13,15,14,11,2,9,18,4,0,86
13,15,14,11,3,18,1,6,20,101
13,15,14,11,4,15,13,0,0,85
13,15,14,11,5,25,0,0,0,83
13,15,14,11,5,25,5,4,0,92
13,15,14,11,5,25,6,25,0,114
13,15,14,11,5,25,9,14,7,113
13,15,14,11,5,25,9,19,8,119
13,15,14,11,5,25,9,19,13,124
13,15,14,11,5,25,14,21,20,138
13,15,14,11,5,25,16,15,4,118
13,15,14,11,5,25,16,15,20,134
13,15,14,11,5,25,18,25,0,126
13,15,14,11,5,25,19,0,0,102
13,15,14,11,5,18,25,0,0,101
13,15,14,11,5,18,9,5,19,109
13,15,14,11,5,19,19,0,0,96
13,15,14,11,6,9,19,8,0,95
13,15,14,11,8,15,15,4,0,95
13,15,14,11,8,15,15,4,19,114
13,15,14,11,9,19,8,0,0,89
13,15,14,11,9,19,8,12,25,126
13,15,14,11,9,19,13,0,0,94
13,15,14,11,12,25,0,0,0,90
13,15,14,11,12,9,11,5,0,90
13,15,14,11,19,0,0,0,0,72
13,15,14,11,19,8,9,16,0,105
13,15,14,11,19,8,15,15,4,114
13,15,14,14,25,0,0,0,0,81
13,15,14,14,9,11,5,18,0,99
13,15,14,14,9,15,14,0,0,94
13,15,14,15,1,3,9,4,0,74
13,15,14,15,1,3,9,4,19,93
13,15,14,15,1,13,9,4,0,84
13,15,14,15,1,13,9,4,5,89
13,15,14,15,1,13,9,14,0,94
13,15,14,15,1,13,9,14,5,99
13,15,14,15,1,13,9,14,15,109
13,15,14,15,1,26,15,0,0,99
13,15,14,15,2,1,19,5,0,84
13,15,14,15,2,1,19,9,3,91
13,15,14,15,2,1,20,8,0,88
13,15,14,15,2,12,15,3,0,89
13,15,14,15,3,1,2,12,5,80
13,15,14,15,3,1,18,16,0,95
13,15,14,15,3,1,18,16,19,114
13,15,14,15,3,5,18,3,15,101
13,15,14,15,3,8,12,15,18,113
13,15,14,15,3,8,15,18,4,105
13,15,14,15,3,25,3,12,5,105
13,15,14,15,3,25,3,12,25,125
13,15,14,15,3,25,20,5,0,110
13,15,14,15,3,25,20,5,19,129
13,15,14,15,3,25,20,9,3,117
13,15,14,15,3,12,5,0,0,77
13,15,14,15,3,12,5,4,0,81
13,15,14,15,3,12,5,9,4,90
13,15,14,15,3,12,5,19,0,96
13,15,14,15,3,12,9,14,5,100
13,15,14,15,3,15,17,21,5,118
13,15,14,15,3,15,20,0,0,95
13,15,14,15,3,15,20,25,12,132
13,15,14,15,3,15,20,19,0,114
13,15,14,15,3,18,1,3,25,107
13,15,14,15,3,18,1,20,0,99
13,15,14,15,3,18,1,20,19,118
13,15,14,15,3,21,12,1,18,112
13,15,14,15,3,21,12,5,0,98
13,15,14,15,3,21,12,21,19,133
13,15,14,15,4,5,12,16,8,102
13,15,14,15,4,25,0,0,0,86
13,15,14,15,4,9,3,0,0,73
13,15,14,15,4,9,3,1,12,86
13,15,14,15,4,9,5,19,0,94
13,15,14,15,4,9,19,20,0,109
13,15,14,15,4,9,19,20,19,128
13,15,14,15,4,9,26,5,0,101
13,15,14,15,4,15,14,20,0,110
13,15,14,15,4,18,1,13,0,93
13,15,14,15,4,18,1,13,1,94
13,15,14,15,4,18,1,13,5,98
13,15,14,15,4,18,15,13,25,132
13,15,14,15,5,3,25,0,0,90
13,15,14,15,5,3,9,1,14,89
13,15,14,15,5,3,9,5,19,98
13,15,14,15,5,3,9,19,13,106
13,15,14,15,5,9,4,9,3,87
13,15,14,15,5,19,20,5,18,124
13,15,14,15,6,9,12,0,0,84
13,15,14,15,6,9,12,13,0,97
13,15,14,15,6,9,12,19,0,103
13,15,14,15,6,21,5,12,0,101
13,15,14,15,6,21,5,12,19,120
13,15,14,15,7,1,13,25,0,103
13,15,14,15,7,1,13,9,3,90
13,15,14,15,7,1,13,9,11,98
13,15,14,15,7,1,13,15,21,114
13,15,14,15,7,5,14,5,0,88
13,15,14,15,7,5,14,25,0,108
13,15,14,15,7,5,14,9,3,95
13,15,14,15,7,5,18,13,0,100
13,15,14,15,7,25,14,25,0,128
13,15,14,15,7,25,14,9,1,113
13,15,14,15,7,25,14,9,3,115
13,15,14,15,7,12,15,20,0,111
13,15,14,15,7,15,14,25,0,118
13,15,14,15,7,18,1,13,0,96
13,15,14,15,7,18,1,13,13,109
13,15,14,15,7,18,1,13,19,115
13,15,14,15,7,18,1,16,8,107
13,15,14,15,8,21,12,12,0,110
13,15,14,15,9,3,15,21,19,124
13,15,14,15,9,4,0,0,0,70
13,15,14,15,11,9,14,9,0,100
13,15,14,15,12,1,25,5,18,118
13,15,14,15,12,1,20,5,18,113
13,15,14,15,12,1,20,18,25,133
13,15,14,15,12,9,14,5,0,97
13,15,14,15,12,9,20,8,0,106
13,15,14,15,12,9,20,8,19,125
13,15,14,15,12,15,7,0,0,91
13,15,14,15,12,15,7,25,0,116
13,15,14,15,12,15,7,9,3,103
13,15,14,15,12,15,7,19,0,110
13,15,14,15,12,15,7,21,5,117
13,15,14,15,13,1,3,8,25,107
13,15,14,15,13,1,9,12,0,92
13,15,14,15,13,1,14,9,1,95
13,15,14,15,13,1,18,11,0,100
13,15,14,15,13,5,18,0,0,93
13,15,14,15,13,5,18,9,3,105
13,15,14,15,13,5,18,19,0,112
13,15,14,15,13,5,20,5,18,118
13,15,14,15,13,9,1,12,0,92
13,15,14,15,13,9,1,12,19,111
13,15,14,15,13,25,1,18,25,139
13,15,14,15,13,9,3,20,0,102
13,15,14,15,14,3,8,0,0,82
13,15,14,15,14,25,13,0,0,109
13,15,14,15,14,25,13,25,0,134
13,15,14,15,14,25,13,9,3,121
13,15,14,15,14,20,0,0,0,91
13,15,14,15,16,1,20,8,25,127
13,15,14,15,16,8,1,7,25,114
13,15,14,15,16,8,1,19,5,106
13,15,14,15,16,8,15,9,3,108
13,15,14,15,16,8,15,14,5,115
13,15,14,15,16,8,15,14,25,135
13,15,14,15,16,8,15,20,5,121
13,15,14,15,16,9,20,3,8,113
13,15,14,15,16,12,1,3,5,94
13,15,14,15,16,12,1,14,5,105
13,15,14,15,16,12,1,19,20,125
13,15,14,15,16,12,15,9,4,113
13,15,14,15,16,15,4,5,0,97
13,15,14,15,16,15,4,5,19,116
13,15,14,15,16,15,4,25,0,117
13,15,14,15,16,15,4,9,1,102
13,15,14,15,16,15,4,9,3,104
13,15,14,15,16,15,12,1,18,119
13,15,14,15,16,15,12,5,0,105
13,15,14,15,16,15,12,5,19,124
13,15,14,15,16,19,15,14,25,146
13,15,14,15,16,20,5,18,1,117
13,15,14,15,16,20,9,3,0,105
13,15,14,15,16,20,15,20,5,133
13,15,14,15,18,1,9,12,0,97
13,15,14,15,18,1,9,12,19,116
13,15,14,15,18,3,8,9,4,99
13,15,14,15,18,3,8,9,19,114
13,15,14,15,18,8,25,13,5,126
13,15,14,15,18,8,9,14,5,111
13,15,14,15,18,9,13,5,0,102
13,15,14,15,19,0,0,0,0,76
13,15,14,15,19,3,15,16,5,115
13,15,14,15,19,5,0,0,0,81
13,15,14,15,19,5,13,25,0,119
13,15,14,15,19,5,13,9,3,106
13,15,14,15,19,11,9,0,0,96
13,15,14,15,19,15,13,5,0,109
13,15,14,15,19,15,13,5,19,128
13,15,14,15,19,15,13,25,0,129
13,15,14,15,19,15,13,9,3,116
13,15,14,15,19,16,1,3,5,101
13,15,14,15,19,16,5,18,13,128
13,15,14,15,19,16,15,18,5,130
13,15,14,15,19,20,5,12,5,118
13,15,14,15,19,20,5,12,25,138
13,15,14,15,19,20,9,3,8,116
13,15,14,15,19,20,15,13,5,129
13,15,14,15,20,9,3,0,0,89
13,15,14,15,20,9,14,20,0,120
13,15,14,15,20,9,14,20,19,139
13,15,14,15,20,25,16,1,12,131
13,15,14,15,20,25,16,5,19,142
13,15,14,15,20,25,16,9,3,130
13,15,14,15,20,15,14,1,12,119
13,15,14,15,20,15,14,5,0,111
13,15,14,15,20,15,14,5,19,130
13,15,14,15,20,15,14,25,0,131
13,15,14,15,20,15,14,9,3,118
13,15,14,15,20,18,5,13,5,118
13,15,14,15,20,18,15,14,0,124
13,15,14,15,20,18,15,16,25,151
13,15,14,15,22,21,12,1,18,131
13,15,14,15,24,9,4,5,0,99
13,15,14,15,24,9,4,5,19,118
13,15,14,15,24,25,12,1,0,119
13,15,14,15,24,25,12,5,0,123
13,15,14,15,24,25,12,9,3,130
13,15,14,15,24,25,12,15,14,147
13,15,14,15,24,9,13,5,0,108
13,15,14,15,26,15,1,14,0,113
13,15,14,15,26,15,9,3,0,110
13,15,14,18,15,12,9,20,5,121
13,15,14,19,9,1,0,0,0,71
13,15,14,19,9,5,21,18,0,114
13,15,14,19,9,5,21,18,19,133
13,15,14,19,15,15,14,0,0,105
13,15,14,19,15,15,14,1,12,118
13,15,14,19,15,15,14,19,0,124
13,15,14,19,16,5,18,13,25,138
13,15,14,19,20,5,18,0,0,104
13,15,14,19,20,5,18,19,0,123
13,15,14,19,20,18,1,20,5,125
13,15,14,19,20,18,9,6,25,139
13,15,14,19,20,18,15,21,19,154
13,15,14,20,1,2,25,14,0,104
13,15,14,20,1,4,1,12,5,85
13,15,14,20,1,7,5,0,0,75
13,15,14,20,1,7,5,4,0,79
13,15,14,20,1,7,5,19,0,94
13,15,14,20,1,7,9,14,7,100
13,15,14,20,1,7,14,5,0,89
13,15,14,20,1,14,1,14,19,111
13,15,14,20,1,14,1,19,0,97
13,15,14,20,1,14,5,0,0,82
13,15,14,20,1,14,5,19,0,101
13,15,14,20,1,14,9,3,0,89
13,15,14,20,1,14,9,14,0,100
13,15,14,20,1,14,9,20,5,111
13,15,14,20,1,14,20,0,0,97
13,15,14,20,1,14,20,15,0,112
13,15,14,20,5,7,18,5,0,97
13,15,14,20,5,9,20,8,19,123
13,15,14,20,5,13,0,0,0,80
13,15,14,20,5,18,1,0,0,86
13,15,14,20,5,18,15,0,0,100
13,15,14,20,5,18,15,19,0,119
13,15,14,20,8,0,0,0,0,70
13,15,14,20,8,12,25,0,0,107
13,15,14,20,8,12,9,5,19,115
13,15,14,20,8,12,15,14,7,118
13,15,14,20,8,15,14,0,0,99
13,15,14,20,8,19,0,0,0,89
13,15,14,20,9,3,12,5,0,91
13,15,14,20,9,3,15,12,1,102
13,15,14,20,9,3,21,12,5,112
13,15,14,20,9,6,15,18,13,123
13,15,14,20,9,12,12,1,0,96
13,15,14,20,10,15,25,0,0,112
13,15,14,20,10,15,25,5,0,117
13,15,14,20,15,14,0,0,0,91
13,15,14,20,18,5,0,0,0,85
13,15,14,20,18,15,19,19,0,133
13,15,14,20,21,18,5,0,0,106
13,15,14,20,21,22,9,15,0,129
13,15,14,21,13,5,14,20,0,115
13,15,14,21,13,5,14,20,19,134
13,15,14,21,18,15,14,0,0,110
13,15,14,21,18,15,14,19,0,129
13,15,14,26,15,14,9,20,5,131
13,15,15,0,0,0,0,0,0,43
13,15,15,3,1,8,0,0,0,55
13,15,15,3,8,0,0,0,0,54
13,15,15,3,8,1,0,0,0,55
13,15,15,3,8,5,4,0,0,63
13,15,15,3,8,5,18,0,0,77
13,15,15,3,8,5,18,19,0,96
13,15,15,3,8,5,19,0,0,78
13,15,15,3,8,9,14,7,0,84
13,15,15,3,8,21,12,11,1,99
13,15,15,4,0,0,0,0,0,47
13,15,15,4,5,18,0,0,0,70
13,15,15,4,9,5,18,0,0,79
13,15,15,4,9,5,19,20,0,100
13,15,15,4,9,12,25,0,0,93
13,15,15,4,9,14,5,19,19,113
13,15,15,4,9,18,0,0,0,74
13,15,15,4,9,19,8,0,0,83
13,15,15,4,9,19,8,12,25,120
13,15,15,4,12,5,0,0,0,64
13,15,15,4,19,0,0,0,0,66
13,15,15,5,4,0,0,0,0,52
13,15,15,9,14,7,0,0,0,73
13,15,15,11,8,20,1,18,0,101
13,15,15,11,20,1,18,0,0,93
13,15,15,12,0,0,0,0,0,55
13,15,15,12,1,0,0,0,0,56
13,15,15,12,1,8,0,0,0,64
13,15,15,12,1,8,19,0,0,83
13,15,15,12,1,19,0,0,0,75
13,15,15,12,5,25,0,0,0,85
13,15,15,12,5,25,19,0,0,104
13,15,15,12,5,20,0,0,0,80
13,15,15,12,9,14,7,19,0,104
13,15,15,12,19,0,0,0,0,74
13,15,15,12,21,13,0,0,0,89
13,15,15,12,22,5,5,0,0,87
13,15,15,12,22,9,0,0,0,86
13,15,15,12,22,9,5,0,0,91
13,15,15,14,1,3,11,0,0,72
13,15,15,14,1,12,0,0,0,70
13,15,15,14,2,5,1,13,0,78
13,15,15,14,2,5,1,13,19,97
13,15,15,14,2,9,12,12,0,92
13,15,15,14,2,12,9,14,4,98
13,15,15,14,2,12,9,14,11,105
13,15,15,14,2,15,23,0,0,97
13,15,15,14,2,15,23,19,0,116
13,15,15,14,3,1,12,6,0,79
13,15,15,14,4,15,7,0,0,83
13,15,15,14,4,15,23,14,0,113
13,15,15,14,4,18,15,16,0,110
13,15,15,14,5,4,0,0,0,66
13,15,15,14,5,25,5,0,0,92
13,15,15,14,5,25,5,19,0,111
13,15,15,14,5,18,0,0,0,80
13,15,15,14,5,18,25,0,0,105
13,15,15,14,5,20,0,0,0,82
13,15,15,14,6,1,3,5,0,72
13,15,15,14,6,1,3,5,4,76
13,15,15,14,6,1,12,12,0,88
13,15,15,14,6,9,19,8,0,99
13,15,15,14,7,0,0,0,0,64
13,15,15,14,7,12,1,4,5,86
13,15,15,14,7,12,15,23,0,114
13,15,15,14,8,5,1,4,0,75
13,15,15,14,25,0,0,0,0,82
13,15,15,14,9,5,0,0,0,71
13,15,15,14,9,5,19,20,0,110
13,15,15,14,9,12,25,0,0,103
13,15,15,14,9,14,5,19,19,123
13,15,15,14,9,14,7,0,0,87
13,15,15,14,9,19,8,0,0,93
13,15,15,14,9,19,8,12,25,130
13,15,15,14,9,20,5,0,0,91
13,15,15,14,10,1,0,0,0,68
13,15,15,14,10,1,8,0,0,76
13,15,15,14,12,5,19,19,0,112
13,15,15,14,12,5,20,0,0,94
13,15,15,14,12,5,20,19,0,113
13,15,15,14,12,9,7,8,20,113
13,15,15,14,12,9,11,5,0,94
13,15,15,14,12,9,14,7,0,99
13,15,15,14,12,9,20,0,0,98
13,15,15,14,13,1,14,0,0,85
13,15,15,14,13,5,14,0,0,89
13,15,15,14,16,1,20,8,0,102
13,15,15,14,16,5,14,14,25,131
13,15,15,14,16,15,18,20,0,126
13,15,15,14,16,18,15,15,6,127
13,15,15,14,17,21,1,11,5,112
13,15,15,14,18,1,11,5,18,110
13,15,15,14,18,1,20,0,0,96
13,15,15,14,18,9,19,5,0,108
13,15,15,14,18,9,19,5,19,127
13,15,15,14,19,0,0,0,0,76
13,15,15,14,19,1,9,12,0,98
13,15,15,14,19,1,9,12,19,117
13,15,15,14,19,3,1,16,5,101
13,15,15,14,19,5,5,4,0,90
13,15,15,14,19,5,5,4,19,109
13,15,15,14,19,5,20,0,0,101
13,15,15,14,19,5,20,19,0,120
13,15,15,14,19,8,1,4,5,94
13,15,15,14,19,8,5,5,0,94
13,15,15,14,19,8,9,14,5,112
13,15,15,14,19,8,9,14,25,132
13,15,15,14,19,8,15,20,0,119
13,15,15,14,19,8,15,20,19,138
13,15,15,14,19,9,3,11,0,99
13,15,15,14,19,9,6,0,0,91
13,15,15,14,19,20,15,14,5,130
13,15,15,14,20,9,4,5,0,95
13,15,15,14,23,1,25,0,0,106
13,15,15,14,23,1,12,11,0,104
13,15,15,14,23,1,12,11,19,123
13,15,15,14,23,1,18,4,0,103
13,15,15,14,23,1,18,4,19,122
13,15,15,14,23,15,18,20,0,133
13,15,15,14,23,15,18,20,19,152
13,15,15,16,0,0,0,0,0,59
13,15,15,18,1,7,5,0,0,74
13,15,15,18,1,7,5,19,0,93
13,15,15,18,2,1,12,12,0,88
13,15,15,18,2,1,14,4,0,82
13,15,15,18,2,5,18,18,25,129
13,15,15,18,2,9,18,4,0,94
13,15,15,18,2,21,18,14,0,116
13,15,15,18,3,15,3,11,0,93
13,15,15,18,5,4,0,0,0,70
13,15,15,18,5,19,19,0,0,104
13,15,15,18,6,15,23,12,0,117
13,15,15,18,6,15,23,12,19,136
13,15,15,18,8,5,14,0,0,88
13,15,15,18,8,5,14,19,0,107
13,15,15,18,25,0,0,0,0,86
13,15,15,18,9,5,18,0,0,93
13,15,15,18,9,5,19,20,0,114
13,15,15,18,9,14,7,0,0,91
13,15,15,18,9,14,7,19,0,110
13,15,15,18,9,19,8,12,25,134
13,15,15,18,12,1,14,4,19,111
13,15,15,18,13,5,14,0,0,93
13,15,15,18,14,0,0,0,0,75
13,15,15,18,16,1,14,0,0,92
13,15,15,18,16,21,14,11,25,148
13,15,15,18,19,0,0,0,0,80
13,15,15,18,19,13,1,14,0,108
13,15,15,18,19,20,15,14,5,134
13,15,15,18,21,11,0,0,0,93
13,15,15,18,21,16,0,0,0,98
13,15,15,18,23,15,18,20,0,137
13,15,15,18,23,15,18,20,19,156
13,15,15,19,0,0,0,0,0,62
13,15,15,19,1,0,0,0,0,63
13,15,15,19,5,0,0,0,0,67
13,15,15,19,5,2,9,18,4,100
13,15,15,19,5,2,21,19,8,117
13,15,15,19,5,3,1,12,12,95
13,15,15,19,5,8,15,15,4,109
13,15,15,19,5,25,0,0,0,92
13,15,15,19,5,13,9,12,11,112
13,15,15,19,5,13,9,19,5,113
13,15,15,19,5,23,15,2,0,107
13,15,15,19,5,23,15,15,4,124
13,15,15,19,20,0,0,0,0,82
13,15,15,20,0,0,0,0,0,63
13,15,15,20,1,2,12,5,0,83
13,15,15,20,3,8,0,0,0,74
13,15,15,20,5,4,0,0,0,72
13,15,15,20,5,18,0,0,0,86
13,15,15,20,5,18,19,0,0,105
13,15,15,20,8,0,0,0,0,71
13,15,15,20,9,14,7,0,0,93
13,15,15,20,13,1,14,0,0,91
13,15,15,20,13,5,14,0,0,95
13,15,15,20,14,5,19,19,0,120
13,15,15,20,19,0,0,0,0,82
13,15,15,20,19,20,5,1,4,112
13,15,15,20,19,21,4,4,25,136
13,15,16,1,14,5,0,0,0,64
13,15,16,1,14,9,0,0,0,68
13,15,16,2,15,1,18,4,0,84
13,15,16,2,15,1,18,4,19,103
13,15,16,5,0,0,0,0,0,49
13,15,16,5,4,0,0,0,0,53
13,15,16,5,4,5,18,0,0,76
13,15,16,5,4,5,18,19,0,95
13,15,16,5,4,19,0,0,0,72
13,15,16,5,8,1,23,11,0,92
13,15,16,5,25,0,0,0,0,74
13,15,16,5,9,5,18,0,0,81
13,15,16,5,9,5,19,20,0,102
13,15,16,5,18,0,0,0,0,67
13,15,16,5,18,25,0,0,0,92
13,15,16,5,18,9,5,19,0,100
13,15,16,5,18,19,0,0,0,86
13,15,16,5,19,0,0,0,0,68
13,15,16,8,0,0,0,0,0,52
13,15,16,8,5,1,4,0,0,62
13,15,16,8,5,1,4,5,4,71
13,15,16,25,0,0,0,0,0,69
13,15,16,9,5,18,0,0,0,76
13,15,16,9,5,19,20,0,0,97
13,15,16,9,14,7,0,0,0,74
13,15,16,9,14,7,12,25,0,111
13,15,16,9,19,8,0,0,0,80
13,15,16,9,19,8,12,25,0,117
13,15,16,12,1,0,0,0,0,57
13,15,16,12,1,8,0,0,0,65
13,15,16,15,11,5,0,0,0,75
13,15,16,15,11,5,19,0,0,94
13,15,16,16,5,4,0,0,0,69
13,15,16,16,5,18,0,0,0,83
13,15,16,16,5,18,19,0,0,102
13,15,16,16,5,20,0,0,0,85
13,15,16,16,5,20,19,0,0,104
13,15,16,16,25,0,0,0,0,85
13,15,16,16,9,14,7,0,0,90
13,15,16,19,0,0,0,0,0,63
13,15,16,19,5,25,0,0,0,93
13,15,16,19,25,0,0,0,0,88
13,15,16,19,20,9,3,11,0,106
13,15,16,21,19,0,0,0,0,84
13,15,16,21,19,5,19,0,0,108
13,15,16,21,19,19,5,19,0,127
13,15,17,21,5,20,20,5,0,116
13,15,17,21,5,20,20,5,19,135
13,15,18,1,2,9,20,0,0,78
13,15,18,1,3,5,15,21,19,110
13,15,18,1,4,1,0,0,0,52
13,15,18,1,5,0,0,0,0,52
13,15,18,1,9,14,1,12,0,83
13,15,18,1,9,14,5,0,0,75
13,15,18,1,9,14,5,19,0,94
13,15,18,1,9,14,9,3,0,82
13,15,18,1,25,19,0,0,0,91
13,15,18,1,12,0,0,0,0,59
13,15,18,1,12,5,0,0,0,64
13,15,18,1,12,5,18,0,0,82
13,15,18,1,12,5,19,0,0,83
13,15,18,1,12,9,19,5,0,92
13,15,18,1,12,9,19,5,4,96
13,15,18,1,12,9,19,5,19,111
13,15,18,1,12,9,19,13,0,100
13,15,18,1,12,9,19,13,19,119
13,15,18,1,12,9,19,20,0,107
13,15,18,1,12,9,19,20,19,126
13,15,18,1,12,9,20,25,0,113
13,15,18,1,12,9,26,5,0,99
13,15,18,1,12,9,26,5,4,103
13,15,18,1,12,9,26,5,18,117
13,15,18,1,12,9,26,5,19,118
13,15,18,1,12,12,5,18,0,94
13,15,18,1,12,12,5,19,19,114
13,15,18,1,12,12,25,0,0,96
13,15,18,1,12,14,5,19,19,116
13,15,18,1,12,19,0,0,0,78
13,15,18,1,19,0,0,0,0,66
13,15,18,1,19,19,0,0,0,85
13,15,18,1,19,19,5,19,0,109
13,15,18,1,19,19,25,0,0,110
13,15,18,1,19,19,9,3,0,97
13,15,18,1,20,0,0,0,0,67
13,15,18,1,20,5,0,0,0,72
13,15,18,1,20,9,15,14,0,105
13,15,18,1,20,15,18,25,0,125
13,15,18,1,20,15,18,9,1,110
13,15,18,1,22,9,20,5,0,103
13,15,18,2,9,4,0,0,0,61
13,15,18,2,9,4,9,20,25,115
13,15,18,2,9,4,9,26,5,101
13,15,18,2,9,4,12,25,0,98
13,15,18,2,9,6,25,0,0,88
13,15,18,2,9,6,9,3,0,75
13,15,18,2,9,12,9,20,25,123
13,15,18,2,9,12,12,9,0,90
13,15,18,2,12,5,21,0,0,86
13,15,18,2,15,19,5,0,0,87
13,15,18,2,21,19,0,0,0,88
13,15,18,3,5,1,21,0,0,76
13,15,18,3,5,1,21,24,0,100
13,15,18,3,8,1,0,0,0,58
13,15,18,4,1,3,9,20,25,108
13,15,18,4,1,14,3,25,0,93
13,15,18,4,1,14,20,0,0,85
13,15,18,4,1,14,20,5,4,94
13,15,18,4,1,14,20,12,25,122
13,15,18,4,1,14,20,19,0,104
13,15,18,4,5,12,12,9,4,92
13,15,18,4,5,14,9,20,5,103
13,15,18,4,5,14,20,0,0,89
13,15,18,4,5,14,20,19,0,108
13,15,18,4,9,3,1,14,20,97
13,15,18,4,9,3,1,20,5,88
13,15,18,4,9,5,21,0,0,85
13,15,18,4,15,18,5,0,0,88
13,15,18,4,21,0,0,0,0,71
13,15,18,5,0,0,0,0,0,51
13,15,18,5,5,14,19,0,0,89
13,15,18,5,6,15,12,4,0,88
13,15,18,5,9,19,8,0,0,87
13,15,18,5,12,12,1,0,0,76
13,15,18,5,12,12,5,0,0,80
13,15,18,5,12,12,5,19,0,99
13,15,18,5,12,12,15,0,0,90
13,15,18,5,12,12,15,19,0,109
13,15,18,5,12,19,0,0,0,82
13,15,18,5,14,3,9,20,5,102
13,15,18,5,14,4,15,0,0,84
13,15,18,5,14,5,19,19,0,108
13,15,18,5,14,9,20,1,0,95
13,15,18,5,15,22,5,18,0,111
13,15,18,5,16,5,15,14,0,101
13,15,18,5,16,15,18,11,0,111
13,15,18,5,19,0,0,0,0,70
13,15,18,5,19,17,21,5,19,132
13,15,18,6,15,14,4,0,0,85
13,15,18,6,15,21,14,4,0,106
13,15,18,6,18,5,25,0,0,100
13,15,18,7,0,0,0,0,0,53
13,15,18,7,1,0,0,0,0,54
13,15,18,7,1,25,0,0,0,79
13,15,18,7,1,14,9,3,0,80
13,15,18,7,1,14,9,20,5,102
13,15,18,7,1,14,9,26,5,108
13,15,18,7,5,14,19,0,0,91
13,15,18,7,12,1,25,0,0,91
13,15,18,7,21,5,0,0,0,79
13,15,18,7,21,5,19,0,0,98
13,15,18,9,1,14,0,0,0,70
13,15,18,9,2,21,14,4,0,96
13,15,18,9,3,0,0,0,0,58
13,15,18,9,3,8,5,0,0,71
13,15,18,9,6,15,18,13,0,107
13,15,18,9,7,12,9,15,0,98
13,15,18,9,12,12,15,14,0,108
13,15,18,9,14,0,0,0,0,69
13,15,18,9,14,4,9,14,0,96
13,15,18,9,14,4,15,14,5,107
13,15,18,9,14,5,12,0,0,86
13,15,18,9,14,7,1,4,0,81
13,15,18,9,14,7,21,9,4,110
13,15,18,9,15,14,0,0,0,84
13,15,18,9,15,14,19,0,0,103
13,15,18,9,19,8,0,0,0,82
13,15,18,11,9,14,0,0,0,80
13,15,18,12,9,14,7,0,0,88
13,15,18,12,15,16,0,0,0,89
13,15,18,13,1,5,18,0,0,83
13,15,18,13,1,12,0,0,0,72
13,15,18,13,1,15,18,0,0,93
13,15,18,13,25,18,0,0,0,102
13,15,18,13,25,18,5,0,0,107
13,15,18,13,25,18,9,1,14,126
13,15,18,13,25,18,9,4,0,115
13,15,18,13,25,18,15,9,4,130
13,15,18,13,15,0,0,0,0,74
13,15,18,13,15,14,19,0,0,107
13,15,18,14,0,0,0,0,0,60
13,15,18,14,5,0,0,0,0,65
13,15,18,14,5,4,0,0,0,69
13,15,18,14,5,20,20,5,0,110
13,15,18,14,9,14,7,12,25,127
13,15,18,14,9,14,7,19,0,109
13,15,18,14,12,5,19,19,0,115
13,15,18,14,12,9,11,5,0,97
13,15,18,14,19,0,0,0,0,79
13,15,18,14,20,9,13,5,0,107
13,15,18,14,23,1,18,4,0,106
13,15,18,15,3,0,0,0,0,64
13,15,18,15,3,1,9,14,0,88
13,15,18,15,3,3,1,14,19,101
13,15,18,15,3,3,15,19,0,101
13,15,18,15,3,15,20,1,0,100
13,15,18,15,12,15,7,25,0,120
13,15,18,15,13,1,14,3,25,117
13,15,18,15,14,0,0,0,0,75
13,15,18,15,14,3,25,0,0,103
13,15,18,15,14,5,0,0,0,80
13,15,18,15,14,5,19,0,0,99
13,15,18,15,14,7,0,0,0,82
13,15,18,15,14,9,3,0,0,87
13,15,18,15,14,9,19,13,0,116
13,15,18,15,14,9,19,13,19,135
13,15,18,15,14,9,20,25,0,129
13,15,18,15,14,18,25,0,0,118
13,15,18,15,14,19,0,0,0,94
13,15,18,15,18,0,0,0,0,79
13,15,18,15,19,5,0,0,0,85
13,15,18,15,19,5,12,25,0,122
13,15,18,15,19,9,19,0,0,108
13,15,18,15,19,9,20,25,0,134
13,15,18,15,19,15,16,8,0,119
13,15,18,15,24,9,20,5,0,119
13,15,18,16,8,0,0,0,0,70
13,15,18,16,8,5,1,0,0,76
13,15,18,16,8,5,13,5,0,93
13,15,18,16,8,5,13,5,19,112
13,15,18,16,8,5,13,9,3,100
13,15,18,16,8,5,20,9,3,107
13,15,18,16,8,5,23,0,0,98
13,15,18,16,8,7,1,14,0,92
13,15,18,16,8,25,0,0,0,95
13,15,18,16,8,9,1,0,0,80
13,15,18,16,8,9,1,19,0,99
13,15,18,16,8,9,1,20,5,105
13,15,18,16,8,9,3,0,0,82
13,15,18,16,8,9,14,0,0,93
13,15,18,16,8,9,14,5,0,98
13,15,18,16,8,9,14,5,19,117
13,15,18,16,8,9,14,9,3,105
13,15,18,16,8,9,14,19,0,112
13,15,18,16,8,9,19,13,0,111
13,15,18,16,8,9,19,13,19,130
13,15,18,16,8,9,26,5,4,114
13,15,18,16,8,15,12,0,0,97
13,15,18,16,8,15,12,9,14,120
13,15,18,16,8,15,14,0,0,99
13,15,18,16,8,15,19,0,0,104
13,15,18,16,8,15,19,5,19,128
13,15,18,16,8,15,19,9,19,132
13,15,18,16,8,15,20,9,3,117
13,15,18,16,8,15,21,19,0,125
13,15,18,16,8,18,5,25,0,118
13,15,18,16,8,19,0,0,0,89
13,15,18,16,9,15,14,0,0,100
13,15,18,16,21,14,11,5,5,118
13,15,18,18,8,21,1,20,5,119
13,15,18,18,8,21,9,14,0,116
13,15,18,18,8,21,9,14,5,121
13,15,18,18,9,3,5,18,0,99
13,15,18,18,9,15,14,0,0,102
13,15,18,18,9,15,14,19,0,121
13,15,18,18,9,19,5,19,0,116
13,15,18,18,15,0,0,0,0,79
13,15,18,18,15,19,0,0,0,98
13,15,18,18,15,23,9,14,7,132
13,15,18,18,15,23,19,0,0,121
13,15,18,19,1,12,0,0,0,78
13,15,18,19,5,12,0,0,0,82
13,15,18,19,5,12,5,4,0,91
13,15,18,19,5,12,9,14,7,112
13,15,18,19,5,12,9,26,5,122
13,15,18,19,5,12,12,5,4,103
13,15,18,19,5,12,19,0,0,101
13,15,18,19,9,14,7,0,0,95
13,15,18,19,21,18,5,0,0,109
13,15,18,20,1,12,0,0,0,79
13,15,18,20,1,12,9,19,13,120
13,15,18,20,1,12,9,19,20,127
13,15,18,20,1,12,9,20,25,133
13,15,18,20,1,12,9,26,5,119
13,15,18,20,1,12,12,25,0,116
13,15,18,20,1,12,19,0,0,98
13,15,18,20,1,12,20,25,0,124
13,15,18,20,1,18,0,0,0,85
13,15,18,20,1,18,5,4,0,94
13,15,18,20,1,18,25,0,0,110
13,15,18,20,1,18,9,14,7,115
13,15,18,20,1,18,9,26,5,125
13,15,18,20,1,18,19,0,0,104
13,15,18,20,2,5,12,12,0,97
13,15,18,20,3,12,15,20,8,124
13,15,18,20,5,13,0,0,0,84
13,15,18,20,7,1,7,5,0,86
13,15,18,20,7,1,7,5,4,90
13,15,18,20,7,1,7,5,5,91
13,15,18,20,7,1,7,5,18,104
13,15,18,20,7,1,7,5,19,105
13,15,18,20,7,1,7,15,18,114
13,15,18,20,8,0,0,0,0,74
13,15,18,20,9,3,5,0,0,83
13,15,18,20,9,3,5,4,0,87
13,15,18,20,9,3,5,18,0,101
13,15,18,20,9,3,5,19,0,102
13,15,18,20,9,3,9,1,14,102
13,15,18,20,9,3,9,14,7,108
13,15,18,20,9,5,18,0,0,98
13,15,18,20,9,6,25,0,0,106
13,15,18,20,9,6,9,3,0,93
13,15,18,20,9,6,9,5,4,99
13,15,18,20,9,6,9,5,18,113
13,15,18,20,9,6,9,5,19,114
13,15,18,20,9,19,0,0,0,94
13,15,18,20,9,19,5,0,0,99
13,15,18,20,9,19,5,4,0,103
13,15,18,20,9,19,5,18,0,117
13,15,18,20,9,19,5,18,19,136
13,15,18,20,9,19,5,19,0,118
13,15,18,20,9,19,9,14,7,124
13,15,18,20,12,1,11,5,0,95
13,15,18,20,12,9,14,7,0,108
13,15,18,20,13,1,9,14,0,103
13,15,18,20,13,1,9,14,19,122
13,15,18,20,15,18,9,15,0,123
13,15,18,20,18,5,19,19,0,127
13,15,18,20,18,5,21,24,0,134
13,15,18,20,18,5,23,5,19,136
13,15,18,20,19,0,0,0,0,85
13,15,18,20,21,1,18,25,0,131
13,15,18,20,21,15,21,19,0,142
13,15,18,21,12,1,0,0,0,80
13,15,18,21,12,1,5,0,0,85
13,15,18,21,12,1,18,0,0,98
13,15,18,21,12,1,19,0,0,99
13,15,18,21,12,5,0,0,0,84
13,15,18,21,12,15,9,4,0,107
13,15,18,23,0,0,0,0,0,69
13,15,18,23,15,14,7,0,0,105
13,15,19,1,9,3,9,19,13,101
13,15,19,1,9,3,9,19,20,108
13,15,19,1,9,3,11,5,4,80
13,15,19,1,9,3,19,0,0,79
13,15,19,1,14,0,0,0,0,62
13,15,19,1,19,1,21,18,0,107
13,15,19,3,8,1,20,5,0,84
13,15,19,3,8,1,20,5,12,96
13,15,19,3,8,9,14,5,0,86
13,15,19,5,25,0,0,0,0,77
13,15,19,5,25,5,4,0,0,86
13,15,19,5,25,9,14,7,0,107
13,15,19,5,25,19,0,0,0,96
13,15,19,5,19,9,20,5,0,105
13,15,19,5,20,20,5,0,0,97
13,15,19,8,1,22,0,0,0,78
13,15,19,8,1,22,9,13,0,100
13,15,19,11,0,0,0,0,0,58
13,15,19,11,5,14,5,5,18,105
13,15,19,11,5,18,0,0,0,81
13,15,19,11,19,0,0,0,0,77
13,15,19,12,9,14,7,19,0,108
13,15,19,15,3,5,3,1,0,74
13,15,19,15,3,5,3,21,13,107
13,15,19,17,21,5,0,0,0,90
13,15,19,17,21,5,12,5,20,127
13,15,19,17,21,5,19,0,0,109
13,15,19,17,21,9,19,8,0,121
13,15,19,17,21,9,20,1,12,127
13,15,19,17,21,9,20,15,19,148
13,15,19,19,2,1,3,11,0,83
13,15,19,19,2,1,3,11,19,102
13,15,19,19,2,5,18,18,25,134
13,15,19,19,5,4,0,0,0,75
13,15,19,19,5,18,0,0,0,89
13,15,19,19,5,18,25,0,0,114
13,15,19,19,5,18,19,0,0,108
13,15,19,19,5,19,0,0,0,90
13,15,19,19,6,21,12,0,0,105
13,15,19,19,8,5,1,4,0,84
13,15,19,19,8,15,18,14,0,121
13,15,19,19,25,0,0,0,0,91
13,15,19,19,25,2,1,3,11,108
13,15,19,19,9,5,0,0,0,80
13,15,19,19,9,5,18,0,0,98
13,15,19,19,9,5,19,20,0,119
13,15,19,19,9,14,5,19,19,132
13,15,19,19,9,14,7,0,0,96
13,15,19,19,12,5,19,19,0,121
13,15,19,19,12,9,11,5,0,103
13,15,19,19,15,0,0,0,0,81
13,15,19,19,23,15,18,20,0,142
13,15,19,20,0,0,0,0,0,67
13,15,19,20,4,5,1,12,0,89
13,15,19,20,5,0,0,0,0,72
13,15,19,20,5,19,20,0,0,111
13,15,19,20,5,19,20,19,0,130
13,15,19,20,9,3,0,0,0,79
13,15,19,20,12,25,0,0,0,104
13,15,19,20,12,9,11,5,0,104
13,15,19,20,12,9,14,7,19,128
13,15,19,20,14,5,19,19,0,124
13,15,19,20,18,1,0,0,0,86
13,15,19,20,19,0,0,0,0,86
13,15,19,20,23,8,1,20,0,119
13,15,19,21,18,0,0,0,0,86
13,15,20,1,0,0,0,0,0,49
13,15,20,1,3,9,12,0,0,73
13,15,20,1,20,15,18,25,0,127
13,15,20,5,0,0,0,0,0,53
13,15,20,5,4,0,0,0,0,57
13,15,20,5,25,0,0,0,0,78
13,15,20,5,12,0,0,0,0,65
13,15,20,5,12,5,19,19,0,108
13,15,20,5,12,19,0,0,0,84
13,15,20,5,18,0,0,0,0,71
13,15,20,5,19,0,0,0,0,72
13,15,20,5,20,0,0,0,0,73
13,15,20,5,20,19,0,0,0,92
13,15,20,5,20,20,9,19,20,141
13,15,20,5,20,21,19,0,0,113
13,15,20,8,2,1,12,12,0,83
13,15,20,8,2,1,12,12,19,102
13,15,20,8,5,4,0,0,0,65
13,15,20,8,5,18,4,15,13,111
13,15,20,8,5,18,5,4,0,88
13,15,20,8,5,18,5,18,0,102
13,15,20,8,5,18,5,18,19,121
13,15,20,8,5,18,25,0,0,104
13,15,20,8,5,18,9,14,7,109
13,15,20,8,5,18,11,9,14,113
13,15,20,8,5,18,12,25,0,116
13,15,20,8,5,18,19,0,0,98
13,15,20,8,25,0,0,0,0,81
13,15,20,8,9,5,18,0,0,88
13,15,20,8,9,5,19,20,0,109
13,15,20,8,12,5,19,19,0,111
13,15,20,8,12,9,11,5,0,93
13,15,20,8,16,18,15,15,6,126
13,15,20,8,19,0,0,0,0,75
13,15,20,8,23,15,18,13,0,125
13,15,20,9,6,0,0,0,0,63
13,15,20,9,6,9,3,0,0,75
13,15,20,9,6,19,0,0,0,82
13,15,20,25,11,1,0,0,0,85
13,15,20,9,12,5,0,0,0,74
13,15,20,9,12,5,19,0,0,93
13,15,20,9,12,9,20,25,0,123
13,15,20,9,15,14,0,0,0,86
13,15,20,9,15,14,1,12,0,99
13,15,20,9,15,14,5,4,0,95
13,15,20,9,15,14,5,18,0,109
13,15,20,9,15,14,5,18,19,128
13,15,20,9,15,14,9,14,7,116
13,15,20,9,15,14,19,0,0,105
13,15,20,9,22,1,20,5,0,105
13,15,20,9,22,1,20,5,4,109
13,15,20,9,22,1,20,5,19,124
13,15,20,9,22,1,20,15,18,133
13,15,20,9,22,5,0,0,0,84
13,15,20,9,22,5,4,0,0,88
13,15,20,9,22,5,19,0,0,103
13,15,20,9,22,9,3,0,0,91
13,15,20,9,22,9,14,7,0,109
13,15,20,9,22,9,20,25,0,133
13,15,20,9,22,15,0,0,0,94
13,15,20,12,5,25,5,18,0,113
13,15,20,12,5,25,5,19,20,134
13,15,20,12,5,25,19,0,0,109
13,15,20,12,9,5,18,0,0,92
13,15,20,12,9,5,19,20,0,113
13,15,20,13,15,20,0,0,0,96
13,15,20,13,15,20,19,0,0,115
13,15,20,15,3,1,18,0,0,85
13,15,20,15,3,25,3,12,5,111
13,15,20,15,3,18,15,19,19,137
13,15,20,15,7,18,1,16,8,113
13,15,20,15,14,0,0,0,0,77
13,15,20,15,16,8,15,14,5,121
13,15,20,15,18,0,0,0,0,81
13,15,20,15,18,1,2,12,5,101
13,15,20,15,18,2,9,11,5,108
13,15,20,15,18,2,15,1,20,119
13,15,20,15,18,2,21,19,0,123
13,15,20,15,18,3,1,2,0,87
13,15,20,15,18,3,1,4,5,94
13,15,20,15,18,3,1,18,0,103
13,15,20,15,18,3,1,18,19,122
13,15,20,15,18,4,15,13,0,113
13,15,20,15,18,5,4,0,0,90
13,15,20,15,18,25,0,0,0,106
13,15,20,15,18,9,1,12,0,103
13,15,20,15,18,9,3,0,0,93
13,15,20,15,18,9,14,7,0,111
13,15,20,15,18,9,14,7,19,130
13,15,20,15,18,9,19,5,0,114
13,15,20,15,18,9,19,5,4,118
13,15,20,15,18,9,19,5,19,133
13,15,20,15,18,9,19,13,0,122
13,15,20,15,18,9,19,20,0,129
13,15,20,15,18,9,19,20,19,148
13,15,20,15,18,9,21,13,0,124
13,15,20,15,18,9,26,5,0,121
13,15,20,15,18,9,26,5,4,125
13,15,20,15,18,9,26,5,19,140
13,15,20,15,18,12,5,19,19,136
13,15,20,15,18,13,1,14,0,109
13,15,20,15,18,13,5,14,0,113
13,15,20,15,18,14,5,5,18,123
13,15,20,15,18,19,0,0,0,100
13,15,20,15,18,19,8,9,16,133
13,15,20,15,18,23,1,25,0,130
13,15,20,15,18,23,1,25,19,149
13,15,20,18,9,3,9,20,25,132
13,15,20,19,0,0,0,0,0,67
13,15,20,20,5,0,0,0,0,73
13,15,20,20,5,19,0,0,0,92
13,15,20,20,5,20,20,15,0,128
13,15,20,20,25,0,0,0,0,93
13,15,20,20,12,5,0,0,0,85
13,15,20,20,12,5,4,0,0,89
13,15,20,20,12,5,18,0,0,103
13,15,20,20,12,5,18,19,0,122
13,15,20,20,12,5,19,0,0,104
13,15,20,20,12,9,14,7,0,110
13,15,20,20,15,0,0,0,0,83
13,15,20,20,15,5,4,0,0,92
13,15,20,20,15,5,19,0,0,107
13,15,20,20,15,12,5,19,19,138
13,15,20,20,15,12,9,11,5,120
13,15,20,20,15,19,0,0,0,102
13,15,20,20,19,0,0,0,0,87
13,15,21,3,8,0,0,0,0,60
13,15,21,3,8,1,18,4,0,83
13,15,21,3,8,5,0,0,0,65
13,15,21,3,8,5,4,0,0,69
13,15,21,3,8,5,19,0,0,84
13,15,21,3,8,9,14,7,0,90
13,15,21,3,8,15,9,18,0,102
13,15,21,3,8,15,9,18,19,121
13,15,21,4,0,0,0,0,0,53
13,15,21,4,25,0,0,0,0,78
13,15,21,4,9,5,0,0,0,67
13,15,21,4,9,5,13,1,14,95
13,15,21,5,0,0,0,0,0,54
13,15,21,5,4,8,9,14,0,89
13,15,21,5,19,0,0,0,0,73
13,15,21,6,6,12,15,14,0,102
13,15,21,6,6,12,15,14,19,121
13,15,21,6,12,15,14,0,0,96
13,15,21,6,12,15,14,19,0,115
13,15,21,7,8,20,0,0,0,84
13,15,21,9,12,12,0,0,0,82
13,15,21,9,12,12,5,0,0,87
13,15,21,9,12,12,21,18,5,126
13,15,21,10,9,11,0,0,0,79
13,15,21,10,9,11,19,0,0,98
13,15,21,12,0,0,0,0,0,61
13,15,21,12,1,7,5,0,0,74
13,15,21,12,1,7,5,19,0,93
13,15,21,12,4,0,0,0,0,65
13,15,21,12,4,5,4,0,0,74
13,15,21,12,4,5,18,0,0,88
13,15,21,12,4,5,18,5,4,97
13,15,21,12,4,5,18,25,0,113
13,15,21,12,4,5,18,19,0,107
13,15,21,12,4,25,0,0,0,90
13,15,21,12,4,9,5,18,0,97
13,15,21,12,4,9,5,19,0,98
13,15,21,12,4,9,5,19,20,118
13,15,21,12,4,9,14,7,0,95
13,15,21,12,4,9,14,7,19,114
13,15,21,12,4,13,1,4,5,88
13,15,21,12,4,19,0,0,0,84
13,15,21,12,4,23,1,18,16,123
13,15,21,12,25,0,0,0,0,86
13,15,21,12,9,14,0,0,0,84
13,15,21,12,9,14,1,7,5,97
13,15,21,12,9,14,5,20,0,109
13,15,21,12,12,5,5,14,0,97
13,15,21,12,18,21,19,8,0,127
13,15,21,12,19,0,0,0,0,80
13,15,21,12,20,0,0,0,0,81
13,15,21,12,20,5,4,0,0,90
13,15,21,12,20,5,14,0,0,100
13,15,21,12,20,5,18,0,0,104
13,15,21,12,20,5,18,19,0,123
13,15,21,12,20,9,14,7,0,111
13,15,21,12,20,19,0,0,0,100
13,15,21,12,22,9,0,0,0,92
13,15,21,14,0,0,0,0,0,63
13,15,21,14,4,5,4,0,0,76
13,15,21,14,4,25,0,0,0,92
13,15,21,14,4,9,14,7,0,97
13,15,21,14,4,12,5,20,0,104
13,15,21,14,4,19,13,1,14,114
13,15,21,14,4,19,13,5,14,118
13,15,21,14,4,23,15,18,11,134
13,15,21,14,19,5,5,18,0,110
13,15,21,14,20,1,2,12,5,103
13,15,21,14,20,1,2,12,25,123
13,15,21,14,20,1,9,14,25,132
13,15,21,14,20,1,9,14,19,126
13,15,21,14,20,1,14,3,5,106
13,15,21,14,20,1,14,20,0,118
13,15,21,14,20,5,4,0,0,92
13,15,21,14,20,5,5,0,0,93
13,15,21,14,20,5,18,0,0,106
13,15,21,14,20,5,18,19,0,125
13,15,21,14,20,9,14,7,0,113
13,15,21,14,20,9,14,7,19,132
13,15,21,14,20,12,5,20,0,120
13,15,21,14,20,19,0,0,0,102
13,15,21,14,20,21,18,5,0,127
13,15,21,16,0,0,0,0,0,65
13,15,21,18,14,0,0,0,0,81
13,15,21,18,14,5,0,0,0,86
13,15,21,18,14,5,4,0,0,90
13,15,21,18,14,5,18,0,0,104
13,15,21,18,14,5,18,19,0,123
13,15,21,18,14,6,21,12,0,120
13,15,21,18,14,9,14,7,0,111
13,15,21,18,14,9,14,7,19,130
13,15,21,18,14,9,22,1,12,125
13,15,21,18,14,19,0,0,0,100
13,15,21,18,14,19,15,13,5,133
13,15,21,19,5,2,1,14,5,95
13,15,21,19,5,2,9,18,4,106
13,15,21,19,5,4,0,0,0,77
13,15,21,19,5,5,0,0,0,78
13,15,21,19,5,5,19,0,0,97
13,15,21,19,5,6,9,19,8,115
13,15,21,19,5,8,1,23,11,116
13,15,21,19,5,8,15,12,5,113
13,15,21,19,5,25,0,0,0,98
13,15,21,19,5,11,9,14,0,107
13,15,21,19,5,12,5,20,0,110
13,15,21,19,5,12,9,11,5,110
13,15,21,19,5,12,9,14,7,115
13,15,21,19,5,13,9,12,12,119
13,15,21,19,5,16,15,24,0,128
13,15,21,19,5,18,0,0,0,91
13,15,21,19,5,18,25,0,0,116
13,15,21,19,5,18,9,5,19,124
13,15,21,19,5,18,19,0,0,110
13,15,21,19,5,19,0,0,0,92
13,15,21,19,5,19,8,9,16,125
13,15,21,19,5,20,1,9,12,115
13,15,21,19,5,20,18,1,16,128
13,15,21,19,5,23,5,2,0,103
13,15,21,19,25,0,0,0,0,93
13,15,21,19,9,5,18,0,0,100
13,15,21,19,9,5,19,20,0,121
13,15,21,19,9,12,25,0,0,114
13,15,21,19,9,14,5,19,19,134
13,15,21,19,9,14,7,0,0,98
13,15,21,19,9,14,7,12,25,135
13,15,21,19,9,14,7,19,0,117
13,15,21,19,12,5,0,0,0,85
13,15,21,19,13,5,0,0,0,86
13,15,21,19,13,5,5,0,0,91
13,15,21,19,19,1,11,1,0,100
13,15,21,19,19,1,11,1,19,119
13,15,21,19,19,5,0,0,0,92
13,15,21,19,19,5,19,0,0,111
13,15,21,19,19,5,21,24,0,137
13,15,21,19,20,1,3,8,5,105
13,15,21,19,20,15,3,0,0,106
13,15,21,20,0,0,0,0,0,69
13,15,21,20,1,14,0,0,0,84
13,15,21,20,1,18,4,5,0,97
13,15,21,20,8,0,0,0,0,77
13,15,21,20,8,1,2,12,5,97
13,15,21,20,8,5,0,0,0,82
13,15,21,20,8,5,4,0,0,86
13,15,21,20,8,5,18,0,0,100
13,15,21,20,8,5,18,19,0,119
13,15,21,20,8,5,19,0,0,101
13,15,21,20,8,6,21,12,0,116
13,15,21,20,8,6,21,12,19,135
13,15,21,20,8,25,0,0,0,102
13,15,21,20,8,9,5,18,0,109
13,15,21,20,8,9,5,19,20,130
13,15,21,20,8,9,12,25,0,123
13,15,21,20,8,9,14,7,0,107
13,15,21,20,8,12,5,19,19,132
13,15,21,20,8,12,9,11,5,114
13,15,21,20,8,16,1,18,20,132
13,15,21,20,8,16,9,16,5,123
13,15,21,20,8,18,15,15,20,145
13,15,21,20,8,19,0,0,0,96
13,15,21,20,8,23,1,19,8,128
13,15,21,20,8,23,9,19,5,133
13,15,21,20,12,5,18,0,0,104
13,15,21,20,12,5,18,19,0,123
13,15,21,20,15,14,5,5,4,112
13,15,21,20,15,14,14,5,5,122
13,15,21,20,15,14,19,0,0,117
13,15,21,26,1,8,0,0,0,84
13,15,21,26,15,21,14,1,0,126
13,15,22,1,2,12,5,0,0,70
13,15,22,1,2,12,5,19,0,89
13,15,22,1,2,12,25,0,0,90
13,15,22,1,14,20,0,0,0,85
13,15,22,5,0,0,0,0,0,55
13,15,22,5,1,2,12,5,0,75
13,15,22,5,1,2,12,5,19,94
13,15,22,5,1,2,12,25,0,95
13,15,22,5,4,0,0,0,0,59
13,15,22,5,12,5,19,19,0,110
13,15,22,5,13,5,14,20,0,107
13,15,22,5,13,5,14,20,19,126
13,15,22,5,14,20,0,0,0,89
13,15,22,5,18,0,0,0,0,73
13,15,22,5,18,19,0,0,0,92
13,15,22,5,19,0,0,0,0,74
13,15,22,9,5,0,0,0,0,64
13,15,22,9,5,4,15,13,0,96
13,15,22,9,5,4,15,13,19,115
13,15,22,9,5,7,15,5,18,109
13,15,22,9,5,9,26,5,0,104
13,15,22,9,5,12,1,14,4,95
13,15,22,9,5,19,0,0,0,83
13,15,22,9,14,7,0,0,0,80
13,15,22,9,14,7,12,25,0,117
13,15,22,9,14,7,19,0,0,99
13,15,22,9,15,12,1,19,0,106
13,15,23,0,0,0,0,0,0,51
13,15,23,1,2,12,5,0,0,71
13,15,23,1,14,1,0,0,0,67
13,15,23,2,21,18,14,0,0,106
13,15,23,2,21,18,14,20,0,126
13,15,23,3,8,0,0,0,0,62
13,15,23,3,8,20,0,0,0,82
13,15,23,5,0,0,0,0,0,56
13,15,23,5,4,0,0,0,0,60
13,15,23,5,18,0,0,0,0,74
13,15,23,5,18,19,0,0,0,93
13,15,23,8,1,0,0,0,0,60
13,15,23,8,1,25,0,0,0,85
13,15,23,8,1,23,11,0,0,94
13,15,23,9,5,0,0,0,0,65
13,15,23,9,14,7,0,0,0,81
13,15,23,9,14,7,19,0,0,100
13,15,23,12,1,14,4,0,0,82
13,15,23,14,0,0,0,0,0,65
13,15,23,18,1,0,0,0,0,70
13,15,23,18,1,8,0,0,0,78
13,15,23,19,0,0,0,0,0,70
13,15,23,19,5,0,0,0,0,75
13,15,23,19,20,5,1,4,0,100
13,15,23,20,0,0,0,0,0,71
13,15,23,20,8,0,0,0,0,79
13,15,24,1,0,0,0,0,0,53
13,15,24,1,19,0,0,0,0,72
13,15,24,9,5,0,0,0,0,66
13,15,24,9,5,19,0,0,0,85
13,15,26,5,0,0,0,0,0,59
13,15,26,5,13,9,26,5,0,112
13,15,26,5,20,20,1,0,0,100
13,15,26,5,20,20,1,19,0,119
13,15,26,5,20,20,5,0,0,104
13,15,26,9,14,7,0,0,0,84
13,15,26,15,0,0,0,0,0,69
13,15,26,15,19,0,0,0,0,88
13,15,26,26,5,20,20,1,0,126
13,15,26,26,5,20,20,1,19,145
13,15,26,26,5,20,20,5,0,130
13,16,2,0,0,0,0,0,0,31
13,16,2,19,0,0,0,0,0,50
13,16,8,16,19,0,0,0,0,72
13,16,18,5,20,0,0,0,0,72
13,18,5,13,0,0,0,0,0,49
13,18,9,4,1,14,7,0,0,66
13,18,9,4,1,14,7,1,0,67
13,18,9,4,1,14,7,1,19,86
13,19,5,3,0,0,0,0,0,40
13,19,9,14,11,0,0,0,0,66
13,19,15,21,18,3,5,0,0,94
13,20,7,0,0,0,0,0,0,40
13,20,7,5,0,0,0,0,0,45
13,20,9,5,18,0,0,0,0,65
13,20,14,0,0,0,0,0,0,47
13,20,19,3,13,4,0,0,0,72
13,21,2,1,18,1,20,0,0,76
13,21,3,1,7,15,0,0,0,60
13,21,3,1,18,15,0,0,0,71
13,21,3,1,20,5,0,0,0,63
13,21,3,5,4,9,14,0,0,69
13,21,3,5,4,9,14,5,0,74
13,21,3,8,0,0,0,0,0,45
13,21,3,8,1,3,8,1,0,58
13,21,3,8,1,3,8,15,0,72
13,21,3,8,1,3,8,15,19,91
13,21,3,8,5,12,0,0,0,62
13,21,3,8,5,19,0,0,0,69
13,21,3,8,6,15,12,4,0,82
13,21,3,8,12,25,0,0,0,82
13,21,3,8,14,5,19,19,0,102
13,21,3,8,23,8,1,20,0,97
13,21,3,9,3,0,0,0,0,49
13,21,3,9,4,0,0,0,0,50
13,21,3,9,4,9,20,25,0,104
13,21,3,9,4,14,5,19,19,107
13,21,3,9,6,9,3,0,0,64
13,21,3,9,6,15,18,13,0,98
13,21,3,9,7,5,14,0,0,72
13,21,3,9,12,1,7,5,0,71
13,21,3,9,12,1,7,5,19,90
13,21,3,9,14,0,0,0,0,60
13,21,3,9,14,15,7,5,14,101
13,21,3,9,14,15,9,4,0,88
13,21,3,9,14,15,21,19,0,115
13,21,3,9,14,19,0,0,0,79
13,21,3,9,22,15,18,5,0,106
13,21,3,11,0,0,0,0,0,48
13,21,3,11,1,13,21,3,11,97
13,21,3,11,5,4,0,0,0,57
13,21,3,11,5,14,4,5,18,94
13,21,3,11,5,18,5,18,0,94
13,21,3,11,5,18,9,19,8,107
13,21,3,11,5,18,9,19,13,112
13,21,3,11,5,18,19,0,0,90
13,21,3,11,5,20,0,0,0,73
13,21,3,11,8,9,12,12,0,89
13,21,3,11,8,15,12,5,0,88
13,21,3,11,25,0,0,0,0,73
13,21,3,11,9,2,21,19,0,99
13,21,3,11,9,5,18,0,0,80
13,21,3,11,9,5,19,20,0,101
13,21,3,11,9,12,25,0,0,94
13,21,3,11,9,14,5,19,19,114
13,21,3,11,9,14,7,0,0,78
13,21,3,11,9,20,5,0,0,82
13,21,3,11,12,5,0,0,0,65
13,21,3,11,12,5,19,0,0,84
13,21,3,11,12,21,3,11,0,95
13,21,3,11,12,21,3,11,19,114
13,21,3,11,13,1,14,0,0,76
13,21,3,11,13,5,14,20,0,100
13,21,3,11,14,1,0,0,0,63
13,21,3,11,18,1,11,5,0,83
13,21,3,11,18,1,11,5,4,87
13,21,3,11,18,1,11,5,18,101
13,21,3,11,18,1,11,5,19,102
13,21,3,11,19,0,0,0,0,67
13,21,3,11,19,25,0,0,0,92
13,21,3,11,19,23,5,1,20,116
13,21,3,11,23,5,5,4,0,85
13,21,3,11,23,15,18,13,0,117
13,21,3,11,23,15,18,13,19,136
13,21,3,12,21,3,0,0,0,73
13,21,3,12,21,3,19,0,0,92
13,21,3,15,3,5,12,5,0,77
13,21,3,15,9,4,0,0,0,65
13,21,3,15,9,4,1,12,0,78
13,21,3,15,9,4,19,0,0,84
13,21,3,15,12,25,20,9,3,121
13,21,3,15,14,9,3,0,0,78
13,21,3,15,16,21,19,0,0,108
13,21,3,15,18,0,0,0,0,70
13,21,3,15,18,9,14,5,0,98
13,21,3,15,18,9,15,9,4,107
13,21,3,15,18,18,8,5,1,102
13,21,3,15,18,19,0,0,0,89
13,21,3,15,19,1,0,0,0,72
13,21,3,15,19,1,5,0,0,77
13,21,3,15,19,1,12,0,0,84
13,21,3,15,19,1,19,0,0,91
13,21,3,15,19,5,0,0,0,76
13,21,3,15,19,9,20,25,0,125
13,21,3,15,19,9,20,9,19,128
13,21,3,15,21,19,0,0,0,92
13,21,3,18,15,0,0,0,0,70
13,21,3,18,15,14,1,20,5,110
13,21,3,18,15,14,5,19,0,108
13,21,3,21,12,5,14,20,0,109
13,21,3,21,19,0,0,0,0,77
13,21,3,21,19,5,19,0,0,101
13,21,3,21,19,9,14,0,0,100
13,21,4,0,0,0,0,0,0,38
13,21,4,1,18,0,0,0,0,57
13,21,4,2,1,14,11,0,0,66
13,21,4,3,1,16,0,0,0,58
13,21,4,3,1,16,16,5,4,83
13,21,4,3,1,16,19,0,0,77
13,21,4,3,1,20,0,0,0,62
13,21,4,3,1,20,19,0,0,81
13,21,4,4,5,0,0,0,0,47
13,21,4,4,5,4,0,0,0,51
13,21,4,4,5,14,0,0,0,61
13,21,4,4,5,18,0,0,0,65
13,21,4,4,5,18,19,0,0,84
13,21,4,4,25,0,0,0,0,67
13,21,4,4,9,5,4,0,0,60
13,21,4,4,9,5,18,0,0,74
13,21,4,4,9,5,19,0,0,75
13,21,4,4,9,5,19,20,0,95
13,21,4,4,9,6,25,0,0,82
13,21,4,4,25,9,14,7,0,97
13,21,4,4,9,12,25,0,0,88
13,21,4,4,9,14,5,19,19,108
13,21,4,4,9,14,7,0,0,72
13,21,4,4,9,19,8,0,0,78
13,21,4,4,12,5,0,0,0,59
13,21,4,4,12,5,4,0,0,63
13,21,4,4,12,5,4,15,13,91
13,21,4,4,12,5,18,0,0,77
13,21,4,4,12,5,18,19,0,96
13,21,4,4,12,5,19,0,0,78
13,21,4,4,12,25,0,0,0,79
13,21,4,4,12,9,14,7,0,84
13,21,4,5,5,0,0,0,0,48
13,21,4,6,1,20,0,0,0,65
13,21,4,6,9,19,8,0,0,80
13,21,4,6,9,19,8,5,19,104
13,21,4,6,12,15,23,0,0,94
13,21,4,6,12,15,23,19,0,113
13,21,4,7,21,1,18,4,0,89
13,21,4,7,21,1,18,4,19,108
13,21,4,8,5,1,4,0,0,56
13,21,4,8,15,12,5,0,0,78
13,21,4,8,15,12,5,19,0,97
13,21,4,8,15,15,11,0,0,87
13,21,4,8,15,16,16,5,18,116
13,21,4,9,18,0,0,0,0,65
13,21,4,9,18,9,1,0,0,75
13,21,4,9,18,9,5,8,0,87
13,21,4,12,1,14,4,0,0,69
13,21,4,12,1,18,11,0,0,80
13,21,4,12,1,18,11,5,18,103
13,21,4,12,1,18,11,19,0,99
13,21,4,12,5,19,19,0,0,93
13,21,4,13,9,14,14,15,23,126
13,21,4,16,1,3,11,0,0,69
13,21,4,16,1,3,11,19,0,88
13,21,4,16,18,15,15,6,0,108
13,21,4,16,21,16,16,25,0,132
13,21,4,18,1,0,0,0,0,57
13,21,4,18,1,19,0,0,0,76
13,21,4,18,15,3,11,0,0,85
13,21,4,18,15,3,11,19,0,104
13,21,4,18,15,15,13,0,0,99
13,21,4,18,15,15,13,19,0,118
13,21,4,19,0,0,0,0,0,57
13,21,4,19,9,12,12,0,0,90
13,21,4,19,9,12,12,19,0,109
13,21,4,19,12,9,4,5,0,87
13,21,4,19,12,9,14,7,0,99
13,21,4,19,16,1,20,5,0,99
13,21,4,19,20,1,9,14,0,101
13,21,4,19,20,15,14,5,0,111
13,21,4,19,20,15,14,5,19,130
13,21,4,19,21,3,11,5,18,115
13,21,4,20,18,1,3,11,0,91
13,21,4,23,5,5,4,0,0,75
13,21,4,23,15,18,20,0,0,114
13,21,5,4,4,9,14,0,0,70
13,21,5,4,4,9,14,19,0,89
13,21,5,14,19,20,5,18,19,134
13,21,5,18,13,15,0,0,0,85
13,21,5,19,12,9,0,0,0,79
13,21,5,19,12,9,19,0,0,98
13,21,5,20,20,5,0,0,0,84
13,21,5,26,26,9,14,0,0,114
13,21,5,26,26,9,14,19,0,133
13,21,6,1,19,1,12,0,0,73
13,21,6,6,0,0,0,0,0,46
13,21,6,6,5,4,0,0,0,55
13,21,6,6,5,18,0,0,0,69
13,21,6,6,5,20,0,0,0,71
13,21,6,6,5,20,5,5,0,81
13,21,6,6,25,0,0,0,0,71
13,21,6,6,9,14,5,5,18,97
13,21,6,6,9,14,7,0,0,76
13,21,6,6,9,14,19,0,0,88
13,21,6,6,9,19,8,0,0,82
13,21,6,6,12,5,0,0,0,63
13,21,6,6,12,5,4,0,0,67
13,21,6,6,12,5,4,12,25,104
13,21,6,6,12,5,13,1,14,91
13,21,6,6,12,5,13,5,14,95
13,21,6,6,12,5,18,0,0,81
13,21,6,6,12,5,18,19,0,100
13,21,6,6,12,5,19,0,0,82
13,21,6,6,12,9,14,0,0,81
13,21,6,6,12,9,14,7,0,88
13,21,6,6,19,0,0,0,0,65
13,21,6,20,25,0,0,0,0,85
13,21,6,20,9,19,0,0,0,88
13,21,7,0,0,0,0,0,0,41
13,21,7,1,0,0,0,0,0,42
13,21,7,5,1,18,9,20,5,99
13,21,7,6,21,12,0,0,0,80
13,21,7,6,21,12,19,0,0,99
13,21,7,7,0,0,0,0,0,48
13,21,7,7,1,18,0,0,0,67
13,21,7,7,1,18,19,0,0,86
13,21,7,7,5,4,0,0,0,57
13,21,7,7,5,5,0,0,0,58
13,21,7,7,5,5,19,0,0,77
13,21,7,7,5,18,0,0,0,71
13,21,7,7,5,18,5,4,0,80
13,21,7,7,5,18,25,0,0,96
13,21,7,7,5,18,9,14,7,101
13,21,7,7,5,18,19,0,0,90
13,21,7,7,5,20,0,0,0,73
13,21,7,7,25,0,0,0,0,73
13,21,7,7,9,5,18,0,0,80
13,21,7,7,9,5,19,20,0,101
13,21,7,7,9,12,25,0,0,94
13,21,7,7,9,14,5,19,19,114
13,21,7,7,9,14,7,0,0,78
13,21,7,7,9,14,7,19,0,97
13,21,7,7,9,14,19,0,0,90
13,21,7,7,9,19,8,0,0,84
13,21,7,7,12,5,19,0,0,84
13,21,7,7,19,0,0,0,0,67
13,21,7,7,21,18,0,0,0,87
13,21,7,7,21,18,19,0,0,106
13,21,7,8,15,0,0,0,0,64
13,21,7,8,15,16,9,14,5,108
13,21,7,8,15,21,19,5,0,109
13,21,7,9,5,14,3,5,0,77
13,21,7,9,5,14,3,25,0,97
13,21,7,9,5,14,20,0,0,89
13,21,7,9,12,15,9,4,0,90
13,21,7,19,0,0,0,0,0,60
13,21,7,21,5,20,0,0,0,87
13,21,7,23,5,5,4,0,0,78
13,21,7,23,5,20,0,0,0,89
13,21,7,23,15,18,20,0,0,117
13,21,7,23,15,18,20,19,0,136
13,21,7,23,21,13,16,0,0,114
13,21,7,23,21,13,16,19,0,133
13,21,8,1,13,13,1,4,9,83
13,21,8,12,25,0,0,0,0,79
13,21,8,12,9,5,19,0,0,87
13,21,9,4,0,0,0,0,0,47
13,21,9,18,2,21,18,14,0,116
13,21,9,18,3,15,3,11,0,93
13,21,9,18,6,15,23,12,0,117
13,21,9,19,8,15,14,4,0,103
13,21,9,19,20,0,0,0,0,82
13,21,25,21,19,1,0,0,0,100
13,21,10,5,18,5,19,0,0,91
13,21,10,9,11,0,0,0,0,64
13,21,10,9,11,19,0,0,0,83
13,21,10,20,1,8,9,4,0,86
13,21,11,1,4,5,0,0,0,55
13,21,11,8,20,1,18,0,0,92
13,21,11,12,21,11,0,0,0,89
13,21,11,12,21,11,19,0,0,108
13,21,11,20,1,18,0,0,0,84
13,21,11,20,1,20,13,1,0,100
13,21,11,20,5,1,18,0,0,89
13,21,11,20,9,0,0,0,0,74
13,21,11,20,21,11,0,0,0,97
13,21,11,20,21,11,19,0,0,116
13,21,12,1,4,1,0,0,0,52
13,21,12,1,4,9,0,0,0,60
13,21,12,1,20,20,1,0,0,88
13,21,12,1,20,20,15,0,0,102
13,21,12,1,20,20,15,5,19,126
13,21,12,1,20,20,15,19,0,121
13,21,12,3,8,0,0,0,0,57
13,21,12,3,8,5,4,0,0,66
13,21,12,3,8,5,18,0,0,80
13,21,12,3,8,5,19,0,0,81
13,21,12,3,8,9,14,7,0,87
13,21,12,3,20,0,0,0,0,69
13,21,12,3,20,1,2,12,5,89
13,21,12,3,20,1,18,25,0,113
13,21,12,3,20,5,4,0,0,78
13,21,12,3,20,9,14,7,0,99
13,21,12,3,20,19,0,0,0,88
13,21,12,3,20,21,1,18,25,134
13,21,12,4,5,18,0,0,0,73
13,21,12,5,0,0,0,0,0,51
13,21,12,5,2,1,3,11,0,68
13,21,12,5,4,0,0,0,0,55
13,21,12,5,6,15,15,20,0,107
13,21,12,5,25,0,0,0,0,76
13,21,12,5,25,19,0,0,0,95
13,21,12,5,13,1,14,0,0,79
13,21,12,5,13,5,14,0,0,83
13,21,12,5,19,0,0,0,0,70
13,21,12,5,20,0,0,0,0,71
13,21,12,5,20,1,0,0,0,72
13,21,12,5,20,1,19,0,0,91
13,21,12,5,20,5,5,18,0,99
13,21,12,5,20,5,5,18,19,118
13,21,12,5,20,18,5,19,19,132
13,21,12,5,20,20,1,0,0,92
13,21,12,5,23,15,18,20,0,127
13,21,12,9,5,2,18,1,12,93
13,21,12,9,5,2,18,9,1,90
13,21,12,9,5,18,0,0,0,78
13,21,12,9,5,18,9,14,5,106
13,21,12,9,5,18,12,25,0,115
13,21,12,9,5,18,15,19,5,117
13,21,12,9,5,18,20,25,0,123
13,21,12,9,14,7,0,0,0,76
13,21,12,9,19,8,0,0,0,82
13,21,12,9,19,8,12,25,0,119
13,21,12,9,19,13,0,0,0,87
13,21,12,9,20,1,0,0,0,76
13,21,12,11,0,0,0,0,0,57
13,21,12,12,1,0,0,0,0,59
13,21,12,12,1,8,0,0,0,67
13,21,12,12,1,8,9,19,13,108
13,21,12,12,1,8,19,0,0,86
13,21,12,12,1,18,0,0,0,77
13,21,12,12,1,19,0,0,0,78
13,21,12,12,5,4,0,0,0,67
13,21,12,12,5,25,0,0,0,88
13,21,12,12,5,9,14,0,0,86
13,21,12,12,5,9,14,19,0,105
13,21,12,12,5,25,19,0,0,107
13,21,12,12,5,14,9,26,5,117
13,21,12,12,5,18,19,0,0,100
13,21,12,12,5,20,0,0,0,83
13,21,12,12,5,20,18,25,0,126
13,21,12,12,5,20,19,0,0,102
13,21,12,12,9,4,0,0,0,71
13,21,12,12,9,7,1,14,19,108
13,21,12,12,9,14,7,0,0,88
13,21,12,12,9,15,14,0,0,96
13,21,12,12,9,15,14,5,4,105
13,21,12,12,9,15,14,19,0,115
13,21,12,12,9,20,5,0,0,92
13,21,12,12,9,20,5,19,0,111
13,21,12,12,15,3,11,0,0,87
13,21,12,12,15,3,11,5,18,110
13,21,12,12,15,3,11,25,0,112
13,21,12,12,15,3,11,19,0,106
13,21,12,12,15,9,4,0,0,86
13,21,12,12,15,23,1,25,0,122
13,21,12,12,19,0,0,0,0,77
13,21,12,13,0,0,0,0,0,59
13,21,12,13,21,12,0,0,0,92
13,21,12,13,21,12,12,0,0,104
13,21,12,19,5,0,0,0,0,70
13,21,12,19,9,6,25,0,0,105
13,21,12,20,0,0,0,0,0,66
13,21,12,20,1,14,7,12,5,105
13,21,12,20,5,9,20,25,0,125
13,21,12,20,9,0,0,0,0,75
13,21,12,20,9,1,7,5,0,88
13,21,12,20,9,2,1,14,4,96
13,21,12,20,9,2,9,20,0,106
13,21,12,20,9,2,25,20,5,127
13,21,12,20,9,2,21,19,0,117
13,21,12,20,9,3,1,18,0,97
13,21,12,20,9,3,1,19,20,118
13,21,12,20,9,3,9,4,5,96
13,21,12,20,9,3,15,9,12,114
13,21,12,20,9,3,15,18,5,116
13,21,12,20,9,4,18,15,16,128
13,21,12,20,9,6,9,4,0,94
13,21,12,20,9,6,9,12,0,102
13,21,12,20,9,6,12,15,23,131
13,21,12,20,9,6,12,21,5,119
13,21,12,20,9,6,15,9,12,117
13,21,12,20,9,6,15,12,4,112
13,21,12,20,9,6,15,14,20,130
13,21,12,20,9,6,15,18,13,127
13,21,12,20,9,7,1,16,0,99
13,21,12,20,9,7,5,18,13,118
13,21,12,20,9,8,5,1,4,93
13,21,12,20,9,8,15,16,0,114
13,21,12,20,9,8,21,5,4,113
13,21,12,20,9,8,21,12,12,128
13,21,12,20,9,25,5,1,18,124
13,21,12,20,9,10,5,20,0,110
13,21,12,20,9,12,1,14,5,107
13,21,12,20,9,12,15,2,5,109
13,21,12,20,9,13,15,4,5,112
13,21,12,20,9,14,15,4,5,113
13,21,12,20,9,16,1,18,1,111
13,21,12,20,9,16,1,18,20,130
13,21,12,20,9,16,1,19,19,130
13,21,12,20,9,16,1,20,8,120
13,21,12,20,9,16,5,4,0,100
13,21,12,20,9,16,5,4,5,105
13,21,12,20,9,16,5,4,19,119
13,21,12,20,9,16,12,1,14,118
13,21,12,20,9,16,12,5,0,108
13,21,12,20,9,16,12,5,19,127
13,21,12,20,9,16,12,5,20,128
13,21,12,20,9,16,12,5,24,132
13,21,12,20,9,16,12,25,0,128
13,21,12,20,9,16,15,12,5,123
13,21,12,20,9,18,1,20,5,119
13,21,12,20,9,18,15,12,5,125
13,21,12,20,9,19,5,3,20,122
13,21,12,20,9,19,8,15,20,137
13,21,12,20,9,19,20,5,16,135
13,21,12,20,9,20,1,19,11,126
13,21,12,20,9,20,15,5,4,119
13,21,12,20,9,20,15,14,0,124
13,21,12,20,9,20,21,2,5,123
13,21,12,20,9,20,21,4,5,125
13,21,12,20,9,20,21,18,14,148
13,21,12,20,9,21,14,9,20,139
13,21,12,20,9,21,19,5,0,120
13,21,12,20,9,21,19,5,18,138
13,21,12,20,9,22,1,14,5,117
13,21,12,20,9,22,9,5,23,134
13,21,12,20,9,23,1,25,0,124
13,21,12,20,9,23,1,12,12,123
13,21,12,20,9,23,15,18,4,135
13,21,12,20,15,0,0,0,0,81
13,21,12,20,21,13,0,0,0,100
13,21,12,20,21,18,5,0,0,110
13,21,12,20,21,18,5,18,0,128
13,21,12,20,21,18,5,19,0,129
13,21,12,22,5,12,0,0,0,85
13,21,13,0,0,0,0,0,0,47
13,21,13,2,12,5,0,0,0,66
13,21,13,2,12,5,2,5,5,78
13,21,13,2,12,5,4,0,0,70
13,21,13,2,12,5,18,0,0,84
13,21,13,2,12,5,18,19,0,103
13,21,13,2,12,5,19,0,0,85
13,21,13,2,12,25,0,0,0,86
13,21,13,2,12,9,14,7,0,91
13,21,13,2,12,9,14,7,19,110
13,21,13,2,15,0,0,0,0,64
13,21,13,2,21,4,7,5,20,106
13,21,13,3,8,1,14,3,5,81
13,21,13,5,0,0,0,0,0,52
13,21,13,8,15,21,19,5,0,115
13,21,13,10,21,13,1,0,0,92
13,21,13,13,0,0,0,0,0,60
13,21,13,13,5,4,0,0,0,69
13,21,13,13,5,18,0,0,0,83
13,21,13,13,5,18,25,0,0,108
13,21,13,13,5,18,9,5,19,116
13,21,13,13,5,18,19,0,0,102
13,21,13,13,25,0,0,0,0,85
13,21,13,13,9,1,0,0,0,70
13,21,13,13,9,3,8,15,7,102
13,21,13,13,9,3,11,0,0,83
13,21,13,13,25,4,15,13,0,117
13,21,13,13,9,5,4,0,0,78
13,21,13,13,9,5,19,0,0,93
13,21,13,13,9,6,25,0,0,100
13,21,13,13,9,6,9,5,4,93
13,21,13,13,9,6,9,5,19,108
13,21,13,13,9,6,15,18,13,121
13,21,13,13,25,8,15,15,4,127
13,21,13,13,25,9,14,7,0,115
13,21,13,13,25,12,9,11,5,122
13,21,13,13,9,14,7,0,0,90
13,21,13,13,19,0,0,0,0,79
13,21,13,14,5,19,19,0,0,104
13,21,13,16,0,0,0,0,0,63
13,21,13,16,5,4,0,0,0,72
13,21,13,16,5,18,0,0,0,86
13,21,13,16,5,18,19,0,0,105
13,21,13,16,8,5,1,4,0,81
13,21,13,16,9,14,7,0,0,93
13,21,13,16,9,19,8,0,0,99
13,21,13,16,9,19,8,12,25,136
13,21,13,16,19,9,13,21,19,144
13,21,13,18,21,6,6,9,14,121
13,21,13,19,0,0,0,0,0,66
13,21,13,19,25,0,0,0,0,91
13,21,13,21,0,0,0,0,0,68
13,21,13,21,19,0,0,0,0,87
13,21,14,3,8,5,4,0,0,68
13,21,14,3,8,5,5,0,0,69
13,21,14,3,8,5,5,12,0,81
13,21,14,3,8,5,18,0,0,82
13,21,14,3,8,5,18,19,0,101
13,21,14,3,8,5,19,0,0,83
13,21,14,3,8,5,20,0,0,84
13,21,14,3,8,25,0,0,0,84
13,21,14,3,8,9,5,19,0,92
13,21,14,3,8,9,14,7,0,89
13,21,14,3,8,11,9,14,0,93
13,21,14,3,21,16,1,20,5,114
13,21,14,4,0,0,0,0,0,52
13,21,14,4,1,12,0,0,0,65
13,21,14,4,1,14,5,0,0,72
13,21,14,4,1,14,5,12,25,109
13,21,14,4,1,14,9,19,13,108
13,21,14,4,1,14,9,20,25,121
13,21,14,4,1,20,9,15,14,111
13,21,14,4,1,20,15,18,25,131
13,21,14,4,9,3,0,0,0,64
13,21,14,4,9,6,25,0,0,92
13,21,14,4,9,6,9,5,4,85
13,21,14,4,9,6,9,5,18,99
13,21,14,4,9,12,0,0,0,73
13,21,14,4,12,5,0,0,0,69
13,21,14,4,21,14,7,15,0,109
13,21,14,4,21,14,7,15,19,128
13,21,14,4,21,14,7,21,19,134
13,21,14,4,21,14,21,7,21,136
13,21,14,7,1,0,0,0,0,56
13,21,14,7,3,15,18,14,0,105
13,21,14,7,5,0,0,0,0,60
13,21,14,7,5,25,0,0,0,85
13,21,14,7,25,0,0,0,0,80
13,21,14,7,15,6,1,0,0,77
13,21,14,7,15,15,19,0,0,104
13,21,14,7,15,15,19,5,0,109
13,21,14,7,15,15,19,5,19,128
13,21,14,7,15,19,0,0,0,89
13,21,14,7,18,5,12,0,0,90
13,21,14,7,19,0,0,0,0,74
13,21,14,7,21,2,1,0,0,79
13,21,14,9,3,0,0,0,0,60
13,21,14,9,3,9,16,1,12,98
13,21,14,9,3,9,16,9,1,95
13,21,14,9,6,25,0,0,0,88
13,21,14,9,6,9,3,0,0,75
13,21,14,9,13,5,14,20,0,109
13,21,14,9,13,5,14,20,19,128
13,21,14,9,20,5,0,0,0,82
13,21,14,9,20,5,4,0,0,86
13,21,14,9,20,25,0,0,0,102
13,21,14,9,20,9,14,7,0,107
13,21,14,9,20,9,15,14,0,115
13,21,14,9,20,9,15,14,19,134
13,21,14,10,0,0,0,0,0,58
13,21,14,10,5,5,20,0,0,88
13,21,14,10,9,19,20,9,14,129
13,21,14,14,9,15,14,0,0,100
13,21,14,14,9,15,14,19,0,119
13,21,14,19,9,6,0,0,0,82
13,21,14,19,9,6,6,0,0,88
13,21,14,19,20,5,18,19,0,129
13,21,14,20,9,14,0,0,0,91
13,21,14,20,9,14,7,0,0,98
13,21,14,20,9,14,7,19,0,117
13,21,14,20,9,14,19,0,0,110
13,21,14,20,10,1,3,0,0,82
13,21,14,20,10,1,3,19,0,101
13,21,14,20,10,1,11,0,0,90
13,21,14,20,10,1,11,19,0,109
13,21,14,20,26,0,0,0,0,94
13,21,15,14,0,0,0,0,0,63
13,21,15,14,9,3,0,0,0,75
13,21,15,14,9,21,13,0,0,106
13,21,15,14,9,21,13,19,0,125
13,21,15,14,19,0,0,0,0,82
13,21,18,1,5,14,9,4,0,85
13,21,18,1,5,14,9,4,19,104
13,21,18,1,5,14,15,9,4,100
13,21,18,1,12,0,0,0,0,65
13,21,18,1,12,5,4,0,0,74
13,21,18,1,12,9,19,20,0,113
13,21,18,1,12,9,19,20,19,132
13,21,18,1,12,12,25,0,0,102
13,21,18,1,12,19,0,0,0,84
13,21,18,1,18,9,21,13,0,114
13,21,18,1,19,0,0,0,0,72
13,21,18,3,8,25,0,0,0,88
13,21,18,3,9,1,14,1,0,80
13,21,18,4,1,2,1,4,0,64
13,21,18,4,5,18,0,0,0,79
13,21,18,4,5,18,5,4,0,88
13,21,18,4,5,18,5,5,0,89
13,21,18,4,5,18,5,5,19,108
13,21,18,4,5,18,5,18,0,102
13,21,18,4,5,18,5,18,19,121
13,21,18,4,5,18,5,19,19,122
13,21,18,4,5,18,9,14,7,109
13,21,18,4,5,18,9,19,8,115
13,21,18,4,5,18,15,21,19,134
13,21,18,4,5,18,19,0,0,98
13,21,18,4,18,21,13,0,0,108
13,21,18,5,4,0,0,0,0,61
13,21,18,5,9,14,0,0,0,80
13,21,18,5,9,14,19,0,0,99
13,21,18,5,14,7,5,18,0,101
13,21,18,5,24,0,0,0,0,81
13,21,18,5,24,1,14,0,0,96
13,21,18,5,24,5,19,0,0,105
13,21,18,5,24,9,4,0,0,94
13,21,18,5,24,9,4,5,0,99
13,21,18,7,1,0,0,0,0,60
13,21,18,7,1,22,9,0,0,91
13,21,18,7,5,15,14,0,0,93
13,21,18,9,1,20,5,0,0,87
13,21,18,9,1,20,5,4,0,91
13,21,18,9,1,20,5,19,0,106
13,21,18,9,1,20,9,3,0,94
13,21,18,9,3,1,20,5,0,90
13,21,18,9,3,1,20,5,4,94
13,21,18,9,3,5,19,0,0,88
13,21,18,9,3,9,4,0,0,77
13,21,18,9,3,9,14,5,0,92
13,21,18,9,3,15,9,4,0,92
13,21,18,9,4,0,0,0,0,65
13,21,18,9,4,9,19,13,0,106
13,21,18,9,4,19,0,0,0,84
13,21,18,9,6,15,18,13,0,113
13,21,18,9,14,5,0,0,0,80
13,21,18,9,14,5,19,0,0,99
13,21,18,9,14,7,0,0,0,82
13,21,18,9,14,21,19,0,0,115
13,21,18,9,20,9,0,0,0,90
13,21,18,9,21,13,0,0,0,95
13,21,18,11,0,0,0,0,0,63
13,21,18,11,5,18,0,0,0,86
13,21,18,11,5,19,20,0,0,107
13,21,18,11,25,0,0,0,0,88
13,21,18,11,9,5,18,0,0,95
13,21,18,11,9,5,19,20,0,116
13,21,18,11,9,12,25,0,0,109
13,21,18,11,9,14,5,19,19,129
13,21,18,11,9,19,8,0,0,99
13,21,18,11,12,25,0,0,0,100
13,21,18,11,14,5,19,19,0,120
13,21,18,11,19,0,0,0,0,82
13,21,18,11,19,15,13,5,0,115
13,21,18,12,1,3,11,0,0,79
13,21,18,12,1,9,14,0,0,88
13,21,18,12,25,0,0,0,0,89
13,21,18,12,9,14,0,0,0,87
13,21,18,12,15,3,11,0,0,93
13,21,18,13,21,18,0,0,0,104
13,21,18,13,21,18,5,4,0,113
13,21,18,13,21,18,5,18,0,127
13,21,18,13,21,18,5,18,19,146
13,21,18,13,21,18,9,14,7,134
13,21,18,13,21,18,9,19,8,140
13,21,18,13,21,18,15,21,19,159
13,21,18,13,21,18,19,0,0,123
13,21,18,14,9,22,1,12,0,110
13,21,18,15,9,4,0,0,0,80
13,21,18,16,8,0,0,0,0,76
13,21,18,16,8,9,5,4,0,94
13,21,18,16,8,9,5,19,0,109
13,21,18,16,8,25,9,14,7,131
13,21,18,18,0,0,0,0,0,70
13,21,18,18,1,0,0,0,0,71
13,21,18,18,1,9,14,0,0,94
13,21,18,18,1,9,14,19,0,113
13,21,18,18,1,12,0,0,0,83
13,21,18,18,1,18,15,0,0,104
13,21,18,18,1,19,0,0,0,90
13,21,18,18,5,0,0,0,0,75
13,21,18,18,5,25,0,0,0,100
13,21,18,18,5,25,19,0,0,119
13,21,18,18,5,12,5,20,0,112
13,21,18,18,5,12,5,20,19,131
13,21,18,18,5,19,0,0,0,94
13,21,18,18,8,1,0,0,0,79
13,21,18,18,8,1,19,0,0,98
13,21,18,18,8,9,14,5,0,106
13,21,18,18,8,21,9,14,5,127
13,21,18,18,9,5,19,0,0,103
13,21,18,18,9,14,1,0,0,94
13,21,18,18,9,14,5,0,0,98
13,21,18,18,9,15,14,0,0,108
13,21,18,18,14,15,14,7,0,120
13,21,18,18,19,0,0,0,0,89
13,21,18,19,8,9,4,0,0,92
13,21,18,20,8,5,18,0,0,103
13,21,18,20,8,5,18,5,4,112
13,21,18,20,8,5,18,5,18,126
13,21,18,20,8,5,18,19,0,122
13,21,18,20,8,25,0,0,0,105
13,21,18,21,13,21,18,21,0,146
13,21,18,21,24,9,0,0,0,106
13,21,18,22,1,0,0,0,0,75
13,21,18,26,1,0,0,0,0,79
13,21,19,1,3,5,15,21,19,117
13,21,19,1,12,0,0,0,0,66
13,21,19,1,14,7,0,0,0,75
13,21,19,1,18,0,0,0,0,72
13,21,19,1,18,4,0,0,0,76
13,21,19,1,18,4,18,25,0,119
13,21,19,3,1,4,5,0,0,66
13,21,19,3,1,4,5,12,0,78
13,21,19,3,1,4,5,12,19,97
13,21,19,3,1,4,9,14,0,84
13,21,19,3,1,18,9,14,5,103
13,21,19,3,1,18,9,19,0,103
13,21,19,3,1,20,5,12,0,94
13,21,19,3,1,20,5,12,19,113
13,21,19,3,1,20,19,0,0,96
13,21,19,3,1,22,1,4,1,85
13,21,19,3,1,22,1,4,15,99
13,21,19,3,9,3,9,4,5,86
13,21,19,3,9,3,15,12,5,100
13,21,19,3,9,4,0,0,0,69
13,21,19,3,9,4,19,0,0,88
13,21,19,3,9,6,15,18,13,117
13,21,19,3,12,5,0,0,0,73
13,21,19,3,12,5,4,0,0,77
13,21,19,3,12,5,13,1,14,101
13,21,19,3,12,5,13,5,14,105
13,21,19,3,12,5,19,0,0,92
13,21,19,3,12,25,0,0,0,93
13,21,19,3,12,9,14,7,0,98
13,21,19,3,15,9,4,0,0,84
13,21,19,3,15,12,15,7,25,130
13,21,19,3,15,14,5,0,0,90
13,21,19,3,15,19,5,0,0,95
13,21,19,3,15,19,9,20,25,144
13,21,19,3,15,20,0,0,0,91
13,21,19,3,15,22,1,4,5,103
13,21,19,3,15,22,1,4,15,113
13,21,19,3,15,23,0,0,0,94
13,21,19,3,21,12,1,18,0,108
13,21,19,3,21,12,5,0,0,94
13,21,19,3,21,12,9,0,0,98
13,21,19,3,21,12,9,14,0,112
13,21,19,3,21,12,15,21,19,144
13,21,19,3,21,12,21,19,0,129
13,21,19,5,4,0,0,0,0,62
13,21,19,5,6,21,12,0,0,97
13,21,19,5,6,21,12,12,25,134
13,21,19,5,9,19,20,0,0,106
13,21,19,5,12,5,19,19,0,113
13,21,19,5,12,9,11,5,0,95
13,21,19,5,15,12,15,7,25,132
13,21,19,5,18,0,0,0,0,76
13,21,19,5,18,25,0,0,0,101
13,21,19,5,18,19,0,0,0,95
13,21,19,5,20,0,0,0,0,78
13,21,19,5,20,20,5,19,0,122
13,21,19,5,21,13,0,0,0,92
13,21,19,5,21,13,9,26,5,132
13,21,19,5,21,13,19,0,0,111
13,21,19,8,0,0,0,0,0,61
13,21,19,8,1,0,0,0,0,62
13,21,19,8,1,1,0,0,0,63
13,21,19,8,5,4,0,0,0,70
13,21,19,8,5,18,0,0,0,84
13,21,19,8,5,18,19,0,0,103
13,21,19,8,5,19,0,0,0,85
13,21,19,8,8,5,1,4,0,79
13,21,19,8,25,0,0,0,0,86
13,21,19,8,9,5,18,0,0,93
13,21,19,8,9,5,19,20,0,114
13,21,19,8,9,12,25,0,0,107
13,21,19,8,9,14,5,19,19,127
13,21,19,8,9,14,7,0,0,91
13,21,19,8,12,1,0,0,0,74
13,21,19,8,13,5,12,15,14,120
13,21,19,8,18,15,15,13,0,122
13,21,19,8,18,15,15,13,25,147
13,21,19,8,18,15,15,13,19,141
13,21,19,8,18,21,0,0,0,100
13,21,19,8,18,21,13,16,0,129
13,21,19,9,3,0,0,0,0,65
13,21,19,9,3,1,0,0,0,66
13,21,19,9,3,1,12,0,0,78
13,21,19,9,3,1,12,5,0,83
13,21,19,9,3,1,12,5,19,102
13,21,19,9,3,1,12,12,25,115
13,21,19,9,3,1,12,19,0,97
13,21,19,9,3,1,20,5,0,91
13,21,19,9,3,9,1,14,0,89
13,21,19,9,3,9,1,14,1,90
13,21,19,9,3,9,1,14,19,108
13,21,19,9,3,11,5,18,0,99
13,21,19,9,3,12,5,19,19,120
13,21,19,9,3,12,9,11,5,102
13,21,19,9,3,15,0,0,0,80
13,21,19,9,3,18,25,0,0,108
13,21,19,9,3,19,0,0,0,84
13,21,19,9,5,0,0,0,0,67
13,21,19,9,12,25,0,0,0,99
13,21,19,9,13,15,14,0,0,104
13,21,19,9,14,7,0,0,0,83
13,21,19,9,14,7,12,25,0,120
13,21,19,9,14,7,19,0,0,102
13,21,19,9,15,14,0,0,0,91
13,21,19,9,20,0,0,0,0,82
13,21,19,9,22,5,0,0,0,89
13,21,19,10,9,4,0,0,0,76
13,21,19,10,9,4,19,0,0,95
13,21,19,11,0,0,0,0,0,64
13,21,19,11,1,4,5,12,0,86
13,21,19,11,1,20,0,0,0,85
13,21,19,11,5,4,0,0,0,73
13,21,19,11,5,7,0,0,0,76
13,21,19,11,5,7,7,25,0,108
13,21,19,11,5,7,19,0,0,95
13,21,19,11,5,20,0,0,0,89
13,21,19,11,5,20,1,4,5,99
13,21,19,11,5,20,5,5,18,117
13,21,19,11,5,20,15,0,0,104
13,21,19,11,5,20,15,15,14,133
13,21,19,11,5,20,18,25,0,132
13,21,19,11,5,20,19,0,0,108
13,21,19,11,7,18,1,19,19,128
13,21,19,11,25,0,0,0,0,89
13,21,19,11,9,5,0,0,0,78
13,21,19,11,9,5,18,0,0,96
13,21,19,11,9,5,19,0,0,97
13,21,19,11,9,5,19,20,0,117
13,21,19,11,9,6,9,5,4,97
13,21,19,11,9,12,25,0,0,110
13,21,19,11,9,14,5,19,19,130
13,21,19,11,9,19,8,0,0,100
13,21,19,11,9,20,0,0,0,93
13,21,19,11,9,20,19,0,0,112
13,21,19,11,12,9,11,5,0,101
13,21,19,11,13,5,12,15,14,123
13,21,19,11,15,14,5,0,0,98
13,21,19,11,15,24,0,0,0,103
13,21,19,11,15,24,5,14,0,122
13,21,19,11,18,1,20,0,0,103
13,21,19,11,18,1,20,19,0,122
13,21,19,11,18,15,15,20,0,132
13,21,19,11,19,0,0,0,0,83
13,21,19,11,23,15,15,4,0,121
13,21,19,12,9,14,0,0,0,88
13,21,19,12,9,14,5,4,0,97
13,21,19,12,9,14,5,20,0,113
13,21,19,12,9,14,19,0,0,107
13,21,19,13,15,14,0,0,0,95
13,21,19,14,21,4,0,0,0,92
13,21,19,15,0,0,0,0,0,68
13,21,19,16,9,11,5,0,0,94
13,21,19,16,9,11,5,19,0,113
13,21,19,17,21,1,19,8,0,119
13,21,19,17,21,1,23,0,0,115
13,21,19,17,21,5,20,15,0,131
13,21,19,18,15,12,0,0,0,98
13,21,19,18,15,15,13,5,4,123
13,21,19,19,0,0,0,0,0,72
13,21,19,19,1,2,12,5,0,92
13,21,19,19,1,2,12,25,0,112
13,21,19,19,1,3,11,0,0,87
13,21,19,19,1,12,0,0,0,85
13,21,19,19,5,4,0,0,0,81
13,21,19,19,5,12,0,0,0,89
13,21,19,19,5,12,5,4,0,98
13,21,19,19,5,12,5,18,0,112
13,21,19,19,5,12,12,9,13,123
13,21,19,19,5,12,19,0,0,108
13,21,19,19,5,19,0,0,0,96
13,21,19,19,25,0,0,0,0,97
13,21,19,19,9,3,11,0,0,95
13,21,19,19,9,5,18,0,0,104
13,21,19,19,9,5,19,20,0,125
13,21,19,19,9,12,25,0,0,118
13,21,19,19,9,14,5,19,19,138
13,21,19,19,9,14,7,0,0,102
13,21,19,19,9,20,1,20,5,127
13,21,19,19,21,3,11,0,0,107
13,21,19,19,21,11,0,0,0,104
13,21,19,19,21,18,1,14,1,127
13,21,19,20,0,0,0,0,0,73
13,21,19,20,1,3,8,5,0,90
13,21,19,20,1,3,8,5,4,94
13,21,19,20,1,3,8,5,19,109
13,21,19,20,1,3,8,9,15,109
13,21,19,20,1,6,9,14,1,104
13,21,19,20,1,6,21,26,0,127
13,21,19,20,1,14,7,0,0,95
13,21,19,20,1,14,7,5,18,118
13,21,19,20,1,14,7,19,0,114
13,21,19,20,1,18,4,0,0,96
13,21,19,20,1,18,4,5,18,119
13,21,19,20,1,18,4,25,0,121
13,21,19,20,1,18,4,19,0,115
13,21,19,20,5,4,0,0,0,82
13,21,19,20,5,5,0,0,0,83
13,21,19,20,5,5,19,0,0,102
13,21,19,20,5,12,9,4,0,103
13,21,19,20,5,12,9,14,0,113
13,21,19,20,5,12,9,14,5,118
13,21,19,20,5,12,15,9,4,118
13,21,19,20,5,18,0,0,0,96
13,21,19,20,5,18,5,4,0,105
13,21,19,20,5,18,5,18,0,119
13,21,19,20,5,18,9,1,12,118
13,21,19,20,5,18,9,14,7,126
13,21,19,20,5,18,19,0,0,115
13,21,19,20,8,0,0,0,0,81
13,21,19,20,8,19,0,0,0,100
13,21,19,20,25,0,0,0,0,98
13,21,19,20,9,5,18,0,0,105
13,21,19,20,9,5,19,0,0,106
13,21,19,20,9,5,19,20,0,126
13,21,19,20,9,6,25,0,0,113
13,21,19,20,9,12,25,0,0,119
13,21,19,20,9,14,5,19,19,139
13,21,19,20,9,14,7,0,0,103
13,21,19,20,14,20,0,0,0,107
13,21,19,20,19,0,0,0,0,92
13,21,19,20,21,12,5,14,20,145
13,21,19,21,13,5,5,0,0,97
13,21,20,0,0,0,0,0,0,54
13,21,20,1,0,0,0,0,0,55
13,21,20,1,2,12,5,0,0,74
13,21,20,1,2,12,25,0,0,94
13,21,20,1,7,5,0,0,0,67
13,21,20,1,7,5,14,0,0,81
13,21,20,1,7,5,14,9,3,93
13,21,20,1,7,5,14,19,0,100
13,21,20,1,14,4,9,19,0,101
13,21,20,1,14,20,0,0,0,89
13,21,20,1,14,20,19,0,0,108
13,21,20,1,19,5,0,0,0,79
13,21,20,1,19,5,19,0,0,98
13,21,20,1,20,5,0,0,0,80
13,21,20,1,20,5,4,0,0,84
13,21,20,1,20,5,19,0,0,99
13,21,20,1,20,9,14,7,0,105
13,21,20,1,20,9,15,14,0,113
13,21,20,1,20,9,15,14,19,132
13,21,20,1,20,9,19,0,0,103
13,21,20,1,20,9,22,5,0,111
13,21,20,1,20,15,18,0,0,108
13,21,20,1,20,15,18,25,0,133
13,21,20,1,23,1,12,12,9,112
13,21,20,3,8,0,0,0,0,65
13,21,20,3,8,5,19,0,0,89
13,21,20,3,8,11,9,14,0,99
13,21,20,3,8,11,9,14,19,118
13,21,20,5,0,0,0,0,0,59
13,21,20,5,4,0,0,0,0,63
13,21,20,5,4,12,25,0,0,100
13,21,20,5,4,14,5,19,19,120
13,21,20,5,12,25,0,0,0,96
13,21,20,5,14,5,19,19,0,116
13,21,20,5,19,0,0,0,0,78
13,21,20,5,19,1,18,9,6,112
13,21,20,5,19,20,0,0,0,98
13,21,20,8,0,0,0,0,0,62
13,21,20,9,3,0,0,0,0,66
13,21,20,9,3,1,20,5,0,92
13,21,20,9,3,15,21,19,0,121
13,21,20,9,12,1,20,5,0,101
13,21,20,9,12,1,20,5,4,105
13,21,20,9,12,1,20,5,19,120
13,21,20,9,12,1,20,15,18,129
13,21,20,9,12,12,9,4,0,100
13,21,20,9,12,15,21,19,0,130
13,21,20,9,14,1,4,15,0,97
13,21,20,9,14,5,0,0,0,82
13,21,20,9,14,5,4,0,0,86
13,21,20,9,14,5,5,18,0,105
13,21,20,9,14,5,5,18,19,124
13,21,20,9,14,5,19,0,0,101
13,21,20,9,14,7,0,0,0,84
13,21,20,9,14,25,0,0,0,102
13,21,20,9,14,9,5,4,0,95
13,21,20,9,14,9,5,19,0,110
13,21,20,9,14,25,9,14,7,132
13,21,20,9,14,9,14,7,0,107
13,21,20,9,14,9,26,5,0,117
13,21,20,9,14,15,21,19,0,132
13,21,20,9,19,13,0,0,0,95
13,21,20,9,19,13,19,0,0,114
13,21,20,9,19,20,0,0,0,102
13,21,20,9,19,20,9,3,0,114
13,21,20,9,22,5,0,0,0,90
13,21,20,9,22,9,20,25,0,139
13,21,20,15,14,0,0,0,0,83
13,21,20,15,14,19,0,0,0,102
13,21,20,15,19,3,15,16,5,127
13,21,20,19,0,0,0,0,0,73
13,21,20,19,10,5,0,0,0,88
13,21,20,19,21,4,4,25,0,127
13,21,20,20,0,0,0,0,0,74
13,21,20,20,5,14,0,0,0,93
13,21,20,20,5,18,0,0,0,97
13,21,20,20,5,18,5,4,0,106
13,21,20,20,5,18,5,18,0,120
13,21,20,20,5,18,5,18,19,139
13,21,20,20,5,18,9,14,7,127
13,21,20,20,5,18,19,0,0,116
13,21,20,20,15,14,0,0,0,103
13,21,20,20,15,14,25,0,0,128
13,21,20,20,15,14,19,0,0,122
13,21,20,20,19,0,0,0,0,93
13,21,20,21,1,12,0,0,0,88
13,21,20,21,1,12,9,19,5,121
13,21,20,21,1,12,9,19,13,129
13,21,20,21,1,12,9,19,20,136
13,21,20,21,1,12,9,20,25,142
13,21,20,21,1,12,9,26,5,128
13,21,20,21,1,12,12,25,0,125
13,21,20,21,1,12,19,0,0,107
13,21,20,21,1,14,20,0,0,110
13,21,20,21,1,18,25,0,0,119
13,21,20,21,1,20,5,0,0,101
13,21,20,21,5,12,0,0,0,92
13,21,20,21,5,12,19,0,0,111
13,21,20,21,12,1,18,0,0,106
13,21,20,21,12,1,18,25,0,131
13,21,20,21,12,5,0,0,0,92
13,21,20,21,12,5,19,0,0,111
13,21,20,21,21,13,0,0,0,109
13,21,20,23,1,12,12,9,0,111
13,21,21,13,21,21,0,0,0,110
13,21,21,13,21,21,19,0,0,129
13,21,22,21,12,5,0,0,0,94
13,21,26,1,18,1,2,0,0,82
13,21,26,8,9,11,0,0,0,88
13,21,26,8,9,11,19,0,0,107
13,21,26,10,9,11,0,0,0,90
13,21,26,10,9,11,19,0,0,109
13,21,26,15,15,14,1,0,0,105
13,21,26,26,0,0,0,0,0,86
13,21,26,26,25,0,0,0,0,111
13,21,26,26,9,5,18,0,0,118
13,21,26,26,9,5,19,20,0,139
13,21,26,26,9,12,25,0,0,132
13,21,26,26,9,14,5,19,19,152
13,21,26,26,12,5,0,0,0,103
13,21,26,26,12,5,4,0,0,107
13,21,26,26,12,5,18,0,0,121
13,21,26,26,12,5,18,19,0,140
13,21,26,26,12,5,19,0,0,122
13,21,26,26,12,9,14,7,0,128
13,24,4,0,0,0,0,0,0,41
13,26,5,5,0,0,0,0,0,49
13,26,21,14,7,21,0,0,0,102
14,4,15,4,5,18,13,0,0,73
14,5,2,1,3,11,0,0,0,36
14,5,2,1,12,9,1,14,0,58
14,5,2,1,12,9,15,9,4,71
14,5,2,2,5,4,0,0,0,32
14,5,2,2,25,0,0,0,0,48
14,5,2,2,9,19,8,0,0,59
14,5,2,2,9,19,8,5,19,83
14,5,2,2,21,3,11,0,0,58
14,5,2,2,21,11,0,0,0,55
14,5,2,5,12,0,0,0,0,38
14,5,2,5,12,9,19,20,0,86
14,5,2,5,14,11,5,18,14,88
14,5,2,18,9,19,0,0,0,67
14,5,2,18,15,4,9,0,0,67
14,5,2,21,12,1,0,0,0,55
14,5,2,21,12,1,5,0,0,60
14,5,2,21,12,1,18,0,0,73
14,5,2,21,12,1,19,0,0,74
14,5,2,21,12,1,20,5,4,84
14,5,2,21,12,5,0,0,0,59
14,5,2,21,12,25,0,0,0,79
14,5,2,21,12,9,19,5,0,87
14,5,2,21,12,9,19,5,4,91
14,5,2,21,12,9,19,5,18,105
14,5,2,21,12,9,19,5,19,106
14,5,2,21,12,9,20,5,0,88
14,5,2,21,12,9,21,13,0,97
14,5,2,21,12,9,26,5,0,94
14,5,2,21,12,9,26,5,4,98
14,5,2,21,12,9,26,5,18,112
14,5,2,21,12,9,26,5,19,113
14,5,2,21,12,15,14,0,0,83
14,5,2,21,12,15,19,5,0,93
14,5,2,21,12,15,19,21,19,128
14,5,2,21,12,15,21,19,0,109
14,5,3,1,20,9,15,14,0,81
14,5,3,5,19,19,1,18,0,84
14,5,3,5,19,19,1,18,25,109
14,5,3,5,19,19,5,0,0,70
14,5,3,5,19,19,9,19,13,106
14,5,3,5,19,19,9,19,20,113
14,5,3,5,19,19,9,20,25,119
14,5,3,9,1,0,0,0,0,32
14,5,3,11,0,0,0,0,0,33
14,5,3,11,1,20,5,5,0,64
14,5,3,11,2,1,14,4,0,54
14,5,3,11,2,1,14,4,19,73
14,5,3,11,3,12,15,20,8,91
14,5,3,11,5,4,0,0,0,42
14,5,3,11,5,14,7,5,18,82
14,5,3,11,5,18,19,0,0,75
14,5,3,11,6,21,12,0,0,72
14,5,3,11,7,21,1,18,4,84
14,5,3,11,9,14,7,0,0,63
14,5,3,11,9,14,7,5,18,86
14,5,3,11,9,14,7,19,0,82
14,5,3,11,25,15,11,5,0,89
14,5,3,11,12,1,3,5,0,54
14,5,3,11,12,1,3,5,4,58
14,5,3,11,12,1,3,5,19,73
14,5,3,11,12,5,19,19,0,88
14,5,3,11,12,5,20,0,0,70
14,5,3,11,12,9,11,5,0,70
14,5,3,11,12,9,14,5,0,73
14,5,3,11,12,9,14,5,19,92
14,5,3,11,13,15,12,4,0,77
14,5,3,11,13,15,21,12,4,98
14,5,3,11,16,9,5,3,5,71
14,5,3,11,19,0,0,0,0,52
14,5,3,11,19,20,15,3,11,101
14,5,3,11,20,9,5,0,0,67
14,5,3,11,20,9,5,19,0,86
14,5,3,11,23,1,18,4,0,79
14,5,3,11,23,5,1,18,0,80
14,5,3,11,23,5,1,18,19,99
14,5,3,11,23,5,5,4,0,70
14,5,3,18,1,5,13,9,1,69
14,5,3,18,5,13,9,1,0,68
14,5,3,18,15,0,0,0,0,55
14,5,3,18,15,12,15,7,25,114
14,5,3,18,15,14,9,20,5,103
14,5,3,18,15,16,8,9,12,100
14,5,3,18,15,16,15,12,9,107
14,5,3,18,15,16,19,25,0,115
14,5,3,18,15,19,5,0,0,79
14,5,3,18,15,19,5,4,0,83
14,5,3,18,15,19,5,19,0,98
14,5,3,18,15,19,9,14,7,104
14,5,3,18,15,19,9,19,0,102
14,5,3,18,15,20,9,3,0,87
14,5,3,18,15,20,25,16,5,121
14,5,3,18,15,20,9,19,5,108
14,5,3,18,15,20,9,26,5,115
14,5,3,18,15,20,15,13,25,128
14,5,3,20,1,18,0,0,0,61
14,5,3,20,1,18,5,1,12,79
14,5,3,20,1,18,5,1,14,81
14,5,3,20,1,18,5,4,0,70
14,5,3,20,1,18,25,0,0,86
14,5,3,20,1,18,9,1,12,83
14,5,3,20,1,18,9,1,14,85
14,5,3,20,1,18,9,5,4,79
14,5,3,20,1,18,9,5,19,94
14,5,3,20,1,18,9,14,0,84
14,5,3,20,1,18,9,14,5,89
14,5,3,20,1,18,9,19,5,94
14,5,3,20,1,18,9,21,13,104
14,5,3,20,1,18,9,26,5,101
14,5,3,20,1,18,15,21,19,116
14,5,3,20,1,18,19,0,0,80
14,5,3,20,15,14,0,0,0,71
14,5,3,20,15,16,15,4,0,92
14,5,3,20,18,15,14,0,0,89
14,5,4,4,5,18,0,0,0,50
14,5,4,4,9,5,19,0,0,60
14,5,5,2,15,18,0,0,0,59
14,5,5,2,15,21,18,0,0,80
14,5,5,4,0,0,0,0,0,28
14,5,5,4,5,4,0,0,0,37
14,5,5,4,5,18,0,0,0,51
14,5,5,4,5,18,19,0,0,70
14,5,5,4,6,9,18,5,0,66
14,5,5,4,6,21,12,0,0,67
14,5,5,4,6,21,12,12,25,104
14,5,5,4,6,21,12,19,0,86
14,5,5,4,7,1,20,5,19,80
14,5,5,4,25,0,0,0,0,53
14,5,5,4,9,5,18,0,0,60
14,5,5,4,9,5,19,20,0,81
14,5,5,4,9,12,25,0,0,74
14,5,5,4,9,14,5,19,19,94
14,5,5,4,9,14,7,0,0,58
14,5,5,4,12,5,0,0,0,45
14,5,5,4,12,5,4,0,0,49
14,5,5,4,12,5,6,21,12,84
14,5,5,4,12,5,13,1,14,73
14,5,5,4,12,5,13,5,14,77
14,5,5,4,12,5,18,0,0,63
14,5,5,4,12,5,18,19,0,82
14,5,5,4,12,5,19,19,0,83
14,5,5,4,12,25,0,0,0,65
14,5,5,4,12,9,14,7,0,70
14,5,5,4,12,9,14,7,19,89
14,5,5,4,13,5,14,20,0,80
14,5,5,4,13,5,14,20,19,99
14,5,5,4,14,0,0,0,0,42
14,5,5,4,14,20,0,0,0,62
14,5,5,4,19,0,0,0,0,47
14,5,5,4,19,12,25,0,0,84
14,5,5,4,19,15,13,5,0,80
14,5,5,7,5,18,0,0,0,54
14,5,5,12,4,0,0,0,0,40
14,5,5,12,5,0,0,0,0,41
14,5,5,12,7,8,1,14,0,66
14,5,5,13,0,0,0,0,0,37
14,5,5,13,2,1,0,0,0,40
14,5,5,13,19,0,0,0,0,56
14,5,5,16,0,0,0,0,0,40
14,5,5,16,15,21,18,0,0,94
14,5,5,16,19,0,0,0,0,59
14,5,5,18,0,0,0,0,0,42
14,5,5,19,5,0,0,0,0,48
14,5,5,20,0,0,0,0,0,44
14,5,5,20,21,16,0,0,0,81
14,5,5,26,5,0,0,0,0,55
14,5,6,0,0,0,0,0,0,25
14,5,6,1,14,4,15,21,19,99
14,5,6,1,18,9,15,21,19,108
14,5,6,1,19,0,0,0,0,45
14,5,6,1,19,20,0,0,0,65
14,5,6,1,19,20,21,19,0,105
14,5,6,6,25,0,0,0,0,56
14,5,6,20,7,9,12,0,0,73
14,5,7,1,18,1,0,0,0,46
14,5,7,1,20,5,0,0,0,52
14,5,7,1,20,5,4,0,0,56
14,5,7,1,20,5,18,0,0,70
14,5,7,1,20,5,18,19,0,89
14,5,7,1,20,5,19,0,0,71
14,5,7,1,20,9,14,7,0,77
14,5,7,1,20,9,15,14,0,85
14,5,7,1,20,9,15,14,19,104
14,5,7,1,20,9,22,5,0,83
14,5,7,1,20,9,22,5,4,87
14,5,7,1,20,9,22,5,18,101
14,5,7,1,20,9,22,5,19,102
14,5,7,1,20,15,14,0,0,76
14,5,7,1,20,15,14,19,0,95
14,5,7,1,20,15,18,0,0,80
14,5,7,1,20,15,18,25,0,105
14,5,7,1,20,15,18,19,0,99
14,5,7,1,20,18,15,14,0,94
14,5,7,1,20,18,15,14,19,113
14,5,7,5,18,0,0,0,0,49
14,5,7,9,14,15,20,8,0,92
14,5,7,12,5,3,20,0,0,66
14,5,7,12,5,3,20,5,4,75
14,5,7,12,5,3,20,5,18,89
14,5,7,12,5,3,20,15,18,99
14,5,7,12,5,3,20,19,0,85
14,5,7,12,9,7,0,0,0,54
14,5,7,12,9,7,5,0,0,59
14,5,7,12,9,7,5,5,0,64
14,5,7,12,9,7,5,5,19,83
14,5,7,12,9,7,5,14,20,93
14,5,7,12,9,7,5,19,0,78
14,5,7,15,3,5,0,0,0,49
14,5,7,15,20,9,1,14,20,105
14,5,7,15,20,9,1,20,5,96
14,5,7,15,20,9,15,21,19,125
14,5,7,18,9,14,5,0,0,72
14,5,7,18,9,20,1,0,0,74
14,5,7,18,9,20,21,4,5,103
14,5,7,18,15,4,15,13,0,91
14,5,7,18,15,8,5,1,4,77
14,5,7,18,15,8,15,15,4,101
14,5,7,18,15,9,4,19,0,91
14,5,7,18,15,9,19,8,0,95
14,5,7,18,15,12,9,11,5,96
14,5,7,18,15,14,9,19,0,101
14,5,7,21,19,5,19,0,0,90
14,5,8,9,12,15,20,8,0,91
14,5,25,1,14,4,1,0,0,64
14,5,9,6,0,0,0,0,0,34
14,5,9,6,19,0,0,0,0,53
14,5,9,7,8,0,0,0,0,43
14,5,9,7,8,2,15,18,0,78
14,5,9,7,8,2,15,18,19,97
14,5,9,7,8,2,15,21,18,99
14,5,9,7,8,5,4,0,0,52
14,5,9,7,8,5,18,0,0,66
14,5,9,7,8,9,14,7,0,73
14,5,9,7,8,19,0,0,0,62
14,5,9,14,0,0,0,0,0,42
14,5,9,16,5,18,0,0,0,67
14,5,9,19,20,0,0,0,0,67
14,5,9,20,8,5,18,0,0,79
14,5,11,0,0,0,0,0,0,30
14,5,11,20,15,14,0,0,0,79
14,5,11,20,15,14,9,3,0,91
14,5,11,20,15,14,19,0,0,98
14,5,12,11,5,14,0,0,0,61
14,5,12,12,9,5,19,0,0,76
14,5,12,19,15,14,9,20,5,113
14,5,12,19,15,14,19,0,0,98
14,5,12,21,13,2,9,1,14,91
14,5,12,21,13,2,15,19,0,101
14,5,13,1,12,9,14,5,0,73
14,5,13,1,12,9,20,5,0,79
14,5,13,1,19,0,0,0,0,52
14,5,13,1,20,8,5,3,5,74
14,5,13,1,20,9,3,0,0,65
14,5,13,1,20,15,4,5,0,77
14,5,13,1,20,15,4,5,19,96
14,5,13,1,20,15,7,5,14,94
14,5,13,1,20,15,9,4,0,81
14,5,13,5,18,20,5,1,14,95
14,5,13,5,18,20,9,1,14,99
14,5,13,5,18,20,9,4,0,88
14,5,13,5,18,20,9,14,5,103
14,5,13,5,18,20,15,9,4,103
14,5,13,5,19,9,3,0,0,68
14,5,13,9,14,5,0,0,0,60
14,5,13,15,3,5,18,1,14,88
14,5,13,15,16,8,9,12,25,117
14,5,13,15,18,1,12,0,0,78
14,5,13,15,19,0,0,0,0,66
14,5,13,16,14,5,0,0,0,67
14,5,14,1,18,3,8,5,0,68
14,5,14,5,0,0,0,0,0,38
14,5,14,5,19,0,0,0,0,57
14,5,14,20,1,0,0,0,0,54
14,5,14,21,16,8,1,18,0,97
14,5,15,2,15,20,1,14,25,111
14,5,15,3,25,20,5,0,0,87
14,5,15,3,15,18,20,5,24,119
14,5,15,3,15,19,13,9,3,96
14,5,15,3,18,1,3,25,0,84
14,5,15,3,21,2,9,19,13,101
14,5,15,3,21,2,9,19,20,108
14,5,15,4,1,13,15,4,5,76
14,5,15,4,25,13,9,21,13,119
14,5,15,6,5,20,1,12,0,78
14,5,15,6,5,20,21,19,0,105
14,5,15,7,1,13,25,0,0,80
14,5,15,7,1,13,15,21,19,110
14,5,15,8,5,24,1,14,5,91
14,5,15,8,15,12,13,9,1,92
14,5,15,12,1,12,9,1,0,69
14,5,15,12,1,20,5,18,0,90
14,5,15,12,1,20,18,25,0,110
14,5,15,12,9,20,8,0,0,83
14,5,15,12,9,20,8,19,0,102
14,5,15,12,15,7,25,0,0,93
14,5,15,12,15,7,9,1,14,92
14,5,15,12,15,7,9,3,0,80
14,5,15,12,15,7,9,5,19,101
14,5,15,12,15,7,9,19,5,101
14,5,15,12,15,7,9,19,13,109
14,5,15,12,15,7,9,19,20,116
14,5,15,12,15,7,9,26,5,108
14,5,15,13,5,14,9,1,0,76
14,5,15,13,5,14,9,1,14,90
14,5,15,13,25,3,9,14,0,98
14,5,15,13,25,3,9,14,19,117
14,5,15,13,15,4,1,12,0,79
14,5,15,13,15,18,16,8,0,104
14,5,15,13,15,18,16,8,19,123
14,5,15,14,0,0,0,0,0,48
14,5,15,14,1,20,1,12,0,82
14,5,15,14,1,20,5,0,0,74
14,5,15,14,1,20,5,19,0,93
14,5,15,14,1,20,21,19,0,109
14,5,15,14,5,4,0,0,0,57
14,5,15,14,5,4,19,0,0,76
14,5,15,14,15,13,9,1,14,100
14,5,15,14,19,0,0,0,0,67
14,5,15,16,1,7,1,14,0,73
14,5,15,16,8,25,20,5,0,108
14,5,15,16,8,25,20,5,19,127
14,5,15,16,8,25,20,9,3,115
14,5,15,16,8,15,2,9,1,85
14,5,15,16,8,15,2,9,3,87
14,5,15,16,9,14,5,0,0,78
14,5,15,16,12,1,19,9,1,92
14,5,15,16,12,1,19,13,0,95
14,5,15,16,12,1,19,13,1,96
14,5,15,16,12,1,19,13,19,114
14,5,15,16,12,1,19,20,25,127
14,5,15,16,18,5,14,5,0,92
14,5,15,16,18,5,14,5,19,111
14,5,15,18,1,13,1,0,0,67
14,5,15,19,19,9,14,0,0,95
14,5,15,19,19,9,14,5,0,100
14,5,15,19,20,25,12,5,0,115
14,5,15,19,20,25,12,5,4,119
14,5,15,20,5,9,14,9,1,92
14,5,15,20,5,9,14,9,3,94
14,5,15,20,5,14,25,0,0,98
14,5,15,20,5,14,9,1,0,83
14,5,15,20,5,14,9,3,0,85
14,5,15,20,5,14,9,5,19,106
14,5,15,20,5,14,15,21,19,128
14,5,15,20,5,18,9,3,0,89
14,5,15,20,5,18,9,3,19,108
14,5,15,20,5,18,9,19,13,118
14,5,15,20,5,18,9,19,20,125
14,5,15,20,5,18,9,26,5,117
14,5,15,20,25,16,5,0,0,100
14,5,15,20,25,16,5,19,0,119
14,5,15,26,1,0,0,0,0,61
14,5,16,5,14,20,8,5,0,87
14,5,16,8,1,12,9,19,13,97
14,5,16,8,1,12,9,19,20,104
14,5,16,8,5,12,9,14,5,88
14,5,16,8,5,12,9,20,5,94
14,5,16,8,5,12,15,9,4,88
14,5,16,8,5,19,8,0,0,75
14,5,16,8,5,23,0,0,0,71
14,5,16,8,5,23,19,0,0,90
14,5,16,8,9,12,9,13,0,86
14,5,16,8,9,15,14,9,3,93
14,5,16,8,15,7,18,1,13,97
14,5,16,8,15,12,15,7,25,117
14,5,16,8,18,1,21,24,5,112
14,5,16,8,18,5,13,9,1,89
14,5,16,8,18,9,1,0,0,71
14,5,16,8,18,9,3,0,0,73
14,5,16,8,18,9,4,9,1,84
14,5,16,8,18,9,19,13,0,102
14,5,16,8,18,9,19,13,19,121
14,5,16,8,18,9,20,5,0,95
14,5,16,8,18,9,20,5,19,114
14,5,16,8,18,9,20,9,3,102
14,5,16,8,18,9,20,9,19,118
14,5,16,8,18,15,9,4,0,89
14,5,16,8,18,15,14,0,0,90
14,5,16,8,18,15,14,19,0,109
14,5,16,8,18,15,19,0,0,95
14,5,16,8,18,15,19,9,19,123
14,5,16,8,18,15,20,9,3,108
14,5,16,9,15,14,9,3,0,85
14,5,16,9,20,0,0,0,0,64
14,5,16,13,1,14,0,0,0,63
14,5,16,13,5,14,0,0,0,67
14,5,16,15,20,1,12,0,0,83
14,5,16,15,20,5,0,0,0,75
14,5,16,15,20,9,3,0,0,82
14,5,16,15,20,9,15,21,19,134
14,5,16,15,20,9,19,13,0,111
14,5,16,15,20,9,19,13,19,130
14,5,16,15,20,9,19,20,0,118
14,5,16,15,20,9,19,20,19,137
14,5,16,15,21,9,20,5,0,105
14,5,16,17,21,9,20,5,0,107
14,5,16,20,21,14,9,19,13,131
14,5,16,20,21,14,9,19,20,138
14,5,16,20,21,14,9,21,13,133
14,5,18,1,12,0,0,0,0,50
14,5,18,4,0,0,0,0,0,41
14,5,18,4,25,0,0,0,0,66
14,5,18,4,19,0,0,0,0,60
14,5,18,5,0,0,0,0,0,42
14,5,18,5,9,4,5,1,14,75
14,5,18,5,9,4,5,19,0,79
14,5,18,5,9,4,15,21,19,110
14,5,18,5,9,20,5,0,0,76
14,5,18,9,20,5,0,0,0,71
14,5,18,9,20,9,3,0,0,78
14,5,18,9,20,10,3,0,0,79
14,5,18,9,20,15,9,4,0,94
14,5,18,11,1,0,0,0,0,49
14,5,18,15,12,0,0,0,0,64
14,5,18,15,12,9,0,0,0,73
14,5,18,15,12,9,19,0,0,92
14,5,18,15,12,19,0,0,0,83
14,5,18,20,19,0,0,0,0,76
14,5,18,20,26,0,0,0,0,83
14,5,18,22,1,20,5,0,0,85
14,5,18,22,1,20,9,15,14,118
14,5,18,22,1,20,21,18,5,124
14,5,18,22,5,0,0,0,0,64
14,5,18,22,5,4,0,0,0,68
14,5,18,22,5,12,5,19,19,119
14,5,18,22,5,12,5,20,0,101
14,5,18,22,5,18,0,0,0,82
14,5,18,22,5,18,15,15,20,132
14,5,18,22,5,19,0,0,0,83
14,5,18,22,25,0,0,0,0,84
14,5,18,22,9,4,0,0,0,72
14,5,18,22,9,4,21,3,20,116
14,5,18,22,9,5,18,0,0,91
14,5,18,22,9,5,19,20,0,112
14,5,18,22,9,12,25,0,0,105
14,5,18,22,9,14,5,0,0,87
14,5,18,22,9,14,5,19,0,106
14,5,18,22,9,14,5,19,19,125
14,5,18,22,9,14,7,0,0,89
14,5,18,22,9,14,7,19,0,108
14,5,18,22,9,19,8,0,0,95
14,5,18,22,9,19,13,0,0,100
14,5,18,22,15,19,1,0,0,94
14,5,18,22,15,19,5,0,0,98
14,5,18,22,15,19,9,19,13,134
14,5,18,22,15,19,9,20,25,147
14,5,18,22,15,21,19,0,0,114
14,5,18,22,15,21,19,12,25,151
14,5,18,22,21,12,1,18,0,111
14,5,18,22,21,12,5,0,0,97
14,5,18,22,21,12,5,19,0,116
14,5,18,22,21,12,5,20,0,117
14,5,18,22,21,12,15,19,5,131
14,5,18,22,21,18,5,0,0,103
14,5,18,22,21,18,5,19,0,122
14,5,18,22,21,19,0,0,0,99
14,5,19,3,9,5,14,3,5,77
14,5,19,3,9,5,14,20,0,89
14,5,19,3,9,5,14,20,19,108
14,5,19,5,0,0,0,0,0,43
14,5,19,8,0,0,0,0,0,46
14,5,19,8,12,25,0,0,0,83
14,5,19,8,14,5,19,19,0,103
14,5,19,9,15,20,5,0,0,87
14,5,19,12,1,22,5,0,0,78
14,5,19,19,0,0,0,0,0,57
14,5,19,19,2,5,18,18,25,125
14,5,19,19,5,19,0,0,0,81
14,5,19,20,0,0,0,0,0,58
14,5,19,20,1,2,12,5,0,78
14,5,19,20,1,7,5,0,0,71
14,5,19,20,5,4,0,0,0,67
14,5,19,20,5,18,19,0,0,100
14,5,19,20,6,21,12,0,0,97
14,5,19,20,25,0,0,0,0,83
14,5,19,20,9,14,7,0,0,88
14,5,19,20,9,14,7,19,0,107
14,5,19,20,12,5,0,0,0,75
14,5,19,20,12,5,4,0,0,79
14,5,19,20,12,5,18,0,0,93
14,5,19,20,12,5,18,19,0,112
14,5,19,20,12,5,19,0,0,94
14,5,19,20,12,9,11,5,0,95
14,5,19,20,12,9,14,7,0,100
14,5,19,20,12,9,14,7,19,119
14,5,19,20,15,18,9,14,5,119
14,5,19,20,15,18,19,0,0,110
14,5,19,20,19,0,0,0,0,77
14,5,20,2,1,12,12,0,0,66
14,5,20,2,21,19,8,0,0,89
14,5,20,3,8,1,0,0,0,51
14,5,20,5,0,0,0,0,0,44
14,5,20,5,18,0,0,0,0,62
14,5,20,6,21,12,0,0,0,78
14,5,20,8,5,9,19,20,0,100
14,5,20,8,5,18,0,0,0,70
14,5,20,11,5,5,16,5,18,99
14,5,20,12,5,1,6,0,0,63
14,5,20,12,5,19,19,0,0,94
14,5,20,12,9,11,5,0,0,76
14,5,20,13,1,11,5,18,0,87
14,5,20,13,1,11,9,14,7,94
14,5,20,13,1,14,0,0,0,67
14,5,20,13,5,14,0,0,0,71
14,5,20,13,9,14,4,5,18,102
14,5,20,13,15,14,7,5,18,111
14,5,20,15,16,0,0,0,0,70
14,5,20,15,16,19,0,0,0,89
14,5,20,19,0,0,0,0,0,58
14,5,20,19,13,1,14,0,0,86
14,5,20,19,21,11,5,0,0,95
14,5,20,19,21,11,5,19,0,114
14,5,20,20,1,2,12,5,0,79
14,5,20,20,1,2,12,25,0,99
14,5,20,20,5,4,0,0,0,68
14,5,20,20,5,18,0,0,0,82
14,5,20,20,5,18,19,0,0,101
14,5,20,20,9,5,18,0,0,91
14,5,20,20,9,5,19,20,0,112
14,5,20,20,9,14,7,0,0,89
14,5,20,20,9,14,7,19,0,108
14,5,20,20,12,5,2,5,4,87
14,5,20,20,12,5,4,0,0,80
14,5,20,20,12,5,18,0,0,94
14,5,20,20,12,5,18,19,0,113
14,5,20,20,12,5,19,0,0,95
14,5,20,20,12,25,0,0,0,96
14,5,20,20,12,9,5,18,0,103
14,5,20,20,12,9,5,19,20,124
14,5,20,20,12,9,14,7,0,101
14,5,20,20,19,0,0,0,0,78
14,5,20,23,9,19,5,0,0,95
14,5,20,23,15,18,11,0,0,106
14,5,20,23,15,18,11,5,4,115
14,5,20,23,15,18,11,19,0,125
14,5,21,11,0,0,0,0,0,51
14,5,21,11,19,0,0,0,0,70
14,5,21,13,0,0,0,0,0,53
14,5,21,13,1,0,0,0,0,54
14,5,21,13,1,20,9,3,0,86
14,5,21,13,1,20,9,26,5,114
14,5,21,13,5,0,0,0,0,58
14,5,21,13,5,19,0,0,0,77
14,5,21,13,9,3,0,0,0,65
14,5,21,13,19,0,0,0,0,72
14,5,21,18,1,4,0,0,0,63
14,5,21,18,1,12,0,0,0,71
14,5,21,18,1,12,5,0,0,76
14,5,21,18,1,12,7,25,0,103
14,5,21,18,1,12,7,9,1,88
14,5,21,18,1,12,7,9,3,90
14,5,21,18,1,12,9,19,20,119
14,5,21,18,1,12,12,25,0,108
14,5,21,18,1,20,1,24,25,129
14,5,21,18,1,20,9,15,14,117
14,5,21,18,1,24,9,1,12,105
14,5,21,18,1,24,9,19,0,111
14,5,21,18,1,24,15,14,0,112
14,5,21,18,1,24,15,14,5,117
14,5,21,18,1,24,15,14,19,131
14,5,21,18,5,18,7,9,3,100
14,5,21,18,9,1,20,18,25,131
14,5,21,18,9,3,0,0,0,70
14,5,21,18,9,4,9,14,5,99
14,5,21,18,9,12,5,13,1,98
14,5,21,18,9,12,9,20,25,133
14,5,21,18,9,14,0,0,0,81
14,5,21,18,9,14,5,0,0,86
14,5,21,18,9,14,5,19,0,105
14,5,21,18,9,14,15,13,1,110
14,5,21,18,9,19,13,0,0,99
14,5,21,18,9,19,20,15,18,139
14,5,21,18,9,20,5,0,0,92
14,5,21,18,9,20,9,3,0,99
14,5,21,18,9,20,9,3,19,118
14,5,21,18,9,20,9,19,0,115
14,5,21,18,15,3,5,12,5,98
14,5,21,18,15,3,25,20,5,126
14,5,21,18,15,3,9,20,25,130
14,5,21,18,15,3,15,5,12,108
14,5,21,18,15,6,9,12,0,100
14,5,21,18,15,7,12,9,1,102
14,5,21,18,15,7,12,9,3,104
14,5,21,18,15,7,18,1,13,112
14,5,21,18,15,9,4,0,0,86
14,5,21,18,15,11,25,13,5,127
14,5,21,18,15,12,0,0,0,85
14,5,21,18,15,12,9,20,5,119
14,5,21,18,15,12,15,7,25,132
14,5,21,18,15,13,1,0,0,87
14,5,21,18,15,13,1,19,0,106
14,5,21,18,15,13,1,19,20,126
14,5,21,18,15,13,1,20,1,108
14,5,21,18,15,13,5,18,5,114
14,5,21,18,15,13,25,9,3,123
14,5,21,18,15,14,0,0,0,87
14,5,21,18,15,14,1,12,0,100
14,5,21,18,15,14,5,0,0,92
14,5,21,18,15,14,5,19,0,111
14,5,21,18,15,14,9,3,0,99
14,5,21,18,15,14,25,13,0,125
14,5,21,18,15,14,25,13,25,150
14,5,21,18,15,14,9,19,13,128
14,5,21,18,15,14,9,19,20,135
14,5,21,18,15,14,19,0,0,106
14,5,21,18,15,16,1,20,8,118
14,5,21,18,15,16,8,9,12,118
14,5,21,18,15,16,9,12,0,110
14,5,21,18,15,16,9,12,5,115
14,5,21,18,15,16,15,4,0,108
14,5,21,18,15,16,15,18,5,127
14,5,21,18,15,16,20,5,18,132
14,5,21,18,15,19,1,12,0,105
14,5,21,18,15,19,5,19,0,116
14,5,21,18,15,19,9,19,0,120
14,5,21,18,15,19,15,13,5,125
14,5,21,18,15,20,9,3,0,105
14,5,21,18,15,20,9,3,19,124
14,5,21,18,15,20,15,13,5,126
14,5,21,18,15,20,15,13,25,146
14,5,21,18,21,1,12,0,0,92
14,5,21,18,21,12,1,0,0,92
14,5,21,18,21,12,1,5,0,97
14,5,21,18,21,12,1,19,0,111
14,5,21,19,20,9,3,0,0,91
14,5,21,19,20,15,14,0,0,108
14,5,21,19,20,15,14,9,3,120
14,5,21,19,20,15,14,19,0,127
14,5,21,20,0,0,0,0,0,60
14,5,21,20,5,18,0,0,0,83
14,5,21,20,5,18,4,15,13,115
14,5,21,20,5,18,5,4,0,92
14,5,21,20,5,18,9,14,7,113
14,5,21,20,5,18,12,25,0,120
14,5,21,20,5,18,19,0,0,102
14,5,21,20,18,1,12,0,0,91
14,5,21,20,18,1,12,12,25,128
14,5,21,20,18,1,12,19,0,110
14,5,21,20,18,5,20,20,15,138
14,5,21,20,18,9,1,0,0,88
14,5,21,20,18,9,14,15,0,116
14,5,21,20,18,9,14,15,19,135
14,5,21,20,18,15,14,0,0,107
14,5,21,20,18,15,14,19,0,126
14,5,22,1,4,1,14,19,0,80
14,5,22,1,4,9,1,14,19,89
14,5,22,1,4,9,20,5,0,80
14,5,22,1,20,0,0,0,0,62
14,5,22,5,12,0,0,0,0,58
14,5,22,5,12,12,0,0,0,70
14,5,22,5,14,0,0,0,0,60
14,5,22,5,18,0,0,0,0,64
14,5,22,5,18,13,1,19,19,116
14,5,22,5,18,13,9,14,4,104
14,5,22,5,18,13,15,18,5,115
14,5,22,5,18,14,5,19,19,121
14,5,22,5,19,0,0,0,0,65
14,5,22,9,0,0,0,0,0,50
14,5,22,15,0,0,0,0,0,56
14,5,22,15,25,0,0,0,0,81
14,5,22,15,9,4,0,0,0,69
14,5,22,21,19,0,0,0,0,81
14,5,23,2,15,18,14,0,0,91
14,5,23,2,15,18,14,19,0,110
14,5,23,3,1,12,0,0,0,58
14,5,23,3,15,13,5,0,0,78
14,5,23,3,15,13,5,18,19,115
14,5,23,5,12,19,0,0,0,78
14,5,23,5,12,20,25,0,0,104
14,5,23,5,18,0,0,0,0,65
14,5,23,5,19,20,0,0,0,86
14,5,23,6,1,14,7,12,5,87
14,5,23,6,9,19,8,0,0,84
14,5,23,6,15,21,14,4,0,102
14,5,23,7,18,15,21,14,4,121
14,5,23,9,5,0,0,0,0,56
14,5,23,9,5,19,0,0,0,75
14,5,23,9,14,7,0,0,0,72
14,5,23,9,14,7,19,0,0,91
14,5,23,9,19,8,0,0,0,78
14,5,23,12,25,0,0,0,0,79
14,5,23,12,9,7,8,20,0,98
14,5,23,12,9,14,5,0,0,82
14,5,23,12,9,14,5,19,0,101
14,5,23,12,9,14,7,19,0,103
14,5,23,12,9,14,19,0,0,96
14,5,23,12,25,23,5,4,0,111
14,5,23,12,25,23,5,4,19,130
14,5,23,13,15,23,14,0,0,107
14,5,23,14,5,19,19,0,0,99
14,5,23,14,5,19,19,5,19,123
14,5,23,19,1,7,5,14,20,108
14,5,23,19,2,5,1,20,0,89
14,5,23,19,2,9,12,12,0,96
14,5,23,19,2,15,1,18,4,101
14,5,23,19,2,15,1,20,0,99
14,5,23,19,2,15,25,0,0,103
14,5,23,19,2,15,25,19,0,122
14,5,23,19,2,18,5,1,11,98
14,5,23,19,3,1,19,20,0,104
14,5,23,19,3,1,19,20,19,123
14,5,23,19,6,21,12,0,0,100
14,5,23,19,7,9,18,12,0,107
14,5,23,19,7,9,18,12,19,126
14,5,23,19,7,18,15,21,16,138
14,5,23,19,8,1,23,11,0,104
14,5,23,19,8,5,14,0,0,88
14,5,23,19,8,15,21,14,4,123
14,5,23,19,25,0,0,0,0,86
14,5,23,19,9,5,0,0,0,75
14,5,23,19,9,5,18,0,0,93
14,5,23,19,9,5,19,0,0,94
14,5,23,19,9,5,19,20,0,114
14,5,23,19,9,14,5,19,19,127
14,5,23,19,12,5,19,19,0,116
14,5,23,19,13,1,14,0,0,89
14,5,23,19,13,5,14,0,0,93
14,5,23,19,16,1,16,5,18,117
14,5,23,19,16,5,1,11,0,94
14,5,23,19,16,5,1,11,19,113
14,5,23,19,16,18,9,14,20,138
14,5,23,19,18,5,5,12,0,101
14,5,23,19,18,5,5,12,19,120
14,5,23,19,18,15,15,13,0,122
14,5,23,19,18,15,15,13,19,141
14,5,23,19,19,8,5,5,20,118
14,5,23,19,19,20,1,14,4,119
14,5,23,19,20,1,14,4,0,100
14,5,23,19,20,1,14,4,19,119
14,5,23,19,23,15,13,1,14,127
14,5,23,19,23,15,13,5,14,131
14,5,23,20,1,11,5,0,0,79
14,5,23,20,15,14,9,20,5,125
14,5,23,20,15,14,19,0,0,110
14,5,23,20,19,0,0,0,0,81
14,5,24,1,12,0,0,0,0,56
14,5,24,20,4,15,15,18,0,115
14,5,24,20,12,25,0,0,0,100
14,5,24,20,14,5,19,19,0,120
14,5,24,21,13,0,0,0,0,77
14,5,24,21,19,0,0,0,0,83
14,5,24,21,19,5,19,0,0,107
14,7,15,13,1,0,0,0,0,50
14,7,21,12,20,18,21,13,0,126
14,7,23,5,5,0,0,0,0,54
14,9,2,0,0,0,0,0,0,25
14,9,2,2,1,14,1,0,0,43
14,9,2,2,5,4,0,0,0,36
14,9,2,2,5,18,0,0,0,50
14,9,2,2,25,0,0,0,0,52
14,9,2,2,9,14,7,0,0,57
14,9,2,2,12,5,0,0,0,44
14,25,2,2,12,5,0,0,0,60
14,9,2,2,12,5,4,0,0,48
14,9,2,2,12,5,18,0,0,62
14,9,2,2,12,5,18,19,0,81
14,9,2,2,12,5,19,0,0,63
14,25,2,2,12,5,19,0,0,79
14,9,2,2,12,9,14,7,0,69
14,25,2,2,12,9,26,5,0,95
14,9,2,12,9,3,0,0,0,49
14,9,2,12,9,3,11,0,0,60
14,9,2,12,9,3,11,19,0,79
14,9,2,12,9,11,5,0,0,62
14,9,2,15,14,7,0,0,0,61
14,9,2,19,0,0,0,0,0,44
14,9,2,19,15,13,5,0,0,77
14,9,2,21,14,7,0,0,0,67
14,9,3,1,4,0,0,0,0,31
14,9,3,1,4,19,0,0,0,50
14,9,3,3,15,12,9,3,0,68
14,9,3,3,15,12,9,20,5,90
14,9,3,3,15,12,15,21,19,111
14,9,3,5,9,19,8,0,0,67
14,9,3,5,12,25,0,0,0,68
14,9,3,5,12,9,14,7,0,73
14,9,3,5,14,5,19,19,0,88
14,9,3,5,18,0,0,0,0,49
14,9,3,5,19,15,13,5,0,83
14,9,3,5,19,20,0,0,0,70
14,9,3,5,20,25,0,0,0,76
14,9,3,5,20,9,5,19,0,84
14,9,3,5,20,9,19,8,0,87
14,9,3,8,1,5,12,0,0,52
14,9,3,8,5,0,0,0,0,39
14,9,3,8,5,4,0,0,0,43
14,9,3,8,5,12,9,14,15,89
14,9,3,8,5,18,0,0,0,57
14,9,3,8,5,19,0,0,0,58
14,9,3,8,5,22,15,0,0,76
14,9,3,8,9,12,0,0,0,55
14,9,3,8,9,14,7,0,0,64
14,9,3,8,20,0,0,0,0,54
14,9,3,8,20,19,0,0,0,73
14,9,3,9,0,0,0,0,0,35
14,9,3,11,1,18,0,0,0,56
14,9,3,11,5,4,0,0,0,46
14,9,3,11,5,25,19,0,0,86
14,9,3,11,5,12,0,0,0,54
14,9,3,11,5,12,1,7,5,67
14,9,3,11,5,12,5,4,0,63
14,9,3,11,5,12,9,3,0,66
14,9,3,11,5,12,9,14,5,82
14,9,3,11,5,12,9,14,7,84
14,9,3,11,5,12,9,19,5,87
14,9,3,11,5,12,9,26,5,94
14,9,3,11,5,12,12,5,4,75
14,9,3,11,5,12,15,21,19,109
14,9,3,11,5,12,19,0,0,73
14,9,3,11,5,18,0,0,0,60
14,9,3,11,5,18,5,4,0,69
14,9,3,11,5,18,25,0,0,85
14,9,3,11,5,18,9,14,7,90
14,9,3,11,5,18,19,0,0,79
14,9,3,11,9,14,7,0,0,67
14,9,3,11,12,5,0,0,0,54
14,9,3,11,12,5,4,0,0,58
14,9,3,11,12,9,14,7,0,79
14,9,3,11,14,1,3,11,0,66
14,9,3,11,14,1,3,11,19,85
14,9,3,11,14,1,13,5,0,70
14,9,3,11,14,1,13,5,4,74
14,9,3,11,14,1,13,5,5,75
14,9,3,11,14,1,13,5,18,88
14,9,3,11,14,1,13,5,19,89
14,9,3,11,16,15,9,14,20,111
14,9,3,11,16,15,20,0,0,88
14,9,3,11,19,20,9,3,11,99
14,9,3,11,21,13,0,0,0,71
14,9,3,15,12,15,0,0,0,68
14,9,3,15,12,19,0,0,0,72
14,9,3,15,20,9,1,0,0,71
14,9,3,15,20,9,1,14,0,85
14,9,3,15,20,9,3,0,0,73
14,9,3,15,20,9,14,0,0,84
14,9,3,15,20,9,14,1,0,85
14,9,3,15,20,9,14,5,0,89
14,9,3,15,20,9,14,5,4,93
14,9,3,15,20,9,14,5,19,108
14,9,3,15,20,9,14,9,3,96
14,9,3,15,20,9,14,19,0,103
14,9,3,15,20,9,19,13,0,102
14,9,3,15,20,9,26,5,0,101
14,25,3,20,1,12,7,9,1,92
14,25,3,20,1,12,15,16,5,111
14,25,3,20,1,12,15,16,25,131
14,25,3,20,1,12,15,16,19,125
14,9,3,20,1,20,5,0,0,72
14,9,3,20,1,20,5,4,0,76
14,9,3,20,1,20,5,19,0,91
14,9,3,20,1,20,9,14,7,97
14,9,3,20,1,20,9,15,14,105
14,25,3,20,5,18,9,14,5,113
14,9,3,20,9,20,1,14,20,110
14,9,3,20,9,20,1,20,5,101
14,25,3,20,21,18,9,1,0,111
14,9,4,0,0,0,0,0,0,27
14,9,4,1,12,0,0,0,0,40
14,9,4,1,14,1,0,0,0,43
14,9,4,1,18,25,0,0,0,71
14,9,4,1,20,9,15,14,0,86
14,9,4,1,20,15,18,25,0,106
14,9,4,4,5,18,0,0,0,54
14,9,4,4,5,18,9,14,7,84
14,9,4,4,9,3,11,0,0,54
14,9,4,4,9,3,15,3,11,72
14,9,4,4,12,5,0,0,0,48
14,9,4,5,0,0,0,0,0,32
14,9,4,5,4,0,0,0,0,36
14,9,4,5,18,9,14,7,0,80
14,9,4,5,18,9,14,7,19,99
14,9,4,5,19,0,0,0,0,51
14,9,4,7,5,0,0,0,0,39
14,9,4,7,5,20,0,0,0,59
14,9,4,7,5,20,25,0,0,84
14,9,4,7,5,20,19,0,0,78
14,9,4,9,0,0,0,0,0,36
14,9,4,9,6,25,0,0,0,67
14,9,4,9,6,9,5,4,0,60
14,9,4,9,6,9,5,18,0,74
14,9,4,9,6,9,5,19,0,75
14,9,4,9,6,25,9,14,7,97
14,9,4,9,14,7,0,0,0,57
14,9,4,9,15,20,0,0,0,71
14,9,4,15,12,15,7,25,0,101
14,9,4,15,18,0,0,0,0,60
14,9,4,15,18,15,19,5,0,99
14,9,4,15,18,15,21,19,0,115
14,9,4,21,4,9,0,0,0,61
14,9,4,21,12,1,14,20,0,95
14,9,4,21,12,1,20,5,0,86
14,9,4,21,12,9,0,0,0,69
14,9,4,21,12,21,19,0,0,100
14,9,4,21,19,0,0,0,0,67
14,9,4,21,19,5,19,0,0,91
14,9,5,3,5,0,0,0,0,36
14,9,5,3,5,12,5,19,19,91
14,9,5,3,5,19,0,0,0,55
14,9,5,3,5,19,8,9,16,88
14,9,5,12,12,1,20,5,4,82
14,9,5,12,12,5,4,0,0,61
14,9,5,12,12,9,0,0,0,61
14,9,5,12,12,9,19,20,0,100
14,9,5,12,12,9,19,20,19,119
14,9,5,12,12,15,0,0,0,67
14,9,5,12,12,15,5,4,0,76
14,9,5,12,12,15,9,14,7,97
14,9,5,12,12,15,19,0,0,86
14,9,5,16,1,0,0,0,0,45
14,9,5,19,8,15,21,20,0,111
14,25,5,20,0,0,0,0,0,64
14,9,5,22,5,0,0,0,0,55
14,9,5,22,5,19,0,0,0,74
14,9,5,22,5,20,1,0,0,76
14,9,5,22,12,9,14,7,0,92
14,9,6,5,0,0,0,0,0,34
14,9,6,5,19,9,13,1,0,76
14,9,6,6,0,0,0,0,0,35
14,9,6,6,5,18,0,0,0,58
14,9,6,6,5,18,5,4,0,67
14,9,6,6,5,18,9,14,7,88
14,9,6,6,5,18,19,0,0,77
14,9,6,9,3,0,0,0,0,41
14,9,6,12,5,0,0,0,0,46
14,9,6,12,9,14,7,0,0,71
14,9,6,20,25,0,0,0,0,74
14,9,6,20,9,5,18,0,0,81
14,9,6,20,9,5,19,0,0,82
14,9,6,20,9,5,19,20,0,102
14,9,6,20,9,12,25,0,0,95
14,9,6,20,9,14,5,19,19,115
14,9,7,5,18,9,1,14,19,96
14,9,7,7,1,18,4,0,0,60
14,9,7,7,1,18,4,5,4,69
14,9,7,7,1,18,4,12,25,97
14,9,7,7,1,18,4,19,0,79
14,9,7,7,5,4,0,0,0,46
14,9,7,7,5,18,0,0,0,60
14,9,7,7,5,18,4,15,13,92
14,9,7,7,5,18,5,4,0,69
14,9,7,7,5,18,25,0,0,85
14,9,7,7,5,18,9,19,8,96
14,9,7,7,5,18,9,19,13,101
14,9,7,7,5,18,19,0,0,79
14,9,7,7,5,18,20,15,5,100
14,9,7,7,5,20,0,0,0,62
14,9,7,7,9,14,7,0,0,67
14,9,7,7,12,5,0,0,0,54
14,9,7,7,12,5,4,0,0,58
14,9,7,7,12,5,18,0,0,72
14,9,7,7,12,5,18,19,0,91
14,9,7,7,12,5,19,0,0,73
14,9,7,7,12,25,0,0,0,74
14,9,7,7,12,9,14,7,0,79
14,9,7,7,12,9,14,7,19,98
14,9,7,7,15,20,0,0,0,72
14,9,7,7,18,1,0,0,0,56
14,9,7,7,21,14,0,0,0,72
14,9,7,8,0,0,0,0,0,38
14,9,7,8,5,4,0,0,0,47
14,9,7,8,5,18,0,0,0,61
14,9,7,8,5,19,20,0,0,82
14,9,7,8,8,1,14,4,0,65
14,9,7,8,9,14,7,0,0,68
14,9,7,8,9,19,8,0,0,74
14,9,7,8,12,25,0,0,0,75
14,9,7,8,14,5,19,19,0,95
14,9,7,8,19,0,0,0,0,57
14,9,7,8,20,0,0,0,0,58
14,9,7,8,20,3,1,16,0,78
14,9,7,8,20,3,1,16,19,97
14,9,7,8,20,3,12,21,2,96
14,9,7,8,20,5,4,0,0,67
14,9,7,8,20,5,18,0,0,81
14,9,7,8,20,5,18,25,0,106
14,9,7,8,20,5,18,19,0,100
14,9,7,8,20,6,1,12,12,89
14,9,7,8,20,6,9,19,8,100
14,9,7,8,20,6,12,9,20,105
14,9,7,8,20,6,15,23,12,114
14,9,7,8,20,7,1,12,5,83
14,9,7,8,20,7,12,15,23,115
14,9,7,8,20,7,15,23,14,117
14,9,7,8,20,8,1,23,11,101
14,9,7,8,20,25,0,0,0,83
14,9,7,8,20,9,5,0,0,72
14,9,7,8,20,9,5,19,0,91
14,9,7,8,20,9,13,5,0,85
14,9,7,8,20,9,14,7,0,88
14,9,7,8,20,9,19,8,0,94
14,9,7,8,20,10,1,18,0,87
14,9,7,8,20,10,1,18,19,106
14,9,7,8,20,12,5,19,19,113
14,9,7,8,20,12,25,0,0,95
14,9,7,8,20,12,9,6,5,90
14,9,7,8,20,12,9,11,5,95
14,9,7,8,20,12,15,14,7,106
14,9,7,8,20,13,1,14,0,86
14,9,7,8,20,13,1,18,5,95
14,9,7,8,20,13,1,18,25,115
14,9,7,8,20,13,5,14,0,90
14,9,7,8,20,19,0,0,0,77
14,9,7,8,20,19,9,4,5,95
14,9,7,8,20,19,16,15,20,128
14,9,7,8,20,20,9,4,5,96
14,9,7,8,20,20,9,13,5,105
14,9,7,8,20,23,1,11,5,98
14,9,7,8,20,23,1,12,11,105
14,9,7,8,20,23,1,18,4,104
14,9,7,8,20,23,5,1,18,105
14,9,7,8,20,23,15,18,11,125
14,9,7,14,1,25,0,0,0,70
14,9,7,14,25,5,0,0,0,74
14,9,7,15,18,9,0,0,0,72
14,9,7,18,5,0,0,0,0,53
14,9,7,18,9,3,1,14,20,95
14,9,7,18,9,6,25,0,0,88
14,9,7,18,9,6,9,5,4,81
14,9,7,18,9,6,9,5,19,96
14,9,7,18,9,14,5,0,0,76
14,9,7,18,9,20,9,5,19,110
14,9,7,18,9,20,21,4,5,107
14,9,7,18,15,19,9,14,0,105
14,9,7,18,15,19,9,14,5,110
14,9,7,18,15,19,9,14,19,124
14,9,7,18,15,21,19,0,0,103
14,9,7,21,1,0,0,0,0,52
14,9,8,9,12,0,0,0,0,52
14,9,8,9,12,9,6,25,0,92
14,9,8,9,12,9,19,13,19,112
14,9,8,9,12,9,19,20,0,100
14,9,8,9,12,9,19,20,19,119
14,9,8,9,12,9,20,25,0,106
14,9,8,9,12,9,20,9,3,93
14,9,8,9,12,19,0,0,0,71
14,9,8,9,12,21,13,0,0,86
14,9,25,1,13,1,0,0,0,63
14,9,25,1,14,4,1,0,0,68
14,9,25,15,7,1,0,0,0,71
14,9,10,8,15,12,20,0,0,88
14,9,11,0,0,0,0,0,0,34
14,9,11,1,21,0,0,0,0,56
14,9,11,11,21,4,0,0,0,70
14,9,11,11,21,4,9,13,0,92
14,9,11,12,5,19,9,20,5,104
14,25,12,1,19,20,0,0,0,91
14,9,12,7,1,9,0,0,0,52
14,9,12,7,1,9,19,0,0,71
14,9,12,7,1,21,0,0,0,64
14,25,12,7,1,21,0,0,0,80
14,9,12,7,1,21,19,0,0,83
14,9,12,7,8,1,9,0,0,60
14,25,12,7,8,1,9,0,0,76
14,9,12,7,8,1,9,19,0,79
14,25,12,7,8,1,9,19,0,95
14,9,12,7,8,1,21,0,0,72
14,25,12,7,8,1,21,0,0,88
14,9,12,7,8,1,21,19,0,91
14,25,12,7,8,1,21,19,0,107
14,9,12,12,0,0,0,0,0,47
14,9,12,12,5,4,0,0,0,56
14,9,12,12,9,14,7,0,0,77
14,9,12,12,19,0,0,0,0,66
14,25,12,15,14,0,0,0,0,80
14,25,12,15,14,19,0,0,0,99
14,9,12,16,15,20,5,14,20,125
14,9,13,2,0,0,0,0,0,38
14,9,13,2,1,20,5,4,0,68
14,9,13,2,5,4,0,0,0,47
14,9,13,2,9,0,0,0,0,47
14,9,13,2,12,5,0,0,0,55
14,9,13,2,12,5,18,0,0,73
14,9,13,2,12,5,19,20,0,94
14,9,13,2,12,5,23,9,20,107
14,9,13,2,12,25,0,0,0,75
14,9,13,2,15,19,5,0,0,77
14,9,13,2,15,19,9,20,25,126
14,9,13,2,21,19,5,4,0,87
14,9,13,2,21,19,5,19,0,102
14,9,13,9,5,20,25,0,0,95
14,9,13,9,5,20,9,5,19,103
14,25,13,9,12,0,0,0,0,73
14,9,13,9,14,25,0,0,0,84
14,9,13,9,15,21,19,0,0,100
14,9,13,13,5,4,0,0,0,58
14,9,13,13,5,18,0,0,0,72
14,9,13,13,9,14,7,0,0,79
14,25,13,16,8,0,0,0,0,76
14,25,13,16,8,1,0,0,0,77
14,25,13,16,8,1,5,0,0,82
14,25,13,16,8,1,5,21,13,116
14,25,13,16,8,1,12,0,0,89
14,25,13,16,8,1,12,9,4,102
14,25,13,16,8,5,1,12,0,94
14,25,13,16,8,5,1,14,0,96
14,25,13,16,8,5,20,0,0,101
14,25,13,16,8,5,20,19,0,120
14,25,13,16,8,5,20,20,5,126
14,25,13,16,8,5,21,13,0,115
14,25,13,16,8,9,3,0,0,88
14,25,13,16,8,9,3,1,12,101
14,25,13,16,8,9,4,0,0,89
14,25,13,16,8,9,14,5,0,104
14,25,13,16,8,9,19,8,0,112
14,25,13,16,8,9,20,9,19,133
14,25,13,16,8,12,25,0,0,113
14,25,13,16,8,12,9,11,5,113
14,25,13,16,8,12,9,14,0,111
14,25,13,16,8,15,0,0,0,91
14,25,13,16,8,15,14,0,0,105
14,25,13,16,8,15,19,0,0,110
14,25,13,16,8,15,19,9,19,138
14,25,13,16,8,19,0,0,0,95
14,25,13,16,8,23,9,19,5,132
14,9,13,18,15,4,19,0,0,92
14,9,13,19,8,9,0,0,0,72
14,25,13,19,19,0,0,0,0,90
14,9,14,3,15,13,0,0,0,68
14,9,14,3,21,13,0,0,0,74
14,9,14,5,2,1,18,11,0,74
14,9,14,5,2,1,18,11,19,93
14,9,14,5,6,15,12,4,0,79
14,9,14,5,8,15,12,5,19,101
14,9,14,5,16,5,7,19,0,89
14,9,14,5,16,5,14,3,5,85
14,9,14,5,16,5,14,14,25,116
14,9,14,5,16,9,14,0,0,81
14,9,14,5,16,9,14,19,0,100
14,9,14,5,19,0,0,0,0,61
14,9,14,5,19,3,15,18,5,102
14,9,14,5,20,5,4,0,0,71
14,9,14,5,20,5,5,14,0,86
14,9,14,5,20,5,5,14,19,105
14,9,14,5,20,25,0,0,0,87
14,9,14,5,20,9,5,19,0,95
14,9,14,5,20,9,5,20,8,104
14,9,14,5,20,25,9,19,8,123
14,9,14,7,0,0,0,0,0,44
14,9,14,7,12,5,0,0,0,61
14,9,14,8,25,4,18,9,14,115
14,9,14,10,1,0,0,0,0,48
14,9,14,10,1,19,0,0,0,67
14,9,14,14,25,0,0,0,0,76
14,9,14,14,9,5,19,0,0,84
14,9,14,14,25,9,19,8,0,112
14,9,14,14,25,9,19,13,0,117
14,9,14,14,25,19,8,9,16,128
14,9,14,15,14,19,0,0,0,85
14,9,14,20,8,0,0,0,0,65
14,9,14,20,8,12,25,0,0,102
14,9,14,20,8,19,0,0,0,84
14,9,14,20,21,0,0,0,0,78
14,9,14,21,20,0,0,0,0,78
14,9,15,2,1,20,5,0,0,66
14,9,15,2,9,3,0,0,0,52
14,9,15,2,9,21,13,0,0,83
14,9,15,2,9,21,13,19,0,102
14,9,15,2,15,21,19,0,0,95
14,9,15,7,0,0,0,0,0,45
14,9,16,1,0,0,0,0,0,40
14,9,16,1,19,0,0,0,0,59
14,9,16,3,8,5,5,19,5,84
14,9,16,16,5,4,0,0,0,64
14,9,16,16,5,18,0,0,0,78
14,9,16,16,5,18,11,9,14,112
14,9,16,16,5,18,19,0,0,97
14,9,16,16,25,0,0,0,0,80
14,9,16,16,9,5,18,0,0,87
14,9,16,16,9,5,19,20,0,108
14,9,16,16,9,12,25,0,0,101
14,9,16,16,9,14,5,19,19,121
14,9,16,16,9,14,7,0,0,85
14,9,16,16,9,14,7,12,25,122
14,9,16,16,9,20,1,20,5,110
14,9,16,16,9,20,1,20,25,130
14,9,16,16,9,20,1,20,15,120
14,9,16,16,12,5,0,0,0,72
14,9,16,16,12,5,4,0,0,76
14,9,16,16,12,5,19,0,0,91
14,9,16,16,12,9,14,7,0,97
14,9,16,16,15,14,9,21,13,127
14,9,16,19,0,0,0,0,0,58
14,9,16,20,5,18,0,0,0,82
14,9,18,9,19,0,0,0,0,69
14,9,18,12,5,19,0,0,0,77
14,9,18,12,19,0,0,0,0,72
14,9,18,22,1,14,1,0,0,79
14,9,18,22,1,14,1,19,0,98
14,9,18,22,1,14,9,3,0,90
14,9,19,2,5,18,18,25,0,110
14,9,19,5,9,19,0,0,0,75
14,9,19,8,9,11,9,0,0,79
14,9,19,9,0,0,0,0,0,51
14,9,19,14,1,19,0,0,0,76
14,9,19,16,5,18,15,0,0,96
14,25,19,20,1,7,13,9,3,111
14,25,19,20,1,7,13,21,19,139
14,25,19,20,1,20,9,14,0,122
14,9,19,21,19,0,0,0,0,82
14,9,20,0,0,0,0,0,0,43
14,9,20,3,8,0,0,0,0,54
14,9,20,3,8,5,22,15,0,96
14,9,20,3,8,9,5,0,0,68
14,9,20,3,8,9,5,19,0,87
14,9,20,5,14,3,25,0,0,90
14,9,20,5,14,20,0,0,0,82
14,9,20,5,14,20,12,25,0,119
14,9,20,5,18,2,21,19,8,116
14,9,20,5,18,5,4,0,0,75
14,9,20,5,18,25,0,0,0,91
14,9,20,5,18,9,5,19,0,99
14,9,20,5,18,9,14,7,0,96
14,9,20,5,18,19,0,0,0,85
14,9,20,8,5,18,0,0,0,74
14,9,20,8,9,14,7,0,0,81
14,9,20,9,4,0,0,0,0,56
14,9,20,9,4,15,21,19,0,111
14,9,20,9,4,21,12,9,4,102
14,9,20,9,14,15,12,0,0,93
14,9,20,9,14,15,12,19,0,112
14,9,20,15,0,0,0,0,0,58
14,9,20,15,14,0,0,0,0,72
14,9,20,15,14,19,0,0,0,91
14,9,20,15,19,0,0,0,0,77
14,9,20,16,9,3,11,0,0,82
14,9,20,16,9,3,11,5,4,91
14,9,20,16,9,3,11,5,18,105
14,9,20,16,9,3,11,19,0,101
14,9,20,18,1,13,9,14,0,98
14,9,20,18,1,13,9,14,5,103
14,9,20,18,1,13,9,14,15,113
14,9,20,18,1,20,5,0,0,87
14,9,20,18,1,20,5,4,0,91
14,9,20,18,1,20,5,19,0,106
14,9,20,18,1,20,9,14,5,110
14,9,20,18,1,20,9,14,7,112
14,9,20,18,1,20,9,15,14,120
14,9,20,18,1,20,15,18,0,115
14,9,20,18,1,20,15,18,19,134
14,9,20,18,5,0,0,0,0,66
14,9,20,18,5,4,0,0,0,70
14,9,20,18,5,19,0,0,0,85
14,9,20,18,9,1,18,25,0,114
14,9,20,18,9,3,0,0,0,73
14,9,20,18,9,4,0,0,0,74
14,9,20,18,9,4,5,0,0,79
14,9,20,18,9,4,5,4,0,83
14,9,20,18,9,4,5,19,0,98
14,9,20,18,9,4,9,14,7,104
14,9,20,18,9,4,9,26,5,114
14,9,20,18,9,4,19,0,0,93
14,9,20,18,9,6,25,0,0,101
14,9,20,18,9,6,9,5,4,94
14,9,20,18,9,6,9,5,18,108
14,9,20,18,9,6,9,5,19,109
14,9,20,18,9,12,0,0,0,82
14,9,20,18,25,12,0,0,0,98
14,25,20,18,9,12,0,0,0,98
14,9,20,18,9,12,5,0,0,87
14,9,20,18,9,12,5,19,0,106
14,9,20,18,9,12,19,0,0,101
14,9,20,18,9,18,25,0,0,113
14,9,20,18,9,20,5,0,0,95
14,9,20,18,9,20,5,19,0,114
14,9,20,18,9,20,15,9,4,118
14,9,20,18,15,6,15,18,13,128
14,9,20,18,15,7,5,14,0,102
14,9,20,18,15,7,5,14,19,121
14,9,20,18,15,12,9,3,0,100
14,9,20,18,15,12,9,13,0,110
14,9,20,18,15,12,9,13,5,115
14,9,20,18,15,19,0,0,0,95
14,9,20,18,15,19,1,20,5,121
14,9,20,18,15,19,9,6,25,135
14,9,20,18,15,19,25,12,0,132
14,9,20,18,15,19,25,12,19,151
14,9,20,18,15,19,9,20,5,129
14,9,20,18,15,19,15,0,0,110
14,9,20,18,15,21,19,0,0,116
14,9,20,18,15,24,25,12,0,137
14,9,20,19,0,0,0,0,0,62
14,9,20,20,1,0,0,0,0,64
14,9,20,20,5,18,0,0,0,86
14,9,20,20,25,0,0,0,0,88
14,9,20,20,9,5,18,0,0,95
14,9,20,20,9,5,19,20,0,116
14,9,20,23,9,20,0,0,0,95
14,9,20,23,9,20,19,0,0,114
14,9,20,23,9,20,20,5,4,124
14,9,22,1,12,0,0,0,0,58
14,9,22,1,20,9,15,14,0,104
14,9,22,5,1,21,0,0,0,72
14,9,22,5,12,12,1,20,5,100
14,9,22,5,14,9,20,5,0,98
14,9,22,5,15,21,19,0,0,105
14,9,22,15,19,9,20,25,0,133
14,9,24,0,0,0,0,0,0,47
14,9,24,5,0,0,0,0,0,52
14,9,24,5,4,0,0,0,0,56
14,9,24,5,18,0,0,0,0,70
14,9,24,5,19,0,0,0,0,71
14,9,24,25,0,0,0,0,0,72
14,9,24,9,5,19,0,0,0,80
14,9,24,9,14,7,0,0,0,77
14,25,24,9,19,0,0,0,0,91
14,9,24,20,1,13,1,12,0,94
14,9,26,1,13,1,20,0,0,84
14,9,26,1,13,1,20,5,0,89
14,9,26,1,13,1,20,5,19,108
14,9,26,1,13,19,0,0,0,82
14,9,26,1,13,21,20,0,0,104
14,9,26,5,25,0,0,0,0,79
14,9,26,25,0,0,0,0,0,74
14,15,2,0,0,0,0,0,0,31
14,15,2,1,20,3,8,0,0,63
14,15,2,2,5,18,0,0,0,56
14,15,2,2,25,0,0,0,0,58
14,15,2,2,9,5,18,0,0,65
14,15,2,2,9,5,19,20,0,86
14,15,2,2,9,12,25,0,0,79
14,15,2,2,12,5,0,0,0,50
14,15,2,2,12,5,4,0,0,54
14,15,2,2,12,5,18,0,0,68
14,15,2,2,12,5,18,19,0,87
14,15,2,2,12,5,19,0,0,69
14,15,2,2,12,9,14,7,0,75
14,15,2,2,21,20,0,0,0,74
14,15,2,5,12,9,19,20,19,115
14,15,2,5,12,9,21,13,0,91
14,15,2,5,12,9,21,13,19,110
14,15,2,9,12,9,1,18,25,105
14,15,2,9,12,9,6,25,0,92
14,15,2,9,12,9,20,25,0,106
14,15,2,9,19,0,0,0,0,59
14,15,2,12,5,4,0,0,0,52
14,15,2,12,5,25,0,0,0,73
14,15,2,12,5,13,1,14,0,76
14,15,2,12,5,13,5,13,0,79
14,15,2,12,5,13,5,14,0,80
14,15,2,12,5,14,5,19,19,105
14,15,2,12,5,18,0,0,0,66
14,15,2,12,5,19,0,0,0,67
14,15,2,12,5,19,19,5,0,91
14,15,2,12,5,19,19,5,19,110
14,15,2,12,5,19,20,0,0,87
14,15,2,12,25,0,0,0,0,68
14,15,2,12,9,6,25,0,0,83
14,15,2,12,9,14,7,0,0,73
14,15,2,15,4,25,0,0,0,75
14,15,2,15,4,25,4,0,0,79
14,15,2,15,4,9,5,19,0,83
14,15,2,19,0,0,0,0,0,50
14,15,2,21,20,0,0,0,0,72
14,15,3,1,11,5,0,0,0,49
14,15,3,5,14,3,5,0,0,59
14,15,3,5,14,20,0,0,0,71
14,15,3,5,18,9,20,5,0,89
14,15,3,8,20,0,0,0,0,60
14,15,3,9,22,5,0,0,0,68
14,15,3,11,0,0,0,0,0,43
14,15,3,11,5,4,0,0,0,52
14,15,3,11,5,18,12,0,0,78
14,15,3,11,5,20,0,0,0,68
14,15,3,11,9,14,7,0,0,73
14,15,3,11,19,0,0,0,0,62
14,15,3,11,20,1,20,0,0,84
14,15,3,15,14,6,9,18,13,107
14,15,3,20,9,4,9,1,12,87
14,15,3,20,9,19,0,0,0,80
14,15,3,20,21,1,0,0,0,74
14,15,3,20,21,9,4,0,0,86
14,15,3,20,21,9,4,19,0,105
14,15,3,20,21,12,5,0,0,90
14,15,3,20,21,12,5,19,0,109
14,15,3,20,21,15,9,4,0,101
14,15,3,20,21,18,9,1,0,101
14,15,3,20,21,18,14,0,0,105
14,15,3,20,21,18,14,1,12,118
14,15,3,20,21,18,14,5,0,110
14,15,3,20,21,18,14,5,19,129
14,15,3,20,21,18,14,19,0,124
14,15,3,21,9,20,25,0,0,107
14,15,3,21,13,5,14,20,0,105
14,15,3,21,15,21,19,0,0,108
14,15,3,21,15,21,19,12,25,145
14,15,4,1,12,0,0,0,0,46
14,15,4,1,12,9,20,25,0,100
14,15,4,1,12,12,25,0,0,83
14,15,4,1,20,5,4,0,0,63
14,15,4,4,5,4,0,0,0,46
14,15,4,4,5,18,0,0,0,60
14,15,4,4,5,18,19,0,0,79
14,15,4,4,9,0,0,0,0,46
14,15,4,4,25,0,0,0,0,62
14,15,4,4,9,5,19,0,0,70
14,15,4,4,9,14,7,0,0,67
14,15,4,4,9,14,7,12,25,104
14,15,4,4,12,5,0,0,0,54
14,15,4,4,12,5,4,0,0,58
14,15,4,4,12,5,19,0,0,73
14,15,4,4,12,9,14,7,0,79
14,15,4,5,0,0,0,0,0,38
14,15,4,5,4,0,0,0,0,42
14,15,4,5,19,0,0,0,0,57
14,15,4,9,0,0,0,0,0,42
14,15,4,9,1,11,0,0,0,54
14,15,4,9,3,1,12,0,0,58
14,15,4,9,3,15,18,14,0,92
14,15,4,9,6,15,18,13,0,94
14,15,4,15,19,1,21,18,0,107
14,15,4,15,19,5,0,0,0,72
14,15,4,15,19,9,20,25,0,121
14,15,4,15,21,19,0,0,0,88
14,15,4,19,0,0,0,0,0,52
14,15,4,21,12,1,18,0,0,85
14,15,4,21,12,1,20,5,0,92
14,15,4,21,12,1,20,5,4,96
14,15,4,21,12,5,0,0,0,71
14,15,4,21,12,5,4,0,0,75
14,15,4,21,12,5,19,0,0,90
14,15,4,21,12,9,0,0,0,75
14,15,4,21,12,9,26,5,0,106
14,15,4,21,12,9,26,5,4,110
14,15,4,21,12,15,19,5,0,105
14,15,4,21,12,15,21,19,0,121
14,15,4,21,12,21,19,0,0,106
14,15,4,21,19,0,0,0,0,73
14,15,5,2,3,4,0,0,0,43
14,15,5,3,8,15,0,0,0,60
14,15,5,12,19,0,0,0,0,65
14,15,5,18,18,15,18,0,0,103
14,15,5,19,0,0,0,0,0,53
14,15,5,19,9,19,0,0,0,81
14,15,5,19,9,19,5,19,0,105
14,15,5,20,9,1,14,0,0,78
14,15,5,20,9,3,19,0,0,85
14,15,5,24,0,0,0,0,0,58
14,15,5,24,5,3,21,20,5,112
14,15,6,9,12,5,0,0,0,61
14,15,7,0,0,0,0,0,0,36
14,15,7,1,4,1,0,0,0,42
14,15,7,1,11,21,0,0,0,69
14,15,7,7,0,0,0,0,0,43
14,15,7,7,5,4,0,0,0,52
14,15,7,7,5,14,0,0,0,62
14,15,7,7,9,14,0,0,0,66
14,15,7,7,9,14,7,0,0,73
14,15,7,7,9,14,7,19,0,92
14,15,7,7,9,14,19,0,0,85
14,15,7,7,19,0,0,0,0,62
14,15,7,8,5,1,4,0,0,54
14,15,7,8,5,1,4,5,4,63
14,15,7,19,0,0,0,0,0,55
14,15,8,5,19,0,0,0,0,61
14,15,8,5,24,0,0,0,0,66
14,15,8,15,23,0,0,0,0,75
14,15,25,0,0,0,0,0,0,54
14,15,25,1,4,5,0,0,0,64
14,15,25,1,4,5,4,0,0,68
14,15,25,1,4,5,19,0,0,83
14,15,25,1,4,9,14,7,0,89
14,15,25,1,14,3,5,0,0,77
14,15,25,1,14,20,0,0,0,89
14,15,25,1,21,0,0,0,0,76
14,15,9,2,23,15,15,4,0,97
14,15,25,6,21,12,0,0,0,93
14,15,9,12,0,0,0,0,0,50
14,15,9,12,1,7,5,0,0,63
14,15,9,12,5,18,0,0,0,73
14,15,9,12,25,0,0,0,0,75
14,15,9,12,19,0,0,0,0,69
14,15,9,14,20,0,0,0,0,72
14,15,9,14,20,13,5,14,20,124
14,15,25,15,21,19,0,0,0,109
14,15,9,18,0,0,0,0,0,56
14,15,9,18,5,0,0,0,0,61
14,15,9,18,5,19,0,0,0,80
14,15,9,19,1,14,3,5,0,80
14,15,9,19,5,0,0,0,0,62
14,15,9,19,5,4,0,0,0,66
14,15,9,19,5,6,21,12,0,101
14,15,9,19,5,12,5,19,19,117
14,15,9,19,5,13,1,11,5,92
14,15,9,19,5,19,0,0,0,81
14,15,9,19,5,20,20,5,0,107
14,15,9,19,25,0,0,0,0,82
14,15,9,19,9,5,18,0,0,89
14,15,9,19,9,5,19,20,0,110
14,15,9,19,9,12,25,0,0,103
14,15,9,19,9,14,5,19,19,123
14,15,9,19,9,14,7,0,0,87
14,15,9,19,15,13,5,0,0,90
14,15,9,19,15,13,5,12,25,127
14,15,9,24,0,0,0,0,0,62
14,15,11,20,1,0,0,0,0,61
14,15,12,0,0,0,0,0,0,41
14,15,12,4,0,0,0,0,0,45
14,15,12,9,20,9,15,14,0,108
14,15,12,12,5,0,0,0,0,58
14,15,12,12,5,9,20,25,0,112
14,15,12,12,5,16,18,15,19,126
14,15,12,15,0,0,0,0,0,56
14,15,12,15,19,0,0,0,0,75
14,15,12,20,0,0,0,0,0,61
14,15,13,0,0,0,0,0,0,42
14,15,13,1,4,0,0,0,0,47
14,15,13,1,4,5,0,0,0,52
14,15,13,1,4,5,19,0,0,71
14,15,13,1,4,9,1,14,0,71
14,15,13,1,4,9,3,0,0,59
14,15,13,1,4,9,3,1,12,72
14,15,13,1,4,9,19,5,0,80
14,15,13,1,4,9,19,13,0,88
14,15,13,1,4,9,19,13,19,107
14,15,13,1,4,9,26,5,0,87
14,15,13,1,4,19,0,0,0,66
14,15,13,1,14,3,25,0,0,85
14,15,13,1,16,0,0,0,0,59
14,15,13,1,18,3,8,0,0,72
14,15,13,1,18,3,8,25,0,97
14,15,13,1,18,3,8,19,0,91
14,15,13,1,19,0,0,0,0,62
14,15,13,2,12,5,19,0,0,80
14,15,13,2,18,9,12,0,0,83
14,15,13,2,18,9,12,19,0,102
14,15,13,5,14,0,0,0,0,61
14,15,13,5,19,0,0,0,0,66
14,15,13,25,0,0,0,0,0,67
14,15,13,9,1,12,0,0,0,64
14,15,13,9,3,0,0,0,0,54
14,15,13,9,14,1,0,0,0,66
14,15,13,9,14,1,2,12,5,85
14,15,13,9,14,1,12,0,0,78
14,15,13,9,14,1,12,12,25,115
14,15,13,9,14,1,12,19,0,97
14,15,13,9,14,1,20,5,0,91
14,15,13,9,14,1,20,5,4,95
14,15,13,9,14,1,20,5,19,110
14,15,13,9,14,1,20,15,18,119
14,15,13,9,14,5,0,0,0,70
14,15,13,9,14,5,5,0,0,75
14,15,13,9,14,5,5,19,0,94
14,15,13,9,14,25,0,0,0,90
14,15,13,9,19,13,0,0,0,83
14,15,13,9,19,13,1,0,0,84
14,15,13,9,19,13,1,20,1,105
14,15,13,9,19,13,19,0,0,102
14,15,13,9,19,20,9,3,0,102
14,15,13,14,5,13,0,0,0,74
14,15,13,15,3,1,14,15,14,104
14,15,13,15,3,18,1,3,25,107
14,15,13,15,7,5,14,25,0,108
14,15,13,15,7,18,1,13,0,96
14,15,13,15,7,18,1,13,19,115
14,15,13,15,7,18,1,16,8,107
14,15,13,15,9,0,0,0,0,66
14,15,13,15,12,15,7,25,0,116
14,15,13,15,19,0,0,0,0,76
14,15,13,15,20,8,5,20,5,115
14,15,13,19,0,0,0,0,0,61
14,15,14,0,0,0,0,0,0,43
14,15,14,1,3,3,5,14,20,89
14,15,14,1,3,3,5,19,19,93
14,15,14,1,3,3,15,18,4,87
14,15,14,1,3,9,4,0,0,60
14,15,14,1,3,9,4,9,3,72
14,15,14,1,3,9,4,19,0,79
14,15,14,1,3,20,0,0,0,67
14,15,14,1,3,20,9,15,14,105
14,15,14,1,3,20,9,22,5,103
14,15,14,1,3,20,15,18,0,100
14,15,14,1,3,20,21,1,12,101
14,15,14,1,3,21,9,20,25,122
14,15,14,1,3,21,20,5,0,93
14,15,14,1,4,4,9,3,20,84
14,15,14,1,4,5,16,20,0,89
14,15,14,1,4,21,12,20,0,101
14,15,14,1,4,21,12,20,19,120
14,15,14,1,7,5,0,0,0,56
14,15,14,1,7,5,14,3,25,98
14,15,14,1,7,5,14,20,0,90
14,15,14,1,7,5,19,0,0,75
14,15,14,1,7,15,14,0,0,80
14,15,14,1,7,15,14,19,0,99
14,15,14,1,9,4,0,0,0,57
14,15,14,1,9,18,0,0,0,71
14,15,14,1,12,9,5,14,0,84
14,15,14,1,12,9,14,5,4,88
14,15,14,1,13,9,14,15,0,95
14,15,14,1,14,5,0,0,0,63
14,15,14,1,14,5,13,9,3,88
14,15,14,1,14,9,13,1,12,93
14,15,14,1,14,15,9,3,0,85
14,15,14,1,14,19,23,5,18,123
14,15,14,1,16,16,12,25,0,113
14,15,14,1,18,3,9,14,7,95
14,15,14,1,18,25,0,0,0,87
14,15,14,1,18,9,5,19,0,95
14,15,14,1,18,20,0,0,0,82
14,15,14,1,18,20,19,0,0,101
14,15,14,1,19,0,0,0,0,63
14,15,14,1,19,19,5,14,20,121
14,15,14,1,19,20,18,1,12,114
14,15,14,1,20,15,13,9,3,104
14,15,14,2,1,14,11,0,0,71
14,15,14,2,1,19,5,0,0,70
14,15,14,2,1,19,9,3,0,77
14,15,14,2,1,19,9,14,7,95
14,15,14,2,5,1,21,20,25,117
14,15,14,2,5,9,14,7,0,80
14,15,14,2,5,9,14,7,19,99
14,15,14,2,5,12,9,5,6,82
14,15,14,2,9,1,19,5,4,83
14,15,14,2,9,20,9,14,7,104
14,15,14,2,9,20,20,5,18,117
14,15,14,2,12,1,3,11,0,72
14,15,14,2,12,1,14,11,0,83
14,15,14,2,12,5,1,3,8,74
14,15,14,2,15,4,25,0,0,89
14,15,14,2,15,4,9,12,25,110
14,15,14,2,15,4,9,14,7,94
14,15,14,2,15,15,11,0,0,86
14,15,14,2,15,15,11,19,0,105
14,15,14,2,18,1,14,4,0,82
14,15,14,2,18,5,1,3,8,80
14,15,14,2,18,15,15,4,25,122
14,15,14,2,18,21,20,1,12,117
14,15,14,2,21,25,9,14,7,121
14,15,14,2,21,12,2,1,18,99
14,15,14,2,21,19,25,0,0,110
14,15,14,2,21,19,9,12,25,131
14,15,14,3,1,4,5,14,20,90
14,15,14,3,1,11,9,14,7,88
14,15,14,3,1,18,2,15,14,96
14,15,14,3,1,18,5,5,18,93
14,15,14,3,1,19,8,0,0,74
14,15,14,3,1,19,20,5,0,91
14,15,14,3,1,19,21,1,12,100
14,15,14,3,1,21,19,1,12,100
14,15,14,3,5,0,0,0,0,51
14,15,14,3,5,14,19,21,19,124
14,15,14,3,5,18,5,1,12,87
14,15,14,3,5,19,0,0,0,70
14,15,14,3,8,1,12,11,25,103
14,15,14,3,8,21,18,3,8,104
14,15,14,3,25,3,12,9,3,98
14,15,14,3,12,1,9,13,0,81
14,15,14,3,12,1,19,19,0,97
14,15,14,3,12,9,14,7,0,88
14,15,14,3,12,15,19,5,0,97
14,15,14,3,15,3,11,0,0,75
14,15,14,3,15,7,5,14,20,107
14,15,14,3,15,11,9,14,7,102
14,15,14,3,15,12,15,18,0,106
14,15,14,3,15,13,0,0,0,74
14,15,14,3,15,13,2,1,20,97
14,15,14,3,15,13,5,0,0,79
14,15,14,3,15,13,9,3,0,86
14,15,14,3,15,13,9,14,7,104
14,15,14,3,15,13,16,15,19,124
14,15,14,3,15,13,19,0,0,93
14,15,14,3,15,14,0,0,0,75
14,15,14,3,15,14,3,21,18,117
14,15,14,3,15,18,9,14,7,109
14,15,14,3,15,19,13,9,3,105
14,15,14,3,15,21,14,20,25,141
14,15,14,3,18,5,4,9,20,102
14,15,14,3,18,9,13,5,0,91
14,15,14,4,1,0,0,0,0,48
14,15,14,4,1,9,18,25,0,100
14,15,14,4,1,14,3,5,0,70
14,15,14,4,1,14,3,5,18,88
14,15,14,4,1,18,11,0,0,77
14,15,14,4,5,1,4,12,25,94
14,15,14,4,5,1,6,0,0,59
14,15,14,4,5,1,6,12,25,96
14,15,14,4,5,1,12,5,18,88
14,15,14,4,5,2,20,15,18,107
14,15,14,4,5,3,1,14,5,75
14,15,14,4,5,3,5,9,20,89
14,15,14,4,5,5,16,0,0,73
14,15,14,4,5,6,5,1,20,84
14,15,14,4,5,9,19,20,0,100
14,15,14,4,5,13,1,14,4,84
14,15,14,4,5,13,9,19,5,98
14,15,14,4,5,14,9,1,12,88
14,15,14,4,5,14,19,5,0,90
14,15,14,4,5,19,9,18,5,103
14,15,14,4,5,20,5,19,20,116
14,15,14,4,5,22,15,21,20,130
14,15,14,4,15,0,0,0,0,62
14,15,14,4,15,9,14,7,0,92
14,15,14,4,18,25,9,14,7,120
14,15,14,4,18,9,22,5,18,119
14,15,14,4,18,21,7,0,0,93
14,15,14,5,0,0,0,0,0,48
14,15,14,5,1,7,5,18,0,79
14,15,14,5,3,8,15,9,3,86
14,15,14,5,4,9,2,12,5,80
14,15,14,5,4,9,20,15,18,114
14,15,14,5,6,6,5,20,5,90
14,15,14,5,7,15,0,0,0,70
14,15,14,5,7,15,19,0,0,89
14,15,14,5,12,5,3,20,0,88
14,15,14,5,12,9,20,5,0,94
14,15,14,5,13,16,20,25,0,122
14,15,14,5,14,5,0,0,0,67
14,15,14,5,14,5,13,25,0,105
14,15,14,5,14,20,0,0,0,82
14,15,14,5,14,20,9,20,25,136
14,15,14,5,14,20,18,5,19,124
14,15,14,5,14,20,18,25,0,125
14,15,14,5,16,9,3,0,0,76
14,15,14,5,16,9,3,1,12,89
14,15,14,5,17,21,1,12,0,99
14,15,14,5,17,21,1,12,19,118
14,15,14,5,18,15,4,5,4,94
14,15,14,5,18,15,20,9,3,113
14,15,14,5,18,18,1,14,20,119
14,15,14,5,19,0,0,0,0,67
14,15,14,5,19,3,1,16,5,92
14,15,14,5,19,21,3,8,0,99
14,15,14,5,20,0,0,0,0,68
14,15,14,5,20,8,9,3,0,88
14,15,14,5,20,8,25,12,0,113
14,15,14,5,20,8,14,9,3,102
14,15,14,5,20,19,0,0,0,87
14,15,14,5,20,20,15,0,0,103
14,15,14,5,22,5,14,20,0,109
14,15,14,5,22,5,14,20,19,128
14,15,14,5,22,9,12,0,0,91
14,15,14,5,22,9,12,12,25,128
14,15,14,5,24,5,13,16,20,126
14,15,14,5,24,15,20,9,3,119
14,15,14,5,24,16,5,18,20,131
14,15,14,5,24,16,9,18,25,140
14,15,14,5,24,20,1,14,20,127
14,15,14,6,1,3,9,1,12,75
14,15,14,6,1,3,9,14,7,83
14,15,14,6,1,3,20,0,0,73
14,15,14,6,1,3,20,19,0,92
14,15,14,6,1,4,9,14,7,84
14,15,14,6,1,12,19,5,0,86
14,15,14,6,1,13,9,12,25,109
14,15,14,6,1,13,15,21,19,118
14,15,14,6,1,14,0,0,0,64
14,15,14,6,1,14,19,0,0,83
14,15,14,6,1,18,13,0,0,81
14,15,14,6,1,20,0,0,0,70
14,15,14,6,1,20,1,12,0,83
14,15,14,6,1,20,20,25,0,115
14,15,14,6,1,21,12,20,25,128
14,15,14,6,5,1,12,20,25,112
14,15,14,6,5,1,19,15,18,107
14,15,14,6,5,3,21,14,4,96
14,15,14,6,5,5,2,12,5,78
14,15,14,6,5,5,2,12,25,98
14,15,14,6,5,12,15,14,25,120
14,15,14,6,5,18,22,9,4,107
14,15,14,6,5,21,4,1,12,92
14,15,14,6,9,12,9,1,12,92
14,15,14,6,9,12,20,5,18,113
14,15,14,6,9,14,1,12,0,85
14,15,14,6,9,14,9,20,5,106
14,15,14,6,9,19,3,1,12,93
14,15,14,6,12,1,11,25,0,98
14,15,14,6,12,1,23,5,4,94
14,15,14,6,12,25,9,14,7,116
14,15,14,6,12,21,5,14,20,121
14,15,14,6,12,21,9,4,0,95
14,15,14,6,12,21,9,4,19,114
14,15,14,6,12,21,24,0,0,106
14,15,14,6,15,3,1,12,0,80
14,15,14,6,15,15,4,0,0,83
14,15,14,6,15,18,5,19,20,126
14,15,14,6,15,18,13,0,0,95
14,15,14,6,15,18,13,1,12,108
14,15,14,6,18,1,20,0,0,88
14,15,14,6,18,5,5,26,5,108
14,15,14,6,18,9,7,9,4,96
14,15,14,6,18,21,7,1,12,108
14,15,14,6,21,5,12,0,0,87
14,15,14,6,21,14,4,5,4,97
14,15,14,6,21,18,15,9,4,116
14,15,14,6,21,19,5,4,0,98
14,15,14,6,21,19,9,15,14,127
14,15,14,6,21,20,9,12,5,116
14,15,14,7,0,0,0,0,0,50
14,15,14,7,1,25,0,0,0,76
14,15,14,7,1,25,19,0,0,95
14,15,14,7,1,13,5,0,0,69
14,15,14,7,1,19,0,0,0,70
14,15,14,7,1,19,5,19,0,94
14,15,14,7,1,19,19,25,0,114
14,15,14,7,5,19,20,9,3,106
14,15,14,7,9,12,4,5,4,84
14,15,14,7,9,12,12,5,4,92
14,15,14,7,9,16,19,25,0,119
14,15,14,7,25,16,19,25,0,135
14,15,14,7,12,1,18,5,0,86
14,15,14,7,12,1,26,5,4,98
14,15,14,7,15,4,0,0,0,69
14,15,14,7,15,12,4,0,0,81
14,15,14,7,15,12,6,5,18,106
14,15,14,7,15,19,16,5,12,117
14,15,14,7,18,1,4,5,4,82
14,15,14,7,18,1,25,0,0,94
14,15,14,7,18,1,9,14,0,92
14,15,14,7,18,1,19,19,0,107
14,15,14,7,18,1,22,5,14,110
14,15,14,7,18,5,1,19,25,118
14,15,14,7,18,5,5,14,0,92
14,15,14,7,18,5,25,0,0,98
14,15,14,7,21,1,18,4,0,94
14,15,14,7,21,9,12,20,0,112
14,15,14,7,21,9,12,20,19,131
14,15,14,8,1,18,4,25,0,99
14,15,14,8,5,1,18,5,18,98
14,15,14,8,5,3,20,9,3,91
14,15,14,8,5,13,5,0,0,74
14,15,14,8,5,18,15,0,0,89
14,15,14,8,5,18,15,5,19,113
14,15,14,8,5,18,15,9,3,101
14,15,14,8,15,13,5,0,0,84
14,15,14,8,21,13,1,14,0,100
14,15,14,8,21,13,21,19,0,125
14,15,14,25,1,0,0,0,0,69
14,15,14,9,3,0,0,0,0,55
14,15,14,9,4,5,1,12,0,74
14,15,14,25,12,0,0,0,0,80
14,15,14,25,12,5,14,5,0,104
14,15,14,25,12,5,14,9,3,111
14,15,14,25,12,9,3,0,0,92
14,15,14,9,12,12,9,15,14,114
14,15,14,25,12,19,0,0,0,99
14,15,14,9,13,1,7,5,0,78
14,15,14,9,13,13,21,14,5,118
14,15,14,9,13,16,1,3,20,105
14,15,14,9,14,5,18,20,0,109
14,15,14,9,14,10,21,18,25,140
14,15,14,9,14,19,5,3,20,113
14,15,14,9,14,20,5,14,20,125
14,15,14,9,15,14,0,0,0,81
14,15,14,9,15,14,9,3,0,93
14,15,14,9,18,1,20,5,0,96
14,15,14,9,18,5,14,9,3,101
14,15,14,9,18,15,14,0,0,99
14,15,14,9,18,15,14,9,3,111
14,15,14,9,19,19,21,5,0,116
14,15,14,10,21,18,1,14,20,127
14,15,14,10,21,18,5,19,19,135
14,15,14,10,21,18,25,0,0,117
14,15,14,10,21,18,9,5,19,125
14,15,14,10,21,18,9,14,7,122
14,15,14,10,21,18,9,19,20,140
14,15,14,10,21,18,15,18,19,144
14,15,14,11,15,19,8,5,18,119
14,15,14,12,1,3,20,9,3,91
14,15,14,12,1,25,9,14,7,111
14,15,14,12,1,23,25,5,18,127
14,15,14,12,5,1,4,5,4,74
14,15,14,12,5,1,6,25,0,92
14,15,14,12,5,7,1,12,0,80
14,15,14,12,5,7,1,20,15,103
14,15,14,12,5,7,21,13,5,106
14,15,14,12,5,20,8,1,12,101
14,15,14,12,5,22,5,12,0,99
14,15,14,12,25,0,0,0,0,80
14,15,14,12,9,1,2,12,5,84
14,15,14,12,9,3,5,20,0,92
14,15,14,12,9,3,9,20,0,96
14,15,14,12,9,6,5,0,0,75
14,15,14,12,9,14,5,1,12,96
14,15,14,12,9,14,5,1,18,102
14,15,14,12,9,17,21,9,4,115
14,15,14,12,25,18,9,3,0,110
14,15,14,12,9,19,20,5,18,126
14,15,14,12,9,22,5,0,0,91
14,15,14,12,9,22,5,19,0,110
14,15,14,12,9,22,9,14,7,116
14,15,14,12,15,3,1,12,0,86
14,15,14,12,15,3,1,12,19,105
14,15,14,12,15,7,9,3,0,89
14,15,14,12,15,25,1,12,0,108
14,15,14,12,15,19,5,18,0,112
14,15,14,12,15,22,5,18,0,115
14,15,14,12,15,22,9,14,7,122
14,15,14,12,21,3,9,4,0,92
14,15,14,12,21,19,20,5,18,138
14,15,14,13,1,10,15,18,0,100
14,15,14,13,1,11,5,21,16,110
14,15,14,13,1,14,0,0,0,71
14,15,14,13,1,14,9,12,1,93
14,15,14,13,1,14,21,1,12,105
14,15,14,13,1,18,9,14,5,103
14,15,14,13,1,18,11,5,20,111
14,15,14,13,1,19,15,14,0,105
14,15,14,13,1,20,20,5,18,120
14,15,14,13,1,20,21,18,5,121
14,15,14,13,5,1,20,0,0,82
14,15,14,13,5,13,2,5,18,99
14,15,14,13,5,14,0,0,0,75
14,15,14,13,5,14,9,1,12,97
14,15,14,13,5,14,20,1,12,108
14,15,14,13,5,20,1,12,0,94
14,15,14,13,5,20,1,12,19,113
14,15,14,13,5,20,18,9,3,111
14,15,14,13,25,15,16,9,3,124
14,15,14,13,25,19,20,9,3,132
14,15,14,13,15,2,9,12,5,99
14,15,14,13,15,4,1,12,0,88
14,15,14,13,15,4,5,18,14,112
14,15,14,13,15,12,1,18,0,102
14,15,14,13,15,14,5,25,0,115
14,15,14,13,15,14,9,19,20,133
14,15,14,13,15,18,1,12,0,102
14,15,14,13,15,18,20,1,12,122
14,15,14,13,15,20,9,12,5,117
14,15,14,13,15,20,9,15,14,129
14,15,14,13,21,3,15,21,19,135
14,15,14,13,21,19,9,3,0,108
14,15,14,13,21,20,21,1,12,131
14,15,14,14,1,14,20,0,0,92
14,15,14,14,1,19,1,12,0,90
14,15,14,14,1,20,0,0,0,78
14,15,14,14,1,20,9,22,5,114
14,15,14,14,1,20,20,25,0,123
14,15,14,14,1,22,1,12,0,93
14,15,14,14,5,21,18,1,12,114
14,15,14,14,5,23,19,0,0,104
14,15,14,14,25,0,0,0,0,82
14,15,14,14,9,20,18,9,3,116
14,15,14,14,15,2,12,5,0,91
14,15,14,14,15,13,1,4,0,90
14,15,14,14,15,18,13,1,12,116
14,15,14,14,15,22,5,12,0,111
14,15,14,15,2,5,19,5,0,89
14,15,14,15,3,3,21,12,20,117
14,15,14,15,8,13,9,3,0,91
14,15,14,15,9,3,0,0,0,70
14,15,14,15,9,12,25,0,0,104
14,15,14,15,13,1,4,0,0,76
14,15,14,15,16,1,17,21,5,118
14,15,14,15,16,20,9,3,0,106
14,15,14,15,18,1,12,0,0,89
14,15,14,15,18,1,12,12,25,126
14,15,14,15,19,3,9,14,5,108
14,15,14,15,23,14,5,18,0,118
14,15,14,15,23,14,5,18,19,137
14,15,14,15,23,14,9,14,7,125
14,15,14,16,1,7,1,14,0,82
14,15,14,16,1,7,1,14,19,101
14,15,14,16,1,9,4,0,0,73
14,15,14,16,1,25,5,18,0,108
14,15,14,16,1,25,9,14,7,115
14,15,14,16,1,16,1,12,0,89
14,15,14,16,1,16,9,19,20,124
14,15,14,16,1,18,0,0,0,78
14,15,14,16,1,18,5,9,12,104
14,15,14,16,1,18,5,14,20,117
14,15,14,16,1,18,9,20,25,132
14,15,14,16,1,18,12,15,18,123
14,15,14,16,1,18,15,21,19,133
14,15,14,16,1,18,20,25,0,123
14,15,14,16,1,19,20,0,0,99
14,15,14,16,1,19,20,19,0,118
14,15,14,16,1,21,19,5,0,105
14,15,14,16,5,1,11,0,0,76
14,15,14,16,5,1,11,5,4,85
14,15,14,16,5,14,1,12,0,91
14,15,14,16,5,18,19,15,14,130
14,15,14,16,8,15,2,9,3,96
14,15,14,16,12,1,3,5,20,100
14,15,14,16,12,1,25,0,0,97
14,15,14,16,12,1,25,19,0,116
14,15,14,16,12,1,14,1,18,105
14,15,14,16,12,1,14,5,0,91
14,15,14,16,12,1,20,5,0,97
14,15,14,16,12,1,20,5,4,101
14,15,14,16,12,9,1,14,20,115
14,15,14,16,12,21,19,0,0,111
14,15,14,16,12,21,19,5,4,120
14,15,14,16,12,21,19,5,19,135
14,15,14,16,15,5,20,0,0,99
14,15,14,16,15,5,20,9,3,111
14,15,14,16,15,12,1,18,0,105
14,15,14,16,15,15,18,0,0,107
14,15,14,16,15,16,5,18,25,138
14,15,14,16,15,18,15,21,19,147
14,15,14,16,15,18,20,0,0,112
14,15,14,16,15,23,5,18,0,120
14,15,14,16,18,5,19,19,0,120
14,15,14,16,18,9,14,20,0,120
14,15,14,16,18,15,6,9,20,127
14,15,14,16,18,15,12,9,24,137
14,15,14,16,18,15,19,0,0,111
14,15,14,16,18,15,22,5,14,133
14,15,14,16,21,2,12,9,3,106
14,15,14,16,21,5,2,12,15,114
14,15,14,17,21,15,20,1,0,117
14,15,14,18,1,3,9,1,12,87
14,15,14,18,1,25,5,4,0,96
14,15,14,18,1,9,19,5,4,99
14,15,14,18,1,14,4,15,13,108
14,15,14,18,1,20,5,4,0,91
14,15,14,18,5,1,4,5,18,94
14,15,14,18,5,2,5,12,0,85
14,15,14,18,5,3,5,14,20,108
14,15,14,18,5,3,5,19,19,112
14,15,14,18,5,3,15,9,12,105
14,15,14,18,5,7,5,14,20,112
14,15,14,18,5,13,5,4,25,113
14,15,14,18,5,16,1,9,18,110
14,15,14,18,5,16,5,1,20,108
14,15,14,18,5,19,3,21,5,114
14,15,14,18,5,20,1,9,12,108
14,15,14,18,5,20,21,18,14,139
14,15,14,18,8,25,13,5,0,112
14,15,14,18,8,25,13,5,4,116
14,15,14,18,8,25,20,8,13,135
14,15,14,18,9,4,9,14,7,104
14,15,14,18,9,7,9,4,0,90
14,15,14,18,9,15,20,5,18,128
14,15,14,18,9,22,1,12,0,105
14,15,14,18,9,22,1,12,19,124
14,15,14,18,15,25,1,12,0,114
14,15,14,18,15,21,14,4,0,115
14,15,14,18,21,2,2,5,18,109
14,15,14,18,21,12,9,14,7,124
14,15,14,18,21,14,0,0,0,96
14,15,14,18,21,18,1,12,0,113
14,15,14,18,21,19,20,9,3,133
14,15,14,19,1,3,18,5,4,93
14,15,14,19,1,9,12,15,18,117
14,15,14,19,1,12,5,0,0,80
14,15,14,19,1,12,9,14,5,103
14,15,14,19,1,14,5,0,0,82
14,15,14,19,1,14,5,12,25,119
14,15,14,19,1,14,9,20,25,131
14,15,14,19,1,20,9,18,5,115
14,15,14,19,1,22,9,14,7,115
14,15,14,19,1,23,9,14,7,116
14,15,14,19,5,3,18,5,20,113
14,15,14,19,5,12,6,0,0,85
14,15,14,19,5,14,19,5,0,105
14,15,14,19,5,14,19,5,19,124
14,15,14,19,5,14,19,9,3,112
14,15,14,19,5,16,20,9,3,115
14,15,14,19,5,18,9,1,12,107
14,15,14,19,5,18,9,6,0,100
14,15,14,19,5,18,15,21,19,140
14,15,14,19,5,20,20,5,18,130
14,15,14,19,5,24,9,19,20,139
14,15,14,19,5,24,21,1,12,125
14,15,14,19,8,1,6,20,0,97
14,15,14,19,9,12,22,5,18,128
14,15,14,19,25,14,3,0,0,104
14,15,14,19,9,14,5,0,0,90
14,15,14,19,9,14,7,12,5,109
14,15,14,19,25,19,20,5,13,144
14,15,14,19,9,19,20,5,18,133
14,15,14,19,9,20,20,5,18,134
14,15,14,19,11,5,4,0,0,82
14,15,14,19,11,5,4,19,0,101
14,15,14,19,11,9,4,0,0,86
14,15,14,19,11,9,5,18,0,105
14,15,14,19,11,9,5,18,19,124
14,15,14,19,12,9,16,0,0,99
14,15,14,19,13,15,11,5,18,124
14,15,14,19,15,2,5,18,0,102
14,15,14,19,15,3,9,1,12,102
14,15,14,19,15,12,1,18,0,108
14,15,14,19,15,12,9,4,0,102
14,15,14,19,15,12,9,4,19,121
14,15,14,19,15,14,1,14,20,126
14,15,14,19,16,5,3,9,5,100
14,15,14,19,16,9,12,12,0,111
14,15,14,19,16,9,14,1,12,114
14,15,14,19,16,9,14,25,0,126
14,15,14,19,16,9,18,1,12,118
14,15,14,19,16,9,18,9,20,134
14,15,14,19,16,15,18,5,4,120
14,15,14,19,20,1,2,12,5,102
14,15,14,19,20,1,2,12,25,122
14,15,14,19,20,1,16,12,5,116
14,15,14,19,20,1,18,3,8,112
14,15,14,19,20,1,20,9,3,115
14,15,14,19,20,9,3,11,0,105
14,15,14,19,20,9,3,11,25,130
14,15,14,19,20,15,3,11,0,111
14,15,14,19,20,15,16,0,0,113
14,15,14,19,20,15,18,25,0,140
14,15,14,19,20,15,23,5,4,129
14,15,14,19,20,18,5,19,19,143
14,15,14,19,20,21,4,25,0,132
14,15,14,19,21,2,20,12,5,122
14,15,14,19,21,2,20,12,25,142
14,15,14,19,21,3,3,15,18,122
14,15,14,19,21,3,8,0,0,94
14,15,14,19,21,3,8,5,19,118
14,15,14,19,21,7,1,18,0,109
14,15,14,19,21,7,1,18,19,128
14,15,14,19,21,9,20,0,0,112
14,15,14,19,21,9,20,5,4,121
14,15,14,19,21,9,20,19,0,131
14,15,14,20,1,3,20,9,3,99
14,15,14,20,1,14,0,0,0,78
14,15,14,20,1,14,14,9,3,104
14,15,14,20,1,14,14,9,14,115
14,15,14,20,1,18,7,5,20,114
14,15,14,20,1,18,9,6,6,103
14,15,14,20,1,18,18,5,4,109
14,15,14,20,1,24,0,0,0,88
14,15,14,20,1,24,5,18,0,111
14,15,14,20,1,24,5,19,0,112
14,15,14,20,5,12,9,3,0,92
14,15,14,20,5,14,1,14,20,117
14,15,14,20,5,14,21,18,5,126
14,15,14,20,5,18,13,0,0,99
14,15,14,20,9,4,1,12,0,89
14,15,14,20,9,14,20,5,4,115
14,15,14,20,9,20,12,5,0,109
14,15,14,20,9,20,12,5,4,113
14,15,14,20,15,14,1,12,0,105
14,15,14,20,15,14,5,4,0,101
14,15,14,20,15,14,9,3,0,104
14,15,14,20,15,24,9,3,0,114
14,15,14,20,18,1,4,5,0,91
14,15,14,20,18,1,4,5,18,109
14,15,14,20,18,1,7,9,3,101
14,15,14,20,18,5,1,20,25,132
14,15,14,20,18,9,1,12,0,103
14,15,14,20,18,9,2,1,12,105
14,15,14,20,18,9,5,18,0,113
14,15,14,20,18,15,16,9,3,124
14,15,14,20,18,21,1,14,20,137
14,15,14,20,18,21,13,16,0,131
14,15,14,20,18,21,19,20,0,141
14,15,14,20,18,21,20,8,0,130
14,15,14,20,18,21,20,8,19,149
14,15,14,20,21,14,5,4,0,107
14,15,14,21,14,3,9,1,12,103
14,15,14,21,14,9,15,14,0,116
14,15,14,21,14,9,15,14,19,135
14,15,14,21,14,9,17,21,5,130
14,15,14,21,14,9,19,15,14,135
14,15,14,21,14,9,20,5,4,116
14,15,14,21,14,9,20,25,0,132
14,15,14,21,16,12,5,0,0,97
14,15,14,21,16,12,5,19,0,116
14,15,14,21,16,12,5,20,0,117
14,15,14,21,18,2,1,14,0,99
14,15,14,21,18,7,5,14,20,128
14,15,14,21,19,1,2,12,5,103
14,15,14,21,19,1,7,5,0,96
14,15,14,21,19,5,0,0,0,88
14,15,14,21,19,5,18,0,0,106
14,15,14,21,19,5,18,19,0,125
14,15,14,21,19,5,19,0,0,107
14,15,14,21,19,9,14,7,0,113
14,15,14,21,20,9,12,5,0,110
14,15,14,22,1,3,1,14,20,104
14,15,14,22,1,3,21,1,0,91
14,15,14,22,1,3,21,21,13,124
14,15,14,22,1,12,5,14,20,117
14,15,14,22,1,12,9,4,0,91
14,15,14,22,1,12,21,5,0,104
14,15,14,22,1,12,21,5,4,108
14,15,14,22,1,12,22,5,0,105
14,15,14,22,1,18,9,5,4,102
14,15,14,22,1,19,19,1,12,117
14,15,14,22,5,3,20,15,18,126
14,15,14,22,5,14,1,12,0,97
14,15,14,22,5,14,15,21,19,139
14,15,14,22,5,18,2,1,12,103
14,15,14,22,9,1,2,12,5,94
14,15,14,22,9,14,15,21,19,143
14,15,14,22,9,18,1,12,0,105
14,15,14,22,9,18,9,12,5,118
14,15,14,22,9,18,20,21,5,138
14,15,14,22,9,19,1,5,4,103
14,15,14,22,9,19,3,9,4,109
14,15,14,22,9,19,21,1,12,127
14,15,14,22,9,20,1,12,0,107
14,15,14,22,15,3,1,12,0,96
14,15,14,22,15,9,3,5,0,97
14,15,14,22,15,9,4,0,0,93
14,15,14,22,15,12,1,14,20,127
14,15,14,22,15,20,5,18,0,123
14,15,14,22,15,20,5,18,19,142
14,15,14,22,15,20,9,14,7,130
14,15,14,22,21,12,22,1,12,133
14,15,14,22,21,12,22,1,18,139
14,15,14,22,22,1,3,21,1,113
14,15,14,23,1,9,22,5,18,121
14,15,14,23,1,18,0,0,0,85
14,15,14,23,1,24,9,14,7,121
14,15,14,23,5,20,20,5,4,120
14,15,14,23,8,9,20,5,0,108
14,15,14,23,8,9,20,5,19,127
14,15,14,23,9,14,7,5,4,105
14,15,14,23,15,14,4,5,18,122
14,15,14,23,15,15,4,25,0,125
14,15,14,23,15,18,4,0,0,103
14,15,14,23,15,18,4,19,0,122
14,15,14,23,15,18,11,5,18,133
14,15,14,23,15,22,5,14,0,122
14,15,14,23,18,9,20,5,0,118
14,15,14,26,5,2,18,1,0,95
14,15,14,26,5,18,15,0,0,107
14,15,14,26,15,14,1,12,0,111
14,15,14,26,15,14,1,20,5,124
14,15,15,0,0,0,0,0,0,44
14,15,15,4,7,5,0,0,0,60
14,15,15,4,7,5,4,0,0,64
14,15,15,4,7,5,19,0,0,79
14,15,15,4,7,9,14,7,0,85
14,15,15,4,12,5,0,0,0,65
14,15,15,4,12,5,4,0,0,69
14,15,15,4,12,5,4,15,13,97
14,15,15,4,12,5,9,19,13,106
14,15,15,4,12,5,19,0,0,84
14,15,15,4,12,9,14,7,0,90
14,15,15,11,0,0,0,0,0,55
14,15,15,11,5,4,0,0,0,64
14,15,15,11,5,18,25,0,0,103
14,15,15,11,5,18,9,5,19,111
14,15,15,11,25,0,0,0,0,80
14,15,15,11,9,5,0,0,0,69
14,15,15,11,9,5,18,0,0,87
14,15,15,11,9,5,19,0,0,88
14,15,15,11,9,5,19,20,0,108
14,15,15,11,9,14,7,0,0,85
14,15,15,11,12,5,20,0,0,92
14,15,15,11,12,9,11,5,0,92
14,15,15,11,19,0,0,0,0,74
14,15,15,12,15,7,25,0,0,103
14,15,15,12,15,7,9,19,20,126
14,15,15,13,5,20,18,25,0,125
14,15,15,14,0,0,0,0,0,58
14,15,15,14,4,1,25,0,0,88
14,15,15,14,4,1,25,19,0,107
14,15,15,14,5,4,0,0,0,67
14,15,15,14,9,14,7,0,0,88
14,15,15,14,9,14,7,19,0,107
14,15,15,14,9,19,8,0,0,94
14,15,15,14,12,9,7,8,20,114
14,15,15,14,12,9,20,0,0,99
14,15,15,14,13,5,1,20,0,97
14,15,15,14,19,0,0,0,0,77
14,15,15,14,19,20,5,1,4,107
14,15,15,14,20,9,4,5,0,96
14,15,15,14,20,9,4,5,19,115
14,15,15,14,20,9,13,5,0,105
14,15,15,14,20,9,13,5,19,124
14,15,15,14,23,1,18,4,19,123
14,15,15,16,0,0,0,0,0,60
14,15,15,19,3,15,16,9,3,109
14,15,15,19,5,0,0,0,0,68
14,15,15,19,5,4,0,0,0,72
14,15,15,19,5,18,0,0,0,86
14,15,15,19,5,18,19,0,0,105
14,15,15,19,5,19,0,0,0,87
14,15,15,19,9,14,7,0,0,93
14,15,15,19,16,8,5,18,5,115
14,15,16,1,12,0,0,0,0,58
14,15,16,1,12,18,25,0,0,101
14,15,16,1,12,19,0,0,0,77
14,15,16,5,0,0,0,0,0,50
14,15,16,9,14,5,14,5,0,92
14,15,18,1,18,4,0,0,0,70
14,15,18,1,20,5,0,0,0,73
14,15,18,1,20,9,15,14,0,106
14,15,18,4,3,1,16,5,18,94
14,15,18,5,1,19,20,0,0,92
14,15,18,5,1,19,20,5,18,115
14,15,18,5,12,9,14,0,0,87
14,15,18,7,9,14,5,0,0,82
14,15,18,9,0,0,0,0,0,56
14,15,18,9,1,0,0,0,0,57
14,15,18,9,1,19,0,0,0,76
14,15,18,9,3,5,0,0,0,64
14,15,18,9,5,0,0,0,0,61
14,15,18,9,13,15,14,0,0,98
14,15,18,9,20,0,0,0,0,76
14,15,18,9,20,5,0,0,0,81
14,15,18,9,20,5,19,0,0,100
14,15,18,9,20,9,3,0,0,88
14,15,18,9,20,15,0,0,0,91
14,15,18,11,25,14,0,0,0,97
14,15,18,12,1,14,4,0,0,78
14,15,18,12,1,14,4,5,18,101
14,15,18,12,1,14,4,19,0,97
14,15,18,13,1,12,0,0,0,73
14,15,18,13,1,12,1,3,25,102
14,15,18,13,1,12,3,25,0,101
14,15,18,13,1,12,9,19,5,106
14,15,18,13,1,12,9,19,13,114
14,15,18,13,1,12,9,19,20,121
14,15,18,13,1,12,9,20,25,127
14,15,18,13,1,12,9,26,5,113
14,15,18,13,1,12,12,25,0,110
14,15,18,13,1,12,19,0,0,92
14,15,18,13,1,14,19,0,0,94
14,15,18,13,1,20,5,4,0,90
14,15,18,13,1,20,9,22,5,117
14,15,18,13,5,4,0,0,0,69
14,15,18,13,12,5,19,19,0,115
14,15,18,13,15,3,25,20,5,128
14,15,18,13,19,0,0,0,0,79
14,15,18,16,9,14,9,3,0,98
14,15,18,19,5,12,0,0,0,83
14,15,18,19,5,12,5,4,0,92
14,15,18,19,5,12,5,18,0,106
14,15,18,19,5,12,9,14,7,113
14,15,18,19,5,12,12,5,4,104
14,15,18,19,5,13,5,14,0,103
14,15,18,20,5,12,18,25,0,127
14,15,18,20,8,5,14,0,0,94
14,15,18,20,8,5,18,0,0,98
14,15,18,20,8,5,18,5,4,107
14,15,18,20,8,5,18,12,25,135
14,15,18,20,8,5,18,14,19,131
14,15,18,20,8,5,18,19,0,117
14,15,18,20,8,5,19,20,0,119
14,15,18,20,8,9,14,7,0,105
14,15,18,20,8,9,14,7,19,124
14,15,18,20,8,13,15,19,20,142
14,15,18,20,8,14,5,19,19,132
14,15,18,20,8,19,0,0,0,94
14,15,18,20,8,23,1,18,4,121
14,15,18,23,1,18,4,19,0,112
14,15,18,23,5,25,1,14,0,115
14,15,18,23,5,19,20,0,0,114
14,15,18,23,5,19,20,5,18,137
14,15,19,1,18,9,1,14,0,91
14,15,19,5,0,0,0,0,0,53
14,15,19,5,1,14,0,0,0,68
14,15,19,5,1,14,9,20,5,102
14,15,19,5,2,1,7,0,0,63
14,15,19,5,2,1,7,19,0,82
14,15,19,5,2,1,14,4,0,74
14,15,19,5,2,1,14,4,19,93
14,15,19,5,2,12,5,5,4,81
14,15,19,5,2,15,14,5,0,89
14,15,19,5,2,21,18,14,0,108
14,15,19,5,4,0,0,0,0,57
14,15,19,5,4,9,22,5,0,93
14,15,19,5,7,1,25,0,0,86
14,15,19,5,7,1,25,19,0,105
14,15,19,5,8,5,18,2,0,86
14,15,19,5,8,15,12,5,0,93
14,15,19,5,25,0,0,0,0,78
14,15,19,5,12,5,19,19,0,108
14,15,19,5,12,9,11,5,0,90
14,15,19,5,12,9,20,5,0,99
14,15,19,5,15,22,5,18,0,113
14,15,19,5,16,9,5,3,5,91
14,15,19,5,16,9,14,3,8,103
14,15,19,5,18,0,0,0,0,71
14,15,19,5,19,0,0,0,0,72
14,15,19,5,19,13,1,18,20,124
14,15,19,5,20,8,9,18,12,120
14,15,19,5,23,1,18,4,19,118
14,15,19,5,23,8,5,5,12,106
14,15,19,5,23,9,14,7,0,106
14,15,19,5,23,9,19,5,0,109
14,15,19,5,23,15,18,20,0,129
14,15,19,8,0,0,0,0,0,56
14,15,19,8,5,4,0,0,0,65
14,15,19,8,5,18,0,0,0,79
14,15,19,8,5,18,19,0,0,98
14,15,19,8,5,19,0,0,0,80
14,15,19,8,9,14,7,0,0,86
14,15,19,25,0,0,0,0,0,73
14,15,19,9,5,18,0,0,0,80
14,15,19,9,5,19,20,0,0,101
14,15,19,9,7,0,0,0,0,64
14,15,19,9,12,25,0,0,0,94
14,15,19,9,14,5,0,0,0,76
14,15,19,9,14,5,19,19,0,114
14,15,19,9,14,7,0,0,0,78
14,15,19,9,14,7,19,0,0,97
14,15,19,9,19,13,0,0,0,89
14,15,19,9,20,5,0,0,0,82
14,15,19,15,7,5,14,25,0,114
14,15,19,15,7,5,14,9,3,101
14,15,19,15,8,5,13,9,1,99
14,15,19,15,12,15,7,25,0,122
14,15,19,15,12,15,7,9,3,109
14,15,19,15,13,1,14,9,1,101
14,15,19,15,14,15,13,25,0,130
14,15,19,15,16,8,25,20,5,137
14,15,19,15,20,1,24,25,0,133
14,15,19,19,5,12,0,0,0,84
14,15,19,20,1,12,7,25,0,113
14,15,19,20,1,12,7,9,1,98
14,15,19,20,1,12,7,9,3,100
14,15,19,20,5,18,0,0,0,91
14,15,19,20,9,3,0,0,0,80
14,15,19,20,15,3,19,0,0,105
14,15,19,20,15,12,15,7,25,142
14,15,19,20,18,9,12,0,0,107
14,15,19,20,18,9,12,5,4,116
14,15,19,20,18,9,12,19,0,126
14,15,19,20,18,21,13,0,0,120
14,15,19,20,18,21,13,19,0,139
14,15,20,0,0,0,0,0,0,49
14,15,20,1,0,0,0,0,0,50
14,15,20,1,2,5,14,5,0,76
14,15,20,1,2,9,12,9,1,83
14,15,20,1,2,12,5,0,0,69
14,15,20,1,2,12,5,19,0,88
14,15,20,1,2,12,25,0,0,89
14,15,20,1,5,1,12,0,0,68
14,15,20,1,5,21,13,0,0,89
14,15,20,1,12,0,0,0,0,62
14,15,20,1,12,7,9,1,0,79
14,15,20,1,12,7,9,3,0,81
14,15,20,1,14,0,0,0,0,64
14,15,20,1,14,4,21,4,1,94
14,15,20,1,14,4,21,13,0,102
14,15,20,1,14,4,21,13,19,121
14,15,20,1,18,25,0,0,0,93
14,15,20,1,18,9,1,12,0,90
14,15,20,1,18,9,1,20,5,103
14,15,20,1,18,9,5,19,0,101
14,15,20,1,18,9,11,15,14,117
14,15,20,1,18,9,26,5,0,108
14,15,20,1,18,9,26,5,4,112
14,15,20,1,18,9,26,5,19,127
14,15,20,1,20,5,0,0,0,75
14,15,20,1,20,5,4,0,0,79
14,15,20,1,20,5,19,0,0,94
14,15,20,1,20,9,14,7,0,100
14,15,20,1,20,9,15,14,0,108
14,15,20,1,20,9,15,14,19,127
14,15,20,1,20,9,22,5,0,106
14,15,20,1,20,15,18,0,0,103
14,15,20,1,21,12,9,24,0,116
14,15,20,3,8,0,0,0,0,60
14,15,20,3,8,2,1,3,11,77
14,15,20,3,8,5,4,0,0,69
14,15,20,3,8,5,12,0,0,77
14,15,20,3,8,5,18,0,0,83
14,15,20,3,8,5,18,19,0,102
14,15,20,3,8,5,19,0,0,84
14,15,20,3,8,6,21,12,0,99
14,15,20,3,8,25,0,0,0,85
14,15,20,3,8,9,14,7,0,90
14,15,20,3,8,23,5,5,4,97
14,15,20,3,8,23,9,14,7,113
14,15,20,3,8,23,15,18,20,136
14,15,20,5,0,0,0,0,0,54
14,15,20,5,2,15,15,11,0,97
14,15,20,5,2,15,15,11,19,116
14,15,20,5,3,1,19,5,0,82
14,15,20,5,3,1,19,5,19,101
14,15,20,5,4,0,0,0,0,58
14,15,20,5,4,12,25,0,0,95
14,15,20,5,4,14,5,19,19,115
14,15,20,5,8,5,1,4,0,72
14,15,20,5,11,9,14,0,0,88
14,15,20,5,12,5,19,19,0,109
14,15,20,5,12,5,20,0,0,91
14,15,20,5,13,1,14,0,0,82
14,15,20,5,13,9,7,7,5,95
14,15,20,5,13,21,7,7,5,107
14,15,20,5,16,1,4,0,0,75
14,15,20,5,16,1,4,19,0,94
14,15,20,5,16,1,16,5,18,110
14,15,20,5,18,0,0,0,0,72
14,15,20,5,18,19,0,0,0,91
14,15,20,5,18,19,5,0,0,96
14,15,20,5,19,0,0,0,0,73
14,15,20,5,23,9,19,5,0,110
14,15,20,8,1,12,0,0,0,70
14,15,20,8,5,18,0,0,0,80
14,15,20,8,9,14,7,0,0,87
14,15,20,8,9,14,7,12,25,124
14,15,20,8,9,14,7,19,0,106
14,15,20,8,15,19,1,21,18,131
14,15,20,8,15,21,19,0,0,112
14,15,20,8,21,19,0,0,0,97
14,15,20,9,3,1,2,12,5,81
14,15,20,9,3,5,0,0,0,66
14,15,20,9,3,5,4,0,0,70
14,15,20,9,3,5,18,0,0,84
14,15,20,9,3,5,19,0,0,85
14,15,20,9,3,9,14,7,0,91
14,15,20,9,4,1,14,9,4,90
14,15,20,9,6,25,0,0,0,89
14,15,20,9,6,9,5,4,0,82
14,15,20,9,6,25,5,5,0,99
14,15,20,9,6,9,5,18,0,96
14,15,20,9,6,9,5,18,19,115
14,15,20,9,6,9,5,19,0,97
14,15,20,9,6,25,9,14,7,119
14,15,20,9,14,7,0,0,0,79
14,15,20,9,15,14,0,0,0,87
14,15,20,9,15,14,1,12,0,100
14,15,20,9,15,14,1,18,25,131
14,15,20,9,15,14,1,20,5,113
14,15,20,9,15,14,5,4,0,96
14,15,20,9,15,14,9,19,20,135
14,15,20,9,15,14,19,0,0,106
14,15,20,9,19,20,0,0,0,97
14,15,20,9,20,9,1,0,0,88
14,15,20,9,20,9,15,14,0,116
14,15,20,15,3,8,15,18,4,112
14,15,20,15,3,15,18,4,0,104
14,15,20,15,9,18,5,0,0,96
14,15,20,15,18,9,5,20,25,141
14,15,20,15,18,9,15,21,19,146
14,15,20,15,20,8,5,18,5,120
14,15,20,15,20,18,9,2,5,118
14,15,20,15,21,18,0,0,0,103
14,15,20,15,21,18,12,25,0,140
14,15,20,19,0,0,0,0,0,68
14,15,20,19,5,12,6,0,0,91
14,15,20,20,21,18,14,9,0,131
14,15,20,20,21,18,14,15,0,137
14,15,20,21,13,0,0,0,0,83
14,15,21,0,0,0,0,0,0,50
14,15,21,3,8,5,0,0,0,66
14,15,21,7,1,20,0,0,0,78
14,15,21,7,1,20,9,14,5,106
14,15,21,7,1,20,19,0,0,97
14,15,21,7,8,20,0,0,0,85
14,15,21,7,8,20,25,0,0,110
14,15,21,7,8,20,9,12,25,131
14,15,21,7,8,20,12,25,0,122
14,15,21,7,8,20,19,0,0,104
14,15,21,9,12,12,5,0,0,88
14,15,21,9,12,12,5,19,0,107
14,15,21,12,4,0,0,0,0,66
14,15,21,13,5,1,9,20,5,103
14,15,21,13,5,9,20,5,0,102
14,15,21,13,5,14,1,0,0,83
14,15,21,13,5,14,1,12,0,95
14,15,21,13,5,14,9,19,13,123
14,15,21,13,5,14,15,14,0,111
14,15,21,13,5,14,15,14,1,112
14,15,21,13,13,15,19,0,0,110
14,15,21,14,0,0,0,0,0,64
14,15,21,14,1,12,0,0,0,77
14,15,21,14,1,12,12,25,0,114
14,15,21,14,9,26,5,0,0,104
14,15,21,14,12,5,19,19,0,119
14,15,21,14,19,0,0,0,0,83
14,15,21,16,0,0,0,0,0,66
14,15,21,18,9,3,5,0,0,85
14,15,21,18,9,19,8,0,0,104
14,15,21,18,9,19,8,5,4,113
14,15,21,18,9,19,8,5,18,127
14,15,21,18,9,19,8,5,19,128
14,15,21,18,9,20,21,18,5,141
14,15,21,19,0,0,0,0,0,69
14,15,21,19,5,12,0,0,0,86
14,15,21,19,5,19,0,0,0,93
14,15,21,20,8,5,18,0,0,101
14,15,21,22,5,1,21,0,0,99
14,15,21,22,5,1,21,20,5,124
14,15,21,22,5,1,21,24,0,123
14,15,21,22,5,12,12,5,0,106
14,15,21,22,5,12,12,5,19,125
14,15,22,1,5,0,0,0,0,57
14,15,22,1,12,5,0,0,0,69
14,15,22,1,12,9,1,0,0,74
14,15,22,1,12,9,11,5,0,89
14,15,22,1,19,0,0,0,0,71
14,15,22,1,20,5,0,0,0,77
14,15,22,1,20,9,15,14,0,110
14,15,22,1,20,9,15,14,19,129
14,15,22,1,20,9,22,5,0,108
14,15,22,1,20,15,18,0,0,105
14,15,22,1,20,15,18,25,0,130
14,15,22,1,20,18,9,24,0,123
14,15,22,3,9,3,0,0,0,66
14,15,22,5,12,0,0,0,0,68
14,15,22,5,12,1,0,0,0,69
14,15,22,5,12,1,14,20,0,103
14,15,22,5,12,4,15,13,0,100
14,15,22,5,12,5,19,5,0,97
14,15,22,5,12,5,20,0,0,93
14,15,22,5,12,5,20,20,5,118
14,15,22,5,12,5,20,20,25,138
14,15,22,5,12,9,19,5,0,101
14,15,22,5,12,9,19,5,4,105
14,15,22,5,12,9,19,5,19,120
14,15,22,5,12,9,19,8,0,104
14,15,22,5,12,9,19,13,0,109
14,15,22,5,12,9,19,20,0,116
14,15,22,5,12,9,19,20,19,135
14,15,22,5,12,9,26,5,0,108
14,15,22,5,12,9,26,5,4,112
14,15,22,5,12,9,26,5,19,127
14,15,22,5,12,12,1,0,0,81
14,15,22,5,12,12,1,5,0,86
14,15,22,5,12,12,1,19,0,100
14,15,22,5,12,12,5,0,0,85
14,15,22,5,12,12,5,19,19,123
14,15,22,5,12,12,25,0,0,105
14,15,22,5,12,12,9,11,5,105
14,15,22,5,12,14,5,19,19,125
14,15,22,5,12,18,25,0,0,111
14,15,22,5,12,20,25,0,0,113
14,15,22,5,12,20,9,5,19,121
14,15,22,5,13,0,0,0,0,69
14,15,22,5,13,2,5,18,19,113
14,15,22,5,13,6,9,4,0,88
14,15,22,5,14,1,0,0,0,71
14,15,22,5,14,1,5,0,0,76
14,15,22,5,14,1,18,25,0,114
14,15,22,5,14,1,19,0,0,90
14,15,22,5,14,4,9,1,12,96
14,15,22,5,14,5,0,0,0,75
14,15,22,5,14,14,9,1,12,106
14,15,22,5,18,3,1,12,0,90
14,15,22,5,18,9,6,25,0,114
14,15,22,5,18,9,14,20,0,117
14,15,22,9,3,5,0,0,0,68
14,15,22,9,3,5,18,25,0,111
14,15,22,9,3,5,19,0,0,87
14,15,22,9,3,9,1,20,5,98
14,15,22,9,12,12,1,4,1,90
14,15,22,9,12,12,5,18,15,122
14,15,22,9,12,12,15,0,0,99
14,15,22,9,12,21,14,1,18,126
14,15,22,9,20,25,0,0,0,105
14,15,22,9,20,9,1,12,0,102
14,15,22,9,20,9,1,20,5,115
14,15,22,9,20,9,15,21,19,144
14,15,22,15,0,0,0,0,0,66
14,15,22,15,4,1,13,21,19,124
14,15,22,21,19,0,0,0,0,91
14,15,23,0,0,0,0,0,0,52
14,15,23,1,4,1,25,0,0,83
14,15,23,1,4,1,25,19,0,102
14,15,23,1,25,0,0,0,0,78
14,15,23,1,25,19,0,0,0,97
14,15,23,3,8,0,0,0,0,63
14,15,23,4,5,18,0,0,0,79
14,15,23,5,4,0,0,0,0,61
14,15,23,8,1,20,0,0,0,81
14,15,23,8,5,14,0,0,0,79
14,15,23,8,5,14,3,5,0,87
14,15,23,8,5,18,5,0,0,88
14,15,23,8,5,18,5,19,0,107
14,15,23,8,9,20,0,0,0,89
14,15,23,8,9,20,8,5,18,120
14,15,23,25,0,0,0,0,0,77
14,15,23,9,19,5,0,0,0,85
14,15,23,14,5,19,19,0,0,109
14,15,23,19,0,0,0,0,0,71
14,15,23,20,0,0,0,0,0,72
14,15,23,20,8,5,0,0,0,85
14,15,23,20,8,5,18,0,0,103
14,15,23,20,8,5,18,4,0,107
14,15,23,20,19,0,0,0,0,91
14,15,24,1,0,0,0,0,0,54
14,15,24,1,12,0,0,0,0,66
14,15,24,1,12,12,25,0,0,103
14,15,24,9,1,12,0,0,0,75
14,15,24,9,15,21,19,0,0,117
14,15,24,9,15,21,19,12,25,154
14,15,26,26,12,5,0,0,0,98
14,15,26,26,12,5,18,0,0,116
14,15,26,26,12,5,19,0,0,117
14,16,5,5,12,0,0,0,0,52
14,16,6,24,0,0,0,0,0,60
14,18,9,20,20,1,0,0,0,82
14,21,2,0,0,0,0,0,0,37
14,21,2,2,25,0,0,0,0,64
14,21,2,2,9,5,18,0,0,71
14,21,2,2,9,5,19,20,0,92
14,21,2,2,9,14,0,0,0,62
14,21,2,2,9,14,5,19,19,105
14,21,2,2,9,14,19,0,0,81
14,21,2,2,12,5,0,0,0,56
14,21,2,2,12,5,4,0,0,60
14,21,2,2,12,5,19,0,0,75
14,21,2,2,12,25,0,0,0,76
14,21,2,2,12,9,5,18,0,83
14,21,2,2,12,9,5,19,20,104
14,21,2,2,12,9,14,7,0,81
14,21,2,5,3,21,12,1,0,79
14,21,2,5,3,21,12,1,5,84
14,21,2,9,1,19,0,0,0,66
14,21,2,9,6,15,18,13,0,98
14,21,2,9,12,1,20,5,0,84
14,21,2,9,12,5,0,0,0,63
14,21,2,9,12,9,20,25,0,112
14,21,2,9,12,15,19,5,0,97
14,21,2,9,12,15,21,19,0,113
14,21,2,19,0,0,0,0,0,56
14,21,3,1,12,0,0,0,0,51
14,21,3,1,13,5,14,20,0,91
14,21,3,5,12,12,1,18,0,86
14,21,3,5,12,12,9,0,0,76
14,21,3,5,12,12,21,19,0,107
14,21,3,8,1,0,0,0,0,47
14,21,3,8,1,5,0,0,0,52
14,21,3,8,1,12,0,0,0,59
14,21,3,8,1,12,5,0,0,64
14,21,3,8,1,12,7,9,1,76
14,21,3,8,1,12,19,0,0,78
14,21,3,9,6,15,18,13,0,99
14,21,3,9,14,0,0,0,0,61
14,21,3,12,5,1,12,0,0,68
14,21,3,12,5,1,14,20,0,90
14,21,3,12,5,1,18,0,0,74
14,21,3,12,5,1,18,25,0,99
14,21,3,12,5,1,19,5,0,80
14,21,3,12,5,1,19,5,19,99
14,21,3,12,5,1,20,5,0,81
14,21,3,12,5,1,20,5,4,85
14,21,3,12,5,1,20,5,19,100
14,21,3,12,5,1,20,15,18,109
14,21,3,12,5,3,12,5,9,84
14,21,3,12,5,9,0,0,0,64
14,21,3,12,5,9,3,0,0,67
14,21,3,12,5,9,14,0,0,78
14,21,3,12,5,9,14,19,0,97
14,21,3,12,5,9,26,5,0,95
14,21,3,12,5,12,9,0,0,76
14,21,3,12,5,15,9,4,0,83
14,21,3,12,5,15,12,1,18,101
14,21,3,12,5,15,12,5,0,87
14,21,3,12,5,15,12,5,19,106
14,21,3,12,5,15,12,9,0,91
14,21,3,12,5,15,12,21,19,122
14,21,3,12,5,15,14,0,0,84
14,21,3,12,5,15,14,5,0,89
14,21,3,12,5,15,14,9,3,96
14,21,3,12,5,15,14,19,0,103
14,21,3,12,5,15,19,9,4,102
14,21,3,12,5,21,19,0,0,95
14,21,3,12,5,21,19,5,19,119
14,21,3,12,9,4,5,0,0,68
14,21,3,12,9,4,5,19,0,87
14,21,3,12,9,4,9,3,0,75
14,21,3,21,12,1,14,5,0,91
14,21,3,21,12,1,14,9,1,96
14,21,3,21,12,5,0,0,0,76
14,21,3,21,12,9,4,0,0,84
14,21,3,21,12,15,9,4,0,99
14,21,4,1,20,5,0,0,0,65
14,21,4,1,20,9,15,14,0,98
14,21,4,4,25,0,0,0,0,68
14,21,4,4,12,5,0,0,0,60
14,21,4,5,0,0,0,0,0,44
14,21,4,5,12,25,0,0,0,81
14,21,4,5,14,5,19,19,0,101
14,21,4,5,18,0,0,0,0,62
14,21,4,5,19,0,0,0,0,63
14,21,4,5,19,20,0,0,0,83
14,21,4,7,5,0,0,0,0,51
14,21,4,7,5,4,0,0,0,55
14,21,4,7,5,18,0,0,0,69
14,21,4,7,5,18,19,0,0,88
14,21,4,7,5,19,0,0,0,70
14,21,4,7,9,14,7,0,0,76
14,21,4,9,3,1,21,12,0,85
14,21,4,9,5,0,0,0,0,53
14,21,4,9,5,19,0,0,0,72
14,21,4,9,6,9,5,18,0,86
14,21,4,9,16,5,4,0,0,73
14,21,4,9,19,8,0,0,0,75
14,21,4,9,19,13,0,0,0,80
14,21,4,9,19,13,19,0,0,99
14,21,4,9,19,20,0,0,0,87
14,21,4,9,19,20,19,0,0,106
14,21,4,9,20,25,0,0,0,93
14,21,4,9,20,9,5,19,0,101
14,21,4,14,9,3,11,0,0,76
14,21,4,14,9,3,11,19,0,95
14,21,4,14,9,11,0,0,0,73
14,21,4,14,9,11,19,0,0,92
14,21,4,21,13,0,0,0,0,73
14,21,4,26,8,0,0,0,0,73
14,21,4,26,8,5,4,0,0,82
14,21,4,26,8,5,19,0,0,97
14,21,4,26,8,9,14,7,0,103
14,21,7,1,3,9,15,21,19,110
14,21,7,1,3,9,20,25,0,100
14,21,7,1,5,0,0,0,0,48
14,21,7,1,13,5,14,20,0,95
14,21,7,1,20,15,18,0,0,96
14,21,7,1,20,15,18,25,0,121
14,21,7,7,1,18,0,0,0,68
14,21,7,7,5,20,0,0,0,74
14,21,7,7,5,20,25,0,0,99
14,21,7,7,5,20,19,0,0,93
14,21,7,9,6,25,0,0,0,82
14,21,7,9,12,15,7,21,5,111
14,21,9,19,1,14,3,5,0,86
14,21,9,19,1,14,3,5,18,104
14,21,9,19,1,14,3,5,19,105
14,21,9,19,15,13,5,0,0,96
14,21,11,5,0,0,0,0,0,51
14,21,11,5,4,0,0,0,0,55
14,21,11,5,19,0,0,0,0,70
14,21,11,9,14,7,0,0,0,76
14,21,12,12,0,0,0,0,0,59
14,21,12,12,1,2,12,5,0,79
14,21,12,12,1,8,0,0,0,68
14,21,12,12,1,8,19,0,0,87
14,21,12,12,1,18,25,0,0,103
14,21,12,12,2,9,5,20,25,120
14,21,12,12,5,4,0,0,0,68
14,21,12,12,9,2,9,19,20,118
14,21,12,12,9,6,25,0,0,99
14,21,12,12,9,6,9,5,4,92
14,21,12,12,9,6,9,5,18,106
14,21,12,12,9,6,9,5,19,107
14,21,12,12,9,14,7,0,0,89
14,21,12,12,9,16,1,18,1,104
14,21,12,12,9,16,12,5,24,125
14,21,12,12,9,16,15,18,5,122
14,21,12,12,9,19,13,0,0,100
14,21,12,12,9,19,15,13,5,120
14,21,12,12,9,20,25,0,0,113
14,21,12,12,9,20,9,5,19,121
14,21,12,12,15,0,0,0,0,74
14,21,12,12,15,19,0,0,0,93
14,21,12,12,19,0,0,0,0,78
14,21,12,12,21,13,0,0,0,93
14,21,12,12,21,19,0,0,0,99
14,21,13,1,3,0,0,0,0,52
14,21,13,2,0,0,0,0,0,50
14,21,13,2,1,20,0,0,0,71
14,21,13,2,1,20,19,0,0,90
14,21,13,2,5,4,0,0,0,59
14,21,13,2,5,18,0,0,0,73
14,21,13,2,5,18,5,4,0,82
14,21,13,2,5,18,5,18,0,96
14,21,13,2,5,18,5,18,19,115
14,21,13,2,5,18,6,21,12,112
14,21,13,2,5,18,9,14,7,103
14,21,13,2,5,18,15,21,19,128
14,21,13,2,5,19,20,0,0,94
14,21,13,2,6,9,19,8,0,92
14,21,13,2,9,14,7,0,0,80
14,21,13,2,9,14,7,12,25,117
14,21,13,2,12,5,0,0,0,67
14,21,13,2,12,5,19,0,0,86
14,21,13,2,12,25,0,0,0,87
14,21,13,2,14,5,19,19,0,107
14,21,13,2,19,0,0,0,0,69
14,21,13,2,19,11,21,12,12,125
14,21,13,4,1,0,0,0,0,53
14,21,13,4,1,8,0,0,0,61
14,21,13,5,14,0,0,0,0,67
14,21,13,5,18,1,2,12,5,91
14,21,13,5,18,1,2,12,25,111
14,21,13,5,18,1,3,25,0,100
14,21,13,5,18,1,12,0,0,84
14,21,13,5,18,1,12,12,25,121
14,21,13,5,18,1,12,19,0,103
14,21,13,5,18,1,14,20,0,106
14,21,13,5,18,1,18,25,0,115
14,21,13,5,18,1,20,5,0,97
14,21,13,5,18,1,20,5,4,101
14,21,13,5,18,1,20,5,19,116
14,21,13,5,18,1,20,15,18,125
14,21,13,5,18,9,3,0,0,83
14,21,13,5,18,9,3,1,12,96
14,21,13,5,18,9,3,19,0,102
14,21,13,5,18,9,19,20,0,119
14,21,13,5,18,15,0,0,0,86
14,21,13,5,18,15,19,0,0,105
14,21,13,5,18,15,19,5,0,110
14,21,13,5,18,15,21,19,0,126
14,21,13,9,14,1,0,0,0,72
14,21,13,9,14,9,19,13,0,112
14,21,13,9,14,15,21,19,0,126
14,21,13,9,19,0,0,0,0,76
14,21,13,13,1,18,25,0,0,105
14,21,13,13,9,0,0,0,0,70
14,21,13,13,9,6,15,18,13,122
14,21,13,13,21,12,1,18,0,113
14,21,13,13,21,12,1,18,25,138
14,21,13,13,21,12,9,14,5,122
14,21,13,13,21,12,9,20,5,128
14,21,13,13,21,19,0,0,0,101
14,21,13,14,1,8,0,0,0,71
14,21,13,16,0,0,0,0,0,64
14,21,13,16,19,0,0,0,0,83
14,21,13,19,11,21,12,12,0,123
14,21,13,19,11,21,12,12,19,142
14,21,13,21,4,0,0,0,0,73
14,21,14,1,20,1,11,0,0,82
14,21,14,1,20,1,11,19,0,101
14,21,14,1,20,9,15,14,0,108
14,21,14,2,9,18,4,0,0,82
14,21,14,3,0,0,0,0,0,52
14,21,14,3,5,0,0,0,0,57
14,21,14,3,8,0,0,0,0,60
14,21,14,3,8,1,11,21,0,93
14,21,14,3,8,5,15,14,0,94
14,21,14,3,8,9,15,14,0,98
14,21,14,3,9,1,20,5,0,87
14,21,14,3,9,15,0,0,0,76
14,21,14,3,9,15,19,0,0,95
14,21,14,3,9,21,19,0,0,101
14,21,14,3,12,5,0,0,0,69
14,21,14,3,12,5,19,0,0,88
14,21,14,3,21,16,1,20,5,115
14,21,14,4,9,14,1,12,0,89
14,21,14,4,9,14,5,0,0,81
14,21,14,8,15,15,4,0,0,91
14,21,14,11,25,0,0,0,0,85
14,21,14,11,19,0,0,0,0,79
14,21,14,12,5,20,0,0,0,86
14,21,14,12,9,11,5,0,0,86
14,21,14,14,1,18,9,0,0,91
14,21,14,14,1,20,5,4,0,93
14,21,14,14,1,20,9,15,14,122
14,21,14,14,5,4,0,0,0,72
14,21,14,14,5,18,9,5,19,119
14,21,14,14,9,0,0,0,0,72
14,21,14,14,9,6,25,0,0,103
14,21,14,14,9,14,7,0,0,93
14,21,14,14,9,19,8,0,0,99
14,21,14,17,21,1,13,0,0,101
14,21,14,18,25,0,0,0,0,92
14,21,14,19,0,0,0,0,0,68
14,21,14,19,8,9,16,0,0,101
14,21,14,20,9,14,7,0,0,99
14,21,14,20,9,21,19,0,0,118
14,21,16,19,15,14,0,0,0,99
14,21,16,20,9,1,12,0,0,93
14,21,16,20,9,1,12,12,25,130
14,21,16,20,9,1,12,19,0,112
14,21,17,21,5,0,0,0,0,78
14,21,18,1,7,8,0,0,0,69
14,21,18,1,7,8,5,0,0,74
14,21,18,1,7,8,5,19,0,93
14,21,18,1,7,8,9,0,0,78
14,21,18,4,0,0,0,0,0,57
14,21,18,4,19,0,0,0,0,76
14,21,18,8,1,7,0,0,0,69
14,21,18,12,0,0,0,0,0,65
14,21,18,12,5,4,0,0,0,74
14,21,18,12,25,0,0,0,0,90
14,21,18,12,9,14,7,0,0,95
14,21,18,12,19,0,0,0,0,84
14,21,18,18,25,0,0,0,0,96
14,21,18,19,1,2,12,5,0,92
14,21,18,19,5,4,0,0,0,81
14,21,18,19,5,4,15,13,0,109
14,21,18,19,5,7,9,18,12,123
14,21,18,19,5,11,9,14,0,111
14,21,18,19,5,12,5,20,0,114
14,21,18,19,5,12,9,11,5,114
14,21,18,19,5,12,9,14,7,119
14,21,18,19,5,13,1,9,4,104
14,21,18,19,5,18,0,0,0,95
14,21,18,19,5,18,25,0,0,120
14,21,18,19,5,18,9,5,19,128
14,21,18,19,5,18,19,0,0,114
14,21,18,19,5,19,0,0,0,96
14,21,18,19,25,0,0,0,0,97
14,21,18,19,9,14,7,0,0,102
14,21,18,19,9,14,7,12,25,139
14,21,18,19,9,14,7,19,0,121
14,21,18,19,12,5,0,0,0,89
14,21,18,19,12,9,14,7,0,114
14,21,18,19,12,9,14,7,19,133
14,21,18,20,21,18,1,12,0,125
14,21,18,20,21,18,1,14,20,147
14,21,18,20,21,18,5,0,0,117
14,21,18,20,21,18,5,4,0,121
14,21,18,20,21,18,5,18,0,135
14,21,18,20,21,18,5,18,19,154
14,21,18,20,21,18,5,19,0,136
14,21,18,20,21,18,9,14,7,142
14,21,19,6,9,1,8,0,0,78
14,21,20,1,14,20,0,0,0,90
14,21,20,1,18,9,1,14,0,98
14,21,20,1,20,5,0,0,0,81
14,21,20,1,20,5,4,0,0,85
14,21,20,1,20,5,19,0,0,100
14,21,20,1,20,9,14,7,0,106
14,21,20,1,20,9,15,14,0,114
14,21,20,1,20,9,15,14,19,133
14,21,20,2,18,15,23,14,0,127
14,21,20,3,1,11,5,0,0,75
14,21,20,3,1,19,5,0,0,83
14,21,20,3,18,1,3,11,0,91
14,21,20,7,1,12,12,0,0,87
14,21,20,7,1,12,12,19,0,106
14,21,20,7,18,1,19,19,0,119
14,21,20,8,1,20,3,8,0,95
14,21,20,8,15,15,11,0,0,104
14,21,20,8,15,21,19,5,0,123
14,21,20,8,15,21,19,5,19,142
14,21,20,10,15,2,2,5,18,107
14,21,20,12,5,20,0,0,0,92
14,21,20,12,5,20,19,0,0,111
14,21,20,12,9,11,5,0,0,92
14,21,20,13,5,1,20,0,0,94
14,21,20,13,5,1,20,19,0,113
14,21,20,13,5,7,0,0,0,80
14,21,20,13,5,7,7,5,4,96
14,21,20,13,5,7,7,25,0,112
14,21,20,13,5,7,19,0,0,99
14,21,20,16,5,3,11,5,18,113
14,21,20,16,9,3,11,0,0,94
14,21,20,16,9,3,11,19,0,113
14,21,20,18,1,13,9,14,0,110
14,21,20,18,9,1,0,0,0,83
14,21,20,18,9,1,19,0,0,102
14,21,20,18,9,3,5,0,0,90
14,21,20,18,9,3,9,1,12,107
14,21,20,18,9,3,9,19,13,126
14,21,20,18,9,5,14,20,0,121
14,21,20,18,9,5,14,20,19,140
14,21,20,18,9,6,25,0,0,113
14,21,20,18,9,12,9,20,5,128
14,21,20,18,9,13,5,14,20,134
14,21,20,18,9,20,9,1,12,124
14,21,20,18,9,20,9,15,14,140
14,21,20,18,9,20,9,22,5,138
14,21,20,18,9,20,15,18,25,160
14,21,20,18,9,20,21,18,5,146
14,21,20,19,0,0,0,0,0,74
14,21,20,19,5,4,7,5,0,95
14,21,20,19,5,4,7,5,19,114
14,21,20,19,5,5,4,0,0,88
14,21,20,19,8,5,12,12,0,111
14,21,20,19,8,5,12,12,19,130
14,21,20,19,25,0,0,0,0,99
14,21,20,19,9,5,18,0,0,106
14,21,20,19,9,5,19,20,0,127
14,21,20,20,5,4,0,0,0,84
14,21,20,20,5,18,25,0,0,123
14,21,20,20,5,18,19,0,0,117
14,21,20,20,25,0,0,0,0,100
14,21,20,20,9,5,18,0,0,107
14,21,20,20,9,5,19,20,0,128
14,21,20,20,9,12,25,0,0,121
14,21,20,20,9,14,5,19,19,141
14,21,20,20,9,14,7,19,0,124
14,21,20,20,9,19,8,0,0,111
14,21,20,23,15,15,4,0,0,112
14,21,20,23,15,15,4,19,0,131
14,21,26,26,5,18,0,0,0,110
14,21,26,26,5,18,1,14,1,126
14,21,26,26,12,5,0,0,0,104
14,21,26,26,12,5,4,0,0,108
14,21,26,26,12,5,18,0,0,122
14,21,26,26,12,5,18,19,0,141
14,21,26,26,12,5,19,0,0,123
14,21,26,26,12,9,14,7,0,129
15,2,2,0,0,0,0,0,0,19
15,2,2,12,9,7,1,20,9,77
15,2,2,12,9,7,1,20,15,83
15,2,3,12,1,22,1,20,5,81
15,2,3,12,21,4,5,0,0,62
15,2,3,15,14,9,3,0,0,61
15,2,3,15,14,9,3,1,12,74
15,2,3,15,18,4,1,20,5,83
15,2,3,21,14,5,1,20,5,86
15,2,4,5,12,20,15,9,4,86
15,2,4,20,0,0,0,0,0,41
15,2,4,21,3,5,0,0,0,50
15,2,4,21,3,20,9,15,14,103
15,2,4,21,18,1,3,25,0,89
15,2,4,21,18,1,20,5,0,86
15,2,4,21,18,1,20,5,4,90
15,2,4,21,18,5,0,0,0,65
15,2,5,1,8,0,0,0,0,31
15,2,5,1,8,9,19,13,0,72
15,2,5,1,8,9,19,13,19,91
15,2,5,1,8,19,0,0,0,50
15,2,5,3,8,5,0,0,0,38
15,2,5,4,9,5,14,3,5,62
15,2,5,4,9,5,14,3,25,82
15,2,5,4,9,5,14,20,0,74
15,2,5,25,0,0,0,0,0,47
15,2,5,25,1,2,12,5,0,67
15,2,5,25,1,14,3,5,0,70
15,2,5,25,5,4,0,0,0,56
15,2,5,25,5,15,0,0,0,67
15,2,5,25,5,18,0,0,0,70
15,2,5,25,5,18,19,0,0,89
15,2,5,25,9,14,7,0,0,77
15,2,5,25,9,14,7,12,25,114
15,2,5,25,19,0,0,0,0,66
15,2,5,9,19,1,14,3,5,73
15,2,5,9,19,1,14,20,0,85
15,2,5,9,19,8,0,0,0,58
15,2,5,9,19,13,0,0,0,63
15,2,5,12,9,0,0,0,0,43
15,2,5,12,9,1,3,0,0,47
15,2,5,12,9,1,12,0,0,56
15,2,5,12,9,1,19,0,0,63
15,2,5,12,9,15,14,0,0,72
15,2,5,12,9,19,3,1,12,78
15,2,5,12,9,19,3,1,18,84
15,2,5,12,9,19,5,0,0,67
15,2,5,12,9,19,5,4,0,71
15,2,5,12,9,19,5,19,0,86
15,2,5,12,9,19,9,14,7,92
15,2,5,12,9,19,11,0,0,73
15,2,5,12,9,19,11,5,4,82
15,2,5,12,9,19,11,19,0,92
15,2,5,12,9,19,13,0,0,75
15,2,5,12,9,19,13,19,0,94
15,2,5,12,9,26,5,0,0,74
15,2,5,12,9,26,5,4,0,78
15,2,5,12,9,26,5,19,0,93
15,2,5,12,9,26,9,14,7,99
15,2,5,12,21,19,0,0,0,74
15,2,5,19,0,0,0,0,0,41
15,2,5,19,5,0,0,0,0,46
15,2,5,19,5,12,25,0,0,83
15,2,5,19,5,14,5,19,19,103
15,2,5,19,9,20,25,0,0,95
15,2,5,19,9,20,9,5,19,103
15,2,5,24,0,0,0,0,0,46
15,2,6,9,18,13,0,0,0,63
15,2,6,21,19,3,1,20,5,92
15,2,6,21,19,3,9,20,25,120
15,2,6,21,19,3,15,21,19,121
15,2,6,21,19,11,0,0,0,74
15,2,9,0,0,0,0,0,0,26
15,2,9,1,0,0,0,0,0,27
15,2,9,1,19,0,0,0,0,46
15,2,9,9,19,13,0,0,0,67
15,2,9,9,19,13,19,0,0,86
15,2,9,9,20,0,0,0,0,55
15,2,9,19,0,0,0,0,0,45
15,2,9,19,16,15,0,0,0,76
15,2,9,20,0,0,0,0,0,46
15,2,9,20,1,12,0,0,0,59
15,2,9,20,5,18,0,0,0,69
15,2,9,20,19,0,0,0,0,65
15,2,9,20,21,1,12,0,0,80
15,2,9,20,21,1,18,25,0,111
15,2,10,0,0,0,0,0,0,27
15,2,10,5,3,20,0,0,0,55
15,2,10,5,3,20,1,14,20,90
15,2,10,5,3,20,5,4,0,64
15,2,10,5,3,20,5,5,0,65
15,2,10,5,3,20,5,18,0,78
15,2,10,5,3,20,9,6,25,95
15,2,10,5,3,20,9,14,7,85
15,2,10,5,3,20,9,15,14,93
15,2,10,5,3,20,9,22,5,91
15,2,10,5,3,20,9,26,5,95
15,2,10,5,3,20,15,18,0,88
15,2,10,5,3,20,15,18,19,107
15,2,10,5,3,20,19,0,0,74
15,2,10,5,20,0,0,0,0,52
15,2,10,9,3,9,5,14,20,87
15,2,10,19,3,1,14,0,0,64
15,2,10,21,18,5,0,0,0,71
15,2,10,21,18,7,1,20,5,99
15,2,12,0,0,0,0,0,0,29
15,2,12,1,19,20,0,0,0,69
15,2,12,1,19,20,9,0,0,78
15,2,12,1,19,20,19,0,0,88
15,2,12,1,20,0,0,0,0,50
15,2,12,1,20,1,0,0,0,51
15,2,12,1,20,5,0,0,0,55
15,2,12,1,20,5,4,0,0,59
15,2,12,1,20,5,12,25,0,92
15,2,12,1,20,5,19,0,0,74
15,2,12,1,20,9,14,7,0,80
15,2,12,1,20,9,15,0,0,74
15,2,12,1,20,9,15,14,0,88
15,2,12,1,20,9,15,14,19,107
15,2,12,1,20,15,18,25,0,108
15,2,12,5,3,20,1,20,5,83
15,2,12,5,25,0,0,0,0,59
15,2,12,9,0,0,0,0,0,38
15,2,12,9,3,17,21,5,0,84
15,2,12,9,7,1,2,12,5,65
15,2,12,9,7,1,14,3,25,88
15,2,12,9,7,1,14,20,0,80
15,2,12,9,7,1,20,5,0,71
15,2,12,9,7,1,20,5,4,75
15,2,12,9,7,1,20,5,19,90
15,2,12,9,7,1,20,9,0,75
15,2,12,9,7,1,20,15,0,81
15,2,12,9,7,1,20,15,18,99
15,2,12,9,7,1,20,15,19,100
15,2,12,9,7,1,20,21,13,100
15,2,12,9,7,5,0,0,0,50
15,2,12,9,7,5,4,0,0,54
15,2,12,9,7,5,4,12,25,91
15,2,12,9,7,5,5,0,0,55
15,2,12,9,7,5,5,19,0,74
15,2,12,9,7,5,18,0,0,68
15,2,12,9,7,5,18,19,0,87
15,2,12,9,7,5,19,0,0,69
15,2,12,9,7,9,14,7,0,75
15,2,12,9,7,15,18,0,0,78
15,2,12,9,7,15,18,19,0,97
15,2,12,9,17,21,1,20,5,102
15,2,12,9,17,21,5,0,0,81
15,2,12,9,17,21,5,4,0,85
15,2,12,9,17,21,5,12,25,118
15,2,12,9,17,21,5,19,0,100
15,2,12,9,17,21,9,14,7,106
15,2,12,9,17,21,9,20,25,130
15,2,12,9,17,21,21,19,0,116
15,2,12,9,22,9,1,12,0,82
15,2,12,9,22,9,15,14,0,98
15,2,12,9,22,9,15,14,19,117
15,2,12,9,22,9,15,21,19,124
15,2,12,15,3,21,20,15,18,121
15,2,12,15,14,7,0,0,0,65
15,2,12,15,14,7,1,20,1,87
15,2,12,15,14,7,9,19,8,101
15,2,12,15,14,7,12,25,0,102
15,2,12,15,14,7,19,0,0,84
15,2,12,15,17,21,25,0,0,107
15,2,12,15,17,21,9,1,12,104
15,2,12,15,17,21,9,5,19,115
15,2,13,9,20,0,0,0,0,59
15,2,14,15,21,14,3,5,0,89
15,2,14,15,21,14,3,5,4,93
15,2,14,15,24,9,5,20,25,129
15,2,14,15,24,9,15,21,19,134
15,2,15,5,19,0,0,0,0,56
15,2,15,9,19,20,0,0,0,80
15,2,15,9,19,20,19,0,0,99
15,2,15,12,0,0,0,0,0,44
15,2,15,12,1,18,25,0,0,88
15,2,15,12,5,0,0,0,0,49
15,2,15,12,5,19,0,0,0,68
15,2,15,12,5,20,0,0,0,69
15,2,15,12,9,0,0,0,0,53
15,2,15,12,15,19,0,0,0,78
15,2,15,12,19,0,0,0,0,63
15,2,15,12,21,19,0,0,0,84
15,2,15,13,5,7,15,9,4,85
15,2,15,21,18,1,3,25,0,100
15,2,15,22,1,12,0,0,0,67
15,2,15,22,1,20,5,0,0,80
15,2,15,22,15,9,4,0,0,82
15,2,18,5,16,20,9,15,14,114
15,2,18,9,26,5,0,0,0,75
15,2,18,15,7,1,20,5,0,83
15,2,18,15,7,1,20,5,4,87
15,2,18,15,20,21,14,4,0,109
15,2,19,3,5,14,5,0,0,63
15,2,19,3,5,14,5,12,25,100
15,2,19,3,5,14,5,18,0,81
15,2,19,3,5,14,5,19,20,102
15,2,19,3,5,14,9,20,25,112
15,2,19,3,21,18,1,0,0,79
15,2,19,3,21,18,1,14,20,113
15,2,19,3,21,18,1,19,0,98
15,2,19,3,21,18,5,0,0,83
15,2,19,3,21,18,5,4,0,87
15,2,19,3,21,18,5,12,25,120
15,2,19,3,21,18,5,18,0,101
15,2,19,3,21,18,5,18,19,120
15,2,19,3,21,18,5,19,0,102
15,2,19,3,21,18,5,19,20,122
15,2,19,3,21,18,9,14,7,108
15,2,19,3,21,18,9,19,13,119
15,2,19,3,21,18,9,19,20,126
15,2,19,3,21,18,9,20,25,132
15,2,19,5,3,18,1,20,5,88
15,2,19,5,4,5,0,0,0,50
15,2,19,5,17,21,5,14,20,118
15,2,19,5,17,21,25,0,0,104
15,2,19,5,17,21,9,1,12,101
15,2,19,5,17,21,9,5,19,112
15,2,19,5,17,21,9,20,25,133
15,2,19,5,17,21,9,21,13,122
15,2,19,5,18,22,5,0,0,86
15,2,19,5,18,22,5,4,0,90
15,2,19,5,18,22,5,18,0,104
15,2,19,5,18,22,5,18,19,123
15,2,19,5,18,22,5,19,0,105
15,2,19,5,18,22,9,14,7,111
15,2,19,5,19,19,0,0,0,79
15,2,19,5,19,19,5,4,0,88
15,2,19,5,19,19,5,19,0,103
15,2,19,5,19,19,9,14,7,109
15,2,19,5,19,19,9,15,14,117
15,2,19,5,19,19,9,22,5,115
15,2,19,5,19,19,15,18,0,112
15,2,19,5,19,19,15,18,19,131
15,2,19,9,4,5,0,0,0,54
15,2,19,9,4,9,1,14,0,73
15,2,19,9,4,9,1,14,19,92
15,2,19,9,4,9,15,21,19,113
15,2,19,9,7,14,0,0,0,66
15,2,19,9,7,14,1,20,5,92
15,2,19,15,12,5,19,3,0,90
15,2,19,15,12,5,19,3,5,95
15,2,19,15,12,5,20,5,0,93
15,2,19,15,12,5,20,5,4,97
15,2,19,15,12,5,20,5,19,112
15,2,19,20,1,3,12,5,0,77
15,2,19,20,1,3,12,5,19,96
15,2,19,20,1,14,3,25,0,99
15,2,19,20,1,14,20,0,0,91
15,2,19,20,1,14,20,5,0,96
15,2,19,20,5,20,0,0,0,81
15,2,19,20,5,20,18,9,3,111
15,2,19,20,5,20,18,9,24,132
15,2,19,20,9,14,1,3,25,108
15,2,19,20,9,14,1,14,20,114
15,2,19,20,9,14,1,20,5,105
15,2,19,20,9,16,1,14,20,116
15,2,19,20,9,16,1,20,5,107
15,2,19,20,18,9,14,7,5,109
15,2,19,20,18,21,3,20,0,118
15,2,19,20,18,21,3,20,19,137
15,2,19,20,18,21,5,14,20,134
15,2,19,20,18,21,19,5,0,119
15,2,19,20,18,21,24,9,20,148
15,2,19,20,21,16,5,6,25,129
15,2,20,1,9,14,0,0,0,61
15,2,20,1,9,14,1,12,0,74
15,2,20,1,9,14,5,4,0,70
15,2,20,1,9,14,5,18,0,84
15,2,20,1,9,14,5,18,19,103
15,2,20,1,9,14,9,14,7,91
15,2,20,1,9,14,19,0,0,80
15,2,20,5,3,20,0,0,0,65
15,2,20,5,3,20,5,4,0,74
15,2,20,5,13,16,5,18,0,94
15,2,20,5,14,4,0,0,0,60
15,2,20,5,14,20,0,0,0,76
15,2,20,5,14,20,9,15,14,114
15,2,20,5,19,20,0,0,0,81
15,2,20,5,19,20,5,4,0,90
15,2,20,5,19,20,9,14,7,111
15,2,20,5,19,20,19,0,0,100
15,2,20,18,5,3,20,0,0,83
15,2,20,18,21,4,5,0,0,85
15,2,20,18,21,4,5,4,0,89
15,2,20,18,21,4,5,18,0,103
15,2,20,18,21,4,5,18,19,122
15,2,20,18,21,4,5,19,0,104
15,2,20,18,21,4,9,14,7,110
15,2,20,18,21,19,9,15,14,133
15,2,20,18,21,19,9,22,5,131
15,2,20,21,14,4,0,0,0,76
15,2,20,21,14,4,5,4,0,85
15,2,20,21,14,4,5,14,20,115
15,2,20,21,14,4,5,18,0,99
15,2,20,21,14,4,9,14,7,106
15,2,20,21,14,4,9,20,25,130
15,2,20,21,14,4,19,0,0,95
15,2,20,21,18,1,20,5,0,102
15,2,20,21,18,1,20,5,4,106
15,2,20,21,18,1,20,5,19,121
15,2,20,21,18,1,20,15,18,130
15,2,20,21,19,5,0,0,0,82
15,2,20,21,19,5,12,25,0,119
15,2,20,21,19,5,18,0,0,100
15,2,20,21,19,5,19,20,0,121
15,2,20,21,19,9,6,9,4,105
15,2,20,21,19,9,15,14,0,115
15,2,20,21,19,9,19,8,0,113
15,2,20,21,19,9,20,25,0,131
15,2,21,13,2,18,1,14,20,106
15,2,21,13,2,18,1,20,5,97
15,2,21,19,0,0,0,0,0,57
15,2,22,0,0,0,0,0,0,39
15,2,22,1,12,12,1,20,5,90
15,2,22,5,14,20,9,15,14,116
15,2,22,5,18,19,1,14,20,116
15,2,22,5,18,19,5,0,0,86
15,2,22,5,18,19,5,12,25,123
15,2,22,5,18,19,5,19,0,105
15,2,22,5,18,19,9,15,14,119
15,2,22,5,18,20,0,0,0,82
15,2,22,5,18,20,5,4,0,91
15,2,22,5,18,20,5,14,4,105
15,2,22,5,18,20,9,14,7,112
15,2,22,5,18,20,19,0,0,101
15,2,22,9,1,2,12,5,0,68
15,2,22,9,1,20,5,0,0,74
15,2,22,9,1,20,5,4,0,78
15,2,22,9,1,20,5,19,0,93
15,2,22,9,1,20,9,14,7,99
15,2,22,9,1,20,9,15,14,107
15,2,22,9,1,20,9,22,5,105
15,2,22,9,1,20,15,18,0,102
15,2,22,9,1,20,15,18,19,121
15,2,22,9,15,21,19,0,0,103
15,2,22,9,15,21,19,12,25,140
15,2,22,15,12,21,20,5,0,112
15,2,22,15,12,21,20,5,4,116
15,2,22,15,12,22,5,0,0,93
15,2,22,15,12,22,5,14,20,127
15,3,3,1,13,25,0,0,0,60
15,3,3,1,19,0,0,0,0,41
15,3,3,1,19,9,15,14,0,79
15,3,3,1,19,9,15,14,19,98
15,3,3,1,19,9,22,5,0,77
15,3,3,9,4,5,14,20,19,92
15,3,3,9,4,21,15,21,19,110
15,3,3,9,16,9,20,1,0,76
15,3,3,9,16,9,20,1,12,88
15,3,3,9,16,21,20,0,0,87
15,3,3,9,16,21,20,19,0,106
15,3,3,9,19,9,15,14,0,87
15,3,3,9,20,15,14,5,0,84
15,3,3,12,21,4,5,0,0,63
15,3,3,12,21,4,5,4,0,67
15,3,3,12,21,4,5,14,20,97
15,3,3,12,21,4,5,19,0,82
15,3,3,12,21,4,9,14,7,88
15,3,3,12,21,19,1,12,0,86
15,3,3,12,21,19,5,0,0,78
15,3,3,12,21,19,9,15,14,111
15,3,3,12,21,19,9,22,5,109
15,3,3,12,21,19,15,18,0,106
15,3,3,21,12,20,0,0,0,74
15,3,3,21,12,20,1,20,5,100
15,3,3,21,12,20,5,4,0,83
15,3,3,21,12,20,5,18,0,97
15,3,3,21,12,20,5,18,19,116
15,3,3,21,12,20,9,14,7,104
15,3,3,21,12,20,9,19,13,115
15,3,3,21,12,20,9,19,20,122
15,3,3,21,12,20,12,25,0,111
15,3,3,21,12,20,19,0,0,93
15,3,3,21,16,1,2,12,5,78
15,3,3,21,16,1,14,3,5,81
15,3,3,21,16,1,14,3,25,101
15,3,3,21,16,1,14,20,0,93
15,3,3,21,16,1,14,20,19,112
15,3,3,21,16,25,0,0,0,83
15,3,3,21,16,9,5,4,0,76
15,3,3,21,16,9,5,18,0,90
15,3,3,21,16,9,5,18,19,109
15,3,3,21,16,9,5,19,0,91
15,3,3,21,16,25,9,14,7,113
15,3,3,21,18,0,0,0,0,60
15,3,3,21,18,5,14,3,5,87
15,3,3,21,18,18,5,4,0,87
15,3,3,21,18,18,5,14,20,117
15,3,3,21,18,18,9,14,7,108
15,3,3,21,18,18,9,20,0,107
15,3,3,21,18,19,0,0,0,79
15,3,3,21,18,19,5,0,0,84
15,3,3,21,18,19,9,22,5,115
15,3,5,1,14,0,0,0,0,38
15,3,5,1,14,1,21,20,0,80
15,3,5,1,14,1,21,20,19,99
15,3,5,1,14,5,4,0,0,47
15,3,5,1,14,5,20,0,0,63
15,3,5,1,14,6,21,12,0,77
15,3,5,1,14,9,20,25,0,92
15,3,5,1,14,12,9,11,5,75
15,3,5,1,14,15,7,0,0,60
15,3,5,1,14,15,21,19,0,93
15,3,5,1,14,19,0,0,0,57
15,3,5,1,14,23,1,25,19,106
15,3,5,1,14,23,1,18,4,84
15,3,5,1,14,23,9,19,5,94
15,3,5,12,12,1,14,1,0,63
15,3,5,12,12,1,18,0,0,66
15,3,5,12,12,1,18,25,0,91
15,3,5,12,12,1,20,5,0,73
15,3,5,12,12,1,20,5,4,77
15,3,5,12,12,9,0,0,0,56
15,3,5,12,12,21,19,0,0,87
15,3,5,12,15,9,4,0,0,63
15,3,5,12,15,20,0,0,0,70
15,3,5,12,15,20,19,0,0,89
15,3,8,0,0,0,0,0,0,26
15,3,8,1,22,1,0,0,0,50
15,3,8,1,22,15,0,0,0,64
15,3,8,5,18,0,0,0,0,49
15,3,8,5,18,5,4,0,0,58
15,3,8,5,18,25,0,0,0,74
15,3,8,5,18,9,14,7,0,79
15,3,8,5,18,9,19,8,0,85
15,3,8,5,18,15,21,19,0,104
15,3,8,5,18,19,0,0,0,68
15,3,8,9,4,15,18,5,0,77
15,3,8,25,13,25,0,0,0,89
15,3,8,12,5,19,9,19,0,90
15,3,8,12,5,20,9,3,0,75
15,3,8,12,15,3,18,1,20,95
15,3,8,15,14,5,0,0,0,60
15,3,8,18,5,0,0,0,0,49
15,3,8,18,5,1,0,0,0,50
15,3,8,18,5,1,5,0,0,55
15,3,8,18,5,1,20,5,0,75
15,3,8,18,5,4,0,0,0,53
15,3,8,18,5,9,19,8,0,85
15,3,8,18,5,15,21,19,0,104
15,3,8,18,5,19,0,0,0,68
15,3,8,18,25,0,0,0,0,69
15,3,8,18,9,14,7,0,0,74
15,3,8,18,15,0,0,0,0,59
15,3,8,18,15,9,4,0,0,72
15,3,8,18,15,12,9,20,5,105
15,3,8,18,15,21,19,0,0,99
15,3,8,20,0,0,0,0,0,46
15,3,25,4,18,15,13,5,0,98
15,3,25,16,15,4,1,14,0,93
15,3,25,16,15,4,9,1,14,102
15,3,25,16,15,4,15,9,4,106
15,3,25,20,5,0,0,0,0,68
15,3,11,0,0,0,0,0,0,29
15,3,11,5,18,19,0,0,0,71
15,3,11,19,20,5,18,0,0,91
15,3,12,15,3,11,0,0,0,59
15,3,15,14,14,5,12,12,0,90
15,3,15,20,5,0,0,0,0,58
15,3,15,20,9,12,12,15,19,120
15,3,17,21,5,0,0,0,0,61
15,3,18,1,3,25,0,0,0,65
15,3,18,5,1,0,0,0,0,42
15,3,18,5,1,5,0,0,0,47
15,3,18,5,1,20,5,0,0,67
15,3,18,5,1,20,5,4,0,71
15,3,20,1,3,8,15,18,4,87
15,3,20,1,3,15,12,9,3,81
15,3,20,1,3,20,9,14,5,90
15,3,20,1,4,0,0,0,0,43
15,3,20,1,4,5,3,25,12,88
15,3,20,1,4,9,3,0,0,55
15,3,20,1,4,19,0,0,0,62
15,3,20,1,5,3,8,15,19,89
15,3,20,1,5,13,5,18,1,81
15,3,20,1,7,15,14,0,0,75
15,3,20,1,7,15,14,1,12,88
15,3,20,1,7,15,14,19,0,94
15,3,20,1,8,5,4,18,1,75
15,3,20,1,12,0,0,0,0,51
15,3,20,1,13,5,20,5,18,100
15,3,20,1,14,0,0,0,0,53
15,3,20,1,14,5,0,0,0,58
15,3,20,1,14,5,19,0,0,77
15,3,20,1,14,7,12,5,0,77
15,3,20,1,14,7,12,5,19,96
15,3,20,1,14,15,12,0,0,80
15,3,20,1,14,15,12,19,0,99
15,3,20,1,14,20,0,0,0,73
15,3,20,1,14,20,1,12,0,86
15,3,20,1,14,20,19,0,0,92
15,3,20,1,16,12,1,0,0,68
15,3,20,1,16,12,15,9,4,95
15,3,20,1,16,15,4,25,0,99
15,3,20,1,16,15,4,9,3,86
15,3,20,1,18,3,8,0,0,68
15,3,20,1,18,3,8,25,0,93
15,3,20,1,18,25,0,0,0,82
15,3,20,1,18,9,21,19,0,106
15,3,20,1,18,15,15,14,0,101
15,3,20,1,19,5,13,9,3,88
15,3,20,1,19,20,9,3,8,98
15,3,20,1,19,20,25,12,5,120
15,3,20,1,22,1,12,0,0,74
15,3,20,1,22,1,18,9,1,90
15,3,20,1,22,4,0,0,0,65
15,3,20,1,22,5,19,0,0,85
15,3,20,1,22,9,3,0,0,73
15,3,20,1,22,9,14,1,0,85
15,3,20,1,22,15,0,0,0,76
15,3,20,1,22,15,19,0,0,95
15,3,20,4,18,1,0,0,0,61
15,3,20,5,3,20,0,0,0,66
15,3,20,5,3,20,19,0,0,85
15,3,20,5,14,1,18,25,0,101
15,3,20,5,14,5,0,0,0,62
15,3,20,5,14,14,9,1,12,93
15,3,20,5,20,0,0,0,0,63
15,3,20,5,20,19,0,0,0,82
15,3,20,5,20,20,5,0,0,88
15,3,20,5,20,20,5,19,0,107
15,3,20,9,3,0,0,0,0,50
15,3,20,25,12,0,0,0,0,75
15,3,20,9,12,5,0,0,0,64
15,3,20,25,12,5,14,5,0,99
15,3,20,9,12,12,9,15,14,109
15,3,20,25,12,19,0,0,0,94
15,3,20,9,14,5,0,0,0,66
15,3,20,25,14,5,0,0,0,82
15,3,20,15,1,4,0,0,0,58
15,3,20,15,1,12,12,15,25,118
15,3,20,15,1,20,5,0,0,79
15,3,20,15,2,1,19,19,0,94
15,3,20,15,2,5,18,19,0,97
15,3,20,15,3,8,15,18,4,101
15,3,20,15,4,5,0,0,0,62
15,3,20,15,4,15,14,20,0,106
15,3,20,15,5,3,8,15,19,103
15,3,20,15,6,9,4,0,0,72
15,3,20,15,6,15,9,12,0,95
15,3,20,15,7,1,13,25,0,99
15,3,20,15,7,9,12,4,0,85
15,3,20,15,7,12,15,20,0,107
15,3,20,15,9,3,0,0,0,65
15,3,20,15,9,4,0,0,0,66
15,3,20,15,25,12,0,0,0,90
15,3,20,15,13,5,18,1,12,102
15,3,20,15,13,5,20,5,18,114
15,3,20,15,14,1,12,0,0,80
15,3,20,15,14,1,18,5,0,91
15,3,20,15,14,1,18,25,0,111
15,3,20,15,14,9,15,14,0,105
15,3,20,15,15,14,0,0,0,82
15,3,20,15,16,5,1,14,0,89
15,3,20,15,16,5,4,0,0,78
15,3,20,15,16,5,4,5,0,83
15,3,20,15,16,9,0,0,0,78
15,3,20,15,16,9,14,5,0,97
15,3,20,15,16,12,15,9,4,109
15,3,20,15,16,15,4,0,0,88
15,3,20,15,16,15,4,1,14,103
15,3,20,15,16,15,4,5,19,112
15,3,20,15,16,15,4,19,0,107
15,3,20,15,16,15,12,1,18,115
15,3,20,15,16,21,19,0,0,109
15,3,20,15,16,21,19,5,19,133
15,3,20,15,18,5,13,5,0,94
15,3,20,15,18,15,15,14,0,115
15,3,20,15,18,15,15,14,19,134
15,3,20,15,19,5,0,0,0,77
15,3,20,15,19,16,15,18,5,126
15,3,20,15,20,8,15,18,16,130
15,3,20,18,15,9,0,0,0,80
15,3,20,18,15,25,0,0,0,96
15,3,20,18,15,9,19,0,0,99
15,3,20,21,15,18,0,0,0,92
15,3,20,21,16,12,5,0,0,92
15,3,20,21,16,12,5,4,0,96
15,3,20,21,16,12,5,19,0,111
15,3,20,21,16,12,5,20,0,112
15,3,20,21,16,12,5,20,19,131
15,3,20,21,16,12,5,24,0,116
15,3,20,21,16,12,25,0,0,112
15,3,20,21,16,12,9,14,7,117
15,3,21,2,25,0,0,0,0,66
15,3,21,12,1,18,0,0,0,70
15,3,21,12,1,18,25,0,0,95
15,3,21,12,1,18,9,19,20,118
15,3,21,12,1,18,12,25,0,107
15,3,21,12,1,18,19,0,0,89
15,3,21,12,1,20,5,0,0,77
15,3,21,12,1,20,5,4,0,81
15,3,21,12,9,0,0,0,0,60
15,3,21,12,9,6,15,18,13,112
15,3,21,12,9,14,9,4,0,87
15,3,21,12,9,14,15,9,4,102
15,3,21,12,9,19,20,0,0,99
15,3,21,12,9,19,20,9,3,111
15,3,21,12,9,19,20,19,0,118
15,3,21,12,12,9,0,0,0,72
15,3,21,12,21,19,0,0,0,91
15,3,21,18,18,5,4,0,0,84
15,4,4,2,1,12,12,0,0,50
15,4,4,2,1,12,12,19,0,69
15,4,4,5,18,0,0,0,0,46
15,4,4,5,19,20,0,0,0,67
15,4,4,9,19,8,0,0,0,59
15,4,4,9,20,25,0,0,0,77
15,4,4,9,20,9,5,19,0,85
15,4,4,12,5,7,19,0,0,66
15,4,4,12,25,0,0,0,0,60
15,4,4,13,1,14,0,0,0,51
15,4,4,13,5,14,20,0,0,75
15,4,4,13,5,14,20,19,0,94
15,4,4,14,5,19,19,0,0,80
15,4,4,14,5,19,19,5,19,104
15,4,4,19,9,4,5,0,0,60
15,4,4,19,13,1,14,0,0,70
15,4,5,0,0,0,0,0,0,24
15,4,5,1,0,0,0,0,0,25
15,4,5,15,14,0,0,0,0,53
15,4,5,15,14,19,0,0,0,72
15,4,5,19,0,0,0,0,0,43
15,4,5,21,13,0,0,0,0,58
15,4,5,21,13,19,0,0,0,77
15,4,9,2,12,5,0,0,0,47
15,4,9,3,0,0,0,0,0,31
15,4,9,3,1,12,12,25,0,81
15,4,9,6,5,18,15,21,19,112
15,4,25,12,0,0,0,0,0,56
15,4,25,12,5,0,0,0,0,61
15,4,25,12,5,19,0,0,0,80
15,4,25,12,9,3,0,0,0,68
15,4,25,12,9,19,13,0,0,97
15,4,25,12,9,19,20,0,0,104
15,4,25,12,9,26,5,0,0,96
15,4,25,12,19,0,0,0,0,75
15,4,9,14,9,20,5,0,0,76
15,4,9,15,13,5,20,5,18,104
15,4,9,15,21,19,0,0,0,83
15,4,9,15,21,19,12,25,0,120
15,4,25,19,19,5,25,19,0,131
15,4,9,19,20,0,0,0,0,67
15,4,9,19,20,19,0,0,0,86
15,4,9,21,13,0,0,0,0,62
15,4,9,21,13,19,0,0,0,81
15,4,12,9,14,7,0,0,0,61
15,4,15,7,18,1,16,8,0,84
15,4,15,7,18,1,16,8,19,103
15,4,15,12,15,7,25,0,0,93
15,4,15,13,5,20,5,18,0,95
15,4,15,13,5,20,5,18,19,114
15,4,15,13,5,20,18,25,0,115
15,4,15,14,1,20,5,0,0,74
15,4,15,14,1,20,5,19,0,93
15,4,15,14,20,0,0,0,0,68
15,4,15,14,20,1,7,18,1,95
15,4,15,14,20,9,1,0,0,78
15,4,15,14,20,9,3,0,0,80
15,4,15,14,20,9,19,20,0,116
15,4,15,14,20,9,20,9,19,125
15,4,15,14,20,15,7,5,14,109
15,4,15,14,20,15,9,4,0,96
15,4,15,14,20,15,9,4,19,115
15,4,15,14,20,15,13,1,0,97
15,4,15,14,20,15,19,9,19,130
15,4,15,15,13,0,0,0,0,62
15,4,15,16,8,15,14,5,0,92
15,4,15,18,0,0,0,0,0,52
15,4,15,18,1,2,12,5,0,72
15,4,15,18,1,14,20,0,0,87
15,4,15,18,1,14,20,19,0,106
15,4,15,18,1,20,5,0,0,78
15,4,15,18,1,20,15,18,0,106
15,4,15,18,5,4,0,0,0,61
15,4,15,18,6,21,12,0,0,91
15,4,15,18,9,6,9,3,0,79
15,4,15,18,9,16,8,15,18,118
15,4,15,18,9,26,5,0,0,92
15,4,15,18,9,26,5,4,0,96
15,4,15,18,9,26,5,18,0,110
15,4,15,18,9,26,5,19,0,111
15,4,15,18,9,26,9,14,7,117
15,4,15,18,12,5,19,19,0,107
15,4,15,18,15,19,9,20,25,140
15,4,15,18,15,21,19,0,0,107
15,4,15,18,15,21,19,12,25,144
15,4,15,18,16,18,15,15,6,122
15,4,15,18,19,0,0,0,0,71
15,4,15,21,18,0,0,0,0,73
15,4,15,21,18,5,4,0,0,82
15,4,15,21,18,6,21,12,0,112
15,4,15,21,18,12,5,19,19,128
15,4,15,21,18,19,0,0,0,92
15,4,19,15,0,0,0,0,0,53
15,4,23,25,5,18,0,0,0,90
15,5,3,9,0,0,0,0,0,32
15,5,3,9,19,20,0,0,0,71
15,5,3,15,4,15,13,9,3,82
15,5,3,15,9,4,0,0,0,51
15,5,3,15,12,15,7,25,0,97
15,5,3,15,14,15,13,9,3,92
15,5,3,15,14,15,13,21,19,120
15,5,3,21,13,5,14,9,3,88
15,5,3,21,19,0,0,0,0,63
15,5,4,5,13,1,0,0,0,43
15,5,4,5,13,1,19,0,0,62
15,5,4,5,13,1,20,1,0,64
15,5,4,5,13,5,18,9,4,78
15,5,4,9,16,1,12,12,25,99
15,5,4,9,16,21,19,5,19,113
15,5,9,12,12,1,4,5,0,63
15,5,9,12,12,1,4,5,19,82
15,5,9,12,12,5,20,0,0,78
15,5,11,9,19,20,0,0,0,79
15,5,12,5,20,0,0,0,0,57
15,5,14,1,14,20,8,9,3,89
15,5,14,1,14,20,8,25,12,114
15,5,14,1,14,20,8,15,12,104
15,5,14,9,14,0,0,0,0,57
15,5,14,15,3,8,15,1,5,81
15,5,14,15,3,8,15,5,0,80
15,5,14,15,3,25,20,5,0,102
15,5,14,15,3,25,20,9,3,109
15,5,14,15,12,9,3,0,0,73
15,5,14,15,12,9,14,0,0,84
15,5,14,15,12,15,7,25,0,108
15,5,14,15,13,1,14,3,25,105
15,5,14,15,13,1,14,9,1,87
15,5,14,15,13,5,12,0,0,79
15,5,14,15,13,5,12,19,0,98
15,5,14,15,13,5,20,5,18,110
15,5,14,15,16,8,9,12,5,99
15,5,18,0,0,0,0,0,0,38
15,5,18,19,20,5,4,0,0,86
15,5,18,19,20,5,4,19,0,105
15,5,19,15,7,9,0,0,0,70
15,5,19,15,16,8,1,7,9,95
15,5,19,20,18,9,1,14,0,101
15,5,19,20,18,9,4,0,0,90
15,5,19,20,18,9,14,0,0,100
15,5,19,20,18,9,14,19,0,119
15,5,19,20,18,9,15,12,0,113
15,5,19,20,18,9,15,12,19,132
15,5,19,20,18,15,7,5,14,118
15,5,19,20,18,15,9,4,0,105
15,5,19,20,18,15,14,5,0,111
15,5,19,20,18,15,14,5,19,130
15,5,19,20,18,15,21,19,0,132
15,5,19,20,18,21,1,12,0,111
15,5,19,20,18,21,1,20,5,124
15,5,19,20,18,21,13,0,0,111
15,5,19,20,18,21,13,19,0,130
15,5,19,20,18,21,19,0,0,117
15,5,19,20,18,21,19,5,19,141
15,5,21,22,18,5,0,0,0,86
15,5,21,22,18,5,19,0,0,105
15,6,5,18,0,0,0,0,0,44
15,6,6,0,0,0,0,0,0,27
15,6,6,1,12,0,0,0,0,40
15,6,6,1,12,9,14,7,0,70
15,6,6,1,12,19,0,0,0,59
15,6,6,2,5,1,20,0,0,55
15,6,6,2,5,1,20,19,0,74
15,6,6,2,18,5,1,11,0,64
15,6,6,3,1,19,20,0,0,70
15,6,6,3,1,19,20,19,0,89
15,6,6,3,15,12,15,21,18,111
15,6,6,3,15,13,5,0,0,63
15,6,6,3,21,20,0,0,0,71
15,6,6,5,4,0,0,0,0,36
15,6,6,5,14,3,5,0,0,54
15,6,6,5,14,3,5,19,0,73
15,6,6,5,14,4,0,0,0,50
15,6,6,5,14,4,1,14,20,85
15,6,6,5,14,4,5,4,0,59
15,6,6,5,14,4,5,18,0,73
15,6,6,5,14,4,5,18,19,92
15,6,6,5,14,4,9,14,7,80
15,6,6,5,14,4,19,0,0,69
15,6,6,5,14,19,5,0,0,70
15,6,6,5,14,19,5,19,0,89
15,6,6,5,14,19,9,15,14,103
15,6,6,5,14,19,9,22,5,101
15,6,6,5,18,0,0,0,0,50
15,6,6,5,18,1,2,12,5,70
15,6,6,5,18,5,4,0,0,59
15,6,6,5,18,5,5,0,0,60
15,6,6,5,18,5,18,0,0,73
15,6,6,5,18,5,18,19,0,92
15,6,6,5,18,9,14,7,0,80
15,6,6,5,18,9,14,7,19,99
15,6,6,5,18,15,18,0,0,83
15,6,6,5,18,15,18,19,0,102
15,6,6,5,18,19,0,0,0,69
15,6,6,7,15,9,14,7,0,79
15,6,6,7,18,1,4,5,0,62
15,6,6,8,1,14,4,0,0,54
15,6,6,8,1,14,4,5,4,63
15,6,6,9,3,0,0,0,0,39
15,6,6,9,3,5,0,0,0,44
15,6,6,9,3,5,18,0,0,62
15,6,6,9,3,5,18,5,4,71
15,6,6,9,3,5,18,19,0,81
15,6,6,9,3,5,19,0,0,63
15,6,6,9,3,9,1,12,19,80
15,6,6,9,3,9,1,14,20,83
15,6,6,9,3,9,1,18,25,92
15,6,6,9,3,9,1,20,5,74
15,6,6,9,3,9,14,1,0,63
15,6,6,9,3,9,14,1,12,75
15,6,6,9,3,9,15,0,0,63
15,6,6,9,3,9,15,21,19,103
15,6,6,9,14,7,0,0,0,57
15,6,6,9,14,7,19,0,0,76
15,6,6,9,19,8,0,0,0,63
15,6,6,9,19,8,12,25,0,100
15,6,6,11,5,25,0,0,0,68
15,6,6,12,1,16,0,0,0,56
15,6,6,12,5,20,0,0,0,64
15,6,6,12,9,14,5,0,0,67
15,6,6,12,15,1,4,0,0,59
15,6,6,12,15,1,4,5,4,68
15,6,6,12,15,1,4,19,0,78
15,6,6,12,15,15,11,0,0,80
15,6,6,16,1,25,0,0,0,69
15,6,6,16,18,9,14,20,0,104
15,6,6,16,18,9,14,20,19,123
15,6,6,18,1,13,16,0,0,75
15,6,6,18,1,13,16,19,0,94
15,6,6,19,0,0,0,0,0,46
15,6,6,19,1,4,4,12,5,72
15,6,6,19,3,1,16,5,0,71
15,6,6,19,3,15,21,18,0,103
15,6,6,19,3,18,5,5,14,91
15,6,6,19,3,21,13,0,0,83
15,6,6,19,5,20,0,0,0,71
15,6,6,19,5,20,19,0,0,90
15,6,6,19,8,15,15,20,0,104
15,6,6,19,8,15,15,20,19,123
15,6,6,19,8,15,18,5,0,92
15,6,6,19,9,4,5,0,0,64
15,6,6,19,9,4,5,18,0,82
15,6,6,19,9,4,5,19,0,83
15,6,6,19,16,18,9,14,7,110
15,6,6,19,20,1,7,5,0,79
15,6,6,20,1,11,5,0,0,64
15,6,6,20,25,16,5,0,0,93
15,6,6,20,18,1,3,11,0,80
15,6,6,21,19,3,1,20,5,96
15,6,6,23,1,18,4,0,0,73
15,6,6,23,1,18,4,19,0,92
15,6,9,3,9,14,1,0,0,57
15,6,12,5,20,5,0,0,0,63
15,6,20,0,0,0,0,0,0,41
15,6,20,5,14,0,0,0,0,60
15,6,20,5,14,5,18,0,0,83
15,6,20,5,14,5,19,20,0,104
15,6,20,5,14,14,5,19,19,117
15,6,20,5,14,19,0,0,0,79
15,6,20,5,14,20,9,13,5,107
15,6,20,5,18,0,0,0,0,64
15,6,20,5,19,20,0,0,0,85
15,6,20,8,9,14,11,0,0,83
15,6,20,12,25,0,0,0,0,78
15,6,20,14,5,19,19,0,0,98
15,6,20,20,9,13,5,0,0,88
15,6,20,20,9,13,5,19,0,107
15,6,20,23,8,9,12,5,19,117
15,7,4,15,1,4,0,0,0,46
15,7,4,15,1,4,19,0,0,65
15,7,4,15,1,19,0,0,0,61
15,7,5,5,0,0,0,0,0,32
15,7,5,5,4,0,0,0,0,36
15,7,5,5,19,0,0,0,0,51
15,7,5,14,5,19,9,19,0,93
15,7,5,14,5,20,9,3,0,78
15,7,8,1,13,0,0,0,0,44
15,7,8,1,13,9,3,0,0,56
15,7,8,1,13,9,19,20,0,92
15,7,8,1,13,9,19,20,19,111
15,7,8,1,13,19,0,0,0,63
15,7,9,22,1,12,0,0,0,66
15,7,9,22,5,0,0,0,0,58
15,7,9,22,5,4,0,0,0,62
15,7,9,22,5,19,0,0,0,77
15,7,12,5,0,0,0,0,0,39
15,7,12,5,4,0,0,0,0,43
15,7,12,5,18,0,0,0,0,57
15,7,12,5,18,19,0,0,0,76
15,7,12,5,19,0,0,0,0,58
15,7,12,9,14,7,0,0,0,64
15,7,13,9,3,0,0,0,0,47
15,7,15,14,9,21,13,0,0,94
15,7,18,1,16,8,25,0,0,90
15,7,18,5,0,0,0,0,0,45
15,7,18,5,9,19,8,0,0,81
15,7,18,5,9,19,8,12,25,118
15,7,18,5,9,19,13,0,0,86
15,7,18,5,9,19,13,19,0,105
15,7,18,5,19,0,0,0,0,64
15,7,18,5,19,19,0,0,0,83
15,7,18,5,19,19,5,19,0,107
15,7,18,9,19,8,0,0,0,76
15,7,18,9,19,8,12,25,0,113
15,7,18,9,19,13,0,0,0,81
15,7,18,9,19,13,19,0,0,100
15,7,20,9,5,18,14,0,0,88
15,7,21,13,0,0,0,0,0,56
15,8,5,4,0,0,0,0,0,32
15,8,5,12,15,0,0,0,0,55
15,8,9,1,0,0,0,0,0,33
15,8,9,1,19,0,0,0,0,52
15,8,9,14,7,0,0,0,0,53
15,8,9,15,1,14,19,0,0,81
15,8,13,1,7,5,0,0,0,49
15,8,13,1,7,5,19,0,0,68
15,8,13,9,3,0,0,0,0,48
15,8,13,9,3,1,12,12,25,98
15,8,13,13,5,20,5,18,0,97
15,8,13,13,5,20,5,18,19,116
15,8,15,0,0,0,0,0,0,38
15,8,15,25,0,0,0,0,0,63
15,8,15,14,5,0,0,0,0,57
15,8,19,0,0,0,0,0,0,42
15,8,22,0,0,0,0,0,0,45
15,9,3,0,0,0,0,0,0,27
15,9,3,11,19,0,0,0,0,57
15,9,4,0,0,0,0,0,0,28
15,9,4,1,12,0,0,0,0,41
15,9,4,5,1,0,0,0,0,34
15,9,4,9,1,0,0,0,0,38
15,9,4,9,15,9,4,0,0,65
15,9,4,23,12,6,5,0,0,74
15,9,5,0,0,0,0,0,0,29
15,25,5,12,5,20,0,0,0,82
15,25,5,18,0,0,0,0,0,63
15,25,5,18,19,0,0,0,0,82
15,25,5,19,0,0,0,0,0,64
15,25,5,19,19,5,19,0,0,107
15,25,5,26,0,0,0,0,0,71
15,9,9,0,0,0,0,0,0,33
15,9,11,0,0,0,0,0,0,35
15,9,11,15,12,15,7,25,0,109
15,9,11,15,13,1,14,9,1,88
15,9,11,15,16,12,1,19,20,118
15,9,11,19,0,0,0,0,0,54
15,9,12,0,0,0,0,0,0,36
15,9,12,2,5,18,18,25,0,104
15,9,12,2,9,18,4,0,0,69
15,9,12,2,9,18,4,19,0,88
15,9,12,3,1,11,5,0,0,56
15,9,12,3,1,13,16,0,0,69
15,9,12,3,1,13,16,19,0,88
15,9,12,3,1,14,0,0,0,54
15,9,12,3,1,14,19,0,0,73
15,9,12,3,1,19,5,0,0,64
15,9,12,3,12,15,20,8,0,94
15,9,12,3,12,15,20,8,19,113
15,9,12,3,15,1,20,0,0,75
15,9,12,3,21,16,0,0,0,76
15,9,12,3,21,16,19,0,0,95
15,9,12,4,15,13,0,0,0,68
15,9,12,5,4,0,0,0,0,45
15,9,12,5,18,0,0,0,0,59
15,9,12,5,18,25,0,0,0,84
15,9,12,5,18,19,0,0,0,78
15,25,12,5,20,0,0,0,0,77
15,9,12,6,9,5,12,4,0,72
15,9,12,6,9,18,5,4,0,78
15,9,12,6,9,19,8,0,0,78
15,9,12,6,9,19,8,5,19,102
15,9,12,8,15,12,5,0,0,76
15,9,12,8,15,12,5,19,0,95
15,9,12,25,0,0,0,0,0,61
15,9,12,9,5,18,0,0,0,68
15,9,12,9,5,19,20,0,0,89
15,9,12,25,9,19,8,0,0,97
15,9,12,9,12,25,0,0,0,82
15,9,12,9,14,5,19,19,0,102
15,9,12,9,14,7,0,0,0,66
15,9,12,9,19,8,0,0,0,72
15,9,12,12,5,19,19,0,0,91
15,9,12,12,5,20,0,0,0,73
15,9,12,12,9,11,5,0,0,73
15,9,12,13,1,14,0,0,0,64
15,9,12,13,5,14,0,0,0,68
15,9,12,13,15,14,7,5,18,108
15,9,12,15,13,5,20,5,18,112
15,9,12,16,1,16,5,18,0,92
15,9,12,16,1,16,5,18,19,111
15,9,12,16,18,15,15,6,0,106
15,9,12,19,0,0,0,0,0,55
15,9,12,19,5,5,4,0,0,69
15,9,12,19,5,5,4,19,0,88
15,9,12,19,11,9,14,0,0,89
15,9,12,19,11,9,14,19,0,108
15,9,12,19,20,15,3,11,0,104
15,9,12,19,20,15,14,5,0,109
15,9,12,19,20,15,14,5,4,113
15,9,12,19,20,15,14,5,19,128
15,9,12,19,20,15,22,5,0,117
15,9,12,20,9,7,8,20,0,100
15,9,12,23,1,25,0,0,0,85
15,9,12,23,1,25,19,0,0,104
15,9,12,23,5,12,12,0,0,88
15,9,13,5,0,0,0,0,0,42
15,9,14,11,0,0,0,0,0,49
15,9,14,11,5,4,0,0,0,58
15,9,14,11,9,14,7,0,0,79
15,9,14,11,19,0,0,0,0,68
15,9,14,15,3,8,15,1,9,89
15,9,14,15,3,8,15,5,0,84
15,9,14,15,3,8,15,5,19,103
15,9,14,15,3,8,15,9,0,88
15,9,14,15,12,15,7,25,0,112
15,9,14,15,13,1,14,3,25,109
15,9,14,15,13,1,14,9,1,91
15,9,14,15,13,5,12,0,0,83
15,9,14,15,13,5,12,19,0,102
15,9,14,20,0,0,0,0,0,58
15,9,14,20,13,5,14,20,0,110
15,9,14,20,13,5,14,20,19,129
15,9,19,9,22,9,20,25,0,128
15,25,19,20,5,18,0,0,0,102
15,25,19,20,5,18,1,7,5,115
15,25,19,20,5,18,5,4,0,111
15,25,19,20,5,18,5,18,0,125
15,25,19,20,5,18,5,18,19,144
15,25,19,20,5,18,9,5,19,135
15,25,19,20,5,18,9,14,7,132
15,25,19,20,5,18,9,19,8,138
15,25,19,20,5,18,13,1,14,130
15,25,19,20,5,18,13,5,14,134
15,25,19,20,5,18,15,21,19,157
15,25,19,20,5,18,19,0,0,121
15,9,20,1,22,1,0,0,0,68
15,9,20,9,3,9,3,1,0,69
15,9,20,9,3,9,3,1,19,88
15,11,5,0,0,0,0,0,0,31
15,11,5,5,0,0,0,0,0,36
15,11,5,8,0,0,0,0,0,39
15,11,5,8,19,0,0,0,0,58
15,11,5,25,0,0,0,0,0,56
15,11,5,25,4,15,11,5,0,91
15,11,5,25,4,15,11,5,25,116
15,11,5,14,9,20,5,0,0,79
15,11,5,18,0,0,0,0,0,49
15,11,5,19,0,0,0,0,0,50
15,11,5,20,0,0,0,0,0,51
15,11,9,0,0,0,0,0,0,35
15,11,9,1,0,0,0,0,0,36
15,11,9,13,15,14,15,0,0,92
15,11,15,12,5,8,1,15,0,82
15,11,15,14,9,15,19,9,19,126
15,11,15,14,9,20,5,0,0,89
15,11,15,21,13,5,0,0,0,80
15,11,18,1,0,0,0,0,0,45
15,11,18,1,19,0,0,0,0,64
15,11,18,15,0,0,0,0,0,59
15,11,18,15,15,7,0,0,0,81
15,11,18,21,7,0,0,0,0,72
15,11,18,21,26,9,0,0,0,100
15,11,19,8,15,15,6,4,0,93
15,11,20,1,0,0,0,0,0,47
15,11,20,8,1,2,1,8,0,66
15,11,21,16,21,11,21,16,21,153
15,12,4,5,14,0,0,0,0,50
15,12,4,5,14,5,4,0,0,59
15,12,4,5,14,9,14,7,0,80
15,12,4,5,18,13,15,19,20,121
15,12,4,5,18,19,0,0,0,73
15,12,4,5,19,20,0,0,0,75
15,12,4,8,1,13,9,20,5,87
15,12,4,25,0,0,0,0,0,56
15,12,4,9,5,0,0,0,0,45
15,12,4,9,5,19,0,0,0,64
15,12,4,9,19,8,0,0,0,67
15,12,4,12,1,14,4,0,0,62
15,12,4,14,5,19,19,0,0,88
15,12,4,14,5,19,19,5,19,112
15,12,4,19,17,21,1,23,0,112
15,12,4,19,20,5,18,0,0,93
15,12,4,19,20,5,18,19,0,112
15,12,4,19,20,25,12,5,0,112
15,12,4,19,20,25,12,5,19,131
15,12,4,23,5,14,3,8,0,84
15,12,4,23,9,6,5,0,0,74
15,12,4,23,9,22,5,19,0,109
15,12,5,0,0,0,0,0,0,32
15,12,5,1,3,5,15,21,19,96
15,12,5,1,14,1,0,0,0,48
15,12,5,1,14,4,5,18,0,74
15,12,5,1,14,4,5,18,19,93
15,12,5,1,14,4,18,9,14,92
15,12,5,1,18,25,0,0,0,76
15,12,5,1,19,5,0,0,0,57
15,12,5,1,19,20,5,18,0,95
15,12,5,1,19,20,5,18,19,114
15,12,5,1,20,5,0,0,0,58
15,12,5,1,20,5,19,0,0,77
15,12,5,3,18,1,14,1,12,81
15,12,5,3,18,1,14,15,14,97
15,12,5,6,9,1,14,20,0,82
15,12,5,6,9,14,0,0,0,61
15,12,5,6,9,14,5,0,0,66
15,12,5,6,9,14,5,19,0,85
15,12,5,6,9,14,9,3,0,73
15,12,5,6,9,14,19,0,0,80
15,12,5,9,3,0,0,0,0,44
15,12,5,9,14,0,0,0,0,55
15,12,5,9,14,5,0,0,0,60
15,12,5,9,14,5,19,0,0,79
15,12,5,9,14,19,0,0,0,74
15,12,5,14,1,0,0,0,0,47
15,12,5,14,9,4,0,0,0,59
15,12,5,14,9,4,9,1,14,83
15,12,5,14,20,0,0,0,0,66
15,12,5,15,0,0,0,0,0,47
15,12,5,15,3,25,19,20,0,114
15,12,5,15,4,21,3,20,0,95
15,12,5,15,7,18,1,16,8,97
15,12,5,15,25,12,0,0,0,84
15,12,5,15,13,5,20,5,18,108
15,12,5,15,16,20,5,14,5,107
15,12,5,15,18,5,19,9,14,112
15,12,5,15,19,0,0,0,0,66
15,12,5,15,19,5,0,0,0,71
15,12,5,15,19,9,20,25,0,120
15,12,5,15,21,19,0,0,0,87
15,12,5,16,25,0,0,0,0,73
15,12,5,19,0,0,0,0,0,51
15,12,5,21,13,0,0,0,0,66
15,12,5,21,13,19,0,0,0,85
15,12,6,1,3,20,0,0,0,57
15,12,6,1,3,20,25,0,0,82
15,12,6,1,3,20,9,15,14,95
15,12,6,1,3,20,9,22,5,93
15,12,6,1,3,20,15,18,0,90
15,12,6,1,3,20,15,18,25,115
15,12,9,2,1,14,0,0,0,53
15,12,9,2,1,14,21,13,0,87
15,12,9,2,1,14,21,13,19,106
15,12,9,2,5,14,5,0,0,62
15,12,25,3,15,15,11,0,0,96
15,12,9,4,0,0,0,0,0,40
15,12,9,7,1,5,13,9,1,72
15,12,9,7,1,18,3,8,0,73
15,12,9,7,1,18,3,8,25,98
15,12,9,7,1,18,3,8,19,92
15,12,9,7,5,13,9,1,0,71
15,12,9,7,9,4,9,3,0,68
15,12,9,7,9,4,18,9,1,84
15,12,9,7,9,19,20,0,0,91
15,12,9,7,9,19,20,9,3,103
15,12,9,7,15,13,5,18,0,94
15,12,9,7,15,13,5,18,25,119
15,12,9,7,15,13,5,18,19,113
15,12,9,7,15,14,9,20,5,106
15,12,9,7,15,16,14,5,1,94
15,12,9,7,15,16,15,12,25,126
15,12,9,7,15,19,9,20,5,111
15,12,9,7,21,18,9,1,0,92
15,12,25,11,15,5,11,0,0,94
15,12,25,13,16,9,1,4,19,114
15,12,9,15,0,0,0,0,0,51
15,12,9,15,19,0,0,0,0,70
15,12,9,16,18,1,14,3,5,93
15,12,9,20,15,18,25,0,0,114
15,12,9,22,1,18,25,0,0,102
15,12,9,22,1,19,20,5,18,121
15,12,9,22,5,4,0,0,0,67
15,12,9,22,5,14,5,19,19,120
15,12,9,22,5,14,9,20,5,111
15,12,9,22,5,18,13,1,14,109
15,12,9,22,5,18,13,5,14,113
15,12,9,22,5,23,15,15,4,120
15,12,9,22,9,6,15,18,13,119
15,12,9,22,9,12,0,0,0,79
15,12,9,22,9,12,5,0,0,84
15,12,9,22,9,12,9,14,0,102
15,12,9,22,9,14,5,0,0,86
15,12,9,22,9,14,5,19,0,105
15,12,9,22,9,14,9,3,0,93
15,12,9,22,9,14,9,20,5,115
15,12,12,1,13,8,0,0,0,61
15,12,12,1,16,15,4,0,0,75
15,12,12,1,19,0,0,0,0,59
15,12,12,1,22,0,0,0,0,62
15,12,12,5,14,9,20,5,0,92
15,12,12,15,3,11,0,0,0,68
15,12,12,21,3,11,0,0,0,74
15,12,15,6,0,0,0,0,0,48
15,12,15,7,25,0,0,0,0,74
15,12,15,7,9,3,1,12,0,74
15,12,15,7,9,5,19,0,0,82
15,12,15,7,9,19,20,0,0,97
15,12,15,7,9,19,20,9,3,109
15,12,15,7,9,19,20,19,0,116
15,12,15,7,18,1,16,8,0,92
15,12,15,12,9,21,17,21,9,131
15,12,15,13,1,15,0,0,0,71
15,12,15,14,1,0,0,0,0,57
15,12,15,18,15,19,15,0,0,109
15,12,15,18,15,19,15,19,0,128
15,12,16,0,0,0,0,0,0,43
15,12,16,1,5,0,0,0,0,49
15,12,16,5,19,0,0,0,0,67
15,12,20,15,14,4,5,0,0,85
15,12,20,21,14,14,1,0,0,97
15,13,2,5,18,0,0,0,0,53
15,13,2,5,18,19,0,0,0,72
15,13,2,18,5,0,0,0,0,53
15,13,2,18,5,19,0,0,0,72
15,13,2,18,5,20,20,5,0,98
15,13,2,18,9,6,21,7,5,96
15,13,2,18,15,12,15,7,25,122
15,13,2,18,15,16,8,9,12,108
15,13,2,21,4,19,13,1,14,102
15,13,2,21,4,19,13,5,14,106
15,13,5,0,0,0,0,0,0,33
15,13,5,7,1,0,0,0,0,41
15,13,5,7,1,19,0,0,0,60
15,13,5,7,15,9,4,0,0,68
15,13,5,12,5,20,0,0,0,70
15,13,5,12,5,20,19,0,0,89
15,13,5,12,5,20,20,5,0,95
15,13,5,12,5,20,20,5,19,114
15,13,5,12,9,5,0,0,0,59
15,13,5,14,0,0,0,0,0,47
15,13,5,14,5,4,0,0,0,56
15,13,5,14,9,14,7,0,0,77
15,13,5,14,15,12,15,7,25,121
15,13,5,14,19,0,0,0,0,66
15,13,5,14,20,1,0,0,0,68
15,13,5,14,20,1,12,0,0,80
15,13,5,14,20,9,20,9,19,124
15,13,5,14,20,21,12,21,13,134
15,13,5,14,20,21,13,0,0,101
15,13,5,14,20,21,13,19,0,120
15,13,5,14,20,21,20,1,0,109
15,13,5,18,19,0,0,0,0,70
15,13,5,20,5,18,0,0,0,76
15,13,9,3,18,15,14,0,0,87
15,13,9,3,18,15,14,19,0,106
15,13,9,11,18,15,14,0,0,95
15,13,9,11,18,15,14,19,0,114
15,13,9,14,1,0,0,0,0,52
15,13,9,14,1,20,5,0,0,77
15,13,9,14,15,21,19,0,0,106
15,13,9,14,15,21,19,12,25,143
15,13,9,19,19,9,2,12,5,103
15,13,9,19,19,9,15,14,0,113
15,13,9,19,19,9,15,14,19,132
15,13,9,19,19,9,22,5,0,111
15,13,9,19,19,21,19,0,0,115
15,13,9,20,0,0,0,0,0,57
15,13,9,20,9,19,0,0,0,85
15,13,9,20,19,0,0,0,0,76
15,13,9,20,20,1,2,12,5,97
15,13,9,20,20,1,14,3,5,100
15,13,9,20,20,5,4,0,0,86
15,13,9,20,20,5,18,0,0,100
15,13,9,20,20,5,18,19,0,119
15,13,9,20,20,9,14,7,0,107
15,13,12,1,8,0,0,0,0,49
15,13,13,1,20,5,1,0,0,68
15,13,13,1,20,5,1,12,0,80
15,13,13,1,20,5,21,13,0,101
15,13,13,1,20,9,4,9,1,85
15,13,14,5,9,20,25,0,0,101
15,13,14,5,19,0,0,0,0,66
15,13,14,9,0,0,0,0,0,51
15,13,14,9,1,14,1,0,0,67
15,13,14,9,1,18,3,8,0,81
15,13,14,9,1,18,3,8,19,100
15,13,14,9,2,21,19,0,0,93
15,13,14,9,2,21,19,5,19,117
15,13,14,9,6,25,0,0,0,82
15,13,14,9,6,9,3,0,0,69
15,13,14,9,6,9,4,5,12,87
15,13,14,9,6,9,5,4,0,75
15,13,14,9,6,25,9,14,7,112
15,13,14,9,6,15,3,1,12,88
15,13,14,9,6,15,18,13,0,103
15,13,14,9,7,18,1,16,8,101
15,13,14,9,8,21,13,1,14,108
15,13,14,9,13,5,20,5,18,112
15,13,14,9,13,15,4,5,0,88
15,13,14,9,18,1,14,7,5,96
15,13,14,9,19,3,15,16,5,109
15,13,14,9,19,20,0,0,0,90
15,13,14,9,20,15,14,1,12,113
15,13,14,9,20,15,14,9,3,112
15,13,14,9,20,21,4,5,0,101
15,13,14,9,21,13,0,0,0,85
15,13,14,9,22,15,18,5,0,111
15,13,14,9,22,15,18,5,19,130
15,13,15,4,25,14,9,1,0,96
15,13,15,8,25,15,9,4,0,104
15,13,15,9,4,5,21,13,0,95
15,13,15,16,8,1,7,25,0,100
15,13,15,16,8,1,7,9,1,85
15,13,15,16,8,1,7,9,3,87
15,13,15,16,8,15,18,9,1,110
15,13,15,16,12,1,20,5,0,97
15,13,16,8,1,3,25,0,0,81
15,13,16,8,1,3,9,14,5,84
15,13,16,8,1,3,9,20,5,90
15,13,16,8,1,12,9,0,0,74
15,13,16,8,1,12,9,3,0,77
15,13,16,8,1,12,9,19,13,106
15,13,16,8,1,12,15,4,5,89
15,13,16,8,1,12,15,9,4,93
15,13,16,8,1,12,15,13,1,94
15,13,16,8,1,12,15,19,0,99
15,13,16,8,1,12,21,19,0,105
15,13,18,1,8,0,0,0,0,55
15,14,2,15,1,18,4,0,0,69
15,14,3,1,0,0,0,0,0,33
15,14,3,5,0,0,0,0,0,37
15,14,3,5,18,0,0,0,0,55
15,14,3,5,19,0,0,0,0,56
15,14,3,5,20,0,0,0,0,57
15,14,3,5,20,20,1,0,0,78
15,14,3,9,1,0,0,0,0,42
15,14,3,9,4,9,21,13,19,107
15,14,3,9,14,0,0,0,0,55
15,14,3,15,7,5,14,5,0,78
15,14,3,15,7,5,14,9,3,85
15,14,3,15,7,18,1,16,8,97
15,14,3,15,12,15,7,25,0,106
15,14,3,15,12,15,7,9,3,93
15,14,3,15,13,5,0,0,0,65
15,14,3,15,13,5,20,5,18,108
15,14,3,15,13,5,20,18,25,128
15,14,3,15,13,9,14,7,0,90
15,14,3,15,13,9,14,7,19,109
15,14,3,15,19,5,19,0,0,90
15,14,3,15,19,9,19,0,0,94
15,14,3,15,19,20,0,0,0,86
15,14,3,15,19,20,13,1,14,114
15,14,3,15,20,9,3,0,0,79
15,14,3,15,20,15,13,25,0,120
15,14,4,1,7,18,1,13,0,73
15,14,4,1,7,18,1,16,8,84
15,14,4,1,13,5,20,5,18,95
15,14,4,1,19,3,15,16,5,92
15,14,4,1,20,18,1,0,0,73
15,14,4,25,0,0,0,0,0,58
15,14,4,9,14,7,0,0,0,63
15,14,4,15,7,18,1,13,0,87
15,14,4,15,7,18,1,13,19,106
15,14,4,15,7,18,1,16,8,98
15,14,4,15,25,1,14,20,0,108
15,14,4,15,13,5,20,5,18,109
15,14,4,15,19,3,15,16,5,106
15,14,4,21,12,5,0,0,0,71
15,14,5,0,0,0,0,0,0,34
15,14,5,2,5,18,18,25,0,102
15,14,5,6,15,12,4,0,0,71
15,14,5,7,9,20,5,0,0,75
15,14,5,8,15,15,4,0,0,76
15,14,5,8,15,23,0,0,0,80
15,14,5,9,4,1,19,0,0,67
15,14,5,25,5,18,0,0,0,82
15,14,5,9,18,9,3,0,0,73
15,14,5,9,18,15,20,9,3,108
15,14,5,9,19,13,0,0,0,75
15,14,5,13,5,14,20,0,0,86
15,14,5,14,5,19,19,0,0,91
15,14,5,14,5,19,19,5,19,115
15,14,5,18,0,0,0,0,0,52
15,14,5,18,1,18,25,0,0,96
15,14,5,18,1,20,5,0,0,78
15,14,5,18,1,20,9,22,5,109
15,14,5,18,25,0,0,0,0,77
15,14,5,18,9,5,18,0,0,84
15,14,5,18,9,5,19,20,0,105
15,14,5,18,15,19,5,0,0,91
15,14,5,18,15,19,9,20,25,140
15,14,5,18,15,21,19,0,0,107
15,14,5,18,15,21,19,12,25,144
15,14,5,19,0,0,0,0,0,53
15,14,5,19,5,12,6,0,0,76
15,14,5,19,9,7,14,5,4,92
15,14,5,20,8,5,0,0,0,67
15,14,5,20,9,13,5,0,0,81
15,14,5,23,8,5,18,5,0,93
15,14,6,1,12,12,0,0,0,60
15,14,6,12,5,13,5,4,0,74
15,14,6,12,15,23,0,0,0,85
15,14,6,12,15,23,9,14,7,115
15,14,7,1,18,15,0,0,0,70
15,14,7,15,9,14,7,0,0,81
15,14,8,1,14,7,5,18,0,82
15,14,25,0,0,0,0,0,0,54
15,14,25,3,8,1,0,0,0,66
15,14,25,3,8,9,1,0,0,75
15,14,25,3,8,9,14,0,0,88
15,14,25,3,8,9,20,5,0,99
15,14,25,3,8,9,20,9,19,122
15,14,25,3,8,9,21,13,0,108
15,14,25,3,8,15,9,4,0,93
15,14,25,3,8,15,19,9,19,127
15,14,9,3,15,12,15,0,0,83
15,14,25,13,0,0,0,0,0,67
15,14,25,13,1,12,0,0,0,80
15,14,25,13,1,14,3,25,0,110
15,14,25,13,1,20,9,3,0,100
15,14,25,13,25,0,0,0,0,92
15,14,25,13,9,20,25,0,0,121
15,14,25,13,9,26,5,0,0,107
15,14,25,13,15,21,19,0,0,122
15,14,9,15,13,1,14,9,1,91
15,14,9,15,14,0,0,0,0,67
15,14,9,15,14,5,20,0,0,92
15,14,9,15,14,25,0,0,0,92
15,14,9,15,14,9,26,5,4,111
15,14,9,15,14,12,9,11,5,104
15,14,9,15,14,16,5,5,12,105
15,14,9,15,14,19,11,9,14,120
15,14,9,18,15,20,9,3,0,103
15,14,9,19,3,15,9,4,0,88
15,14,9,21,13,0,0,0,0,72
15,14,25,24,5,19,0,0,0,102
15,14,25,24,9,19,0,0,0,106
15,14,25,24,9,20,9,19,0,135
15,14,11,5,18,0,0,0,0,63
15,14,11,15,19,0,0,0,0,74
15,14,12,1,25,0,0,0,0,67
15,14,12,1,9,4,0,0,0,55
15,14,12,1,25,9,14,7,0,97
15,14,12,1,16,0,0,0,0,58
15,14,12,5,16,25,0,0,0,87
15,14,12,5,19,19,0,0,0,84
15,14,12,25,0,0,0,0,0,66
15,14,12,9,5,19,20,0,0,94
15,14,12,9,14,5,0,0,0,69
15,14,12,9,14,5,19,19,0,107
15,14,12,15,15,11,0,0,0,82
15,14,12,15,15,11,5,18,0,105
15,14,12,15,15,11,5,18,19,124
15,14,12,15,15,11,9,14,7,112
15,14,13,1,18,3,8,0,0,72
15,14,15,3,18,15,20,1,12,113
15,14,15,6,18,9,20,5,0,102
15,14,15,12,1,20,18,25,0,120
15,14,15,13,1,14,3,25,0,100
15,14,15,13,1,14,20,9,1,102
15,14,15,13,1,19,20,9,3,109
15,14,15,13,1,20,15,16,0,109
15,14,15,13,1,20,15,16,5,114
15,14,15,13,1,20,15,16,25,134
15,14,15,13,1,20,15,21,19,133
15,14,18,21,19,8,0,0,0,95
15,14,18,21,19,8,5,19,0,119
15,14,18,21,19,8,9,14,7,125
15,14,19,0,0,0,0,0,0,48
15,14,19,5,20,0,0,0,0,73
15,14,19,5,20,19,0,0,0,92
15,14,19,5,20,20,5,18,0,116
15,14,19,5,20,20,9,14,7,123
15,14,19,8,15,18,5,0,0,94
15,14,19,9,4,5,0,0,0,66
15,14,19,9,7,8,20,0,0,92
15,14,19,12,1,21,7,8,20,117
15,14,19,20,1,7,5,0,0,81
15,14,19,20,1,14,4,0,0,87
15,14,19,20,5,1,4,0,0,78
15,14,19,23,5,5,16,0,0,97
15,14,20,0,0,0,0,0,0,49
15,14,20,1,12,0,0,0,0,62
15,14,20,9,3,0,0,0,0,61
15,14,20,9,3,1,12,12,25,111
15,14,20,15,0,0,0,0,0,64
15,14,20,15,3,25,3,12,5,112
15,14,20,15,7,5,14,1,12,103
15,14,20,15,7,5,14,25,0,115
15,14,20,15,7,5,14,9,3,102
15,14,20,15,12,15,7,25,0,123
15,14,20,15,12,15,7,9,3,110
15,14,20,15,19,15,16,8,25,147
15,14,21,19,0,0,0,0,0,69
15,14,21,19,5,19,0,0,0,93
15,14,23,1,9,20,9,14,7,112
15,14,23,1,18,4,0,0,0,75
15,14,23,1,18,4,12,25,0,112
15,14,23,1,18,4,19,0,0,94
15,14,26,1,0,0,0,0,0,56
15,15,2,9,20,0,0,0,0,61
15,15,2,12,1,19,20,0,0,84
15,15,2,12,1,19,20,9,3,96
15,15,3,25,5,19,9,19,0,110
15,15,3,25,19,20,0,0,0,97
15,15,3,25,19,20,9,3,0,109
15,15,3,25,19,20,19,0,0,116
15,15,3,25,20,5,0,0,0,83
15,15,3,25,20,5,19,0,0,102
15,15,4,12,5,19,0,0,0,70
15,15,4,12,9,14,19,0,0,88
15,15,5,3,9,1,0,0,0,48
15,15,5,3,9,1,12,0,0,60
15,15,5,3,9,21,13,0,0,81
15,15,6,0,0,0,0,0,0,36
15,15,6,2,9,18,4,0,0,69
15,15,6,25,0,0,0,0,0,61
15,15,6,9,5,18,0,0,0,68
15,15,6,9,5,19,20,0,0,89
15,15,6,12,5,19,19,0,0,91
15,15,6,20,9,19,8,0,0,92
15,15,7,1,13,5,20,5,0,81
15,15,7,1,13,5,20,5,19,100
15,15,7,1,13,25,0,0,0,76
15,15,7,1,13,9,5,19,0,84
15,15,7,1,13,15,21,19,0,106
15,15,7,5,14,5,19,9,19,108
15,15,7,5,14,5,20,9,3,93
15,15,7,5,14,25,0,0,0,81
15,15,7,5,14,9,5,19,0,89
15,15,7,12,5,1,0,0,0,55
15,15,7,12,15,5,1,0,0,70
15,15,7,15,14,5,0,0,0,71
15,15,7,15,14,9,1,0,0,76
15,15,7,15,14,9,1,12,0,88
15,15,7,15,14,9,14,9,1,99
15,15,7,15,14,9,21,13,0,109
15,15,7,15,14,9,21,13,19,128
15,15,7,18,1,16,8,0,0,80
15,15,8,0,0,0,0,0,0,38
15,15,8,5,4,0,0,0,0,47
15,15,8,9,14,7,0,0,0,68
15,15,8,19,0,0,0,0,0,57
15,15,9,4,0,0,0,0,0,43
15,15,9,4,1,12,0,0,0,56
15,15,11,9,14,5,19,9,19,116
15,15,11,9,14,5,20,5,0,94
15,15,11,9,14,5,20,9,3,101
15,15,12,1,3,8,1,14,0,69
15,15,12,1,3,8,1,14,19,88
15,15,12,1,11,0,0,0,0,54
15,15,12,1,11,1,14,0,0,69
15,15,12,5,13,13,1,0,0,74
15,15,12,9,20,5,0,0,0,76
15,15,12,9,20,5,19,0,0,95
15,15,12,9,20,8,0,0,0,79
15,15,12,9,20,8,19,0,0,98
15,15,12,12,25,0,0,0,0,79
15,15,12,12,9,5,19,0,0,87
15,15,12,15,7,25,0,0,0,89
15,15,12,15,7,9,3,0,0,76
15,15,12,15,7,9,3,1,12,89
15,15,12,15,7,9,5,19,0,97
15,15,12,15,7,9,19,20,0,112
15,15,12,15,7,9,19,20,19,131
15,15,12,15,7,9,26,5,0,104
15,15,12,15,14,7,0,0,0,78
15,15,12,15,14,7,19,0,0,97
15,15,13,1,14,3,25,0,0,86
15,15,13,1,14,20,9,1,0,88
15,15,13,5,20,5,18,0,0,91
15,15,13,5,20,18,25,0,0,111
15,15,13,5,20,18,9,3,0,98
15,15,13,9,1,3,0,0,0,56
15,15,13,9,1,3,11,0,0,67
15,15,13,9,1,3,11,19,0,86
15,15,13,9,1,3,19,0,0,75
15,15,13,9,1,11,0,0,0,64
15,15,13,9,1,11,19,0,0,83
15,15,13,25,3,5,20,5,0,101
15,15,13,16,1,8,0,0,0,68
15,15,13,16,1,8,5,4,0,77
15,15,13,16,1,8,19,0,0,87
15,15,13,16,8,0,0,0,0,67
15,15,13,16,8,19,0,0,0,86
15,15,14,0,0,0,0,0,0,44
15,15,14,19,0,0,0,0,0,63
15,15,14,20,0,0,0,0,0,64
15,15,15,15,0,0,0,0,0,60
15,15,16,1,3,11,0,0,0,61
15,15,16,1,11,0,0,0,0,58
15,15,16,8,25,20,5,0,0,104
15,15,16,8,25,20,5,19,0,123
15,15,16,8,25,20,9,3,0,111
15,15,16,8,15,18,5,0,0,92
15,15,16,8,15,18,9,3,0,99
15,15,16,8,15,18,15,13,1,116
15,15,16,8,15,18,15,14,0,116
15,15,16,12,1,19,13,0,0,91
15,15,16,12,1,19,13,9,3,103
15,15,16,12,1,19,20,0,0,98
15,15,16,15,4,0,0,0,0,65
15,15,16,15,4,1,12,0,0,78
15,15,16,21,8,21,5,0,0,101
15,15,18,1,12,9,0,0,0,70
15,15,18,1,12,9,19,0,0,89
15,15,18,4,0,0,0,0,0,52
15,15,18,25,0,0,0,0,0,73
15,15,18,9,1,12,0,0,0,70
15,15,18,9,5,0,0,0,0,62
15,15,19,0,0,0,0,0,0,49
15,15,19,3,15,16,5,0,0,88
15,15,19,3,15,16,25,0,0,108
15,15,19,5,0,0,0,0,0,54
15,15,19,16,5,18,13,0,0,101
15,15,19,16,5,18,13,19,0,120
15,15,19,16,8,5,18,5,0,101
15,15,19,16,8,5,18,5,19,120
15,15,19,16,15,18,5,0,0,103
15,15,19,16,15,18,5,19,0,122
15,15,19,16,15,18,9,3,0,110
15,15,19,16,15,18,15,21,19,153
15,15,19,20,5,7,9,20,5,115
15,15,20,8,5,3,1,0,0,67
15,15,20,8,5,3,1,5,0,72
15,15,20,8,5,3,1,12,0,79
15,15,20,9,4,0,0,0,0,63
15,15,20,9,4,19,0,0,0,82
15,15,20,25,16,5,0,0,0,96
15,15,20,15,3,15,9,4,0,96
15,15,20,15,3,15,21,19,0,123
15,15,20,19,0,0,0,0,0,69
15,15,20,23,9,20,8,0,0,110
15,15,21,1,19,19,1,0,0,91
15,15,26,5,0,0,0,0,0,61
15,15,26,5,4,0,0,0,0,65
15,15,26,5,19,0,0,0,0,80
15,15,26,9,5,18,0,0,0,88
15,15,26,9,5,19,20,0,0,109
15,15,26,9,12,25,0,0,0,102
15,15,26,9,14,5,19,19,0,122
15,15,26,9,14,7,0,0,0,86
15,15,26,15,1,0,0,0,0,72
15,15,26,15,9,4,0,0,0,84
15,15,26,15,15,9,4,0,0,99
15,16,3,15,4,5,0,0,0,58
15,16,4,1,12,9,20,5,0,82
15,16,5,0,0,0,0,0,0,36
15,16,5,4,0,0,0,0,0,40
15,16,5,4,5,12,4,15,3,79
15,16,5,12,5,20,0,0,0,73
15,16,5,12,21,0,0,0,0,69
15,16,5,14,0,0,0,0,0,50
15,16,5,14,1,2,12,5,0,70
15,16,5,14,2,1,14,4,0,71
15,16,5,14,2,5,1,11,0,69
15,16,5,14,2,9,12,12,0,85
15,16,5,14,3,1,19,20,0,93
15,16,5,14,3,8,1,9,14,85
15,16,5,14,3,21,20,0,0,94
15,16,5,14,5,4,0,0,0,59
15,16,5,14,5,18,0,0,0,73
15,16,5,14,5,18,19,0,0,92
15,16,5,14,5,19,20,0,0,94
15,16,5,14,8,5,1,4,0,68
15,16,5,14,9,14,7,0,0,80
15,16,5,14,9,14,7,19,0,99
15,16,5,14,12,25,0,0,0,87
15,16,5,14,14,5,19,19,0,107
15,16,5,14,19,0,0,0,0,69
15,16,5,14,19,9,4,5,0,87
15,16,5,14,23,15,18,11,0,117
15,16,5,14,23,15,18,11,19,136
15,16,5,18,1,0,0,0,0,55
15,16,5,18,1,2,9,12,25,103
15,16,5,18,1,2,12,5,0,74
15,16,5,18,1,2,12,25,0,94
15,16,5,18,1,5,0,0,0,60
15,16,5,18,1,7,15,5,18,100
15,16,5,18,1,14,3,5,0,77
15,16,5,18,1,14,3,25,0,97
15,16,5,18,1,14,4,0,0,73
15,16,5,18,1,14,4,9,0,82
15,16,5,18,1,14,4,19,0,92
15,16,5,18,1,14,20,0,0,89
15,16,5,18,1,14,20,9,19,117
15,16,5,18,1,14,20,12,25,126
15,16,5,18,1,14,20,19,0,108
15,16,5,18,1,18,25,0,0,98
15,16,5,18,1,19,0,0,0,74
15,16,5,18,1,20,5,0,0,80
15,16,5,18,1,20,5,4,0,84
15,16,5,18,1,20,5,5,0,85
15,16,5,18,1,20,5,19,0,99
15,16,5,18,1,20,9,3,0,87
15,16,5,18,1,20,9,3,19,106
15,16,5,18,1,20,9,14,7,105
15,16,5,18,1,20,9,15,14,113
15,16,5,18,1,20,9,22,5,111
15,16,5,18,1,20,9,26,5,115
15,16,5,18,1,20,15,18,0,108
15,16,5,18,1,20,15,18,25,133
15,16,5,18,1,20,15,18,19,127
15,16,5,18,1,20,18,9,24,126
15,16,5,18,3,5,12,5,0,79
15,16,5,18,3,5,12,5,19,98
15,16,5,18,3,12,5,0,0,74
15,16,5,18,3,12,5,4,0,78
15,16,5,18,3,21,12,1,0,91
15,16,5,18,3,21,12,1,18,109
15,16,5,18,3,21,12,5,0,95
15,16,5,18,3,21,12,5,19,114
15,16,5,18,3,21,12,21,13,124
15,16,5,18,5,20,20,1,0,100
15,16,5,18,5,20,20,1,19,119
15,16,5,18,5,20,20,5,0,104
15,16,5,18,12,1,0,0,0,67
15,16,5,18,15,14,0,0,0,83
15,16,5,18,15,14,19,0,0,102
15,16,5,18,15,19,5,0,0,93
15,16,5,18,15,19,5,12,25,130
15,16,5,18,15,19,9,20,25,142
15,16,5,19,0,0,0,0,0,55
15,16,8,9,1,19,9,19,0,96
15,16,8,9,3,0,0,0,0,51
15,16,8,9,4,9,1,14,0,76
15,16,8,9,4,9,1,14,19,95
15,16,8,9,4,9,15,9,4,89
15,16,8,9,4,9,15,21,19,116
15,16,8,9,4,9,21,13,0,95
15,16,8,9,15,9,4,0,0,76
15,16,8,9,15,12,9,20,5,109
15,16,8,9,15,12,15,7,25,122
15,16,8,9,15,14,9,4,0,90
15,16,8,9,15,14,9,14,5,105
15,16,8,9,20,5,19,0,0,92
15,16,8,9,21,18,1,14,0,102
15,16,8,9,21,18,9,4,0,100
15,16,8,9,21,18,15,9,4,115
15,16,8,18,25,15,14,0,0,111
15,16,8,20,8,1,12,13,0,93
15,16,8,20,8,1,12,13,25,118
15,16,9,1,0,0,0,0,0,41
15,16,9,1,14,5,0,0,0,60
15,16,9,1,14,9,3,0,0,67
15,16,9,1,14,25,12,0,0,92
15,16,9,1,20,5,0,0,0,66
15,16,9,1,20,5,4,0,0,70
15,16,9,1,20,5,19,0,0,85
15,16,9,1,20,9,3,0,0,73
15,16,9,1,20,9,14,7,0,91
15,16,9,6,5,24,0,0,0,75
15,16,9,6,9,3,5,0,0,63
15,16,9,6,9,3,5,18,0,81
15,16,9,9,19,13,0,0,0,81
15,16,9,14,1,2,12,5,0,74
15,16,9,14,1,2,12,25,0,94
15,16,9,14,1,14,20,0,0,89
15,16,9,14,1,20,9,15,14,113
15,16,9,14,1,20,9,22,5,111
15,16,9,14,1,20,15,18,0,108
15,16,9,14,5,0,0,0,0,59
15,16,9,14,5,4,0,0,0,63
15,16,9,14,5,18,0,0,0,77
15,16,9,14,5,18,19,0,0,96
15,16,9,14,5,19,0,0,0,78
15,16,9,14,7,0,0,0,0,61
15,16,9,14,9,1,20,5,0,89
15,16,9,14,9,1,20,5,4,93
15,16,9,14,9,1,20,5,18,107
15,16,9,14,9,1,20,18,5,107
15,16,9,14,9,3,21,19,0,106
15,16,9,14,9,14,7,0,0,84
15,16,9,14,9,15,14,0,0,92
15,16,9,14,9,15,14,1,12,105
15,16,9,14,9,15,14,5,4,101
15,16,9,14,9,15,14,19,0,111
15,16,9,15,9,4,0,0,0,68
15,16,9,15,9,4,19,0,0,87
15,16,9,15,13,1,14,9,1,93
15,16,9,15,16,8,1,7,25,112
15,16,9,16,1,18,15,21,19,130
15,16,9,19,20,8,9,15,14,125
15,16,9,21,13,0,0,0,0,74
15,16,9,21,13,9,19,13,0,115
15,16,9,21,13,9,19,13,19,134
15,16,9,21,13,19,0,0,0,93
15,16,15,2,1,12,19,1,13,94
15,16,15,4,5,12,4,15,3,89
15,16,15,4,25,13,21,19,0,128
15,16,15,12,9,19,0,0,0,86
15,16,15,16,1,14,1,24,0,102
15,16,15,16,15,14,1,24,0,116
15,16,15,19,19,21,13,0,0,118
15,16,15,19,19,21,13,19,0,137
15,16,16,9,4,1,0,0,0,61
15,16,16,9,4,1,14,0,0,75
15,16,16,9,4,1,14,19,0,94
15,16,16,9,4,21,13,0,0,94
15,16,16,9,12,1,14,20,0,103
15,16,16,9,12,1,20,5,0,94
15,16,16,9,12,1,20,5,4,98
15,16,16,9,12,1,20,5,19,113
15,16,16,12,5,20,5,0,0,89
15,16,16,12,5,20,9,15,14,122
15,16,16,15,14,5,0,0,0,81
15,16,16,15,14,5,14,3,25,123
15,16,16,15,14,5,14,19,0,114
15,16,16,15,14,5,14,20,0,115
15,16,16,15,14,5,14,20,19,134
15,16,16,15,18,20,21,14,5,140
15,16,16,15,19,1,2,12,5,101
15,16,16,15,19,1,12,0,0,94
15,16,16,15,19,5,0,0,0,86
15,16,16,15,19,5,4,0,0,90
15,16,16,15,19,5,18,0,0,104
15,16,16,15,19,5,18,19,0,123
15,16,16,15,19,5,19,0,0,105
15,16,16,15,19,9,14,7,0,111
15,16,16,15,19,9,20,0,0,110
15,16,16,15,19,9,20,5,0,115
15,16,16,15,19,9,20,5,19,134
15,16,16,15,19,19,21,13,0,134
15,16,16,15,19,21,18,5,0,125
15,16,16,18,5,19,19,0,0,108
15,16,16,18,5,19,19,5,4,117
15,16,16,18,5,19,19,5,19,132
15,16,16,18,5,19,19,15,18,141
15,16,16,18,15,2,18,25,0,125
15,16,16,21,7,14,0,0,0,89
15,16,16,21,7,14,1,3,25,118
15,16,16,21,7,14,1,14,20,124
15,16,16,21,7,14,1,20,5,115
15,16,16,21,7,14,5,4,0,98
15,16,16,21,7,14,5,18,0,112
15,16,16,21,7,14,5,18,19,131
15,16,16,21,7,14,9,14,7,119
15,16,16,21,7,14,19,0,0,108
15,16,19,25,0,0,0,0,0,75
15,16,19,9,7,1,13,25,0,105
15,16,19,9,13,1,20,8,0,101
15,16,19,9,13,1,20,8,25,126
15,16,19,9,14,0,0,0,0,73
15,16,19,9,14,19,0,0,0,92
15,16,19,9,19,0,0,0,0,78
15,16,19,9,19,6,15,18,13,130
15,16,19,9,19,20,25,16,5,144
15,16,19,15,14,9,1,0,0,89
15,16,19,15,14,9,3,0,0,91
15,16,19,15,14,9,6,25,0,119
15,16,19,15,14,9,14,0,0,102
15,16,19,15,14,9,14,19,0,121
15,16,19,15,14,9,19,20,0,127
15,16,19,15,14,9,21,13,0,122
15,16,19,15,14,9,26,5,0,119
15,16,19,15,14,9,26,5,4,123
15,16,19,15,14,9,26,5,19,138
15,16,19,15,14,15,7,5,14,120
15,16,19,15,14,15,9,4,0,107
15,16,20,0,0,0,0,0,0,51
15,16,20,1,2,12,5,0,0,71
15,16,20,1,2,12,25,0,0,91
15,16,20,1,14,20,0,0,0,86
15,16,20,1,20,5,0,0,0,77
15,16,20,1,20,9,15,14,0,110
15,16,20,1,20,9,22,5,0,108
15,16,20,1,20,9,22,5,19,127
15,16,20,5,4,0,0,0,0,60
15,16,20,8,1,12,13,9,3,97
15,16,20,9,3,0,0,0,0,63
15,16,20,9,3,1,12,0,0,76
15,16,20,9,3,1,12,12,25,113
15,16,20,9,3,9,1,14,0,87
15,16,20,9,3,9,1,14,19,106
15,16,20,9,3,9,19,13,0,104
15,16,20,9,3,9,19,20,0,111
15,16,20,9,3,9,19,20,19,130
15,16,20,9,3,9,20,25,0,117
15,16,20,9,3,12,25,0,0,100
15,16,20,9,3,15,14,0,0,92
15,16,20,9,3,19,0,0,0,82
15,16,20,9,7,18,1,16,8,110
15,16,20,9,13,1,0,0,0,74
15,16,20,9,13,1,3,25,0,102
15,16,20,9,13,1,12,0,0,86
15,16,20,9,13,1,12,12,25,123
15,16,20,9,13,1,20,5,0,99
15,16,20,9,13,1,20,5,19,118
15,16,20,9,13,5,0,0,0,78
15,16,20,9,13,5,19,0,0,97
15,16,20,9,13,5,20,5,18,121
15,16,20,9,13,9,19,5,0,106
15,16,20,9,13,9,19,5,4,110
15,16,20,9,13,9,19,5,19,125
15,16,20,9,13,9,19,13,0,114
15,16,20,9,13,9,19,13,19,133
15,16,20,9,13,9,19,20,0,121
15,16,20,9,13,9,19,20,19,140
15,16,20,9,13,9,20,25,0,127
15,16,20,9,13,9,26,5,0,113
15,16,20,9,13,9,26,5,4,117
15,16,20,9,13,9,26,5,18,131
15,16,20,9,13,9,26,5,19,132
15,16,20,9,13,21,13,0,0,107
15,16,20,9,13,21,13,19,0,126
15,16,20,9,14,7,0,0,0,81
15,16,20,9,15,14,0,0,0,89
15,16,20,9,15,14,1,12,0,102
15,16,20,9,15,14,1,12,19,121
15,16,20,9,15,14,1,18,25,133
15,16,20,9,15,14,5,4,0,98
15,16,20,9,15,14,5,5,0,99
15,16,20,9,15,14,5,5,19,118
15,16,20,9,15,14,9,14,7,119
15,16,20,9,15,14,15,18,0,122
15,16,20,9,15,14,19,0,0,108
15,16,20,9,22,5,0,0,0,87
15,16,20,15,2,12,1,19,20,120
15,16,20,15,7,18,1,13,0,105
15,16,20,15,12,15,7,25,0,125
15,16,20,15,13,5,20,5,18,127
15,16,20,15,13,5,20,18,25,147
15,16,20,15,16,8,15,14,5,124
15,16,20,15,20,25,16,5,0,132
15,16,20,19,0,0,0,0,0,70
15,16,21,12,5,14,3,5,0,91
15,16,21,12,5,14,3,5,19,110
15,16,21,12,5,14,3,25,0,111
15,16,21,12,5,14,20,0,0,103
15,16,21,12,5,14,20,12,25,140
15,16,21,12,21,19,0,0,0,104
15,16,21,14,20,9,1,19,0,115
15,16,21,14,20,9,15,9,4,123
15,16,21,19,0,0,0,0,0,71
15,16,21,19,3,12,5,0,0,91
15,16,21,19,3,21,12,1,0,108
15,16,21,19,3,21,12,1,18,126
15,16,21,19,3,21,12,5,0,112
15,16,21,19,3,21,12,5,19,131
15,16,21,19,3,21,12,21,13,141
15,16,21,19,5,19,0,0,0,95
15,17,21,1,19,19,1,0,0,93
15,17,21,1,19,19,1,19,0,112
15,18,2,1,20,5,0,0,0,61
15,18,2,1,20,9,15,14,0,94
15,18,2,5,4,0,0,0,0,44
15,18,2,5,12,12,0,0,0,64
15,18,2,25,0,0,0,0,0,60
15,18,2,9,3,0,0,0,0,47
15,18,2,9,3,1,12,0,0,60
15,18,2,9,3,12,5,0,0,64
15,18,2,9,3,21,12,1,18,99
15,18,2,9,5,18,0,0,0,67
15,18,2,9,5,19,20,0,0,88
15,18,2,9,6,9,3,0,0,62
15,18,2,9,14,7,0,0,0,65
15,18,2,9,20,0,0,0,0,64
15,18,2,9,20,1,12,0,0,77
15,18,2,9,20,1,12,5,0,82
15,18,2,9,20,1,12,12,25,114
15,18,2,9,20,1,12,19,0,96
15,18,2,9,20,1,18,0,0,83
15,18,2,9,20,1,18,25,0,108
15,18,2,9,20,5,0,0,0,69
15,18,2,9,20,5,4,0,0,73
15,18,2,9,20,5,12,1,18,100
15,18,2,9,20,5,12,5,0,86
15,18,2,9,20,5,18,0,0,87
15,18,2,9,20,5,18,19,0,106
15,18,2,9,20,25,0,0,0,89
15,18,2,9,20,9,14,7,0,94
15,18,2,9,20,19,0,0,0,83
15,18,2,9,20,21,4,5,0,94
15,18,2,12,5,19,19,0,0,90
15,18,2,12,5,20,0,0,0,72
15,18,2,12,9,11,5,0,0,72
15,18,2,19,0,0,0,0,0,54
15,18,3,0,0,0,0,0,0,36
15,18,3,1,14,5,20,0,0,76
15,18,3,1,14,5,20,20,5,101
15,18,3,5,9,14,0,0,0,64
15,18,3,5,9,14,19,0,0,83
15,18,3,8,0,0,0,0,0,44
15,18,3,8,1,13,21,19,0,98
15,18,3,8,1,14,5,20,0,84
15,18,3,8,1,18,4,0,0,67
15,18,3,8,1,18,4,19,0,86
15,18,3,8,1,20,0,0,0,65
15,18,3,8,5,9,20,9,19,106
15,18,3,8,5,12,0,0,0,61
15,18,3,8,5,12,12,1,0,74
15,18,3,8,5,14,0,0,0,63
15,18,3,8,5,19,9,19,0,96
15,18,3,8,5,19,20,5,18,111
15,18,3,8,5,19,20,9,3,100
15,18,3,8,5,19,20,18,1,107
15,18,3,8,5,19,20,18,5,111
15,18,3,8,9,3,0,0,0,56
15,18,3,8,9,4,0,0,0,57
15,18,3,8,9,4,5,1,14,77
15,18,3,8,9,4,9,19,20,105
15,18,3,8,9,4,19,0,0,76
15,18,3,8,9,12,0,0,0,65
15,18,3,8,9,12,12,1,0,78
15,18,3,8,9,12,19,0,0,84
15,18,3,8,9,19,5,19,0,96
15,18,3,8,9,20,9,3,0,85
15,18,3,8,9,20,9,19,0,101
15,18,3,8,15,20,15,13,25,132
15,18,3,9,14,0,0,0,0,59
15,18,3,9,14,5,0,0,0,64
15,18,3,9,14,15,12,0,0,86
15,18,3,9,14,15,12,19,0,105
15,18,3,9,14,19,0,0,0,78
15,18,3,19,0,0,0,0,0,55
15,18,4,1,9,14,0,0,0,61
15,18,4,1,9,14,5,4,0,70
15,18,4,1,9,14,5,18,0,84
15,18,4,1,9,14,5,18,19,103
15,18,4,1,9,14,9,14,7,91
15,18,4,1,9,14,19,0,0,80
15,18,4,1,12,9,1,14,0,74
15,18,4,1,12,9,21,13,0,93
15,18,4,5,1,12,0,0,0,55
15,18,4,5,1,12,19,0,0,74
15,18,4,5,14,5,0,0,0,61
15,18,4,5,18,0,0,0,0,60
15,18,4,5,18,1,2,12,5,80
15,18,4,5,18,5,4,0,0,69
15,18,4,5,18,5,18,0,0,83
15,18,4,5,18,5,18,19,0,102
15,18,4,5,18,9,14,7,0,90
15,18,4,5,18,9,14,7,19,109
15,18,4,5,18,12,5,19,19,115
15,18,4,5,18,12,25,0,0,97
15,18,4,5,18,12,9,5,19,105
15,18,4,5,18,19,0,0,0,79
15,18,4,9,14,1,2,12,5,80
15,18,4,9,14,1,9,18,5,93
15,18,4,9,14,1,12,0,0,73
15,18,4,9,14,1,12,12,25,110
15,18,4,9,14,1,12,19,0,92
15,18,4,9,14,1,14,3,5,83
15,18,4,9,14,1,14,4,0,79
15,18,4,9,14,1,14,4,19,98
15,18,4,9,14,1,14,20,0,95
15,18,4,9,14,1,18,0,0,79
15,18,4,9,14,1,18,25,0,104
15,18,4,9,14,1,20,5,0,86
15,18,4,9,14,1,20,5,4,90
15,18,4,9,14,1,20,5,19,105
15,18,4,9,14,1,20,15,18,114
15,18,4,9,14,5,5,0,0,70
15,18,4,9,14,5,19,0,0,84
15,18,4,14,0,0,0,0,0,51
15,18,4,14,1,14,3,5,0,74
15,18,4,14,1,14,3,5,19,93
15,18,4,15,0,0,0,0,0,52
15,18,4,15,14,14,1,14,20,115
15,18,4,15,19,0,0,0,0,71
15,18,4,15,19,9,20,5,0,105
15,18,4,21,0,0,0,0,0,58
15,18,4,21,18,5,0,0,0,81
15,18,4,21,18,5,19,0,0,100
15,18,4,21,18,15,21,19,0,131
15,18,5,1,4,0,0,0,0,43
15,18,5,1,4,19,0,0,0,62
15,18,5,3,3,8,9,15,14,90
15,18,5,3,20,9,3,0,0,73
15,18,5,3,20,9,22,5,0,97
15,18,5,4,0,0,0,0,0,42
15,18,5,7,1,14,15,0,0,75
15,18,5,7,1,14,15,19,0,94
15,18,5,7,15,14,9,0,0,83
15,18,5,9,4,5,0,0,0,56
15,18,5,9,4,5,19,0,0,75
15,18,5,9,12,5,20,0,0,84
15,18,5,9,12,12,5,18,0,94
15,18,5,9,12,12,5,20,0,96
15,18,5,10,15,14,0,0,0,77
15,18,5,12,12,9,14,0,0,85
15,18,5,13,1,14,0,0,0,66
15,18,5,13,21,19,0,0,0,91
15,18,5,14,4,1,0,0,0,57
15,18,5,14,4,9,20,5,0,90
15,18,5,15,4,15,14,20,0,106
15,18,5,19,0,0,0,0,0,57
15,18,5,19,8,15,15,20,0,115
15,18,5,20,9,3,0,0,0,70
15,18,5,23,5,5,4,0,0,75
15,18,5,23,15,15,4,0,0,95
15,18,5,24,9,14,0,0,0,85
15,18,5,24,9,19,0,0,0,90
15,18,6,0,0,0,0,0,0,39
15,18,6,5,0,0,0,0,0,44
15,18,6,7,9,12,4,0,0,71
15,18,6,18,1,25,0,0,0,83
15,18,6,18,1,25,19,0,0,102
15,18,7,0,0,0,0,0,0,40
15,18,7,1,12,0,0,0,0,53
15,18,7,1,13,5,14,20,0,93
15,18,7,1,13,25,0,0,0,79
15,18,7,1,14,0,0,0,0,55
15,18,7,1,14,1,0,0,0,56
15,18,7,1,14,1,12,0,0,68
15,18,7,1,14,2,9,18,4,88
15,18,7,1,14,4,25,0,0,84
15,18,7,1,14,4,9,5,0,73
15,18,7,1,14,4,9,5,19,92
15,18,7,1,14,5,12,12,1,85
15,18,7,1,14,5,12,12,5,89
15,18,7,1,14,5,18,0,0,78
15,18,7,1,14,5,20,20,5,105
15,18,7,1,14,25,0,0,0,80
15,18,7,1,14,9,3,0,0,67
15,18,7,1,14,9,3,1,12,80
15,18,7,1,14,9,3,19,0,86
15,18,7,1,14,9,6,25,0,95
15,18,7,1,14,9,6,9,3,82
15,18,7,1,14,9,14,7,0,85
15,18,7,1,14,9,19,5,0,88
15,18,7,1,14,9,19,5,4,92
15,18,7,1,14,9,19,5,19,107
15,18,7,1,14,9,19,13,0,96
15,18,7,1,14,9,19,13,19,115
15,18,7,1,14,9,19,20,0,103
15,18,7,1,14,9,19,20,19,122
15,18,7,1,14,9,20,25,0,109
15,18,7,1,14,9,26,5,0,95
15,18,7,1,14,9,26,5,4,99
15,18,7,1,14,9,26,5,18,113
15,18,7,1,14,9,26,5,19,114
15,18,7,1,14,12,5,19,19,110
15,18,7,1,14,15,7,5,12,94
15,18,7,1,14,15,7,5,14,96
15,18,7,1,14,15,9,4,0,83
15,18,7,1,14,15,14,0,0,84
15,18,7,1,14,15,14,25,13,122
15,18,7,1,14,15,14,25,14,123
15,18,7,1,14,15,14,19,0,103
15,18,7,1,14,15,19,15,12,116
15,18,7,1,14,15,20,9,14,113
15,18,7,1,14,18,25,0,0,98
15,18,7,1,14,19,0,0,0,74
15,18,7,1,14,21,12,5,0,93
15,18,7,1,14,21,13,0,0,89
15,18,7,1,14,21,13,19,0,108
15,18,7,1,14,26,1,0,0,82
15,18,7,1,14,26,1,19,0,101
15,18,7,1,14,26,9,14,5,109
15,18,7,1,19,13,0,0,0,73
15,18,7,1,19,13,9,3,0,85
15,18,7,1,19,13,19,0,0,92
15,18,7,1,19,20,9,3,0,92
15,18,7,5,1,20,0,0,0,66
15,18,7,5,1,20,19,0,0,85
15,18,7,25,0,0,0,0,0,65
15,18,7,9,1,0,0,0,0,50
15,18,7,9,1,3,0,0,0,53
15,18,7,9,1,3,19,0,0,72
15,18,7,9,1,19,13,0,0,82
15,18,7,9,1,19,20,0,0,89
15,18,7,9,1,19,20,9,3,101
15,18,7,9,3,0,0,0,0,52
15,18,7,9,5,19,0,0,0,73
15,18,7,25,9,1,0,0,0,75
15,18,7,15,14,5,0,0,0,74
15,18,7,15,14,5,19,0,0,93
15,18,7,21,5,0,0,0,0,66
15,18,7,21,5,9,12,0,0,87
15,18,7,21,9,12,0,0,0,82
15,18,7,21,12,15,21,19,0,128
15,18,8,1,13,23,15,15,4,112
15,18,25,0,0,0,0,0,0,58
15,18,9,1,0,0,0,0,0,43
15,18,9,1,12,0,0,0,0,55
15,18,9,1,14,19,0,0,0,76
15,18,9,2,1,20,9,4,0,78
15,18,9,2,1,20,9,4,19,97
15,18,9,2,9,0,0,0,0,53
15,18,9,2,9,19,0,0,0,72
15,18,9,3,8,1,12,3,0,69
15,18,9,3,8,1,12,3,8,77
15,18,9,3,25,3,12,5,0,90
15,18,9,3,15,14,9,3,0,86
15,18,25,3,20,9,3,19,0,112
15,18,9,5,12,19,0,0,0,78
15,18,9,5,14,3,25,0,0,89
15,18,9,5,14,20,1,12,19,113
15,18,9,5,14,20,1,20,5,107
15,18,9,5,14,20,5,4,0,90
15,18,9,5,14,20,5,18,0,104
15,18,9,5,14,20,9,14,7,111
15,18,9,5,14,20,9,20,5,115
15,18,9,5,14,20,9,26,5,121
15,18,9,5,14,20,12,25,0,118
15,18,9,5,14,20,19,0,0,100
15,18,9,6,1,3,9,1,12,74
15,18,9,6,9,3,5,0,0,65
15,18,9,6,9,3,5,19,0,84
15,18,9,6,9,3,9,1,12,82
15,18,9,6,12,1,13,2,0,76
15,18,9,6,12,1,13,13,5,92
15,18,9,6,15,18,13,0,0,94
15,18,9,7,0,0,0,0,0,49
15,18,9,7,1,13,9,0,0,72
15,18,9,7,1,13,9,19,0,91
15,18,9,7,1,14,0,0,0,64
15,18,9,7,1,14,19,0,0,83
15,18,9,7,1,14,21,13,19,117
15,18,9,7,9,14,0,0,0,72
15,18,9,7,9,14,1,12,0,85
15,18,9,7,9,14,1,12,19,104
15,18,9,7,9,14,1,14,20,107
15,18,9,7,9,14,1,18,25,116
15,18,9,7,9,14,1,20,5,98
15,18,9,7,9,14,5,19,0,96
15,18,9,7,9,14,9,19,20,120
15,18,9,7,9,14,19,0,0,91
15,18,9,7,14,1,12,0,0,76
15,18,9,8,15,14,0,0,0,79
15,18,9,12,12,9,15,14,0,104
15,18,9,12,12,15,14,0,0,95
15,18,9,14,1,19,1,12,0,89
15,18,9,14,1,19,1,12,19,108
15,18,9,15,12,5,19,0,0,93
15,18,9,15,21,19,0,0,0,97
15,18,9,19,15,14,0,0,0,90
15,18,9,19,15,14,19,0,0,109
15,18,9,19,16,8,5,18,5,113
15,18,25,19,19,9,4,0,0,109
15,18,9,19,20,9,3,0,0,93
15,18,9,21,13,0,0,0,0,76
15,18,25,24,5,19,0,0,0,106
15,18,25,26,1,14,9,14,0,122
15,18,25,26,1,14,9,14,5,127
15,18,25,26,5,14,9,14,0,126
15,18,11,5,25,0,0,0,0,74
15,18,12,0,0,0,0,0,0,45
15,18,12,1,7,5,0,0,0,58
15,18,12,5,0,0,0,0,0,50
15,18,12,5,19,0,0,0,0,69
15,18,12,5,20,0,0,0,0,70
15,18,12,5,23,1,25,19,0,118
15,18,12,5,23,9,19,5,0,106
15,18,12,15,0,0,0,0,0,60
15,18,12,15,16,0,0,0,0,76
15,18,12,15,16,19,0,0,0,95
15,18,12,15,19,0,0,0,0,79
15,18,13,5,18,0,0,0,0,69
15,18,13,5,18,19,0,0,0,88
15,18,13,15,12,21,0,0,0,94
15,18,13,15,12,21,19,0,0,113
15,18,13,21,26,9,14,5,0,121
15,18,14,1,13,5,14,20,0,100
15,18,14,1,13,5,14,20,19,119
15,18,14,1,18,25,0,0,0,91
15,18,14,1,20,5,0,0,0,73
15,18,14,1,20,5,12,25,0,110
15,18,14,1,20,9,15,14,0,106
15,18,14,1,20,21,18,5,0,112
15,18,14,5,18,25,0,0,0,95
15,18,14,5,18,9,5,18,0,102
15,18,14,5,18,9,5,19,20,123
15,18,14,5,18,9,12,25,0,116
15,18,14,5,19,0,0,0,0,71
15,18,14,9,6,25,0,0,0,87
15,18,14,9,19,0,0,0,0,75
15,18,14,9,19,3,15,16,25,134
15,18,14,9,20,8,0,0,0,84
15,18,14,9,20,8,5,19,0,108
15,18,14,9,20,8,9,3,0,96
15,18,14,9,20,8,9,14,5,112
15,18,14,9,20,8,15,9,4,112
15,18,14,9,20,8,15,12,0,111
15,18,14,9,20,8,15,14,0,113
15,18,14,15,9,20,5,0,0,96
15,18,15,1,14,1,12,0,0,76
15,18,15,3,18,1,20,9,3,102
15,18,15,7,5,14,0,0,0,74
15,18,15,7,5,14,5,19,25,123
15,18,15,7,5,14,25,0,0,99
15,18,15,7,5,14,9,3,0,86
15,18,15,7,5,14,9,5,19,107
15,18,15,7,18,1,16,8,0,98
15,18,15,7,18,1,16,8,25,123
15,18,15,9,4,5,0,0,0,66
15,18,15,9,4,5,19,0,0,85
15,18,15,12,15,7,25,0,0,107
15,18,15,12,15,7,9,5,19,115
15,18,15,12,15,7,9,19,20,130
15,18,15,13,5,20,5,18,0,109
15,18,15,13,5,20,5,18,19,128
15,18,15,13,5,20,18,25,0,129
15,18,15,13,5,20,18,9,3,116
15,18,15,14,1,19,1,12,0,95
15,18,15,14,15,11,15,0,0,103
15,18,15,14,15,15,11,15,0,118
15,18,15,20,21,14,4,0,0,107
15,18,15,20,21,14,4,19,0,126
15,18,16,8,1,14,0,0,0,72
15,18,16,8,1,14,1,7,5,85
15,18,16,8,1,14,3,25,0,100
15,18,16,8,1,14,4,15,13,104
15,18,16,8,1,14,5,4,0,81
15,18,16,8,1,14,7,5,0,84
15,18,16,8,1,14,9,14,7,102
15,18,16,8,1,14,9,19,13,113
15,18,16,8,1,14,9,26,5,112
15,18,16,8,1,14,18,25,0,115
15,18,16,8,1,14,19,0,0,91
15,18,16,8,1,18,9,15,14,114
15,18,16,8,5,15,14,0,0,91
15,18,16,8,5,21,13,0,0,96
15,18,16,8,18,5,25,0,0,105
15,18,16,8,18,5,25,5,4,114
15,18,16,8,18,5,25,19,0,124
15,18,16,9,13,5,14,20,0,110
15,18,16,9,13,5,14,20,19,129
15,18,16,9,14,0,0,0,0,72
15,18,16,9,14,3,0,0,0,75
15,18,16,9,14,5,0,0,0,77
15,18,16,9,14,5,19,0,0,96
15,18,16,9,14,19,0,0,0,91
15,18,16,9,20,0,0,0,0,78
15,18,18,1,0,0,0,0,0,52
15,18,18,5,18,25,0,0,0,99
15,18,18,5,18,9,5,3,0,91
15,18,18,5,18,9,5,19,0,107
15,18,18,8,15,9,4,0,0,87
15,18,18,8,15,12,15,7,25,133
15,18,18,9,3,5,0,0,0,68
15,18,18,9,3,5,19,0,0,87
15,18,18,9,19,0,0,0,0,79
15,18,18,9,19,5,19,0,0,103
15,18,18,9,19,18,15,15,20,147
15,18,18,15,23,0,0,0,0,89
15,18,19,0,0,0,0,0,0,52
15,18,19,5,4,5,0,0,0,66
15,18,19,5,4,21,5,0,0,87
15,18,19,5,9,12,12,5,0,95
15,18,19,5,12,0,0,0,0,69
15,18,19,5,12,12,5,0,0,86
15,18,19,5,12,12,5,18,0,104
15,18,19,5,12,12,9,3,0,93
15,18,20,1,12,9,4,0,0,79
15,18,20,1,14,9,17,21,5,120
15,18,20,5,18,4,5,0,0,85
15,18,20,5,20,0,0,0,0,78
15,18,20,8,1,12,0,0,0,74
15,18,20,8,1,14,20,0,0,96
15,18,20,8,9,1,14,0,0,85
15,18,20,8,9,3,0,0,0,73
15,18,20,8,9,3,15,14,0,102
15,18,20,8,9,3,15,14,19,121
15,18,20,8,9,4,0,0,0,74
15,18,20,8,9,20,5,0,0,95
15,18,20,8,9,20,9,3,0,102
15,18,20,8,15,0,0,0,0,76
15,18,20,8,15,1,24,9,19,129
15,18,20,8,15,3,25,13,0,117
15,18,20,8,15,4,15,13,5,113
15,18,20,8,15,5,16,25,0,122
15,18,20,8,15,5,16,9,3,109
15,18,20,8,15,7,1,13,25,122
15,18,20,8,15,12,15,7,25,135
15,18,20,8,15,16,1,20,8,121
15,18,20,8,15,16,5,4,25,126
15,18,20,8,15,16,14,5,1,112
15,18,20,8,15,16,15,4,0,111
15,18,20,8,15,16,20,5,18,135
15,18,20,8,15,16,20,9,3,124
15,18,20,8,15,19,5,0,0,100
15,18,20,8,15,19,9,19,0,123
15,18,20,8,15,19,9,20,5,129
15,18,20,8,15,19,20,1,20,136
15,18,20,8,15,20,9,3,0,108
15,18,20,8,15,20,9,3,19,127
15,18,20,8,15,20,25,16,5,142
15,18,20,8,15,20,9,19,20,144
15,18,20,8,15,20,15,14,5,130
15,18,20,8,18,15,14,0,0,108
15,18,20,9,7,1,0,0,0,70
15,18,20,25,7,1,14,0,0,100
15,18,20,25,7,9,14,5,0,113
15,18,20,9,22,5,0,0,0,89
15,18,20,13,1,14,0,0,0,81
15,18,20,15,12,1,14,0,0,95
15,18,20,15,12,1,14,19,0,114
15,18,20,19,0,0,0,0,0,72
15,18,20,19,20,1,12,5,18,128
15,18,20,19,20,5,9,14,0,120
15,18,22,5,20,0,0,0,0,80
15,18,22,9,5,20,1,14,0,104
15,18,22,9,5,20,9,20,5,123
15,18,26,15,0,0,0,0,0,74
15,18,26,15,19,0,0,0,0,93
15,19,3,1,18,19,0,0,0,75
15,19,3,5,12,12,1,0,0,67
15,19,3,8,5,1,12,0,0,63
15,19,3,8,5,9,20,9,19,107
15,19,3,8,5,15,13,1,0,79
15,19,3,9,12,12,1,14,20,105
15,19,3,9,12,12,1,20,5,96
15,19,3,9,14,0,0,0,0,60
15,19,3,9,14,5,0,0,0,65
15,19,3,9,14,9,1,14,0,84
15,19,3,9,14,9,14,5,0,88
15,19,3,9,20,1,14,3,5,89
15,19,3,9,20,1,14,3,25,109
15,19,3,9,20,1,14,20,0,101
15,19,3,9,20,1,20,5,0,92
15,19,3,14,15,4,5,0,0,75
15,19,3,21,12,1,0,0,0,71
15,19,3,21,12,1,2,12,5,90
15,19,3,21,12,1,14,20,0,105
15,19,3,21,12,1,18,0,0,89
15,19,3,21,12,1,20,5,0,96
15,19,3,21,12,1,20,5,4,100
15,19,3,21,12,1,20,5,19,115
15,19,3,21,12,5,0,0,0,75
15,19,3,21,12,5,19,0,0,94
15,19,3,21,12,21,13,0,0,104
15,19,5,0,0,0,0,0,0,39
15,19,5,12,1,0,0,0,0,52
15,19,5,12,12,1,0,0,0,64
15,19,5,12,12,5,0,0,0,68
15,19,5,19,0,0,0,0,0,58
15,19,8,1,3,0,0,0,0,46
15,19,8,5,1,0,0,0,0,48
15,19,9,4,5,0,0,0,0,52
15,19,9,5,18,0,0,0,0,66
15,19,9,5,18,5,4,0,0,75
15,19,9,5,18,25,0,0,0,91
15,19,9,5,18,9,5,19,0,99
15,19,9,5,18,12,9,11,5,103
15,19,9,5,18,19,0,0,0,85
15,19,9,19,0,0,0,0,0,62
15,19,9,20,25,0,0,0,0,88
15,19,13,1,20,5,0,0,0,73
15,19,13,1,20,5,18,9,1,101
15,19,13,1,20,9,3,0,0,80
15,19,13,1,20,9,19,13,0,109
15,19,13,1,26,15,13,5,0,107
15,19,13,5,19,9,19,0,0,99
15,19,13,5,20,5,18,9,1,105
15,19,13,5,20,9,3,0,0,84
15,19,13,9,1,13,9,3,0,82
15,19,13,9,3,0,0,0,0,59
15,19,13,9,3,19,0,0,0,78
15,19,13,9,14,0,0,0,0,70
15,19,13,9,14,1,0,0,0,71
15,19,13,9,15,21,19,0,0,111
15,19,13,9,20,5,0,0,0,81
15,19,13,9,21,13,0,0,0,90
15,19,13,9,21,13,19,0,0,109
15,19,13,15,7,5,14,5,0,93
15,19,13,15,7,18,1,16,8,112
15,19,13,15,12,0,0,0,0,74
15,19,13,15,12,1,12,0,0,87
15,19,13,15,12,1,18,0,0,93
15,19,13,15,12,15,7,25,0,121
15,19,13,15,12,19,0,0,0,93
15,19,13,15,13,5,20,5,18,123
15,19,13,15,13,5,20,18,25,143
15,19,13,15,14,4,9,20,5,114
15,19,13,15,16,8,15,18,5,124
15,19,13,15,19,3,15,16,5,120
15,19,13,15,19,5,0,0,0,86
15,19,13,15,19,5,4,0,0,90
15,19,13,15,19,5,19,0,0,105
15,19,13,15,19,9,14,7,0,111
15,19,13,15,19,9,19,0,0,109
15,19,13,15,20,1,24,9,19,135
15,19,13,15,20,9,3,0,0,94
15,19,13,15,21,19,0,0,0,102
15,19,13,21,14,4,1,19,0,106
15,19,13,21,14,4,9,14,5,114
15,19,13,21,14,4,19,0,0,105
15,19,14,1,2,21,18,7,19,116
15,19,15,2,5,18,18,25,0,117
15,19,15,14,5,0,0,0,0,68
15,19,15,16,8,25,0,0,0,98
15,19,15,16,8,9,5,19,0,106
15,19,15,16,8,15,14,5,0,107
15,19,16,5,18,13,0,0,0,86
15,19,16,8,5,18,5,0,0,86
15,19,16,8,25,9,20,9,19,140
15,19,16,8,18,1,4,9,1,91
15,19,16,8,18,5,19,9,19,128
15,19,16,8,18,5,20,9,3,113
15,19,16,15,18,5,0,0,0,88
15,19,16,18,5,25,19,0,0,117
15,19,19,1,12,0,0,0,0,66
15,19,19,1,18,9,21,13,0,115
15,19,19,1,20,21,18,5,0,118
15,19,19,5,1,0,0,0,0,59
15,19,19,5,9,14,0,0,0,81
15,19,19,5,9,14,19,0,0,100
15,19,19,5,12,5,20,0,0,95
15,19,19,5,13,5,14,20,19,129
15,19,19,5,15,21,19,0,0,113
15,19,19,5,15,21,19,12,25,150
15,19,19,5,20,5,18,0,0,101
15,19,19,9,1,0,0,0,0,63
15,19,19,9,3,12,5,0,0,82
15,19,19,9,3,12,5,19,0,101
15,19,19,9,3,21,12,1,0,99
15,19,19,9,3,21,12,1,18,117
15,19,19,9,3,21,12,5,0,103
15,19,19,9,3,21,12,21,13,132
15,19,19,9,6,25,0,0,0,93
15,19,19,9,6,9,3,0,0,80
15,19,19,9,6,9,5,4,0,86
15,19,19,9,6,9,5,18,0,100
15,19,19,9,6,9,5,18,19,119
15,19,19,9,6,9,5,19,0,101
15,19,19,9,6,25,9,14,7,123
15,19,19,9,6,15,18,13,0,114
15,19,19,9,6,18,1,7,5,99
15,19,19,25,16,9,20,5,0,128
15,19,19,21,1,18,25,0,0,118
15,19,19,21,1,18,9,5,19,126
15,19,19,21,1,18,9,21,13,136
15,19,20,1,12,7,9,1,0,84
15,19,20,5,1,12,0,0,0,72
15,19,20,5,1,12,7,9,1,89
15,19,20,5,3,20,15,13,25,135
15,19,20,5,9,14,0,0,0,82
15,19,20,5,9,20,9,3,0,100
15,19,20,5,9,20,9,19,0,116
15,19,20,5,13,9,1,0,0,82
15,19,20,5,14,19,9,15,14,130
15,19,20,5,14,19,9,22,5,128
15,19,20,5,14,19,15,18,25,150
15,19,20,5,14,20,0,0,0,93
15,19,20,5,14,20,1,20,5,119
15,19,20,5,14,20,9,22,5,129
15,19,20,5,14,20,15,21,19,148
15,19,20,5,15,3,5,12,5,99
15,19,20,5,15,3,25,20,5,127
15,19,20,5,15,4,5,18,13,114
15,19,20,5,15,7,5,14,0,100
15,19,20,5,15,7,5,14,25,125
15,19,20,5,15,9,4,0,0,87
15,19,20,5,15,9,4,19,0,106
15,19,20,5,15,12,9,20,5,120
15,19,20,5,15,12,15,7,25,133
15,19,20,5,15,13,1,0,0,88
15,19,20,5,15,13,1,19,0,107
15,19,20,5,15,13,1,20,1,109
15,19,20,5,15,13,5,0,0,92
15,19,20,5,15,13,5,18,5,115
15,19,20,5,15,14,3,21,19,131
15,19,20,5,15,16,1,20,8,119
15,19,20,5,15,19,5,19,0,117
15,19,20,5,15,19,9,19,0,121
15,19,20,5,15,20,15,13,5,127
15,19,20,5,15,20,15,13,25,147
15,19,20,5,18,9,1,0,0,87
15,19,20,9,1,12,0,0,0,76
15,19,20,9,1,18,25,0,0,107
15,19,20,9,1,18,9,5,19,115
15,19,20,9,1,18,9,21,19,131
15,19,20,9,1,20,5,0,0,89
15,19,20,9,14,1,20,15,0,113
15,19,20,9,14,1,20,15,19,132
15,19,20,9,15,12,1,18,0,109
15,19,20,9,15,12,1,20,5,116
15,19,20,9,15,12,5,0,0,95
15,19,20,9,15,12,5,19,0,114
15,19,20,9,20,9,19,0,0,111
15,19,20,9,21,13,0,0,0,97
15,19,20,12,5,18,5,19,19,132
15,19,20,12,5,18,9,5,0,103
15,19,20,12,5,18,19,0,0,108
15,19,20,13,1,18,11,0,0,97
15,19,20,13,1,18,11,19,0,116
15,19,20,15,13,1,20,9,4,116
15,19,20,15,13,25,0,0,0,107
15,19,20,15,13,9,5,19,0,115
15,19,20,15,19,5,19,0,0,112
15,19,20,15,19,9,19,0,0,116
15,19,20,15,19,9,19,5,19,140
15,19,20,18,1,3,1,0,0,77
15,19,20,18,1,3,5,1,14,96
15,19,20,18,1,3,9,14,5,104
15,19,20,18,1,3,9,19,5,109
15,19,20,18,1,3,9,19,13,117
15,19,20,18,1,3,9,20,5,110
15,19,20,18,1,3,9,26,5,116
15,19,20,18,1,3,15,4,0,95
15,19,20,18,1,3,15,4,5,100
15,19,20,18,1,3,15,4,19,114
15,19,20,18,1,3,15,9,4,104
15,19,20,18,1,3,15,14,0,105
15,19,20,18,1,3,21,13,0,110
15,19,20,18,1,9,20,5,0,107
15,19,20,18,3,1,0,0,0,76
15,19,20,18,5,7,5,18,0,107
15,19,20,18,5,15,9,4,0,105
15,19,20,18,9,3,8,0,0,92
15,19,20,18,9,3,8,5,19,116
15,19,20,18,9,14,7,5,18,125
15,19,20,19,9,19,0,0,0,101
15,19,20,19,9,19,5,19,0,125
15,19,21,12,12,9,22,1,14,125
15,20,5,0,0,0,0,0,0,40
15,20,5,3,20,15,13,25,0,116
15,20,5,12,3,15,19,9,19,117
15,20,8,5,18,4,15,13,0,98
15,20,8,5,18,5,19,20,0,110
15,20,8,5,18,8,15,23,0,112
15,20,8,5,18,9,19,13,0,107
15,20,8,5,18,9,19,20,0,114
15,20,8,5,18,14,5,19,19,123
15,20,8,5,18,19,0,0,0,85
15,20,8,5,18,19,15,13,5,118
15,20,8,5,18,20,9,13,5,113
15,20,8,5,18,23,1,25,19,134
15,20,8,5,18,23,9,19,5,122
15,20,8,25,7,18,15,13,1,122
15,20,8,13,1,14,25,0,0,96
15,20,9,1,14,20,0,0,0,79
15,20,9,1,20,18,25,0,0,108
15,20,9,1,20,18,9,3,0,95
15,20,9,1,20,18,9,3,19,114
15,20,9,3,0,0,0,0,0,47
15,20,9,4,9,1,0,0,0,58
15,20,9,4,9,6,15,18,13,109
15,20,9,4,9,14,5,0,0,76
15,20,9,4,9,21,13,0,0,91
15,20,9,15,19,5,0,0,0,83
15,20,9,15,19,5,12,25,0,120
15,20,9,15,19,9,20,25,0,132
15,20,9,20,9,3,0,0,0,76
15,20,9,20,9,4,5,19,0,101
15,20,9,20,9,19,0,0,0,92
15,20,9,21,13,0,0,0,0,78
15,20,11,15,14,0,0,0,0,75
15,20,15,3,25,19,20,0,0,117
15,20,15,3,25,19,20,9,3,129
15,20,15,3,25,19,20,19,0,136
15,20,15,3,15,14,9,1,0,92
15,20,15,3,15,14,9,1,12,104
15,20,15,3,15,14,9,20,5,116
15,20,15,3,15,14,9,21,13,125
15,20,15,3,18,1,14,5,0,91
15,20,15,3,18,1,14,9,3,98
15,20,15,4,25,14,9,1,0,103
15,20,15,4,25,14,9,3,0,105
15,20,15,7,5,14,9,3,0,88
15,20,15,7,5,14,15,21,19,131
15,20,15,7,18,1,16,8,25,125
15,20,15,12,9,20,5,0,0,96
15,20,15,12,9,20,8,0,0,99
15,20,15,12,9,20,8,9,3,111
15,20,15,12,9,20,8,19,0,118
15,20,15,12,9,20,9,3,0,103
15,20,15,12,15,7,25,0,0,109
15,20,15,12,15,7,9,3,0,96
15,20,15,12,15,7,9,5,19,117
15,20,15,12,15,7,9,19,20,132
15,20,15,13,25,3,5,19,0,115
15,20,15,16,1,20,8,25,0,120
15,20,15,16,1,20,8,9,3,107
15,20,15,16,8,15,14,5,0,108
15,20,15,16,9,5,19,9,19,127
15,20,15,16,25,15,19,9,19,153
15,20,15,16,12,1,19,20,25,143
15,20,15,18,18,8,5,1,0,100
15,20,15,18,18,8,15,5,1,115
15,20,15,19,3,15,16,5,0,108
15,20,15,19,3,15,16,5,19,127
15,20,15,19,3,15,16,25,0,128
15,20,15,19,3,15,16,9,3,115
15,20,15,19,9,19,0,0,0,97
15,20,15,19,20,5,1,12,0,107
15,20,15,19,20,5,15,14,0,123
15,20,15,20,15,9,0,0,0,94
15,20,15,20,15,13,25,0,0,123
15,20,15,20,15,24,9,3,0,121
15,20,20,1,18,0,0,0,0,74
15,20,20,1,18,19,0,0,0,93
15,20,20,1,22,1,0,0,0,79
15,20,20,1,22,1,19,0,0,98
15,20,20,1,22,5,0,0,0,83
15,20,20,1,22,9,14,15,0,116
15,20,20,1,23,1,19,0,0,99
15,20,20,5,18,5,18,0,0,101
15,20,20,5,18,19,0,0,0,97
15,20,20,5,20,20,15,0,0,115
15,20,20,9,14,7,11,1,18,115
15,20,20,15,19,0,0,0,0,89
15,20,20,18,5,12,9,6,5,110
15,20,20,18,5,12,9,20,5,124
15,20,20,18,15,25,5,0,0,118
15,20,21,18,9,1,0,0,0,84
15,20,24,9,0,0,0,0,0,68
15,21,2,12,9,1,14,3,5,82
15,21,2,12,9,5,20,0,0,84
15,21,2,12,9,5,20,20,5,109
15,21,3,8,0,0,0,0,0,47
15,21,3,8,5,4,0,0,0,56
15,21,3,8,5,19,0,0,0,71
15,21,3,8,9,14,7,0,0,77
15,21,4,0,0,0,0,0,0,40
15,21,4,5,14,1,18,4,5,87
15,21,4,19,0,0,0,0,0,59
15,21,5,14,9,20,5,0,0,89
15,21,6,0,0,0,0,0,0,42
15,21,6,15,21,7,8,20,0,113
15,21,7,8,0,0,0,0,0,51
15,21,7,8,20,0,0,0,0,71
15,21,7,8,20,5,4,0,0,80
15,21,7,8,20,9,14,7,0,101
15,21,7,8,20,12,9,14,19,125
15,21,7,8,20,14,5,19,19,128
15,21,7,8,20,14,20,0,0,105
15,21,7,8,20,19,0,0,0,90
15,21,7,21,9,25,1,0,0,99
15,21,9,0,0,0,0,0,0,45
15,21,25,5,26,4,0,0,0,96
15,21,9,19,20,9,20,9,0,122
15,21,9,19,20,9,20,9,19,141
15,21,11,9,1,0,0,0,0,57
15,21,12,1,16,0,0,0,0,65
15,21,14,3,5,0,0,0,0,58
15,21,14,3,5,19,0,0,0,77
15,21,14,4,25,0,0,0,0,79
15,21,14,4,9,14,7,0,0,84
15,21,14,4,19,0,0,0,0,73
15,21,16,8,0,0,0,0,0,60
15,21,16,8,5,0,0,0,0,65
15,21,16,8,5,19,0,0,0,84
15,21,16,8,9,19,8,0,0,96
15,21,16,8,19,0,0,0,0,79
15,21,18,0,0,0,0,0,0,54
15,21,18,1,12,9,0,0,0,76
15,21,18,1,14,7,0,0,0,76
15,21,18,1,14,7,19,0,0,95
15,21,18,1,18,9,0,0,0,82
15,21,18,1,18,9,19,0,0,101
15,21,18,5,2,9,0,0,0,70
15,21,18,5,2,9,19,0,0,89
15,21,18,9,3,21,18,25,0,130
15,21,18,9,5,0,0,0,0,68
15,21,18,14,0,0,0,0,0,68
15,21,18,15,21,2,0,0,0,92
15,21,18,19,0,0,0,0,0,73
15,21,18,19,5,12,0,0,0,90
15,21,18,19,5,12,6,0,0,96
15,21,18,19,5,12,19,0,0,109
15,21,18,19,5,12,22,5,19,136
15,21,19,0,0,0,0,0,0,55
15,21,19,5,12,0,0,0,0,72
15,21,19,5,12,19,0,0,0,91
15,21,19,9,1,0,0,0,0,65
15,21,19,20,0,0,0,0,0,75
15,21,19,20,5,4,0,0,0,84
15,21,19,20,5,5,0,0,0,85
15,21,19,20,5,18,0,0,0,98
15,21,19,20,5,18,19,0,0,117
15,21,19,20,9,14,7,0,0,105
15,21,19,20,9,20,9,0,0,113
15,21,19,20,19,0,0,0,0,94
15,21,20,0,0,0,0,0,0,56
15,21,20,1,3,20,0,0,0,80
15,21,20,1,3,20,5,4,0,89
15,21,20,1,3,20,9,14,7,110
15,21,20,1,3,20,19,0,0,99
15,21,20,1,4,4,0,0,0,65
15,21,20,1,4,4,5,4,0,74
15,21,20,1,4,4,9,14,7,95
15,21,20,1,4,4,19,0,0,84
15,21,20,1,7,5,0,0,0,69
15,21,20,1,7,5,19,0,0,88
15,21,20,1,13,2,21,19,8,120
15,21,20,1,18,4,5,0,0,84
15,21,20,1,18,7,21,5,0,108
15,21,20,1,18,7,21,5,4,112
15,21,20,1,18,7,21,5,19,127
15,21,20,1,19,0,0,0,0,76
15,21,20,1,19,9,7,8,20,120
15,21,20,1,19,11,0,0,0,87
15,21,20,1,19,11,5,4,0,96
15,21,20,1,19,11,9,14,7,117
15,21,20,1,19,11,19,0,0,106
15,21,20,1,20,5,0,0,0,82
15,21,20,1,23,5,0,0,0,85
15,21,20,1,23,5,4,0,0,89
15,21,20,1,23,9,14,7,0,110
15,21,20,2,1,2,2,12,5,80
15,21,20,2,1,3,11,0,0,73
15,21,20,2,1,3,11,5,18,96
15,21,20,2,1,3,11,19,0,92
15,21,20,2,1,4,5,0,0,68
15,21,20,2,1,11,5,0,0,75
15,21,20,2,1,11,5,4,0,79
15,21,20,2,1,11,5,19,0,94
15,21,20,2,1,11,9,14,7,100
15,21,20,2,1,14,0,0,0,73
15,21,20,2,1,14,14,5,4,96
15,21,20,2,1,14,20,5,18,116
15,21,20,2,1,18,0,0,0,77
15,21,20,2,1,18,11,0,0,88
15,21,20,2,1,18,11,5,4,97
15,21,20,2,1,18,11,19,0,107
15,21,20,2,1,18,18,5,4,104
15,21,20,2,1,18,20,5,18,120
15,21,20,2,1,20,0,0,0,79
15,21,20,2,1,20,20,5,4,108
15,21,20,2,1,20,20,5,18,122
15,21,20,2,1,23,12,0,0,94
15,21,20,2,1,23,12,5,4,103
15,21,20,2,1,23,12,19,0,113
15,21,20,2,2,12,5,4,0,81
15,21,20,2,2,18,5,4,0,87
15,21,20,2,5,1,13,0,0,77
15,21,20,2,5,1,13,5,4,86
15,21,20,2,5,1,13,19,0,96
15,21,20,2,5,1,18,0,0,82
15,21,20,2,5,7,0,0,0,70
15,21,20,2,5,7,7,1,18,96
15,21,20,2,5,7,7,5,4,86
15,21,20,2,5,7,19,0,0,89
15,21,20,2,5,12,3,8,0,86
15,21,20,2,5,12,12,15,23,125
15,21,20,2,5,14,4,0,0,81
15,21,20,2,5,14,20,0,0,97
15,21,20,2,5,20,20,5,18,126
15,21,20,2,25,0,0,0,0,83
15,21,20,2,9,4,0,0,0,71
15,21,20,2,9,4,4,5,14,94
15,21,20,2,9,4,4,5,18,98
15,21,20,2,9,4,19,0,0,90
15,21,20,2,25,5,0,0,0,88
15,21,20,2,9,18,20,8,0,113
15,21,20,2,9,20,3,8,0,98
15,21,20,2,12,1,26,5,0,102
15,21,20,2,12,1,26,5,4,106
15,21,20,2,12,1,26,5,19,121
15,21,20,2,12,5,1,20,0,96
15,21,20,2,12,5,1,20,19,115
15,21,20,2,12,5,4,0,0,79
15,21,20,2,12,5,5,4,0,84
15,21,20,2,12,5,19,19,0,113
15,21,20,2,12,5,23,0,0,98
15,21,20,2,12,15,15,13,0,113
15,21,20,2,12,15,15,13,19,132
15,21,20,2,12,15,20,0,0,105
15,21,20,2,12,15,23,0,0,108
15,21,20,2,12,15,23,14,0,122
15,21,20,2,12,21,6,6,0,103
15,21,20,2,12,21,6,6,19,122
15,21,20,2,12,21,19,8,0,118
15,21,20,2,15,1,18,4,0,96
15,21,20,2,15,1,18,4,19,115
15,21,20,2,15,1,19,20,0,113
15,21,20,2,15,1,19,20,19,132
15,21,20,2,15,14,4,0,0,91
15,21,20,2,15,15,11,0,0,99
15,21,20,2,15,18,5,0,0,96
15,21,20,2,15,18,14,0,0,105
15,21,20,2,15,18,14,5,0,110
15,21,20,2,15,21,14,4,0,112
15,21,20,2,15,21,14,4,19,131
15,21,20,2,15,23,0,0,0,96
15,21,20,2,15,23,5,4,0,105
15,21,20,2,15,23,12,0,0,108
15,21,20,2,15,24,0,0,0,97
15,21,20,2,15,24,5,4,0,106
15,21,20,2,15,24,5,19,0,121
15,21,20,2,15,24,9,14,7,127
15,21,20,2,18,1,7,0,0,84
15,21,20,2,18,1,7,19,0,103
15,21,20,2,18,1,25,0,0,102
15,21,20,2,18,1,9,4,0,90
15,21,20,2,18,1,14,3,8,102
15,21,20,2,18,1,22,5,0,104
15,21,20,2,18,1,22,5,4,108
15,21,20,2,18,1,22,5,19,123
15,21,20,2,18,1,23,12,0,112
15,21,20,2,18,1,26,5,14,122
15,21,20,2,18,5,1,11,0,93
15,21,20,2,18,5,1,11,19,112
15,21,20,2,18,5,1,20,8,110
15,21,20,2,18,5,4,0,0,85
15,21,20,2,18,5,5,4,0,90
15,21,20,2,18,5,5,4,19,109
15,21,20,2,18,9,2,5,0,92
15,21,20,2,18,9,2,5,4,96
15,21,20,2,18,9,2,5,19,111
15,21,20,2,18,9,4,7,5,101
15,21,20,2,18,9,14,7,0,106
15,21,20,2,21,4,0,0,0,83
15,21,20,2,21,4,4,5,4,96
15,21,20,2,21,25,0,0,0,104
15,21,20,2,21,9,12,4,0,104
15,21,20,2,21,9,12,4,19,123
15,21,20,2,21,9,12,20,0,120
15,21,20,2,21,12,7,5,0,103
15,21,20,2,21,12,7,5,4,107
15,21,20,2,21,12,11,0,0,102
15,21,20,2,21,12,11,19,0,121
15,21,20,2,21,12,12,25,0,128
15,21,20,2,21,18,14,0,0,111
15,21,20,2,21,18,14,5,4,120
15,21,20,2,21,18,14,19,0,130
15,21,20,2,21,18,14,20,0,131
15,21,20,2,21,18,19,20,0,136
15,21,20,2,21,18,19,20,19,155
15,21,20,2,21,19,20,12,5,135
15,21,20,2,21,26,26,0,0,131
15,21,20,3,1,13,5,0,0,78
15,21,20,3,1,14,20,0,0,94
15,21,20,3,1,16,5,18,0,99
15,21,20,3,1,16,5,18,19,118
15,21,20,3,1,18,15,12,0,105
15,21,20,3,1,18,18,25,0,121
15,21,20,3,1,19,5,0,0,84
15,21,20,3,1,19,20,0,0,99
15,21,20,3,1,19,20,5,0,104
15,21,20,3,1,19,20,5,4,108
15,21,20,3,1,19,20,5,19,123
15,21,20,3,1,19,20,19,0,118
15,21,20,3,1,20,3,8,0,91
15,21,20,3,1,21,7,8,20,116
15,21,20,3,1,22,9,12,0,103
15,21,20,3,1,22,9,12,19,122
15,21,20,3,5,16,20,0,0,100
15,21,20,3,8,1,18,13,0,99
15,21,20,3,8,1,18,13,19,118
15,21,20,3,8,1,19,5,0,92
15,21,20,3,8,1,19,5,4,96
15,21,20,3,8,5,1,20,0,93
15,21,20,3,8,5,1,20,19,112
15,21,20,3,8,9,4,0,0,80
15,21,20,3,8,9,4,5,0,85
15,21,20,3,8,9,4,5,4,89
15,21,20,3,8,9,4,5,19,104
15,21,20,3,9,20,25,0,0,113
15,21,20,3,9,20,9,5,19,121
15,21,20,3,12,1,13,15,18,118
15,21,20,3,12,1,19,19,0,110
15,21,20,3,12,5,18,11,0,105
15,21,20,3,12,9,13,2,0,95
15,21,20,3,12,9,13,2,19,114
15,21,20,3,12,15,13,2,0,101
15,21,20,3,15,1,3,8,0,86
15,21,20,3,15,13,5,0,0,92
15,21,20,3,15,13,5,18,0,110
15,21,20,3,15,13,5,19,0,111
15,21,20,3,15,13,9,14,7,117
15,21,20,3,15,15,11,0,0,100
15,21,20,3,15,15,11,5,4,109
15,21,20,3,15,15,11,19,0,119
15,21,20,3,15,18,14,5,18,129
15,21,20,3,15,21,14,20,0,129
15,21,20,3,15,21,18,20,0,133
15,21,20,3,18,1,23,12,0,113
15,21,20,3,18,1,23,12,19,132
15,21,20,3,18,5,5,16,0,103
15,21,20,3,18,5,16,20,0,118
15,21,20,3,18,25,0,0,0,102
15,21,20,3,18,9,5,4,0,95
15,21,20,3,18,9,5,18,0,109
15,21,20,3,18,9,5,19,0,110
15,21,20,3,18,25,9,14,7,132
15,21,20,3,18,15,16,0,0,108
15,21,20,3,18,15,16,19,0,127
15,21,20,3,18,15,19,19,0,130
15,21,20,3,18,15,23,0,0,115
15,21,20,3,18,15,23,4,0,119
15,21,20,3,18,15,23,5,4,124
15,21,20,3,18,15,23,19,0,134
15,21,20,3,21,12,12,0,0,104
15,21,20,3,21,18,5,0,0,103
15,21,20,3,21,18,5,4,0,107
15,21,20,3,21,18,9,14,7,128
15,21,20,3,21,18,19,5,0,122
15,21,20,3,21,18,19,5,4,126
15,21,20,3,21,18,19,5,19,141
15,21,20,3,21,18,22,5,0,125
15,21,20,3,21,18,22,5,4,129
15,21,20,3,21,18,22,5,19,144
15,21,20,3,21,20,0,0,0,100
15,21,20,4,1,14,3,5,0,83
15,21,20,4,1,14,3,5,4,87
15,21,20,4,1,14,3,5,19,102
15,21,20,4,1,18,5,0,0,84
15,21,20,4,1,18,5,4,0,88
15,21,20,4,1,18,5,19,0,103
15,21,20,4,1,18,9,14,7,109
15,21,20,4,1,20,5,0,0,86
15,21,20,4,1,20,5,4,0,90
15,21,20,4,1,20,5,19,0,105
15,21,20,4,1,20,9,14,7,111
15,21,20,4,1,26,26,12,5,130
15,21,20,4,5,22,9,12,0,108
15,21,20,4,9,4,0,0,0,73
15,21,20,4,15,0,0,0,0,75
15,21,20,4,15,4,7,5,0,91
15,21,20,4,15,4,7,5,4,95
15,21,20,4,15,4,7,5,19,110
15,21,20,4,15,5,18,0,0,98
15,21,20,4,15,5,18,19,0,117
15,21,20,4,15,5,19,0,0,99
15,21,20,4,15,9,14,7,0,105
15,21,20,4,15,14,5,0,0,94
15,21,20,4,15,15,18,0,0,108
15,21,20,4,15,15,18,19,0,127
15,21,20,4,15,15,18,19,25,152
15,21,20,4,18,1,6,20,0,105
15,21,20,4,18,1,7,0,0,86
15,21,20,4,18,1,7,15,14,115
15,21,20,4,18,1,7,19,0,105
15,21,20,4,18,1,14,11,0,104
15,21,20,4,18,1,23,0,0,102
15,21,20,4,18,1,23,14,0,116
15,21,20,4,18,1,23,19,0,121
15,21,20,4,18,5,1,13,0,97
15,21,20,4,18,5,1,13,19,116
15,21,20,4,18,5,1,13,20,117
15,21,20,4,18,5,19,19,0,121
15,21,20,4,18,5,23,0,0,106
15,21,20,4,18,9,14,11,0,112
15,21,20,4,18,9,14,11,19,131
15,21,20,4,18,9,22,5,0,114
15,21,20,4,18,9,22,5,14,128
15,21,20,4,18,9,22,5,19,133
15,21,20,4,18,15,16,0,0,109
15,21,20,4,18,15,16,19,0,128
15,21,20,4,18,15,22,5,0,120
15,21,20,4,18,21,14,11,0,124
15,21,20,4,21,5,12,0,0,98
15,21,20,4,21,5,12,19,0,117
15,21,20,4,21,18,5,0,0,104
15,21,20,4,23,5,12,12,0,112
15,21,20,4,23,5,12,20,0,120
15,21,20,5,1,18,14,0,0,94
15,21,20,5,1,18,14,19,0,113
15,21,20,5,1,20,0,0,0,82
15,21,20,5,1,20,5,0,0,87
15,21,20,5,1,20,5,14,0,101
15,21,20,5,1,20,9,14,7,112
15,21,20,5,1,20,19,0,0,101
15,21,20,5,3,8,15,0,0,87
15,21,20,5,3,8,15,5,4,96
15,21,20,5,3,8,15,5,19,111
15,21,20,5,3,8,15,19,0,106
15,21,20,5,4,0,0,0,0,65
15,21,20,5,4,7,5,0,0,77
15,21,20,5,4,7,5,4,0,81
15,21,20,5,4,7,9,14,7,102
15,21,20,5,25,5,0,0,0,91
15,21,20,5,25,5,4,0,0,95
15,21,20,5,14,0,0,0,0,75
15,21,20,5,18,3,15,1,20,118
15,21,20,5,18,12,25,0,0,116
15,21,20,5,18,13,15,19,20,146
15,21,20,5,18,14,5,19,19,136
15,21,20,5,18,19,0,0,0,98
15,21,20,5,18,23,5,1,18,126
15,21,20,6,1,2,12,5,0,82
15,21,20,6,1,2,12,5,4,86
15,21,20,6,1,2,12,5,19,101
15,21,20,6,1,3,5,0,0,71
15,21,20,6,1,3,5,4,0,75
15,21,20,6,1,3,5,19,0,90
15,21,20,6,1,3,9,14,7,96
15,21,20,6,1,12,12,0,0,87
15,21,20,6,1,12,12,19,0,106
15,21,20,6,1,13,5,0,0,81
15,21,20,6,1,13,5,4,0,85
15,21,20,6,1,13,9,14,7,106
15,21,20,6,1,19,20,0,0,102
15,21,20,6,1,19,20,5,4,111
15,21,20,6,1,19,20,19,0,121
15,21,20,6,1,23,14,0,0,100
15,21,20,6,1,23,14,5,4,109
15,21,20,6,1,23,14,19,0,119
15,21,20,6,5,1,19,20,0,107
15,21,20,6,5,1,19,20,19,126
15,21,20,6,5,1,20,0,0,88
15,21,20,6,5,4,0,0,0,71
15,21,20,6,5,5,4,0,0,76
15,21,20,6,5,5,12,0,0,84
15,21,20,6,5,5,12,19,0,103
15,21,20,6,5,12,20,0,0,99
15,21,20,6,5,14,3,5,0,89
15,21,20,6,5,14,3,5,4,93
15,21,20,6,5,18,18,5,20,128
15,21,20,6,6,5,4,0,0,77
15,21,20,6,9,5,12,4,0,92
15,21,20,6,9,5,12,4,19,111
15,21,20,6,9,7,8,20,0,106
15,21,20,6,9,7,8,20,19,125
15,21,20,6,9,7,21,18,5,122
15,21,20,6,9,14,4,0,0,89
15,21,20,6,9,14,4,19,0,108
15,21,20,6,9,18,5,0,0,94
15,21,20,6,9,18,5,4,0,98
15,21,20,6,9,18,5,19,0,113
15,21,20,6,9,18,9,14,7,119
15,21,20,6,9,19,8,0,0,98
15,21,20,6,9,20,0,0,0,91
15,21,20,6,9,20,19,0,0,110
15,21,20,6,9,20,20,5,4,120
15,21,20,6,9,20,20,5,18,134
15,21,20,6,12,1,13,5,0,93
15,21,20,6,12,1,13,5,4,97
15,21,20,6,12,1,14,11,0,100
15,21,20,6,12,1,14,11,19,119
15,21,20,6,12,1,18,5,0,98
15,21,20,6,12,1,18,5,4,102
15,21,20,6,12,1,19,8,0,102
15,21,20,6,12,5,4,0,0,83
15,21,20,6,12,5,5,0,0,84
15,21,20,6,12,5,23,0,0,102
15,21,20,6,12,25,0,0,0,99
15,21,20,6,12,9,5,19,0,107
15,21,20,6,12,25,9,14,7,129
15,21,20,6,12,9,14,7,0,104
15,21,20,6,12,15,1,20,0,110
15,21,20,6,12,15,23,0,0,112
15,21,20,6,12,15,23,5,4,121
15,21,20,6,12,15,23,14,0,126
15,21,20,6,12,15,23,19,0,131
15,21,20,6,12,21,5,0,0,100
15,21,20,6,12,21,14,7,0,116
15,21,20,6,12,21,14,11,25,145
15,21,20,6,12,21,19,8,0,122
15,21,20,6,12,21,24,0,0,119
15,21,20,6,15,12,4,0,0,93
15,21,20,6,15,15,12,0,0,104
15,21,20,6,15,15,12,5,4,113
15,21,20,6,15,15,12,19,0,123
15,21,20,6,15,15,20,0,0,112
15,21,20,6,15,15,20,5,4,121
15,21,20,6,15,15,20,19,0,131
15,21,20,6,15,18,13,0,0,108
15,21,20,6,15,18,20,0,0,115
15,21,20,6,15,18,20,8,0,123
15,21,20,6,15,21,7,8,20,133
15,21,20,6,15,21,14,4,0,116
15,21,20,6,15,24,0,0,0,101
15,21,20,6,15,24,5,4,0,110
15,21,20,6,15,24,5,19,0,125
15,21,20,6,15,24,9,14,7,131
15,21,20,6,18,15,14,20,0,129
15,21,20,6,18,15,20,8,0,123
15,21,20,6,18,15,23,14,0,132
15,21,20,6,18,15,23,14,19,151
15,21,20,7,1,2,2,12,5,85
15,21,20,7,1,9,14,0,0,87
15,21,20,7,1,9,14,5,4,96
15,21,20,7,1,9,14,19,0,106
15,21,20,7,1,12,12,15,16,119
15,21,20,7,1,13,2,12,5,96
15,21,20,7,1,13,5,0,0,82
15,21,20,7,1,13,5,4,0,86
15,21,20,7,1,13,9,14,7,107
15,21,20,7,1,14,7,0,0,85
15,21,20,7,1,18,20,8,0,110
15,21,20,7,1,19,0,0,0,83
15,21,20,7,1,19,19,5,4,111
15,21,20,7,1,19,19,5,19,126
15,21,20,7,1,20,5,0,0,89
15,21,20,7,1,21,7,5,0,97
15,21,20,7,1,22,5,0,0,91
15,21,20,7,1,26,5,0,0,95
15,21,20,7,1,26,5,4,0,99
15,21,20,7,1,26,9,14,7,120
15,21,20,7,9,22,5,0,0,99
15,21,20,7,9,22,5,14,0,113
15,21,20,7,9,22,5,19,0,118
15,21,20,7,9,22,9,14,7,124
15,21,20,7,12,1,4,0,0,80
15,21,20,7,12,1,18,5,0,99
15,21,20,7,12,1,18,5,4,103
15,21,20,7,12,1,18,5,19,118
15,21,20,7,12,5,1,13,0,94
15,21,20,7,12,15,15,13,0,118
15,21,20,7,12,15,23,0,0,113
15,21,20,7,12,15,23,5,4,122
15,21,20,7,12,15,23,19,0,132
15,21,20,7,14,1,23,0,0,101
15,21,20,7,14,1,23,5,4,110
15,21,20,7,14,1,23,14,0,115
15,21,20,7,14,1,23,19,0,120
15,21,20,7,15,0,0,0,0,78
15,21,20,7,15,5,18,0,0,101
15,21,20,7,15,5,19,0,0,102
15,21,20,7,15,9,14,7,0,108
15,21,20,7,15,9,14,7,19,127
15,21,20,7,15,14,5,0,0,97
15,21,20,7,18,5,5,14,0,105
15,21,20,7,18,5,23,0,0,109
15,21,20,7,18,9,14,0,0,104
15,21,20,7,18,9,14,19,0,123
15,21,20,7,18,15,19,19,0,134
15,21,20,7,18,15,21,14,4,135
15,21,20,7,18,15,21,16,0,133
15,21,20,7,18,15,21,16,19,152
15,21,20,7,18,15,23,0,0,119
15,21,20,7,18,15,23,14,0,133
15,21,20,7,18,15,23,19,0,138
15,21,20,7,18,15,23,20,8,147
15,21,20,7,21,1,18,4,0,107
15,21,20,7,21,5,19,19,0,127
15,21,20,7,21,9,4,5,0,102
15,21,20,7,21,9,4,5,4,106
15,21,20,7,21,9,4,5,19,121
15,21,20,7,21,14,0,0,0,98
15,21,20,7,21,14,14,5,4,121
15,21,20,7,21,14,19,0,0,117
15,21,20,7,21,19,8,0,0,111
15,21,20,7,21,19,8,5,19,135
15,21,20,8,1,13,13,5,18,114
15,21,20,8,1,19,20,5,14,123
15,21,20,8,1,21,12,0,0,98
15,21,20,8,1,21,12,5,18,121
15,21,20,8,1,21,12,19,0,117
15,21,20,8,5,1,18,0,0,88
15,21,20,8,5,1,18,4,0,92
15,21,20,8,5,1,18,19,0,107
15,21,20,8,5,1,18,20,0,108
15,21,20,8,5,3,20,15,18,125
15,21,20,8,5,5,12,0,0,86
15,21,20,8,5,18,0,0,0,87
15,21,20,8,25,13,14,0,0,116
15,21,20,8,9,18,5,0,0,96
15,21,20,8,9,18,5,4,0,100
15,21,20,8,9,18,9,14,7,121
15,21,20,8,9,19,19,0,0,111
15,21,20,8,9,20,0,0,0,93
15,21,20,8,9,20,19,0,0,112
15,21,20,8,15,12,4,0,0,95
15,21,20,8,15,13,5,18,0,115
15,21,20,8,15,18,14,0,0,111
15,21,20,8,15,18,18,15,18,148
15,21,20,8,15,21,19,5,0,124
15,21,20,8,15,21,19,5,19,143
15,21,20,8,15,23,12,0,0,114
15,21,20,8,15,23,12,5,4,123
15,21,20,8,15,23,12,19,0,133
15,21,20,8,21,5,0,0,0,90
15,21,20,8,21,13,15,18,0,131
15,21,20,8,21,13,15,18,19,150
15,21,20,8,21,14,20,0,0,119
15,21,20,8,21,14,20,19,0,138
15,21,20,8,21,18,12,0,0,115
15,21,20,8,21,20,0,0,0,105
15,21,20,25,1,18,4,0,0,104
15,21,20,25,5,12,12,0,0,110
15,21,20,25,5,12,12,5,4,119
15,21,20,25,5,12,12,19,0,129
15,21,20,25,5,12,16,0,0,114
15,21,20,25,5,12,16,5,4,123
15,21,20,25,5,12,16,19,0,133
15,21,20,25,9,5,12,4,0,111
15,21,20,25,9,5,12,4,19,130
15,21,20,9,13,1,7,5,0,91
15,21,20,9,14,7,19,0,0,105
15,21,20,9,14,22,5,14,20,140
15,21,20,9,19,8,0,0,0,92
15,21,20,9,19,19,21,5,0,129
15,21,20,9,19,19,21,5,4,133
15,21,20,10,1,26,26,0,0,119
15,21,20,10,5,19,20,0,0,110
15,21,20,10,5,20,0,0,0,91
15,21,20,10,5,20,20,5,4,120
15,21,20,10,9,14,24,0,0,113
15,21,20,10,9,14,24,5,4,122
15,21,20,10,9,14,24,5,19,137
15,21,20,10,15,3,11,5,25,125
15,21,20,10,21,7,7,12,5,118
15,21,20,10,21,13,16,0,0,116
15,21,20,10,21,13,16,5,4,125
15,21,20,10,21,13,16,19,0,135
15,21,20,10,21,20,0,0,0,107
15,21,20,10,21,20,19,0,0,126
15,21,20,10,21,20,20,5,4,136
15,21,20,11,5,5,16,0,0,93
15,21,20,11,5,5,16,5,18,116
15,21,20,11,5,5,16,19,0,112
15,21,20,11,5,16,20,0,0,108
15,21,20,11,9,3,11,0,0,90
15,21,20,11,9,3,11,5,4,99
15,21,20,11,9,3,11,19,0,109
15,21,20,11,9,12,12,0,0,100
15,21,20,11,9,12,12,19,0,119
15,21,20,11,9,14,7,0,0,97
15,21,20,11,9,19,19,0,0,114
15,21,20,11,9,19,19,5,4,123
15,21,20,11,9,19,19,5,19,138
15,21,20,11,14,1,22,5,0,109
15,21,20,11,14,5,5,0,0,91
15,21,20,12,1,2,15,18,0,104
15,21,20,12,1,25,0,0,0,94
15,21,20,12,1,9,4,0,0,82
15,21,20,12,1,25,9,14,7,124
15,21,20,12,1,9,14,0,0,92
15,21,20,12,1,25,19,0,0,113
15,21,20,12,1,14,3,5,0,91
15,21,20,12,1,14,3,5,4,95
15,21,20,12,1,14,4,0,0,87
15,21,20,12,1,14,4,5,18,110
15,21,20,12,1,14,4,19,0,106
15,21,20,12,1,19,8,0,0,96
15,21,20,12,1,19,20,0,0,108
15,21,20,12,1,19,20,5,4,117
15,21,20,12,1,19,20,19,0,127
15,21,20,12,1,21,7,8,0,105
15,21,20,12,1,21,7,8,19,124
15,21,20,12,1,21,14,3,8,115
15,21,20,12,1,23,5,4,0,101
15,21,20,12,1,23,9,14,7,122
15,21,20,12,1,23,18,25,0,135
15,21,20,12,1,23,19,0,0,111
15,21,20,12,5,1,4,0,0,78
15,21,20,12,5,1,14,0,0,88
15,21,20,12,5,1,16,0,0,90
15,21,20,12,5,1,16,5,4,99
15,21,20,12,5,1,16,19,0,109
15,21,20,12,5,1,16,20,0,110
15,21,20,12,5,1,18,14,0,106
15,21,20,12,5,1,18,14,19,125
15,21,20,12,5,1,18,14,20,126
15,21,20,12,5,4,0,0,0,77
15,21,20,12,5,7,5,14,4,103
15,21,20,12,5,14,7,20,8,122
15,21,20,12,5,18,0,0,0,91
15,21,20,12,5,20,0,0,0,93
15,21,20,12,5,20,19,0,0,112
15,21,20,12,25,0,0,0,0,93
15,21,20,12,9,5,0,0,0,82
15,21,20,12,9,5,18,0,0,100
15,21,20,12,9,5,18,19,0,119
15,21,20,12,9,5,19,0,0,101
15,21,20,12,9,7,7,5,18,114
15,21,20,12,25,9,14,7,0,123
15,21,20,12,9,13,2,0,0,92
15,21,20,12,9,13,14,0,0,104
15,21,20,12,9,14,5,0,0,96
15,21,20,12,9,14,5,1,18,115
15,21,20,12,9,14,5,4,0,100
15,21,20,12,9,14,5,18,0,114
15,21,20,12,9,14,5,19,0,115
15,21,20,12,9,14,7,5,18,121
15,21,20,12,9,14,9,14,7,121
15,21,20,12,9,16,0,0,0,93
15,21,20,12,9,16,16,5,4,118
15,21,20,12,9,22,5,0,0,104
15,21,20,12,9,22,5,4,0,108
15,21,20,12,9,22,5,18,0,122
15,21,20,12,9,22,5,18,19,141
15,21,20,12,9,22,5,19,0,123
15,21,20,12,9,22,9,14,7,129
15,21,20,12,12,5,4,0,0,89
15,21,20,12,15,15,11,5,18,132
15,21,20,12,15,15,11,19,0,128
15,21,20,12,15,16,5,0,0,104
15,21,20,12,15,18,4,0,0,105
15,21,20,12,15,20,0,0,0,103
15,21,20,12,15,22,5,0,0,110
15,21,20,12,15,22,5,4,0,114
15,21,20,12,15,22,5,19,0,129
15,21,20,12,15,22,9,14,7,135
15,21,20,12,21,14,7,0,0,110
15,21,20,12,21,19,20,5,18,151
15,21,20,13,1,7,9,3,0,89
15,21,20,13,1,14,0,0,0,84
15,21,20,13,1,14,14,5,4,107
15,21,20,13,1,14,19,0,0,103
15,21,20,13,1,14,20,12,5,121
15,21,20,13,1,18,3,8,0,99
15,21,20,13,1,18,18,25,0,131
15,21,20,13,1,19,20,5,18,132
15,21,20,13,1,20,3,8,0,101
15,21,20,13,1,20,5,0,0,95
15,21,20,13,1,20,5,4,0,99
15,21,20,13,1,20,9,14,7,120
15,21,20,13,5,14,0,0,0,88
15,21,20,13,15,4,5,0,0,93
15,21,20,13,15,4,5,4,0,97
15,21,20,13,15,4,5,19,0,112
15,21,20,13,15,4,9,14,7,118
15,21,20,13,15,19,20,0,0,123
15,21,20,13,15,21,14,20,0,139
15,21,20,13,15,21,20,8,0,133
15,21,20,13,15,22,5,0,0,111
15,21,20,13,15,22,5,4,0,115
15,21,20,13,15,22,5,19,0,130
15,21,20,13,15,22,9,14,7,136
15,21,20,14,1,13,5,0,0,89
15,21,20,14,5,19,19,0,0,113
15,21,20,14,9,7,8,20,0,114
15,21,20,14,15,9,19,5,0,118
15,21,20,14,15,15,11,0,0,111
15,21,20,14,21,13,2,5,18,129
15,21,20,15,6,6,9,3,5,100
15,21,20,15,22,5,14,0,0,112
15,21,20,16,1,3,5,0,0,81
15,21,20,16,1,3,5,4,0,85
15,21,20,16,1,3,5,19,0,100
15,21,20,16,1,3,9,14,7,106
15,21,20,16,1,7,5,0,0,85
15,21,20,16,1,25,0,0,0,98
15,21,20,16,1,9,14,20,0,116
15,21,20,16,1,9,14,20,19,135
15,21,20,16,1,18,9,19,8,127
15,21,20,16,1,18,20,0,0,111
15,21,20,16,1,18,20,19,0,130
15,21,20,16,1,19,19,0,0,111
15,21,20,16,1,19,19,5,4,120
15,21,20,16,1,19,19,5,19,135
15,21,20,16,1,20,8,0,0,101
15,21,20,16,5,1,12,0,0,90
15,21,20,16,5,5,16,0,0,98
15,21,20,16,5,5,18,0,0,100
15,21,20,16,5,15,16,12,5,125
15,21,20,16,9,3,11,0,0,95
15,21,20,16,9,3,11,5,20,120
15,21,20,16,9,16,5,0,0,102
15,21,20,16,9,16,5,4,0,106
15,21,20,16,9,16,9,14,7,127
15,21,20,16,9,20,3,8,0,112
15,21,20,16,9,20,25,0,0,126
15,21,20,16,9,20,9,5,4,119
15,21,20,16,9,20,9,5,19,134
15,21,20,16,12,1,3,5,0,93
15,21,20,16,12,1,25,0,0,110
15,21,20,16,12,1,25,5,4,119
15,21,20,16,12,1,25,19,0,129
15,21,20,16,12,1,14,0,0,99
15,21,20,16,12,1,14,19,0,118
15,21,20,16,12,5,1,19,5,114
15,21,20,16,12,15,4,0,0,103
15,21,20,16,12,15,4,19,0,122
15,21,20,16,12,15,20,0,0,119
15,21,20,16,12,15,20,19,0,138
15,21,20,16,15,9,14,20,0,130
15,21,20,16,15,9,14,20,19,149
15,21,20,16,15,9,19,5,0,120
15,21,20,16,15,9,19,15,14,144
15,21,20,16,15,12,12,0,0,111
15,21,20,16,15,12,12,5,4,120
15,21,20,16,15,12,12,19,0,130
15,21,20,16,15,13,16,0,0,116
15,21,20,16,15,16,0,0,0,103
15,21,20,16,15,16,16,5,4,128
15,21,20,16,15,18,3,8,0,116
15,21,20,16,15,18,20,0,0,125
15,21,20,16,15,18,20,5,18,148
15,21,20,16,15,18,20,19,0,144
15,21,20,16,15,19,20,0,0,126
15,21,20,16,15,19,20,19,0,145
15,21,20,16,15,21,18,0,0,126
15,21,20,16,15,21,18,5,4,135
15,21,20,16,15,21,18,5,18,149
15,21,20,16,15,21,18,19,0,145
15,21,20,16,18,1,25,0,0,116
15,21,20,16,18,1,25,5,4,125
15,21,20,16,18,1,25,19,0,135
15,21,20,16,18,1,9,19,5,124
15,21,20,16,18,5,1,3,8,107
15,21,20,16,18,5,5,14,0,114
15,21,20,16,18,5,5,14,19,133
15,21,20,16,18,5,19,19,0,133
15,21,20,16,18,25,0,0,0,115
15,21,20,16,18,9,3,5,0,107
15,21,20,16,18,9,3,5,4,111
15,21,20,16,18,9,3,5,19,126
15,21,20,16,18,9,5,4,0,108
15,21,20,16,18,25,9,14,7,145
15,21,20,16,21,12,12,0,0,117
15,21,20,16,21,12,12,5,4,126
15,21,20,16,21,12,12,19,0,136
15,21,20,16,21,14,3,8,0,118
15,21,20,16,21,16,9,12,0,130
15,21,20,16,21,18,12,0,0,123
15,21,20,16,21,18,19,5,0,135
15,21,20,16,21,18,19,21,5,156
15,21,20,16,21,19,8,0,0,120
15,21,20,16,21,19,8,5,4,129
15,21,20,16,21,19,8,5,19,144
15,21,20,16,21,20,0,0,0,113
15,21,20,16,21,20,19,0,0,132
15,21,20,16,21,20,20,5,4,142
15,21,20,16,21,20,20,5,18,156
15,21,20,17,21,1,6,6,0,107
15,21,20,17,21,5,5,14,0,118
15,21,20,17,21,5,18,25,0,142
15,21,20,17,21,15,20,5,0,134
15,21,20,17,21,15,20,5,4,138
15,21,20,17,21,15,20,5,19,153
15,21,20,18,0,0,0,0,0,74
15,21,20,18,1,3,5,0,0,83
15,21,20,18,1,3,5,4,0,87
15,21,20,18,1,3,5,19,0,102
15,21,20,18,1,3,9,14,7,108
15,21,20,18,1,7,5,0,0,87
15,21,20,18,1,7,5,4,0,91
15,21,20,18,1,7,5,12,25,124
15,21,20,18,1,7,5,18,0,105
15,21,20,18,1,7,5,19,0,106
15,21,20,18,1,7,9,14,7,112
15,21,20,18,1,25,0,0,0,100
15,21,20,18,1,9,12,0,0,96
15,21,20,18,1,9,19,5,0,108
15,21,20,18,1,9,19,5,4,112
15,21,20,18,1,9,19,5,19,127
15,21,20,18,1,11,5,0,0,91
15,21,20,18,1,14,0,0,0,89
15,21,20,18,1,14,3,5,0,97
15,21,20,18,1,14,3,5,19,116
15,21,20,18,1,14,7,0,0,96
15,21,20,18,1,14,7,5,0,101
15,21,20,18,1,14,7,5,4,105
15,21,20,18,1,14,7,5,19,120
15,21,20,18,1,14,11,0,0,100
15,21,20,18,1,14,11,5,4,109
15,21,20,18,1,14,11,19,0,119
15,21,20,18,1,14,20,0,0,109
15,21,20,18,1,16,0,0,0,91
15,21,20,18,1,16,16,5,4,116
15,21,20,18,1,20,5,0,0,100
15,21,20,18,1,20,5,4,0,104
15,21,20,18,1,20,5,19,0,119
15,21,20,18,1,20,9,14,7,125
15,21,20,18,1,21,7,8,20,131
15,21,20,18,1,22,5,0,0,102
15,21,20,18,1,22,5,4,0,106
15,21,20,18,1,22,5,19,0,121
15,21,20,18,1,22,9,14,7,127
15,21,20,18,1,26,5,0,0,106
15,21,20,18,5,0,0,0,0,79
15,21,20,18,5,1,3,8,0,91
15,21,20,18,5,1,4,0,0,84
15,21,20,18,5,1,4,19,0,103
15,21,20,18,5,1,19,15,14,128
15,21,20,18,5,3,11,15,14,122
15,21,20,18,5,4,4,5,14,106
15,21,20,18,5,4,5,0,0,88
15,21,20,18,5,9,7,14,0,109
15,21,20,18,5,12,9,5,6,111
15,21,20,18,5,13,5,18,0,115
15,21,20,18,5,14,5,19,19,136
15,21,20,18,8,25,13,5,0,125
15,21,20,18,8,25,13,5,4,129
15,21,20,18,9,2,0,0,0,85
15,21,20,18,9,2,2,5,4,96
15,21,20,18,9,3,11,0,0,97
15,21,20,18,9,4,4,5,14,110
15,21,20,18,9,4,5,0,0,92
15,21,20,18,9,4,5,18,0,110
15,21,20,18,9,4,5,18,19,129
15,21,20,18,9,4,5,19,0,111
15,21,20,18,9,4,9,14,7,117
15,21,20,18,9,7,0,0,0,90
15,21,20,18,9,7,7,5,4,106
15,21,20,18,9,7,7,5,18,120
15,21,20,18,9,7,8,20,0,118
15,21,20,18,9,14,7,0,0,104
15,21,20,18,9,14,7,19,0,123
15,21,20,18,9,22,1,12,0,118
15,21,20,18,9,22,1,12,19,137
15,21,20,18,9,22,5,0,0,110
15,21,20,18,15,1,4,0,0,94
15,21,20,18,15,1,18,0,0,108
15,21,20,18,15,1,18,5,4,117
15,21,20,18,15,1,18,19,0,127
15,21,20,18,15,3,11,0,0,103
15,21,20,18,15,3,11,5,4,112
15,21,20,18,15,3,11,19,0,122
15,21,20,18,15,4,5,0,0,98
15,21,20,18,15,7,21,5,0,122
15,21,20,18,15,7,21,5,4,126
15,21,20,18,15,25,1,12,0,127
15,21,20,18,15,12,12,0,0,113
15,21,20,18,15,12,12,5,4,122
15,21,20,18,15,12,12,19,0,132
15,21,20,18,15,15,16,0,0,120
15,21,20,18,15,15,16,5,18,143
15,21,20,18,15,15,20,0,0,124
15,21,20,18,15,15,20,5,4,133
15,21,20,18,15,15,20,19,0,143
15,21,20,18,15,22,5,0,0,116
15,21,20,18,15,22,5,4,0,120
15,21,20,18,15,22,9,14,7,141
15,21,20,18,15,23,0,0,0,112
15,21,20,18,15,23,5,4,0,121
15,21,20,18,15,23,19,0,0,131
15,21,20,18,21,14,0,0,0,109
15,21,20,18,21,14,7,0,0,116
15,21,20,18,21,14,14,5,18,146
15,21,20,18,21,14,19,0,0,128
15,21,20,18,21,19,8,0,0,122
15,21,20,18,21,19,8,5,19,146
15,21,20,19,0,0,0,0,0,75
15,21,20,19,1,25,0,0,0,101
15,21,20,19,1,9,4,0,0,89
15,21,20,19,1,25,9,14,7,131
15,21,20,19,1,9,12,0,0,97
15,21,20,19,1,9,12,5,4,106
15,21,20,19,1,9,12,19,0,116
15,21,20,19,1,9,14,20,0,119
15,21,20,19,1,12,12,25,0,125
15,21,20,19,1,14,7,0,0,97
15,21,20,19,1,20,0,0,0,96
15,21,20,19,1,22,15,18,0,131
15,21,20,19,1,22,15,18,19,150
15,21,20,19,1,23,0,0,0,99
15,21,20,19,3,1,16,5,0,100
15,21,20,19,3,5,14,20,0,117
15,21,20,19,3,15,12,4,0,109
15,21,20,19,3,15,12,4,19,128
15,21,20,19,3,15,15,16,0,124
15,21,20,19,3,15,18,5,0,116
15,21,20,19,3,15,18,5,4,120
15,21,20,19,3,15,18,5,19,135
15,21,20,19,3,15,18,14,0,125
15,21,20,19,3,15,18,14,19,144
15,21,20,19,3,15,21,18,0,132
15,21,20,19,3,15,21,20,0,134
15,21,20,19,3,18,5,1,13,115
15,21,20,19,5,1,0,0,0,81
15,21,20,19,5,1,13,0,0,94
15,21,20,19,5,1,18,3,8,110
15,21,20,19,5,5,0,0,0,85
15,21,20,19,5,5,9,14,7,115
15,21,20,19,5,5,11,0,0,96
15,21,20,19,5,5,14,0,0,99
15,21,20,19,5,5,19,0,0,104
15,21,20,19,5,12,12,0,0,104
15,21,20,19,5,12,12,19,0,123
15,21,20,19,5,14,4,0,0,98
15,21,20,19,5,14,20,18,25,157
15,21,20,19,5,18,20,0,0,118
15,21,20,19,5,18,20,19,0,137
15,21,20,19,5,18,22,5,0,125
15,21,20,19,5,18,22,5,4,129
15,21,20,19,5,18,22,5,19,144
15,21,20,19,5,20,0,0,0,100
15,21,20,19,5,20,19,0,0,119
15,21,20,19,8,1,4,15,23,126
15,21,20,19,8,1,11,5,0,100
15,21,20,19,8,1,13,5,0,102
15,21,20,19,8,1,13,5,4,106
15,21,20,19,8,1,13,5,19,121
15,21,20,19,8,1,16,5,0,105
15,21,20,19,8,1,16,5,4,109
15,21,20,19,8,1,18,16,0,118
15,21,20,19,8,9,6,20,0,118
15,21,20,19,8,9,6,20,19,137
15,21,20,19,8,9,14,5,0,111
15,21,20,19,8,9,14,5,4,115
15,21,20,19,8,9,14,5,18,129
15,21,20,19,8,9,14,5,19,130
15,21,20,19,8,15,14,5,0,117
15,21,20,19,8,15,15,20,0,133
15,21,20,19,8,15,15,20,19,152
15,21,20,19,8,15,20,0,0,118
15,21,20,19,8,15,21,20,0,139
15,21,20,19,8,15,21,20,19,158
15,21,20,19,8,15,22,5,0,125
15,21,20,19,8,15,22,5,4,129
15,21,20,19,8,15,23,0,0,121
15,21,20,19,8,15,23,5,4,130
15,21,20,19,8,15,23,5,18,144
15,21,20,19,8,15,23,14,0,135
15,21,20,19,8,18,9,5,11,126
15,21,20,19,8,18,9,12,12,134
15,21,20,19,8,21,20,0,0,124
15,21,20,19,9,4,5,0,0,93
15,21,20,19,9,4,5,4,0,97
15,21,20,19,9,4,5,18,0,111
15,21,20,19,9,4,5,18,19,130
15,21,20,19,9,4,5,19,0,112
15,21,20,19,9,6,20,0,0,110
15,21,20,19,9,7,8,0,0,99
15,21,20,19,9,7,8,20,0,119
15,21,20,19,9,7,8,20,19,138
15,21,20,19,9,14,0,0,0,98
15,21,20,19,9,14,7,0,0,105
15,21,20,19,9,14,7,19,0,124
15,21,20,19,9,14,14,5,4,121
15,21,20,19,9,14,19,0,0,117
15,21,20,19,9,20,0,0,0,104
15,21,20,19,9,20,19,0,0,123
15,21,20,19,9,26,5,0,0,115
15,21,20,19,9,26,5,4,0,119
15,21,20,19,9,26,5,19,0,134
15,21,20,19,11,1,20,5,0,112
15,21,20,19,11,9,12,12,0,119
15,21,20,19,11,9,16,0,0,111
15,21,20,19,11,9,18,20,0,133
15,21,20,19,11,9,18,20,19,152
15,21,20,19,12,1,14,7,0,109
15,21,20,19,12,5,5,16,0,113
15,21,20,19,12,5,5,16,19,132
15,21,20,19,12,5,16,20,0,128
15,21,20,19,12,9,3,11,0,110
15,21,20,19,12,9,4,0,0,100
15,21,20,19,12,9,4,5,0,105
15,21,20,19,12,9,14,7,0,117
15,21,20,19,12,9,14,11,0,121
15,21,20,19,12,9,16,0,0,112
15,21,20,19,13,1,18,20,0,127
15,21,20,19,13,1,18,20,19,146
15,21,20,19,13,5,12,12,0,117
15,21,20,19,13,9,12,5,0,114
15,21,20,19,13,9,12,5,4,118
15,21,20,19,13,9,12,5,19,133
15,21,20,19,13,15,11,5,0,119
15,21,20,19,13,15,11,5,4,123
15,21,20,19,13,15,11,5,19,138
15,21,20,19,14,1,20,3,8,121
15,21,20,19,14,15,18,5,0,127
15,21,20,19,14,15,18,5,4,131
15,21,20,19,14,15,18,5,19,146
15,21,20,19,15,1,18,0,0,109
15,21,20,19,15,1,18,5,4,118
15,21,20,19,15,1,18,19,0,128
15,21,20,19,15,12,4,0,0,106
15,21,20,19,15,12,5,0,0,107
15,21,20,19,15,12,5,18,0,125
15,21,20,19,15,12,5,19,0,126
15,21,20,19,15,14,5,20,0,129
15,21,20,19,15,14,14,5,20,143
15,21,20,19,15,21,7,8,20,146
15,21,20,19,15,21,14,4,0,129
15,21,20,19,16,1,14,0,0,106
15,21,20,19,16,1,14,19,0,125
15,21,20,19,16,1,20,0,0,112
15,21,20,19,16,5,1,11,0,108
15,21,20,19,16,5,1,11,19,127
15,21,20,19,16,5,4,0,0,100
15,21,20,19,16,5,5,3,8,112
15,21,20,19,16,5,5,4,0,105
15,21,20,19,16,5,12,12,0,120
15,21,20,19,16,5,12,12,19,139
15,21,20,19,16,5,12,20,0,128
15,21,20,19,16,5,14,4,0,114
15,21,20,19,16,5,14,4,19,133
15,21,20,19,16,5,14,20,0,130
15,21,20,19,16,25,0,0,0,116
15,21,20,19,16,9,5,4,0,109
15,21,20,19,16,25,9,14,7,146
15,21,20,19,16,9,12,12,0,124
15,21,20,19,16,9,14,0,0,114
15,21,20,19,16,9,18,9,20,147
15,21,20,19,16,9,20,0,0,120
15,21,20,19,16,15,11,5,0,122
15,21,20,19,16,15,11,5,14,136
15,21,20,19,16,15,18,20,0,144
15,21,20,19,16,15,21,20,0,147
15,21,20,19,16,18,1,14,7,131
15,21,20,19,16,18,5,1,4,119
15,21,20,19,16,18,9,14,7,139
15,21,20,19,16,18,9,14,20,152
15,21,20,19,16,18,21,5,0,135
15,21,20,19,16,18,21,5,4,139
15,21,20,19,16,21,5,0,0,117
15,21,20,19,16,21,18,14,0,144
15,21,20,19,16,21,18,20,0,150
15,21,20,19,20,1,25,0,0,121
15,21,20,19,20,1,9,4,0,109
15,21,20,19,20,1,25,5,4,130
15,21,20,19,20,1,9,18,0,123
15,21,20,19,20,1,25,19,0,140
15,21,20,19,20,1,14,4,0,114
15,21,20,19,20,1,14,4,19,133
15,21,20,19,20,1,14,11,0,121
15,21,20,19,20,1,18,5,0,119
15,21,20,19,20,1,18,5,4,123
15,21,20,19,20,1,18,5,19,138
15,21,20,19,20,1,18,20,0,134
15,21,20,19,20,1,18,20,19,153
15,21,20,19,20,1,20,5,0,121
15,21,20,19,20,1,20,5,4,125
15,21,20,19,20,1,20,5,18,139
15,21,20,19,20,1,20,5,19,140
15,21,20,19,20,5,1,12,0,113
15,21,20,19,20,5,1,13,0,114
15,21,20,19,20,5,5,18,0,123
15,21,20,19,20,5,5,18,19,142
15,21,20,19,20,5,16,0,0,116
15,21,20,19,20,9,14,7,0,125
15,21,20,19,20,9,14,11,0,129
15,21,20,19,20,15,12,5,0,127
15,21,20,19,20,15,12,5,14,141
15,21,20,19,20,15,15,4,0,129
15,21,20,19,20,15,18,13,0,141
15,21,20,19,20,18,1,9,14,137
15,21,20,19,20,18,5,1,13,132
15,21,20,19,20,18,5,5,20,143
15,21,20,19,20,18,9,4,5,131
15,21,20,19,20,18,9,11,5,138
15,21,20,19,20,18,9,16,0,138
15,21,20,19,20,18,9,16,19,157
15,21,20,19,20,18,9,22,5,149
15,21,20,19,20,18,15,4,5,137
15,21,20,19,20,18,15,11,5,144
15,21,20,19,20,18,15,22,5,155
15,21,20,19,20,18,21,3,11,148
15,21,20,19,20,18,21,20,0,154
15,21,20,19,20,21,4,25,0,145
15,21,20,19,20,21,14,7,0,137
15,21,20,19,20,21,14,20,0,150
15,21,20,19,20,21,14,20,19,169
15,21,20,19,21,2,20,12,5,135
15,21,20,19,21,3,11,0,0,110
15,21,20,19,21,3,11,5,14,129
15,21,20,19,21,6,6,5,18,131
15,21,20,19,21,9,20,15,18,158
15,21,20,19,21,12,11,0,0,119
15,21,20,19,21,12,11,5,4,128
15,21,20,19,21,12,11,19,0,138
15,21,20,19,21,13,0,0,0,109
15,21,20,19,21,13,13,5,4,131
15,21,20,19,21,14,7,0,0,117
15,21,20,19,23,1,13,0,0,112
15,21,20,19,23,1,18,5,0,122
15,21,20,19,23,1,18,13,0,130
15,21,20,19,23,5,1,18,0,122
15,21,20,19,23,5,1,18,19,141
15,21,20,19,23,5,5,16,0,124
15,21,20,19,23,5,12,12,0,127
15,21,20,19,23,9,6,20,0,133
15,21,20,19,23,9,13,0,0,120
15,21,20,19,23,9,13,19,0,139
15,21,20,19,23,9,14,7,0,128
15,21,20,19,23,9,18,12,0,137
15,21,20,19,23,15,18,5,0,136
15,21,20,19,23,15,18,14,0,145
15,21,20,19,23,21,13,0,0,132
15,21,20,19,23,21,14,7,0,140
15,21,20,20,1,11,5,0,0,93
15,21,20,20,1,11,5,14,0,107
15,21,20,20,1,11,5,19,0,112
15,21,20,20,1,12,5,14,20,128
15,21,20,20,1,12,11,0,0,100
15,21,20,20,1,12,11,5,4,109
15,21,20,20,1,12,11,19,0,119
15,21,20,20,1,19,11,0,0,107
15,21,20,20,1,19,11,5,4,116
15,21,20,20,1,19,11,19,0,126
15,21,20,20,1,19,20,5,0,121
15,21,20,20,5,1,18,0,0,100
15,21,20,20,5,1,19,5,0,106
15,21,20,20,5,1,19,5,4,110
15,21,20,20,5,12,12,0,0,105
15,21,20,20,5,12,12,19,0,124
15,21,20,20,8,1,14,11,0,110
15,21,20,20,8,1,14,11,19,129
15,21,20,20,8,9,5,22,5,125
15,21,20,20,8,9,14,11,0,118
15,21,20,20,8,9,14,11,19,137
15,21,20,20,8,18,5,23,0,130
15,21,20,20,8,18,15,2,0,119
15,21,20,20,8,18,15,2,19,138
15,21,20,20,8,18,15,23,0,140
15,21,20,20,8,18,15,23,14,154
15,21,20,20,8,18,15,23,19,159
15,21,20,20,8,18,21,19,20,162
15,21,20,20,8,23,1,3,11,122
15,21,20,20,9,14,11,12,5,127
15,21,20,20,9,18,5,0,0,108
15,21,20,20,9,18,5,4,0,112
15,21,20,20,9,18,9,14,7,133
15,21,20,20,15,9,12,0,0,112
15,21,20,20,15,12,4,0,0,107
15,21,20,20,15,14,7,21,5,138
15,21,20,20,15,16,0,0,0,107
15,21,20,20,15,16,16,5,4,132
15,21,20,20,15,18,5,0,0,114
15,21,20,20,15,18,14,0,0,123
15,21,20,20,15,23,5,18,0,137
15,21,20,20,15,23,5,18,19,156
15,21,20,20,18,1,4,5,0,104
15,21,20,20,18,1,4,5,4,108
15,21,20,20,18,1,4,5,19,123
15,21,20,20,18,1,9,12,0,116
15,21,20,20,18,1,22,5,12,134
15,21,20,20,18,9,3,11,0,117
15,21,20,20,18,9,3,11,19,136
15,21,20,20,18,15,20,0,0,129
15,21,20,20,18,15,20,19,0,148
15,21,20,20,18,21,13,16,0,144
15,21,20,20,18,21,13,16,19,163
15,21,20,20,20,15,18,5,0,134
15,21,20,20,20,15,18,14,0,143
15,21,20,20,21,18,14,0,0,129
15,21,20,20,21,18,14,5,4,138
15,21,20,20,21,18,14,19,0,148
15,21,20,20,23,9,14,5,0,127
15,21,20,21,19,21,18,5,0,140
15,21,20,22,1,12,21,5,0,117
15,21,20,22,1,12,21,5,4,121
15,21,20,22,1,12,21,5,19,136
15,21,20,22,1,14,9,19,8,129
15,21,20,22,1,21,14,20,0,134
15,21,20,22,1,21,14,20,19,153
15,21,20,22,5,12,22,5,20,142
15,21,20,22,5,14,15,13,0,125
15,21,20,22,9,3,20,15,18,143
15,21,20,22,9,5,0,0,0,92
15,21,20,22,9,5,4,0,0,96
15,21,20,22,9,5,18,0,0,110
15,21,20,22,9,5,19,0,0,111
15,21,20,22,9,7,9,12,0,115
15,21,20,22,25,9,14,7,0,133
15,21,20,22,15,25,1,7,5,131
15,21,20,22,15,9,3,5,0,110
15,21,20,22,15,9,3,5,4,114
15,21,20,22,15,9,3,5,19,129
15,21,20,22,15,20,5,0,0,118
15,21,20,22,15,20,5,4,0,122
15,21,20,22,15,20,5,18,0,136
15,21,20,22,15,20,5,19,0,137
15,21,20,22,15,20,9,14,7,143
15,21,20,23,1,25,0,0,0,105
15,21,20,23,1,9,20,0,0,109
15,21,20,23,1,9,20,5,4,118
15,21,20,23,1,9,20,19,0,128
15,21,20,23,1,11,5,0,0,96
15,21,20,23,1,12,5,0,0,97
15,21,20,23,1,12,11,0,0,103
15,21,20,23,1,12,11,5,4,112
15,21,20,23,1,12,11,19,0,122
15,21,20,23,1,12,12,0,0,104
15,21,20,23,1,12,12,15,16,135
15,21,20,23,1,14,4,5,18,121
15,21,20,23,1,18,0,0,0,98
15,21,20,23,1,18,2,12,5,117
15,21,20,23,1,18,4,0,0,102
15,21,20,23,1,18,4,12,25,139
15,21,20,23,1,18,4,19,0,121
15,21,20,23,1,18,18,5,4,125
15,21,20,23,1,18,19,0,0,117
15,21,20,23,1,19,8,0,0,107
15,21,20,23,1,19,8,5,19,131
15,21,20,23,1,19,20,5,0,124
15,21,20,23,1,19,20,5,4,128
15,21,20,23,1,19,20,5,19,143
15,21,20,23,1,20,3,8,0,111
15,21,20,23,1,20,5,18,0,123
15,21,20,23,1,22,5,0,0,107
15,21,20,23,1,22,5,4,0,111
15,21,20,23,1,22,9,14,7,132
15,21,20,23,5,1,12,20,8,125
15,21,20,23,5,1,16,15,14,130
15,21,20,23,5,1,18,0,0,103
15,21,20,23,5,1,18,25,0,128
15,21,20,23,5,1,18,19,0,122
15,21,20,23,5,1,22,5,0,112
15,21,20,23,5,5,4,0,0,93
15,21,20,23,5,5,16,0,0,105
15,21,20,23,5,5,16,19,0,124
15,21,20,23,5,9,7,8,0,108
15,21,20,23,5,9,7,8,19,127
15,21,20,23,5,9,7,8,20,128
15,21,20,23,5,12,12,0,0,108
15,21,20,23,5,14,20,0,0,118
15,21,20,23,5,16,20,0,0,120
15,21,20,23,8,9,18,12,0,126
15,21,20,23,8,9,18,12,19,145
15,21,20,23,9,3,11,0,0,102
15,21,20,23,9,7,7,12,5,119
15,21,20,23,9,12,5,0,0,105
15,21,20,23,9,12,5,4,0,109
15,21,20,23,9,12,5,19,0,124
15,21,20,23,9,12,9,14,7,130
15,21,20,23,9,12,12,0,0,112
15,21,20,23,9,12,12,5,4,121
15,21,20,23,9,12,12,19,0,131
15,21,20,23,9,14,0,0,0,102
15,21,20,23,9,14,4,0,0,106
15,21,20,23,9,14,4,5,4,115
15,21,20,23,9,14,4,15,23,144
15,21,20,23,9,14,4,19,0,125
15,21,20,23,9,14,7,0,0,109
15,21,20,23,9,19,8,0,0,115
15,21,20,23,9,19,8,5,4,124
15,21,20,23,9,19,8,5,19,139
15,21,20,23,9,20,0,0,0,108
15,21,20,23,9,20,8,0,0,116
15,21,20,23,9,20,19,0,0,127
15,21,20,23,9,20,20,1,12,141
15,21,20,23,9,20,20,5,4,137
15,21,20,23,9,20,20,5,18,151
15,21,20,23,15,5,0,0,0,99
15,21,20,23,15,13,1,14,0,122
15,21,20,23,15,15,4,0,0,113
15,21,20,23,15,18,4,0,0,116
15,21,20,23,15,18,5,0,0,117
15,21,20,23,15,18,11,0,0,123
15,21,20,23,15,18,11,5,4,132
15,21,20,23,15,18,11,5,18,146
15,21,20,23,15,18,11,19,0,142
15,21,20,23,15,18,12,4,0,128
15,21,20,23,15,18,14,0,0,126
15,21,20,23,15,18,20,8,0,140
15,21,20,23,15,22,5,0,0,121
15,21,20,23,15,22,5,14,0,135
15,21,20,23,18,5,14,3,8,127
15,21,20,23,18,5,19,20,0,141
15,21,20,23,18,9,14,7,0,127
15,21,20,23,18,9,20,0,0,126
15,21,20,23,18,9,20,5,0,131
15,21,20,23,18,9,20,5,19,150
15,21,20,23,18,15,20,5,0,137
15,21,20,23,18,21,14,7,0,139
15,21,20,23,23,5,16,20,0,143
15,21,20,23,23,15,22,5,0,144
15,21,20,23,23,15,22,5,14,158
15,21,20,26,1,14,25,0,0,122
15,21,22,5,18,20,0,0,0,101
15,21,22,5,18,20,5,0,0,106
15,21,22,18,1,7,5,0,0,89
15,21,22,18,5,0,0,0,0,81
15,21,22,18,9,5,18,0,0,108
15,21,22,18,9,5,18,5,0,113
15,21,26,5,0,0,0,0,0,67
15,21,26,5,12,0,0,0,0,79
15,21,26,5,12,19,0,0,0,98
15,21,26,15,0,0,0,0,0,77
15,21,26,15,19,0,0,0,0,96
15,22,5,25,0,0,0,0,0,67
15,22,5,14,0,0,0,0,0,56
15,22,5,14,2,9,18,4,0,89
15,22,5,14,2,9,18,4,19,108
15,22,5,14,4,18,25,0,0,103
15,22,5,14,5,4,0,0,0,65
15,22,5,14,6,21,12,0,0,95
15,22,5,14,9,14,7,0,0,86
15,22,5,14,12,25,0,0,0,93
15,22,5,14,12,9,11,5,0,93
15,22,5,14,13,1,14,0,0,84
15,22,5,14,13,5,14,0,0,88
15,22,5,14,16,5,5,12,0,94
15,22,5,14,19,0,0,0,0,75
15,22,5,14,19,13,1,14,0,103
15,22,5,14,19,20,15,14,5,129
15,22,5,14,23,1,18,5,0,103
15,22,5,14,23,1,18,5,19,122
15,22,5,14,23,9,19,5,0,112
15,22,5,14,23,15,15,4,0,113
15,22,5,18,0,0,0,0,0,60
15,22,5,18,1,2,12,5,0,80
15,22,5,18,1,2,12,25,0,100
15,22,5,18,1,2,21,19,5,108
15,22,5,18,1,3,20,0,0,84
15,22,5,18,1,3,20,5,4,93
15,22,5,18,1,3,20,19,0,103
15,22,5,18,1,3,21,20,5,110
15,22,5,18,1,4,15,18,14,112
15,22,5,18,1,7,5,0,0,73
15,22,5,18,1,7,5,19,0,92
15,22,5,18,1,12,12,0,0,85
15,22,5,18,1,12,12,5,4,94
15,22,5,18,1,12,12,19,0,104
15,22,5,18,1,14,7,18,25,125
15,22,5,18,1,16,20,0,0,97
15,22,5,18,1,16,20,12,25,134
15,22,5,18,1,18,3,8,0,90
15,22,5,18,1,18,7,21,5,112
15,22,5,18,1,18,13,0,0,92
15,22,5,18,1,20,5,0,0,86
15,22,5,18,1,23,5,0,0,89
15,22,5,18,1,23,5,4,0,93
15,22,5,18,1,23,5,19,0,108
15,22,5,18,1,23,6,21,12,123
15,22,5,18,1,23,9,14,7,114
15,22,5,18,1,23,14,0,0,98
15,22,5,18,2,1,4,5,0,72
15,22,5,18,2,1,9,20,0,92
15,22,5,18,2,1,11,5,0,79
15,22,5,18,2,1,11,5,4,83
15,22,5,18,2,1,11,5,19,98
15,22,5,18,2,1,12,13,0,88
15,22,5,18,2,1,14,4,25,106
15,22,5,18,2,1,14,11,0,88
15,22,5,18,2,1,18,0,0,81
15,22,5,18,2,1,18,11,0,92
15,22,5,18,2,1,19,5,0,87
15,22,5,18,2,2,15,18,5,102
15,22,5,18,2,2,18,5,4,91
15,22,5,18,2,5,1,18,0,86
15,22,5,18,2,5,1,18,19,105
15,22,5,18,2,5,1,20,0,88
15,22,5,18,2,5,4,0,0,71
15,22,5,18,2,5,14,4,0,85
15,22,5,18,2,5,18,7,0,92
15,22,5,18,2,5,20,0,0,87
15,22,5,18,2,5,20,19,0,106
15,22,5,18,2,25,0,0,0,87
15,22,5,18,2,9,1,19,0,91
15,22,5,18,2,9,4,0,0,75
15,22,5,18,2,9,4,5,0,80
15,22,5,18,2,9,4,19,0,94
15,22,5,18,2,9,7,0,0,78
15,22,5,18,2,9,12,12,0,95
15,22,5,18,2,9,20,0,0,91
15,22,5,18,2,9,20,5,0,96
15,22,5,18,2,9,20,5,19,115
15,22,5,18,2,12,1,3,11,89
15,22,5,18,2,12,1,13,5,93
15,22,5,18,2,12,1,26,5,106
15,22,5,18,2,12,5,23,0,102
15,22,5,18,2,12,9,14,4,101
15,22,5,18,2,12,15,15,13,117
15,22,5,18,2,12,15,23,0,112
15,22,5,18,2,12,15,23,14,126
15,22,5,18,2,12,15,23,19,131
15,22,5,18,2,15,1,18,4,100
15,22,5,18,2,15,1,19,20,117
15,22,5,18,2,15,4,25,0,106
15,22,5,18,2,15,9,12,0,98
15,22,5,18,2,15,12,4,0,93
15,22,5,18,2,15,15,11,0,103
15,22,5,18,2,15,15,11,19,122
15,22,5,18,2,15,15,20,0,112
15,22,5,18,2,15,18,5,0,100
15,22,5,18,2,15,18,14,0,109
15,22,5,18,2,15,18,14,5,114
15,22,5,18,2,15,21,14,4,116
15,22,5,18,2,15,23,0,0,100
15,22,5,18,2,15,23,5,4,109
15,22,5,18,2,15,23,12,0,112
15,22,5,18,2,18,1,3,5,89
15,22,5,18,2,18,1,7,0,88
15,22,5,18,2,18,1,25,0,106
15,22,5,18,2,18,1,11,5,97
15,22,5,18,2,18,1,22,5,108
15,22,5,18,2,18,5,1,11,97
15,22,5,18,2,18,5,4,0,89
15,22,5,18,2,18,5,5,4,94
15,22,5,18,2,18,9,2,5,96
15,22,5,18,2,18,9,13,0,102
15,22,5,18,2,18,15,1,4,100
15,22,5,18,2,18,15,9,12,116
15,22,5,18,2,18,15,15,4,114
15,22,5,18,2,18,15,23,0,118
15,22,5,18,2,18,15,23,14,132
15,22,5,18,2,18,21,19,8,128
15,22,5,18,2,21,25,0,0,108
15,22,5,18,2,21,9,12,4,108
15,22,5,18,2,21,9,12,20,124
15,22,5,18,2,21,25,19,0,127
15,22,5,18,2,21,12,11,0,106
15,22,5,18,2,21,12,11,25,131
15,22,5,18,2,21,18,14,0,115
15,22,5,18,2,21,18,14,20,135
15,22,5,18,2,21,18,19,20,140
15,22,5,18,2,21,19,25,0,127
15,22,5,18,3,1,12,12,0,88
15,22,5,18,3,1,12,12,19,107
15,22,5,18,3,1,13,5,0,82
15,22,5,18,3,1,14,14,25,117
15,22,5,18,3,1,16,0,0,80
15,22,5,18,3,1,16,5,0,85
15,22,5,18,3,1,18,4,0,86
15,22,5,18,3,1,18,5,0,87
15,22,5,18,3,1,18,18,25,125
15,22,5,18,3,1,19,20,0,103
15,22,5,18,3,1,19,20,19,122
15,22,5,18,3,1,20,3,8,95
15,22,5,18,3,8,1,6,5,83
15,22,5,18,3,8,1,14,20,106
15,22,5,18,3,8,1,19,5,96
15,22,5,18,3,8,5,1,16,93
15,22,5,18,3,8,5,3,11,90
15,22,5,18,3,8,9,5,6,91
15,22,5,18,3,8,9,12,12,104
15,22,5,18,3,8,15,11,5,102
15,22,5,18,3,9,22,9,12,115
15,22,5,18,3,12,1,9,13,98
15,22,5,18,3,12,1,19,16,111
15,22,5,18,3,12,5,1,14,95
15,22,5,18,3,12,9,13,2,99
15,22,5,18,3,12,15,1,11,102
15,22,5,18,3,12,15,7,0,97
15,22,5,18,3,12,15,25,0,115
15,22,5,18,3,12,15,19,5,114
15,22,5,18,3,12,15,21,4,115
15,22,5,18,3,15,1,20,0,99
15,22,5,18,3,15,1,20,19,118
15,22,5,18,3,15,25,0,0,103
15,22,5,18,3,15,9,12,0,99
15,22,5,18,3,15,25,12,25,140
15,22,5,18,3,15,12,4,0,94
15,22,5,18,3,15,12,15,18,123
15,22,5,18,3,15,13,5,0,96
15,22,5,18,3,15,13,5,18,114
15,22,5,18,3,15,13,5,19,115
15,22,5,18,3,15,15,11,0,104
15,22,5,18,3,15,15,11,19,123
15,22,5,18,3,15,15,12,0,105
15,22,5,18,3,15,15,12,19,124
15,22,5,18,3,15,21,14,20,133
15,22,5,18,3,15,22,5,18,123
15,22,5,18,3,15,23,0,0,101
15,22,5,18,3,18,1,13,0,95
15,22,5,18,3,18,1,13,19,114
15,22,5,18,3,18,5,5,4,95
15,22,5,18,3,18,5,5,16,107
15,22,5,18,3,18,25,0,0,106
15,22,5,18,3,18,15,16,0,112
15,22,5,18,3,18,15,16,19,131
15,22,5,18,3,18,15,19,19,134
15,22,5,18,3,18,15,23,0,119
15,22,5,18,3,18,15,23,4,123
15,22,5,18,3,18,15,23,14,133
15,22,5,18,3,18,21,19,20,141
15,22,5,18,3,21,12,12,0,108
15,22,5,18,3,21,16,0,0,100
15,22,5,18,3,21,18,5,0,107
15,22,5,18,3,21,18,5,4,111
15,22,5,18,3,21,18,12,0,114
15,22,5,18,3,21,20,0,0,104
15,22,5,18,4,1,13,14,0,92
15,22,5,18,4,1,14,3,5,87
15,22,5,18,4,1,18,5,0,88
15,22,5,18,4,1,18,5,4,92
15,22,5,18,4,1,18,5,19,107
15,22,5,18,4,1,19,8,0,92
15,22,5,18,4,1,20,5,4,94
15,22,5,18,4,1,26,5,4,100
15,22,5,18,4,5,1,12,0,82
15,22,5,18,4,5,1,18,0,88
15,22,5,18,4,5,3,11,0,83
15,22,5,18,4,5,3,11,19,102
15,22,5,18,4,5,5,16,0,90
15,22,5,18,4,5,14,0,0,83
15,22,5,18,4,9,4,0,0,77
15,22,5,18,4,25,5,0,0,94
15,22,5,18,4,25,5,4,0,98
15,22,5,18,4,25,5,18,0,112
15,22,5,18,4,25,5,19,0,113
15,22,5,18,4,25,9,14,7,119
15,22,5,18,4,15,0,0,0,79
15,22,5,18,4,15,5,18,0,102
15,22,5,18,4,15,5,18,19,121
15,22,5,18,4,15,5,19,0,103
15,22,5,18,4,15,9,14,7,109
15,22,5,18,4,15,13,5,0,97
15,22,5,18,4,15,14,5,0,98
15,22,5,18,4,15,15,18,0,112
15,22,5,18,4,15,19,5,0,103
15,22,5,18,4,15,19,5,4,107
15,22,5,18,4,15,19,5,19,122
15,22,5,18,4,15,21,2,20,122
15,22,5,18,4,15,26,5,0,110
15,22,5,18,4,15,26,5,4,114
15,22,5,18,4,18,1,6,20,109
15,22,5,18,4,18,1,9,14,106
15,22,5,18,4,18,1,14,11,108
15,22,5,18,4,18,1,16,5,104
15,22,5,18,4,18,1,23,0,106
15,22,5,18,4,18,1,23,14,120
15,22,5,18,4,18,1,23,19,125
15,22,5,18,4,18,5,1,13,101
15,22,5,18,4,18,5,19,19,125
15,22,5,18,4,18,5,23,0,110
15,22,5,18,4,18,25,0,0,107
15,22,5,18,4,18,9,5,4,100
15,22,5,18,4,18,9,12,25,128
15,22,5,18,4,18,9,14,11,116
15,22,5,18,4,18,9,16,0,107
15,22,5,18,4,18,9,22,5,118
15,22,5,18,4,18,15,15,16,128
15,22,5,18,4,18,15,22,5,124
15,22,5,18,4,18,21,14,11,128
15,22,5,18,4,21,2,0,0,87
15,22,5,18,4,21,2,19,0,106
15,22,5,18,4,21,5,0,0,90
15,22,5,18,4,21,18,5,0,108
15,22,5,18,4,21,19,20,0,124
15,22,5,18,5,1,7,5,18,96
15,22,5,18,5,1,18,12,25,121
15,22,5,18,5,1,19,25,0,110
15,22,5,18,5,1,20,0,0,86
15,22,5,18,5,1,20,5,0,91
15,22,5,18,5,1,20,5,14,105
15,22,5,18,5,1,20,5,18,109
15,22,5,18,5,1,20,19,0,105
15,22,5,18,5,4,0,0,0,69
15,22,5,18,5,4,7,5,0,81
15,22,5,18,5,4,9,20,0,98
15,22,5,18,5,7,7,0,0,79
15,22,5,18,5,25,5,0,0,95
15,22,5,18,5,25,5,4,0,99
15,22,5,18,5,25,9,14,7,120
15,22,5,18,5,12,1,20,5,103
15,22,5,18,5,13,16,20,25,139
15,22,5,18,5,14,20,5,18,122
15,22,5,18,5,14,20,18,25,142
15,22,5,18,5,17,21,1,12,116
15,22,5,18,5,17,21,9,16,128
15,22,5,18,5,19,20,0,0,104
15,22,5,18,5,24,5,18,20,132
15,22,5,18,6,1,3,5,0,75
15,22,5,18,6,1,7,0,0,74
15,22,5,18,6,1,9,14,20,110
15,22,5,18,6,1,9,20,8,104
15,22,5,18,6,1,12,12,0,91
15,22,5,18,6,1,13,5,4,89
15,22,5,18,6,1,14,3,25,109
15,22,5,18,6,1,18,0,0,85
15,22,5,18,6,1,19,20,0,106
15,22,5,18,6,1,20,0,0,87
15,22,5,18,6,1,21,12,20,120
15,22,5,18,6,1,22,15,18,122
15,22,5,18,6,5,1,18,0,90
15,22,5,18,6,5,1,18,19,109
15,22,5,18,6,5,1,19,20,111
15,22,5,18,6,5,4,0,0,75
15,22,5,18,6,5,5,0,0,76
15,22,5,18,6,5,5,4,0,80
15,22,5,18,6,5,5,4,19,99
15,22,5,18,6,5,5,12,0,88
15,22,5,18,6,5,12,12,0,95
15,22,5,18,6,5,12,15,14,112
15,22,5,18,6,5,23,0,0,94
15,22,5,18,6,9,12,5,0,92
15,22,5,18,6,9,12,12,0,99
15,22,5,18,6,9,12,12,19,118
15,22,5,18,6,9,12,13,0,100
15,22,5,18,6,9,14,5,0,94
15,22,5,18,6,9,19,8,0,102
15,22,5,18,6,9,20,0,0,95
15,22,5,18,6,9,24,0,0,99
15,22,5,18,6,12,1,16,0,95
15,22,5,18,6,12,1,20,0,99
15,22,5,18,6,12,5,23,0,106
15,22,5,18,6,12,25,0,0,103
15,22,5,18,6,12,9,5,19,111
15,22,5,18,6,12,9,14,7,108
15,22,5,18,6,12,15,1,20,114
15,22,5,18,6,12,15,7,0,100
15,22,5,18,6,12,15,15,4,112
15,22,5,18,6,12,15,21,18,132
15,22,5,18,6,12,15,23,0,116
15,22,5,18,6,12,15,23,14,130
15,22,5,18,6,12,15,23,19,135
15,22,5,18,6,12,21,19,8,126
15,22,5,18,6,15,12,4,0,97
15,22,5,18,6,15,14,4,0,99
15,22,5,18,6,15,15,20,0,116
15,22,5,18,6,15,18,3,5,107
15,22,5,18,6,15,21,12,0,114
15,22,5,18,6,18,1,9,12,106
15,22,5,18,6,18,1,14,11,110
15,22,5,18,6,18,5,5,0,94
15,22,5,18,6,18,5,20,0,109
15,22,5,18,6,18,15,20,8,127
15,22,5,18,6,18,15,23,14,136
15,22,5,18,6,21,12,12,0,111
15,22,5,18,6,21,14,4,0,105
15,22,5,18,7,1,14,7,0,89
15,22,5,18,7,1,26,5,0,99
15,22,5,18,7,5,20,0,0,92
15,22,5,18,7,9,12,4,0,92
15,22,5,18,7,9,12,4,19,111
15,22,5,18,7,9,12,20,0,108
15,22,5,18,7,9,18,4,0,98
15,22,5,18,7,9,18,4,19,117
15,22,5,18,7,9,18,20,0,114
15,22,5,18,7,9,22,5,0,103
15,22,5,18,7,12,1,4,0,84
15,22,5,18,7,12,1,19,19,118
15,22,5,18,7,12,1,26,5,111
15,22,5,18,7,12,9,4,5,97
15,22,5,18,7,12,9,14,20,122
15,22,5,18,7,12,15,15,13,122
15,22,5,18,7,12,15,19,19,132
15,22,5,18,7,12,21,20,0,120
15,22,5,18,7,15,0,0,0,82
15,22,5,18,7,15,1,4,0,87
15,22,5,18,7,15,1,4,19,106
15,22,5,18,7,15,4,0,0,86
15,22,5,18,7,15,4,12,25,123
15,22,5,18,7,15,9,14,7,112
15,22,5,18,7,15,14,5,0,101
15,22,5,18,7,15,15,4,0,101
15,22,5,18,7,15,18,7,5,112
15,22,5,18,7,15,20,0,0,102
15,22,5,18,7,15,23,14,0,119
15,22,5,18,7,18,1,3,5,94
15,22,5,18,7,18,1,4,5,95
15,22,5,18,7,18,1,9,14,109
15,22,5,18,7,18,1,26,5,117
15,22,5,18,7,18,5,1,20,111
15,22,5,18,7,18,5,5,4,99
15,22,5,18,7,18,5,23,0,113
15,22,5,18,7,18,9,14,4,112
15,22,5,18,7,18,15,19,19,138
15,22,5,18,7,18,15,23,0,123
15,22,5,18,7,18,15,23,14,137
15,22,5,18,7,18,15,23,19,142
15,22,5,18,7,21,14,0,0,102
15,22,5,18,8,1,9,12,0,90
15,22,5,18,8,1,9,18,0,96
15,22,5,18,8,1,12,5,0,86
15,22,5,18,8,1,12,6,0,87
15,22,5,18,8,1,14,4,0,87
15,22,5,18,8,1,14,4,19,106
15,22,5,18,8,1,14,7,0,90
15,22,5,18,8,1,14,7,19,109
15,22,5,18,8,1,16,16,25,126
15,22,5,18,8,1,18,4,0,91
15,22,5,18,8,1,18,4,25,116
15,22,5,18,8,1,18,19,8,114
15,22,5,18,8,1,19,20,5,113
15,22,5,18,8,1,19,20,25,133
15,22,5,18,8,1,20,5,0,94
15,22,5,18,8,1,20,5,4,98
15,22,5,18,8,1,20,5,19,113
15,22,5,18,8,1,21,12,0,102
15,22,5,18,8,1,21,12,19,121
15,22,5,18,8,5,1,4,0,78
15,22,5,18,8,5,1,4,25,103
15,22,5,18,8,5,1,4,19,97
15,22,5,18,8,5,1,16,0,90
15,22,5,18,8,5,1,16,19,109
15,22,5,18,8,5,1,18,0,92
15,22,5,18,8,5,1,18,4,96
15,22,5,18,8,5,1,18,19,111
15,22,5,18,8,5,1,20,0,94
15,22,5,18,8,5,1,20,19,113
15,22,5,18,8,5,1,22,5,101
15,22,5,18,8,5,1,22,25,121
15,22,5,18,8,5,12,4,0,89
15,22,5,18,8,5,12,16,0,101
15,22,5,18,8,9,5,0,0,82
15,22,5,18,8,9,7,8,0,92
15,22,5,18,8,9,12,12,0,101
15,22,5,18,8,9,16,0,0,93
15,22,5,18,8,25,16,5,0,114
15,22,5,18,8,9,20,0,0,97
15,22,5,18,8,15,12,4,0,99
15,22,5,18,8,15,12,4,19,118
15,22,5,18,8,15,12,25,0,120
15,22,5,18,8,15,14,15,18,130
15,22,5,18,8,15,16,5,0,104
15,22,5,18,8,15,16,5,4,108
15,22,5,18,8,15,16,5,19,123
15,22,5,18,8,15,18,19,5,125
15,22,5,18,8,15,20,0,0,103
15,22,5,18,8,15,20,12,25,140
15,22,5,18,8,15,21,18,0,122
15,22,5,18,8,15,21,19,5,128
15,22,5,18,8,15,22,5,18,128
15,22,5,18,8,21,7,5,0,101
15,22,5,18,8,21,13,1,14,117
15,22,5,18,8,21,14,7,0,110
15,22,5,18,8,21,14,20,0,123
15,22,5,18,8,21,14,20,19,142
15,22,5,18,8,21,18,12,0,119
15,22,5,18,8,21,18,18,25,150
15,22,5,18,8,21,19,11,0,119
15,22,5,18,9,4,4,5,14,96
15,22,5,18,9,4,12,5,0,90
15,22,5,18,9,4,12,25,0,110
15,22,5,18,25,5,1,18,0,109
15,22,5,18,9,14,7,0,0,90
15,22,5,18,9,14,11,0,0,94
15,22,5,18,25,15,21,14,7,142
15,22,5,18,9,19,19,21,5,133
15,22,5,18,10,1,4,5,0,80
15,22,5,18,10,1,4,5,4,84
15,22,5,18,10,1,23,5,4,103
15,22,5,18,10,15,2,0,0,87
15,22,5,18,10,15,25,0,0,110
15,22,5,18,10,15,25,5,4,119
15,22,5,18,10,15,25,19,0,129
15,22,5,18,10,21,4,7,5,107
15,22,5,18,10,21,13,16,0,120
15,22,5,18,10,21,19,20,0,130
15,22,5,18,11,5,5,14,0,95
15,22,5,18,11,5,5,16,0,97
15,22,5,18,11,9,3,11,0,94
15,22,5,18,11,9,12,12,0,104
15,22,5,18,11,9,12,12,19,123
15,22,5,18,11,9,14,4,0,98
15,22,5,18,11,9,14,7,0,101
15,22,5,18,11,14,5,5,0,95
15,22,5,18,11,14,15,23,0,123
15,22,5,18,12,1,2,15,18,108
15,22,5,18,12,1,3,5,0,81
15,22,5,18,12,1,4,5,0,82
15,22,5,18,12,1,4,5,4,86
15,22,5,18,12,1,4,5,14,96
15,22,5,18,12,1,4,5,19,101
15,22,5,18,12,1,25,0,0,98
15,22,5,18,12,1,9,4,0,86
15,22,5,18,12,1,25,5,4,107
15,22,5,18,12,1,25,5,18,121
15,22,5,18,12,1,9,14,0,96
15,22,5,18,12,1,25,19,0,117
15,22,5,18,12,1,14,4,19,110
15,22,5,18,12,1,16,0,0,89
15,22,5,18,12,1,16,19,0,108
15,22,5,18,12,1,18,4,0,95
15,22,5,18,12,1,18,7,5,103
15,22,5,18,12,1,19,8,0,100
15,22,5,18,12,1,19,20,0,112
15,22,5,18,12,1,20,5,0,98
15,22,5,18,12,1,21,4,0,98
15,22,5,18,12,1,21,7,8,109
15,22,5,18,12,1,22,5,0,100
15,22,5,18,12,1,24,0,0,97
15,22,5,18,12,1,24,12,25,134
15,22,5,18,12,5,1,4,0,82
15,22,5,18,12,5,1,6,0,84
15,22,5,18,12,5,1,14,0,92
15,22,5,18,12,5,1,16,0,94
15,22,5,18,12,5,1,16,19,113
15,22,5,18,12,5,1,16,20,114
15,22,5,18,12,5,1,18,14,110
15,22,5,18,12,5,1,22,5,105
15,22,5,18,12,5,5,18,0,100
15,22,5,18,12,5,7,0,0,84
15,22,5,18,12,5,14,4,0,95
15,22,5,18,12,5,14,20,0,111
15,22,5,18,12,5,20,0,0,97
15,22,5,18,12,5,20,19,0,116
15,22,5,18,12,5,23,4,0,104
15,22,5,18,12,9,3,11,0,95
15,22,5,18,12,9,5,0,0,86
15,22,5,18,12,9,5,18,0,104
15,22,5,18,12,9,5,19,0,105
15,22,5,18,12,9,6,20,0,107
15,22,5,18,12,9,7,8,20,116
15,22,5,18,12,9,9,14,7,111
15,22,5,18,12,25,9,14,7,127
15,22,5,18,12,9,13,9,20,123
15,22,5,18,12,9,14,5,0,100
15,22,5,18,12,9,14,7,0,102
15,22,5,18,12,9,16,0,0,97
15,22,5,18,12,9,20,0,0,101
15,22,5,18,12,9,22,5,0,108
15,22,5,18,12,9,22,5,4,112
15,22,5,18,12,9,22,5,18,126
15,22,5,18,12,9,22,5,19,127
15,22,5,18,12,15,1,4,0,92
15,22,5,18,12,15,1,4,19,111
15,22,5,18,12,15,1,14,0,102
15,22,5,18,12,15,1,20,8,116
15,22,5,18,12,15,3,11,0,101
15,22,5,18,12,15,6,20,25,138
15,22,5,18,12,15,25,1,12,125
15,22,5,18,12,15,14,7,0,108
15,22,5,18,12,15,15,11,0,113
15,22,5,18,12,15,15,11,19,132
15,22,5,18,12,15,15,19,5,126
15,22,5,18,12,15,18,4,0,109
15,22,5,18,12,15,18,4,19,128
15,22,5,18,12,15,21,4,0,112
15,22,5,18,12,15,21,16,0,124
15,22,5,18,12,15,22,5,0,114
15,22,5,18,12,15,22,5,4,118
15,22,5,18,12,15,22,5,18,132
15,22,5,18,12,15,22,5,19,133
15,22,5,18,12,15,23,0,0,110
15,22,5,18,12,21,19,8,0,120
15,22,5,18,12,21,19,20,25,157
15,22,5,18,13,1,14,0,0,88
15,22,5,18,13,1,14,25,0,113
15,22,5,18,13,1,14,19,0,107
15,22,5,18,13,1,18,3,8,103
15,22,5,18,13,1,18,11,0,103
15,22,5,18,13,1,18,12,0,104
15,22,5,18,13,1,19,11,0,104
15,22,5,18,13,1,19,20,0,113
15,22,5,18,13,1,20,3,8,105
15,22,5,18,13,5,1,14,0,93
15,22,5,18,13,5,5,11,0,94
15,22,5,18,13,5,12,20,0,110
15,22,5,18,13,5,12,20,19,129
15,22,5,18,13,5,14,0,0,92
15,22,5,18,13,5,18,9,20,125
15,22,5,18,13,5,18,18,25,139
15,22,5,18,13,9,12,4,0,98
15,22,5,18,13,9,12,11,0,105
15,22,5,18,13,9,12,12,0,106
15,22,5,18,13,9,14,4,0,100
15,22,5,18,13,9,14,5,0,101
15,22,5,18,13,9,24,0,0,106
15,22,5,18,13,9,24,5,4,115
15,22,5,18,13,9,24,5,19,130
15,22,5,18,13,15,9,19,20,136
15,22,5,18,13,15,18,1,12,119
15,22,5,18,13,15,18,5,0,111
15,22,5,18,13,15,19,19,0,126
15,22,5,18,13,15,19,20,0,127
15,22,5,18,13,15,20,15,18,141
15,22,5,18,13,15,21,14,20,143
15,22,5,18,13,15,21,18,14,141
15,22,5,18,13,21,3,8,0,105
15,22,5,18,13,21,19,5,0,118
15,22,5,18,14,1,13,5,0,93
15,22,5,18,14,5,1,18,0,98
15,22,5,18,14,5,1,20,0,100
15,22,5,18,14,5,19,19,0,117
15,22,5,18,14,5,20,0,0,99
15,22,5,18,14,5,23,0,0,102
15,22,5,18,14,9,3,5,0,91
15,22,5,18,14,9,7,8,0,98
15,22,5,18,14,9,7,8,20,118
15,22,5,18,14,15,2,12,5,108
15,22,5,18,14,15,2,12,25,128
15,22,5,18,14,15,9,19,5,122
15,22,5,18,14,21,18,19,5,137
15,22,5,18,15,2,5,19,5,106
15,22,5,18,15,18,4,5,18,120
15,22,5,18,16,1,3,11,0,91
15,22,5,18,16,1,25,0,0,102
15,22,5,18,16,1,9,4,0,90
15,22,5,18,16,1,9,14,20,120
15,22,5,18,16,1,25,19,0,121
15,22,5,18,16,1,18,11,0,106
15,22,5,18,16,1,18,20,0,115
15,22,5,18,16,1,18,20,25,140
15,22,5,18,16,1,19,19,0,115
15,22,5,18,16,1,19,20,0,116
15,22,5,18,16,5,5,18,0,104
15,22,5,18,16,5,18,20,0,119
15,22,5,18,16,5,20,0,0,101
15,22,5,18,16,9,3,11,0,99
15,22,5,18,16,9,15,21,19,140
15,22,5,18,16,9,20,3,8,116
15,22,5,18,16,12,1,3,5,97
15,22,5,18,16,12,1,25,0,114
15,22,5,18,16,12,1,9,14,112
15,22,5,18,16,12,1,25,19,133
15,22,5,18,16,12,1,14,0,103
15,22,5,18,16,12,1,14,20,123
15,22,5,18,16,12,25,0,0,113
15,22,5,18,16,12,9,5,4,106
15,22,5,18,16,12,9,5,19,121
15,22,5,18,16,12,15,20,0,123
15,22,5,18,16,12,15,23,0,126
15,22,5,18,16,12,21,13,2,124
15,22,5,18,16,12,21,13,5,127
15,22,5,18,16,12,21,13,16,138
15,22,5,18,16,12,21,19,0,128
15,22,5,18,16,15,9,19,5,124
15,22,5,18,16,15,12,5,0,108
15,22,5,18,16,15,19,20,0,130
15,22,5,18,16,15,20,0,0,111
15,22,5,18,16,15,21,18,0,130
15,22,5,18,16,15,23,5,18,137
15,22,5,18,16,18,1,25,0,120
15,22,5,18,16,18,1,19,5,119
15,22,5,18,16,18,5,19,19,137
15,22,5,18,16,18,9,3,5,111
15,22,5,18,16,18,9,3,11,117
15,22,5,18,16,18,9,4,5,112
15,22,5,18,16,18,9,14,20,137
15,22,5,18,16,18,9,26,5,134
15,22,5,18,16,18,15,14,5,128
15,22,5,18,16,18,15,15,6,130
15,22,5,18,16,18,15,21,4,134
15,22,5,18,16,18,15,22,5,136
15,22,5,18,16,18,21,14,5,134
15,22,5,18,16,21,6,6,0,109
15,22,5,18,16,21,13,16,0,126
15,22,5,18,16,21,20,0,0,117
15,22,5,18,17,21,5,12,12,127
15,22,5,18,17,21,9,3,11,121
15,22,5,18,17,21,9,5,20,132
15,22,5,18,18,1,3,5,0,87
15,22,5,18,18,1,3,11,0,93
15,22,5,18,18,1,11,5,0,95
15,22,5,18,18,1,11,5,4,99
15,22,5,18,18,1,14,0,0,93
15,22,5,18,18,1,14,7,5,105
15,22,5,18,18,1,14,11,0,104
15,22,5,18,18,1,19,8,0,106
15,22,5,18,18,1,20,5,0,104
15,22,5,18,18,1,20,5,4,108
15,22,5,18,18,1,20,5,19,123
15,22,5,18,18,5,1,3,8,95
15,22,5,18,18,5,1,3,20,107
15,22,5,18,18,5,1,4,0,88
15,22,5,18,18,5,1,4,25,113
15,22,5,18,18,5,12,1,24,120
15,22,5,18,18,5,14,20,0,117
15,22,5,18,18,9,3,8,0,98
15,22,5,18,18,9,4,0,0,91
15,22,5,18,18,9,4,5,0,96
15,22,5,18,18,9,4,5,18,114
15,22,5,18,18,9,4,5,19,115
15,22,5,18,18,9,6,5,0,98
15,22,5,18,18,9,7,8,20,122
15,22,5,18,18,9,7,9,4,107
15,22,5,18,18,9,13,0,0,100
15,22,5,18,18,9,15,20,0,122
15,22,5,18,18,9,16,5,0,108
15,22,5,18,18,9,16,5,14,122
15,22,5,18,18,9,19,5,0,111
15,22,5,18,18,9,19,5,14,125
15,22,5,18,18,15,1,19,20,133
15,22,5,18,18,15,4,5,0,102
15,22,5,18,18,15,25,1,12,131
15,22,5,18,18,15,12,12,0,117
15,22,5,18,18,15,15,6,0,114
15,22,5,18,18,15,19,5,0,117
15,22,5,18,18,15,21,7,8,129
15,22,5,18,18,21,4,5,0,108
15,22,5,18,18,21,6,6,0,111
15,22,5,18,18,21,6,6,19,130
15,22,5,18,18,21,12,5,0,116
15,22,5,18,18,21,12,5,4,120
15,22,5,18,18,21,12,5,18,134
15,22,5,18,18,21,12,5,19,135
15,22,5,18,18,21,14,0,0,113
15,22,5,18,18,21,14,19,0,132
15,22,5,18,18,21,19,8,0,126
15,22,5,18,18,21,19,20,0,138
15,22,5,18,19,0,0,0,0,79
15,22,5,18,19,1,4,0,0,84
15,22,5,18,19,1,4,12,25,121
15,22,5,18,19,1,25,0,0,105
15,22,5,18,19,1,9,4,0,93
15,22,5,18,19,1,9,12,0,101
15,22,5,18,19,1,12,5,0,97
15,22,5,18,19,1,12,5,19,116
15,22,5,18,19,1,12,20,0,112
15,22,5,18,19,1,12,20,25,137
15,22,5,18,19,1,12,20,19,131
15,22,5,18,19,1,14,4,0,98
15,22,5,18,19,1,20,5,0,105
15,22,5,18,19,1,20,5,4,109
15,22,5,18,19,1,21,3,5,109
15,22,5,18,19,1,21,3,25,129
15,22,5,18,19,1,22,5,0,107
15,22,5,18,19,1,22,5,4,111
15,22,5,18,19,1,22,5,19,126
15,22,5,18,19,1,23,0,0,103
15,22,5,18,19,3,1,18,5,106
15,22,5,18,19,3,15,18,5,120
15,22,5,18,19,3,15,21,18,136
15,22,5,18,19,3,18,21,2,123
15,22,5,18,19,3,21,18,6,127
15,22,5,18,19,5,1,0,0,85
15,22,5,18,19,5,1,12,0,97
15,22,5,18,19,5,1,13,0,98
15,22,5,18,19,5,1,19,0,104
15,22,5,18,19,5,5,0,0,89
15,22,5,18,19,5,5,4,0,93
15,22,5,18,19,5,5,4,19,112
15,22,5,18,19,5,5,14,0,103
15,22,5,18,19,5,5,18,0,107
15,22,5,18,19,5,5,18,19,126
15,22,5,18,19,5,5,19,0,108
15,22,5,18,19,5,9,14,7,114
15,22,5,18,19,5,12,12,0,108
15,22,5,18,19,5,12,12,19,127
15,22,5,18,19,5,14,4,0,102
15,22,5,18,19,5,20,0,0,104
15,22,5,18,19,5,20,19,0,123
15,22,5,18,19,5,23,0,0,107
15,22,5,18,19,5,23,5,4,116
15,22,5,18,19,5,23,14,0,121
15,22,5,18,19,5,23,19,0,126
15,22,5,18,19,5,24,5,4,117
15,22,5,18,19,8,1,4,5,97
15,22,5,18,19,8,1,11,5,104
15,22,5,18,19,8,1,18,16,122
15,22,5,18,19,8,1,22,5,115
15,22,5,18,19,8,5,5,20,117
15,22,5,18,19,8,9,14,5,115
15,22,5,18,19,8,9,18,20,134
15,22,5,18,19,8,15,5,0,107
15,22,5,18,19,8,15,5,19,126
15,22,5,18,19,8,15,14,5,121
15,22,5,18,19,8,15,15,20,137
15,22,5,18,19,8,15,18,20,140
15,22,5,18,19,8,15,20,0,122
15,22,5,18,19,8,15,20,19,141
15,22,5,18,19,9,3,11,0,102
15,22,5,18,19,9,4,5,0,97
15,22,5,18,19,9,4,5,19,116
15,22,5,18,19,9,7,8,20,123
15,22,5,18,19,9,12,5,0,105
15,22,5,18,19,9,26,5,0,119
15,22,5,18,19,9,26,5,4,123
15,22,5,18,19,9,26,5,19,138
15,22,5,18,19,11,9,13,0,112
15,22,5,18,19,11,9,16,0,115
15,22,5,18,19,11,9,18,20,137
15,22,5,18,19,12,1,3,11,106
15,22,5,18,19,12,5,5,16,117
15,22,5,18,19,12,5,16,20,132
15,22,5,18,19,12,9,4,0,104
15,22,5,18,19,12,9,4,5,109
15,22,5,18,19,12,9,16,0,116
15,22,5,18,19,12,9,16,19,135
15,22,5,18,19,12,9,16,20,136
15,22,5,18,19,12,15,16,0,122
15,22,5,18,19,12,15,16,5,127
15,22,5,18,19,12,15,23,0,129
15,22,5,18,19,12,21,18,0,130
15,22,5,18,19,13,1,12,12,117
15,22,5,18,19,13,1,14,0,107
15,22,5,18,19,13,9,20,5,126
15,22,5,18,19,13,15,11,5,123
15,22,5,18,19,14,5,19,19,136
15,22,5,18,19,14,15,23,0,131
15,22,5,18,19,15,1,11,0,106
15,22,5,18,19,15,1,11,19,125
15,22,5,18,19,15,1,16,0,111
15,22,5,18,19,15,1,18,0,113
15,22,5,18,19,15,3,11,0,108
15,22,5,18,19,15,6,20,0,120
15,22,5,18,19,15,12,4,0,110
15,22,5,18,19,15,15,14,0,123
15,22,5,18,19,15,20,0,0,114
15,22,5,18,19,15,21,12,0,127
15,22,5,18,19,15,21,12,19,146
15,22,5,18,19,15,21,14,4,133
15,22,5,18,19,15,21,18,0,133
15,22,5,18,19,15,23,0,0,117
15,22,5,18,19,15,23,5,4,126
15,22,5,18,19,15,23,14,0,131
15,22,5,18,19,16,1,14,0,110
15,22,5,18,19,16,5,1,11,112
15,22,5,18,19,16,5,5,4,109
15,22,5,18,19,16,5,14,4,118
15,22,5,18,19,16,5,14,20,134
15,22,5,18,19,16,9,3,5,112
15,22,5,18,19,16,9,12,12,128
15,22,5,18,19,16,9,12,20,136
15,22,5,18,19,16,9,14,0,118
15,22,5,18,19,16,9,14,19,137
15,22,5,18,19,16,15,11,5,126
15,22,5,18,19,16,21,14,0,130
15,22,5,18,19,19,8,15,20,141
15,22,5,18,19,20,1,6,6,112
15,22,5,18,19,20,1,25,0,125
15,22,5,18,19,20,1,9,4,113
15,22,5,18,19,20,1,9,14,123
15,22,5,18,19,20,1,25,19,144
15,22,5,18,19,20,1,12,5,117
15,22,5,18,19,20,1,14,4,118
15,22,5,18,19,20,1,20,5,125
15,22,5,18,19,20,5,5,18,127
15,22,5,18,19,20,5,16,0,120
15,22,5,18,19,20,5,16,19,139
15,22,5,18,19,20,9,6,6,120
15,22,5,18,19,20,9,18,0,126
15,22,5,18,19,20,9,18,19,145
15,22,5,18,19,20,15,3,11,128
15,22,5,18,19,20,15,15,4,133
15,22,5,18,19,20,15,15,16,145
15,22,5,18,19,20,15,18,5,137
15,22,5,18,19,20,15,18,25,157
15,22,5,18,19,20,15,21,20,155
15,22,5,18,19,20,18,5,23,145
15,22,5,18,19,20,21,4,0,124
15,22,5,18,19,20,21,4,25,149
15,22,5,18,19,20,21,6,6,132
15,22,5,18,19,21,4,19,0,123
15,22,5,18,19,21,13,0,0,113
15,22,5,18,19,21,16,0,0,116
15,22,5,18,19,21,16,19,0,135
15,22,5,18,19,21,18,5,0,123
15,22,5,18,19,21,18,5,4,127
15,22,5,18,19,21,18,7,5,130
15,22,5,18,19,23,1,25,0,128
15,22,5,18,19,23,1,18,13,134
15,22,5,18,19,23,5,5,16,128
15,22,5,18,19,23,5,5,20,132
15,22,5,18,19,23,5,12,12,131
15,22,5,18,19,23,9,6,20,137
15,22,5,18,19,23,9,13,0,124
15,22,5,18,19,23,9,14,7,132
15,22,5,18,20,0,0,0,0,80
15,22,5,18,20,1,11,5,0,97
15,22,5,18,20,1,11,5,14,111
15,22,5,18,20,1,11,5,18,115
15,22,5,18,20,1,11,5,19,116
15,22,5,18,20,1,12,11,0,104
15,22,5,18,20,1,13,5,0,99
15,22,5,18,20,1,18,5,0,104
15,22,5,18,20,1,18,18,25,142
15,22,5,18,20,1,18,20,0,119
15,22,5,18,20,1,19,11,0,111
15,22,5,18,20,1,19,11,19,130
15,22,5,18,20,1,24,0,0,105
15,22,5,18,20,1,24,5,4,114
15,22,5,18,20,1,24,5,19,129
15,22,5,18,20,5,1,3,8,97
15,22,5,18,20,5,5,13,0,103
15,22,5,18,20,5,12,12,0,109
15,22,5,18,20,5,13,16,20,134
15,22,5,18,20,5,14,19,5,123
15,22,5,18,20,5,19,20,0,124
15,22,5,18,20,8,9,3,11,111
15,22,5,18,20,8,9,14,0,111
15,22,5,18,20,8,9,14,11,122
15,22,5,18,20,8,18,5,23,134
15,22,5,18,20,8,18,15,23,144
15,22,5,18,20,9,4,5,0,98
15,22,5,18,20,9,7,8,20,124
15,22,5,18,20,9,12,12,0,113
15,22,5,18,20,9,12,20,0,121
15,22,5,18,20,9,13,5,0,107
15,22,5,18,20,9,13,5,4,111
15,22,5,18,20,9,13,5,18,125
15,22,5,18,20,9,13,5,19,126
15,22,5,18,20,9,13,9,4,115
15,22,5,18,20,9,14,20,0,123
15,22,5,18,20,9,16,0,0,105
15,22,5,18,20,25,16,5,0,126
15,22,5,18,20,25,16,5,4,130
15,22,5,18,20,9,16,19,0,124
15,22,5,18,20,9,18,5,0,112
15,22,5,18,20,9,18,5,4,116
15,22,5,18,20,9,18,5,19,131
15,22,5,18,20,9,20,12,5,126
15,22,5,18,20,12,25,0,0,117
15,22,5,18,20,14,5,19,19,137
15,22,5,18,20,15,5,0,0,100
15,22,5,18,20,15,9,12,0,116
15,22,5,18,20,15,9,12,19,135
15,22,5,18,20,15,9,19,5,128
15,22,5,18,20,15,12,4,0,111
15,22,5,18,20,15,14,5,0,114
15,22,5,18,20,15,14,5,19,133
15,22,5,18,20,15,15,11,0,121
15,22,5,18,20,15,16,0,0,111
15,22,5,18,20,15,16,19,0,130
15,22,5,18,20,15,23,5,18,141
15,22,5,18,20,18,1,3,5,107
15,22,5,18,20,18,1,3,11,113
15,22,5,18,20,18,1,4,5,108
15,22,5,18,20,18,1,9,14,122
15,22,5,18,20,18,5,1,4,108
15,22,5,18,20,18,5,1,20,124
15,22,5,18,20,18,9,3,11,121
15,22,5,18,20,18,9,13,0,120
15,22,5,18,20,18,9,13,19,139
15,22,5,18,20,18,15,4,0,117
15,22,5,18,20,18,21,5,0,124
15,22,5,18,20,18,21,12,25,156
15,22,5,18,20,18,21,13,16,148
15,22,5,18,20,18,21,19,20,158
15,22,5,18,20,21,18,5,0,124
15,22,5,18,20,21,18,5,4,128
15,22,5,18,20,21,18,5,19,143
15,22,5,18,20,21,18,14,0,133
15,22,5,18,20,21,18,14,19,152
15,22,5,18,20,21,20,15,18,154
15,22,5,18,20,23,9,14,5,131
15,22,5,18,20,23,9,19,20,151
15,22,5,18,21,18,7,5,0,111
15,22,5,18,21,18,7,5,4,115
15,22,5,18,21,18,7,5,19,130
15,22,5,18,21,19,5,0,0,105
15,22,5,18,21,19,5,4,0,109
15,22,5,18,21,19,5,19,0,124
15,22,5,18,21,19,9,14,7,130
15,22,5,18,21,19,21,1,12,134
15,22,5,18,22,1,12,21,5,121
15,22,5,18,22,1,18,25,0,126
15,22,5,18,22,1,21,12,20,136
15,22,5,18,22,5,9,12,0,108
15,22,5,18,22,9,5,23,0,119
15,22,5,18,22,9,5,23,19,138
15,22,5,18,22,15,20,5,0,122
15,22,5,18,22,15,20,5,4,126
15,22,5,18,22,15,20,5,19,141
15,22,5,18,23,1,4,5,0,93
15,22,5,18,23,1,7,5,19,115
15,22,5,18,23,1,25,0,0,109
15,22,5,18,23,1,11,5,0,100
15,22,5,18,23,1,12,11,0,107
15,22,5,18,23,1,18,4,0,106
15,22,5,18,23,1,18,25,0,127
15,22,5,18,23,1,18,13,0,115
15,22,5,18,23,1,18,13,19,134
15,22,5,18,23,1,18,20,0,122
15,22,5,18,23,1,19,8,0,111
15,22,5,18,23,1,20,3,8,115
15,22,5,18,23,1,20,5,18,127
15,22,5,18,23,1,22,5,0,111
15,22,5,18,23,5,1,11,0,100
15,22,5,18,23,5,1,18,0,107
15,22,5,18,23,5,1,18,25,132
15,22,5,18,23,5,1,18,19,126
15,22,5,18,23,5,1,22,5,116
15,22,5,18,23,5,2,0,0,90
15,22,5,18,23,5,5,14,0,107
15,22,5,18,23,5,5,14,19,126
15,22,5,18,23,5,5,16,0,109
15,22,5,18,23,5,9,7,8,112
15,22,5,18,23,5,12,12,0,112
15,22,5,18,23,5,12,20,0,120
15,22,5,18,23,5,14,4,0,106
15,22,5,18,23,5,14,20,0,122
15,22,5,18,23,5,20,0,0,108
15,22,5,18,23,5,20,19,0,127
15,22,5,18,23,8,5,5,12,113
15,22,5,18,23,8,5,12,13,121
15,22,5,18,23,8,9,16,0,116
15,22,5,18,23,8,9,18,12,130
15,22,5,18,23,9,4,5,0,101
15,22,5,18,23,9,12,4,0,108
15,22,5,18,23,9,12,25,0,129
15,22,5,18,23,9,14,0,0,106
15,22,5,18,23,9,14,4,0,110
15,22,5,18,23,9,14,4,19,129
15,22,5,18,23,9,14,7,0,113
15,22,5,18,23,9,16,5,4,117
15,22,5,18,23,9,19,5,0,116
15,22,5,18,23,15,13,1,14,126
15,22,5,18,23,15,14,0,0,112
15,22,5,18,23,15,15,4,0,117
15,22,5,18,23,15,15,4,25,142
15,22,5,18,23,15,18,4,0,120
15,22,5,18,23,15,18,4,19,139
15,22,5,18,23,15,18,5,0,121
15,22,5,18,23,15,18,11,0,127
15,22,5,18,23,15,18,11,19,146
15,22,5,18,23,15,18,12,4,132
15,22,5,18,23,15,18,14,0,130
15,22,5,18,23,15,18,18,25,159
15,22,5,18,23,15,21,14,4,137
15,22,5,18,23,15,22,5,0,125
15,22,5,18,23,15,22,5,14,139
15,22,5,18,23,18,1,16,0,118
15,22,5,18,23,18,5,19,20,145
15,22,5,18,23,18,9,20,5,135
15,22,5,18,23,18,15,20,5,141
15,22,5,18,23,18,15,20,8,144
15,22,5,18,26,5,1,12,0,104
15,22,5,18,26,5,1,12,19,123
15,22,5,19,20,0,0,0,0,81
15,22,5,23,15,21,14,4,0,119
15,22,9,2,15,22,9,14,5,113
15,22,9,3,5,12,12,0,0,78
15,22,9,3,9,4,1,12,0,75
15,22,9,3,9,4,5,0,0,67
15,22,9,3,9,4,5,19,0,86
15,22,9,3,25,19,20,0,0,113
15,22,9,3,25,19,20,9,3,125
15,22,9,3,21,12,1,18,0,101
15,22,9,3,21,12,21,13,0,116
15,22,9,4,21,3,1,12,0,87
15,22,9,4,21,3,20,0,0,94
15,22,9,4,21,3,20,1,12,107
15,22,9,4,21,3,20,19,0,113
15,22,9,6,5,18,15,21,19,130
15,22,9,6,15,18,13,0,0,98
15,22,9,7,5,14,9,3,0,84
15,22,9,7,5,14,15,21,19,127
15,22,9,7,5,18,0,0,0,76
15,22,9,7,5,18,13,0,0,89
15,22,9,7,5,18,15,21,19,131
15,22,9,12,5,0,0,0,0,63
15,22,9,14,5,0,0,0,0,65
15,22,9,14,5,19,0,0,0,84
15,22,9,14,9,1,0,0,0,70
15,22,9,16,1,18,1,0,0,82
15,22,9,16,1,18,1,12,0,94
15,22,9,16,1,18,9,20,25,135
15,22,9,16,1,18,15,21,19,136
15,22,9,16,15,19,9,20,0,125
15,22,9,16,15,19,9,20,19,144
15,22,9,19,1,3,0,0,0,69
15,22,9,19,1,3,19,0,0,88
15,22,9,19,3,1,16,20,0,105
15,22,9,19,13,0,0,0,0,78
15,22,9,19,20,0,0,0,0,85
15,22,9,19,20,9,3,0,0,97
15,22,9,22,15,18,15,21,19,156
15,22,15,3,25,20,5,0,0,105
15,22,15,6,12,1,22,9,14,116
15,22,15,7,5,14,15,21,19,133
15,22,15,7,15,14,9,21,13,131
15,22,15,9,4,0,0,0,0,65
15,22,15,9,4,1,12,0,0,78
15,22,15,9,4,19,0,0,0,84
15,22,15,12,5,13,13,1,0,96
15,22,15,12,9,0,0,0,0,73
15,22,15,12,25,20,9,3,0,121
15,22,15,12,15,0,0,0,0,79
15,22,15,12,15,7,25,0,0,111
15,22,15,12,15,7,9,19,20,134
15,22,15,12,15,19,0,0,0,98
15,22,15,13,21,3,15,9,4,117
15,22,15,14,9,3,0,0,0,78
15,22,15,14,9,3,19,0,0,97
15,22,15,16,12,1,19,13,0,113
15,22,15,20,5,19,20,9,19,144
15,22,21,12,1,18,0,0,0,89
15,22,21,12,1,18,25,0,0,114
15,22,21,12,1,18,9,1,14,113
15,22,21,12,1,20,5,0,0,96
15,22,21,12,1,20,5,4,0,100
15,22,21,12,1,20,5,19,0,115
15,22,21,12,1,20,9,14,7,121
15,22,21,12,1,20,9,15,14,129
15,22,21,12,1,20,15,18,25,149
15,22,21,12,5,0,0,0,0,75
15,22,21,12,5,19,0,0,0,94
15,22,21,12,9,19,20,0,0,118
15,22,21,12,9,20,5,0,0,104
15,22,21,12,21,13,0,0,0,104
15,22,21,13,0,0,0,0,0,71
15,23,4,0,0,0,0,0,0,42
15,23,5,0,0,0,0,0,0,43
15,23,5,4,0,0,0,0,0,47
15,23,5,12,20,25,0,0,0,100
15,23,5,18,0,0,0,0,0,61
15,23,5,18,1,14,3,5,0,84
15,23,5,18,2,25,0,0,0,88
15,23,5,18,3,15,13,5,0,97
15,23,5,18,7,1,14,7,0,90
15,23,5,18,12,15,21,16,0,125
15,23,5,18,20,1,5,14,0,101
15,23,5,18,23,15,18,4,0,121
15,23,5,19,0,0,0,0,0,62
15,23,7,8,20,0,0,0,0,73
15,23,8,5,18,5,0,0,0,74
15,23,25,8,5,5,9,20,5,115
15,23,9,14,7,0,0,0,0,68
15,23,11,0,0,0,0,0,0,49
15,23,12,0,0,0,0,0,0,50
15,23,12,4,15,13,0,0,0,82
15,23,12,5,18,0,0,0,0,73
15,23,12,5,18,25,0,0,0,98
15,23,12,5,18,9,5,19,0,106
15,23,12,5,20,0,0,0,0,75
15,23,12,5,20,19,0,0,0,94
15,23,12,8,5,1,4,0,0,68
15,23,12,25,0,0,0,0,0,75
15,23,12,9,14,7,0,0,0,80
15,23,12,9,19,8,0,0,0,86
15,23,12,9,19,8,12,25,0,123
15,23,12,9,19,13,0,0,0,91
15,23,12,12,9,7,8,20,0,106
15,23,12,12,9,11,5,0,0,87
15,23,12,19,0,0,0,0,0,69
15,23,14,0,0,0,0,0,0,52
15,23,14,1,2,12,5,0,0,72
15,23,14,5,4,0,0,0,0,61
15,23,14,5,18,0,0,0,0,75
15,23,14,5,18,12,5,19,19,130
15,23,14,5,18,19,0,0,0,94
15,23,14,5,18,19,8,9,16,127
15,23,14,8,15,15,4,0,0,94
15,23,14,9,14,7,0,0,0,82
15,23,14,14,5,19,19,0,0,109
15,23,14,19,0,0,0,0,0,71
15,23,14,19,5,12,6,0,0,94
15,23,14,23,1,25,9,19,8,137
15,23,18,5,3,15,13,5,0,97
15,23,18,5,7,1,14,5,0,88
15,23,18,5,8,9,16,0,0,94
15,23,18,5,12,1,25,0,0,99
15,23,19,5,0,0,0,0,0,62
15,23,19,5,14,0,0,0,0,76
15,23,19,5,18,0,0,0,0,80
15,23,20,0,0,0,0,0,0,58
15,23,20,3,8,1,8,0,0,78
15,24,2,1,14,5,0,0,0,61
15,24,2,5,18,18,25,0,0,107
15,24,2,5,18,18,9,5,19,115
15,24,2,9,18,4,0,0,0,72
15,24,2,9,20,5,18,0,0,93
15,24,2,12,15,15,4,0,0,87
15,24,2,12,15,15,4,19,0,106
15,24,2,15,25,0,0,0,0,81
15,24,2,15,23,19,0,0,0,98
15,24,2,18,1,11,5,0,0,76
15,24,3,1,18,20,0,0,0,81
15,24,3,1,18,20,19,0,0,100
15,24,3,8,5,5,11,0,0,71
15,24,4,9,1,26,15,12,5,111
15,24,5,1,0,0,0,0,0,45
15,24,5,1,20,5,0,0,0,70
15,24,5,25,5,0,0,0,0,74
15,24,5,25,5,19,0,0,0,93
15,24,5,14,0,0,0,0,0,58
15,24,5,15,20,5,0,0,0,84
15,24,5,18,0,0,0,0,0,62
15,24,5,19,0,0,0,0,0,63
15,24,5,20,15,14,5,0,0,98
15,24,6,12,25,0,0,0,0,82
15,24,7,1,12,12,0,0,0,71
15,24,7,1,14,7,0,0,0,68
15,24,7,1,20,5,0,0,0,72
15,24,7,15,1,4,0,0,0,66
15,24,8,1,18,18,15,23,0,122
15,24,8,5,1,4,0,0,0,57
15,24,8,5,1,12,0,0,0,65
15,24,8,5,1,18,20,0,0,91
15,24,8,5,1,18,20,19,0,110
15,24,8,5,18,4,0,0,0,74
15,24,8,9,4,5,0,0,0,65
15,24,8,15,6,20,0,0,0,88
15,24,8,15,18,14,0,0,0,94
15,24,8,15,21,19,5,0,0,107
15,24,8,21,22,21,4,0,0,115
15,24,25,0,0,0,0,0,0,64
15,24,25,1,3,9,4,0,0,81
15,24,25,1,3,9,4,19,0,100
15,24,25,1,13,9,14,5,0,106
15,24,25,1,16,8,9,1,0,99
15,24,25,1,19,20,5,18,0,127
15,24,25,1,26,15,0,0,0,106
15,24,25,2,1,16,8,1,0,92
15,24,25,2,1,16,8,15,14,120
15,24,25,2,5,14,26,25,12,148
15,24,25,3,18,1,20,5,0,111
15,24,9,4,0,0,0,0,0,52
15,24,9,4,1,2,12,5,0,72
15,24,25,4,1,3,20,25,12,129
15,24,9,4,1,14,20,0,0,87
15,24,9,4,1,14,20,19,0,106
15,24,9,4,1,19,5,0,0,77
15,24,25,4,1,19,5,0,0,93
15,24,9,4,1,19,5,19,0,96
15,24,9,4,1,19,9,3,0,84
15,24,25,4,1,19,9,3,0,100
15,24,9,4,1,20,5,0,0,78
15,24,9,4,1,20,5,4,0,82
15,24,9,4,1,20,5,19,0,97
15,24,9,4,1,20,9,14,7,103
15,24,9,4,1,20,9,15,14,111
15,24,25,4,1,20,9,15,14,127
15,24,9,4,1,20,9,22,5,109
15,24,9,4,1,20,15,18,0,106
15,24,9,4,5,0,0,0,0,57
15,24,9,4,5,19,0,0,0,76
15,24,25,4,9,1,3,20,0,101
15,24,9,4,9,3,0,0,0,64
15,24,9,4,9,19,5,0,0,85
15,24,9,4,9,19,5,4,0,89
15,24,9,4,9,19,5,18,0,103
15,24,9,4,9,19,5,18,19,122
15,24,9,4,9,19,5,19,0,104
15,24,9,4,9,19,9,14,7,110
15,24,9,4,9,26,5,0,0,92
15,24,9,4,9,26,5,4,0,96
15,24,9,4,9,26,5,18,0,110
15,24,9,4,9,26,5,18,19,129
15,24,9,4,9,26,5,19,0,111
15,24,9,4,9,26,9,14,7,117
15,24,9,4,19,0,0,0,0,71
15,24,25,5,20,8,5,18,0,120
15,24,25,5,20,8,25,12,0,134
15,24,25,6,1,20,20,25,0,136
15,24,25,7,1,19,0,0,0,91
15,24,25,7,5,14,0,0,0,90
15,24,25,7,5,14,1,14,20,125
15,24,25,7,5,14,1,19,5,115
15,24,25,7,5,14,1,20,5,116
15,24,25,7,5,14,9,3,0,102
15,24,25,7,5,14,9,21,13,133
15,24,25,7,5,14,9,26,5,130
15,24,25,7,5,14,15,21,19,145
15,24,25,7,5,14,19,0,0,109
15,24,25,7,5,21,19,9,1,126
15,24,25,7,15,14,0,0,0,100
15,24,25,7,15,14,1,12,0,113
15,24,25,7,15,14,9,1,12,122
15,24,25,8,1,12,9,4,5,103
15,24,25,8,1,12,15,9,4,113
15,24,25,8,25,4,18,9,3,131
15,24,25,9,15,4,9,4,5,110
15,24,25,11,5,20,15,14,5,134
15,24,25,12,0,0,0,0,0,76
15,24,9,13,0,0,0,0,0,61
15,24,9,13,1,20,5,0,0,87
15,24,9,13,1,20,9,15,14,120
15,24,9,13,5,0,0,0,0,66
15,24,25,13,5,12,0,0,0,94
15,24,9,13,5,19,0,0,0,85
15,24,9,13,5,20,5,18,0,109
15,24,9,13,5,20,18,25,0,129
15,24,9,13,5,20,18,9,3,116
15,24,25,13,15,13,15,18,1,139
15,24,25,13,15,18,1,0,0,111
15,24,25,13,15,18,15,14,0,139
15,24,9,13,19,0,0,0,0,80
15,24,9,14,4,15,12,5,0,98
15,24,25,14,5,21,18,9,14,145
15,24,25,14,20,9,3,0,0,110
15,24,25,15,16,25,0,0,0,120
15,24,25,15,16,9,1,0,0,105
15,24,25,16,8,5,14,25,12,144
15,24,25,16,8,5,14,15,12,134
15,24,25,16,8,9,12,0,0,109
15,24,25,16,8,9,12,5,0,114
15,24,25,16,8,9,12,5,19,133
15,24,25,16,8,9,12,9,3,121
15,24,25,16,8,9,12,19,0,128
15,24,25,16,8,25,20,5,0,138
15,24,25,16,8,15,14,25,0,142
15,24,25,16,8,15,14,9,1,127
15,24,25,16,25,3,14,15,19,156
15,24,25,16,9,3,18,9,3,122
15,24,25,16,21,18,9,14,5,147
15,24,25,18,8,25,14,3,8,140
15,24,25,18,8,9,14,5,0,118
15,24,25,19,1,12,20,0,0,116
15,24,25,19,1,12,20,19,0,135
15,24,25,19,15,13,5,0,0,116
15,24,25,19,15,13,5,19,0,135
15,24,25,19,20,15,13,5,0,136
15,24,25,19,21,12,6,9,4,135
15,24,25,20,25,12,15,20,5,161
15,24,25,20,15,3,9,1,0,112
15,24,25,20,15,3,9,3,0,114
15,24,25,20,15,3,9,3,19,133
15,24,25,20,15,3,9,14,0,125
15,24,25,20,15,3,9,14,19,144
15,24,25,20,15,3,15,21,19,157
15,24,25,20,15,12,21,9,3,144
15,24,25,20,15,14,5,0,0,118
15,24,25,20,15,14,5,19,0,137
15,24,25,20,15,14,9,3,0,125
15,24,25,20,15,14,9,26,5,153
15,24,25,21,18,9,4,0,0,116
15,24,25,21,18,15,21,19,0,158
15,24,12,1,14,4,0,0,0,70
15,24,12,9,11,5,0,0,0,76
15,24,12,9,16,0,0,0,0,76
15,24,12,9,16,19,0,0,0,95
15,24,13,1,14,0,0,0,0,67
15,24,13,1,14,19,8,9,16,119
15,24,15,0,0,0,0,0,0,54
15,24,15,14,9,3,0,0,0,80
15,24,15,14,9,21,13,0,0,111
15,24,15,26,15,14,5,0,0,114
15,24,15,26,15,14,9,4,5,127
15,24,16,5,3,11,5,18,0,97
15,24,16,5,3,11,5,18,19,116
15,24,16,8,15,14,25,0,0,117
15,24,18,5,9,13,0,0,0,84
15,24,19,8,15,5,0,0,0,86
15,24,19,11,9,14,0,0,0,92
15,24,20,1,9,12,0,0,0,81
15,24,20,1,9,12,19,0,0,100
15,24,20,5,18,0,0,0,0,82
15,24,20,5,18,19,0,0,0,101
15,24,20,15,14,7,21,5,0,121
15,24,20,15,14,7,21,5,19,140
15,24,23,15,18,20,0,0,0,115
15,26,5,14,1,0,0,0,0,61
15,26,15,2,18,15,13,5,0,109
15,26,15,3,5,18,9,20,5,116
15,26,15,5,14,1,0,0,0,76
15,26,15,11,5,18,9,20,0,119
15,26,15,11,5,18,9,20,5,124
15,26,15,14,1,20,5,0,0,96
15,26,15,14,1,20,9,15,14,129
15,26,15,14,1,20,15,18,0,124
15,26,15,14,5,0,0,0,0,75
15,26,15,14,5,4,0,0,0,79
15,26,15,14,5,18,0,0,0,93
15,26,15,14,5,19,0,0,0,94
15,26,15,14,9,3,0,0,0,82
15,26,15,14,9,4,0,0,0,83
15,26,15,14,9,4,5,0,0,88
15,26,15,14,9,4,5,19,0,107
15,26,15,14,9,6,25,0,0,110
15,26,15,14,9,19,5,0,0,103
15,26,15,14,9,19,5,4,0,107
15,26,15,14,9,19,5,19,0,122
15,26,15,14,9,19,9,14,7,128
15,26,15,14,9,26,5,0,0,110
15,26,15,14,9,26,5,4,0,114
15,26,15,14,9,26,5,18,0,128
15,26,15,14,9,26,5,18,19,147
15,26,15,14,9,26,5,19,0,129
15,26,15,14,9,26,9,14,7,135
15,26,15,14,15,21,19,0,0,125
15,26,15,16,8,5,14,0,0,99
15,26,15,16,8,5,14,5,0,104
15,26,15,19,20,15,13,9,1,133
15,26,15,20,25,16,5,0,0,122
15,26,19,0,0,0,0,0,0,60
16,2,24,5,19,0,0,0,0,66
16,3,20,0,0,0,0,0,0,39
16,5,2,2,12,5,0,0,0,42
16,5,2,2,12,5,4,0,0,46
16,5,2,2,12,5,19,0,0,61
16,5,2,2,12,25,0,0,0,62
16,5,2,2,12,9,5,18,0,69
16,5,2,2,12,9,5,19,20,90
16,5,2,2,12,9,14,7,0,67
16,5,2,18,9,14,5,0,0,69
16,5,2,18,9,14,15,21,19,119
16,5,3,1,14,0,0,0,0,39
16,5,3,1,14,19,0,0,0,58
16,5,3,3,1,2,12,5,0,47
16,5,3,3,1,14,3,25,0,70
16,5,3,3,1,14,20,0,0,62
16,5,3,3,1,14,20,12,25,99
16,5,3,3,1,18,25,0,0,71
16,5,3,3,1,18,9,5,19,79
16,5,3,3,1,20,9,15,14,86
16,5,3,3,1,22,9,0,0,59
16,5,3,3,1,22,9,19,0,78
16,5,3,8,0,0,0,0,0,32
16,5,3,8,1,25,0,0,0,58
16,5,3,8,1,14,0,0,0,47
16,5,3,8,1,14,19,0,0,66
16,5,3,8,5,4,0,0,0,41
16,5,3,8,9,12,9,0,0,62
16,5,3,8,9,14,7,0,0,62
16,5,3,8,25,19,0,0,0,76
16,5,3,8,19,0,0,0,0,51
16,5,3,8,20,0,0,0,0,52
16,5,3,9,6,25,0,0,0,64
16,5,3,9,20,5,0,0,0,58
16,5,3,11,1,7,5,0,0,48
16,5,3,11,5,4,0,0,0,44
16,5,3,11,5,18,0,0,0,58
16,5,3,11,5,18,19,0,0,77
16,5,3,11,5,20,0,0,0,60
16,5,3,11,6,21,12,0,0,74
16,5,3,11,25,0,0,0,0,60
16,5,3,11,9,5,18,0,0,67
16,5,3,11,9,5,19,20,0,88
16,5,3,11,9,14,5,19,19,101
16,5,3,11,9,14,7,0,0,65
16,5,3,11,9,19,8,0,0,71
16,5,3,11,9,19,8,12,25,108
16,5,3,11,12,5,0,0,0,52
16,5,3,11,12,5,4,0,0,56
16,5,3,11,12,25,0,0,0,72
16,5,3,11,19,0,0,0,0,54
16,5,3,20,1,19,5,0,0,69
16,5,3,20,1,19,5,19,0,88
16,5,3,20,1,20,5,0,0,70
16,5,3,20,1,20,5,19,0,89
16,5,3,20,5,14,0,0,0,63
16,5,3,20,5,14,19,0,0,82
16,5,3,20,9,3,0,0,0,56
16,5,3,20,9,14,0,0,0,67
16,5,3,20,9,14,1,12,0,80
16,5,3,20,9,14,1,19,5,92
16,5,3,20,9,14,1,20,5,93
16,5,3,20,9,14,5,1,12,85
16,5,3,20,9,14,5,19,0,91
16,5,3,20,9,14,5,21,19,112
16,5,3,20,9,14,9,3,0,79
16,5,3,20,9,14,9,4,0,80
16,5,3,20,9,14,9,20,5,101
16,5,3,20,9,14,15,9,4,95
16,5,3,20,9,14,15,19,5,106
16,5,3,20,9,14,15,21,19,122
16,5,3,20,9,14,19,0,0,86
16,5,3,20,9,26,5,0,0,84
16,5,3,20,9,26,5,4,0,88
16,5,3,20,9,26,5,19,0,103
16,5,3,20,9,26,9,14,7,109
16,5,3,20,15,12,9,20,5,105
16,5,3,20,15,18,1,0,0,78
16,5,3,20,15,18,1,12,0,90
16,5,3,20,15,18,1,12,19,109
16,5,3,20,15,18,9,19,0,105
16,5,3,20,15,19,1,19,5,103
16,5,3,20,15,19,5,0,0,83
16,5,3,20,15,19,9,3,0,90
16,5,3,20,15,21,19,0,0,99
16,5,3,20,18,15,14,0,0,91
16,5,3,20,21,19,0,0,0,84
16,5,3,21,12,1,20,5,0,83
16,5,3,21,12,1,20,5,4,87
16,5,3,21,12,1,20,5,19,102
16,5,3,21,12,1,20,15,18,111
16,5,3,21,12,9,1,0,0,67
16,5,3,21,12,9,1,18,0,85
16,5,3,21,12,9,1,18,19,104
16,5,3,21,12,9,21,13,0,100
16,5,3,21,14,9,1,0,0,69
16,5,3,21,14,9,1,12,0,81
16,5,3,21,14,9,1,18,25,112
16,5,3,21,14,9,15,21,19,123
16,5,4,0,0,0,0,0,0,25
16,5,4,1,0,0,0,0,0,26
16,5,4,1,7,5,0,0,0,38
16,5,4,1,7,5,19,5,0,62
16,5,4,1,7,15,7,0,0,55
16,5,4,1,7,15,7,1,12,68
16,5,4,1,7,15,7,25,0,80
16,5,4,1,7,15,7,9,3,67
16,5,4,1,7,15,7,19,0,74
16,5,4,1,7,15,7,21,5,81
16,5,4,1,12,0,0,0,0,38
16,5,4,1,12,5,4,0,0,47
16,5,4,1,12,5,18,0,0,61
16,5,4,1,12,6,5,18,0,67
16,5,4,1,12,6,5,18,19,86
16,5,4,1,12,9,1,14,0,62
16,5,4,1,12,9,5,18,0,70
16,5,4,1,12,9,5,18,19,89
16,5,4,1,12,9,14,7,0,68
16,5,4,1,12,9,19,13,0,79
16,5,4,1,12,9,19,20,0,86
16,5,4,1,12,9,20,5,18,90
16,5,4,1,12,9,20,25,0,92
16,5,4,1,12,12,5,4,0,59
16,5,4,1,12,12,5,18,0,73
16,5,4,1,12,12,9,14,7,80
16,5,4,1,12,15,0,0,0,53
16,5,4,1,12,19,0,0,0,57
16,5,4,1,14,20,0,0,0,60
16,5,4,1,14,20,5,0,0,65
16,5,4,1,14,20,5,19,19,103
16,5,4,1,14,20,9,3,0,72
16,5,4,1,14,20,9,3,19,91
16,5,4,1,14,20,9,19,13,101
16,5,4,1,14,20,9,26,5,100
16,5,4,1,14,20,18,25,0,103
16,5,4,1,14,20,19,0,0,79
16,5,4,1,18,25,0,0,0,69
16,5,4,1,18,9,1,14,0,68
16,5,4,1,20,5,0,0,0,51
16,5,4,1,20,5,4,0,0,55
16,5,4,1,20,5,12,25,0,88
16,5,4,1,20,9,6,9,4,74
16,5,4,4,5,18,0,0,0,52
16,5,4,4,12,1,18,0,0,60
16,5,4,4,12,5,0,0,0,46
16,5,4,4,12,5,4,0,0,50
16,5,4,4,12,5,18,0,0,64
16,5,4,4,12,5,18,25,0,89
16,5,4,4,12,5,18,19,0,83
16,5,4,4,12,5,19,0,0,65
16,5,4,4,12,9,14,7,0,71
16,5,4,5,0,0,0,0,0,30
16,5,4,5,5,0,0,0,0,35
16,5,4,5,12,9,15,14,0,80
16,5,4,5,18,1,19,20,0,88
16,5,4,5,18,1,19,20,25,113
16,5,4,5,18,1,19,20,19,107
16,5,4,5,18,5,18,15,0,86
16,5,4,5,19,0,0,0,0,49
16,5,4,5,19,5,19,0,0,73
16,5,4,5,19,9,19,0,0,77
16,5,4,5,19,20,1,12,0,82
16,5,4,5,19,20,1,12,19,101
16,5,4,5,20,9,3,0,0,62
16,5,4,9,1,4,0,0,0,39
16,5,4,9,1,12,0,0,0,47
16,5,4,9,1,12,7,9,1,64
16,5,4,9,1,20,18,25,0,98
16,5,4,9,1,20,18,9,3,85
16,5,4,9,3,1,2,0,0,40
16,5,4,9,3,1,2,19,0,59
16,5,4,9,3,5,12,0,0,54
16,5,4,9,3,5,12,5,4,63
16,5,4,9,3,5,12,19,0,73
16,5,4,9,3,12,5,0,0,54
16,5,4,9,3,12,5,4,0,58
16,5,4,9,3,12,5,19,0,73
16,5,4,9,3,21,12,1,18,89
16,5,4,9,3,21,12,5,0,75
16,5,4,9,3,21,12,9,4,83
16,5,4,9,3,21,18,5,0,81
16,5,4,9,3,21,18,5,4,85
16,5,4,9,3,21,18,5,19,100
16,5,4,9,6,15,18,13,0,86
16,5,4,9,7,18,1,9,3,72
16,5,4,9,7,18,5,5,0,69
16,5,4,9,7,18,5,5,4,73
16,5,4,9,7,18,5,5,19,88
16,5,4,9,13,1,14,5,0,67
16,5,4,9,13,5,14,20,0,86
16,5,4,9,13,5,14,20,19,105
16,5,4,9,15,14,0,0,0,63
16,5,4,9,16,1,12,16,0,79
16,5,4,9,16,1,12,16,19,98
16,5,4,9,23,1,11,0,0,69
16,5,4,12,1,18,0,0,0,56
16,5,4,12,1,18,25,0,0,81
16,5,4,12,1,18,9,5,19,89
16,5,4,12,1,18,19,0,0,75
16,5,4,12,5,18,0,0,0,60
16,5,4,12,5,18,25,0,0,85
16,5,4,12,5,18,9,5,19,93
16,5,4,12,5,18,19,0,0,79
16,5,4,15,3,1,12,0,0,56
16,5,4,15,3,1,12,9,3,68
16,5,4,15,3,1,12,19,0,75
16,5,4,15,7,5,14,9,3,78
16,5,4,15,7,18,1,16,8,90
16,5,4,15,12,15,7,25,0,99
16,5,4,15,12,15,7,9,3,86
16,5,4,15,13,1,14,3,25,96
16,5,4,15,13,1,14,9,1,78
16,5,4,15,13,5,20,5,18,101
16,5,4,15,13,15,20,15,18,121
16,5,4,15,16,8,9,12,5,90
16,5,4,15,20,18,9,2,5,94
16,5,4,18,1,9,12,0,0,65
16,5,4,18,5,7,1,12,0,68
16,5,4,18,5,18,15,0,0,81
16,5,4,18,15,19,0,0,0,77
16,5,4,19,0,0,0,0,0,44
16,5,4,21,12,5,0,0,0,63
16,5,4,21,13,0,0,0,0,59
16,5,4,21,14,3,12,5,0,80
16,5,4,21,14,3,12,5,4,84
16,5,4,21,14,3,12,5,19,99
16,5,4,21,14,3,21,12,9,105
16,5,5,0,0,0,0,0,0,26
16,5,5,2,5,5,14,0,0,52
16,5,5,2,5,5,14,19,0,71
16,5,5,4,0,0,0,0,0,30
16,5,5,9,14,7,0,0,0,56
16,5,5,11,0,0,0,0,0,37
16,5,5,11,1,2,15,15,0,70
16,5,5,11,1,2,15,15,19,89
16,5,5,11,5,0,0,0,0,42
16,5,5,11,5,4,0,0,0,46
16,5,5,11,9,14,7,0,0,67
16,5,5,11,19,0,0,0,0,56
16,5,5,12,1,2,12,5,0,58
16,5,5,12,3,18,15,23,0,97
16,5,5,12,5,4,0,0,0,47
16,5,5,12,5,18,0,0,0,61
16,5,5,12,5,18,19,0,0,80
16,5,5,12,8,15,21,19,5,106
16,5,5,12,9,14,7,0,0,68
16,5,5,12,9,14,7,19,0,87
16,5,5,12,13,1,14,0,0,66
16,5,5,12,19,0,0,0,0,57
16,5,5,14,0,0,0,0,0,40
16,5,5,14,5,4,0,0,0,49
16,5,5,14,7,5,0,0,0,52
16,5,5,14,9,14,7,0,0,70
16,5,5,14,19,0,0,0,0,59
16,5,5,15,25,0,0,0,0,66
16,5,5,16,0,0,0,0,0,42
16,5,5,16,5,4,0,0,0,51
16,5,5,16,5,25,5,0,0,77
16,5,5,16,5,18,0,0,0,65
16,5,5,16,5,18,19,0,0,84
16,5,5,16,8,15,12,5,0,82
16,5,5,16,8,15,12,5,19,101
16,5,5,16,25,0,0,0,0,67
16,5,5,16,9,14,7,0,0,72
16,5,5,16,19,0,0,0,0,61
16,5,5,16,19,8,15,23,0,107
16,5,5,16,19,8,15,23,19,126
16,5,5,16,21,12,0,0,0,75
16,5,5,16,21,12,19,0,0,94
16,5,5,18,1,7,5,0,0,57
16,5,5,18,1,7,5,19,0,76
16,5,5,18,4,15,13,0,0,76
16,5,5,18,5,4,0,0,0,53
16,5,5,18,5,19,19,0,0,87
16,5,5,18,5,19,19,5,19,111
16,5,5,18,8,15,15,4,0,86
16,5,5,18,9,5,0,0,0,58
16,5,5,18,9,5,19,0,0,77
16,5,5,18,9,14,7,0,0,74
16,5,5,18,9,14,7,12,25,111
16,5,5,18,12,25,0,0,0,81
16,5,5,18,12,9,14,7,0,86
16,5,5,18,19,8,9,16,0,96
16,5,5,18,20,0,0,0,0,64
16,5,5,19,0,0,0,0,0,45
16,5,5,19,1,19,8,0,0,73
16,5,5,19,5,23,5,5,16,99
16,5,5,19,15,18,5,8,0,91
16,5,5,19,23,5,5,16,0,94
16,5,5,19,23,5,5,16,19,113
16,5,5,20,23,5,5,20,0,99
16,5,5,20,23,5,5,20,19,118
16,5,5,22,5,0,0,0,0,53
16,5,5,22,5,4,0,0,0,57
16,5,5,22,5,4,12,25,0,94
16,5,5,22,5,18,19,0,0,90
16,5,5,22,5,19,0,0,0,72
16,5,5,22,9,14,7,0,0,78
16,5,5,22,9,19,8,0,0,84
16,5,5,22,9,19,8,12,25,121
16,5,5,23,5,5,0,0,0,59
16,5,5,23,5,5,16,0,0,75
16,5,5,23,5,5,19,0,0,78
16,5,5,23,9,20,0,0,0,78
16,5,5,23,9,20,19,0,0,97
16,5,7,1,4,15,18,0,0,66
16,5,7,1,12,12,0,0,0,53
16,5,7,1,13,15,9,4,0,70
16,5,7,1,14,9,20,5,0,77
16,5,7,1,19,15,9,4,0,76
16,5,7,2,15,1,18,4,0,68
16,5,7,2,15,1,18,4,19,87
16,5,7,2,15,24,0,0,0,69
16,5,7,2,15,24,5,19,0,93
16,5,7,7,5,4,0,0,0,44
16,5,7,7,5,18,0,0,0,58
16,5,7,7,25,13,1,19,20,113
16,5,7,7,9,14,7,0,0,65
16,5,7,7,12,5,0,0,0,52
16,5,7,8,0,0,0,0,0,36
16,5,7,12,5,7,7,5,4,68
16,5,7,12,5,19,19,0,0,83
16,5,7,12,5,20,0,0,0,65
16,5,7,12,9,11,5,0,0,65
16,5,7,13,1,14,0,0,0,56
16,5,7,13,1,20,9,20,5,96
16,5,7,13,1,20,9,26,5,102
16,5,7,13,1,20,15,9,4,90
16,5,7,13,5,14,0,0,0,60
16,5,7,15,12,15,7,25,0,102
16,5,7,15,13,1,14,3,25,99
16,5,7,15,24,25,12,0,0,104
16,5,7,18,15,15,20,19,0,115
16,5,7,19,0,0,0,0,0,47
16,5,7,20,15,16,19,0,0,98
16,5,7,23,15,15,4,0,0,85
16,5,8,15,0,0,0,0,0,44
16,5,8,19,0,0,0,0,0,48
16,5,9,7,14,15,9,18,0,93
16,5,9,7,14,15,9,18,19,112
16,5,9,11,20,8,1,0,0,70
16,5,9,14,0,0,0,0,0,44
16,5,9,14,5,0,0,0,0,49
16,5,9,14,5,4,0,0,0,53
16,5,9,14,9,14,7,0,0,74
16,5,9,14,19,0,0,0,0,63
16,5,25,15,20,5,0,0,0,86
16,5,25,15,20,5,19,0,0,105
16,5,25,15,20,25,12,0,0,118
16,5,25,15,20,25,12,19,0,137
16,5,25,15,20,9,19,13,0,122
16,5,25,15,20,12,0,0,0,93
16,5,25,15,20,12,19,0,0,112
16,5,9,18,1,19,20,9,3,100
16,5,9,19,1,7,5,0,0,62
16,5,9,19,1,14,20,0,0,84
16,5,9,19,5,0,0,0,0,54
16,5,9,19,5,4,0,0,0,58
16,5,9,19,5,18,0,0,0,72
16,5,9,19,5,19,0,0,0,73
16,5,9,19,9,14,7,0,0,79
16,5,25,20,18,1,12,0,0,97
16,5,25,20,18,1,12,19,0,116
16,5,9,20,18,5,12,0,0,85
16,5,25,20,18,5,12,0,0,101
16,5,25,20,18,5,12,19,0,120
16,5,9,24,5,18,5,0,0,82
16,5,9,24,5,18,5,25,0,107
16,5,9,26,5,0,0,0,0,61
16,5,10,5,18,18,5,25,0,102
16,5,10,15,18,1,20,5,0,90
16,5,10,15,18,9,19,13,0,105
16,5,10,15,18,9,19,20,0,112
16,5,10,15,18,9,20,25,0,118
16,5,11,1,14,0,0,0,0,47
16,5,11,1,14,19,0,0,0,66
16,5,11,5,0,0,0,0,0,37
16,5,11,5,19,0,0,0,0,56
16,5,11,9,14,19,0,0,0,74
16,5,11,15,5,0,0,0,0,52
16,5,11,15,5,19,0,0,0,71
16,5,12,1,4,5,0,0,0,43
16,5,12,1,4,9,3,0,0,50
16,5,12,1,4,15,0,0,0,53
16,5,12,1,4,15,18,5,0,76
16,5,12,1,7,5,19,0,0,65
16,5,12,1,7,9,1,12,0,63
16,5,12,1,7,9,3,0,0,53
16,5,12,1,7,18,1,0,0,60
16,5,12,1,13,25,4,0,0,76
16,5,12,1,14,15,19,0,0,82
16,5,12,1,18,7,9,3,0,71
16,5,12,5,1,14,0,0,0,53
16,5,12,5,3,1,14,0,0,56
16,5,12,5,3,25,16,15,4,101
16,5,12,5,3,15,9,4,0,69
16,5,12,5,12,9,20,8,0,87
16,5,12,5,12,9,21,0,0,80
16,5,12,5,14,7,0,0,0,59
16,5,12,5,18,9,14,0,0,79
16,5,12,5,18,9,14,5,0,84
16,5,12,5,18,9,14,5,19,103
16,5,12,5,19,0,0,0,0,57
16,5,12,5,20,18,5,0,0,81
16,5,12,6,0,0,0,0,0,39
16,5,12,6,19,0,0,0,0,58
16,5,12,9,3,1,14,0,0,60
16,5,12,9,3,1,14,18,25,103
16,5,12,9,3,1,14,19,0,79
16,5,12,9,3,11,0,0,0,56
16,5,12,9,11,1,9,0,0,63
16,5,12,9,11,5,0,0,0,58
16,5,12,9,15,13,0,0,0,70
16,5,12,9,15,13,1,0,0,71
16,5,12,9,15,19,9,19,0,104
16,5,12,9,19,19,5,0,0,85
16,5,12,9,19,19,5,19,0,104
16,5,12,9,20,5,0,0,0,67
16,5,12,9,20,5,19,0,0,86
16,5,12,9,20,9,3,0,0,74
16,5,12,12,1,7,5,0,0,58
16,5,12,12,1,7,18,1,0,72
16,5,12,12,1,7,18,1,19,91
16,5,12,12,1,7,18,9,3,83
16,5,12,12,1,7,18,9,14,94
16,5,12,12,1,18,0,0,0,64
16,5,12,12,1,18,4,0,0,68
16,5,12,12,1,19,0,0,0,65
16,5,12,12,1,20,5,0,0,71
16,5,12,12,1,20,9,15,14,104
16,5,12,12,5,11,1,18,0,80
16,5,12,12,5,18,0,0,0,68
16,5,12,12,5,20,1,12,0,83
16,5,12,12,5,20,5,4,0,79
16,5,12,12,5,20,25,0,0,95
16,5,12,12,5,20,9,14,7,100
16,5,12,12,5,20,9,26,5,110
16,5,12,12,5,20,19,0,0,89
16,5,12,12,9,3,12,5,0,74
16,5,12,12,9,3,12,5,19,93
16,5,12,12,9,3,21,12,1,91
16,5,12,12,9,3,21,12,5,95
16,5,12,12,9,12,5,0,0,71
16,5,12,12,9,20,15,18,25,132
16,5,12,12,13,5,12,12,0,87
16,5,12,12,13,5,12,12,19,106
16,5,12,12,15,3,11,0,0,74
16,5,12,12,15,20,9,14,0,103
16,5,12,12,15,20,9,14,5,108
16,5,12,12,21,3,5,14,20,108
16,5,12,12,21,3,9,4,0,82
16,5,12,13,1,20,1,0,0,68
16,5,12,13,1,20,9,3,0,79
16,5,12,13,5,20,0,0,0,71
16,5,12,13,5,20,19,0,0,90
16,5,12,15,2,1,20,9,4,84
16,5,12,15,4,25,20,9,4,110
16,5,12,15,9,4,0,0,0,61
16,5,12,15,14,0,0,0,0,62
16,5,12,15,18,9,1,0,0,76
16,5,12,15,18,9,1,14,0,90
16,5,12,15,18,9,1,19,0,95
16,5,12,15,18,9,1,20,5,101
16,5,12,15,18,9,3,0,0,78
16,5,12,15,18,9,19,13,0,107
16,5,12,15,18,9,26,5,0,106
16,5,12,15,18,9,26,5,4,110
16,5,12,15,18,21,19,0,0,106
16,5,12,15,18,21,19,5,19,130
16,5,12,15,20,1,0,0,0,69
16,5,12,15,20,15,14,0,0,97
16,5,12,20,0,0,0,0,0,53
16,5,12,20,1,0,0,0,0,54
16,5,12,20,1,5,0,0,0,59
16,5,12,20,1,19,20,0,0,93
16,5,12,20,1,19,20,19,0,112
16,5,12,20,1,20,5,0,0,79
16,5,12,20,1,20,5,4,0,83
16,5,12,20,1,20,5,12,25,116
16,5,12,20,1,20,9,15,14,112
16,5,12,20,5,4,0,0,0,62
16,5,12,20,5,18,0,0,0,76
16,5,12,20,5,18,5,4,0,85
16,5,12,20,5,18,5,18,0,99
16,5,12,20,5,18,19,0,0,95
16,5,12,20,9,6,15,18,13,114
16,5,12,20,9,14,7,0,0,83
16,5,12,20,9,14,7,12,25,120
16,5,12,20,9,19,8,0,0,89
16,5,12,20,12,5,19,19,0,108
16,5,12,20,18,25,0,0,0,96
16,5,12,20,18,9,5,19,0,104
16,5,12,20,19,0,0,0,0,72
16,5,12,21,0,0,0,0,0,54
16,5,12,21,4,15,0,0,0,73
16,5,12,21,18,5,0,0,0,77
16,5,12,22,5,19,0,0,0,79
16,5,12,22,9,3,0,0,0,67
16,5,12,22,9,3,19,0,0,86
16,5,12,22,9,6,15,18,13,116
16,5,12,22,9,19,0,0,0,83
16,5,12,22,9,19,5,19,0,107
16,5,13,2,9,14,1,19,0,79
16,5,13,9,3,1,14,0,0,61
16,5,13,9,3,1,14,19,0,80
16,5,13,13,9,3,1,14,0,74
16,5,13,13,9,3,1,14,19,93
16,5,13,15,12,9,14,5,0,89
16,5,13,15,12,9,14,5,19,108
16,5,13,16,8,9,7,21,19,114
16,5,13,16,8,9,24,0,0,91
16,5,13,16,8,9,24,5,19,115
16,5,14,1,3,21,20,5,0,85
16,5,14,1,12,0,0,0,0,48
16,5,14,1,12,9,19,5,0,81
16,5,14,1,12,9,19,5,4,85
16,5,14,1,12,9,19,5,19,100
16,5,14,1,12,9,19,20,0,96
16,5,14,1,12,9,20,25,0,102
16,5,14,1,12,9,26,5,0,88
16,5,14,1,12,9,26,5,4,92
16,5,14,1,12,9,26,5,19,107
16,5,14,1,12,12,25,0,0,85
16,5,14,1,12,20,25,0,0,93
16,5,14,1,12,20,9,5,19,101
16,5,14,1,14,3,5,0,0,58
16,5,14,1,14,3,5,4,0,62
16,5,14,1,14,3,5,18,0,76
16,5,14,1,14,3,5,19,0,77
16,5,14,1,14,3,25,0,0,78
16,5,14,1,14,3,9,14,7,83
16,5,14,1,14,7,19,0,0,76
16,5,14,1,18,9,1,0,0,64
16,5,14,2,1,18,4,0,0,60
16,5,14,3,1,20,9,20,5,93
16,5,14,3,5,25,0,0,0,68
16,5,14,3,5,12,0,0,0,55
16,5,14,3,5,12,5,19,19,98
16,5,14,3,5,12,19,0,0,74
16,5,14,3,8,1,14,20,0,81
16,5,14,3,8,1,14,20,19,100
16,5,14,3,8,5,0,0,0,51
16,5,14,3,8,21,20,5,0,92
16,5,14,3,9,12,0,0,0,59
16,5,14,3,9,12,5,4,0,68
16,5,14,3,9,12,5,18,0,82
16,5,14,3,9,12,5,18,19,101
16,5,14,3,9,12,9,14,7,89
16,5,14,3,9,12,12,5,4,80
16,5,14,3,9,12,12,5,18,94
16,5,14,3,9,12,18,25,0,102
16,5,14,3,9,12,19,0,0,78
16,5,14,3,12,5,18,11,0,84
16,5,14,3,18,1,6,20,0,83
16,5,14,4,0,0,0,0,0,39
16,5,14,4,1,0,0,0,0,40
16,5,14,4,1,6,12,5,24,87
16,5,14,4,1,14,20,0,0,74
16,5,14,4,1,14,20,5,4,83
16,5,14,4,1,14,20,19,0,93
16,5,14,4,1,20,9,22,5,96
16,5,14,4,5,4,0,0,0,48
16,5,14,4,5,14,3,25,0,86
16,5,14,4,5,14,19,0,0,77
16,5,14,4,5,14,20,0,0,78
16,5,14,4,5,14,20,5,0,83
16,5,14,4,5,14,20,12,25,115
16,5,14,4,5,14,20,19,0,97
16,5,14,4,9,3,12,5,0,68
16,5,14,4,9,3,12,5,18,86
16,5,14,4,9,14,7,0,0,69
16,5,14,4,12,5,0,0,0,56
16,5,14,4,14,0,0,0,0,53
16,5,14,4,15,13,0,0,0,67
16,5,14,4,19,0,0,0,0,58
16,5,14,4,21,12,1,14,20,107
16,5,14,4,21,12,1,18,0,91
16,5,14,4,21,12,1,20,5,98
16,5,14,4,21,12,5,0,0,77
16,5,14,4,21,12,9,14,5,100
16,5,14,4,21,12,15,21,19,127
16,5,14,4,21,12,21,13,0,106
16,5,14,4,21,12,21,13,19,125
16,5,14,5,3,20,15,13,25,116
16,5,14,5,9,4,0,0,0,53
16,5,14,5,16,12,1,9,14,92
16,5,14,5,16,12,1,14,5,88
16,5,14,5,19,0,0,0,0,59
16,5,14,5,19,20,0,0,0,79
16,5,14,5,20,18,1,12,0,91
16,5,14,5,20,18,1,14,20,113
16,5,14,5,20,18,1,20,5,104
16,5,14,6,15,12,4,0,0,72
16,5,14,6,21,12,0,0,0,74
16,5,14,7,0,0,0,0,0,42
16,5,14,7,8,21,12,21,0,104
16,5,14,7,15,0,0,0,0,57
16,5,14,7,15,19,0,0,0,76
16,5,14,7,21,9,14,0,0,86
16,5,14,7,21,9,14,19,0,105
16,5,14,7,21,14,0,0,0,77
16,5,14,8,5,1,4,0,0,53
16,5,14,8,15,12,4,5,18,97
16,5,14,9,1,12,0,0,0,57
16,5,14,9,2,12,5,0,0,63
16,5,14,9,3,9,12,0,0,68
16,5,14,9,3,9,12,19,0,87
16,5,14,9,4,5,0,0,0,53
16,5,14,9,12,5,0,0,0,61
16,5,14,9,12,12,9,15,14,106
16,5,14,9,14,20,9,13,5,105
16,5,14,9,19,0,0,0,0,63
16,5,14,9,19,5,19,0,0,87
16,5,14,9,19,20,15,14,5,117
16,5,14,9,20,5,14,3,5,91
16,5,14,9,20,5,14,3,25,111
16,5,14,9,20,5,14,20,0,103
16,5,14,9,20,5,14,20,19,122
16,5,14,9,20,9,19,0,0,92
16,5,14,11,0,0,0,0,0,46
16,5,14,11,5,5,16,5,18,95
16,5,14,11,14,9,6,5,0,80
16,5,14,11,14,9,22,5,19,115
16,5,14,12,9,7,8,20,0,91
16,5,14,12,9,7,8,20,19,110
16,5,14,12,9,11,5,0,0,72
16,5,14,12,9,20,5,0,0,81
16,5,14,12,9,20,5,19,0,100
16,5,14,12,15,16,0,0,0,78
16,5,14,13,1,11,5,18,0,83
16,5,14,13,1,11,9,14,7,90
16,5,14,13,1,19,20,5,18,111
16,5,14,13,5,14,0,0,0,67
16,5,14,14,1,5,0,0,0,55
16,5,14,14,1,7,5,0,0,62
16,5,14,14,1,13,5,0,0,68
16,5,14,14,1,13,5,19,0,87
16,5,14,14,1,14,20,0,0,84
16,5,14,14,1,14,20,19,0,103
16,5,14,14,1,20,5,0,0,75
16,5,14,14,1,20,5,4,0,79
16,5,14,14,5,4,0,0,0,58
16,5,14,14,5,5,3,8,0,70
16,5,14,14,5,5,3,11,0,73
16,5,14,14,5,18,0,0,0,72
16,5,14,14,5,18,19,0,0,91
16,5,14,14,5,20,0,0,0,74
16,5,14,14,9,1,0,0,0,59
16,5,14,14,25,2,9,18,4,107
16,5,14,14,9,5,4,0,0,67
16,5,14,14,9,5,19,0,0,82
16,5,14,14,9,6,15,18,13,110
16,5,14,14,25,8,15,12,5,114
16,5,14,14,25,12,1,14,4,105
16,5,14,14,25,12,5,1,6,98
16,5,14,14,9,12,5,19,19,113
16,5,14,14,9,12,12,0,0,82
16,5,14,14,9,14,5,0,0,77
16,5,14,14,9,14,7,0,0,79
16,5,14,14,9,14,9,20,5,106
16,5,14,14,25,18,15,20,0,127
16,5,14,14,9,19,0,0,0,77
16,5,14,14,25,23,9,19,5,130
16,5,14,14,25,23,15,18,20,150
16,5,14,14,15,14,0,0,0,78
16,5,14,14,15,14,3,5,12,98
16,5,14,14,15,14,5,4,0,87
16,5,14,14,15,14,19,0,0,97
16,5,14,14,15,18,20,8,0,110
16,5,14,14,21,3,11,12,5,101
16,5,14,15,3,8,5,0,0,66
16,5,14,15,3,8,5,19,0,85
16,5,14,15,3,8,9,0,0,70
16,5,14,15,12,15,7,25,0,109
16,5,14,15,12,15,7,9,3,96
16,5,14,15,14,3,5,12,0,84
16,5,14,15,14,3,5,12,19,103
16,5,14,15,18,3,15,14,0,100
16,5,14,15,21,14,0,0,0,85
16,5,14,16,15,9,14,20,0,109
16,5,14,16,15,9,14,20,19,128
16,5,14,16,21,19,8,5,18,122
16,5,14,18,1,3,11,0,0,68
16,5,14,19,0,0,0,0,0,54
16,5,14,19,3,18,9,16,20,120
16,5,14,19,5,0,0,0,0,59
16,5,14,19,5,5,0,0,0,64
16,5,14,19,5,6,21,12,0,98
16,5,14,19,5,18,15,19,15,126
16,5,14,19,8,9,16,0,0,87
16,5,14,19,25,0,0,0,0,79
16,5,14,19,9,12,0,0,0,75
16,5,14,19,9,12,5,0,0,80
16,5,14,19,9,12,9,20,25,129
16,5,14,19,9,12,19,0,0,94
16,5,14,19,9,15,14,0,0,92
16,5,14,19,9,15,14,1,20,113
16,5,14,19,9,15,14,5,0,97
16,5,14,19,9,15,14,5,4,101
16,5,14,19,9,15,14,5,18,115
16,5,14,19,9,15,14,5,19,116
16,5,14,19,9,15,14,18,25,135
16,5,14,19,9,15,14,19,0,111
16,5,14,19,9,22,5,0,0,90
16,5,14,19,9,22,5,4,0,94
16,5,14,19,9,22,5,12,25,127
16,5,14,19,20,5,13,15,14,121
16,5,14,19,20,5,18,0,0,97
16,5,14,19,20,5,18,19,0,116
16,5,14,19,20,9,3,11,0,97
16,5,14,19,20,15,3,11,0,103
16,5,14,19,20,15,3,11,19,122
16,5,14,19,21,13,0,0,0,88
16,5,14,20,1,0,0,0,0,56
16,5,14,20,1,3,5,0,0,64
16,5,14,20,1,3,9,4,0,72
16,5,14,20,1,3,12,5,0,76
16,5,14,20,1,3,12,5,19,95
16,5,14,20,1,3,18,15,14,106
16,5,14,20,1,4,0,0,0,60
16,5,14,20,1,4,9,3,0,72
16,5,14,20,1,4,19,0,0,79
16,5,14,20,1,6,9,4,0,75
16,5,14,20,1,7,25,14,0,102
16,5,14,20,1,7,12,15,20,110
16,5,14,20,1,7,15,14,19,111
16,5,14,20,1,7,18,1,13,95
16,5,14,20,1,7,18,9,4,94
16,5,14,20,1,9,12,0,0,77
16,5,14,20,1,12,15,7,25,115
16,5,14,20,1,12,16,8,1,93
16,5,14,20,1,13,5,18,25,117
16,5,14,20,1,14,4,5,18,97
16,5,14,20,1,14,5,0,0,75
16,5,14,20,1,14,5,19,0,94
16,5,14,20,1,14,7,12,5,94
16,5,14,20,1,14,15,9,3,97
16,5,14,20,1,14,15,12,0,97
16,5,14,20,1,14,15,14,5,104
16,5,14,20,1,16,15,4,25,116
16,5,14,20,1,17,21,9,14,117
16,5,14,20,1,18,3,8,0,85
16,5,14,20,1,18,3,8,25,110
16,5,14,20,1,18,3,8,19,104
16,5,14,20,1,19,20,15,13,123
16,5,14,20,1,20,15,14,5,110
16,5,14,20,1,20,18,15,14,123
16,5,14,20,5,14,5,0,0,79
16,5,14,20,5,14,5,19,0,98
16,5,14,20,8,15,21,19,5,123
16,5,14,20,8,18,9,20,0,110
16,5,14,20,8,18,9,20,5,115
16,5,14,20,9,3,5,0,0,72
16,5,14,20,9,3,12,5,0,84
16,5,14,20,25,12,0,0,0,92
16,5,14,20,25,12,5,14,5,116
16,5,14,20,25,12,9,3,0,104
16,5,14,20,25,12,19,0,0,111
16,5,14,20,9,14,5,0,0,83
16,5,14,20,25,14,5,0,0,99
16,5,14,20,9,20,0,0,0,84
16,5,14,20,9,20,5,0,0,89
16,5,14,20,9,20,15,12,0,111
16,5,14,20,15,4,5,0,0,79
16,5,14,20,15,4,5,19,0,98
16,5,14,20,15,9,3,0,0,82
16,5,14,20,15,12,0,0,0,82
16,5,14,20,15,12,9,20,5,116
16,5,14,20,15,13,9,3,0,95
16,5,14,20,15,19,1,14,0,104
16,5,14,20,15,19,1,14,5,109
16,5,14,20,15,19,1,14,19,123
16,5,14,20,15,19,5,0,0,94
16,5,14,20,15,19,5,19,0,113
16,5,14,20,15,19,9,4,0,102
16,5,14,20,15,19,9,4,5,107
16,5,14,20,15,24,9,4,5,112
16,5,14,20,18,9,20,0,0,102
16,5,14,20,18,9,20,5,0,107
16,5,14,20,18,15,21,7,8,124
16,5,14,20,19,20,15,3,11,123
16,5,14,20,20,1,9,12,0,97
16,5,14,21,3,8,5,0,0,72
16,5,14,21,3,8,5,19,0,91
16,5,14,21,3,8,9,0,0,76
16,5,14,21,3,8,9,19,0,95
16,5,14,21,3,8,12,5,0,84
16,5,14,21,3,8,12,5,19,103
16,5,14,21,3,11,12,5,0,87
16,5,14,21,3,11,12,5,19,106
16,5,14,21,12,20,0,0,0,88
16,5,14,21,12,20,9,13,0,110
16,5,14,21,12,20,9,13,1,111
16,5,14,21,12,20,19,0,0,107
16,5,14,21,13,2,18,1,0,90
16,5,14,21,13,2,18,1,5,95
16,5,14,21,13,2,18,1,12,102
16,5,14,21,13,2,18,1,19,109
16,5,14,21,16,0,0,0,0,72
16,5,14,21,18,25,0,0,0,99
16,5,14,21,18,9,5,19,0,107
16,5,14,21,18,9,15,21,19,138
16,5,14,23,9,16,5,18,0,106
16,5,14,23,15,13,1,14,0,101
16,5,14,23,15,13,5,14,0,105
16,5,14,23,15,18,11,5,18,125
16,5,14,23,18,9,7,8,20,120
16,5,15,14,0,0,0,0,0,50
16,5,15,14,1,7,5,0,0,63
16,5,15,14,1,7,5,19,0,82
16,5,15,14,5,19,0,0,0,74
16,5,15,14,9,5,19,0,0,83
16,5,15,14,9,19,13,0,0,91
16,5,15,14,9,19,13,19,0,110
16,5,15,14,9,26,5,0,0,90
16,5,15,14,19,0,0,0,0,69
16,5,15,16,12,5,0,0,0,69
16,5,15,16,12,5,4,0,0,73
16,5,15,16,12,5,4,15,13,101
16,5,15,16,12,5,9,26,5,109
16,5,15,16,12,5,18,0,0,87
16,5,15,16,12,5,18,19,0,106
16,5,15,16,12,5,20,0,0,89
16,5,15,16,12,9,14,7,0,94
16,5,15,16,12,9,19,8,0,100
16,5,15,20,15,13,25,0,0,109
16,5,16,5,18,5,11,0,0,76
16,5,16,5,18,9,14,5,0,88
16,5,16,5,18,9,14,15,0,98
16,5,16,5,18,15,14,9,0,98
16,5,16,5,18,15,14,9,19,117
16,5,16,6,21,12,0,0,0,76
16,5,16,9,14,5,12,12,1,90
16,5,16,9,14,15,0,0,0,75
16,5,16,9,14,15,19,0,0,94
16,5,16,12,1,0,0,0,0,50
16,5,16,12,5,19,19,0,0,92
16,5,16,12,15,19,0,0,0,83
16,5,16,12,15,19,5,4,0,92
16,5,16,12,15,19,5,19,0,107
16,5,16,12,21,13,0,0,0,83
16,5,16,12,21,13,5,4,0,92
16,5,16,12,21,13,19,0,0,102
16,5,16,12,21,19,0,0,0,89
16,5,16,12,21,19,5,19,0,113
16,5,16,15,0,0,0,0,0,52
16,5,16,15,14,9,4,0,0,79
16,5,16,15,14,9,4,1,0,80
16,5,16,15,14,9,4,1,19,99
16,5,16,15,14,9,21,13,0,109
16,5,16,15,14,9,21,13,19,128
16,5,16,15,19,0,0,0,0,71
16,5,16,16,5,4,0,0,0,62
16,5,16,16,5,18,2,15,24,117
16,5,16,16,5,18,5,4,0,85
16,5,16,16,5,18,5,18,0,99
16,5,16,16,5,18,5,18,19,118
16,5,16,16,5,18,25,0,0,101
16,5,16,16,5,18,9,12,25,122
16,5,16,16,5,18,9,14,7,106
16,5,16,16,5,18,9,19,8,112
16,5,16,16,5,18,15,14,9,114
16,5,16,16,5,18,19,0,0,95
16,5,16,16,9,5,18,0,0,85
16,5,16,16,9,5,19,20,0,106
16,5,16,16,9,12,25,0,0,99
16,5,16,16,9,14,0,0,0,76
16,5,16,16,9,14,5,19,19,119
16,5,16,16,9,14,7,0,0,83
16,5,16,19,0,0,0,0,0,56
16,5,16,19,9,14,0,0,0,79
16,5,16,19,9,14,1,20,5,105
16,5,16,19,9,14,5,0,0,84
16,5,16,19,9,14,5,19,0,103
16,5,16,19,9,14,19,0,0,98
16,5,16,19,9,19,0,0,0,84
16,5,16,20,9,3,0,0,0,69
16,5,16,20,9,3,1,12,0,82
16,5,16,20,9,3,9,20,25,123
16,5,16,20,9,3,19,0,0,88
16,5,16,20,9,4,0,0,0,70
16,5,16,20,9,4,1,19,5,95
16,5,16,20,9,4,5,0,0,75
16,5,16,20,9,4,5,19,0,94
16,5,16,20,9,4,9,3,0,82
16,5,16,20,9,4,19,0,0,89
16,5,16,20,9,26,5,0,0,97
16,5,16,20,9,26,5,4,0,101
16,5,16,20,9,26,5,18,0,115
16,5,16,20,9,26,5,18,19,134
16,5,16,20,9,26,5,19,0,116
16,5,16,20,9,26,9,14,7,122
16,5,16,20,15,7,5,14,0,98
16,5,16,20,15,7,5,14,25,123
16,5,16,20,15,14,1,20,5,112
16,5,16,20,15,14,5,0,0,91
16,5,16,20,15,14,5,19,0,110
16,5,16,20,15,14,9,3,0,98
16,5,16,20,15,14,9,19,5,119
16,5,16,20,15,14,9,26,5,126
16,5,16,20,15,14,15,9,4,114
16,5,18,1,3,5,20,9,3,80
16,5,18,1,3,9,4,0,0,56
16,5,18,1,3,9,4,19,0,75
16,5,18,1,3,20,0,0,0,63
16,5,18,1,3,21,20,5,0,89
16,5,18,1,7,18,1,20,5,91
16,5,18,1,9,0,0,0,0,49
16,5,18,1,13,2,12,5,0,72
16,5,18,1,21,0,0,0,0,61
16,5,18,2,5,14,4,0,0,64
16,5,18,2,15,18,1,20,5,100
16,5,18,2,15,18,1,24,0,99
16,5,18,3,1,12,5,0,0,60
16,5,18,3,1,12,5,19,0,79
16,5,18,3,1,12,9,14,5,83
16,5,18,3,1,19,5,0,0,67
16,5,18,3,5,1,14,20,0,82
16,5,18,3,5,9,22,5,0,83
16,5,18,3,5,9,22,5,4,87
16,5,18,3,5,9,22,5,18,101
16,5,18,3,5,9,22,5,19,102
16,5,18,3,5,14,20,0,0,81
16,5,18,3,5,14,20,1,12,94
16,5,18,3,5,14,20,5,18,104
16,5,18,3,5,14,20,19,0,100
16,5,18,3,5,14,20,21,13,115
16,5,18,3,5,16,20,0,0,83
16,5,18,3,5,16,20,19,0,102
16,5,18,3,5,16,20,21,13,117
16,5,18,3,8,0,0,0,0,50
16,5,18,3,8,1,0,0,0,51
16,5,18,3,8,1,2,12,5,70
16,5,18,3,8,1,14,3,5,73
16,5,18,3,8,5,4,0,0,59
16,5,18,3,8,5,18,0,0,73
16,5,18,3,8,5,18,19,0,92
16,5,18,3,8,5,19,0,0,74
16,5,18,3,8,9,14,7,0,80
16,5,18,3,9,4,0,0,0,55
16,5,18,3,9,6,15,18,13,103
16,5,18,3,25,12,9,20,5,113
16,5,18,3,9,16,9,0,0,76
16,5,18,3,12,15,19,5,0,93
16,5,18,3,15,3,20,0,0,80
16,5,18,3,15,9,4,0,0,70
16,5,18,3,15,9,4,19,0,89
16,5,18,3,15,12,1,20,5,95
16,5,18,3,21,18,0,0,0,81
16,5,18,3,21,19,19,0,0,101
16,5,18,3,21,19,19,5,4,110
16,5,18,3,21,19,19,5,19,125
16,5,18,3,21,19,19,15,18,134
16,5,18,4,5,14,4,15,0,81
16,5,18,4,25,0,0,0,0,68
16,5,18,4,9,3,9,14,5,83
16,5,18,4,9,5,0,0,0,57
16,5,18,4,9,6,15,9,12,94
16,5,18,4,9,6,21,13,5,97
16,5,18,4,9,20,0,0,0,72
16,5,18,4,9,20,9,15,14,110
16,5,18,4,18,9,7,15,14,106
16,5,18,4,18,9,24,0,0,94
16,5,18,4,21,5,0,0,0,69
16,5,18,4,21,5,19,0,0,88
16,5,18,4,21,18,1,14,20,117
16,5,18,4,21,18,5,0,0,87
16,5,18,4,21,18,5,4,0,91
16,5,18,4,21,18,5,19,0,106
16,5,18,4,21,18,9,14,7,112
16,5,18,4,21,19,0,0,0,83
16,5,18,5,0,0,0,0,0,44
16,5,18,5,1,0,0,0,0,45
16,5,18,5,7,18,9,14,0,92
16,5,18,5,7,18,9,14,1,93
16,5,18,5,7,18,9,14,19,111
16,5,18,5,9,1,0,0,0,54
16,5,18,5,9,15,14,0,0,82
16,5,18,5,9,15,16,15,4,103
16,5,18,5,9,18,9,14,5,99
16,5,18,5,10,15,14,5,20,108
16,5,18,5,13,16,20,0,0,93
16,5,18,5,14,4,21,18,5,106
16,5,18,5,14,14,1,20,5,98
16,5,18,5,14,14,9,1,12,94
16,5,18,5,14,14,9,20,25,126
16,5,18,5,15,14,0,0,0,73
16,5,18,5,15,16,15,4,0,94
16,5,18,5,18,18,1,20,5,106
16,5,18,5,19,0,0,0,0,63
16,5,18,5,21,14,4,5,13,101
16,5,18,5,26,15,14,5,0,104
16,5,18,6,0,0,0,0,0,45
16,5,18,6,1,25,0,0,0,71
16,5,18,6,5,3,20,1,0,74
16,5,18,6,5,3,20,1,19,93
16,5,18,6,5,3,20,5,4,82
16,5,18,6,5,3,20,5,18,96
16,5,18,6,5,3,20,9,0,82
16,5,18,6,5,3,20,12,25,110
16,5,18,6,5,3,20,15,0,88
16,5,18,6,5,3,20,15,18,106
16,5,18,6,5,3,20,15,19,107
16,5,18,6,5,3,20,19,0,92
16,5,18,6,5,18,22,9,4,103
16,5,18,6,5,18,22,15,18,123
16,5,18,6,9,4,25,0,0,83
16,5,18,6,9,4,9,5,19,91
16,5,18,6,9,14,0,0,0,68
16,5,18,6,9,14,19,0,0,87
16,5,18,6,9,24,0,0,0,78
16,5,18,6,12,1,2,12,5,77
16,5,18,6,12,1,20,5,0,83
16,5,18,6,12,21,5,14,20,117
16,5,18,6,15,18,1,14,20,113
16,5,18,6,15,18,1,20,5,104
16,5,18,6,15,18,3,5,0,86
16,5,18,6,15,18,13,0,0,91
16,5,18,6,15,18,13,5,4,100
16,5,18,6,15,18,13,5,18,114
16,5,18,6,15,18,13,19,0,110
16,5,18,6,21,13,5,0,0,84
16,5,18,6,21,13,5,4,0,88
16,5,18,6,21,13,5,18,0,102
16,5,18,6,21,13,5,18,25,127
16,5,18,6,21,13,5,18,19,121
16,5,18,6,21,13,5,19,0,103
16,5,18,6,21,13,25,0,0,104
16,5,18,6,21,13,9,14,7,109
16,5,18,6,21,19,1,20,5,111
16,5,18,6,21,19,5,0,0,90
16,5,18,6,21,19,5,4,0,94
16,5,18,6,21,19,5,19,0,109
16,5,18,6,21,19,9,14,7,115
16,5,18,6,21,19,9,15,14,123
16,5,18,6,21,19,9,22,5,121
16,5,18,7,1,13,25,14,0,99
16,5,18,7,15,12,1,0,0,74
16,5,18,7,15,12,1,19,0,93
16,5,18,7,21,14,14,1,8,104
16,5,18,8,0,0,0,0,0,47
16,5,18,8,1,12,9,4,5,78
16,5,18,8,1,16,19,0,0,83
16,5,18,8,1,16,19,5,19,107
16,5,18,8,1,26,1,18,4,97
16,5,18,8,25,4,18,15,12,121
16,5,18,9,1,3,20,21,19,112
16,5,18,9,1,14,1,12,0,76
16,5,18,9,1,14,20,8,0,91
16,5,18,9,1,14,20,8,19,110
16,5,18,9,1,16,20,0,0,85
16,5,18,9,1,16,20,19,0,104
16,5,18,9,1,18,5,21,13,106
16,5,18,9,1,19,20,5,18,111
16,5,18,9,1,19,20,18,1,107
16,5,18,9,1,21,7,5,18,100
16,5,18,9,1,24,9,1,12,95
16,5,18,9,2,12,1,19,20,102
16,5,18,9,2,12,5,13,0,80
16,5,18,9,2,12,5,13,19,99
16,5,18,9,2,15,12,9,0,86
16,5,18,9,2,15,12,15,9,101
16,5,18,9,2,15,12,15,19,111
16,5,18,9,2,15,12,21,19,117
16,5,18,9,3,1,18,16,0,86
16,5,18,9,3,1,18,16,19,105
16,5,18,9,3,5,3,1,12,72
16,5,18,9,3,8,5,20,5,89
16,5,18,9,3,8,15,18,4,96
16,5,18,9,3,8,20,9,1,89
16,5,18,9,3,25,3,12,5,96
16,5,18,9,3,12,1,19,5,88
16,5,18,9,3,12,9,14,5,91
16,5,18,9,3,15,16,1,5,88
16,5,18,9,3,15,16,1,12,95
16,5,18,9,3,15,16,5,0,87
16,5,18,9,3,15,16,5,19,106
16,5,18,9,3,15,16,9,3,94
16,5,18,9,3,21,12,21,13,118
16,5,18,9,4,5,18,13,0,88
16,5,18,9,4,5,18,13,19,107
16,5,18,9,4,5,19,13,0,89
16,5,18,9,4,9,1,0,0,62
16,5,18,9,4,9,1,12,0,74
16,5,18,9,4,9,12,1,0,74
16,5,18,9,4,9,14,9,4,88
16,5,18,9,4,9,15,12,1,89
16,5,18,9,4,9,15,12,5,93
16,5,18,9,4,9,21,13,0,95
16,5,18,9,4,15,20,9,3,99
16,5,18,9,4,15,20,19,0,106
16,5,18,9,4,18,15,13,5,103
16,5,18,9,5,18,7,25,0,103
16,5,18,9,7,5,1,12,0,73
16,5,18,9,7,5,1,14,0,75
16,5,18,9,7,5,5,0,0,65
16,5,18,9,7,5,5,19,0,84
16,5,18,9,7,5,21,13,0,94
16,5,18,9,7,25,14,25,0,119
16,5,18,9,7,12,9,1,12,89
16,5,18,9,7,12,15,5,1,88
16,5,18,9,7,15,14,0,0,84
16,5,18,9,7,15,14,1,12,97
16,5,18,9,7,15,14,5,0,89
16,5,18,9,7,15,14,9,1,94
16,5,18,9,7,15,14,19,0,103
16,5,18,9,7,18,1,16,8,98
16,5,18,9,8,5,12,9,1,83
16,5,18,9,10,15,22,5,0,100
16,5,18,9,11,1,18,25,1,104
16,5,18,9,12,0,0,0,0,60
16,5,18,9,12,5,4,0,0,69
16,5,18,9,12,25,13,16,8,122
16,5,18,9,12,9,14,7,0,90
16,5,18,9,12,12,1,19,0,92
16,5,18,9,12,12,5,4,0,81
16,5,18,9,12,12,5,19,19,115
16,5,18,9,12,12,9,14,7,102
16,5,18,9,12,15,2,1,18,96
16,5,18,9,12,15,21,19,0,115
16,5,18,9,12,19,0,0,0,79
16,5,18,9,12,19,15,13,5,112
16,5,18,9,12,21,14,5,0,100
16,5,18,9,12,21,14,5,19,119
16,5,18,9,13,5,20,5,18,109
16,5,18,9,13,5,20,18,25,129
16,5,18,9,13,25,19,9,1,115
16,5,18,9,13,15,18,16,8,118
16,5,18,9,14,1,5,21,13,102
16,5,18,9,14,1,20,1,12,96
16,5,18,9,14,4,5,0,0,71
16,5,18,9,14,5,0,0,0,67
16,5,18,9,14,5,1,0,0,68
16,5,18,9,14,5,1,12,0,80
16,5,18,9,14,5,21,13,0,101
16,5,18,9,14,9,21,13,0,105
16,5,18,9,15,4,0,0,0,67
16,5,18,9,15,4,1,20,5,93
16,5,18,9,15,4,9,3,0,79
16,5,18,9,15,4,9,4,0,80
16,5,18,9,15,4,9,4,5,85
16,5,18,9,15,4,9,4,19,99
16,5,18,9,15,4,9,26,5,107
16,5,18,9,15,4,19,0,0,86
16,5,18,9,15,5,3,9,3,83
16,5,18,9,15,5,3,9,4,84
16,5,18,9,15,5,3,21,19,111
16,5,18,9,15,9,11,15,9,107
16,5,18,9,15,14,25,24,0,126
16,5,18,9,15,16,12,5,0,96
16,5,18,9,15,16,12,9,3,103
16,5,18,9,15,16,20,9,3,111
16,5,18,9,15,17,21,5,0,106
16,5,18,9,15,18,1,12,0,94
16,5,18,9,15,18,2,9,20,112
16,5,18,9,15,19,20,0,0,102
16,5,18,9,15,19,20,5,1,108
16,5,18,9,15,20,9,3,0,95
16,5,18,9,16,5,20,25,0,114
16,5,18,9,16,5,20,9,1,99
16,5,18,9,16,8,5,18,25,120
16,5,18,9,16,8,25,19,5,121
16,5,18,9,16,12,1,19,13,109
16,5,18,9,16,12,1,19,20,116
16,5,18,9,16,12,21,19,0,116
16,5,18,9,16,15,12,1,18,110
16,5,18,9,16,18,15,3,20,120
16,5,18,9,16,20,5,18,0,107
16,5,18,9,16,20,5,18,25,132
16,5,18,9,16,20,5,18,19,126
16,5,18,9,17,21,5,0,0,91
16,5,18,9,17,21,5,19,0,110
16,5,18,9,18,5,14,1,12,98
16,5,18,9,18,25,18,12,5,126
16,5,18,9,19,0,0,0,0,67
16,5,18,9,19,1,18,3,0,89
16,5,18,9,19,1,18,3,19,108
16,5,18,9,19,3,9,1,14,94
16,5,18,9,19,3,9,9,0,88
16,5,18,9,19,3,15,16,5,106
16,5,18,9,19,8,0,0,0,75
16,5,18,9,19,8,5,4,0,84
16,5,18,9,19,8,5,18,0,98
16,5,18,9,19,8,5,18,19,117
16,5,18,9,19,8,5,19,0,99
16,5,18,9,19,8,9,14,7,105
16,5,18,9,19,15,13,1,0,96
16,5,18,9,19,15,13,1,12,108
16,5,18,9,19,15,13,5,0,100
16,5,18,9,19,16,5,18,13,119
16,5,18,9,19,16,15,13,5,116
16,5,18,9,19,16,15,18,5,121
16,5,18,9,19,19,1,4,0,91
16,5,18,9,19,20,5,12,5,109
16,5,18,9,19,20,25,12,5,129
16,5,18,9,19,20,15,12,5,119
16,5,18,9,19,20,15,13,1,116
16,5,18,9,19,20,15,13,5,120
16,5,18,9,20,0,0,0,0,68
16,5,18,9,20,3,9,1,0,81
16,5,18,9,20,5,0,0,0,73
16,5,18,9,20,5,14,15,14,116
16,5,18,9,20,8,5,3,5,89
16,5,18,9,20,12,9,1,0,90
16,5,18,9,20,15,13,25,0,121
16,5,18,9,20,15,14,5,1,103
16,5,18,9,20,18,1,3,11,101
16,5,18,9,20,18,5,13,1,105
16,5,18,9,20,18,5,13,5,109
16,5,18,9,20,18,9,3,8,106
16,5,18,9,20,18,15,3,8,112
16,5,18,9,20,21,18,1,0,108
16,5,18,9,23,9,7,0,0,87
16,5,18,9,23,9,7,19,0,106
16,5,18,10,9,14,11,0,0,83
16,5,18,10,9,14,11,12,25,120
16,5,18,10,21,18,5,0,0,93
16,5,18,10,21,18,5,4,0,97
16,5,18,10,21,18,5,18,0,111
16,5,18,10,21,18,5,18,19,130
16,5,18,10,21,18,5,19,0,112
16,5,18,10,21,18,5,19,19,131
16,5,18,10,21,18,25,0,0,113
16,5,18,10,21,18,9,5,19,121
16,5,18,10,21,18,9,14,7,118
16,5,18,10,21,18,15,21,19,143
16,5,18,11,0,0,0,0,0,50
16,5,18,11,5,4,0,0,0,59
16,5,18,11,25,0,0,0,0,75
16,5,18,11,9,5,18,0,0,82
16,5,18,11,9,5,19,20,0,103
16,5,18,11,9,12,25,0,0,96
16,5,18,11,9,14,5,19,19,116
16,5,18,11,9,14,7,0,0,80
16,5,18,11,9,14,7,12,25,117
16,5,18,11,9,14,9,19,13,114
16,5,18,11,9,19,8,0,0,86
16,5,18,11,14,9,20,5,0,98
16,5,18,12,1,20,9,22,5,108
16,5,18,12,5,3,8,5,0,72
16,5,18,12,9,4,0,0,0,64
16,5,18,12,9,14,7,0,0,81
16,5,18,12,9,20,5,0,0,85
16,5,18,12,9,20,5,19,0,104
16,5,18,12,9,20,9,3,0,92
16,5,18,12,15,9,18,0,0,93
16,5,18,13,1,14,5,14,20,106
16,5,18,13,1,20,18,15,14,120
16,5,18,13,5,1,2,12,5,77
16,5,18,13,5,1,2,12,25,97
16,5,18,13,5,1,14,3,5,80
16,5,18,13,5,1,14,20,0,92
16,5,18,13,5,1,19,5,0,82
16,5,18,13,5,1,19,5,19,101
16,5,18,13,5,1,20,5,0,83
16,5,18,13,5,1,20,5,4,87
16,5,18,13,5,1,20,5,19,102
16,5,18,13,5,1,20,15,18,111
16,5,18,13,5,4,0,0,0,61
16,5,18,13,9,14,7,0,0,82
16,5,18,13,9,14,22,1,18,116
16,5,18,13,9,19,19,0,0,99
16,5,18,13,9,20,0,0,0,81
16,5,18,13,9,20,19,0,0,100
16,5,18,13,9,20,20,5,4,110
16,5,18,13,9,20,20,5,5,111
16,5,18,13,9,20,20,5,18,124
16,5,18,13,9,24,0,0,0,85
16,5,18,13,9,24,5,4,0,94
16,5,18,13,19,0,0,0,0,71
16,5,18,13,21,20,1,20,5,119
16,5,18,13,21,20,5,0,0,98
16,5,18,13,21,20,5,4,0,102
16,5,18,13,21,20,5,18,0,116
16,5,18,13,21,20,5,19,0,117
16,5,18,13,21,20,9,14,7,123
16,5,18,14,0,0,0,0,0,53
16,5,18,14,1,14,3,25,0,96
16,5,18,14,1,19,1,12,0,86
16,5,18,14,5,1,0,0,0,59
16,5,18,14,5,12,0,0,0,70
16,5,18,14,25,3,8,9,1,99
16,5,18,14,9,3,9,15,14,103
16,5,18,14,25,9,0,0,0,87
16,5,18,14,9,14,5,0,0,81
16,5,18,14,9,15,0,0,0,77
16,5,18,14,9,20,18,9,3,112
16,5,18,14,15,18,0,0,0,86
16,5,18,15,2,1,0,0,0,57
16,5,18,15,12,9,1,18,25,119
16,5,18,15,13,5,12,21,19,124
16,5,18,15,14,1,20,5,0,94
16,5,18,15,14,5,0,0,0,73
16,5,18,15,14,5,1,12,0,86
16,5,18,15,14,5,9,0,0,82
16,5,18,15,14,5,21,19,0,113
16,5,18,15,14,9,1,12,0,90
16,5,18,15,14,9,21,13,0,111
16,5,18,15,14,14,5,9,0,96
16,5,18,15,16,15,4,0,0,89
16,5,18,15,16,21,19,0,0,110
16,5,18,15,18,1,12,0,0,85
16,5,18,15,18,1,12,12,25,122
16,5,18,15,18,1,20,5,0,98
16,5,18,15,18,1,20,5,4,102
16,5,18,15,18,1,20,5,19,117
16,5,18,15,18,1,20,15,18,126
16,5,18,15,19,5,19,0,0,97
16,5,18,15,19,9,19,0,0,101
16,5,18,15,19,13,1,20,5,112
16,5,18,15,19,13,9,3,0,98
16,5,18,15,19,15,13,21,19,141
16,5,18,15,20,9,3,0,0,86
16,5,18,15,24,25,0,0,0,103
16,5,18,15,24,9,4,0,0,91
16,5,18,15,24,9,4,5,0,96
16,5,18,15,24,9,4,5,4,100
16,5,18,15,24,9,4,5,19,115
16,5,18,15,24,9,4,9,3,103
16,5,18,15,24,9,4,19,0,110
16,5,18,15,24,25,12,0,0,115
16,5,18,15,26,15,14,9,4,122
16,5,18,16,0,0,0,0,0,55
16,5,18,16,5,14,4,0,0,78
16,5,18,16,5,14,4,5,4,87
16,5,18,16,5,14,4,19,0,97
16,5,18,16,5,14,19,5,0,98
16,5,18,16,5,14,20,0,0,94
16,5,18,16,5,14,20,19,0,113
16,5,18,16,5,18,1,0,0,79
16,5,18,16,5,20,0,0,0,80
16,5,18,16,5,20,21,1,12,114
16,5,18,16,5,20,21,21,13,135
16,5,18,16,12,5,24,0,0,96
16,5,18,16,12,5,24,5,4,105
16,5,18,16,12,5,24,5,18,119
16,5,18,16,12,5,24,5,19,120
16,5,18,17,21,5,5,18,0,105
16,5,18,17,21,5,9,18,0,109
16,5,18,17,21,5,19,20,0,121
16,5,18,18,1,4,9,1,12,84
16,5,18,18,1,4,9,21,19,111
16,5,18,18,5,9,1,0,0,72
16,5,18,18,9,5,18,0,0,89
16,5,18,18,9,5,19,0,0,90
16,5,18,18,15,14,19,0,0,105
16,5,18,18,15,17,21,5,20,135
16,5,18,18,21,3,8,5,0,94
16,5,18,18,21,11,5,18,25,137
16,5,18,18,21,17,21,5,0,121
16,5,18,19,1,12,20,0,0,91
16,5,18,19,1,12,20,19,0,110
16,5,18,19,3,5,14,20,0,100
16,5,18,19,3,18,9,2,5,95
16,5,18,19,5,3,21,20,5,112
16,5,18,19,5,9,20,5,0,97
16,5,18,19,5,9,20,25,0,117
16,5,18,19,5,9,20,15,12,119
16,5,18,19,5,19,0,0,0,82
16,5,18,19,5,22,5,18,5,113
16,5,18,19,9,1,14,19,0,101
16,5,18,19,9,3,1,18,25,114
16,5,18,19,9,3,15,0,0,85
16,5,18,19,9,3,15,20,0,105
16,5,18,19,9,5,14,14,5,105
16,5,18,19,9,13,13,15,14,122
16,5,18,19,9,15,0,0,0,82
16,5,18,19,9,19,20,0,0,106
16,5,18,19,9,19,20,5,4,115
16,5,18,19,9,19,20,5,18,129
16,5,18,19,9,19,20,19,0,125
16,5,18,19,15,12,22,5,0,112
16,5,18,19,15,14,0,0,0,87
16,5,18,19,15,14,1,0,0,88
16,5,18,19,15,14,1,7,5,100
16,5,18,19,15,14,1,12,0,100
16,5,18,19,15,14,1,12,19,119
16,5,18,19,15,14,1,13,0,101
16,5,18,19,15,14,1,19,0,107
16,5,18,19,15,14,1,20,5,113
16,5,18,19,15,14,5,4,0,96
16,5,18,19,15,14,9,6,25,127
16,5,18,19,15,14,9,26,5,127
16,5,18,19,15,14,14,5,12,118
16,5,18,19,16,9,3,9,12,107
16,5,18,19,16,9,18,5,0,106
16,5,18,19,16,9,18,5,4,110
16,5,18,19,16,9,18,5,19,125
16,5,18,19,16,9,18,25,0,126
16,5,18,19,20,1,14,4,0,97
16,5,18,19,21,1,4,5,0,89
16,5,18,19,21,1,4,5,4,93
16,5,18,19,21,1,4,5,18,107
16,5,18,19,21,1,4,5,19,108
16,5,18,19,21,5,0,0,0,84
16,5,18,20,1,9,14,0,0,83
16,5,18,20,1,9,14,5,4,92
16,5,18,20,1,9,14,19,0,102
16,5,18,20,5,14,0,0,0,78
16,5,18,20,5,18,0,0,0,82
16,5,18,20,5,19,20,0,0,103
16,5,18,20,8,9,20,5,0,101
16,5,18,20,8,9,20,9,3,108
16,5,18,20,25,0,0,0,0,84
16,5,18,20,9,14,1,20,5,108
16,5,18,20,9,14,5,14,20,121
16,5,18,20,9,19,8,0,0,95
16,5,18,20,12,25,0,0,0,96
16,5,18,20,14,5,19,19,0,116
16,5,18,20,21,18,2,0,0,100
16,5,18,20,21,18,2,5,4,109
16,5,18,20,21,18,2,5,18,123
16,5,18,20,21,18,2,19,0,119
16,5,18,20,21,19,5,0,0,104
16,5,18,20,21,19,5,4,0,108
16,5,18,20,21,19,9,15,14,137
16,5,18,20,21,19,19,1,12,131
16,5,18,20,21,19,19,9,19,146
16,5,18,21,11,5,0,0,0,76
16,5,18,21,11,5,4,0,0,80
16,5,18,21,11,5,18,0,0,94
16,5,18,21,11,5,18,25,0,119
16,5,18,21,11,5,19,0,0,95
16,5,18,21,11,9,5,18,0,103
16,5,18,21,12,1,0,0,0,73
16,5,18,21,12,1,20,5,0,98
16,5,18,21,12,5,0,0,0,77
16,5,18,21,19,1,2,12,5,99
16,5,18,21,19,1,12,0,0,92
16,5,18,21,19,1,12,19,0,111
16,5,18,21,19,5,0,0,0,84
16,5,18,21,19,5,4,0,0,88
16,5,18,21,19,5,18,0,0,102
16,5,18,21,19,5,18,19,0,121
16,5,18,21,19,5,19,0,0,103
16,5,18,21,19,9,14,7,0,109
16,5,18,21,22,9,1,14,19,125
16,5,18,22,0,0,0,0,0,61
16,5,18,22,1,4,5,0,0,71
16,5,18,22,1,4,5,4,0,75
16,5,18,22,1,4,5,18,0,89
16,5,18,22,1,4,5,18,19,108
16,5,18,22,1,4,5,19,0,90
16,5,18,22,1,4,9,14,7,96
16,5,18,22,1,7,1,20,5,95
16,5,18,22,1,12,22,1,18,115
16,5,18,22,1,19,9,15,14,119
16,5,18,22,1,19,9,22,5,117
16,5,18,22,5,14,3,8,5,96
16,5,18,22,5,18,19,5,0,108
16,5,18,22,5,18,20,0,0,104
16,5,18,22,5,18,20,5,4,113
16,5,18,22,5,18,20,5,18,127
16,5,18,22,5,18,20,19,0,123
16,5,18,22,9,1,2,12,5,90
16,5,18,22,9,1,12,0,0,83
16,5,18,22,9,15,21,19,0,125
16,5,18,23,9,3,11,0,0,85
16,5,18,23,9,20,19,11,25,146
16,5,19,0,0,0,0,0,0,40
16,5,19,1,0,0,0,0,0,41
16,5,19,1,4,5,0,0,0,50
16,5,19,1,4,5,19,0,0,69
16,5,19,1,7,5,0,0,0,53
16,5,19,1,14,20,5,0,0,80
16,5,19,3,15,4,0,0,0,62
16,5,19,5,20,1,0,0,0,66
16,5,19,5,20,1,19,0,0,85
16,5,19,5,23,1,0,0,0,69
16,5,19,5,23,1,19,0,0,88
16,5,19,8,11,1,18,0,0,78
16,5,19,8,11,1,19,8,0,87
16,5,19,8,23,1,0,0,0,72
16,5,19,11,25,0,0,0,0,76
16,5,19,11,9,5,18,0,0,83
16,5,19,11,9,5,19,20,0,104
16,5,19,11,9,12,25,0,0,97
16,5,19,11,9,14,5,19,19,117
16,5,19,15,0,0,0,0,0,55
16,5,19,15,19,0,0,0,0,74
16,5,19,19,0,0,0,0,0,59
16,5,19,19,1,18,25,0,0,103
16,5,19,19,1,18,9,5,19,111
16,5,19,19,9,13,1,12,0,94
16,5,19,19,9,13,9,19,13,122
16,5,19,19,9,13,9,19,20,129
16,5,19,19,9,13,9,26,5,121
16,5,19,19,9,13,21,13,0,115
16,5,19,19,15,14,5,18,0,111
16,5,19,19,21,12,1,18,0,111
16,5,19,19,21,12,21,19,0,132
16,5,19,20,5,18,0,0,0,83
16,5,19,20,5,18,5,4,0,92
16,5,19,20,5,18,5,18,0,106
16,5,19,20,5,18,5,18,19,125
16,5,19,20,5,18,9,14,7,113
16,5,19,20,5,18,15,21,19,138
16,5,19,20,5,18,19,0,0,102
16,5,19,20,6,21,12,0,0,99
16,5,19,20,8,15,12,5,0,100
16,5,19,20,8,15,12,5,19,119
16,5,19,20,8,15,21,19,5,128
16,5,19,20,9,3,9,4,5,90
16,5,19,20,9,4,21,3,20,117
16,5,19,20,9,6,25,0,0,100
16,5,19,20,9,12,5,14,20,120
16,5,19,20,9,19,0,0,0,88
16,5,19,20,12,5,0,0,0,77
16,5,19,20,12,5,4,0,0,81
16,5,19,20,12,5,19,0,0,96
16,5,19,20,12,9,14,7,0,102
16,5,19,20,15,0,0,0,0,75
16,5,19,20,15,12,15,7,25,134
16,5,19,20,15,19,0,0,0,94
16,5,19,20,16,18,15,15,6,130
16,5,19,20,19,0,0,0,0,79
16,5,20,1,12,0,0,0,0,54
16,5,20,1,12,1,7,5,0,67
16,5,20,1,12,5,4,0,0,63
16,5,20,1,12,25,0,0,0,79
16,5,20,1,12,9,14,5,0,82
16,5,20,1,12,9,14,7,0,84
16,5,20,1,12,9,19,13,0,95
16,5,20,1,12,9,20,5,0,88
16,5,20,1,12,12,5,4,0,75
16,5,20,1,12,12,5,19,19,109
16,5,20,1,12,12,9,11,5,91
16,5,20,1,12,12,9,14,7,96
16,5,20,1,12,15,4,25,0,98
16,5,20,1,12,15,4,9,3,85
16,5,20,1,12,15,9,4,0,82
16,5,20,1,12,15,14,0,0,83
16,5,20,1,12,15,21,19,0,109
16,5,20,1,12,19,0,0,0,73
16,5,20,1,12,23,9,19,5,110
16,5,20,1,18,1,0,0,0,61
16,5,20,1,18,4,0,0,0,64
16,5,20,1,18,4,5,5,18,92
16,5,20,1,18,4,9,5,18,96
16,5,20,1,18,4,9,14,7,94
16,5,20,1,18,4,19,0,0,83
16,5,20,1,18,25,0,0,0,85
16,5,20,1,19,13,1,0,0,75
16,5,20,1,19,15,19,0,0,95
16,5,20,1,19,15,19,5,19,119
16,5,20,1,19,21,19,0,0,101
16,5,20,1,19,21,19,5,19,125
16,5,20,1,20,5,0,0,0,67
16,5,20,1,21,18,9,14,5,109
16,5,20,1,21,18,9,19,20,129
16,5,20,3,8,1,18,25,0,96
16,5,20,3,15,3,11,0,0,73
16,5,20,3,15,3,11,19,0,92
16,5,20,5,3,1,0,0,0,50
16,5,20,5,3,8,9,1,0,67
16,5,20,5,3,8,9,1,5,72
16,5,20,5,3,8,9,1,12,79
16,5,20,5,7,18,5,21,0,97
16,5,20,5,13,1,14,0,0,74
16,5,20,5,13,5,14,0,0,78
16,5,20,5,18,5,4,0,0,73
16,5,20,5,18,5,18,15,0,102
16,5,20,5,18,9,14,7,0,94
16,5,20,5,18,13,5,14,0,96
16,5,20,5,18,14,5,20,0,103
16,5,20,5,18,23,15,18,20,140
16,5,20,6,21,12,0,0,0,80
16,5,20,8,5,18,0,0,0,72
16,5,20,8,9,4,9,14,5,90
16,5,20,9,15,12,1,18,0,96
16,5,20,9,15,12,1,18,25,121
16,5,20,9,15,12,1,20,5,103
16,5,20,9,15,12,5,0,0,82
16,5,20,9,15,12,5,4,0,86
16,5,20,9,15,12,5,19,0,101
16,5,20,9,15,12,9,0,0,86
16,5,20,9,15,12,21,12,5,115
16,5,20,9,15,12,21,19,0,117
16,5,20,9,20,5,19,0,0,94
16,5,20,9,20,9,15,0,0,94
16,5,20,9,20,9,15,14,0,108
16,5,20,9,20,9,15,14,19,127
16,5,20,9,20,15,18,0,0,103
16,5,20,9,20,15,18,25,0,128
16,5,20,9,20,19,0,0,0,89
16,5,20,11,9,14,0,0,0,75
16,5,20,11,9,14,19,0,0,94
16,5,20,12,9,14,7,0,0,83
16,5,20,14,1,16,0,0,0,72
16,5,20,14,1,16,19,0,0,91
16,5,20,15,0,0,0,0,0,56
16,5,20,15,19,0,0,0,0,75
16,5,20,18,1,12,15,7,25,119
16,5,20,18,1,18,25,0,0,103
16,5,20,18,5,0,0,0,0,64
16,5,20,18,5,1,14,0,0,79
16,5,20,18,5,9,20,25,0,118
16,5,20,18,5,12,19,0,0,95
16,5,20,18,9,0,0,0,0,68
16,5,20,18,9,6,25,0,0,99
16,5,20,18,9,6,9,3,0,86
16,5,20,18,9,6,9,5,4,92
16,5,20,18,9,6,9,5,18,106
16,5,20,18,9,6,9,5,19,107
16,5,20,18,15,0,0,0,0,74
16,5,20,18,15,7,0,0,0,81
16,5,20,18,15,7,5,14,25,125
16,5,20,18,15,7,18,1,13,113
16,5,20,18,15,12,0,0,0,86
16,5,20,18,15,12,1,7,5,99
16,5,20,18,15,12,5,1,14,106
16,5,20,18,15,12,5,14,5,110
16,5,20,18,15,12,5,21,13,125
16,5,20,18,15,12,5,21,18,130
16,5,20,18,15,12,9,3,0,98
16,5,20,18,15,12,9,14,0,109
16,5,20,18,15,12,9,19,20,134
16,5,20,18,15,12,9,26,5,126
16,5,20,18,15,12,12,5,4,107
16,5,20,18,15,12,15,7,25,133
16,5,20,18,15,12,19,0,0,105
16,5,20,18,15,14,5,12,0,105
16,5,20,18,15,14,5,12,19,124
16,5,20,18,15,19,1,0,0,94
16,5,20,18,15,19,1,12,0,106
16,5,20,18,15,19,21,13,0,127
16,5,20,18,15,21,19,0,0,114
16,5,20,19,0,0,0,0,0,60
16,5,20,19,1,9,0,0,0,70
16,5,20,19,1,9,19,0,0,89
16,5,20,20,1,2,12,5,0,81
16,5,20,20,1,8,0,0,0,70
16,5,20,20,5,4,0,0,0,70
16,5,20,20,5,4,12,25,0,107
16,5,20,20,5,18,0,0,0,84
16,5,20,20,5,18,19,0,0,103
16,5,20,20,9,0,0,0,0,70
16,5,20,20,9,1,7,21,1,100
16,5,20,20,9,3,15,1,20,109
16,5,20,20,9,5,18,0,0,93
16,5,20,20,9,5,19,20,0,114
16,5,20,20,9,6,15,7,0,98
16,5,20,20,25,6,15,7,0,114
16,5,20,20,9,6,15,7,19,117
16,5,20,20,25,7,15,4,0,112
16,5,20,20,9,12,25,0,0,107
16,5,20,20,9,14,5,19,19,127
16,5,20,20,9,14,7,0,0,91
16,5,20,20,9,14,7,12,25,128
16,5,20,20,9,14,7,19,0,110
16,5,20,20,9,19,8,0,0,97
16,5,20,20,9,19,8,12,25,134
16,5,20,20,9,20,15,5,19,129
16,5,20,20,12,5,0,0,0,78
16,5,20,20,12,5,4,0,0,82
16,5,20,20,12,5,19,0,0,97
16,5,20,20,12,9,14,7,0,103
16,5,20,20,15,0,0,0,0,76
16,5,20,21,12,1,14,3,5,97
16,5,20,21,12,1,14,3,25,117
16,5,20,21,12,1,14,20,0,109
16,5,20,21,13,0,0,0,0,75
16,5,20,21,14,5,0,0,0,81
16,5,20,21,14,9,1,19,0,105
16,5,20,21,14,19,5,0,0,100
16,5,20,21,14,20,19,5,0,120
16,5,20,21,14,20,19,5,19,139
16,5,20,21,14,20,26,5,0,127
16,5,20,21,14,20,26,5,19,146
16,5,20,23,15,15,4,0,0,98
16,5,20,26,9,20,5,0,0,101
16,5,21,3,25,12,0,0,0,82
16,5,21,3,9,20,5,19,0,98
16,5,21,8,12,0,0,0,0,62
16,5,21,12,22,1,14,0,0,91
16,5,23,0,0,0,0,0,0,44
16,5,23,1,7,5,0,0,0,57
16,5,23,4,15,13,0,0,0,76
16,5,23,5,5,0,0,0,0,54
16,5,23,5,5,19,0,0,0,73
16,5,23,6,5,12,12,15,23,117
16,5,23,6,21,12,0,0,0,83
16,5,23,8,15,12,4,5,18,106
16,5,23,25,0,0,0,0,0,69
16,5,23,9,14,7,0,0,0,74
16,5,23,9,20,0,0,0,0,73
16,5,23,9,20,19,0,0,0,92
16,5,23,12,5,19,19,0,0,99
16,5,23,13,1,20,5,0,0,83
16,5,23,19,0,0,0,0,0,63
16,5,23,20,5,18,0,0,0,87
16,5,23,20,5,18,5,18,0,110
16,5,23,20,5,18,5,18,19,129
16,5,23,20,5,18,25,0,0,112
16,5,23,20,5,18,19,0,0,106
16,5,26,1,14,20,9,3,0,94
16,5,26,9,26,15,9,4,0,110
16,5,26,15,7,18,1,16,8,112
16,6,3,0,0,0,0,0,0,25
16,6,4,0,0,0,0,0,0,26
16,6,5,14,14,9,7,0,0,71
16,6,5,14,14,9,7,5,0,76
16,6,5,14,14,9,7,19,0,90
16,6,6,20,0,0,0,0,0,48
16,6,7,0,0,0,0,0,0,29
16,6,12,1,7,0,0,0,0,42
16,6,21,9,0,0,0,0,0,52
16,6,21,14,4,0,0,0,0,61
16,6,21,14,4,5,0,0,0,66
16,6,24,0,0,0,0,0,0,46
16,7,14,20,20,0,0,0,0,77
16,7,14,20,20,18,16,0,0,111
16,8,5,1,12,0,0,0,0,42
16,8,5,1,18,19,5,0,0,72
16,8,5,1,19,1,14,20,0,84
16,8,5,1,19,1,14,20,19,103
16,8,5,5,1,12,0,0,0,47
16,8,5,12,12,5,13,0,0,71
16,8,5,12,12,5,13,19,0,90
16,8,5,12,12,15,7,5,14,94
16,8,5,12,12,15,14,9,3,94
16,8,5,12,12,21,13,0,0,87
16,8,5,12,15,14,9,1,0,80
16,8,5,12,15,14,9,15,14,108
16,8,5,13,9,3,0,0,0,54
16,8,5,14,1,3,25,12,0,84
16,8,5,14,1,3,9,20,5,81
16,8,5,14,1,11,9,19,13,96
16,8,5,14,1,11,9,20,5,89
16,8,5,14,1,20,5,0,0,69
16,8,5,14,1,20,5,19,0,88
16,8,5,14,1,26,9,14,0,93
16,8,5,14,1,26,9,14,5,98
16,8,5,14,1,26,9,14,19,112
16,8,5,14,1,26,15,14,5,104
16,8,5,14,5,7,15,12,0,82
16,8,5,14,5,14,5,0,0,67
16,8,5,14,5,20,8,25,12,113
16,8,5,14,5,20,9,3,0,80
16,8,5,14,5,20,9,3,19,99
16,8,5,14,5,20,15,12,0,95
16,8,5,14,5,20,15,12,5,100
16,8,5,14,5,20,15,12,19,114
16,8,5,14,7,9,20,5,0,84
16,8,5,14,9,3,0,0,0,55
16,8,5,14,9,3,1,20,5,81
16,8,5,14,9,3,9,14,5,83
16,8,5,14,25,12,0,0,0,80
16,8,5,14,25,12,1,20,5,106
16,8,5,14,25,12,5,14,5,104
16,8,5,14,25,12,9,3,0,92
16,8,5,14,25,12,19,0,0,99
16,8,5,14,9,14,0,0,0,66
16,8,5,14,9,14,5,0,0,71
16,8,5,14,9,24,5,19,0,100
16,8,5,14,15,3,1,9,14,85
16,8,5,14,15,3,15,12,12,100
16,8,5,14,15,3,15,16,25,117
16,8,5,14,15,12,0,0,0,70
16,8,5,14,15,12,1,20,5,96
16,8,5,14,15,12,9,1,0,80
16,8,5,14,15,12,9,3,0,82
16,8,5,14,15,12,9,3,19,101
16,8,5,14,15,12,9,15,14,108
16,8,5,14,15,12,9,26,5,110
16,8,5,14,15,12,15,7,25,117
16,8,5,14,15,12,15,9,4,98
16,8,5,14,15,12,19,0,0,89
16,8,5,14,15,13,0,0,0,71
16,8,5,14,15,13,5,14,1,91
16,8,5,14,15,13,19,0,0,90
16,8,5,14,15,19,1,12,0,90
16,8,5,14,15,19,5,0,0,82
16,8,5,14,15,19,15,12,0,104
16,8,5,14,15,20,25,16,5,124
16,8,5,14,15,24,25,0,0,107
16,8,5,14,15,24,9,4,0,95
16,8,5,14,15,24,9,4,5,100
16,8,5,15,14,0,0,0,0,58
16,8,5,15,16,8,25,12,0,105
16,8,5,15,16,8,25,12,12,117
16,8,5,18,5,20,18,5,18,113
16,8,5,18,15,13,15,14,5,109
16,8,5,23,0,0,0,0,0,52
16,8,9,1,12,0,0,0,0,46
16,8,9,1,12,1,5,0,0,52
16,8,9,1,12,1,9,0,0,56
16,8,9,1,12,5,0,0,0,51
16,8,9,1,12,5,4,0,0,55
16,8,9,1,12,6,21,12,0,85
16,8,9,1,12,9,4,5,0,64
16,8,9,1,12,9,14,5,0,74
16,8,9,1,12,9,14,7,0,76
16,8,9,1,12,12,5,4,0,67
16,8,9,1,12,12,9,11,5,83
16,8,9,1,12,12,9,14,7,88
16,8,9,1,12,19,0,0,0,65
16,8,25,3,9,3,0,0,0,64
16,8,25,3,9,20,5,0,0,86
16,8,25,3,9,20,15,12,0,108
16,8,25,3,15,12,15,7,25,126
16,8,9,5,19,0,0,0,0,57
16,8,9,12,0,0,0,0,0,45
16,8,25,12,1,0,0,0,0,62
16,8,9,12,1,2,5,7,0,60
16,8,9,12,1,2,5,7,19,79
16,8,25,12,1,3,20,9,3,97
16,8,25,12,1,5,0,0,0,67
16,8,9,12,1,13,15,20,0,94
16,8,25,12,1,18,0,0,0,80
16,8,25,12,1,18,3,8,0,91
16,8,25,12,1,18,3,8,25,116
16,8,9,12,1,20,5,12,25,108
16,8,9,12,1,21,20,25,0,112
16,8,25,12,1,24,9,19,0,114
16,8,9,12,5,0,0,0,0,50
16,8,25,12,5,0,0,0,0,66
16,8,25,12,5,19,5,19,0,109
16,8,25,12,5,19,9,19,0,113
16,8,25,12,5,20,9,3,0,98
16,8,25,12,5,20,9,19,13,127
16,8,9,12,9,1,0,0,0,55
16,8,9,12,9,1,20,5,18,98
16,8,9,12,9,2,5,7,0,68
16,8,9,12,9,2,5,7,19,87
16,8,9,12,9,3,0,0,0,57
16,8,25,12,9,3,0,0,0,73
16,8,9,12,9,16,16,21,19,126
16,8,9,12,9,19,20,5,18,116
16,8,9,12,12,0,0,0,0,57
16,8,25,12,12,0,0,0,0,73
16,8,25,12,12,1,4,5,0,83
16,8,25,12,12,1,18,25,0,117
16,8,9,12,12,9,12,5,23,106
16,8,9,12,12,9,12,15,15,108
16,8,25,12,12,9,14,0,0,96
16,8,25,12,12,9,14,5,0,101
16,8,9,12,12,9,16,16,9,107
16,8,9,12,12,25,18,9,14,123
16,8,25,12,12,9,20,5,0,107
16,8,25,12,12,9,20,5,19,126
16,8,25,12,12,9,20,9,3,114
16,8,25,12,12,15,0,0,0,88
16,8,25,12,12,15,4,5,0,97
16,8,25,12,12,15,4,5,19,116
16,8,25,12,12,15,4,25,0,117
16,8,25,12,12,15,4,9,1,102
16,8,25,12,12,15,9,4,0,101
16,8,25,12,12,15,9,4,19,120
16,8,25,12,12,15,13,5,0,106
16,8,25,12,12,15,13,5,19,125
16,8,25,12,12,15,13,9,3,113
16,8,25,12,12,15,16,15,4,123
16,8,25,12,12,15,19,0,0,107
16,8,25,12,12,15,21,19,0,128
16,8,9,12,15,3,1,12,25,101
16,8,9,12,15,3,25,14,25,127
16,8,9,12,15,4,15,24,0,103
16,8,25,12,15,7,5,14,25,127
16,8,9,12,15,7,25,14,25,131
16,8,9,12,15,12,0,0,0,72
16,8,9,12,15,12,15,7,25,119
16,8,25,12,15,12,15,7,25,135
16,8,9,12,15,13,5,0,0,78
16,8,9,12,15,13,5,12,19,109
16,8,9,12,15,13,21,19,5,118
16,8,25,12,15,14,0,0,0,90
16,8,9,12,15,14,9,21,13,117
16,8,9,12,15,16,5,14,1,96
16,8,9,12,15,16,9,7,0,92
16,8,9,12,15,16,15,5,20,116
16,8,9,12,15,19,0,0,0,79
16,8,9,12,15,19,15,16,8,118
16,8,9,12,15,21,19,0,0,100
16,8,9,12,15,26,15,9,3,113
16,8,9,12,20,5,18,0,0,88
16,8,9,12,20,5,18,5,4,97
16,8,9,12,20,5,18,5,18,111
16,8,9,12,20,5,18,19,0,107
16,8,9,12,20,18,1,0,0,84
16,8,9,12,20,18,5,0,0,88
16,8,9,12,20,18,5,4,0,92
16,8,9,12,20,18,5,19,0,107
16,8,9,12,20,18,9,14,7,113
16,8,9,12,20,18,21,13,0,117
16,8,25,12,21,13,0,0,0,95
16,8,25,12,21,13,12,1,0,108
16,8,25,13,1,0,0,0,0,63
16,8,25,13,1,19,0,0,0,82
16,8,25,13,1,20,1,0,0,84
16,8,25,13,1,20,9,3,0,95
16,8,25,13,1,20,9,4,0,96
16,8,25,13,1,20,15,9,4,111
16,8,9,13,15,19,5,4,0,89
16,8,9,13,15,19,5,19,0,104
16,8,9,13,15,19,9,19,0,108
16,8,9,13,15,20,9,3,0,93
16,8,9,16,16,5,0,0,0,70
16,8,25,18,5,0,0,0,0,72
16,8,9,18,15,26,5,0,0,97
16,8,9,19,0,0,0,0,0,52
16,8,25,19,0,0,0,0,0,68
16,8,25,19,1,12,9,1,14,105
16,8,25,19,1,12,9,20,5,115
16,8,25,19,3,9,15,9,4,108
16,8,25,19,5,4,0,0,0,77
16,8,25,19,5,4,19,0,0,96
16,8,25,19,5,19,0,0,0,92
16,8,25,19,9,3,0,0,0,80
16,8,25,19,9,3,1,12,0,93
16,8,25,19,9,3,1,12,19,112
16,8,25,19,9,3,9,1,14,104
16,8,25,19,9,3,9,19,13,121
16,8,25,19,9,3,9,19,20,128
16,8,25,19,9,3,11,5,4,100
16,8,25,19,9,3,11,5,18,114
16,8,25,19,9,3,11,25,0,116
16,8,25,19,9,3,11,19,0,110
16,8,25,19,9,3,19,0,0,99
16,8,25,19,9,4,0,0,0,81
16,8,25,19,9,6,15,18,13,129
16,8,25,19,9,15,12,0,0,104
16,8,25,19,9,17,21,5,0,120
16,8,25,19,9,17,21,5,4,124
16,8,25,19,9,17,21,5,19,139
16,8,25,19,9,19,0,0,0,96
16,8,25,19,9,20,9,19,13,138
16,8,25,19,9,21,18,7,25,148
16,8,25,19,14,15,13,25,0,135
16,8,25,19,15,3,5,12,5,108
16,8,25,19,15,16,15,4,0,118
16,8,9,20,0,0,0,0,0,53
16,8,25,20,1,14,5,0,0,89
16,8,25,20,1,14,5,19,0,108
16,8,25,20,1,19,5,0,0,94
16,8,25,20,1,20,5,0,0,95
16,8,25,20,5,0,0,0,0,74
16,8,25,20,9,3,0,0,0,81
16,8,25,20,9,6,15,18,13,130
16,8,25,20,25,12,0,0,0,106
16,8,25,20,9,14,0,0,0,92
16,8,25,20,9,14,19,0,0,111
16,8,25,20,15,3,9,4,5,105
16,8,25,20,15,7,1,13,25,130
16,8,25,20,15,7,5,14,25,135
16,8,25,20,15,9,4,0,0,97
16,8,25,20,15,12,0,0,0,96
16,8,25,20,15,12,9,20,5,130
16,8,25,20,15,12,9,20,8,133
16,8,25,20,15,12,15,7,25,143
16,8,25,20,15,12,19,0,0,115
16,8,25,20,15,13,1,0,0,98
16,8,25,20,15,13,5,0,0,102
16,8,25,20,15,13,5,18,0,120
16,8,25,20,15,13,5,18,1,121
16,8,25,20,15,14,0,0,0,98
16,8,9,20,15,14,5,19,0,106
16,8,25,20,15,14,9,3,0,110
16,8,25,20,15,14,15,13,25,151
16,8,25,20,15,14,19,0,0,117
16,8,25,20,15,16,8,9,12,129
16,8,25,20,15,16,20,9,4,133
16,8,25,20,15,19,1,21,18,143
16,8,25,20,15,19,9,19,0,131
16,8,25,20,15,20,15,13,25,157
16,8,25,20,15,20,18,15,14,151
16,8,25,20,15,26,15,1,14,140
16,8,25,20,15,26,15,15,14,154
16,8,9,26,5,19,0,0,0,83
16,8,9,26,15,7,0,0,0,81
16,8,12,5,2,9,20,9,3,84
16,8,12,5,2,9,20,9,19,100
16,8,12,5,2,15,9,4,0,71
16,8,12,5,7,13,0,0,0,61
16,8,12,5,7,13,1,0,0,62
16,8,12,5,7,13,25,0,0,86
16,8,12,5,7,13,9,5,18,93
16,8,12,5,7,13,15,14,0,90
16,8,12,5,7,13,19,0,0,80
16,8,12,25,3,20,5,14,1,104
16,8,12,15,5,13,0,0,0,69
16,8,12,15,5,13,19,0,0,88
16,8,12,15,5,21,13,0,0,90
16,8,12,15,7,9,19,13,1,100
16,8,12,15,7,15,19,5,4,101
16,8,12,15,7,15,19,9,14,115
16,8,12,15,7,15,19,9,19,120
16,8,12,15,7,15,20,9,3,105
16,8,12,15,18,5,20,9,3,106
16,8,12,15,18,5,20,9,14,117
16,8,12,15,18,9,14,1,0,93
16,8,12,15,18,9,26,9,14,127
16,8,12,15,18,15,12,0,0,96
16,8,12,15,18,15,14,5,0,103
16,8,12,15,24,0,0,0,0,75
16,8,12,15,24,5,19,0,0,99
16,8,12,15,24,9,14,0,0,98
16,8,15,0,0,0,0,0,0,39
16,8,15,2,5,0,0,0,0,46
16,8,15,2,25,0,0,0,0,66
16,8,15,2,9,1,0,0,0,51
16,8,15,2,9,1,3,0,0,54
16,8,15,2,9,1,19,0,0,70
16,8,15,2,9,3,0,0,0,53
16,8,15,2,9,3,19,0,0,72
16,8,15,2,9,5,19,0,0,74
16,8,15,2,9,19,13,0,0,82
16,8,15,2,9,19,20,0,0,89
16,8,15,3,1,0,0,0,0,43
16,8,15,3,1,3,5,1,14,66
16,8,15,3,1,12,0,0,0,55
16,8,15,3,5,14,1,20,5,87
16,8,15,3,5,14,9,3,0,73
16,8,15,3,5,14,9,14,0,84
16,8,15,3,9,4,0,0,0,55
16,8,15,3,9,6,15,18,13,103
16,8,15,3,9,14,5,0,0,70
16,8,15,3,15,4,15,14,20,110
16,8,15,3,15,9,4,0,0,70
16,8,15,3,15,13,5,12,9,96
16,8,15,5,2,1,4,19,0,70
16,8,15,5,2,5,19,0,0,70
16,8,15,5,14,9,7,13,0,87
16,8,15,5,14,9,24,5,19,115
16,8,15,8,0,0,0,0,0,47
16,8,15,12,1,4,0,0,0,56
16,8,15,12,1,4,9,1,14,80
16,8,15,12,1,4,9,4,0,69
16,8,15,12,1,4,15,9,4,84
16,8,15,12,3,9,4,0,0,67
16,8,15,12,3,15,9,4,0,82
16,8,15,12,9,4,15,0,0,79
16,8,15,12,9,4,15,20,5,104
16,8,15,14,0,0,0,0,0,53
16,8,15,14,1,12,0,0,0,66
16,8,15,14,1,20,5,0,0,79
16,8,15,14,1,20,5,4,0,83
16,8,15,14,1,20,5,19,0,98
16,8,15,14,1,20,9,14,7,104
16,8,15,14,1,20,9,15,14,112
16,8,15,14,1,20,15,18,25,132
16,8,15,14,5,0,0,0,0,58
16,8,15,14,5,4,0,0,0,62
16,8,15,14,5,25,0,0,0,83
16,8,15,14,5,25,5,4,0,92
16,8,15,14,5,9,5,18,0,90
16,8,15,14,5,9,5,19,20,111
16,8,15,14,5,25,19,0,0,102
16,8,15,14,5,13,5,0,0,76
16,8,15,14,5,13,5,19,0,95
16,8,15,14,5,13,9,3,0,83
16,8,15,14,5,13,9,3,19,102
16,8,15,14,5,18,0,0,0,76
16,8,15,14,5,19,0,0,0,77
16,8,15,14,5,19,9,19,0,105
16,8,15,14,5,20,0,0,0,78
16,8,15,14,5,20,9,3,0,90
16,8,15,14,5,20,9,3,19,109
16,8,15,14,5,20,9,19,13,119
16,8,15,14,5,20,9,19,20,126
16,8,15,14,5,20,9,26,5,118
16,8,15,14,7,8,9,0,0,77
16,8,15,14,25,0,0,0,0,78
16,8,15,14,9,1,20,18,25,126
16,8,15,14,9,3,0,0,0,65
16,8,15,14,9,3,19,0,0,84
16,8,15,14,9,5,4,0,0,71
16,8,15,14,9,5,18,0,0,85
16,8,15,14,9,5,19,0,0,86
16,8,15,14,9,5,19,20,0,106
16,8,15,14,25,9,14,7,0,108
16,8,15,14,9,11,15,14,0,102
16,8,15,14,9,12,25,0,0,99
16,8,15,14,9,14,5,19,19,119
16,8,15,14,9,14,7,0,0,83
16,8,15,14,9,19,13,0,0,94
16,8,15,14,15,0,0,0,0,68
16,8,15,14,15,4,5,9,11,97
16,8,15,14,15,7,18,1,13,107
16,8,15,14,15,12,0,0,0,80
16,8,15,14,15,12,9,20,5,114
16,8,15,14,15,12,15,7,25,127
16,8,15,14,15,14,0,0,0,82
16,8,15,14,15,14,19,0,0,101
16,8,15,14,15,16,12,5,24,125
16,8,15,14,15,16,15,18,5,122
16,8,15,14,15,19,0,0,0,87
16,8,15,14,15,20,25,16,5,134
16,8,15,14,15,20,25,16,25,154
16,8,15,14,19,0,0,0,0,72
16,8,15,15,0,0,0,0,0,54
16,8,15,15,5,25,0,0,0,84
16,8,15,15,11,1,0,0,0,66
16,8,15,18,1,20,5,0,0,83
16,8,15,18,1,20,5,19,0,102
16,8,15,18,2,9,14,0,0,82
16,8,15,18,5,0,0,0,0,62
16,8,15,18,5,19,25,0,0,106
16,8,15,18,5,19,9,19,0,109
16,8,15,18,9,1,0,0,0,67
16,8,15,18,9,4,0,0,0,70
16,8,15,18,13,9,14,24,0,117
16,8,15,18,15,12,15,7,25,131
16,8,15,18,15,14,5,0,0,91
16,8,15,18,15,14,9,3,0,98
16,8,15,18,15,14,9,4,0,99
16,8,15,18,15,14,15,13,25,139
16,8,15,18,15,21,19,0,0,112
16,8,15,18,18,8,5,1,0,89
16,8,15,19,0,0,0,0,0,58
16,8,15,19,5,0,0,0,0,63
16,8,15,19,7,5,14,5,0,89
16,8,15,19,7,5,14,5,19,108
16,8,15,19,7,5,14,9,3,96
16,8,15,19,9,19,0,0,0,86
16,8,15,19,16,8,1,13,0,96
16,8,15,19,16,8,1,20,5,108
16,8,15,19,16,8,5,14,5,106
16,8,15,19,16,8,9,4,0,95
16,8,15,19,16,8,9,4,5,100
16,8,15,19,16,8,9,4,19,114
16,8,15,19,16,8,25,12,0,119
16,8,15,19,16,8,9,14,0,105
16,8,15,19,16,8,9,14,5,110
16,8,15,19,16,8,9,14,19,124
16,8,15,19,16,8,9,20,5,116
16,8,15,19,16,8,15,0,0,97
16,8,15,19,16,8,15,18,5,120
16,8,15,19,16,8,15,18,9,124
16,8,15,19,16,8,15,18,19,134
16,8,15,19,19,0,0,0,0,77
16,8,15,19,19,25,0,0,0,102
16,8,15,20,0,0,0,0,0,59
16,8,15,20,1,12,0,0,0,72
16,8,15,20,1,12,7,9,1,89
16,8,15,20,5,3,8,25,0,100
16,8,15,20,5,15,12,9,3,103
16,8,15,20,9,3,0,0,0,71
16,8,15,20,9,3,19,0,0,90
16,8,15,20,9,19,13,0,0,100
16,8,15,20,9,19,20,9,3,119
16,8,15,20,15,0,0,0,0,74
16,8,15,20,15,3,5,12,12,106
16,8,15,20,15,3,15,16,25,133
16,8,15,20,15,5,4,0,0,83
16,8,15,20,15,5,14,7,0,100
16,8,15,20,15,5,20,3,8,110
16,8,15,20,15,6,9,12,13,114
16,8,15,20,15,7,0,0,0,81
16,8,15,20,15,7,5,14,0,100
16,8,15,20,15,7,5,14,5,105
16,8,15,20,15,7,5,14,25,125
16,8,15,20,15,7,18,1,13,113
16,8,15,20,15,7,18,1,20,120
16,8,15,20,15,7,19,0,0,100
16,8,15,20,15,9,14,7,0,104
16,8,15,20,15,9,19,20,0,122
16,8,15,20,15,12,25,20,5,136
16,8,15,20,15,12,9,20,8,123
16,8,15,20,15,12,25,26,5,142
16,8,15,20,15,12,15,7,25,133
16,8,15,20,15,13,0,0,0,87
16,8,15,20,15,13,1,0,0,88
16,8,15,20,15,13,1,16,0,104
16,8,15,20,15,13,1,16,19,123
16,8,15,20,15,14,9,3,0,100
16,8,15,20,15,14,19,0,0,107
16,8,15,20,15,16,9,1,0,100
16,8,15,20,15,16,9,1,19,119
16,8,15,20,15,16,9,3,0,102
16,8,15,20,15,16,9,12,5,116
16,8,15,20,15,16,12,1,25,128
16,8,15,20,15,19,0,0,0,93
16,8,15,20,15,19,1,12,20,126
16,8,15,20,15,19,5,20,0,118
16,8,15,20,15,19,5,20,19,137
16,8,15,20,15,20,1,24,25,144
16,8,15,20,15,20,25,16,5,140
16,8,15,20,15,20,25,16,25,160
16,8,15,20,15,20,21,2,5,122
16,8,15,20,19,0,0,0,0,78
16,8,15,20,21,18,9,1,0,108
16,8,15,21,19,4,1,18,0,102
16,8,16,8,20,0,0,0,0,68
16,8,18,0,0,0,0,0,0,42
16,8,18,1,7,13,1,0,0,64
16,8,18,1,7,13,15,9,4,91
16,8,18,1,13,16,5,12,0,89
16,8,18,1,19,1,2,12,5,82
16,8,18,1,19,1,12,0,0,75
16,8,18,1,19,1,12,12,25,112
16,8,18,1,19,5,0,0,0,67
16,8,18,1,19,5,4,0,0,71
16,8,18,1,19,5,25,0,0,92
16,8,18,1,19,5,13,0,0,80
16,8,18,1,19,5,13,1,14,95
16,8,18,1,19,5,18,0,0,85
16,8,18,1,19,5,19,0,0,86
16,8,18,1,19,25,0,0,0,87
16,8,18,1,19,9,6,25,0,102
16,8,18,1,19,9,14,7,0,92
16,8,18,1,19,9,14,7,19,111
16,8,18,1,20,15,18,0,0,96
16,8,18,1,20,18,1,12,0,94
16,8,18,1,20,18,25,0,0,106
16,8,18,1,20,18,9,1,0,91
16,8,18,1,20,18,9,1,3,94
16,8,18,1,20,18,9,1,12,103
16,8,18,1,20,18,9,3,0,93
16,8,18,1,20,18,9,5,19,114
16,8,18,5,1,20,9,3,0,80
16,8,18,5,14,0,0,0,0,61
16,8,18,5,14,5,19,9,1,95
16,8,18,5,14,5,19,9,19,113
16,8,18,5,14,5,20,9,3,98
16,8,18,5,14,9,1,0,0,71
16,8,18,5,14,9,3,0,0,73
16,8,18,5,14,9,3,19,0,92
16,8,18,5,14,9,20,9,3,102
16,8,18,5,14,9,20,9,19,118
16,8,18,5,14,15,12,0,0,88
16,8,18,5,14,15,19,9,14,118
16,8,18,5,14,19,25,0,0,105
16,8,18,5,14,19,9,5,4,98
16,8,18,5,14,19,9,5,19,113
16,8,18,25,7,9,21,13,0,117
16,8,18,25,14,9,4,0,0,94
16,8,18,25,14,9,14,0,0,104
16,8,18,25,14,15,9,4,0,109
16,8,18,15,14,5,19,9,19,123
16,8,20,0,0,0,0,0,0,44
16,8,20,1,12,9,3,0,0,69
16,8,20,8,1,12,1,14,0,80
16,8,20,8,1,12,1,20,5,91
16,8,20,8,1,12,5,9,14,93
16,8,20,8,1,12,9,3,0,77
16,8,20,8,1,12,9,4,0,78
16,8,20,8,1,12,9,4,5,83
16,8,20,8,1,12,25,12,0,102
16,8,20,8,1,12,9,14,0,88
16,8,20,8,1,12,9,14,19,107
16,8,20,8,1,14,9,20,5,101
16,8,20,8,9,14,15,9,4,103
16,8,20,8,9,15,3,15,12,106
16,8,20,8,9,19,5,19,0,104
16,8,20,8,9,19,9,3,0,92
16,8,20,8,9,19,9,3,19,111
16,8,20,8,9,19,9,19,0,108
16,8,20,8,15,14,7,1,12,101
16,8,20,8,15,18,0,0,0,85
16,8,20,8,15,18,9,3,0,97
16,8,21,0,0,0,0,0,0,45
16,8,21,7,15,9,4,0,0,80
16,8,21,12,11,1,18,9,0,96
16,8,21,12,23,1,0,0,0,81
16,8,21,12,23,1,18,1,0,100
16,8,21,20,0,0,0,0,0,65
16,8,21,20,19,0,0,0,0,84
16,9,2,1,12,0,0,0,0,40
16,9,2,1,12,19,0,0,0,59
16,9,2,3,15,18,14,0,0,77
16,9,2,7,15,18,14,0,0,81
16,9,2,12,15,3,11,20,15,103
16,9,2,12,15,11,20,15,0,100
16,9,2,12,15,11,20,15,19,119
16,9,2,18,15,3,8,0,0,71
16,9,2,18,15,3,8,5,19,95
16,9,2,18,15,3,8,19,0,90
16,9,3,1,3,8,15,19,0,74
16,9,3,1,4,15,18,0,0,66
16,9,3,1,4,15,18,5,19,90
16,9,3,1,4,15,18,19,0,85
16,9,3,1,4,21,18,1,0,73
16,9,3,1,25,21,14,5,19,113
16,9,3,1,12,0,0,0,0,41
16,9,3,1,13,1,18,0,0,61
16,9,3,1,14,9,14,14,25,105
16,9,3,1,18,1,0,0,0,48
16,9,3,1,18,1,19,0,0,67
16,9,3,1,18,5,12,0,0,64
16,9,3,1,18,25,0,0,0,72
16,9,3,1,18,9,1,14,0,71
16,9,3,1,18,15,0,0,0,62
16,9,3,1,18,15,15,14,0,91
16,9,3,1,18,15,15,14,19,110
16,9,3,1,18,15,19,0,0,81
16,9,3,1,19,0,0,0,0,48
16,9,3,3,1,4,9,12,12,69
16,9,3,3,1,7,5,0,0,44
16,9,3,3,1,14,9,14,0,69
16,9,3,3,1,14,20,5,0,71
16,9,3,3,1,20,1,0,0,53
16,9,3,3,9,15,20,20,15,110
16,9,3,3,15,12,15,0,0,73
16,9,3,3,15,12,15,19,0,92
16,9,3,5,0,0,0,0,0,33
16,9,3,5,9,14,0,0,0,56
16,9,3,5,15,21,19,0,0,88
16,9,3,5,23,15,18,20,8,117
16,25,3,8,5,0,0,0,0,57
16,9,3,8,5,25,0,0,0,66
16,9,3,8,9,0,0,0,0,45
16,9,3,8,21,18,9,3,0,87
16,9,3,8,21,18,9,13,0,97
16,9,3,9,6,15,18,13,0,89
16,9,3,9,14,5,0,0,0,56
16,9,3,11,0,0,0,0,0,39
16,9,3,11,1,2,1,3,11,57
16,9,3,11,1,2,12,5,0,59
16,9,3,11,1,4,9,12,0,65
16,9,3,11,1,4,9,12,19,84
16,9,3,11,1,7,5,0,0,52
16,9,3,11,1,18,15,15,14,102
16,9,3,11,1,23,1,25,0,89
16,9,3,11,1,24,0,0,0,64
16,9,3,11,1,24,5,0,0,69
16,9,3,11,1,24,5,4,0,73
16,9,3,11,1,24,5,19,0,88
16,9,3,11,1,24,9,14,7,94
16,9,3,11,2,1,3,11,0,56
16,9,3,11,5,4,0,0,0,48
16,9,3,11,5,4,12,25,0,85
16,9,3,11,5,5,0,0,0,49
16,9,3,11,5,5,18,0,0,67
16,9,3,11,5,5,18,5,4,76
16,9,3,11,5,5,18,19,0,86
16,9,3,11,5,12,0,0,0,56
16,9,3,11,5,18,5,12,0,79
16,9,3,11,5,18,5,12,19,98
16,9,3,11,5,18,25,0,0,87
16,9,3,11,5,18,19,0,0,81
16,9,3,11,5,20,0,0,0,64
16,9,3,11,5,20,5,4,0,73
16,9,3,11,5,20,5,5,18,92
16,9,3,11,5,20,5,18,0,87
16,9,3,11,5,20,5,18,19,106
16,9,3,11,5,20,9,14,7,94
16,9,3,11,5,20,19,0,0,83
16,9,3,11,6,15,18,11,0,89
16,9,3,11,25,0,0,0,0,64
16,9,3,11,9,5,18,0,0,71
16,9,3,11,9,5,19,20,0,92
16,9,3,11,9,5,20,1,18,92
16,9,3,11,9,14,0,0,0,62
16,9,3,11,9,14,7,0,0,69
16,9,3,11,9,14,7,19,0,88
16,9,3,11,12,5,0,0,0,56
16,9,3,11,12,5,4,0,0,60
16,9,3,11,12,5,13,1,14,84
16,9,3,11,12,5,18,0,0,74
16,9,3,11,12,5,19,0,0,75
16,9,3,11,12,9,14,7,0,81
16,9,3,11,12,15,3,11,0,80
16,9,3,11,12,15,3,11,19,99
16,9,3,11,13,1,23,0,0,76
16,9,3,11,13,5,14,0,0,71
16,9,3,11,14,9,3,11,0,76
16,9,3,11,15,6,6,0,0,66
16,9,3,11,15,6,6,19,0,85
16,9,3,11,15,21,20,0,0,95
16,9,3,11,15,22,5,18,0,99
16,9,3,11,16,5,14,14,25,113
16,9,3,11,16,15,12,5,0,87
16,9,3,11,16,18,15,15,6,109
16,9,3,11,16,21,18,19,5,118
16,9,3,11,19,0,0,0,0,58
16,9,3,11,19,8,1,6,20,93
16,9,3,11,19,13,1,14,0,86
16,9,3,11,19,13,9,20,8,108
16,9,3,11,19,15,13,5,0,91
16,9,3,11,20,8,1,14,11,93
16,9,3,11,20,15,15,20,8,117
16,9,3,11,21,16,0,0,0,76
16,9,3,11,21,16,19,0,0,95
16,9,3,11,23,9,3,11,0,85
16,9,3,11,23,9,3,11,19,104
16,9,3,11,23,15,18,11,0,106
16,9,3,12,15,18,1,13,0,87
16,9,3,12,15,18,1,13,19,106
16,25,3,14,9,1,0,0,0,68
16,25,3,14,9,1,12,0,0,80
16,9,3,14,9,3,0,0,0,54
16,25,3,14,9,3,0,0,0,70
16,9,3,14,9,3,11,5,4,74
16,9,3,14,9,3,11,5,18,88
16,9,3,14,9,3,11,25,0,90
16,9,3,14,9,3,19,0,0,73
16,25,3,14,9,4,0,0,0,71
16,25,3,14,9,4,9,1,0,81
16,25,3,14,9,4,9,1,12,93
16,25,3,14,9,4,9,21,13,114
16,25,3,14,9,20,5,0,0,92
16,25,3,14,9,21,13,0,0,101
16,25,3,14,15,4,15,14,20,126
16,25,3,14,15,19,5,19,0,116
16,25,3,14,15,19,9,19,0,120
16,25,3,14,15,20,9,3,0,105
16,9,3,15,0,0,0,0,0,43
16,9,3,15,3,21,18,9,5,99
16,9,3,15,6,1,18,1,4,73
16,9,3,15,7,18,1,13,0,82
16,9,3,15,7,18,1,13,19,101
16,9,3,15,9,4,0,0,0,56
16,9,3,15,10,15,21,12,5,106
16,9,3,15,12,9,14,0,0,78
16,9,3,15,12,9,14,5,0,83
16,9,3,15,12,9,14,5,19,102
16,9,3,15,12,9,14,9,3,90
16,9,3,15,12,9,14,19,0,97
16,9,3,15,13,5,20,5,18,104
16,9,3,15,13,15,12,5,0,88
16,9,3,15,14,7,0,0,0,64
16,9,3,15,18,25,0,0,0,86
16,9,3,15,20,0,0,0,0,63
16,9,3,15,20,1,8,0,0,72
16,9,3,15,20,5,0,0,0,68
16,9,3,15,20,5,4,0,0,72
16,9,3,15,20,5,5,0,0,73
16,9,3,15,20,5,5,19,0,92
16,9,3,15,20,9,14,7,0,93
16,9,3,15,20,9,20,5,0,97
16,9,3,15,20,19,0,0,0,82
16,9,3,15,20,20,1,8,0,92
16,9,3,15,23,1,20,20,0,107
16,9,3,17,21,5,20,0,0,91
16,9,3,17,21,5,20,5,18,114
16,9,3,17,21,5,20,19,0,110
16,9,3,18,1,0,0,0,0,47
16,9,3,18,1,13,9,3,0,72
16,9,3,18,1,19,13,9,14,102
16,9,3,18,1,20,5,0,0,72
16,9,3,18,1,20,5,4,0,76
16,9,3,18,1,20,5,19,0,91
16,9,3,18,25,0,0,0,0,71
16,9,3,18,9,3,0,0,0,58
16,9,3,18,25,12,0,0,0,83
16,9,3,18,9,20,5,0,0,80
16,9,3,18,9,20,5,19,0,99
16,9,3,18,9,20,9,3,0,87
16,9,3,18,15,12,0,0,0,73
16,9,3,18,15,12,9,20,5,107
16,9,3,18,15,20,9,14,0,104
16,9,3,20,1,18,14,9,5,95
16,9,3,20,15,7,18,1,13,102
16,9,3,20,15,18,9,1,12,103
16,9,3,20,15,18,9,3,0,93
16,9,3,20,21,14,0,0,0,83
16,9,3,20,21,18,1,12,0,100
16,9,3,20,21,18,5,0,0,92
16,9,3,20,21,18,5,4,0,96
16,9,3,20,21,18,5,12,25,129
16,9,3,20,21,18,5,18,0,110
16,9,3,20,21,18,5,18,19,129
16,9,3,20,21,18,5,19,0,111
16,9,3,20,21,18,25,0,0,112
16,9,3,20,21,18,9,14,7,117
16,9,3,20,21,18,9,26,5,127
16,9,3,21,3,21,12,5,0,90
16,9,3,21,4,1,0,0,0,54
16,9,3,21,4,9,12,12,1,87
16,9,3,21,4,15,0,0,0,68
16,9,3,21,12,0,0,0,0,61
16,9,3,21,12,5,0,0,0,66
16,9,3,21,12,5,20,0,0,86
16,9,3,21,12,19,0,0,0,80
16,9,3,21,12,21,12,5,0,99
16,9,4,1,14,0,0,0,0,44
16,9,4,4,12,5,0,0,0,50
16,9,4,4,12,5,4,0,0,54
16,9,4,4,12,5,18,0,0,68
16,9,4,4,12,5,18,19,0,87
16,9,4,4,12,5,19,0,0,69
16,9,4,4,12,25,0,0,0,70
16,9,4,4,12,9,14,7,0,75
16,9,4,4,15,3,11,0,0,62
16,9,4,4,15,3,11,19,0,81
16,9,4,7,9,14,0,0,0,59
16,9,4,7,9,14,9,26,5,99
16,9,4,7,9,14,19,0,0,78
16,9,4,7,9,26,5,4,0,80
16,9,4,7,9,26,9,14,7,101
16,9,4,10,1,10,1,16,0,67
16,9,5,0,0,0,0,0,0,30
16,25,5,0,0,0,0,0,0,46
16,9,5,2,1,12,4,0,0,49
16,9,5,2,1,12,4,12,25,86
16,9,5,2,1,12,4,19,0,68
16,9,5,3,5,0,0,0,0,38
16,9,5,3,5,1,2,12,5,58
16,9,5,3,5,4,0,0,0,42
16,9,5,3,5,12,5,19,19,93
16,9,5,3,5,13,5,1,12,69
16,9,5,3,5,14,0,0,0,52
16,9,5,3,5,14,5,18,0,75
16,9,5,3,5,18,0,0,0,56
16,9,5,3,5,18,19,0,0,75
16,9,5,3,5,19,0,0,0,57
16,9,5,3,5,20,20,5,0,83
16,9,5,3,5,23,9,19,5,94
16,9,5,3,5,23,15,18,11,105
16,9,5,3,9,14,7,0,0,63
16,9,5,3,9,14,7,19,0,82
16,9,5,3,18,21,19,20,0,111
16,9,5,3,18,21,19,20,19,130
16,9,5,4,0,0,0,0,0,34
16,9,5,4,6,15,18,20,0,93
16,9,5,4,6,15,18,20,19,112
16,9,5,4,12,25,0,0,0,71
16,9,5,4,13,15,14,20,19,115
16,9,5,4,14,5,19,19,0,91
16,9,5,4,18,15,9,20,0,96
16,9,5,6,15,18,20,0,0,89
16,9,5,6,15,18,20,19,0,108
16,9,5,8,15,21,19,5,0,98
16,9,5,9,14,7,0,0,0,60
16,9,5,12,5,19,19,0,0,85
16,9,5,12,5,20,0,0,0,67
16,25,5,12,9,3,0,0,0,70
16,9,5,12,9,11,5,0,0,67
16,25,5,12,9,20,9,3,0,99
16,25,5,12,9,20,9,19,0,115
16,25,5,12,15,7,18,1,13,112
16,25,5,12,15,20,15,13,25,146
16,9,5,12,21,13,0,0,0,76
16,9,5,13,1,7,0,0,0,51
16,9,5,13,1,14,0,0,0,58
16,9,5,13,1,18,11,5,18,96
16,25,5,13,5,19,9,19,0,111
16,25,5,13,9,1,0,0,0,69
16,25,5,13,9,1,19,0,0,88
16,25,5,13,9,3,0,0,0,71
16,9,5,14,0,0,0,0,0,44
16,9,5,14,1,1,18,0,0,64
16,9,5,14,1,14,14,25,0,98
16,9,5,14,4,0,0,0,0,48
16,25,5,14,7,1,4,21,0,93
16,9,5,14,20,1,15,0,0,80
16,9,5,16,1,14,0,0,0,61
16,9,5,16,12,1,14,20,0,93
16,9,5,16,12,1,14,20,19,112
16,9,5,16,15,21,4,18,5,109
16,9,5,16,15,23,4,5,18,111
16,9,5,16,18,9,14,20,0,107
16,9,5,18,1,7,5,0,0,61
16,9,5,18,3,1,18,12,15,97
16,9,5,18,3,5,4,0,0,60
16,9,5,18,3,5,12,0,0,68
16,9,5,18,3,5,14,20,0,90
16,9,5,18,3,5,18,0,0,74
16,9,5,18,3,5,18,19,0,93
16,9,5,18,3,5,19,0,0,75
16,9,5,18,3,9,14,7,0,81
16,9,5,18,4,18,15,16,0,101
16,9,5,18,8,5,1,4,0,66
16,9,5,18,9,4,0,0,0,61
16,9,5,18,9,4,9,14,5,89
16,9,5,18,9,14,5,0,0,76
16,9,5,18,12,5,19,19,0,103
16,9,5,18,12,9,11,5,0,85
16,9,5,18,15,7,9,0,0,79
16,9,5,18,18,15,20,9,3,113
16,9,5,18,18,15,20,19,0,120
16,9,5,18,20,0,0,0,0,68
16,9,5,19,0,0,0,0,0,49
16,25,5,19,0,0,0,0,0,65
16,9,5,19,8,15,16,0,0,88
16,9,5,19,20,0,0,0,0,69
16,9,5,20,5,0,0,0,0,55
16,9,5,20,25,0,0,0,0,75
16,9,5,20,9,3,0,0,0,62
16,9,5,20,9,5,19,0,0,83
16,9,5,20,9,19,13,19,0,110
16,9,5,20,9,19,20,9,3,110
16,9,5,20,9,19,20,19,0,117
16,9,5,20,15,14,0,0,0,79
16,9,5,20,15,19,5,0,0,89
16,9,5,20,15,19,15,0,0,99
16,9,5,23,9,6,5,0,0,73
16,9,5,23,9,16,5,0,0,83
16,9,5,23,15,13,1,14,0,96
16,9,5,26,15,0,0,0,0,71
16,9,6,5,18,15,0,0,0,69
16,9,6,6,0,0,0,0,0,37
16,9,6,6,5,18,15,0,0,75
16,9,6,6,12,5,0,0,0,54
16,9,6,6,12,5,4,0,0,58
16,9,6,6,12,5,18,0,0,72
16,9,6,6,12,5,19,0,0,73
16,9,6,6,12,9,14,7,0,79
16,9,6,9,14,5,0,0,0,59
16,9,7,0,0,0,0,0,0,32
16,25,7,1,12,0,0,0,0,61
16,25,7,1,12,7,9,1,0,78
16,25,7,1,18,7,0,0,0,74
16,25,7,1,18,7,21,19,0,114
16,9,7,2,5,12,12,25,0,88
16,9,7,2,15,1,20,0,0,70
16,9,7,2,15,1,20,19,0,89
16,9,7,4,1,14,0,0,0,51
16,9,7,4,15,13,0,0,0,64
16,9,7,5,15,14,5,5,18,94
16,9,7,5,15,14,5,18,0,89
16,9,7,5,15,14,9,20,5,100
16,9,7,5,15,14,13,1,14,94
16,9,7,5,15,14,16,15,24,121
16,9,7,5,15,14,18,25,0,109
16,9,7,5,15,14,19,0,0,85
16,9,7,6,1,3,5,0,0,47
16,9,7,6,9,19,8,0,0,74
16,9,7,6,9,19,8,5,19,98
16,9,7,6,12,15,23,5,18,111
16,9,7,6,15,15,20,0,0,88
16,9,7,6,21,12,0,0,0,71
16,9,7,7,0,0,0,0,0,39
16,9,7,7,5,4,0,0,0,48
16,9,7,7,5,18,25,0,0,87
16,9,7,7,5,18,9,5,19,95
16,9,7,7,25,2,1,3,11,81
16,9,7,7,9,5,0,0,0,53
16,9,7,7,9,5,18,0,0,71
16,9,7,7,9,5,19,0,0,72
16,9,7,7,9,5,19,20,0,92
16,9,7,7,9,14,0,0,0,62
16,9,7,7,9,14,7,0,0,69
16,9,7,7,9,14,19,0,0,81
16,9,7,7,9,19,8,0,0,75
16,9,7,7,9,19,8,12,25,112
16,9,7,7,12,5,0,0,0,56
16,9,7,8,5,1,4,0,0,50
16,9,7,8,5,1,4,5,4,59
16,9,7,8,5,18,4,0,0,67
16,9,7,8,20,0,0,0,0,60
16,9,7,8,20,5,12,0,0,77
16,9,7,8,20,12,5,0,0,77
16,9,7,25,1,18,4,0,0,80
16,25,7,9,4,9,1,0,0,71
16,25,7,9,4,9,1,12,0,83
16,25,7,9,4,9,4,0,0,74
16,25,7,9,7,9,4,9,1,87
16,9,7,12,5,19,19,0,0,87
16,9,7,12,5,20,0,0,0,69
16,9,7,12,5,20,19,0,0,88
16,9,7,12,25,0,0,0,0,69
16,9,7,12,9,11,5,0,0,69
16,9,7,12,9,14,7,0,0,74
16,25,7,13,1,5,1,14,0,82
16,9,7,13,1,11,5,18,0,80
16,9,7,13,1,11,9,14,7,87
16,9,7,13,1,14,0,0,0,60
16,25,7,13,5,1,14,0,0,81
16,9,7,13,5,1,20,0,0,71
16,9,7,13,5,14,20,0,0,84
16,9,7,13,5,14,20,1,12,97
16,9,7,13,5,14,20,5,4,93
16,9,7,13,5,14,20,19,0,103
16,9,7,13,5,23,0,0,0,73
16,25,7,13,25,4,15,13,0,118
16,25,7,13,25,8,15,15,4,128
16,25,7,13,25,9,19,8,0,122
16,25,7,13,25,9,19,13,0,127
16,25,7,13,25,9,19,13,19,146
16,25,7,13,25,19,8,9,16,138
16,25,7,13,25,23,5,5,4,123
16,25,7,13,15,9,4,0,0,89
16,9,7,14,5,20,0,0,0,71
16,9,7,14,15,12,9,0,0,82
16,9,7,14,15,12,9,1,0,83
16,9,7,14,15,12,9,19,0,101
16,9,7,14,15,14,0,0,0,75
16,9,7,14,15,18,1,0,0,80
16,9,7,14,15,18,1,20,5,105
16,9,7,14,21,19,0,0,0,86
16,9,7,14,21,20,0,0,0,87
16,9,7,14,21,20,19,0,0,106
16,25,7,15,6,5,18,0,0,92
16,25,7,15,16,1,7,21,19,127
16,25,7,15,16,15,4,0,0,98
16,25,7,15,19,20,25,12,5,144
16,9,7,15,21,20,0,0,0,88
16,9,7,15,21,20,19,0,0,107
16,9,7,16,5,14,0,0,0,67
16,9,7,16,5,14,19,0,0,86
16,9,7,18,9,20,9,1,0,89
16,9,7,18,9,20,21,4,5,109
16,9,7,18,15,15,20,0,0,100
16,9,7,18,15,15,20,19,0,119
16,9,7,19,3,15,14,3,5,91
16,9,7,19,11,9,14,0,0,85
16,9,7,19,11,9,14,19,0,104
16,9,7,19,14,5,25,0,0,95
16,9,7,19,14,5,25,19,0,114
16,9,7,19,14,9,5,19,0,98
16,9,7,19,20,25,0,0,0,96
16,9,7,19,20,9,3,11,0,94
16,9,7,19,20,9,3,11,19,113
16,9,7,19,20,9,5,19,0,104
16,9,7,19,23,9,12,12,0,107
16,9,7,20,1,9,12,0,0,74
16,9,7,20,1,9,12,5,4,83
16,9,7,20,1,9,12,19,0,93
16,9,7,23,1,19,8,0,0,83
16,9,7,23,5,5,4,0,0,69
16,9,7,23,5,5,4,19,0,88
16,9,7,23,9,4,7,9,14,98
16,9,7,23,9,7,5,15,14,105
16,25,9,3,0,0,0,0,0,53
16,25,9,14,0,0,0,0,0,64
16,9,9,14,7,0,0,0,0,55
16,25,9,14,19,0,0,0,0,83
16,9,9,20,9,19,0,0,0,82
16,25,10,1,13,1,0,0,0,66
16,25,10,1,13,1,5,4,0,75
16,25,10,1,13,1,19,0,0,85
16,9,11,0,0,0,0,0,0,36
16,9,11,1,0,0,0,0,0,37
16,9,11,1,11,5,0,0,0,53
16,9,11,1,11,5,19,0,0,72
16,9,11,1,19,0,0,0,0,56
16,25,11,5,0,0,0,0,0,57
16,9,11,5,4,0,0,0,0,45
16,9,11,5,25,0,0,0,0,66
16,9,11,5,12,0,0,0,0,53
16,9,11,5,12,5,20,0,0,78
16,9,11,5,12,9,11,5,0,78
16,9,11,5,13,1,14,0,0,69
16,9,11,5,13,5,14,0,0,73
16,9,11,5,16,5,18,3,8,91
16,9,11,5,18,0,0,0,0,59
16,9,11,5,18,19,0,0,0,78
16,9,11,5,19,0,0,0,0,60
16,9,11,5,19,20,1,6,6,93
16,9,11,5,20,1,9,12,0,83
16,9,11,9,0,0,0,0,0,45
16,9,11,25,0,0,0,0,0,61
16,9,11,9,14,7,0,0,0,66
16,9,11,12,5,0,0,0,0,53
16,25,11,14,1,20,15,13,0,115
16,25,11,14,9,3,0,0,0,78
16,25,11,14,9,3,19,0,0,97
16,25,11,14,15,19,5,19,0,124
16,25,11,14,15,19,9,19,0,128
16,25,11,14,15,20,9,3,0,113
16,9,12,0,0,0,0,0,0,37
16,25,12,1,0,0,0,0,0,54
16,9,12,1,6,0,0,0,0,44
16,9,12,1,6,6,0,0,0,50
16,9,12,1,6,6,19,0,0,69
16,9,12,1,6,19,0,0,0,63
16,9,12,1,7,5,0,0,0,50
16,25,12,1,7,15,18,5,0,99
16,9,12,1,14,4,9,20,5,90
16,25,12,1,14,7,9,1,12,97
16,25,12,1,14,7,9,21,13,118
16,9,12,1,16,9,12,0,0,75
16,25,12,1,18,0,0,0,0,72
16,9,12,1,18,25,0,0,0,81
16,9,12,1,19,20,5,18,0,100
16,9,12,1,19,20,5,18,19,119
16,9,12,1,19,20,18,9,3,107
16,9,12,1,21,0,0,0,0,59
16,9,12,1,21,5,4,0,0,68
16,9,12,1,21,19,0,0,0,78
16,9,12,1,23,0,0,0,0,61
16,9,12,1,23,19,0,0,0,80
16,9,12,3,8,0,0,0,0,48
16,9,12,3,8,1,18,4,0,71
16,9,12,3,8,1,18,4,19,90
16,9,12,3,8,5,18,0,0,71
16,9,12,3,8,5,18,4,0,75
16,9,12,3,15,18,14,0,0,87
16,9,12,3,18,15,23,0,0,96
16,9,12,5,0,0,0,0,0,42
16,9,12,5,1,20,1,0,0,64
16,9,12,5,1,20,5,0,0,68
16,9,12,5,1,20,5,4,0,72
16,9,12,5,4,0,0,0,0,46
16,9,12,5,9,0,0,0,0,51
16,9,12,5,9,6,15,18,13,103
16,9,12,5,12,5,19,19,0,97
16,9,12,5,15,12,9,0,0,78
16,9,12,5,15,12,21,19,0,109
16,9,12,5,15,21,19,0,0,97
16,9,12,5,18,0,0,0,0,60
16,9,12,5,18,19,0,0,0,79
16,9,12,5,19,0,0,0,0,61
16,9,12,5,21,13,0,0,0,76
16,9,12,5,21,16,0,0,0,79
16,9,12,5,21,16,19,0,0,98
16,9,12,5,21,19,0,0,0,82
16,9,12,5,23,5,5,4,0,79
16,9,12,5,23,15,18,11,0,109
16,9,12,5,23,15,18,13,0,111
16,9,12,5,23,15,18,20,0,118
16,9,12,5,23,15,18,20,19,137
16,9,12,6,5,18,0,0,0,66
16,9,12,6,5,18,1,7,5,79
16,9,12,6,5,18,5,4,0,75
16,9,12,6,5,18,5,18,0,89
16,9,12,6,5,18,5,18,19,108
16,9,12,6,5,18,25,0,0,91
16,9,12,6,5,18,9,14,7,96
16,9,12,6,5,18,19,0,0,85
16,9,12,6,18,5,0,0,0,66
16,9,12,7,1,18,12,9,3,87
16,9,12,7,18,9,13,0,0,84
16,9,12,7,18,9,13,5,18,107
16,9,12,7,18,9,13,19,0,103
16,9,12,9,0,0,0,0,0,46
16,9,12,25,0,0,0,0,0,62
16,25,12,9,3,0,0,0,0,65
16,9,12,9,4,9,21,13,0,93
16,9,12,9,5,19,0,0,0,70
16,9,12,9,6,5,18,0,0,75
16,9,12,9,6,15,18,13,0,98
16,9,12,9,7,1,14,0,0,68
16,9,12,9,7,1,14,9,14,91
16,9,12,9,11,1,9,0,0,67
16,9,12,9,11,9,1,0,0,67
16,9,12,9,12,12,15,15,0,100
16,9,12,9,14,0,0,0,0,60
16,9,12,9,14,5,0,0,0,65
16,9,12,9,14,7,0,0,0,67
16,9,12,9,14,7,19,0,0,86
16,9,12,9,19,0,0,0,0,65
16,9,12,9,20,9,3,15,0,93
16,9,12,11,9,14,19,0,0,90
16,9,12,12,0,0,0,0,0,49
16,9,12,12,1,7,5,0,0,62
16,9,12,12,1,7,5,4,0,66
16,9,12,12,1,7,5,5,0,67
16,9,12,12,1,7,5,18,19,99
16,9,12,12,1,7,5,19,0,81
16,9,12,12,1,7,9,14,7,87
16,9,12,12,1,18,0,0,0,68
16,9,12,12,1,18,5,4,0,77
16,9,12,12,1,18,5,20,0,93
16,9,12,12,1,18,25,0,0,93
16,9,12,12,1,18,9,14,7,98
16,9,12,12,1,18,9,19,20,116
16,9,12,12,1,18,9,26,5,108
16,9,12,12,1,18,12,5,20,105
16,9,12,12,1,18,19,0,0,87
16,9,12,12,1,19,0,0,0,69
16,9,12,12,2,15,24,0,0,90
16,9,12,12,2,15,24,5,19,114
16,9,12,12,5,4,0,0,0,58
16,9,12,12,5,18,0,0,0,72
16,9,12,12,5,18,25,0,0,97
16,9,12,12,5,20,0,0,0,74
16,9,12,12,5,21,19,0,0,94
16,9,12,12,8,5,1,4,0,67
16,9,12,12,9,3,15,3,11,90
16,9,12,12,9,14,7,0,0,79
16,9,12,12,9,15,14,0,0,87
16,9,12,12,9,15,14,19,0,106
16,9,12,12,9,22,5,18,0,103
16,9,12,12,13,1,11,5,18,97
16,9,12,12,15,18,25,0,0,107
16,9,12,12,15,18,9,5,4,100
16,9,12,12,15,18,9,5,19,115
16,9,12,12,15,18,9,26,5,122
16,9,12,12,15,23,2,5,18,112
16,9,12,12,15,23,5,4,0,96
16,9,12,12,15,23,25,0,0,112
16,9,12,12,15,23,9,14,7,117
16,9,12,12,15,23,19,0,0,106
16,9,12,12,19,0,0,0,0,68
16,9,12,12,21,12,1,18,0,101
16,9,12,12,21,12,5,0,0,87
16,9,12,12,23,15,18,13,0,118
16,9,12,12,23,15,18,20,0,125
16,9,12,13,0,0,0,0,0,50
16,9,12,13,25,0,0,0,0,75
16,9,12,15,13,15,20,15,18,133
16,9,12,15,14,0,0,0,0,66
16,25,12,15,14,0,0,0,0,82
16,9,12,15,14,9,4,1,12,92
16,25,12,15,14,19,0,0,0,101
16,9,12,15,18,9,0,0,0,79
16,25,12,15,18,9,0,0,0,95
16,25,12,15,18,9,3,0,0,98
16,25,12,15,18,9,20,9,19,143
16,25,12,15,18,15,21,19,0,141
16,25,12,15,18,21,19,0,0,126
16,25,12,15,18,21,19,5,19,150
16,9,12,15,19,5,0,0,0,76
16,9,12,15,19,9,14,0,0,94
16,9,12,15,19,9,14,5,0,99
16,9,12,15,19,9,19,0,0,99
16,9,12,15,19,9,19,13,0,112
16,9,12,15,19,9,20,25,0,125
16,9,12,15,20,0,0,0,0,72
16,9,12,15,20,1,7,5,0,85
16,9,12,15,20,1,7,5,19,104
16,9,12,15,20,5,4,0,0,81
16,9,12,15,20,5,5,0,0,82
16,9,12,15,20,6,9,19,8,114
16,9,12,15,20,9,0,0,0,81
16,9,12,15,20,9,14,7,0,102
16,9,12,15,20,9,14,7,19,121
16,9,12,15,20,9,19,13,0,113
16,9,12,15,20,12,5,19,19,127
16,9,12,15,20,13,1,14,0,100
16,9,12,15,20,18,25,0,0,115
16,9,12,15,20,19,0,0,0,91
16,9,12,15,20,19,8,9,16,124
16,9,12,15,20,23,5,5,4,109
16,9,12,15,21,19,0,0,0,92
16,9,12,16,21,12,0,0,0,86
16,9,12,16,21,12,9,19,20,134
16,9,12,19,5,14,5,18,19,117
16,9,12,19,14,5,18,19,0,112
16,9,12,20,15,3,11,0,0,86
16,9,12,21,12,1,0,0,0,71
16,9,12,21,12,1,18,0,0,89
16,9,12,21,12,5,0,0,0,75
16,9,12,21,12,5,19,0,0,94
16,9,12,21,12,9,19,20,0,118
16,9,12,21,12,15,21,19,0,125
16,9,12,21,13,0,0,0,0,71
16,9,12,21,19,0,0,0,0,77
16,9,12,21,19,12,9,0,0,98
16,9,12,23,9,12,12,5,20,118
16,9,13,0,0,0,0,0,0,38
16,9,13,1,18,9,3,0,0,69
16,9,13,2,9,14,1,0,0,64
16,9,13,5,12,1,20,5,0,81
16,9,13,5,12,9,3,0,0,67
16,9,13,5,12,9,20,5,0,89
16,9,13,5,12,9,20,9,19,112
16,9,13,5,14,20,0,0,0,77
16,9,13,5,14,20,5,12,0,94
16,9,13,5,14,20,15,14,0,106
16,9,13,5,14,20,15,19,0,111
16,9,13,7,5,14,5,20,0,89
16,9,13,9,5,14,20,1,0,87
16,9,13,9,5,14,20,15,0,101
16,9,13,9,5,14,20,15,19,120
16,9,13,12,9,3,15,0,0,77
16,9,13,15,12,1,0,0,0,66
16,9,13,16,0,0,0,0,0,54
16,9,13,16,5,4,0,0,0,63
16,9,13,16,5,18,25,0,0,102
16,9,13,16,5,18,14,5,12,108
16,9,13,16,9,14,7,0,0,84
16,9,13,16,9,19,8,0,0,90
16,9,13,16,12,5,0,0,0,71
16,9,13,16,12,5,4,0,0,75
16,9,13,16,12,5,19,0,0,90
16,9,13,16,12,25,0,0,0,91
16,9,13,16,12,9,5,18,0,98
16,9,13,16,12,9,5,19,20,119
16,9,13,16,12,9,14,7,0,96
16,9,13,16,12,15,0,0,0,81
16,9,13,16,12,15,5,0,0,86
16,9,13,16,12,15,21,19,0,121
16,9,13,16,19,0,0,0,0,73
16,9,13,16,19,8,9,16,0,106
16,9,14,1,0,0,0,0,0,40
16,9,14,1,2,5,20,5,0,72
16,9,14,1,3,5,15,21,19,103
16,9,14,1,3,5,19,0,0,67
16,9,14,1,3,12,5,0,0,60
16,9,14,1,3,15,9,4,0,71
16,9,14,1,3,15,12,0,0,70
16,9,14,1,3,15,12,9,3,82
16,9,14,1,3,15,12,9,14,93
16,9,14,1,3,15,14,5,0,77
16,9,14,1,3,21,12,21,13,110
16,9,14,1,6,15,18,5,19,103
16,9,14,1,25,21,19,1,0,106
16,9,14,1,11,15,9,4,0,79
16,9,14,1,14,7,0,0,0,61
16,9,14,1,14,7,19,0,0,80
16,9,14,1,18,4,0,0,0,62
16,9,14,1,18,4,19,0,0,81
16,9,14,1,19,0,0,0,0,59
16,9,14,1,19,20,5,18,0,102
16,9,14,1,19,20,5,18,19,121
16,9,14,1,20,1,0,0,0,61
16,9,14,1,20,1,19,0,0,80
16,9,14,1,20,25,16,5,0,106
16,9,14,1,24,0,0,0,0,64
16,9,14,2,1,12,12,0,0,66
16,9,14,2,1,12,12,19,0,85
16,9,14,2,5,6,15,18,5,90
16,9,14,2,15,14,5,0,0,75
16,9,14,2,15,14,5,19,0,94
16,9,14,2,18,1,9,14,0,83
16,9,14,2,21,19,8,0,0,89
16,9,14,3,1,19,5,0,0,67
16,9,14,3,5,13,5,14,20,99
16,9,14,3,5,18,0,0,0,65
16,9,14,3,5,18,19,0,0,84
16,9,14,3,5,20,20,5,0,92
16,9,14,3,8,0,0,0,0,50
16,9,14,3,8,1,2,12,5,70
16,9,14,3,8,2,1,3,11,67
16,9,14,3,8,2,5,3,11,71
16,9,14,3,8,2,21,7,0,80
16,9,14,3,8,2,21,7,19,99
16,9,14,3,8,3,15,3,11,82
16,9,14,3,8,5,0,0,0,55
16,9,14,3,8,5,3,11,0,69
16,9,14,3,8,5,3,11,19,88
16,9,14,3,8,5,4,0,0,59
16,9,14,3,8,5,4,12,25,96
16,9,14,3,8,5,13,0,0,68
16,9,14,3,8,5,18,0,0,73
16,9,14,3,8,5,18,19,0,92
16,9,14,3,8,5,19,0,0,74
16,9,14,3,8,6,9,19,20,104
16,9,14,3,8,7,21,20,0,98
16,9,14,3,8,9,14,7,0,80
16,9,14,3,15,6,6,9,14,92
16,9,14,3,16,9,14,3,0,84
16,9,14,4,0,0,0,0,0,43
16,9,14,4,1,0,0,0,0,44
16,9,14,4,1,12,0,0,0,56
16,9,14,4,1,18,9,3,19,93
16,9,14,4,5,18,0,0,0,66
16,9,14,4,5,18,19,0,0,85
16,9,14,4,25,0,0,0,0,68
16,9,14,4,10,1,10,1,16,81
16,9,14,4,12,9,14,7,0,85
16,9,14,5,1,12,0,0,0,57
16,9,14,5,1,12,9,19,13,98
16,9,14,5,1,12,15,13,1,86
16,9,14,5,1,16,16,12,5,94
16,9,14,5,3,15,14,5,0,81
16,9,14,5,3,15,14,5,19,100
16,9,14,5,4,0,0,0,0,48
16,9,14,5,4,18,15,16,19,116
16,9,14,5,25,0,0,0,0,69
16,9,14,5,12,9,11,5,0,81
16,9,14,5,14,5,0,0,0,63
16,9,14,5,14,5,19,0,0,82
16,9,14,5,18,0,0,0,0,62
16,9,14,5,18,25,0,0,0,87
16,9,14,5,18,9,5,19,0,95
16,9,14,5,19,1,16,0,0,80
16,9,14,5,19,1,16,19,0,99
16,9,14,5,20,1,0,0,0,65
16,9,14,5,20,21,13,0,0,98
16,9,14,5,23,5,5,4,0,81
16,9,14,5,23,15,15,4,19,120
16,9,14,6,1,12,12,0,0,70
16,9,14,6,9,18,5,0,0,77
16,9,14,6,9,19,8,0,0,81
16,9,14,6,9,19,8,5,19,105
16,9,14,6,15,12,4,0,0,76
16,9,14,6,15,12,4,5,4,85
16,9,14,6,15,12,4,19,0,95
16,9,14,7,5,0,0,0,0,51
16,9,14,7,5,4,0,0,0,55
16,9,14,7,5,18,0,0,0,69
16,9,14,7,5,18,19,0,0,88
16,9,14,7,9,14,7,0,0,76
16,9,14,7,12,5,0,0,0,63
16,9,14,7,12,5,18,0,0,81
16,9,14,7,15,0,0,0,0,61
16,9,14,7,15,19,0,0,0,80
16,9,14,7,18,1,19,19,0,103
16,9,14,7,19,0,0,0,0,65
16,9,14,7,19,20,5,18,0,108
16,9,14,7,21,5,0,0,0,72
16,9,14,7,21,5,6,25,0,103
16,9,14,7,21,9,4,0,0,80
16,9,14,7,21,9,14,0,0,90
16,9,14,7,21,9,20,5,0,101
16,9,14,8,5,1,4,0,0,57
16,9,14,8,5,1,4,5,4,66
16,9,14,8,5,1,4,19,0,76
16,9,14,8,15,12,4,0,0,78
16,9,14,8,15,12,5,0,0,79
16,9,14,8,15,12,5,19,0,98
16,9,14,8,15,15,11,0,0,88
16,9,14,25,0,0,0,0,0,64
16,9,14,9,3,0,0,0,0,51
16,9,14,9,5,18,0,0,0,71
16,9,14,9,5,19,20,0,0,92
16,9,14,9,6,15,18,13,0,100
16,9,14,25,9,14,0,0,0,87
16,9,14,25,9,14,19,0,0,106
16,9,14,25,12,0,0,0,0,76
16,9,14,9,14,7,0,0,0,69
16,9,14,9,14,7,12,25,0,106
16,9,14,9,14,7,19,0,0,88
16,9,14,9,15,14,0,0,0,77
16,9,14,25,15,14,0,0,0,93
16,9,14,9,15,14,5,4,0,86
16,9,14,9,15,14,9,14,7,107
16,9,14,9,15,14,19,0,0,96
16,9,14,25,15,14,19,0,0,112
16,9,14,9,20,5,0,0,0,73
16,9,14,9,20,5,19,0,0,92
16,9,14,9,20,15,12,0,0,95
16,9,14,9,20,15,12,19,0,114
16,9,14,10,1,14,5,0,0,69
16,9,14,10,18,1,0,0,0,68
16,9,14,11,0,0,0,0,0,50
16,9,14,11,1,14,25,0,0,90
16,9,14,11,2,5,18,18,25,118
16,9,14,11,5,4,0,0,0,59
16,9,14,11,5,5,14,0,0,74
16,9,14,11,5,25,0,0,0,80
16,9,14,11,5,25,5,0,0,85
16,9,14,11,5,25,5,19,0,104
16,9,14,11,5,25,19,0,0,99
16,9,14,11,5,14,0,0,0,69
16,9,14,11,5,14,5,4,0,78
16,9,14,11,5,14,25,0,0,94
16,9,14,11,5,14,19,0,0,88
16,9,14,11,5,18,0,0,0,73
16,9,14,11,5,18,19,0,0,92
16,9,14,11,5,19,20,0,0,94
16,9,14,11,6,9,19,8,0,92
16,9,14,11,25,0,0,0,0,75
16,9,14,11,9,5,0,0,0,64
16,9,14,11,9,5,19,0,0,83
16,9,14,11,9,6,25,0,0,90
16,9,14,11,9,6,9,5,4,83
16,9,14,11,9,12,25,0,0,96
16,9,14,11,9,14,5,19,19,116
16,9,14,11,9,14,7,0,0,80
16,9,14,11,9,14,7,19,0,99
16,9,14,11,9,19,8,0,0,86
16,9,14,11,12,25,0,0,0,87
16,9,14,11,14,5,19,19,0,107
16,9,14,11,15,0,0,0,0,65
16,9,14,11,15,5,19,0,0,89
16,9,14,11,15,19,0,0,0,84
16,9,14,11,18,15,15,20,0,118
16,9,14,11,18,15,15,20,19,137
16,9,14,11,19,0,0,0,0,69
16,9,14,11,19,15,13,5,0,102
16,9,14,11,23,5,5,4,0,87
16,9,14,11,23,15,15,4,0,107
16,9,14,11,23,15,18,20,0,126
16,9,14,12,5,19,19,0,0,94
16,9,14,12,15,3,11,0,0,80
16,9,14,13,1,11,5,18,0,87
16,9,14,13,1,11,9,14,7,94
16,9,14,13,1,14,0,0,0,67
16,9,14,14,1,3,5,0,0,62
16,9,14,14,1,3,5,19,0,81
16,9,14,14,1,3,12,5,0,74
16,9,14,14,1,3,12,5,4,78
16,9,14,14,1,3,12,5,19,93
16,9,14,14,1,3,12,5,20,94
16,9,14,14,1,5,0,0,0,59
16,9,14,14,1,7,5,0,0,66
16,9,14,14,1,12,0,0,0,66
16,9,14,14,1,19,0,0,0,73
16,9,14,14,1,20,5,0,0,79
16,9,14,14,1,20,5,4,0,83
16,9,14,14,1,20,5,12,25,116
16,9,14,14,1,20,9,15,14,112
16,9,14,14,5,4,0,0,0,62
16,9,14,14,5,12,0,0,0,70
16,9,14,14,5,18,0,0,0,76
16,9,14,14,5,18,19,0,0,95
16,9,14,14,5,20,0,0,0,78
16,9,14,14,25,0,0,0,0,78
16,9,14,14,9,5,19,0,0,86
16,9,14,14,9,6,15,18,13,114
16,9,14,14,9,14,7,0,0,83
16,9,14,14,9,14,7,12,25,120
16,9,14,14,9,14,7,19,0,102
16,9,14,14,9,16,5,4,0,87
16,9,14,14,9,16,5,4,19,106
16,9,14,14,9,19,5,3,20,109
16,9,14,14,15,3,11,0,0,82
16,9,14,14,15,9,20,5,0,102
16,9,14,14,15,20,5,18,5,116
16,9,14,14,21,12,1,0,0,87
16,9,14,14,21,12,1,5,0,92
16,9,14,14,21,12,1,18,0,105
16,9,14,14,21,12,1,20,5,112
16,9,14,14,21,12,5,0,0,91
16,9,14,14,21,12,5,19,0,110
16,9,14,14,21,12,5,20,0,111
16,9,14,15,0,0,0,0,0,54
16,9,14,15,3,3,8,9,15,92
16,9,14,15,3,8,12,5,0,82
16,9,14,15,3,8,12,5,19,101
16,9,14,15,3,12,5,0,0,74
16,9,14,15,3,12,5,19,0,93
16,9,14,15,12,5,19,0,0,90
16,9,14,15,12,5,21,13,0,105
16,9,14,15,12,9,1,0,0,76
16,9,14,15,12,9,14,0,0,89
16,9,14,15,14,5,19,0,0,92
16,9,14,15,14,9,3,0,0,80
16,9,14,15,14,19,0,0,0,87
16,25,14,15,20,0,0,0,0,90
16,9,14,15,20,19,0,0,0,93
16,9,14,16,9,12,12,15,23,126
16,9,14,16,15,9,14,20,0,113
16,9,14,16,15,9,14,20,19,132
16,9,14,16,18,9,3,11,0,96
16,9,14,16,18,9,3,11,19,115
16,9,14,16,18,15,15,6,0,109
16,9,14,18,1,9,12,0,0,79
16,9,14,18,15,23,5,4,0,104
16,9,14,19,0,0,0,0,0,58
16,9,14,19,3,8,5,18,0,92
16,9,14,19,3,8,5,18,19,111
16,9,14,19,5,20,20,5,18,126
16,9,14,19,15,14,19,0,0,106
16,9,14,19,20,18,9,16,5,126
16,9,14,20,0,0,0,0,0,59
16,9,14,20,1,4,1,0,0,65
16,9,14,20,1,4,1,19,0,84
16,9,14,20,1,4,5,18,1,88
16,9,14,20,1,4,15,0,0,79
16,9,14,20,1,4,15,5,19,103
16,9,14,20,1,4,15,19,0,98
16,9,14,20,1,9,12,0,0,81
16,9,14,20,1,9,12,19,0,100
16,9,14,20,1,14,15,0,0,89
16,9,14,20,1,14,15,19,0,108
16,9,14,20,1,19,0,0,0,79
16,9,14,20,5,0,0,0,0,64
16,9,14,20,9,4,0,0,0,72
16,9,14,20,12,5,0,0,0,76
16,9,14,20,12,5,19,0,0,95
16,9,14,20,15,5,19,0,0,98
16,9,14,20,15,19,0,0,0,93
16,9,14,20,19,0,0,0,0,78
16,9,14,20,19,9,26,5,0,118
16,9,14,20,21,18,1,0,0,99
16,9,14,21,5,12,1,0,0,78
16,9,14,21,12,21,19,0,0,112
16,25,14,21,14,7,0,0,0,97
16,9,14,21,16,0,0,0,0,76
16,9,14,21,16,19,0,0,0,95
16,9,14,23,1,12,5,0,0,80
16,9,14,23,1,12,5,19,0,99
16,9,14,23,5,5,4,0,0,76
16,9,14,23,5,5,4,19,0,95
16,9,14,23,8,5,5,12,0,92
16,9,14,23,8,5,5,12,19,111
16,9,14,23,9,14,7,0,0,92
16,9,14,23,15,18,11,0,0,106
16,9,14,23,15,18,11,19,0,125
16,9,14,23,15,18,13,0,0,108
16,9,14,23,15,18,13,19,0,127
16,9,14,24,0,0,0,0,0,63
16,9,14,24,9,20,0,0,0,92
16,25,15,3,5,12,5,0,0,81
16,25,15,3,25,1,14,9,14,122
16,25,15,3,25,19,20,0,0,123
16,25,15,3,25,20,5,0,0,109
16,25,15,3,20,1,14,9,14,117
16,25,15,4,5,18,13,1,0,97
16,25,15,4,5,18,13,1,19,116
16,25,15,4,5,18,13,9,1,106
16,25,15,4,5,18,13,9,3,108
16,25,15,7,5,14,9,3,0,94
16,25,15,7,5,14,9,14,0,105
16,25,15,7,5,14,15,21,19,137
16,25,15,9,4,0,0,0,0,69
16,9,15,12,5,20,0,0,0,77
16,9,15,12,5,20,19,0,0,96
16,25,15,12,25,13,16,8,0,130
16,25,15,13,5,20,18,1,0,113
16,9,15,14,0,0,0,0,0,54
16,9,15,14,5,4,0,0,0,63
16,9,15,14,5,5,18,5,4,91
16,9,15,14,5,5,18,19,0,101
16,9,15,14,5,18,25,0,0,102
16,9,15,14,9,3,0,0,0,66
16,9,15,14,14,15,20,5,19,127
16,9,15,14,19,0,0,0,0,73
16,25,15,16,8,1,7,9,1,98
16,25,15,16,12,1,14,9,1,109
16,25,15,16,20,25,19,9,19,164
16,25,15,18,18,8,5,1,0,106
16,25,15,18,18,8,5,1,12,118
16,25,15,18,18,8,5,1,19,125
16,25,15,18,18,8,5,9,3,117
16,25,15,18,18,8,15,5,1,121
16,9,15,19,3,15,16,5,0,98
16,25,15,19,5,19,0,0,0,99
16,25,15,19,9,19,0,0,0,103
16,9,15,19,9,20,25,0,0,113
16,9,15,19,9,20,9,5,19,121
16,9,15,20,5,4,0,0,0,69
16,25,15,20,8,15,18,1,24,142
16,9,15,20,9,14,5,0,0,88
16,9,15,20,20,25,0,0,0,105
16,9,15,21,16,9,15,21,0,122
16,25,15,21,18,5,20,5,18,143
16,9,15,21,18,25,0,0,0,104
16,9,15,21,19,0,0,0,0,80
16,9,15,21,19,12,25,0,0,117
16,9,15,21,19,14,5,19,19,137
16,9,16,1,0,0,0,0,0,42
16,9,16,1,7,5,0,0,0,54
16,9,16,1,7,5,19,0,0,73
16,9,16,1,12,0,0,0,0,54
16,9,16,1,12,19,0,0,0,73
16,9,16,5,0,0,0,0,0,46
16,9,16,5,1,7,5,0,0,59
16,9,16,5,1,7,5,19,0,78
16,9,16,5,3,12,1,25,0,87
16,9,16,5,3,15,12,9,14,99
16,9,16,5,4,0,0,0,0,50
16,9,16,5,4,18,5,1,13,87
16,9,16,5,6,9,19,8,0,88
16,9,16,5,6,21,12,0,0,85
16,9,16,5,6,21,12,19,0,104
16,9,16,5,25,0,0,0,0,71
16,9,16,5,12,1,25,5,18,107
16,9,16,5,12,5,19,19,0,101
16,9,16,5,12,9,11,5,0,83
16,9,16,5,12,9,14,5,0,86
16,9,16,5,12,9,14,5,4,90
16,9,16,5,12,9,14,5,19,105
16,9,16,5,13,1,14,0,0,74
16,9,16,5,13,15,21,20,8,123
16,9,16,5,18,1,20,5,0,90
16,9,16,5,18,1,26,9,14,114
16,9,16,5,18,25,0,0,0,89
16,9,16,5,18,9,3,0,0,76
16,9,16,5,18,9,4,5,0,82
16,9,16,5,18,9,4,7,5,89
16,9,16,5,18,9,4,9,4,90
16,9,16,5,18,9,4,9,14,100
16,9,16,5,18,9,14,5,0,92
16,9,16,5,18,9,14,5,19,111
16,9,16,5,18,12,25,0,0,101
16,9,16,5,18,14,15,0,0,93
16,9,16,5,18,15,9,4,0,92
16,9,16,5,18,15,14,1,12,106
16,9,16,5,18,15,14,25,12,130
16,9,16,5,18,19,0,0,0,83
16,9,16,5,19,0,0,0,0,65
16,9,16,5,19,20,5,13,19,122
16,9,16,5,20,0,0,0,0,66
16,9,16,5,20,19,0,0,0,85
16,9,16,5,20,20,5,0,0,91
16,9,16,5,20,20,5,4,0,95
16,9,16,5,20,20,5,19,0,110
16,9,16,5,20,20,9,14,7,116
16,9,16,5,23,15,15,4,0,103
16,9,16,5,23,15,18,11,0,113
16,9,16,5,23,15,18,20,0,122
16,9,16,9,0,0,0,0,0,50
16,9,16,25,0,0,0,0,0,66
16,9,16,9,4,0,0,0,0,54
16,9,16,9,5,18,0,0,0,73
16,9,16,9,5,19,20,0,0,94
16,9,16,9,11,1,21,12,1,96
16,9,16,9,14,5,19,19,0,107
16,9,16,9,14,7,0,0,0,71
16,9,16,9,14,7,12,25,0,108
16,9,16,9,14,7,19,0,0,90
16,9,16,9,18,9,0,0,0,77
16,9,16,9,19,20,18,5,12,124
16,9,16,9,20,0,0,0,0,70
16,9,16,9,20,19,0,0,0,89
16,9,16,11,9,14,0,0,0,75
16,9,16,11,9,14,5,20,0,100
16,9,16,11,9,14,19,0,0,94
16,9,16,12,5,19,19,0,0,96
16,9,16,16,5,4,0,0,0,66
16,9,16,16,5,14,0,0,0,76
16,9,16,16,5,18,0,0,0,80
16,9,16,16,9,5,18,0,0,89
16,9,16,16,9,5,19,20,0,110
16,9,16,16,9,14,0,0,0,80
16,9,16,16,9,14,5,18,0,103
16,9,16,16,9,14,7,0,0,87
16,9,16,16,9,14,19,0,0,99
16,9,16,16,12,5,0,0,0,74
16,9,16,18,9,14,5,0,0,87
16,9,16,18,15,9,4,0,0,87
16,9,16,19,0,0,0,0,0,60
16,9,16,19,17,21,5,1,11,115
16,9,17,21,0,0,0,0,0,63
16,9,17,21,1,2,12,5,0,83
16,9,17,21,1,14,3,5,0,86
16,9,17,21,1,14,3,25,0,106
16,9,17,21,1,14,20,0,0,98
16,9,17,21,1,14,20,12,25,135
16,9,17,21,5,0,0,0,0,68
16,9,17,21,5,4,0,0,0,72
16,9,17,21,5,18,15,0,0,101
16,9,17,21,5,19,0,0,0,87
16,9,17,21,5,20,0,0,0,88
16,9,17,21,5,20,19,0,0,107
16,9,17,21,5,20,20,5,0,113
16,9,17,21,5,21,18,0,0,107
16,9,17,21,9,1,0,0,0,73
16,9,17,21,9,5,18,5,0,100
16,9,17,21,9,14,7,0,0,93
16,9,17,21,18,5,0,0,0,86
16,9,18,0,0,0,0,0,0,43
16,25,18,0,0,0,0,0,0,59
16,25,18,1,3,1,14,20,8,106
16,25,18,1,3,5,14,5,0,87
16,9,18,1,3,25,0,0,0,72
16,9,18,1,3,9,5,19,0,80
16,9,18,1,7,21,1,0,0,73
16,9,18,1,7,21,1,19,0,92
16,9,18,1,25,1,0,0,0,70
16,9,18,1,25,1,19,0,0,89
16,25,18,1,12,0,0,0,0,72
16,25,18,1,12,9,4,0,0,85
16,25,18,1,12,9,4,1,14,100
16,25,18,1,12,9,4,9,4,98
16,25,18,1,12,9,4,19,0,104
16,25,18,1,12,9,19,0,0,100
16,25,18,1,12,15,9,4,0,100
16,25,18,1,13,9,4,0,0,86
16,25,18,1,13,9,4,1,12,99
16,25,18,1,13,9,4,5,4,95
16,25,18,1,13,9,4,5,18,109
16,25,18,1,13,9,4,5,19,110
16,25,18,1,13,9,4,9,1,96
16,25,18,1,13,9,4,9,3,98
16,25,18,1,13,9,4,19,0,105
16,25,18,1,13,15,9,4,0,101
16,25,18,1,13,21,19,0,0,113
16,25,18,1,14,0,0,0,0,74
16,9,18,1,14,1,0,0,0,59
16,9,18,1,14,1,19,0,0,78
16,9,18,1,14,8,1,0,0,67
16,9,18,1,14,8,1,19,0,86
16,25,18,1,14,25,12,0,0,111
16,25,18,1,14,15,9,4,0,102
16,25,18,1,14,15,19,5,0,113
16,25,18,1,14,15,19,5,19,132
16,25,18,1,14,19,0,0,0,93
16,9,18,1,18,21,3,21,0,107
16,9,18,1,18,21,3,21,19,126
16,9,18,1,20,5,0,0,0,69
16,9,18,1,20,5,4,0,0,73
16,9,18,1,20,5,18,25,0,112
16,9,18,1,20,5,19,0,0,88
16,9,18,1,20,5,19,19,0,107
16,9,18,1,20,25,0,0,0,89
16,9,18,1,20,9,3,0,0,76
16,9,18,1,20,9,3,1,12,89
16,9,18,1,20,9,14,7,0,94
16,9,18,1,20,9,19,13,0,105
16,9,18,1,20,9,26,5,0,104
16,9,18,1,20,18,25,0,0,107
16,25,18,1,26,9,14,0,0,109
16,25,18,1,26,9,14,5,0,114
16,25,18,1,26,15,12,5,0,118
16,25,18,1,26,15,12,25,12,150
16,25,18,5,0,0,0,0,0,64
16,25,18,5,3,20,9,3,0,99
16,25,18,5,14,1,0,0,0,79
16,25,18,5,14,5,19,0,0,102
16,25,18,5,14,9,3,0,0,90
16,25,18,5,14,9,14,0,0,101
16,25,18,5,14,15,9,4,0,106
16,25,18,5,14,15,9,4,19,125
16,25,18,5,19,0,0,0,0,83
16,25,18,5,20,8,18,9,14,133
16,25,18,5,20,9,3,0,0,96
16,25,18,5,24,9,1,0,0,98
16,25,18,5,24,9,1,12,0,110
16,25,18,5,24,9,1,19,0,117
16,25,18,5,24,9,3,0,0,100
16,25,18,5,24,9,3,1,12,113
16,25,18,7,15,9,4,1,12,107
16,25,18,7,15,13,0,0,0,94
16,25,18,9,2,15,12,5,0,102
16,25,18,9,3,0,0,0,0,71
16,25,18,9,4,9,3,0,0,84
16,25,18,9,4,25,12,0,0,109
16,25,18,9,4,9,14,5,0,100
16,25,18,9,4,9,14,5,19,119
16,25,18,9,4,15,14,5,0,106
16,25,18,9,4,15,24,1,12,124
16,25,18,9,4,15,24,9,14,134
16,9,18,9,6,15,18,13,0,104
16,25,18,9,6,15,18,13,0,120
16,9,18,9,10,9,18,9,0,98
16,25,18,25,12,9,21,13,0,139
16,25,18,9,13,9,4,25,12,131
16,25,18,9,13,9,4,9,14,117
16,9,18,9,16,9,18,9,0,104
16,9,18,9,18,9,7,21,1,108
16,25,18,9,20,5,0,0,0,93
16,25,18,9,20,9,3,0,0,100
16,25,18,9,20,9,3,1,12,113
16,25,18,9,20,9,26,5,0,128
16,25,18,9,20,15,9,4,0,116
16,25,18,9,20,15,21,19,0,143
16,9,18,12,0,0,0,0,0,55
16,9,18,12,9,5,0,0,0,69
16,9,18,14,0,0,0,0,0,57
16,9,18,14,5,4,0,0,0,66
16,9,18,14,5,18,0,0,0,80
16,9,18,14,25,0,0,0,0,82
16,9,18,14,9,5,0,0,0,71
16,9,18,14,19,0,0,0,0,76
16,25,18,15,0,0,0,0,0,74
16,25,18,15,1,3,9,4,0,91
16,25,18,15,2,9,0,0,0,85
16,25,18,15,2,15,18,9,3,121
16,25,18,15,3,15,12,12,0,116
16,9,18,15,7,0,0,0,0,65
16,9,18,15,7,5,14,0,0,84
16,25,18,15,7,5,14,0,0,100
16,25,18,15,7,5,14,9,3,112
16,25,18,15,7,5,14,19,0,119
16,9,18,15,7,8,9,0,0,82
16,9,18,15,7,9,0,0,0,74
16,9,18,15,7,9,5,19,0,98
16,25,18,15,7,18,1,16,8,124
16,9,18,15,7,21,5,0,0,91
16,9,18,15,7,21,5,19,0,110
16,25,18,15,9,4,0,0,0,87
16,9,18,15,10,11,9,0,0,88
16,9,18,15,12,0,0,0,0,70
16,25,18,15,12,1,19,0,0,106
16,25,18,15,12,1,20,5,18,130
16,25,18,15,12,1,20,18,25,150
16,25,18,15,12,9,14,5,0,114
16,25,18,15,12,25,19,5,0,135
16,25,18,15,12,25,19,9,19,158
16,25,18,15,12,9,20,5,0,120
16,25,18,15,12,25,20,9,3,143
16,25,18,15,12,25,26,5,0,142
16,25,18,15,12,25,26,5,4,146
16,25,18,15,12,25,26,5,18,160
16,25,18,15,12,25,26,5,19,161
16,25,18,15,12,15,7,25,0,133
16,25,18,15,13,1,3,8,25,124
16,25,18,15,13,1,14,3,25,130
16,25,18,15,13,1,14,9,1,112
16,25,18,15,13,5,20,5,18,135
16,25,18,15,13,5,20,18,25,155
16,25,18,15,13,15,20,15,18,155
16,25,18,15,13,21,3,9,3,123
16,25,18,15,13,21,3,25,12,148
16,25,18,15,14,5,0,0,0,93
16,25,18,15,14,5,19,0,0,112
16,25,18,15,14,9,14,5,0,116
16,25,18,15,14,9,14,5,19,135
16,25,18,15,14,25,24,9,19,165
16,9,18,15,15,20,0,0,0,93
16,25,18,15,16,5,0,0,0,95
16,25,18,15,16,5,14,0,0,109
16,25,18,15,16,5,19,0,0,114
16,25,18,15,16,8,9,12,5,124
16,25,18,15,16,8,15,14,5,132
16,9,18,15,16,12,1,19,13,119
16,25,18,15,16,21,19,0,0,130
16,9,18,15,17,21,5,0,0,101
16,9,18,15,17,21,5,19,0,120
16,25,18,15,19,3,15,16,5,132
16,25,18,15,19,3,15,16,25,152
16,9,18,15,19,8,11,9,0,105
16,25,18,15,19,9,19,0,0,121
16,25,18,15,19,9,19,5,19,145
16,25,18,15,19,15,13,5,0,126
16,25,18,15,19,20,1,20,0,134
16,25,18,15,19,20,1,20,19,153
16,9,18,15,20,0,0,0,0,78
16,25,18,15,20,9,3,0,0,106
16,25,18,15,20,15,24,9,14,156
16,9,18,15,21,5,20,20,5,129
16,25,18,15,21,18,9,3,0,125
16,25,18,15,24,5,14,5,0,122
16,25,18,15,24,5,14,5,19,141
16,25,18,15,24,5,14,9,3,129
16,25,18,15,24,25,12,5,0,140
16,25,18,15,24,25,12,9,3,147
16,25,18,15,24,25,12,9,14,158
16,9,18,15,26,8,11,9,0,112
16,9,18,15,26,8,15,11,0,118
16,9,18,18,0,0,0,0,0,61
16,9,18,18,1,21,18,1,0,102
16,9,18,18,1,21,18,21,0,122
16,25,18,18,8,9,3,19,0,116
16,25,18,18,8,15,21,19,0,140
16,9,18,18,9,5,0,0,0,75
16,25,18,18,25,12,0,0,0,114
16,25,18,18,25,12,5,14,5,138
16,9,18,18,13,1,23,0,0,98
16,25,18,18,15,25,12,0,0,129
16,25,18,18,15,12,0,0,0,104
16,25,18,18,15,12,5,0,0,109
16,25,18,18,15,12,5,19,0,128
16,25,18,18,15,12,9,3,0,116
16,25,18,18,15,12,9,14,5,132
16,25,18,18,15,12,19,0,0,123
16,25,18,21,12,9,14,5,0,120
16,25,18,21,12,15,9,4,0,120
16,25,18,21,22,1,20,5,0,128
16,25,18,21,22,1,20,5,19,147
16,25,18,21,22,9,3,0,0,114
16,25,18,21,22,9,12,0,0,123
16,25,18,21,22,25,12,0,0,139
16,25,18,21,23,12,0,0,0,115
16,9,19,0,0,0,0,0,0,44
16,9,19,1,3,8,5,5,0,66
16,9,19,1,3,8,9,0,0,65
16,9,19,1,25,0,0,0,0,70
16,9,19,1,14,7,0,0,0,66
16,9,19,1,14,9,20,5,0,93
16,9,19,3,1,18,25,0,0,91
16,9,19,3,1,18,9,5,19,99
16,9,19,3,1,20,9,15,14,106
16,9,19,3,1,20,15,18,0,101
16,9,19,3,1,20,15,18,25,126
16,9,19,3,1,20,15,18,19,120
16,9,19,3,9,1,14,0,0,71
16,9,19,3,9,3,9,4,5,77
16,9,19,3,9,6,15,18,13,108
16,9,19,3,9,14,1,0,0,71
16,9,19,3,9,14,1,5,0,76
16,9,19,3,9,14,1,12,0,83
16,9,19,3,9,14,1,19,0,90
16,9,19,3,9,14,5,0,0,75
16,9,19,3,9,14,9,20,25,124
16,9,19,3,9,15,9,4,0,84
16,9,19,3,15,0,0,0,0,62
16,9,19,3,15,19,0,0,0,81
16,9,19,5,0,0,0,0,0,49
16,9,19,8,1,21,7,0,0,81
16,9,19,8,5,4,0,0,0,61
16,9,19,8,5,19,0,0,0,76
16,9,19,8,9,14,7,0,0,82
16,9,19,8,15,7,5,0,0,79
16,9,19,8,15,7,5,19,0,98
16,9,19,8,15,7,21,5,0,100
16,9,19,8,16,1,19,8,0,96
16,9,19,8,16,15,19,8,0,110
16,9,19,8,21,0,0,0,0,73
16,9,19,9,6,15,18,13,0,105
16,9,19,9,6,15,18,13,19,124
16,9,19,11,0,0,0,0,0,55
16,9,19,11,25,0,0,0,0,80
16,9,19,11,21,14,0,0,0,90
16,9,19,13,9,18,5,0,0,89
16,9,19,13,9,18,5,19,0,108
16,9,19,13,9,18,9,19,13,125
16,9,19,13,15,0,0,0,0,72
16,9,19,15,0,0,0,0,0,59
16,9,19,15,12,9,20,5,0,105
16,9,19,15,12,9,20,5,19,124
16,9,19,15,12,9,20,9,3,112
16,9,19,15,20,5,0,0,0,84
16,9,19,19,0,0,0,0,0,63
16,9,19,19,1,2,5,4,0,75
16,9,19,19,1,14,20,0,0,98
16,9,19,19,1,14,20,19,0,117
16,9,19,19,5,4,0,0,0,72
16,9,19,19,5,18,0,0,0,86
16,9,19,19,5,18,19,0,0,105
16,9,19,19,5,19,0,0,0,87
16,9,19,19,9,14,7,0,0,93
16,9,19,19,15,4,5,19,0,106
16,9,19,19,15,9,18,0,0,105
16,9,19,19,15,9,18,19,0,124
16,9,19,20,0,0,0,0,0,64
16,9,19,20,1,3,8,5,0,81
16,9,19,20,1,3,8,5,19,100
16,9,19,20,1,3,8,9,15,100
16,9,19,20,1,3,9,20,5,102
16,9,19,20,1,18,5,5,14,107
16,9,19,20,5,0,0,0,0,69
16,9,19,20,5,19,0,0,0,88
16,9,19,20,9,3,0,0,0,76
16,9,19,20,9,3,11,0,0,87
16,9,19,20,9,12,0,0,0,85
16,9,19,20,9,12,12,1,18,116
16,9,19,20,9,12,12,9,4,110
16,9,19,20,9,12,15,7,25,132
16,9,19,20,9,12,19,0,0,104
16,9,19,20,12,5,0,0,0,81
16,9,19,20,12,5,18,0,0,99
16,9,19,20,15,12,0,0,0,91
16,9,19,20,15,12,1,4,5,101
16,9,19,20,15,12,5,0,0,96
16,9,19,20,15,12,5,4,0,100
16,9,19,20,15,12,5,5,18,119
16,9,19,20,15,12,5,19,0,115
16,9,19,20,15,12,5,20,0,116
16,9,19,20,15,12,9,5,18,123
16,9,19,20,15,12,9,14,7,121
16,9,19,20,15,12,12,5,4,112
16,9,19,20,15,12,15,7,25,138
16,9,19,20,15,12,19,0,0,110
16,9,19,20,15,14,19,0,0,112
16,9,19,20,18,9,3,5,19,118
16,9,19,20,18,9,24,0,0,115
16,9,20,1,0,0,0,0,0,46
16,9,20,1,8,1,25,1,0,81
16,9,20,1,25,1,0,0,0,72
16,9,20,1,25,9,20,1,0,101
16,9,20,1,14,7,1,0,0,68
16,9,20,1,14,7,21,1,0,89
16,9,20,1,16,1,20,0,0,83
16,9,20,1,16,1,20,19,0,102
16,9,20,1,18,1,8,0,0,73
16,9,20,1,19,0,0,0,0,65
16,9,20,1,19,20,9,12,5,111
16,9,20,1,21,0,0,0,0,67
16,9,20,1,23,1,19,0,0,89
16,9,20,2,9,18,4,0,0,78
16,9,20,3,8,0,0,0,0,56
16,9,20,3,8,1,2,12,5,76
16,9,20,3,8,5,4,0,0,65
16,9,20,3,8,5,18,5,4,88
16,9,20,3,8,5,18,25,0,104
16,9,20,3,8,5,18,19,0,98
16,9,20,3,8,5,19,0,0,80
16,9,20,3,8,6,15,18,11,106
16,9,20,3,8,8,15,12,5,96
16,9,20,3,8,9,0,0,0,65
16,9,20,3,8,25,0,0,0,81
16,9,20,3,8,9,5,18,0,88
16,9,20,3,8,9,5,19,20,109
16,9,20,3,8,9,12,25,0,102
16,9,20,3,8,9,14,7,0,86
16,9,20,3,8,12,9,11,5,93
16,9,20,3,8,13,1,14,0,84
16,9,20,3,8,13,5,14,0,88
16,9,20,3,8,15,21,20,0,112
16,9,20,3,8,15,21,20,19,131
16,9,20,3,8,16,9,11,5,97
16,9,20,3,8,16,15,12,5,104
16,9,20,3,8,16,15,12,12,111
16,9,20,3,8,16,15,20,0,107
16,9,20,3,8,23,15,18,11,123
16,9,20,5,9,18,1,0,0,78
16,9,20,5,15,21,19,0,0,105
16,9,20,5,15,21,19,12,25,142
16,9,20,6,1,12,12,0,0,76
16,9,20,6,1,12,12,19,0,95
16,9,20,6,15,12,4,0,0,82
16,9,20,8,0,0,0,0,0,53
16,9,20,8,5,1,4,0,0,63
16,9,20,8,5,1,4,19,0,82
16,9,20,8,5,3,1,14,0,76
16,9,20,8,5,3,9,1,14,85
16,9,20,8,5,3,9,19,13,102
16,9,20,8,5,3,15,9,4,89
16,9,20,8,5,3,21,19,0,101
16,9,20,8,5,4,0,0,0,62
16,9,20,8,5,19,0,0,0,77
16,9,20,8,6,21,12,0,0,92
16,9,20,8,25,0,0,0,0,78
16,9,20,8,9,5,18,0,0,85
16,9,20,8,9,5,19,20,0,106
16,9,20,8,9,12,25,0,0,99
16,9,20,8,9,14,5,19,19,119
16,9,20,8,9,14,7,0,0,83
16,9,20,8,12,5,19,19,0,108
16,9,20,8,15,9,0,0,0,77
16,9,20,8,15,12,5,0,0,85
16,25,20,8,15,14,5,19,19,141
16,25,20,8,15,14,9,3,0,110
16,25,20,8,15,14,9,4,0,111
16,25,20,8,15,14,9,14,5,126
16,25,20,8,15,14,9,19,13,139
16,25,20,8,15,14,9,19,20,146
16,25,20,8,15,14,9,26,5,138
16,25,20,8,15,14,15,9,4,126
16,25,20,8,15,14,19,0,0,117
16,9,20,8,15,19,0,0,0,87
16,9,20,8,19,0,0,0,0,72
16,9,20,8,19,15,13,5,0,105
16,9,20,8,23,15,18,11,0,120
16,9,20,25,0,0,0,0,0,70
16,9,20,9,1,2,12,5,0,74
16,9,20,9,1,2,12,25,0,94
16,9,20,9,5,4,0,0,0,63
16,9,20,9,5,4,12,25,0,100
16,9,20,9,5,18,0,0,0,77
16,9,20,9,5,18,19,0,0,96
16,9,20,9,5,19,0,0,0,78
16,9,20,9,6,21,12,0,0,93
16,9,20,9,6,21,12,12,25,130
16,9,20,25,9,14,7,0,0,100
16,9,20,25,9,14,7,12,25,137
16,9,20,9,11,9,14,19,0,107
16,9,20,9,12,5,19,19,0,109
16,9,20,25,16,18,15,15,6,140
16,9,20,25,18,15,9,4,0,116
16,9,20,9,18,18,9,0,0,99
16,9,20,12,5,19,19,0,0,100
16,9,20,12,9,11,5,0,0,82
16,9,20,13,1,11,5,18,0,93
16,9,20,13,1,11,9,14,7,100
16,9,20,13,1,14,19,0,0,92
16,9,20,13,1,18,11,0,0,88
16,9,20,13,5,14,0,0,0,77
16,9,20,13,9,18,11,0,0,96
16,9,20,15,13,5,20,5,18,121
16,9,20,15,13,9,5,0,0,87
16,9,20,15,14,0,0,0,0,74
16,9,20,15,14,19,0,0,0,93
16,9,20,16,1,14,0,0,0,76
16,9,20,16,9,20,0,0,0,90
16,9,20,16,18,15,16,0,0,110
16,9,20,18,5,19,19,9,14,129
16,9,20,19,0,0,0,0,0,64
16,9,20,19,1,23,0,0,0,88
16,9,20,19,1,23,19,0,0,107
16,9,20,19,9,4,5,0,0,82
16,9,20,20,1,3,1,12,0,82
16,9,20,20,1,14,3,5,0,88
16,9,20,20,1,14,3,5,18,106
16,9,20,20,1,14,3,5,19,107
16,9,20,20,1,18,4,0,0,88
16,9,20,20,5,4,0,0,0,74
16,9,20,20,5,18,0,0,0,88
16,9,20,20,9,3,9,20,5,111
16,9,20,20,9,14,5,0,0,93
16,9,20,20,9,14,7,0,0,95
16,9,20,20,9,14,7,19,0,114
16,9,20,20,15,9,4,0,0,93
16,9,20,21,9,3,25,20,5,128
16,9,20,21,9,20,1,0,0,96
16,9,20,21,9,20,1,12,0,108
16,9,20,21,9,20,1,18,25,139
16,9,20,21,9,20,5,0,0,100
16,9,20,21,9,20,15,21,19,150
16,9,20,21,18,9,0,0,0,93
16,9,20,23,15,15,4,0,0,102
16,9,20,23,15,18,11,0,0,112
16,9,20,23,18,9,7,8,20,130
16,9,21,0,0,0,0,0,0,46
16,9,21,16,9,21,0,0,0,92
16,9,21,18,9,0,0,0,0,73
16,25,21,18,9,1,0,0,0,90
16,25,21,18,9,1,19,0,0,109
16,9,22,1,12,9,3,0,0,72
16,9,22,15,20,0,0,0,0,82
16,9,22,15,20,1,2,12,5,102
16,9,22,15,20,1,12,0,0,95
16,9,22,15,20,1,12,12,25,132
16,9,22,15,20,5,4,0,0,91
16,9,22,15,20,5,18,0,0,105
16,9,22,15,20,9,14,7,0,112
16,9,22,15,20,13,1,14,0,110
16,9,22,15,20,13,5,14,0,114
16,9,22,15,20,19,0,0,0,101
16,25,22,21,18,9,12,0,0,123
16,9,23,21,20,0,0,0,0,89
16,9,24,0,0,0,0,0,0,49
16,25,24,0,0,0,0,0,0,65
16,9,24,5,12,19,0,0,0,85
16,9,24,5,19,0,0,0,0,73
16,25,24,5,19,0,0,0,0,89
16,9,24,25,0,0,0,0,0,74
16,25,24,9,4,1,20,5,0,104
16,25,24,9,4,5,19,0,0,102
16,25,24,9,4,9,1,0,0,88
16,25,24,9,4,9,21,13,0,121
16,9,24,9,5,0,0,0,0,63
16,25,24,9,5,0,0,0,0,79
16,9,24,9,5,9,19,8,0,99
16,9,24,9,5,19,0,0,0,82
16,25,24,9,5,19,0,0,0,98
16,9,24,25,9,19,8,0,0,110
16,9,24,9,12,1,20,5,4,100
16,9,24,9,14,5,19,19,0,115
16,9,24,25,19,0,0,0,0,93
16,9,26,1,9,14,5,0,0,80
16,9,26,1,26,26,0,0,0,104
16,9,26,1,26,26,5,19,0,128
16,9,26,1,26,26,25,0,0,129
16,9,26,5,0,0,0,0,0,56
16,9,26,26,0,0,0,0,0,77
16,9,26,26,1,0,0,0,0,78
16,9,26,26,1,19,0,0,0,97
16,9,26,26,1,26,26,0,0,130
16,9,26,26,1,26,26,5,19,154
16,9,26,26,5,18,9,1,0,110
16,9,26,26,5,18,9,1,19,129
16,9,26,26,9,3,1,20,15,125
16,9,26,26,12,5,0,0,0,94
16,9,26,26,12,5,19,0,0,113
16,11,7,0,0,0,0,0,0,34
16,11,7,19,0,0,0,0,0,53
16,11,19,0,0,0,0,0,0,46
16,11,20,0,0,0,0,0,0,47
16,11,23,25,0,0,0,0,0,75
16,12,2,18,15,3,8,0,0,74
16,12,5,1,0,0,0,0,0,34
16,12,5,1,3,8,0,0,0,45
16,12,5,1,3,8,5,4,0,54
16,12,5,1,3,8,5,18,0,68
16,12,5,1,3,8,5,19,0,69
16,12,5,1,3,8,9,14,7,75
16,12,5,1,4,0,0,0,0,38
16,12,5,1,4,1,2,12,5,58
16,12,5,1,4,5,4,0,0,47
16,12,5,1,4,5,18,0,0,61
16,12,5,1,4,5,18,19,0,80
16,12,5,1,4,9,14,7,0,68
16,12,5,1,4,9,14,7,19,87
16,12,5,1,4,19,0,0,0,57
16,12,5,1,16,18,15,15,6,104
16,12,5,1,19,1,2,12,5,73
16,12,5,1,19,1,14,3,5,76
16,12,5,1,19,5,0,0,0,58
16,12,5,1,19,5,4,0,0,62
16,12,5,1,19,5,4,12,25,99
16,12,5,1,19,5,13,1,14,86
16,12,5,1,19,5,13,5,14,90
16,12,5,1,19,5,18,0,0,76
16,12,5,1,19,5,18,19,0,95
16,12,5,1,19,5,19,0,0,77
16,12,5,1,19,8,9,16,0,86
16,12,5,1,19,9,14,7,0,83
16,12,5,1,19,21,18,5,0,97
16,12,5,1,19,21,18,5,4,101
16,12,5,1,19,21,18,5,18,115
16,12,5,1,19,21,18,5,19,116
16,12,5,1,20,0,0,0,0,54
16,12,5,1,20,5,4,0,0,63
16,12,5,1,20,5,18,0,0,77
16,12,5,1,20,5,18,19,0,96
16,12,5,1,20,9,14,7,0,84
16,12,5,1,20,12,5,19,19,109
16,12,5,1,20,19,0,0,0,73
16,12,5,2,0,0,0,0,0,35
16,12,5,2,2,25,0,0,0,62
16,12,5,2,5,0,0,0,0,40
16,12,5,2,5,9,1,14,0,64
16,12,5,2,5,9,1,14,19,83
16,12,5,2,5,9,20,25,0,94
16,12,5,2,5,19,0,0,0,59
16,12,5,2,9,1,14,0,0,59
16,12,5,2,9,6,25,0,0,75
16,12,5,2,19,0,0,0,0,54
16,12,5,3,11,0,0,0,0,47
16,12,5,3,15,20,9,14,5,99
16,12,5,3,20,18,1,0,0,75
16,12,5,3,20,18,5,0,0,79
16,12,5,3,20,18,15,14,0,103
16,12,5,3,20,18,15,14,19,122
16,12,5,3,20,18,21,13,0,108
16,12,5,3,20,18,21,13,19,127
16,12,5,4,0,0,0,0,0,37
16,12,5,4,1,2,12,5,0,57
16,12,5,4,7,5,0,0,0,49
16,12,5,4,7,5,4,0,0,53
16,12,5,4,7,5,5,0,0,54
16,12,5,4,7,5,5,19,0,73
16,12,5,4,7,5,15,18,0,82
16,12,5,4,7,5,15,18,19,101
16,12,5,4,7,5,18,19,0,86
16,12,5,4,7,5,19,0,0,68
16,12,5,4,7,5,20,0,0,69
16,12,5,4,7,5,20,19,0,88
16,12,5,4,7,9,14,7,0,74
16,12,5,4,7,15,18,0,0,77
16,12,5,4,7,15,18,19,0,96
16,12,5,7,9,1,0,0,0,50
16,12,5,9,1,4,19,0,0,66
16,12,5,9,15,2,1,18,0,78
16,12,5,9,15,13,5,18,25,118
16,12,5,9,15,14,0,0,0,71
16,12,5,9,15,14,9,1,14,95
16,12,5,9,15,20,1,24,25,127
16,12,5,9,19,0,0,0,0,61
16,12,5,13,15,3,8,15,5,92
16,12,5,14,1,0,0,0,0,48
16,12,5,14,1,18,25,0,0,91
16,12,5,14,1,18,9,12,25,112
16,12,5,14,1,18,9,21,13,109
16,12,5,14,1,18,20,25,0,111
16,12,5,14,3,8,0,0,0,58
16,12,5,14,3,8,5,19,0,82
16,12,5,14,25,0,0,0,0,72
16,12,5,14,9,3,15,18,14,106
16,12,5,14,9,12,21,14,5,108
16,12,5,14,9,16,15,0,0,87
16,12,5,14,9,19,8,0,0,83
16,12,5,14,9,19,8,5,4,92
16,12,5,14,9,19,8,5,19,107
16,12,5,14,9,19,13,0,0,88
16,12,5,14,9,19,13,19,0,107
16,12,5,14,9,19,20,0,0,95
16,12,5,14,9,19,20,19,0,114
16,12,5,14,9,20,25,0,0,101
16,12,5,14,9,20,9,4,5,94
16,12,5,14,9,20,21,4,5,106
16,12,5,14,19,8,9,14,7,104
16,12,5,14,20,5,15,21,19,127
16,12,5,14,20,9,5,19,0,100
16,12,5,14,20,9,6,25,0,107
16,12,5,14,20,9,6,21,12,115
16,12,5,14,21,13,0,0,0,81
16,12,5,14,21,13,19,0,0,100
16,12,5,15,4,15,14,20,0,101
16,12,5,15,13,1,26,9,1,98
16,12,5,15,13,15,18,16,8,118
16,12,5,15,14,0,0,0,0,62
16,12,5,15,14,1,12,0,0,75
16,12,5,15,14,1,19,13,0,95
16,12,5,15,14,1,19,13,19,114
16,12,5,15,14,1,19,20,0,102
16,12,5,15,14,1,19,20,5,107
16,12,5,15,14,5,24,9,1,101
16,12,5,15,14,9,3,0,0,74
16,12,5,15,16,15,4,0,0,83
16,12,5,15,16,15,4,19,0,102
16,12,5,18,15,13,1,0,0,80
16,12,5,18,15,13,5,0,0,84
16,12,5,18,15,19,9,19,0,113
16,12,5,18,15,20,9,3,0,98
16,12,5,19,1,14,3,5,0,75
16,12,5,19,19,15,18,0,0,104
16,12,5,19,19,15,18,19,0,123
16,12,5,20,8,15,18,1,0,95
16,12,5,20,8,15,18,1,19,114
16,12,5,20,8,15,18,25,0,119
16,12,5,20,8,15,18,9,3,106
16,12,5,20,8,18,15,14,0,108
16,12,5,20,8,18,21,13,0,113
16,12,5,21,18,1,0,0,0,73
16,12,5,21,18,1,5,0,0,78
16,12,5,21,18,1,12,0,0,85
16,12,5,21,18,1,19,0,0,92
16,12,5,21,18,9,3,0,0,84
16,12,5,21,18,9,19,25,0,125
16,12,5,21,18,9,20,5,0,106
16,12,5,21,18,9,20,9,3,113
16,12,5,21,18,9,20,9,19,129
16,12,5,21,18,15,9,4,0,100
16,12,5,21,18,15,14,0,0,101
16,12,5,21,18,21,13,0,0,106
16,12,5,21,19,20,15,14,0,122
16,12,5,21,19,20,15,14,19,141
16,12,5,22,9,14,0,0,0,78
16,12,5,23,0,0,0,0,0,56
16,12,5,23,3,8,0,0,0,67
16,12,5,23,7,8,0,0,0,71
16,12,5,23,19,0,0,0,0,75
16,12,5,24,0,0,0,0,0,57
16,12,5,24,1,12,0,0,0,70
16,12,5,24,9,3,15,19,5,108
16,12,5,24,9,6,15,18,13,118
16,12,5,24,15,4,15,14,20,125
16,12,5,24,15,18,0,0,0,90
16,12,5,24,15,18,19,0,0,109
16,12,5,24,21,18,5,0,0,101
16,12,5,24,21,19,0,0,0,97
16,12,5,24,21,19,5,19,0,121
16,12,6,0,0,0,0,0,0,34
16,12,9,0,0,0,0,0,0,37
16,12,25,0,0,0,0,0,0,53
16,12,9,1,2,12,5,0,0,57
16,12,9,1,2,12,25,0,0,77
16,12,9,1,14,3,25,0,0,80
16,12,9,1,14,3,9,5,19,88
16,12,9,1,14,20,0,0,0,72
16,12,9,1,14,20,12,25,0,109
16,12,25,2,15,1,18,4,0,93
16,12,9,3,1,0,0,0,0,41
16,12,9,3,1,2,12,5,0,60
16,12,9,3,1,5,0,0,0,46
16,12,9,3,1,12,0,0,0,53
16,12,9,3,1,20,5,0,0,66
16,12,9,3,1,20,5,4,0,70
16,12,9,3,1,20,5,12,25,103
16,12,9,3,1,20,5,18,0,84
16,12,9,3,1,20,9,12,5,87
16,12,9,3,1,20,9,14,7,91
16,12,9,3,1,20,9,15,14,99
16,12,9,3,1,20,9,22,5,97
16,12,9,3,1,20,15,18,0,94
16,12,9,3,1,20,21,18,5,105
16,12,9,3,9,6,15,18,13,101
16,12,9,5,0,0,0,0,0,42
16,12,9,5,4,0,0,0,0,46
16,12,9,5,18,0,0,0,0,60
16,12,25,5,18,0,0,0,0,76
16,12,9,5,18,19,0,0,0,79
16,12,25,5,18,19,0,0,0,95
16,12,9,5,19,0,0,0,0,61
16,12,25,7,1,9,14,0,0,84
16,12,9,7,8,20,0,0,0,72
16,12,9,7,8,20,5,4,0,81
16,12,9,7,8,20,5,18,0,95
16,12,9,7,8,20,5,18,19,114
16,12,9,7,8,20,9,14,7,102
16,12,9,7,8,20,19,0,0,91
16,12,25,9,14,7,0,0,0,83
16,12,25,9,14,7,12,25,0,120
16,12,9,13,0,0,0,0,0,50
16,12,9,13,13,5,4,0,0,72
16,12,9,13,13,9,14,7,0,93
16,12,25,13,15,21,20,8,19,149
16,12,9,13,19,15,12,0,0,96
16,12,9,13,19,15,12,5,0,101
16,12,9,13,19,15,12,5,19,120
16,12,9,13,19,15,12,12,19,127
16,12,9,13,19,15,12,19,0,115
16,12,9,14,11,0,0,0,0,62
16,12,9,14,11,5,4,0,0,71
16,12,9,14,11,5,18,0,0,85
16,12,9,14,11,5,18,19,0,104
16,12,9,14,11,9,14,7,0,92
16,12,9,14,11,19,0,0,0,81
16,12,9,14,20,8,0,0,0,79
16,12,9,14,20,8,5,18,0,102
16,12,9,14,20,8,19,0,0,98
16,12,9,15,19,1,21,18,0,111
16,12,25,19,3,15,18,5,0,113
16,12,9,19,11,25,0,0,0,92
16,12,9,19,11,9,5,0,0,81
16,12,9,19,11,9,5,19,0,100
16,12,9,19,19,0,0,0,0,75
16,12,9,19,19,5,0,0,0,80
16,12,9,19,19,5,19,0,0,99
16,12,9,20,3,8,0,0,0,68
16,12,25,23,15,15,4,0,0,110
16,12,25,23,15,15,4,19,0,129
16,12,15,1,20,0,0,0,0,64
16,12,15,3,5,0,0,0,0,51
16,12,15,3,11,0,0,0,0,57
16,12,15,4,0,0,0,0,0,47
16,12,15,4,4,5,4,0,0,60
16,12,15,4,4,5,18,0,0,74
16,12,15,4,4,5,18,12,25,111
16,12,15,4,4,5,18,19,0,93
16,12,15,4,4,9,14,7,0,81
16,12,15,4,7,5,0,0,0,59
16,12,15,4,19,0,0,0,0,66
16,12,15,25,0,0,0,0,0,68
16,12,15,9,4,0,0,0,0,56
16,12,15,9,4,25,0,0,0,81
16,12,15,9,4,9,5,19,0,89
16,12,15,25,5,4,0,0,0,77
16,12,15,25,9,14,7,0,0,98
16,12,15,9,13,1,20,5,0,91
16,12,15,25,13,5,14,20,0,120
16,12,15,25,19,0,0,0,0,87
16,12,15,13,2,0,0,0,0,58
16,12,15,14,11,0,0,0,0,68
16,12,15,14,11,5,4,0,0,77
16,12,15,14,11,9,14,7,0,98
16,12,15,14,11,15,0,0,0,83
16,12,15,14,11,19,0,0,0,87
16,12,15,15,11,0,0,0,0,69
16,12,15,16,0,0,0,0,0,59
16,12,15,16,16,5,4,0,0,84
16,12,15,16,16,9,14,7,0,105
16,12,15,16,19,0,0,0,0,78
16,12,15,18,1,20,9,15,14,120
16,12,15,18,1,20,15,18,25,140
16,12,15,19,9,15,14,0,0,100
16,12,15,19,9,15,14,19,0,119
16,12,15,19,9,22,5,0,0,98
16,12,15,19,9,22,5,19,0,117
16,12,15,20,0,0,0,0,0,63
16,12,15,20,3,8,0,0,0,74
16,12,15,20,3,15,3,11,0,95
16,12,15,20,5,0,0,0,0,68
16,12,15,20,6,21,12,0,0,102
16,12,15,20,12,5,19,19,0,118
16,12,15,20,12,9,2,0,0,86
16,12,15,20,15,19,9,4,0,110
16,12,15,20,16,18,15,15,6,133
16,12,15,20,19,0,0,0,0,82
16,12,15,20,20,0,0,0,0,83
16,12,15,20,20,1,7,5,0,96
16,12,15,20,20,1,7,5,19,115
16,12,15,20,20,5,4,0,0,92
16,12,15,20,20,5,18,0,0,106
16,12,15,20,20,5,18,25,0,131
16,12,15,20,20,5,18,19,0,125
16,12,15,20,20,25,0,0,0,108
16,12,15,20,20,9,5,18,0,115
16,12,15,20,20,9,5,19,0,116
16,12,15,20,20,9,5,19,20,136
16,12,15,20,20,9,14,7,0,113
16,12,15,20,20,15,14,0,0,112
16,12,15,20,24,0,0,0,0,87
16,12,15,20,26,0,0,0,0,89
16,12,15,20,26,5,4,0,0,98
16,12,15,20,26,5,19,0,0,113
16,12,15,20,26,9,14,7,0,119
16,12,15,21,7,8,2,15,25,121
16,12,15,21,7,8,5,4,0,88
16,12,15,21,7,8,5,18,0,102
16,12,15,21,7,8,5,18,19,121
16,12,15,21,7,8,9,14,7,109
16,12,15,21,7,8,13,1,14,107
16,12,15,21,7,8,13,5,14,111
16,12,15,21,7,8,19,0,0,98
16,12,15,21,11,0,0,0,0,75
16,12,15,21,11,5,4,0,0,84
16,12,15,21,11,25,0,0,0,100
16,12,15,21,14,3,5,0,0,86
16,12,15,21,20,0,0,0,0,84
16,12,15,21,20,5,18,0,0,107
16,12,15,22,5,18,0,0,0,88
16,12,15,22,5,18,25,0,0,113
16,12,15,22,5,18,19,0,0,107
16,12,15,23,0,0,0,0,0,66
16,12,15,23,1,2,12,5,0,86
16,12,15,23,2,1,3,11,0,83
16,12,15,23,2,1,3,11,19,102
16,12,15,23,2,15,25,0,0,108
16,12,15,23,2,15,25,19,0,127
16,12,15,23,2,15,20,5,0,108
16,12,15,23,5,4,0,0,0,75
16,12,15,23,5,18,0,0,0,89
16,12,15,23,5,18,19,0,0,108
16,12,15,23,6,9,19,8,0,108
16,12,15,23,6,15,15,20,0,122
16,12,15,23,7,1,14,7,0,95
16,12,15,23,7,1,20,5,0,99
16,12,15,23,8,5,1,4,0,84
16,12,15,23,8,5,1,4,19,103
16,12,15,23,9,14,7,0,0,96
16,12,15,23,12,1,14,4,0,97
16,12,15,23,12,1,14,4,19,116
16,12,15,23,12,9,7,8,20,122
16,12,15,23,12,9,14,5,0,106
16,12,15,23,13,1,11,5,18,114
16,12,15,23,13,1,14,0,0,94
16,12,15,23,13,5,12,12,0,108
16,12,15,23,13,5,14,0,0,98
16,12,15,23,16,15,9,14,20,140
16,12,15,23,19,0,0,0,0,85
16,12,15,23,19,8,1,18,5,117
16,12,15,23,19,8,15,5,0,113
16,12,15,23,19,20,1,6,6,118
16,12,15,23,19,20,9,12,20,146
16,12,15,23,20,1,9,12,0,108
16,12,15,23,20,5,18,0,0,109
16,12,15,23,23,9,19,5,0,122
16,12,15,23,23,15,13,1,14,132
16,12,20,1,14,15,0,0,0,78
16,12,21,0,0,0,0,0,0,49
16,12,21,3,11,0,0,0,0,63
16,12,21,3,11,1,7,5,0,76
16,12,21,3,11,5,4,0,0,72
16,12,21,3,11,5,18,0,0,86
16,12,21,3,11,5,18,19,0,105
16,12,21,3,11,25,0,0,0,88
16,12,21,3,11,9,5,18,0,95
16,12,21,3,11,9,5,19,20,116
16,12,21,3,11,9,12,25,0,109
16,12,21,3,11,9,14,7,0,93
16,12,21,3,11,12,5,19,19,118
16,12,21,3,11,19,0,0,0,82
16,12,21,4,0,0,0,0,0,53
16,12,21,6,6,0,0,0,0,61
16,12,21,6,6,5,18,0,0,84
16,12,21,6,6,25,0,0,0,86
16,12,21,7,0,0,0,0,0,56
16,12,21,7,2,15,1,18,4,96
16,12,21,7,7,1,2,12,5,83
16,12,21,7,7,5,4,0,0,72
16,12,21,7,7,5,18,0,0,86
16,12,21,7,7,5,18,19,0,105
16,12,21,7,7,25,0,0,0,88
16,12,21,7,7,9,14,7,0,93
16,12,21,7,8,15,12,5,0,96
16,12,21,7,12,5,5,19,0,97
16,12,21,7,12,5,19,19,0,111
16,12,21,7,12,9,11,5,0,93
16,12,21,7,13,1,14,0,0,84
16,12,21,7,13,5,14,0,0,88
16,12,21,7,15,12,1,0,0,84
16,12,21,7,15,12,1,19,0,103
16,12,21,7,19,0,0,0,0,75
16,12,21,7,20,18,1,25,0,120
16,12,21,7,20,18,5,5,0,104
16,12,21,7,21,7,12,25,0,121
16,12,21,13,0,0,0,0,0,62
16,12,21,13,1,0,0,0,0,63
16,12,21,13,1,3,8,0,0,74
16,12,21,13,1,4,5,0,0,72
16,12,21,13,1,7,5,0,0,75
16,12,21,13,1,7,5,4,0,79
16,12,21,13,1,7,5,18,25,118
16,12,21,13,1,7,5,19,0,94
16,12,21,13,1,19,9,20,5,116
16,12,21,13,1,20,5,0,0,88
16,12,21,13,2,0,0,0,0,64
16,12,21,13,2,1,2,12,5,84
16,12,21,13,2,1,7,5,0,77
16,12,21,13,2,1,7,9,14,95
16,12,21,13,2,1,7,15,0,87
16,12,21,13,2,1,7,15,19,106
16,12,21,13,2,1,20,5,0,90
16,12,21,13,2,5,1,14,0,84
16,12,21,13,2,5,4,0,0,73
16,12,21,13,2,5,15,21,19,124
16,12,21,13,2,5,18,0,0,87
16,12,21,13,2,5,18,25,0,112
16,12,21,13,2,5,18,19,0,106
16,12,21,13,2,5,20,0,0,89
16,12,21,13,2,9,3,0,0,76
16,12,21,13,2,9,3,15,14,105
16,12,21,13,2,9,14,7,0,94
16,12,21,13,2,9,14,7,19,113
16,12,21,13,2,9,19,13,0,105
16,12,21,13,2,9,19,13,19,124
16,12,21,13,2,9,20,5,0,98
16,12,21,13,2,12,5,19,19,119
16,12,21,13,2,14,5,19,19,121
16,12,21,13,2,15,7,0,0,86
16,12,21,13,2,15,21,19,0,119
16,12,21,13,2,19,0,0,0,83
16,12,21,13,2,21,13,0,0,98
16,12,21,13,2,21,13,19,0,117
16,12,21,13,3,15,20,0,0,100
16,12,21,13,4,1,13,1,19,100
16,12,21,13,4,1,13,9,19,108
16,12,21,13,5,4,0,0,0,71
16,12,21,13,5,12,5,19,19,122
16,12,21,13,5,12,5,20,0,104
16,12,21,13,5,12,5,20,19,123
16,12,21,13,5,12,9,11,5,104
16,12,21,13,5,15,21,19,0,122
16,12,21,13,5,18,0,0,0,85
16,12,21,13,5,18,25,0,0,110
16,12,21,13,5,19,0,0,0,86
16,12,21,13,5,20,0,0,0,87
16,12,21,13,5,20,5,0,0,92
16,12,21,13,5,20,9,19,0,115
16,12,21,13,5,20,20,5,0,112
16,12,21,13,25,0,0,0,0,87
16,12,21,13,9,3,15,18,14,121
16,12,21,13,9,5,18,0,0,94
16,12,21,13,9,5,19,20,0,115
16,12,21,13,9,6,25,0,0,102
16,12,21,13,9,6,15,18,13,123
16,12,21,13,9,14,5,19,19,128
16,12,21,13,9,14,7,0,0,92
16,12,21,13,9,16,5,4,0,96
16,12,21,13,9,16,5,4,5,101
16,12,21,13,9,16,5,4,19,115
16,12,21,13,9,19,20,0,0,110
16,12,21,13,12,5,19,19,0,117
16,12,21,13,12,5,20,0,0,99
16,12,21,13,12,9,11,5,0,99
16,12,21,13,13,5,20,0,0,100
16,12,21,13,13,5,20,5,4,109
16,12,21,13,13,5,20,19,0,119
16,12,21,13,13,25,0,0,0,100
16,12,21,13,13,9,5,18,0,107
16,12,21,13,13,9,5,19,20,128
16,12,21,13,13,9,14,7,0,105
16,12,21,13,15,19,5,0,0,101
16,12,21,13,15,19,5,12,25,138
16,12,21,13,15,19,9,20,5,130
16,12,21,13,15,19,9,20,25,150
16,12,21,13,15,21,19,0,0,117
16,12,21,13,16,0,0,0,0,78
16,12,21,13,16,5,4,0,0,87
16,12,21,13,16,5,14,0,0,97
16,12,21,13,16,5,14,5,4,106
16,12,21,13,16,5,14,19,0,116
16,12,21,13,16,5,18,0,0,101
16,12,21,13,16,5,18,19,0,120
16,12,21,13,16,5,19,20,0,122
16,12,21,13,16,25,0,0,0,103
16,12,21,13,16,9,14,7,0,108
16,12,21,13,16,9,19,8,0,114
16,12,21,13,16,12,25,0,0,115
16,12,21,13,16,14,5,19,19,135
16,12,21,13,16,19,0,0,0,97
16,12,21,13,18,15,3,11,0,109
16,12,21,13,19,0,0,0,0,81
16,12,21,13,21,12,1,0,0,96
16,12,21,13,21,12,1,18,0,114
16,12,21,13,21,12,1,20,5,121
16,12,21,13,21,12,5,0,0,100
16,12,21,13,21,12,5,19,0,119
16,12,21,13,21,12,15,19,5,134
16,12,21,14,4,5,18,0,0,90
16,12,21,14,4,5,18,5,4,99
16,12,21,14,4,5,18,5,18,113
16,12,21,14,4,5,18,19,0,109
16,12,21,14,7,5,0,0,0,75
16,12,21,14,7,5,4,0,0,79
16,12,21,14,7,5,15,14,0,104
16,12,21,14,7,5,18,0,0,93
16,12,21,14,7,5,18,19,0,112
16,12,21,14,7,5,19,0,0,94
16,12,21,14,7,25,0,0,0,95
16,12,21,14,7,9,14,7,0,100
16,12,21,14,11,0,0,0,0,74
16,12,21,14,11,5,4,0,0,83
16,12,21,14,11,5,18,0,0,97
16,12,21,14,11,5,18,19,0,116
16,12,21,14,11,9,14,7,0,104
16,12,21,14,11,19,0,0,0,93
16,12,21,14,20,8,5,18,0,114
16,12,21,16,0,0,0,0,0,65
16,12,21,16,6,0,0,0,0,71
16,12,21,18,0,0,0,0,0,67
16,12,21,18,1,12,0,0,0,80
16,12,21,18,1,12,9,19,5,113
16,12,21,18,1,12,9,19,13,121
16,12,21,18,1,12,9,19,20,128
16,12,21,18,1,12,9,20,25,134
16,12,21,18,1,12,9,26,5,120
16,12,21,18,1,12,12,25,0,117
16,12,21,18,1,12,19,0,0,99
16,12,21,18,1,20,9,22,5,124
16,12,21,18,5,12,0,0,0,84
16,12,21,18,9,2,21,19,0,118
16,12,21,18,9,5,19,0,0,100
16,12,21,18,9,6,25,0,0,107
16,12,21,18,9,16,1,18,1,112
16,12,21,18,9,19,25,0,0,120
16,12,21,18,9,22,15,18,25,156
16,12,21,19,0,0,0,0,0,68
16,12,21,19,5,19,0,0,0,92
16,12,21,19,8,0,0,0,0,76
16,12,21,19,8,5,4,0,0,85
16,12,21,19,8,5,18,0,0,99
16,12,21,19,8,5,19,0,0,100
16,12,21,19,8,5,19,20,0,120
16,12,21,19,8,5,20,20,5,126
16,12,21,19,8,25,0,0,0,101
16,12,21,19,8,9,5,18,0,108
16,12,21,19,8,9,5,19,20,129
16,12,21,19,8,9,12,25,0,122
16,12,21,19,8,12,25,0,0,113
16,12,21,19,8,12,9,11,5,113
16,12,21,19,8,14,5,19,19,133
16,12,21,19,17,21,1,13,0,120
16,12,21,19,19,1,7,5,0,100
16,12,21,19,19,1,7,5,19,119
16,12,21,19,19,5,19,0,0,111
16,12,21,20,1,18,3,8,25,124
16,12,21,20,5,1,12,0,0,87
16,12,21,20,5,1,14,0,0,89
16,12,21,20,5,9,0,0,0,83
16,12,21,20,5,21,19,0,0,114
16,12,21,20,5,21,19,5,19,138
16,12,21,20,5,21,20,5,9,129
16,12,21,20,15,3,18,1,20,126
16,12,21,20,15,12,15,7,25,143
16,12,21,20,15,14,0,0,0,98
16,12,21,20,15,14,9,19,13,139
16,12,21,20,15,14,9,19,20,146
16,12,21,20,15,14,9,20,5,132
16,12,21,20,15,14,15,13,25,151
16,12,21,20,15,14,19,0,0,117
16,12,21,20,20,5,18,0,0,112
16,12,21,22,9,1,12,0,0,93
16,12,21,22,9,1,12,12,25,130
16,12,21,22,9,1,12,19,0,112
16,12,21,22,9,1,14,0,0,95
16,12,21,22,9,14,5,0,0,99
16,12,21,22,9,15,21,19,0,135
16,13,11,0,0,0,0,0,0,40
16,13,19,7,0,0,0,0,0,55
16,14,3,5,0,0,0,0,0,38
16,14,5,1,0,0,0,0,0,36
16,14,5,15,7,18,1,16,8,100
16,14,5,15,13,5,20,5,18,111
16,14,5,15,13,5,20,18,25,131
16,14,5,15,16,8,15,18,5,112
16,14,5,15,19,3,15,16,5,108
16,14,5,21,13,0,0,0,0,69
16,14,5,21,13,1,0,0,0,70
16,14,5,21,13,1,19,0,0,89
16,14,5,21,13,1,20,9,3,102
16,14,5,21,13,5,0,0,0,74
16,14,5,21,13,15,14,25,0,123
16,14,5,21,13,15,14,9,1,108
16,14,5,21,13,15,14,9,3,110
16,14,25,24,0,0,0,0,0,79
16,14,24,20,0,0,0,0,0,74
16,15,2,2,25,0,0,0,0,60
16,15,2,2,9,5,19,0,0,68
16,15,2,5,4,25,0,0,0,67
16,15,2,12,1,3,9,15,14,87
16,15,2,19,0,0,0,0,0,52
16,15,3,1,14,0,0,0,0,49
16,15,3,8,1,4,5,0,0,52
16,15,3,8,1,4,5,19,0,71
16,15,3,8,1,25,0,0,0,68
16,15,3,8,1,9,19,5,0,76
16,15,3,8,1,18,4,0,0,65
16,15,3,8,1,18,4,19,0,84
16,15,3,8,5,0,0,0,0,47
16,15,3,8,5,20,20,5,0,92
16,15,3,8,9,19,13,15,0,98
16,15,3,8,15,9,18,0,0,84
16,15,3,8,15,20,5,0,0,82
16,15,3,9,12,12,0,0,0,67
16,15,3,11,0,0,0,0,0,45
16,15,3,11,5,4,0,0,0,54
16,15,3,11,5,20,0,0,0,70
16,15,3,11,5,20,5,4,0,79
16,15,3,11,5,20,5,18,0,93
16,15,3,11,5,20,5,18,19,112
16,15,3,11,5,20,6,21,12,109
16,15,3,11,5,20,25,0,0,95
16,15,3,11,5,20,9,14,7,100
16,15,3,11,5,20,19,0,0,89
16,15,3,11,8,15,21,19,5,113
16,15,3,11,25,0,0,0,0,70
16,15,3,11,9,5,18,0,0,77
16,15,3,11,9,5,19,20,0,98
16,15,3,11,9,12,25,0,0,91
16,15,3,11,9,14,5,19,19,111
16,15,3,11,9,14,7,0,0,75
16,15,3,11,13,1,14,11,25,109
16,15,3,11,13,1,18,11,0,88
16,15,3,11,13,1,18,11,19,107
16,15,3,11,19,0,0,0,0,64
16,15,3,11,23,5,5,4,0,82
16,15,3,11,23,15,15,4,0,102
16,15,3,15,0,0,0,0,0,49
16,15,3,15,19,5,14,0,0,87
16,15,3,15,19,9,14,0,0,91
16,15,3,15,19,9,14,19,0,110
16,15,3,15,19,15,14,0,0,97
16,15,3,21,12,0,0,0,0,67
16,15,3,21,12,1,18,25,0,111
16,15,3,21,12,5,14,20,0,106
16,15,3,21,19,0,0,0,0,74
16,15,4,0,0,0,0,0,0,35
16,15,4,1,0,0,0,0,0,36
16,15,4,1,7,18,1,0,0,62
16,15,4,1,7,18,1,12,0,74
16,15,4,1,7,18,1,19,0,81
16,15,4,1,7,18,25,0,0,86
16,15,4,1,7,18,9,3,0,73
16,15,4,1,7,18,15,21,19,116
16,15,4,1,12,0,0,0,0,48
16,15,4,1,12,7,9,1,0,65
16,15,4,1,12,9,3,0,0,60
16,15,4,1,14,7,5,18,0,80
16,15,4,1,18,7,9,14,5,89
16,15,4,1,18,7,21,5,0,87
16,15,4,1,20,21,19,0,0,96
16,15,4,4,5,4,0,0,0,48
16,15,4,4,5,18,0,0,0,62
16,15,4,4,25,0,0,0,0,64
16,15,4,4,9,1,0,0,0,49
16,15,4,4,9,4,7,5,0,64
16,15,4,4,9,5,19,0,0,72
16,15,4,4,9,7,5,0,0,60
16,15,4,4,9,14,7,0,0,69
16,15,4,4,9,19,8,0,0,75
16,15,4,4,12,5,0,0,0,56
16,15,4,4,15,3,11,0,0,68
16,15,4,5,12,3,15,13,1,84
16,15,4,5,15,14,0,0,0,69
16,15,4,5,19,20,1,0,0,80
16,15,4,5,19,20,1,19,0,99
16,15,4,5,20,9,1,0,0,70
16,15,4,5,20,9,21,13,0,103
16,15,4,5,24,0,0,0,0,64
16,15,4,7,5,0,0,0,0,47
16,15,4,7,5,18,0,0,0,65
16,15,4,7,25,0,0,0,0,67
16,15,4,7,9,5,18,0,0,74
16,15,4,7,9,5,19,20,0,95
16,15,4,7,9,12,25,0,0,88
16,15,4,7,9,14,5,19,19,108
16,15,4,9,1,0,0,0,0,45
16,15,4,9,1,12,0,0,0,57
16,15,4,9,1,20,18,25,0,108
16,15,4,9,1,20,18,9,3,95
16,15,4,9,3,1,12,0,0,60
16,15,4,9,3,5,19,0,0,71
16,15,4,9,20,5,0,0,0,69
16,15,4,9,20,5,19,0,0,88
16,15,4,9,20,9,3,0,0,76
16,15,4,9,20,20,9,0,0,93
16,15,4,9,21,13,0,0,0,78
16,15,4,9,21,13,19,0,0,97
16,15,4,12,5,25,0,0,0,77
16,15,4,12,5,18,0,0,0,70
16,15,4,12,9,11,5,0,0,72
16,15,4,15,3,1,18,16,0,88
16,15,4,15,4,5,18,13,0,90
16,15,4,15,4,25,14,9,1,103
16,15,4,15,7,25,14,0,0,96
16,15,4,15,7,25,14,5,0,101
16,15,4,15,12,9,20,5,0,96
16,15,4,15,12,15,7,25,0,109
16,15,4,15,13,1,14,3,25,106
16,15,4,15,13,5,18,5,0,91
16,15,4,15,13,5,18,5,19,110
16,15,4,15,13,5,20,5,18,111
16,15,4,15,13,5,20,18,25,131
16,15,4,15,19,0,0,0,0,69
16,15,4,15,19,3,1,16,8,97
16,15,4,15,19,3,15,16,25,128
16,15,4,15,19,16,5,18,13,121
16,15,4,15,20,8,5,3,1,87
16,15,4,15,21,19,0,0,0,90
16,15,4,19,0,0,0,0,0,54
16,15,4,19,15,12,0,0,0,81
16,15,4,19,15,12,9,3,0,93
16,15,4,19,15,12,9,26,5,121
16,15,4,19,15,12,19,0,0,100
16,15,4,20,9,1,0,0,0,65
16,15,4,21,18,1,14,0,0,89
16,15,4,21,18,9,4,0,0,87
16,15,4,23,1,18,5,0,0,82
16,15,4,26,15,12,0,0,0,88
16,15,4,26,15,12,9,3,0,100
16,15,4,26,15,12,9,26,5,128
16,15,4,26,15,12,19,0,0,107
16,15,5,2,9,18,4,0,0,69
16,15,5,3,8,15,18,5,0,85
16,15,5,3,8,15,18,5,19,104
16,15,5,3,8,15,18,9,3,92
16,15,5,3,9,12,9,20,5,94
16,15,5,13,0,0,0,0,0,49
16,15,5,13,1,20,9,3,0,82
16,15,5,13,5,20,0,0,0,74
16,15,5,13,12,5,20,0,0,86
16,15,5,13,19,0,0,0,0,68
16,15,5,14,15,12,15,7,25,124
16,15,5,19,25,0,0,0,0,80
16,15,5,19,9,5,0,0,0,69
16,15,5,19,9,5,19,0,0,88
16,15,5,19,9,12,5,19,19,119
16,15,5,19,9,19,0,0,0,83
16,15,5,20,0,0,0,0,0,56
16,15,5,20,1,19,20,5,18,119
16,15,5,20,1,19,20,18,25,139
16,15,5,20,3,18,1,6,20,104
16,15,5,20,4,15,13,0,0,88
16,15,5,20,5,19,17,21,5,123
16,15,5,20,5,19,19,0,0,99
16,15,5,20,5,19,19,5,19,123
16,15,5,20,8,15,15,4,0,98
16,15,5,20,9,3,0,0,0,68
16,15,5,20,9,3,1,12,0,81
16,15,5,20,9,3,9,19,5,101
16,15,5,20,9,3,9,19,13,109
16,15,5,20,9,3,9,26,5,108
16,15,5,20,9,3,19,0,0,87
16,15,5,20,9,3,21,12,5,106
16,15,5,20,9,9,19,5,4,102
16,15,5,20,9,19,5,0,0,89
16,15,5,20,9,19,5,4,0,93
16,15,5,20,9,19,5,18,0,107
16,15,5,20,9,19,5,18,19,126
16,15,5,20,9,19,5,19,0,108
16,15,5,20,9,19,9,14,7,114
16,15,5,20,9,20,15,0,0,100
16,15,5,20,9,26,5,0,0,96
16,15,5,20,9,26,5,4,0,100
16,15,5,20,9,26,5,18,0,114
16,15,5,20,9,26,5,18,19,133
16,15,5,20,9,26,5,19,0,115
16,15,5,20,9,26,9,14,7,121
16,15,5,20,12,5,19,19,0,111
16,15,5,20,12,25,0,0,0,93
16,15,5,20,12,9,11,5,0,93
16,15,5,20,12,9,14,7,0,98
16,15,5,20,18,5,19,19,0,117
16,15,5,20,18,25,0,0,0,99
16,15,5,20,18,9,5,19,0,107
16,15,5,20,19,0,0,0,0,75
16,15,5,20,19,8,9,16,0,108
16,15,5,20,23,9,19,5,0,112
16,15,6,6,12,5,0,0,0,60
16,15,7,5,25,0,0,0,0,68
16,15,7,5,25,19,0,0,0,87
16,15,7,7,5,0,0,0,0,50
16,15,7,7,25,0,0,0,0,70
16,15,7,7,9,5,19,0,0,78
16,15,7,25,0,0,0,0,0,63
16,15,7,9,5,19,0,0,0,71
16,15,7,15,14,9,1,19,0,96
16,15,7,15,14,9,1,20,5,102
16,15,7,15,14,9,15,14,0,105
16,15,7,15,14,9,16,0,0,92
16,15,7,15,14,9,16,19,0,111
16,15,7,15,14,9,18,9,19,122
16,15,7,15,14,9,20,5,0,101
16,15,7,18,15,13,0,0,0,84
16,15,7,18,15,13,5,4,0,93
16,15,7,18,15,13,9,14,7,114
16,15,7,18,15,13,9,19,20,132
16,15,7,18,15,13,9,26,5,124
16,15,7,18,15,13,19,0,0,103
16,15,8,1,0,0,0,0,0,40
16,15,8,9,3,11,15,18,25,120
16,15,8,14,1,0,0,0,0,54
16,15,9,0,0,0,0,0,0,40
16,15,25,0,0,0,0,0,0,56
16,15,25,2,9,18,4,0,0,89
16,15,9,5,19,9,19,0,0,92
16,15,9,5,20,9,3,0,0,77
16,15,9,7,14,1,4,15,0,81
16,15,9,7,14,1,14,3,5,84
16,15,9,7,14,1,14,3,25,104
16,15,9,7,14,1,14,20,0,96
16,15,9,7,14,1,18,4,0,84
16,15,9,7,14,5,20,0,0,86
16,15,9,11,9,12,5,0,0,77
16,15,9,11,9,12,9,5,0,86
16,15,9,12,0,0,0,0,0,52
16,15,9,12,21,0,0,0,0,73
16,15,9,12,21,19,0,0,0,92
16,15,9,13,5,14,9,3,0,84
16,15,9,13,5,14,9,3,19,103
16,15,9,14,1,4,15,0,0,74
16,15,9,14,1,18,4,0,0,77
16,15,9,14,4,0,0,0,0,58
16,15,9,14,4,1,2,12,5,78
16,15,9,14,4,5,4,0,0,67
16,15,9,14,4,5,18,0,0,81
16,15,9,14,4,9,14,7,0,88
16,15,9,14,4,19,0,0,0,77
16,15,9,14,20,1,2,12,5,94
16,15,9,14,20,1,7,5,0,87
16,15,9,14,20,1,12,0,0,87
16,15,9,14,20,5,0,0,0,79
16,15,9,14,20,5,4,0,0,83
16,15,9,14,20,5,4,12,25,120
16,15,9,14,20,5,12,0,0,91
16,15,25,14,20,5,12,12,0,119
16,15,9,14,20,5,18,0,0,97
16,15,9,14,20,5,19,0,0,98
16,15,9,14,20,6,21,12,0,113
16,15,9,14,20,25,0,0,0,99
16,15,9,14,20,9,5,18,0,106
16,15,9,14,20,9,5,19,20,127
16,15,25,14,20,9,12,12,0,123
16,15,9,14,20,9,12,12,5,112
16,15,9,14,20,9,14,7,0,104
16,15,9,14,20,12,5,19,19,129
16,15,9,14,20,12,5,20,0,111
16,15,9,14,20,13,1,14,0,102
16,15,9,14,20,13,5,14,0,106
16,15,9,14,20,13,5,14,20,126
16,15,9,14,20,18,5,12,0,109
16,15,9,14,20,19,0,0,0,93
16,15,9,14,20,19,13,1,14,121
16,15,9,14,20,19,13,5,14,125
16,15,9,14,20,21,18,5,0,118
16,15,9,14,20,23,1,25,19,142
16,15,9,14,20,23,9,19,5,130
16,15,25,15,21,0,0,0,0,92
16,15,25,15,21,19,0,0,0,111
16,15,9,18,5,0,0,0,0,63
16,15,9,19,0,0,0,0,0,59
16,15,9,19,1,2,12,5,0,79
16,15,9,19,5,0,0,0,0,64
16,15,9,19,5,4,0,0,0,68
16,15,9,19,5,18,0,0,0,82
16,15,9,19,5,18,19,0,0,101
16,15,9,19,5,19,0,0,0,83
16,15,9,19,9,14,7,0,0,89
16,15,9,19,15,14,0,0,0,88
16,15,9,19,15,14,5,4,0,97
16,15,9,19,15,14,5,18,0,111
16,15,9,19,15,14,5,18,19,130
16,15,9,19,15,14,6,21,12,127
16,15,9,19,15,14,9,14,7,118
16,15,9,19,15,14,15,21,19,143
16,15,9,19,15,14,19,0,0,107
16,15,9,19,19,1,18,4,5,106
16,15,9,19,20,5,18,0,0,102
16,15,9,19,21,18,5,0,0,103
16,15,9,20,18,1,9,12,0,100
16,15,9,20,18,5,12,0,0,95
16,15,9,20,18,5,12,19,0,114
16,15,9,22,18,1,4,5,0,90
16,15,11,1,2,12,5,0,0,62
16,15,11,5,0,0,0,0,0,47
16,15,11,5,2,5,18,18,25,115
16,15,11,5,4,0,0,0,0,51
16,15,11,5,6,21,12,0,0,86
16,15,11,5,25,0,0,0,0,72
16,15,11,5,25,19,0,0,0,91
16,15,11,5,12,15,7,1,14,96
16,15,11,5,12,15,11,5,14,104
16,15,11,5,15,21,20,0,0,103
16,15,11,5,18,0,0,0,0,65
16,15,11,5,18,6,1,3,5,80
16,15,11,5,18,9,19,8,0,101
16,15,11,5,18,12,9,11,5,102
16,15,11,5,18,15,15,20,0,115
16,15,11,5,18,15,15,20,19,134
16,15,11,5,18,19,0,0,0,84
16,15,11,5,19,0,0,0,0,66
16,15,11,5,23,5,5,4,0,84
16,15,11,5,23,5,5,4,19,103
16,15,11,25,0,0,0,0,0,67
16,15,11,9,5,0,0,0,0,56
16,15,11,9,5,18,0,0,0,74
16,15,11,9,5,19,0,0,0,75
16,15,11,9,5,19,20,0,0,95
16,15,11,9,12,25,0,0,0,88
16,15,11,9,14,5,19,19,0,108
16,15,11,9,14,7,0,0,0,72
16,15,11,9,14,7,12,25,0,109
16,15,11,15,13,15,15,0,0,100
16,15,11,21,14,20,0,0,0,97
16,15,12,1,3,18,5,0,0,70
16,15,12,1,18,0,0,0,0,62
16,15,12,1,18,1,14,0,0,77
16,15,12,1,18,1,14,19,0,96
16,15,12,1,18,25,0,0,0,87
16,15,12,1,18,9,3,0,0,74
16,15,12,1,18,9,12,25,0,108
16,15,12,1,18,9,19,5,0,95
16,15,12,1,18,9,19,5,4,99
16,15,12,1,18,9,19,5,18,113
16,15,12,1,18,9,19,5,19,114
16,15,12,1,18,9,20,25,0,116
16,15,12,1,18,9,20,15,14,120
16,15,12,1,18,9,26,5,0,102
16,15,12,1,18,9,26,5,4,106
16,15,12,1,18,9,26,5,18,120
16,15,12,1,18,9,26,5,19,121
16,15,12,1,18,12,25,0,0,99
16,15,12,1,18,15,9,4,19,109
16,15,12,1,18,15,14,0,0,91
16,15,12,1,18,15,14,19,0,110
16,15,12,1,18,19,0,0,0,81
16,15,12,1,18,23,1,18,4,108
16,15,12,1,24,9,19,0,0,96
16,15,12,4,1,22,25,0,0,95
16,15,12,4,1,22,9,19,0,98
16,15,12,4,5,18,0,0,0,70
16,15,12,4,5,18,2,15,25,112
16,15,12,4,5,18,13,1,14,98
16,15,12,4,5,18,19,0,0,89
16,15,12,4,15,15,4,25,0,106
16,15,12,4,18,15,14,0,0,94
16,15,12,5,0,0,0,0,0,48
16,15,12,5,1,18,13,0,0,80
16,15,12,5,1,24,0,0,0,73
16,15,12,5,1,24,5,0,0,78
16,15,12,5,1,24,5,4,0,82
16,15,12,5,1,24,5,18,0,96
16,15,12,5,1,24,5,19,0,97
16,15,12,5,1,24,9,14,7,103
16,15,12,5,2,21,18,14,0,103
16,15,12,5,3,1,20,0,0,72
16,15,12,5,3,1,20,19,0,91
16,15,12,5,4,0,0,0,0,52
16,15,12,5,8,5,1,4,0,66
16,15,12,5,25,0,0,0,0,73
16,15,12,5,25,14,0,0,0,87
16,15,12,5,25,14,5,0,0,92
16,15,12,5,25,14,19,0,0,106
16,15,12,5,9,19,0,0,0,76
16,15,12,5,12,5,19,19,0,103
16,15,12,5,13,1,14,0,0,76
16,15,12,5,13,1,18,3,8,91
16,15,12,5,13,9,3,0,0,73
16,15,12,5,13,9,3,1,12,86
16,15,12,5,13,9,3,19,0,92
16,15,12,5,13,9,19,20,0,109
16,15,12,5,13,9,19,20,19,128
16,15,12,5,13,9,26,5,0,101
16,15,12,5,13,9,26,5,4,105
16,15,12,5,13,9,26,5,19,120
16,15,12,5,14,20,1,0,0,83
16,15,12,5,14,20,1,19,0,102
16,15,12,5,18,19,0,0,0,85
16,15,12,5,19,0,0,0,0,67
16,15,12,5,19,1,23,0,0,91
16,15,12,5,19,13,1,14,0,95
16,15,12,5,19,20,1,18,0,106
16,15,12,5,19,20,1,18,19,125
16,15,12,5,23,1,18,4,0,94
16,15,12,5,23,1,18,4,19,113
16,15,12,5,23,9,7,0,0,87
16,15,12,25,0,0,0,0,0,68
16,15,12,25,1,3,9,4,0,85
16,15,12,25,1,3,20,0,0,92
16,15,12,9,1,4,0,0,0,57
16,15,12,25,1,4,0,0,0,73
16,15,12,9,1,4,9,3,0,69
16,15,12,25,1,4,9,3,0,85
16,15,12,25,1,5,13,9,1,97
16,15,12,25,1,5,13,9,3,99
16,15,12,25,1,13,9,4,5,100
16,15,12,25,1,13,9,14,5,110
16,15,12,25,1,14,4,18,25,130
16,15,12,9,1,14,9,20,5,101
16,15,12,25,1,14,20,8,1,112
16,15,12,25,1,14,20,8,9,120
16,15,12,25,1,14,20,8,25,136
16,15,12,25,1,18,3,8,0,98
16,15,12,25,1,18,3,8,25,123
16,15,12,25,1,24,9,1,12,115
16,15,12,25,1,24,15,14,0,122
16,15,12,25,1,24,15,14,5,127
16,15,12,25,2,1,19,9,3,102
16,15,12,25,2,12,1,19,20,122
16,15,12,25,2,18,9,4,0,101
16,15,12,25,2,18,9,4,19,120
16,15,12,25,2,21,14,25,0,130
16,15,12,25,3,1,18,16,25,131
16,15,12,9,3,5,0,0,0,60
16,15,12,9,3,5,4,0,0,64
16,15,12,9,3,5,4,15,13,92
16,15,12,9,3,5,13,1,14,88
16,15,12,9,3,5,13,5,14,92
16,15,12,9,3,5,19,0,0,79
16,15,12,25,3,8,15,18,4,116
16,15,12,25,3,8,19,9,1,108
16,15,12,9,3,25,0,0,0,80
16,15,12,9,3,9,1,12,0,77
16,15,12,25,3,25,3,12,25,136
16,15,12,9,3,9,5,19,0,88
16,15,12,9,3,9,14,7,0,85
16,15,12,9,3,9,26,5,0,95
16,15,12,9,3,9,26,5,18,113
16,15,12,25,3,12,1,4,0,88
16,15,12,25,3,12,1,4,25,113
16,15,12,25,3,12,15,14,1,113
16,15,12,25,3,15,14,9,3,112
16,15,12,25,3,15,20,0,0,106
16,15,12,25,3,15,20,25,12,143
16,15,12,25,3,15,20,19,0,125
16,15,12,25,3,18,1,3,25,118
16,15,12,25,3,18,1,19,5,114
16,15,12,25,4,5,13,9,3,102
16,15,12,25,4,5,18,13,25,133
16,15,12,25,5,4,18,1,12,108
16,15,12,25,5,9,4,9,3,98
16,15,12,25,5,13,9,1,0,96
16,15,12,25,5,13,9,3,0,98
16,15,12,25,5,14,5,0,0,92
16,15,12,25,5,14,5,19,0,111
16,15,12,25,5,14,9,3,0,99
16,15,12,25,5,18,7,9,3,110
16,15,12,9,5,19,0,0,0,76
16,15,12,25,5,19,20,5,18,135
16,15,12,25,6,15,9,12,0,110
16,15,12,25,6,15,12,4,0,105
16,15,12,25,7,1,12,1,19,108
16,15,12,25,7,1,12,9,3,100
16,15,12,25,7,1,12,9,14,111
16,15,12,25,7,1,13,0,0,89
16,15,12,25,7,1,13,25,0,114
16,15,12,25,7,1,13,9,3,101
16,15,12,9,7,1,18,0,0,78
16,15,12,25,7,1,18,0,0,94
16,15,12,25,7,5,14,5,0,99
16,15,12,25,7,5,14,5,19,118
16,15,12,25,7,5,14,25,0,119
16,15,12,25,7,5,14,9,3,106
16,15,12,25,7,25,14,0,0,114
16,15,12,25,7,25,14,25,0,139
16,15,12,25,7,25,14,9,3,126
16,15,12,25,7,25,18,1,12,131
16,15,12,25,7,25,18,9,1,128
16,15,12,25,7,12,15,20,0,122
16,15,12,25,7,12,15,20,19,141
16,15,12,25,7,15,14,0,0,104
16,15,12,25,7,15,14,1,12,117
16,15,12,25,7,15,14,25,0,129
16,15,12,25,7,15,14,9,3,116
16,15,12,25,7,15,14,19,0,123
16,15,12,25,7,18,1,13,0,107
16,15,12,25,7,18,1,16,8,118
16,15,12,25,8,5,4,18,1,104
16,15,12,25,8,5,13,9,1,104
16,15,12,25,8,5,13,9,3,106
16,15,12,25,9,4,5,9,3,98
16,15,12,25,9,13,9,4,5,108
16,15,12,25,12,5,13,13,1,112
16,15,12,25,12,9,20,8,0,117
16,15,12,9,12,12,1,0,0,77
16,15,12,25,12,15,7,25,0,127
16,15,12,25,13,1,14,9,1,106
16,15,12,25,13,1,19,20,25,146
16,15,12,25,13,1,20,8,0,110
16,15,12,25,13,1,20,8,25,135
16,15,12,25,13,1,20,8,19,129
16,15,12,25,13,1,26,9,1,118
16,15,12,25,13,5,12,25,0,123
16,15,12,25,13,5,12,9,1,108
16,15,12,25,13,5,18,0,0,104
16,15,12,25,13,5,18,5,0,109
16,15,12,25,13,5,18,25,0,129
16,15,12,25,13,5,18,9,1,114
16,15,12,25,13,5,18,9,3,116
16,15,12,25,13,5,18,19,0,123
16,15,12,25,13,5,20,5,18,129
16,15,12,25,13,25,15,9,4,134
16,15,12,25,13,25,20,8,25,159
16,15,12,25,13,25,24,9,14,153
16,15,12,25,13,14,25,0,0,120
16,15,12,25,13,14,9,20,5,129
16,15,12,25,13,15,18,16,8,138
16,15,12,25,14,5,5,0,0,92
16,15,12,25,14,5,13,9,4,113
16,15,12,25,14,5,19,9,3,118
16,15,12,9,14,7,0,0,0,73
16,15,12,25,14,9,1,0,0,92
16,15,12,25,14,25,1,0,0,108
16,15,12,25,14,25,1,19,0,127
16,15,12,25,14,15,4,1,12,114
16,15,12,25,14,15,9,4,0,110
16,15,12,25,14,15,13,5,0,115
16,15,12,25,14,15,13,9,3,122
16,15,12,9,15,0,0,0,0,67
16,15,12,25,15,4,15,14,20,136
16,15,12,25,15,5,3,25,0,116
16,15,12,25,15,12,0,0,0,95
16,15,12,25,15,13,1,0,0,97
16,15,12,25,15,13,1,19,0,116
16,15,12,25,15,14,25,13,0,135
16,15,12,25,15,14,25,13,25,160
16,15,12,25,15,14,15,13,25,150
16,15,12,25,15,16,9,1,0,109
16,15,12,25,15,16,9,3,0,111
16,15,12,25,15,16,19,25,0,143
16,15,12,25,15,16,19,9,1,128
16,15,12,25,15,18,1,13,1,116
16,15,12,9,15,19,0,0,0,86
16,15,12,25,15,19,5,0,0,107
16,15,12,9,15,19,9,19,0,114
16,15,12,25,15,24,9,4,5,125
16,15,12,25,16,0,0,0,0,84
16,15,12,25,16,1,7,5,0,97
16,15,12,25,16,1,7,5,4,101
16,15,12,25,16,1,18,25,0,128
16,15,12,25,16,1,18,9,1,113
16,15,12,25,16,5,1,14,0,104
16,15,12,25,16,5,4,0,0,93
16,15,12,25,16,5,20,1,12,122
16,15,12,25,16,8,1,7,5,105
16,15,12,25,16,8,1,7,25,125
16,15,12,25,16,8,1,19,5,117
16,15,12,25,16,8,25,12,25,154
16,15,12,25,16,8,15,14,5,126
16,15,12,25,16,8,15,14,25,146
16,15,12,25,16,8,15,18,5,130
16,15,12,25,16,8,15,20,5,132
16,15,12,25,16,9,1,14,0,108
16,15,12,25,16,9,4,5,0,102
16,15,12,25,16,9,4,5,19,121
16,15,12,25,16,9,4,15,13,125
16,15,12,25,16,9,5,18,0,116
16,15,12,25,16,9,6,5,18,122
16,15,12,25,16,9,20,5,0,118
16,15,12,25,16,12,15,9,4,124
16,15,12,25,16,14,5,1,0,104
16,15,12,25,16,14,5,1,19,123
16,15,12,25,16,14,5,9,3,115
16,15,12,25,16,14,15,5,1,119
16,15,12,25,16,15,4,0,0,103
16,15,12,25,16,15,4,25,0,128
16,15,12,25,16,15,4,9,1,113
16,15,12,25,16,15,4,19,0,122
16,15,12,25,16,15,9,4,0,112
16,15,12,25,16,15,18,5,0,122
16,15,12,25,16,15,18,5,19,141
16,15,12,25,16,15,19,5,0,123
16,15,12,25,16,15,19,9,19,146
16,15,12,25,16,15,21,19,0,139
16,15,12,25,16,18,5,14,5,126
16,15,12,25,16,18,9,19,13,143
16,15,12,25,16,19,0,0,0,103
16,15,12,25,16,20,25,3,8,140
16,15,12,25,16,20,15,20,5,144
16,15,12,25,16,21,19,0,0,124
16,15,12,25,16,21,19,5,19,148
16,15,12,9,19,0,0,0,0,71
16,15,12,25,19,0,0,0,0,87
16,15,12,25,19,3,15,16,5,126
16,15,12,25,19,5,13,25,0,130
16,15,12,25,19,5,13,9,1,115
16,15,12,9,19,8,5,4,0,88
16,15,12,9,19,8,5,18,0,102
16,15,12,9,19,8,5,18,19,121
16,15,12,9,19,8,5,19,0,103
16,15,12,9,19,8,9,14,7,109
16,15,12,25,19,9,4,5,4,109
16,15,12,9,19,13,1,14,0,99
16,15,12,25,19,15,13,5,0,120
16,15,12,25,19,15,13,5,19,139
16,15,12,25,19,15,13,25,0,140
16,15,12,25,19,15,13,9,1,125
16,15,12,25,19,15,13,9,3,127
16,15,12,25,19,16,1,19,20,143
16,15,12,25,19,16,15,18,5,141
16,15,12,9,19,19,15,9,18,132
16,15,12,9,19,20,1,0,0,92
16,15,12,25,19,20,5,12,5,129
16,15,12,25,19,20,25,12,5,149
16,15,12,25,19,20,15,13,5,140
16,15,12,9,20,0,0,0,0,72
16,15,12,9,20,1,18,3,8,102
16,15,12,9,20,5,0,0,0,77
16,15,12,9,20,5,6,21,12,116
16,15,12,9,20,5,9,0,0,86
16,15,12,9,20,5,9,1,0,87
16,15,12,9,20,5,12,25,0,114
16,15,12,25,20,5,14,5,0,112
16,15,12,25,20,5,14,25,0,132
16,15,12,9,20,5,18,0,0,95
16,15,12,9,20,5,19,19,5,120
16,15,12,9,20,5,19,20,0,116
16,15,12,25,20,8,5,12,25,138
16,15,12,25,20,8,5,14,5,120
16,15,12,9,20,25,0,0,0,97
16,15,12,9,20,9,3,0,0,84
16,15,12,9,20,9,3,1,12,97
16,15,12,9,20,9,3,11,0,95
16,15,12,9,20,9,3,11,19,114
16,15,12,9,20,9,3,12,25,121
16,15,12,9,20,9,3,15,0,99
16,15,12,9,20,9,3,15,19,118
16,15,12,9,20,9,3,19,0,103
16,15,12,9,20,9,5,4,0,90
16,15,12,9,20,9,5,19,0,105
16,15,12,25,20,25,16,5,0,134
16,15,12,25,20,25,16,5,4,138
16,15,12,25,20,25,16,5,19,153
16,15,12,25,20,25,16,25,0,154
16,15,12,25,20,25,16,9,3,141
16,15,12,9,20,9,19,20,0,120
16,15,12,9,20,9,26,5,0,112
16,15,12,25,20,15,11,25,0,139
16,15,12,25,20,15,13,25,0,141
16,15,12,25,20,15,14,1,12,130
16,15,12,25,20,15,14,5,0,122
16,15,12,25,20,15,14,25,0,142
16,15,12,25,20,15,14,9,3,129
16,15,12,25,20,15,16,5,0,124
16,15,12,25,20,15,16,9,3,131
16,15,12,25,20,18,15,16,5,142
16,15,12,9,20,21,18,5,0,116
16,15,12,25,21,18,9,1,0,117
16,15,12,25,21,18,9,1,19,136
16,15,12,25,21,18,9,3,0,119
16,15,12,25,22,5,0,0,0,95
16,15,12,25,22,9,14,25,12,150
16,15,12,25,23,1,20,5,18,135
16,15,12,25,26,15,1,12,0,122
16,15,12,25,26,15,1,14,0,124
16,15,12,25,26,15,1,14,19,143
16,15,12,25,26,15,1,18,25,153
16,15,12,25,26,15,9,3,0,121
16,15,12,25,26,15,9,19,13,150
16,15,12,25,26,15,14,1,12,136
16,15,12,25,26,15,15,9,4,137
16,15,12,25,26,15,15,14,0,138
16,15,12,10,5,0,0,0,0,58
16,15,12,11,1,0,0,0,0,55
16,15,12,11,1,4,15,20,0,94
16,15,12,11,1,5,4,0,0,64
16,15,12,11,1,9,14,7,0,85
16,15,12,11,1,19,0,0,0,74
16,15,12,11,9,0,0,0,0,63
16,15,12,12,1,2,12,5,0,75
16,15,12,12,1,3,11,19,0,89
16,15,12,12,1,4,26,0,0,86
16,15,12,12,1,7,5,0,0,68
16,15,12,12,1,13,0,0,0,69
16,15,12,12,1,14,0,0,0,70
16,15,12,12,1,18,3,8,25,110
16,15,12,12,1,18,4,5,4,87
16,15,12,12,1,18,4,19,0,97
16,15,12,12,2,15,15,11,0,98
16,15,12,12,3,1,4,15,20,98
16,15,12,12,5,4,0,0,0,64
16,15,12,12,5,5,0,0,0,65
16,15,12,12,5,5,19,0,0,84
16,15,12,12,5,14,1,20,5,100
16,15,12,12,5,14,5,4,0,83
16,15,12,12,5,14,9,14,7,104
16,15,12,12,5,14,9,20,5,108
16,15,12,12,5,14,19,0,0,93
16,15,12,12,5,14,20,0,0,94
16,15,12,12,5,18,0,0,0,78
16,15,12,12,5,18,1,0,0,79
16,15,12,12,5,18,1,19,0,98
16,15,12,12,5,18,19,0,0,97
16,15,12,12,5,20,0,0,0,80
16,15,12,12,5,20,5,14,0,99
16,15,12,12,5,20,20,5,0,105
16,15,12,12,5,24,0,0,0,84
16,15,12,12,9,3,1,12,0,80
16,15,12,12,9,3,1,18,0,86
16,15,12,12,9,3,1,20,5,93
16,15,12,12,9,3,5,19,0,91
16,15,12,12,25,6,9,19,8,122
16,15,12,12,9,14,1,18,0,97
16,15,12,12,9,14,1,20,5,104
16,15,12,12,9,14,7,0,0,85
16,15,12,12,9,14,9,1,0,88
16,15,12,12,9,14,9,3,0,90
16,15,12,12,9,14,9,21,13,121
16,15,12,12,9,14,9,26,5,118
16,15,12,12,9,14,15,9,4,106
16,15,12,12,9,14,15,19,5,117
16,15,12,12,9,19,20,0,0,103
16,15,12,12,9,19,20,19,0,122
16,15,12,12,9,23,9,7,0,103
16,15,12,12,9,23,15,7,0,109
16,15,12,12,25,23,15,7,0,125
16,15,12,12,9,23,15,7,19,128
16,15,12,12,25,23,15,7,19,144
16,15,12,12,15,3,11,19,0,103
16,15,12,12,15,9,0,0,0,79
16,15,12,12,19,0,0,0,0,74
16,15,12,12,19,20,5,18,0,117
16,15,12,12,19,20,5,18,19,136
16,15,12,12,21,3,9,20,5,113
16,15,12,12,21,20,1,14,20,131
16,15,12,12,21,20,5,0,0,101
16,15,12,12,21,20,5,4,0,105
16,15,12,12,21,20,5,18,0,119
16,15,12,12,21,20,5,18,19,138
16,15,12,12,21,20,5,19,0,120
16,15,12,12,21,20,9,14,7,126
16,15,12,12,21,20,9,15,14,134
16,15,12,12,21,20,9,22,5,132
16,15,12,15,3,25,20,5,0,111
16,15,12,15,3,15,14,9,3,102
16,15,12,15,9,0,0,0,0,67
16,15,12,15,9,4,1,12,0,84
16,15,12,15,9,19,20,0,0,106
16,15,12,15,9,19,20,19,0,125
16,15,12,15,14,1,9,19,5,106
16,15,12,15,14,25,0,0,0,97
16,15,12,15,14,9,3,11,0,95
16,15,12,15,14,9,21,13,0,115
16,15,12,15,14,9,21,13,19,134
16,15,12,15,16,15,14,25,0,128
16,15,12,15,19,0,0,0,0,77
16,15,12,19,0,0,0,0,0,62
16,15,12,19,20,5,18,0,0,105
16,15,12,20,0,0,0,0,0,63
16,15,12,20,6,15,15,20,0,119
16,15,12,20,9,14,1,0,0,87
16,15,12,20,9,14,9,11,0,106
16,15,12,20,9,14,14,9,11,120
16,15,12,20,18,15,15,14,0,125
16,15,12,20,18,15,15,14,19,144
16,15,12,22,5,18,9,14,5,116
16,15,12,26,5,14,9,20,5,122
16,15,13,1,3,5,0,0,0,53
16,15,13,1,3,5,15,21,19,108
16,15,13,1,3,5,19,0,0,72
16,15,13,1,4,1,0,0,0,50
16,15,13,1,4,5,0,0,0,54
16,15,13,1,4,5,4,0,0,58
16,15,13,1,4,5,19,0,0,73
16,15,13,1,4,9,14,7,0,79
16,15,13,1,14,4,5,18,0,86
16,15,13,1,14,4,5,18,19,105
16,15,13,1,14,5,0,0,0,64
16,15,13,1,18,4,0,0,0,67
16,15,13,1,18,25,0,0,0,88
16,15,13,1,18,9,14,5,0,91
16,15,13,1,18,9,21,13,0,106
16,15,13,1,20,5,0,0,0,70
16,15,13,1,20,15,0,0,0,80
16,15,13,1,20,15,5,19,0,104
16,15,13,1,20,15,13,9,4,106
16,15,13,1,20,21,13,0,0,99
16,15,13,1,20,21,13,19,0,118
16,15,13,2,5,0,0,0,0,51
16,15,13,2,15,0,0,0,0,61
16,15,13,5,0,0,0,0,0,49
16,15,13,5,25,0,0,0,0,74
16,15,13,5,25,19,0,0,0,93
16,15,13,5,12,0,0,0,0,61
16,15,13,5,12,25,0,0,0,86
16,15,13,5,12,15,0,0,0,76
16,15,13,5,12,15,19,0,0,95
16,15,13,5,18,9,1,0,0,77
16,15,13,5,18,9,21,13,0,110
16,15,13,5,19,0,0,0,0,68
16,15,13,5,23,1,20,5,18,116
16,15,13,6,18,5,19,20,0,112
16,15,13,6,18,5,20,19,0,112
16,15,13,9,6,15,18,13,0,105
16,15,13,13,1,4,15,0,0,77
16,15,13,13,1,7,5,0,0,70
16,15,13,13,5,0,0,0,0,62
16,15,13,13,5,5,0,0,0,67
16,15,13,13,5,25,0,0,0,87
16,15,13,13,5,12,5,4,0,83
16,15,13,13,5,12,5,18,0,97
16,15,13,13,5,12,9,14,7,104
16,15,13,13,5,12,9,15,14,112
16,15,13,13,5,12,12,5,4,95
16,15,13,13,5,12,12,5,18,109
16,15,13,13,5,12,15,0,0,89
16,15,13,13,5,12,19,0,0,93
16,15,13,13,5,18,0,0,0,80
16,15,13,13,5,18,25,0,0,105
16,15,13,13,5,20,0,0,0,82
16,15,13,13,5,20,20,25,0,127
16,15,13,13,25,0,0,0,0,82
16,15,13,13,9,5,0,0,0,71
16,15,13,13,9,5,19,0,0,90
16,15,13,15,5,18,9,21,13,125
16,15,13,15,12,15,0,0,0,86
16,15,13,15,12,15,7,25,0,118
16,15,13,15,14,1,12,0,0,86
16,15,13,15,14,9,3,0,0,85
16,15,13,16,0,0,0,0,0,60
16,15,13,16,1,0,0,0,0,61
16,15,13,16,1,12,0,0,0,73
16,15,13,16,1,14,15,0,0,90
16,15,13,16,1,14,15,19,0,109
16,15,13,16,1,20,9,3,0,93
16,15,13,16,5,18,11,9,14,117
16,15,13,16,8,15,12,9,24,128
16,15,13,16,8,15,12,25,24,144
16,15,13,16,8,21,19,0,0,108
16,15,13,16,9,5,18,0,0,92
16,15,13,16,9,12,9,4,0,94
16,15,13,16,9,12,15,9,4,109
16,15,13,16,9,15,14,0,0,98
16,15,13,16,9,19,20,0,0,108
16,15,13,16,12,5,19,19,0,115
16,15,13,16,15,12,5,15,14,121
16,15,13,16,15,13,0,0,0,88
16,15,13,16,15,13,19,0,0,107
16,15,13,16,15,14,0,0,0,89
16,15,13,16,15,14,19,0,0,108
16,15,13,16,15,15,14,0,0,104
16,15,13,16,15,19,9,20,25,148
16,15,13,16,15,19,15,0,0,109
16,15,13,16,15,21,19,0,0,115
16,15,13,16,15,21,19,12,25,152
16,15,13,16,19,0,0,0,0,79
16,15,13,16,19,20,5,18,0,122
16,15,13,19,0,0,0,0,0,63
16,15,13,19,20,5,18,0,0,106
16,15,14,0,0,0,0,0,0,45
16,15,14,3,5,1,21,0,0,75
16,15,14,3,5,4,0,0,0,57
16,15,14,3,5,12,5,20,0,90
16,15,14,3,5,19,0,0,0,72
16,15,14,3,8,15,0,0,0,71
16,15,14,3,8,15,5,4,0,80
16,15,14,3,8,15,19,0,0,90
16,15,14,3,9,14,7,0,0,78
16,15,14,4,1,7,5,0,0,62
16,15,14,4,2,21,19,8,0,99
16,15,14,4,5,4,0,0,0,58
16,15,14,4,5,18,0,0,0,72
16,15,14,4,5,18,1,12,0,85
16,15,14,4,5,18,1,14,20,107
16,15,14,4,5,18,1,18,25,116
16,15,14,4,5,18,1,20,5,98
16,15,14,4,5,18,5,4,0,81
16,15,14,4,5,18,5,18,0,95
16,15,14,4,5,18,5,18,19,114
16,15,14,4,5,18,9,14,7,102
16,15,14,4,5,18,15,21,19,127
16,15,14,4,5,18,19,0,0,91
16,15,14,4,6,9,19,8,0,91
16,15,14,4,6,21,12,0,0,88
16,15,14,4,7,18,1,19,19,113
16,15,14,4,25,0,0,0,0,74
16,15,14,4,9,14,7,0,0,79
16,15,14,4,12,5,20,0,0,86
16,15,14,4,12,9,11,5,0,86
16,15,14,4,13,1,14,0,0,77
16,15,14,4,15,11,0,0,0,75
16,15,14,4,15,11,11,9,5,100
16,15,14,4,19,0,0,0,0,68
16,15,14,4,19,9,4,5,0,86
16,15,14,4,21,19,0,0,0,89
16,15,14,4,22,9,12,12,5,109
16,15,14,4,23,5,5,4,0,86
16,15,14,4,23,5,5,4,19,105
16,15,14,4,23,15,18,20,0,125
16,15,14,5,0,0,0,0,0,50
16,15,14,5,25,0,0,0,0,75
16,15,14,5,14,20,0,0,0,84
16,15,14,5,18,9,4,0,0,81
16,15,14,5,18,9,14,5,0,96
16,15,14,5,18,15,9,4,0,96
16,15,14,5,19,0,0,0,0,69
16,15,14,7,0,0,0,0,0,52
16,15,14,7,1,0,0,0,0,53
16,15,14,7,5,4,0,0,0,61
16,15,14,7,5,5,0,0,0,62
16,15,14,7,5,5,19,0,0,81
16,15,14,7,9,4,0,0,0,65
16,15,14,7,9,4,19,0,0,84
16,15,14,7,9,14,7,0,0,82
16,15,14,7,19,0,0,0,0,71
16,15,14,8,1,23,19,0,0,96
16,15,14,25,0,0,0,0,0,70
16,15,14,9,1,18,4,0,0,77
16,15,14,9,1,18,4,5,4,86
16,15,14,9,1,18,4,19,0,96
16,15,14,9,3,1,0,0,0,58
16,15,14,25,3,1,18,20,0,112
16,15,14,9,5,4,0,0,0,63
16,15,14,9,5,18,0,0,0,77
16,15,14,9,5,19,0,0,0,78
16,15,14,25,9,14,7,0,0,100
16,15,14,25,20,1,9,12,0,112
16,15,14,25,20,1,9,12,19,131
16,15,14,10,1,0,0,0,0,56
16,15,14,15,7,18,1,16,8,110
16,15,14,15,19,0,0,0,0,79
16,15,14,19,0,0,0,0,0,64
16,15,14,20,0,0,0,0,0,65
16,15,14,20,1,7,5,0,0,78
16,15,14,20,1,12,0,0,0,78
16,15,14,20,5,5,0,0,0,75
16,15,14,20,5,19,0,0,0,89
16,15,14,20,9,1,3,19,0,97
16,15,14,20,9,1,14,1,3,93
16,15,14,20,9,6,5,24,0,109
16,15,14,20,9,6,6,0,0,86
16,15,14,20,9,6,6,19,0,105
16,15,14,20,9,6,25,0,0,105
16,15,14,20,9,6,9,3,0,92
16,15,14,20,9,6,9,3,5,97
16,15,14,20,9,12,0,0,0,86
16,15,14,20,9,12,5,0,0,91
16,15,14,20,9,12,19,0,0,105
16,15,14,20,9,14,0,0,0,88
16,15,14,20,9,19,20,0,0,113
16,15,14,20,12,5,22,9,19,132
16,15,14,20,15,0,0,0,0,80
16,15,14,20,15,14,5,5,18,122
16,15,14,20,15,14,9,5,18,126
16,15,14,20,15,14,19,0,0,113
16,15,14,20,15,15,14,0,0,109
16,15,14,20,15,15,14,5,18,132
16,15,14,20,15,15,14,19,0,128
16,15,14,26,9,20,5,0,0,105
16,15,15,1,0,0,0,0,0,47
16,15,15,3,8,0,0,0,0,57
16,15,15,3,8,5,4,0,0,66
16,15,15,3,8,5,19,0,0,81
16,15,15,3,8,9,14,7,0,87
16,15,15,4,0,0,0,0,0,50
16,15,15,4,5,18,0,0,0,73
16,15,15,4,12,5,0,0,0,67
16,15,15,4,12,5,4,15,13,99
16,15,15,4,12,5,9,19,8,103
16,15,15,4,12,5,18,0,0,85
16,15,15,4,12,5,19,0,0,86
16,15,15,4,19,0,0,0,0,69
16,15,15,6,0,0,0,0,0,52
16,15,15,6,25,0,0,0,0,77
16,15,15,6,19,0,0,0,0,71
16,15,15,6,20,1,8,0,0,81
16,15,15,6,20,1,8,19,0,100
16,15,15,6,20,5,18,0,0,95
16,15,15,6,20,5,18,19,0,114
16,15,15,7,25,5,0,0,0,83
16,15,15,8,5,4,0,0,0,63
16,15,15,8,9,14,7,0,0,84
16,15,15,8,19,0,0,0,0,73
16,15,15,10,1,8,0,0,0,65
16,15,15,11,0,0,0,0,0,57
16,15,15,11,1,0,0,0,0,58
16,15,15,11,1,21,14,0,0,93
16,15,15,11,1,23,14,0,0,95
16,15,15,11,8,1,21,14,0,101
16,15,15,11,15,15,0,0,0,87
16,15,15,12,5,4,0,0,0,67
16,15,15,12,8,1,12,12,0,91
16,15,15,12,8,1,12,12,19,110
16,15,15,12,9,0,0,0,0,67
16,15,15,12,25,0,0,0,0,83
16,15,15,12,9,14,7,0,0,88
16,15,15,12,18,15,15,13,0,119
16,15,15,12,18,15,15,13,19,138
16,15,15,12,18,15,15,20,0,126
16,15,15,12,19,0,0,0,0,77
16,15,15,12,19,9,4,5,0,95
16,15,15,12,23,15,18,20,0,134
16,15,15,14,0,0,0,0,0,60
16,15,15,14,1,3,0,0,0,64
16,15,15,14,1,8,0,0,0,69
16,15,15,14,3,5,0,0,0,68
16,15,15,14,7,1,0,0,0,68
16,15,15,14,7,5,5,0,0,77
16,15,15,14,7,8,5,5,0,85
16,15,15,14,7,8,9,5,0,89
16,15,15,14,19,0,0,0,0,79
16,15,15,16,5,4,0,0,0,71
16,15,15,16,8,25,20,5,0,120
16,15,15,16,8,25,20,9,3,127
16,15,15,16,9,14,7,0,0,92
16,15,15,16,19,0,0,0,0,81
16,15,15,16,19,9,5,0,0,95
16,15,15,18,0,0,0,0,0,64
16,15,15,18,5,18,0,0,0,87
16,15,15,18,5,19,20,0,0,108
16,15,15,18,7,1,0,0,0,72
16,15,15,18,8,15,21,19,5,132
16,15,15,18,9,0,0,0,0,73
16,15,15,18,9,19,0,0,0,92
16,15,15,18,9,19,8,0,0,100
16,15,15,18,12,25,0,0,0,101
16,15,15,18,12,25,9,19,8,137
16,15,15,18,12,9,14,7,0,106
16,15,15,18,14,5,19,19,0,121
16,15,15,18,20,0,0,0,0,84
16,15,15,18,20,9,20,8,0,121
16,15,15,18,20,9,20,8,19,140
16,15,15,18,23,5,5,4,0,101
16,15,15,18,23,9,12,12,0,120
16,15,15,20,0,0,0,0,0,66
16,15,15,20,8,5,18,0,0,97
16,15,15,20,25,0,0,0,0,91
16,15,15,22,5,0,0,0,0,73
16,15,15,22,5,19,0,0,0,92
16,15,16,1,4,1,13,0,0,66
16,15,16,1,12,0,0,0,0,60
16,15,16,3,15,18,14,0,0,97
16,15,16,3,15,18,14,19,0,116
16,15,16,4,15,3,11,0,0,80
16,15,16,5,4,15,13,0,0,84
16,15,16,5,4,15,13,19,0,103
16,15,16,5,8,15,12,25,0,112
16,15,16,5,8,15,15,4,0,94
16,15,16,5,25,5,0,0,0,82
16,15,16,5,25,5,4,0,0,86
16,15,16,5,25,5,19,0,0,101
16,15,16,5,9,19,13,0,0,93
16,15,16,5,12,5,18,0,0,87
16,15,16,5,12,5,19,19,0,107
16,15,16,5,12,25,0,0,0,89
16,15,16,5,12,9,11,5,0,89
16,15,16,5,12,9,14,5,0,92
16,15,16,5,12,9,14,7,0,94
16,15,16,5,18,25,0,0,0,95
16,15,16,5,18,9,5,19,0,103
16,15,16,5,19,0,0,0,0,71
16,15,16,5,19,8,9,16,0,104
16,15,16,5,19,19,0,0,0,90
16,15,16,7,12,15,22,5,0,108
16,15,16,7,21,14,0,0,0,89
16,15,16,7,21,14,14,5,18,126
16,15,16,7,21,14,19,0,0,108
16,15,16,9,5,0,0,0,0,61
16,15,16,9,6,25,0,0,0,87
16,15,16,9,14,1,3,0,0,74
16,15,16,9,14,10,1,25,0,106
16,15,16,9,14,10,1,25,19,125
16,15,16,9,19,8,12,25,0,120
16,15,16,10,15,25,0,0,0,97
16,15,16,12,1,18,0,0,0,78
16,15,16,12,1,18,5,4,0,87
16,15,16,12,1,18,19,0,0,97
16,15,16,12,5,13,1,14,0,92
16,15,16,12,5,19,9,5,0,97
16,15,16,12,5,20,0,0,0,84
16,15,16,12,9,14,0,0,0,82
16,15,16,12,9,14,19,0,0,101
16,15,16,12,9,20,5,1,12,106
16,15,16,12,9,20,5,9,0,102
16,15,16,12,9,20,5,21,19,133
16,15,16,12,9,20,9,3,0,100
16,15,16,12,15,12,12,25,0,123
16,15,16,15,4,5,0,0,0,71
16,15,16,15,4,9,21,13,0,109
16,15,16,15,12,9,19,0,0,102
16,15,16,15,22,5,18,0,0,107
16,15,16,15,22,5,18,19,0,126
16,15,16,16,1,0,0,0,0,64
16,15,16,16,1,2,12,5,0,83
16,15,16,16,1,4,15,13,0,96
16,15,16,16,5,1,14,0,0,83
16,15,16,16,5,4,0,0,0,72
16,15,16,16,5,12,0,0,0,80
16,15,16,16,5,18,19,0,0,105
16,15,16,16,5,20,0,0,0,88
16,15,16,16,5,20,19,0,0,107
16,15,16,16,25,3,15,3,11,120
16,15,16,16,9,5,4,0,0,81
16,15,16,16,9,5,19,0,0,96
16,15,16,16,25,6,9,19,8,130
16,15,16,16,25,8,5,1,4,106
16,15,16,16,25,12,9,11,5,125
16,15,16,16,9,14,0,0,0,86
16,15,16,16,9,14,7,0,0,93
16,15,16,16,25,23,15,18,20,164
16,15,16,16,12,5,0,0,0,80
16,15,16,16,12,5,4,0,0,84
16,15,16,16,12,5,19,0,0,99
16,15,16,16,12,25,0,0,0,100
16,15,16,16,12,9,14,7,0,105
16,15,16,19,8,15,16,0,0,105
16,15,16,19,25,0,0,0,0,91
16,15,16,19,9,5,0,0,0,80
16,15,16,19,9,5,19,0,0,99
16,15,16,21,12,1,3,5,0,89
16,15,16,21,12,1,3,5,19,108
16,15,16,21,12,1,3,25,0,109
16,15,16,21,12,1,18,0,0,99
16,15,16,21,12,1,18,5,19,123
16,15,16,21,12,1,18,12,25,136
16,15,16,21,12,1,20,5,0,106
16,15,16,21,12,1,20,5,4,110
16,15,16,21,12,1,20,5,19,125
16,15,16,21,12,1,20,15,14,130
16,15,16,21,12,1,20,15,18,134
16,15,16,21,12,5,15,14,0,114
16,15,16,21,12,9,0,0,0,89
16,15,16,21,12,9,14,0,0,103
16,15,16,21,12,9,19,13,19,140
16,15,16,21,12,9,19,20,19,147
16,15,16,21,12,15,21,19,0,135
16,15,16,21,12,21,13,0,0,114
16,15,16,23,5,5,4,0,0,84
16,15,18,1,9,12,0,0,0,71
16,15,18,1,12,0,0,0,0,62
16,15,18,2,5,1,7,12,5,81
16,15,18,3,0,0,0,0,0,52
16,15,18,3,1,20,5,0,0,78
16,15,18,3,1,20,5,4,0,82
16,15,18,3,5,12,1,9,14,93
16,15,18,3,8,0,0,0,0,60
16,15,18,3,8,5,4,0,0,69
16,15,18,3,8,5,19,0,0,84
16,15,18,3,8,9,14,7,0,90
16,15,18,3,8,12,5,19,19,115
16,15,18,3,8,12,9,11,5,97
16,15,18,3,9,14,5,0,0,80
16,15,18,3,9,14,9,0,0,84
16,15,18,3,9,14,15,0,0,90
16,15,18,3,21,16,9,14,5,117
16,15,18,5,0,0,0,0,0,54
16,15,18,5,4,0,0,0,0,58
16,15,18,5,12,9,11,5,0,91
16,15,18,5,18,0,0,0,0,72
16,15,18,5,19,0,0,0,0,73
16,15,18,5,20,0,0,0,0,74
16,15,18,7,5,0,0,0,0,61
16,15,18,7,5,18,0,0,0,79
16,15,18,7,25,0,0,0,0,81
16,15,18,7,9,5,19,0,0,89
16,15,18,7,15,0,0,0,0,71
16,15,18,25,0,0,0,0,0,74
16,15,18,9,3,9,4,1,12,87
16,15,18,9,6,5,18,1,12,100
16,15,18,9,6,15,18,13,0,110
16,15,18,9,13,1,14,9,1,96
16,15,18,9,14,1,0,0,0,73
16,15,18,9,14,5,19,19,0,115
16,15,18,9,14,7,0,0,0,79
16,15,18,9,14,7,12,25,0,116
16,15,18,9,15,14,0,0,0,87
16,15,18,9,15,14,19,0,0,106
16,15,18,9,19,13,0,0,0,90
16,15,18,9,19,13,19,0,0,109
16,15,18,9,19,20,9,3,0,109
16,15,18,9,20,5,0,0,0,83
16,15,18,9,20,15,9,4,0,106
16,15,18,11,0,0,0,0,0,60
16,15,18,11,3,8,15,16,0,102
16,15,18,11,5,1,20,5,18,109
16,15,18,11,5,18,0,0,0,83
16,15,18,11,5,18,25,0,0,108
16,15,18,11,5,18,19,0,0,102
16,15,18,11,5,20,0,0,0,85
16,15,18,11,6,9,19,8,0,102
16,15,18,11,25,0,0,0,0,85
16,15,18,11,9,5,18,0,0,92
16,15,18,11,9,5,19,0,0,93
16,15,18,11,9,5,19,20,0,113
16,15,18,11,9,14,0,0,0,83
16,15,18,11,9,14,5,19,19,126
16,15,18,11,9,19,8,0,0,96
16,15,18,11,12,5,19,19,0,115
16,15,18,11,12,9,14,7,0,102
16,15,18,11,13,1,14,0,0,88
16,15,18,11,15,12,20,0,0,107
16,15,18,11,16,5,14,0,0,95
16,15,18,11,16,9,5,0,0,90
16,15,18,11,16,9,5,19,0,109
16,15,18,11,19,0,0,0,0,79
16,15,18,11,23,15,15,4,0,117
16,15,18,11,23,15,15,4,19,136
16,15,18,14,0,0,0,0,0,63
16,15,18,14,25,0,0,0,0,88
16,15,18,14,15,0,0,0,0,78
16,15,18,14,15,3,18,1,20,120
16,15,18,14,15,19,0,0,0,97
16,15,18,14,19,0,0,0,0,82
16,15,18,15,4,9,14,5,0,96
16,15,18,15,4,9,20,5,0,102
16,15,18,15,7,1,13,0,0,85
16,15,18,15,7,1,13,25,0,110
16,15,18,15,7,1,13,9,3,97
16,15,18,15,13,1,0,0,0,78
16,15,18,15,13,1,19,0,0,97
16,15,18,15,13,1,20,1,0,99
16,15,18,15,13,5,18,9,3,112
16,15,18,15,13,5,20,5,18,125
16,15,18,15,16,15,18,15,0,128
16,15,18,15,18,15,3,1,0,101
16,15,18,15,19,0,0,0,0,83
16,15,18,15,19,3,15,16,5,122
16,15,18,15,19,3,15,16,25,142
16,15,18,15,19,5,0,0,0,88
16,15,18,15,19,9,19,0,0,111
16,15,18,15,19,9,20,25,0,137
16,15,18,15,20,9,3,0,0,96
16,15,18,15,20,25,16,5,0,130
16,15,18,15,21,19,0,0,0,104
16,15,18,15,21,19,12,25,0,141
16,15,18,16,8,9,14,5,0,101
16,15,18,16,8,25,18,9,1,126
16,15,18,16,8,25,18,9,14,139
16,15,18,16,9,20,15,9,4,122
16,15,18,16,15,9,19,5,0,113
16,15,18,16,15,9,19,5,19,132
16,15,18,16,15,18,1,20,5,124
16,15,18,18,0,0,0,0,0,67
16,15,18,18,5,3,20,0,0,95
16,15,18,18,5,3,20,21,19,135
16,15,18,18,5,20,0,0,0,92
16,15,18,18,25,0,0,0,0,92
16,15,18,18,9,4,7,5,0,92
16,15,18,18,9,4,7,5,19,111
16,15,18,18,9,4,7,25,0,112
16,15,18,18,9,7,15,0,0,98
16,15,18,18,9,14,7,5,18,120
16,15,18,20,1,2,12,5,0,89
16,15,18,20,1,2,12,5,19,108
16,15,18,20,1,2,12,25,0,109
16,15,18,20,1,7,5,4,0,86
16,15,18,20,1,7,5,19,0,101
16,15,18,20,1,7,9,14,7,107
16,15,18,20,1,7,21,5,0,103
16,15,18,20,1,9,12,0,0,91
16,15,18,20,1,12,0,0,0,82
16,15,18,20,1,12,5,4,0,91
16,15,18,20,1,12,12,5,4,103
16,15,18,20,1,12,19,0,0,101
16,15,18,20,1,14,3,5,0,92
16,15,18,20,1,14,3,5,19,111
16,15,18,20,1,16,1,11,0,98
16,15,18,20,1,19,0,0,0,89
16,15,18,20,1,19,19,0,0,108
16,15,18,20,1,20,5,0,0,95
16,15,18,20,1,20,9,12,5,116
16,15,18,20,1,20,9,22,5,126
16,15,18,20,1,20,15,0,0,105
16,15,18,20,1,20,15,18,0,123
16,15,18,20,5,1,3,9,4,91
16,15,18,20,5,4,0,0,0,78
16,15,18,20,5,14,4,0,0,92
16,15,18,20,5,14,4,5,4,101
16,15,18,20,5,14,4,19,0,111
16,15,18,20,5,14,20,0,0,108
16,15,18,20,5,14,20,19,0,127
16,15,18,20,5,15,21,19,0,129
16,15,18,20,5,18,1,7,5,105
16,15,18,20,5,18,5,19,19,135
16,15,18,20,5,18,12,25,0,129
16,15,18,20,5,18,19,0,0,111
16,15,18,20,5,19,19,5,0,117
16,15,18,20,6,9,18,5,0,107
16,15,18,20,6,15,12,9,15,126
16,15,18,20,7,12,1,22,5,116
16,15,18,20,7,18,1,22,5,122
16,15,18,20,7,18,5,22,5,126
16,15,18,20,8,15,12,5,0,109
16,15,18,20,8,15,12,5,19,128
16,15,18,20,8,15,15,11,0,118
16,15,18,20,8,15,18,19,0,129
16,15,18,20,8,15,21,19,5,137
16,15,18,20,9,3,15,0,0,96
16,15,18,20,9,3,15,5,4,105
16,15,18,20,9,3,15,5,19,120
16,15,18,20,9,3,15,19,0,115
16,15,18,20,9,3,21,19,0,121
16,15,18,20,9,5,18,5,0,106
16,15,18,20,9,5,18,5,4,110
16,15,18,20,9,5,18,5,19,125
16,15,18,20,9,6,25,0,0,109
16,15,18,20,9,6,15,18,25,142
16,15,18,20,9,14,7,0,0,99
16,15,18,20,9,15,0,0,0,93
16,15,18,20,9,15,14,0,0,107
16,15,18,20,9,15,14,1,12,120
16,15,18,20,9,15,14,5,4,116
16,15,18,20,9,15,14,5,18,130
16,15,18,20,9,15,14,5,19,131
16,15,18,20,9,15,14,19,0,126
16,15,18,20,9,20,15,18,0,131
16,15,18,20,12,1,19,20,0,121
16,15,18,20,12,5,19,19,0,124
16,15,18,20,12,5,20,0,0,106
16,15,18,20,12,25,0,0,0,106
16,15,18,20,12,9,5,18,0,113
16,15,18,20,12,9,5,19,20,134
16,15,18,20,12,9,7,8,20,125
16,15,18,20,12,9,12,25,0,127
16,15,18,20,13,1,14,0,0,97
16,15,18,20,13,5,14,20,0,121
16,15,18,20,13,15,15,20,0,132
16,15,18,20,13,15,20,5,0,122
16,15,18,20,15,9,19,5,0,117
16,15,18,20,15,12,1,14,0,111
16,15,18,20,15,12,1,14,9,120
16,15,18,20,15,12,1,14,15,126
16,15,18,20,16,1,25,14,5,130
16,15,18,20,18,1,25,0,0,113
16,15,18,20,18,1,25,1,12,126
16,15,18,20,18,1,25,5,4,122
16,15,18,20,18,1,25,5,18,136
16,15,18,20,18,1,25,19,0,132
16,15,18,20,18,1,9,20,0,117
16,15,18,20,18,1,9,20,19,136
16,15,18,20,18,5,5,22,5,124
16,15,18,20,18,5,19,19,0,130
16,15,18,20,19,0,0,0,0,88
16,15,18,20,19,1,12,5,0,106
16,15,18,20,19,9,4,5,0,106
16,15,18,20,19,9,4,5,18,124
16,15,18,20,19,13,1,14,0,116
16,15,18,20,19,15,11,5,14,133
16,15,18,20,21,1,18,25,0,134
16,15,18,20,21,7,1,9,19,126
16,15,18,20,21,7,5,19,5,126
16,15,18,20,21,12,1,14,0,117
16,15,18,20,21,14,9,1,14,128
16,15,18,20,21,14,9,4,0,117
16,15,18,20,21,18,5,0,0,113
16,15,18,20,23,1,25,0,0,118
16,15,18,21,12,5,0,0,0,87
16,15,18,21,12,15,19,5,0,121
16,15,18,21,12,15,21,19,0,137
16,15,18,21,19,0,0,0,0,89
16,15,18,23,9,7,12,5,0,105
16,15,19,1,2,12,5,0,0,70
16,15,19,1,4,1,0,0,0,56
16,15,19,1,21,14,5,0,0,91
16,15,19,3,1,0,0,0,0,54
16,15,19,3,8,1,25,0,0,87
16,15,19,5,0,0,0,0,0,55
16,15,19,5,4,0,0,0,0,59
16,15,19,5,25,0,0,0,0,80
16,15,19,5,13,5,14,20,0,107
16,15,19,5,18,0,0,0,0,73
16,15,19,5,18,19,0,0,0,92
16,15,19,5,19,0,0,0,0,74
16,15,19,5,21,18,0,0,0,94
16,15,19,5,21,18,19,0,0,113
16,15,19,5,21,19,5,0,0,100
16,15,19,8,0,0,0,0,0,58
16,15,19,8,5,18,0,0,0,81
16,15,19,8,5,19,20,0,0,102
16,15,19,8,12,25,0,0,0,95
16,15,19,8,14,5,19,19,0,115
16,15,19,8,15,0,0,0,0,73
16,15,19,25,0,0,0,0,0,75
16,15,19,9,5,4,0,0,0,68
16,15,19,9,5,19,0,0,0,83
16,15,19,9,14,7,0,0,0,80
16,15,19,9,14,7,12,25,0,117
16,15,19,9,20,0,0,0,0,79
16,15,19,9,20,5,4,0,0,88
16,15,19,9,20,9,6,0,0,94
16,15,19,9,20,9,14,7,0,109
16,15,19,9,20,9,15,14,0,117
16,15,19,9,20,9,15,14,19,136
16,15,19,9,20,9,22,1,12,123
16,15,19,9,20,9,22,5,0,115
16,15,19,9,20,9,22,5,18,133
16,15,19,9,20,9,22,5,19,134
16,15,19,9,20,15,18,0,0,112
16,15,19,9,20,18,9,14,15,135
16,15,19,9,20,18,15,14,0,126
16,15,19,9,20,18,15,14,19,145
16,15,19,9,20,19,0,0,0,98
16,15,19,9,20,21,13,0,0,113
16,15,19,9,20,21,18,5,0,123
16,15,19,14,5,20,0,0,0,89
16,15,19,15,12,5,0,0,0,82
16,15,19,15,12,15,0,0,0,92
16,15,19,15,12,15,7,25,0,124
16,15,19,15,12,15,7,9,3,111
16,15,19,16,15,12,9,20,5,127
16,15,19,19,0,0,0,0,0,69
16,15,19,19,5,0,0,0,0,74
16,15,19,19,5,13,1,14,0,102
16,15,19,19,5,13,5,14,0,106
16,15,19,19,5,19,0,0,0,93
16,15,19,19,5,19,19,0,0,112
16,15,19,19,5,19,19,5,4,121
16,15,19,19,5,19,19,5,19,136
16,15,19,19,5,19,19,9,15,136
16,15,19,19,5,19,19,15,18,145
16,15,19,19,5,20,0,0,0,94
16,15,19,19,5,20,19,0,0,113
16,15,19,19,25,0,0,0,0,94
16,15,19,19,9,2,9,12,5,106
16,15,19,19,9,2,12,5,0,97
16,15,19,19,9,2,12,5,18,115
16,15,19,19,9,2,12,5,19,116
16,15,19,19,9,2,12,25,0,117
16,15,19,19,9,5,0,0,0,83
16,15,19,19,9,5,19,0,0,102
16,15,19,19,15,4,9,5,0,102
16,15,19,19,21,13,0,0,0,103
16,15,19,19,21,13,8,1,23,135
16,15,19,19,21,13,19,0,0,122
16,15,19,20,1,2,12,5,0,90
16,15,19,20,1,3,20,0,0,94
16,15,19,20,1,7,5,0,0,83
16,15,19,20,1,7,5,19,0,102
16,15,19,20,1,12,0,0,0,83
16,15,19,20,1,12,12,25,0,120
16,15,19,20,1,12,19,0,0,102
16,15,19,20,1,13,5,14,20,123
16,15,19,20,1,14,1,12,0,98
16,15,19,20,1,24,9,1,4,109
16,15,19,20,1,24,9,1,12,117
16,15,19,20,2,1,7,0,0,80
16,15,19,20,2,1,7,19,0,99
16,15,19,20,2,1,19,5,0,97
16,15,19,20,2,15,25,0,0,112
16,15,19,20,2,15,25,19,0,131
16,15,19,20,2,15,15,11,0,113
16,15,19,20,2,15,24,0,0,111
16,15,19,20,2,15,24,5,19,135
16,15,19,20,2,21,18,14,0,125
16,15,19,20,3,1,18,4,0,96
16,15,19,20,3,1,18,4,19,115
16,15,19,20,3,1,18,20,0,112
16,15,19,20,3,1,22,1,0,97
16,15,19,20,3,1,22,1,5,102
16,15,19,20,3,1,22,1,12,109
16,15,19,20,3,5,3,1,12,94
16,15,19,20,3,5,14,1,12,105
16,15,19,20,3,9,2,1,12,97
16,15,19,20,3,15,4,5,0,97
16,15,19,20,3,15,12,15,14,129
16,15,19,20,3,15,18,14,21,141
16,15,19,20,3,15,21,16,0,125
16,15,19,20,3,15,24,1,12,125
16,15,19,20,4,1,20,5,0,100
16,15,19,20,4,1,20,5,4,104
16,15,19,20,4,1,20,5,19,119
16,15,19,20,4,9,22,5,0,110
16,15,19,20,4,18,21,7,0,120
16,15,19,20,4,21,18,1,12,126
16,15,19,20,5,1,0,0,0,76
16,15,19,20,5,4,0,0,0,79
16,15,19,20,5,5,14,0,0,94
16,15,19,20,5,5,14,19,0,113
16,15,19,20,5,12,0,0,0,87
16,15,19,20,5,14,20,18,25,152
16,15,19,20,5,18,0,0,0,93
16,15,19,20,5,18,9,1,4,107
16,15,19,20,5,18,9,1,12,115
16,15,19,20,5,18,9,15,18,135
16,15,19,20,5,18,9,19,8,129
16,15,19,20,5,18,9,19,20,141
16,15,19,20,5,18,9,20,25,147
16,15,19,20,5,18,9,26,5,133
16,15,19,20,5,18,14,0,0,107
16,15,19,20,5,18,14,19,0,126
16,15,19,20,5,18,19,0,0,112
16,15,19,20,5,24,9,19,20,147
16,15,19,20,6,1,3,5,0,85
16,15,19,20,6,1,3,5,19,104
16,15,19,20,6,1,3,20,0,100
16,15,19,20,6,5,20,1,12,114
16,15,19,20,6,9,24,0,0,109
16,15,19,20,6,9,24,1,12,122
16,15,19,20,6,9,24,5,4,118
16,15,19,20,6,9,24,5,19,133
16,15,19,20,6,15,18,13,0,122
16,15,19,20,6,15,18,13,19,141
16,15,19,20,6,21,18,3,1,119
16,15,19,20,7,1,13,5,0,96
16,15,19,20,8,1,2,9,20,110
16,15,19,20,8,1,19,20,5,123
16,15,19,20,8,5,1,20,0,104
16,15,19,20,8,25,15,9,4,131
16,15,19,20,8,9,20,9,19,135
16,15,19,20,8,15,3,0,0,96
16,15,19,20,8,15,12,5,0,110
16,15,19,20,8,15,12,5,19,129
16,15,19,20,8,15,21,19,5,138
16,15,19,20,8,21,13,1,0,113
16,15,19,20,8,21,13,5,0,117
16,15,19,20,8,21,13,21,19,152
16,15,19,20,25,1,18,4,0,118
16,15,19,20,9,3,0,0,0,82
16,15,19,20,9,3,1,12,0,95
16,15,19,20,9,3,8,5,0,95
16,15,19,20,9,3,8,5,19,114
16,15,19,20,9,3,15,21,19,137
16,15,19,20,9,3,21,13,0,116
16,15,19,20,9,3,21,19,0,122
16,15,19,20,9,5,0,0,0,84
16,15,19,20,9,12,0,0,0,91
16,15,19,20,9,12,5,18,0,114
16,15,19,20,9,12,9,15,14,129
16,15,19,20,9,12,12,5,18,126
16,15,19,20,9,12,19,0,0,110
16,15,19,20,9,14,0,0,0,93
16,15,19,20,9,14,7,0,0,100
16,15,19,20,9,14,7,12,25,137
16,15,19,20,9,14,7,19,0,119
16,15,19,20,9,14,19,0,0,112
16,15,19,20,9,17,21,5,0,122
16,15,19,20,9,17,21,5,19,141
16,15,19,20,12,5,7,1,12,107
16,15,19,20,12,5,19,19,0,125
16,15,19,20,12,9,11,5,0,107
16,15,19,20,12,15,18,1,12,128
16,15,19,20,12,21,4,5,0,112
16,15,19,20,12,21,4,5,19,131
16,15,19,20,13,1,18,11,0,113
16,15,19,20,13,1,18,11,19,132
16,15,19,20,13,5,4,9,1,102
16,15,19,20,13,5,14,0,0,102
16,15,19,20,14,1,18,9,19,131
16,15,19,20,14,1,19,1,12,117
16,15,19,20,14,1,20,1,12,118
16,15,19,20,14,1,20,5,0,110
16,15,19,20,14,1,20,9,0,114
16,15,19,20,14,1,20,21,19,145
16,15,19,20,14,15,4,1,12,116
16,15,19,20,14,15,20,1,0,120
16,15,19,20,14,15,20,21,13,153
16,15,19,20,15,16,20,9,3,133
16,15,19,20,15,18,1,12,0,116
16,15,19,20,15,18,4,5,18,130
16,15,19,20,15,20,9,3,0,117
16,15,19,20,16,1,7,1,14,109
16,15,19,20,16,1,9,4,0,100
16,15,19,20,16,12,1,3,5,107
16,15,19,20,16,15,14,5,0,120
16,15,19,20,16,15,14,5,4,124
16,15,19,20,16,15,14,5,18,138
16,15,19,20,16,15,14,5,19,139
16,15,19,20,16,15,19,5,0,125
16,15,19,20,16,15,19,9,20,149
16,15,19,20,16,21,2,9,3,121
16,15,19,20,16,21,2,9,19,137
16,15,19,20,18,1,3,5,0,97
16,15,19,20,18,1,13,21,19,142
16,15,19,20,18,5,14,1,12,120
16,15,19,20,18,9,4,5,18,124
16,15,19,20,18,9,15,20,0,132
16,15,19,20,18,15,18,19,5,145
16,15,19,20,19,0,0,0,0,89
16,15,19,20,19,9,7,14,0,119
16,15,19,20,19,25,14,3,0,131
16,15,19,20,20,5,5,14,0,114
16,15,19,20,20,5,19,20,0,134
16,15,19,20,20,5,19,20,19,153
16,15,19,20,20,15,14,9,3,131
16,15,19,20,20,15,24,9,3,141
16,15,19,20,20,18,9,1,12,130
16,15,19,20,21,12,1,14,20,138
16,15,19,20,21,12,1,20,1,125
16,15,19,20,21,12,1,20,5,129
16,15,19,20,21,12,14,1,18,136
16,15,19,20,21,18,1,12,0,122
16,15,19,20,21,18,5,0,0,114
16,15,19,20,21,18,5,4,0,118
16,15,19,20,21,18,5,18,0,132
16,15,19,20,21,18,5,18,19,151
16,15,19,20,21,18,5,19,0,133
16,15,19,20,21,18,9,14,7,139
16,15,19,20,21,18,9,19,5,142
16,15,19,20,21,18,9,19,20,157
16,15,19,20,21,18,9,26,5,149
16,15,19,20,22,5,12,1,18,128
16,15,19,20,22,9,4,5,0,110
16,15,19,20,23,1,18,0,0,112
16,15,19,20,23,1,18,4,0,116
16,15,19,20,23,9,19,5,0,126
16,15,19,20,23,15,13,1,14,136
16,15,19,20,23,15,13,5,14,140
16,15,20,0,0,0,0,0,0,51
16,15,20,1,2,12,5,0,0,71
16,15,20,1,2,12,5,19,0,90
16,15,20,1,7,5,0,0,0,64
16,15,20,1,7,5,18,0,0,82
16,15,20,1,7,5,18,5,0,87
16,15,20,1,7,5,18,25,0,107
16,15,20,1,7,5,18,9,5,96
16,15,20,1,7,5,19,0,0,83
16,15,20,1,9,12,0,0,0,73
16,15,20,1,13,9,1,14,0,89
16,15,20,1,13,9,3,0,0,77
16,15,20,1,14,3,5,0,0,74
16,15,20,1,19,8,5,18,25,127
16,15,20,1,19,8,5,19,0,103
16,15,20,1,19,19,0,0,0,90
16,15,20,1,19,19,1,0,0,91
16,15,20,1,19,19,9,3,0,102
16,15,20,1,19,19,9,21,13,133
16,15,20,1,20,5,0,0,0,77
16,15,20,1,20,9,15,14,0,110
16,15,20,1,20,9,15,14,19,129
16,15,20,1,20,9,22,5,0,108
16,15,20,1,20,15,0,0,0,87
16,15,20,1,20,15,5,19,0,111
16,15,20,1,20,15,18,0,0,105
16,15,20,1,20,15,18,25,0,130
16,15,20,2,1,14,11,0,0,79
16,15,20,2,5,12,12,25,0,107
16,15,20,2,15,25,0,0,0,93
16,15,20,2,15,25,4,15,13,125
16,15,20,2,15,9,12,0,0,89
16,15,20,2,15,9,12,5,4,98
16,15,20,2,15,9,12,5,18,112
16,15,20,2,15,9,12,19,0,108
16,15,20,2,15,25,19,0,0,112
16,15,20,3,8,0,0,0,0,62
16,15,20,3,8,5,18,0,0,85
16,15,20,3,18,15,15,11,0,113
16,15,20,4,1,18,0,0,0,74
16,15,20,5,0,0,0,0,0,56
16,15,20,5,3,1,18,25,0,103
16,15,20,5,5,14,0,0,0,75
16,15,20,5,5,14,19,0,0,94
16,15,20,5,25,5,0,0,0,86
16,15,20,5,14,3,5,0,0,78
16,15,20,5,14,3,5,19,0,97
16,15,20,5,14,3,25,0,0,98
16,15,20,5,14,3,9,5,19,106
16,15,20,5,14,20,0,0,0,90
16,15,20,5,14,20,1,3,25,119
16,15,20,5,14,20,1,20,5,116
16,15,20,5,14,20,5,5,0,100
16,15,20,5,14,20,25,0,0,115
16,15,20,5,14,20,9,1,12,112
16,15,20,5,14,20,9,5,19,123
16,15,20,5,14,20,9,26,5,130
16,15,20,5,14,20,12,25,0,127
16,15,20,5,18,0,0,0,0,74
16,15,20,5,19,20,1,12,0,108
16,15,20,5,19,20,1,19,0,115
16,15,20,5,19,20,1,20,5,121
16,15,20,6,21,12,0,0,0,90
16,15,20,6,21,12,19,0,0,109
16,15,20,7,9,18,12,0,0,97
16,15,20,7,21,14,0,0,0,93
16,15,20,7,21,20,0,0,0,99
16,15,20,8,1,14,7,5,18,104
16,15,20,8,5,1,4,0,0,69
16,15,20,8,5,1,4,19,0,88
16,15,20,8,5,3,1,18,25,111
16,15,20,8,5,5,14,0,0,83
16,15,20,8,5,5,14,19,0,102
16,15,20,8,5,18,0,0,0,82
16,15,20,8,5,18,2,0,0,84
16,15,20,8,5,18,2,19,0,103
16,15,20,8,5,18,5,4,0,91
16,15,20,8,5,18,25,0,0,107
16,15,20,8,5,18,9,14,7,112
16,15,20,8,5,18,19,0,0,101
16,15,20,8,15,12,4,5,18,113
16,15,20,8,15,12,5,0,0,91
16,15,20,8,15,12,5,4,0,95
16,15,20,8,15,12,5,18,0,109
16,15,20,8,15,12,5,19,0,110
16,15,20,8,15,12,9,14,7,116
16,15,20,8,15,15,11,0,0,100
16,15,20,8,15,15,11,19,0,119
16,15,20,8,15,21,19,5,0,119
16,15,20,8,15,21,19,5,25,144
16,15,20,8,15,21,19,5,19,138
16,15,20,8,21,14,20,0,0,114
16,15,20,8,21,14,20,5,4,123
16,15,20,8,21,14,20,5,18,137
16,15,20,9,0,0,0,0,0,60
16,15,20,9,3,1,18,25,0,107
16,15,20,25,3,1,18,25,0,123
16,15,20,9,3,8,5,0,0,76
16,15,20,9,3,8,5,19,0,95
16,15,20,9,6,5,18,0,0,89
16,15,20,9,15,14,0,0,0,89
16,15,20,9,15,14,19,0,0,108
16,15,20,12,1,3,8,0,0,75
16,15,20,12,1,3,8,5,0,80
16,15,20,12,1,3,8,5,19,99
16,15,20,12,1,20,3,8,0,95
16,15,20,12,5,7,0,0,0,75
16,15,20,12,9,3,11,5,18,109
16,15,20,12,9,4,0,0,0,76
16,15,20,12,9,11,5,0,0,88
16,15,20,12,9,11,11,5,18,117
16,15,20,12,9,14,5,0,0,91
16,15,20,12,9,14,5,19,0,110
16,15,20,12,9,14,7,0,0,93
16,15,20,12,21,3,11,0,0,98
16,15,20,12,21,3,11,19,0,117
16,15,20,13,1,11,5,18,0,99
16,15,20,13,1,11,9,14,7,106
16,15,20,13,1,14,0,0,0,79
16,15,20,13,5,14,0,0,0,83
16,15,20,15,13,1,14,9,1,104
16,15,20,15,13,1,20,15,0,115
16,15,20,15,13,5,20,5,18,127
16,15,20,15,14,7,0,0,0,87
16,15,20,15,15,0,0,0,0,81
16,15,20,15,15,19,0,0,0,100
16,15,20,15,18,15,15,0,0,114
16,15,20,15,18,15,15,19,0,133
16,15,20,16,9,5,0,0,0,81
16,15,20,16,9,5,19,0,0,100
16,15,20,16,15,21,18,18,9,148
16,15,20,18,1,3,11,0,0,84
16,15,20,19,8,1,18,4,0,101
16,15,20,19,8,1,18,4,19,120
16,15,20,19,8,1,23,0,0,102
16,15,20,19,8,5,18,4,0,105
16,15,20,19,8,5,18,4,19,124
16,15,20,19,8,15,15,20,0,128
16,15,20,19,8,15,20,0,0,113
16,15,20,19,8,15,20,19,0,132
16,15,20,19,25,0,0,0,0,95
16,15,20,19,9,5,0,0,0,84
16,15,20,19,9,5,19,0,0,103
16,15,20,19,20,9,3,11,0,113
16,15,20,19,20,15,14,5,0,124
16,15,20,19,20,15,14,5,19,143
16,15,20,20,0,0,0,0,0,71
16,15,20,20,1,7,5,0,0,84
16,15,20,20,1,7,5,19,0,103
16,15,20,20,1,7,25,0,0,104
16,15,20,20,1,8,0,0,0,80
16,15,20,20,1,18,15,0,0,105
16,15,20,20,5,4,0,0,0,80
16,15,20,20,5,5,14,0,0,95
16,15,20,20,5,5,14,19,0,114
16,15,20,20,5,18,5,4,0,103
16,15,20,20,5,18,5,18,0,117
16,15,20,20,5,18,5,18,19,136
16,15,20,20,5,18,5,19,19,137
16,15,20,20,5,18,25,0,0,119
16,15,20,20,5,18,9,14,7,124
16,15,20,20,5,18,14,0,0,108
16,15,20,20,5,18,19,0,0,113
16,15,20,20,9,0,0,0,0,80
16,15,20,20,25,0,0,0,0,96
16,15,20,20,9,5,18,0,0,103
16,15,20,20,9,5,19,0,0,104
16,15,20,20,9,5,19,20,0,124
16,15,20,20,9,14,7,0,0,101
16,15,20,20,9,14,7,5,18,124
16,15,20,20,12,5,0,0,0,88
16,15,20,20,12,5,4,0,0,92
16,15,20,20,12,5,19,0,0,107
16,15,20,20,15,0,0,0,0,86
16,15,20,20,15,19,0,0,0,105
16,15,20,20,21,18,0,0,0,110
16,15,20,21,19,0,0,0,0,91
16,15,20,23,1,12,12,5,18,122
16,15,20,23,1,18,5,0,0,98
16,15,20,23,8,9,19,11,25,146
16,15,20,23,15,18,11,0,0,118
16,15,20,23,15,18,20,0,0,127
16,15,21,3,5,0,0,0,0,60
16,15,21,3,5,25,0,0,0,85
16,15,21,3,5,18,0,0,0,78
16,15,21,3,8,0,0,0,0,63
16,15,21,3,8,5,4,0,0,72
16,15,21,3,8,5,19,0,0,87
16,15,21,3,8,6,21,12,0,102
16,15,21,3,8,25,0,0,0,88
16,15,21,3,8,9,5,18,0,95
16,15,21,3,8,9,5,19,20,116
16,15,21,3,8,9,14,7,0,93
16,15,21,3,8,12,5,19,19,118
16,15,21,3,8,12,9,11,5,100
16,15,21,3,25,0,0,0,0,80
16,15,21,4,18,5,20,0,0,99
16,15,21,4,18,5,20,20,5,124
16,15,21,4,18,5,21,19,5,124
16,15,21,4,18,9,14,0,0,97
16,15,21,6,0,0,0,0,0,58
16,15,21,6,5,4,0,0,0,67
16,15,21,6,6,0,0,0,0,64
16,15,21,6,6,5,0,0,0,69
16,15,21,6,6,5,4,0,0,73
16,15,21,6,6,5,19,0,0,88
16,15,21,6,6,19,0,0,0,83
16,15,21,6,19,0,0,0,0,77
16,15,21,12,1,9,14,5,0,93
16,15,21,12,1,18,4,0,0,87
16,15,21,12,1,18,4,5,0,92
16,15,21,12,1,18,4,5,19,111
16,15,21,12,1,18,4,19,0,106
16,15,21,12,4,18,15,14,0,115
16,15,21,12,5,0,0,0,0,69
16,15,21,12,5,20,0,0,0,89
16,15,21,12,5,20,20,5,0,114
16,15,21,12,16,0,0,0,0,80
16,15,21,12,16,5,0,0,0,85
16,15,21,12,20,0,0,0,0,84
16,15,21,12,20,5,18,5,18,130
16,15,21,12,20,5,18,19,0,126
16,15,21,12,20,9,3,5,0,101
16,15,21,12,20,9,3,5,4,105
16,15,21,12,20,9,3,5,19,120
16,15,21,12,20,18,25,0,0,127
16,15,21,12,20,18,9,5,19,135
16,15,21,12,20,19,0,0,0,103
16,15,21,14,1,13,21,0,0,101
16,15,21,14,3,5,0,0,0,74
16,15,21,14,3,5,4,0,0,78
16,15,21,14,3,5,18,0,0,92
16,15,21,14,3,5,18,19,0,111
16,15,21,14,3,5,19,0,0,93
16,15,21,14,3,5,20,0,0,94
16,15,21,14,3,25,0,0,0,94
16,15,21,14,3,9,14,7,0,99
16,15,21,14,4,1,7,5,0,83
16,15,21,14,4,1,7,5,19,102
16,15,21,14,4,1,12,0,0,83
16,15,21,14,4,1,12,19,0,102
16,15,21,14,4,3,1,11,5,90
16,15,21,14,4,5,4,0,0,79
16,15,21,14,4,5,18,0,0,93
16,15,21,14,4,5,18,19,0,112
16,15,21,14,4,9,14,7,0,100
16,15,21,14,4,12,5,19,19,125
16,15,21,14,4,12,9,11,5,107
16,15,21,14,4,13,1,14,0,98
16,15,21,14,4,13,5,1,12,101
16,15,21,14,4,19,0,0,0,89
16,15,21,18,0,0,0,0,0,70
16,15,21,18,1,2,12,5,0,90
16,15,21,18,2,15,9,18,5,119
16,15,21,18,5,4,0,0,0,79
16,15,21,18,5,18,0,0,0,93
16,15,21,18,5,18,19,0,0,112
16,15,21,18,9,5,0,0,0,84
16,15,21,18,9,14,7,0,0,100
16,15,21,18,9,14,7,12,25,137
16,15,21,18,16,1,18,20,25,150
16,15,21,18,16,9,5,3,5,108
16,15,21,18,16,15,9,14,20,144
16,15,21,18,16,18,9,19,5,137
16,15,21,18,17,21,15,9,0,132
16,15,21,18,18,9,19,0,0,116
16,15,21,18,19,0,0,0,0,89
16,15,21,18,22,5,20,5,0,122
16,15,21,19,5,18,0,0,0,94
16,15,21,19,25,0,0,0,0,96
16,15,21,19,19,5,0,0,0,95
16,15,21,19,19,5,20,20,5,140
16,15,21,19,19,9,5,0,0,104
16,15,21,19,19,9,5,19,0,123
16,15,21,19,20,9,5,0,0,105
16,15,21,20,0,0,0,0,0,72
16,15,21,20,5,4,0,0,0,81
16,15,21,20,5,18,0,0,0,95
16,15,21,20,5,18,19,0,0,114
16,15,21,20,6,21,12,0,0,111
16,15,21,20,25,0,0,0,0,97
16,15,21,20,9,5,18,0,0,104
16,15,21,20,9,5,19,20,0,125
16,15,21,20,9,14,7,0,0,102
16,15,21,20,9,14,7,12,25,139
16,15,21,20,19,0,0,0,0,91
16,15,22,5,18,9,19,8,0,112
16,15,22,5,18,20,25,0,0,121
16,15,22,5,18,20,9,5,19,129
16,15,23,1,14,0,0,0,0,69
16,15,23,3,1,20,0,0,0,78
16,15,23,4,5,18,5,4,0,90
16,15,23,4,5,18,5,18,0,104
16,15,23,4,5,18,5,18,19,123
16,15,23,4,5,18,25,0,0,106
16,15,23,4,5,18,9,5,19,114
16,15,23,4,5,18,9,14,7,111
16,15,23,4,5,18,9,26,5,121
16,15,23,4,5,18,13,1,14,109
16,15,23,4,5,18,19,0,0,100
16,15,23,4,9,11,5,0,0,83
16,15,23,4,18,25,0,0,0,101
16,15,23,5,12,12,9,20,5,117
16,15,23,5,18,1,2,12,5,97
16,15,23,5,18,1,2,12,25,117
16,15,23,5,18,2,15,1,20,115
16,15,23,5,18,5,4,0,0,86
16,15,23,5,18,6,21,12,0,116
16,15,23,5,18,9,14,7,0,107
16,15,23,5,18,12,5,19,19,132
16,15,23,5,18,19,5,20,0,121
16,15,23,5,18,19,5,20,19,140
16,15,23,5,18,19,20,1,20,137
16,15,23,8,5,1,4,0,0,72
16,15,23,9,20,3,8,0,0,94
16,15,23,12,4,15,15,4,25,129
16,15,23,14,25,0,0,0,0,93
16,15,23,14,9,5,0,0,0,82
16,15,23,19,0,0,0,0,0,73
16,15,23,19,15,4,4,25,0,121
16,15,23,19,15,23,4,25,0,140
16,15,23,20,5,18,0,0,0,97
16,15,23,20,5,18,19,0,0,116
16,15,23,23,15,23,0,0,0,115
16,15,23,23,15,23,5,4,0,124
16,15,23,23,15,23,5,18,0,138
16,15,23,23,15,23,9,14,7,145
16,15,23,23,15,23,9,19,13,156
16,15,23,23,15,23,19,0,0,134
16,15,24,0,0,0,0,0,0,55
16,15,24,5,4,0,0,0,0,64
16,15,24,5,19,0,0,0,0,79
16,15,24,25,0,0,0,0,0,80
16,15,24,9,14,7,0,0,0,85
16,15,24,22,9,18,21,19,0,144
16,15,26,0,0,0,0,0,0,57
16,15,26,26,15,12,1,14,0,125
16,15,26,26,15,12,1,14,1,126
16,15,26,26,15,12,1,14,19,144
16,16,8,0,0,0,0,0,0,40
16,16,12,0,0,0,0,0,0,44
16,16,18,0,0,0,0,0,0,50
16,16,20,14,0,0,0,0,0,66
16,18,5,1,2,19,15,18,2,96
16,18,5,1,3,3,5,16,20,87
16,18,5,1,3,3,5,19,19,89
16,18,5,1,3,3,15,18,4,83
16,18,5,1,3,3,21,19,5,91
16,18,5,1,3,5,0,0,0,48
16,18,5,1,3,8,0,0,0,51
16,18,5,1,3,8,5,4,0,60
16,18,5,1,3,8,5,18,19,93
16,18,5,1,3,8,5,19,0,75
16,18,5,1,3,8,25,0,0,76
16,18,5,1,3,8,9,5,18,83
16,18,5,1,3,8,9,6,25,91
16,18,5,1,3,8,9,12,25,97
16,18,5,1,3,8,9,14,7,81
16,18,5,1,3,8,13,1,14,79
16,18,5,1,3,9,4,0,0,56
16,18,5,1,3,9,4,12,25,93
16,18,5,1,3,14,5,19,19,100
16,18,5,1,3,17,21,9,20,110
16,18,5,1,3,20,0,0,0,63
16,18,5,1,3,20,5,4,0,72
16,18,5,1,3,20,9,14,7,93
16,18,5,1,3,20,9,15,14,101
16,18,5,1,3,20,9,22,5,99
16,18,5,1,3,20,19,0,0,82
16,18,5,1,3,21,20,5,0,89
16,18,5,1,4,1,13,9,3,70
16,18,5,1,4,1,16,20,0,81
16,18,5,1,4,1,16,20,19,100
16,18,5,1,4,8,5,18,5,80
16,18,5,1,4,10,21,19,20,114
16,18,5,1,4,13,9,18,5,89
16,18,5,1,4,13,9,20,0,86
16,18,5,1,4,13,9,20,19,105
16,18,5,1,4,15,16,20,0,95
16,18,5,1,4,15,16,20,19,114
16,18,5,1,4,15,18,5,0,82
16,18,5,1,4,15,18,14,0,91
16,18,5,1,4,21,12,20,0,97
16,18,5,1,4,21,12,20,19,116
16,18,5,1,4,22,9,3,5,83
16,18,5,1,4,22,9,19,5,99
16,18,5,1,6,6,5,3,20,80
16,18,5,1,6,6,9,18,13,92
16,18,5,1,7,5,0,0,0,52
16,18,5,1,7,5,4,0,0,56
16,18,5,1,7,9,14,7,0,77
16,18,5,1,7,15,14,1,12,89
16,18,5,1,7,15,14,25,0,101
16,18,5,1,7,18,5,5,0,75
16,18,5,1,7,18,5,5,4,79
16,18,5,1,12,1,18,13,0,84
16,18,5,1,12,12,5,7,5,81
16,18,5,1,12,12,25,0,0,89
16,18,5,1,12,12,9,5,4,82
16,18,5,1,12,12,9,5,19,97
16,18,5,1,12,12,15,20,0,99
16,18,5,1,12,12,15,20,19,118
16,18,5,1,12,12,15,23,0,102
16,18,5,1,12,12,21,4,5,94
16,18,5,1,12,20,1,18,0,91
16,18,5,1,12,20,5,18,0,95
16,18,5,1,13,2,12,5,0,72
16,18,5,1,13,2,12,5,4,76
16,18,5,1,13,2,12,5,19,91
16,18,5,1,13,16,0,0,0,69
16,18,5,1,13,16,19,0,0,88
16,18,5,1,14,1,12,0,0,67
16,18,5,1,14,14,5,24,0,97
16,18,5,1,15,18,20,9,3,105
16,18,5,1,16,16,12,25,0,109
16,18,5,1,18,13,0,0,0,71
16,18,5,1,18,13,5,4,0,80
16,18,5,1,18,13,9,14,7,101
16,18,5,1,18,13,19,0,0,90
16,18,5,1,18,18,5,19,20,120
16,18,5,1,19,19,5,18,20,121
16,18,5,1,19,19,9,7,14,108
16,18,5,1,19,19,21,13,5,117
16,18,5,1,19,19,21,18,5,122
16,18,5,1,20,1,24,9,3,97
16,18,5,1,20,15,13,9,3,100
16,18,5,1,20,20,21,14,5,120
16,18,5,1,21,4,9,20,0,94
16,18,5,1,22,5,18,0,0,85
16,18,5,1,22,5,18,19,0,104
16,18,5,1,22,15,23,1,12,113
16,18,5,1,24,9,1,4,0,78
16,18,5,1,24,9,1,12,0,86
16,18,5,2,1,4,5,0,0,51
16,18,5,2,1,11,5,0,0,58
16,18,5,2,1,12,12,15,20,101
16,18,5,2,1,19,1,12,0,74
16,18,5,2,1,20,20,12,5,99
16,18,5,2,2,12,5,0,0,60
16,18,5,2,5,12,5,22,5,90
16,18,5,2,5,12,9,5,6,78
16,18,5,2,5,12,12,21,13,104
16,18,5,2,5,14,4,0,0,64
16,18,5,2,5,14,4,1,12,77
16,18,5,2,5,14,4,19,0,83
16,18,5,2,5,19,5,20,0,90
16,18,5,2,5,19,20,15,23,123
16,18,5,2,5,20,18,1,25,110
16,18,5,2,9,4,0,0,0,54
16,18,5,2,9,12,12,0,0,74
16,18,5,2,9,12,12,5,4,83
16,18,5,2,9,12,12,19,0,93
16,18,5,2,9,14,4,0,0,68
16,18,5,2,9,14,4,19,0,87
16,18,5,2,9,15,20,9,3,97
16,18,5,2,12,5,19,19,0,96
16,18,5,2,15,1,19,20,0,96
16,18,5,2,15,4,9,14,7,90
16,18,5,2,15,9,12,0,0,77
16,18,5,2,15,9,12,5,4,86
16,18,5,2,15,9,12,19,0,96
16,18,5,2,15,15,13,0,0,84
16,18,5,2,15,18,14,0,0,88
16,18,5,2,15,21,14,4,0,95
16,18,5,2,18,9,4,1,12,85
16,18,5,2,18,15,14,26,5,119
16,18,5,2,18,21,20,5,0,105
16,18,5,2,21,3,3,1,12,81
16,18,5,2,21,4,7,5,20,98
16,18,5,2,21,18,14,0,0,94
16,18,5,3,0,0,0,0,0,42
16,18,5,3,1,14,3,5,12,77
16,18,5,3,1,14,20,0,0,77
16,18,5,3,1,18,25,0,0,86
16,18,5,3,1,18,9,1,0,71
16,18,5,3,1,18,9,21,13,104
16,18,5,3,1,19,20,0,0,82
16,18,5,3,1,19,20,19,0,101
16,18,5,3,1,20,9,15,14,101
16,18,5,3,1,20,9,22,5,99
16,18,5,3,1,20,15,18,25,121
16,18,5,3,1,21,4,1,12,81
16,18,5,3,1,22,1,0,0,66
16,18,5,3,1,22,1,5,0,71
16,18,5,3,1,22,1,12,0,78
16,18,5,3,3,8,15,19,5,92
16,18,5,3,5,4,5,0,0,56
16,18,5,3,5,4,5,4,0,60
16,18,5,3,5,4,5,14,20,90
16,18,5,3,5,4,5,18,0,74
16,18,5,3,5,4,5,19,0,75
16,18,5,3,5,4,9,14,7,81
16,18,5,3,5,4,14,3,5,73
16,18,5,3,5,12,0,0,0,59
16,18,5,3,5,14,19,15,18,113
16,18,5,3,5,14,19,21,19,120
16,18,5,3,5,14,20,0,0,81
16,18,5,3,5,14,20,5,4,90
16,18,5,3,5,14,20,15,18,114
16,18,5,3,5,14,20,19,0,100
16,18,5,3,5,16,20,0,0,83
16,18,5,3,5,16,20,15,18,116
16,18,5,3,5,16,20,19,0,102
16,18,5,3,5,19,0,0,0,66
16,18,5,3,5,19,19,0,0,85
16,18,5,3,5,19,19,5,4,94
16,18,5,3,5,19,19,5,19,109
16,18,5,3,8,1,18,7,5,81
16,18,5,3,8,1,18,20,0,89
16,18,5,3,8,5,3,11,0,69
16,18,5,3,8,5,3,11,19,88
16,18,5,3,8,9,12,12,0,83
16,18,5,3,8,9,12,12,19,102
16,18,5,3,8,15,9,3,5,82
16,18,5,3,8,15,15,19,5,104
16,18,5,3,8,15,19,5,0,89
16,18,5,3,8,15,19,5,14,103
16,18,5,3,9,4,5,0,0,60
16,18,5,3,9,5,21,19,5,101
16,18,5,3,9,5,21,24,0,101
16,18,5,3,9,14,3,20,0,88
16,18,5,3,9,14,3,20,19,107
16,18,5,3,9,15,21,19,0,106
16,18,5,3,9,16,5,0,0,72
16,18,5,3,9,16,5,19,0,91
16,18,5,3,9,16,9,3,5,84
16,18,5,3,9,19,0,0,0,70
16,18,5,3,9,19,5,0,0,75
16,18,5,3,9,19,5,4,0,79
16,18,5,3,9,19,5,12,25,112
16,18,5,3,9,19,5,18,0,93
16,18,5,3,9,19,5,19,0,94
16,18,5,3,9,19,5,19,20,114
16,18,5,3,9,19,9,1,14,94
16,18,5,3,9,19,9,14,7,100
16,18,5,3,9,19,9,15,14,108
16,18,5,3,9,19,9,22,5,106
16,18,5,3,9,19,15,0,0,85
16,18,5,3,25,19,20,0,0,106
16,18,5,3,25,19,20,9,3,118
16,18,5,3,9,20,5,0,0,76
16,18,5,3,9,20,5,4,0,80
16,18,5,3,9,20,9,14,7,101
16,18,5,3,12,1,9,13,0,77
16,18,5,3,12,1,18,5,0,78
16,18,5,3,12,5,1,14,0,74
16,18,5,3,12,5,1,14,19,93
16,18,5,3,12,5,1,18,0,78
16,18,5,3,12,9,13,1,24,101
16,18,5,3,12,9,22,1,12,98
16,18,5,3,12,15,19,5,0,93
16,18,5,3,12,15,19,5,4,97
16,18,5,3,12,15,20,8,5,102
16,18,5,3,12,21,4,5,0,84
16,18,5,3,12,21,4,5,4,88
16,18,5,3,12,21,4,5,19,103
16,18,5,3,15,3,5,0,0,65
16,18,5,3,15,3,9,1,12,82
16,18,5,3,15,3,9,20,25,114
16,18,5,3,15,4,5,0,0,66
16,18,5,3,15,4,5,4,0,70
16,18,5,3,15,4,5,19,0,85
16,18,5,3,15,9,12,0,0,78
16,18,5,3,15,9,12,5,18,101
16,18,5,3,15,12,15,18,0,102
16,18,5,3,15,12,15,21,18,123
16,18,5,3,15,13,2,1,20,93
16,18,5,3,15,13,13,9,20,112
16,18,5,3,15,13,16,5,12,103
16,18,5,3,15,14,3,21,18,113
16,18,5,3,15,14,6,5,18,100
16,18,5,3,15,14,25,0,0,96
16,18,5,3,15,14,9,19,5,104
16,18,5,3,15,14,9,26,5,111
16,18,5,3,15,14,22,5,25,123
16,18,5,3,15,15,11,0,0,83
16,18,5,3,15,15,11,5,4,92
16,18,5,3,15,15,11,5,18,106
16,18,5,3,15,15,11,19,0,102
16,18,5,3,15,15,12,0,0,84
16,18,5,3,15,15,12,5,4,93
16,18,5,3,15,15,12,5,18,107
16,18,5,3,15,15,12,19,0,103
16,18,5,3,15,16,25,0,0,98
16,18,5,3,15,16,9,5,4,91
16,18,5,3,15,18,4,9,1,89
16,18,5,3,15,18,14,21,0,110
16,18,5,3,15,19,13,9,3,101
16,18,5,3,15,19,20,1,12,109
16,18,5,3,15,21,16,0,0,94
16,18,5,3,15,21,18,19,5,120
16,18,5,3,15,22,5,18,0,102
16,18,5,3,15,24,0,0,0,81
16,18,5,3,18,1,19,8,0,88
16,18,5,3,18,5,1,20,5,91
16,18,5,3,18,5,4,9,20,98
16,18,5,3,18,5,5,4,0,74
16,18,5,3,18,21,18,1,12,112
16,18,5,3,21,12,5,0,0,80
16,18,5,3,21,14,5,1,12,95
16,18,5,3,21,14,5,21,19,122
16,18,5,3,21,18,5,0,0,86
16,18,5,3,21,18,5,4,0,90
16,18,5,3,21,18,5,19,0,105
16,18,5,3,21,18,9,14,7,111
16,18,5,3,21,18,18,5,18,122
16,18,5,3,21,18,19,1,12,113
16,18,5,3,21,18,19,5,0,105
16,18,5,3,21,18,19,15,18,133
16,18,5,3,21,20,0,0,0,83
16,18,5,3,21,20,19,0,0,102
16,18,5,4,0,0,0,0,0,43
16,18,5,4,1,2,12,5,0,63
16,18,5,4,1,3,5,1,14,67
16,18,5,4,1,3,9,20,25,101
16,18,5,4,1,25,0,0,0,69
16,18,5,4,1,13,1,7,5,70
16,18,5,4,1,13,14,0,0,71
16,18,5,4,1,18,11,0,0,73
16,18,5,4,1,20,1,0,0,65
16,18,5,4,1,20,5,0,0,69
16,18,5,4,1,20,5,4,0,73
16,18,5,4,1,20,5,19,0,88
16,18,5,4,1,20,9,14,7,94
16,18,5,4,1,20,9,15,14,102
16,18,5,4,1,20,9,19,13,105
16,18,5,4,1,20,9,22,5,100
16,18,5,4,1,20,15,18,0,97
16,18,5,4,1,20,15,18,25,122
16,18,5,4,1,20,15,18,19,116
16,18,5,4,1,23,14,0,0,81
16,18,5,4,1,23,14,19,0,100
16,18,5,4,5,1,12,5,18,84
16,18,5,4,5,1,20,8,0,77
16,18,5,4,5,2,1,20,5,76
16,18,5,4,5,2,9,20,0,79
16,18,5,4,5,2,20,15,18,103
16,18,5,4,5,3,1,25,0,77
16,18,5,4,5,3,5,19,19,94
16,18,5,4,5,3,9,4,5,69
16,18,5,4,5,3,18,5,5,79
16,18,5,4,5,4,21,3,20,96
16,18,5,4,5,6,5,1,20,80
16,18,5,4,5,6,5,3,20,82
16,18,5,4,5,6,5,14,4,77
16,18,5,4,5,6,25,0,0,79
16,18,5,4,5,6,9,5,4,72
16,18,5,4,5,6,9,14,5,82
16,18,5,4,5,6,18,1,25,98
16,18,5,4,5,7,18,5,5,83
16,18,5,4,5,12,1,25,0,86
16,18,5,4,5,12,12,1,0,73
16,18,5,4,5,12,12,5,0,77
16,18,5,4,5,12,21,4,5,90
16,18,5,4,5,13,1,14,4,80
16,18,5,4,5,14,25,0,0,87
16,18,5,4,5,14,9,1,12,84
16,18,5,4,5,14,9,5,4,80
16,18,5,4,5,14,20,1,12,95
16,18,5,4,5,16,1,18,20,103
16,18,5,4,5,18,9,22,5,102
16,18,5,4,5,19,5,18,20,110
16,18,5,4,5,19,9,7,14,97
16,18,5,4,5,20,1,3,8,80
16,18,5,4,5,20,1,9,12,90
16,18,5,4,5,20,1,9,14,92
16,18,5,4,5,20,5,3,20,96
16,18,5,4,5,20,5,19,20,112
16,18,5,4,5,22,9,19,5,103
16,18,5,4,5,22,15,20,5,110
16,18,5,4,5,22,15,21,18,124
16,18,5,4,25,0,0,0,0,68
16,18,5,4,9,1,12,0,0,65
16,18,5,4,9,3,1,14,20,90
16,18,5,4,9,3,1,20,5,81
16,18,5,4,9,3,20,0,0,75
16,18,5,4,9,3,20,5,4,84
16,18,5,4,9,3,20,15,18,108
16,18,5,4,9,3,20,19,0,94
16,18,5,4,9,5,20,0,0,77
16,18,5,4,9,7,5,19,20,103
16,18,5,4,9,11,1,14,20,98
16,18,5,4,9,12,5,3,20,92
16,18,5,4,9,14,5,0,0,71
16,18,5,4,9,14,5,4,0,75
16,18,5,4,9,14,9,14,7,96
16,18,5,4,9,14,14,5,18,103
16,18,5,4,9,18,5,3,20,98
16,18,5,4,9,22,5,0,0,79
16,18,5,4,9,22,5,18,20,117
16,18,5,4,9,22,9,4,5,92
16,18,5,4,15,14,1,20,5,98
16,18,5,4,15,14,15,18,0,105
16,18,5,4,15,15,13,0,0,86
16,18,5,4,15,18,19,1,12,108
16,18,5,4,15,21,2,20,0,101
16,18,5,4,18,1,6,20,0,88
16,18,5,4,18,1,23,0,0,85
16,18,5,4,18,1,23,5,18,108
16,18,5,4,18,1,23,14,0,99
16,18,5,4,18,5,1,4,0,71
16,18,5,4,18,5,23,0,0,89
16,18,5,4,18,25,0,0,0,86
16,18,5,4,18,9,5,4,0,79
16,18,5,4,18,25,9,14,7,116
16,18,5,4,18,9,12,12,0,94
16,18,5,4,18,9,22,5,0,97
16,18,5,4,18,9,22,5,14,111
16,18,5,4,18,9,22,5,18,115
16,18,5,4,18,15,22,5,0,103
16,18,5,4,21,19,11,0,0,94
16,18,5,4,21,19,11,19,0,113
16,18,5,4,23,5,12,12,0,95
16,18,5,5,0,0,0,0,0,44
16,18,5,5,4,0,0,0,0,48
16,18,5,5,4,9,20,0,0,77
16,18,5,5,4,9,20,15,18,110
16,18,5,5,4,9,20,19,0,96
16,18,5,5,6,6,5,3,20,84
16,18,5,5,6,6,15,18,20,109
16,18,5,5,9,14,7,0,0,74
16,18,5,5,12,5,3,20,0,84
16,18,5,5,12,5,3,20,19,103
16,18,5,5,13,2,15,4,25,103
16,18,5,5,13,9,5,0,0,71
16,18,5,5,13,9,5,19,0,90
16,18,5,5,13,16,12,15,25,125
16,18,5,5,13,16,20,0,0,93
16,18,5,5,13,16,20,5,4,102
16,18,5,5,13,16,20,15,18,126
16,18,5,5,13,16,20,19,0,112
16,18,5,5,14,0,0,0,0,58
16,18,5,5,14,1,2,12,5,78
16,18,5,5,14,1,3,20,0,82
16,18,5,5,14,1,3,20,19,101
16,18,5,5,14,5,4,0,0,67
16,18,5,5,14,5,18,0,0,81
16,18,5,5,14,5,18,19,0,100
16,18,5,5,14,7,1,7,5,78
16,18,5,5,14,9,14,7,0,88
16,18,5,5,14,10,15,25,0,108
16,18,5,5,14,12,9,19,20,118
16,18,5,5,14,18,15,12,12,115
16,18,5,5,14,19,0,0,0,77
16,18,5,5,14,20,1,9,12,100
16,18,5,5,14,20,5,18,0,101
16,18,5,5,14,20,18,25,0,121
16,18,5,5,17,21,9,16,0,107
16,18,5,5,17,21,9,20,25,136
16,18,5,5,18,5,3,20,0,90
16,18,5,5,18,21,16,20,0,119
16,18,5,5,19,0,0,0,0,63
16,18,5,5,19,3,1,16,5,88
16,18,5,5,19,19,1,25,0,108
16,18,5,5,19,20,5,5,13,106
16,18,5,5,22,1,4,5,0,76
16,18,5,5,22,1,4,5,4,80
16,18,5,5,24,1,3,20,0,92
16,18,5,5,24,3,5,16,20,112
16,18,5,5,24,3,9,20,5,105
16,18,5,5,24,3,21,19,5,116
16,18,5,5,24,5,13,16,20,122
16,18,5,5,24,9,12,9,3,101
16,18,5,5,24,9,19,20,0,116
16,18,5,5,24,9,19,20,19,135
16,18,5,5,24,16,1,14,4,103
16,18,5,5,24,16,5,3,20,112
16,18,5,5,24,16,5,14,4,107
16,18,5,5,24,16,15,19,5,123
16,18,5,5,24,20,5,14,4,111
16,18,5,5,24,20,5,14,20,127
16,18,5,5,26,5,0,0,0,75
16,18,5,6,0,0,0,0,0,45
16,18,5,6,1,2,0,0,0,48
16,18,5,6,1,2,2,5,4,59
16,18,5,6,1,2,19,0,0,67
16,18,5,6,1,3,5,4,0,58
16,18,5,6,1,3,5,18,0,72
16,18,5,6,1,3,5,18,19,91
16,18,5,6,1,3,5,19,0,73
16,18,5,6,1,3,9,1,12,71
16,18,5,6,1,3,9,14,7,79
16,18,5,6,1,3,9,19,20,97
16,18,5,6,1,3,20,15,18,102
16,18,5,6,1,4,5,0,0,55
16,18,5,6,1,4,5,4,0,59
16,18,5,6,1,4,5,19,0,74
16,18,5,6,1,13,15,21,19,114
16,18,5,6,1,20,9,1,12,88
16,18,5,6,1,20,15,18,0,99
16,18,5,6,1,20,15,18,25,124
16,18,5,6,1,22,15,18,0,101
16,18,5,6,5,1,19,20,0,90
16,18,5,6,5,3,20,0,0,73
16,18,5,6,5,3,20,12,25,110
16,18,5,6,5,3,20,19,0,92
16,18,5,6,5,12,9,3,0,74
16,18,5,6,5,18,0,0,0,68
16,18,5,6,5,18,5,4,0,77
16,18,5,6,5,18,5,5,0,78
16,18,5,6,5,18,5,14,20,107
16,18,5,6,5,18,18,1,12,99
16,18,5,6,5,18,18,5,4,95
16,18,5,6,5,18,18,5,18,109
16,18,5,6,5,18,19,0,0,87
16,18,5,6,5,18,22,9,4,103
16,18,5,6,5,20,0,0,0,70
16,18,5,6,5,21,4,1,12,88
16,18,5,6,6,18,15,26,5,115
16,18,5,6,9,7,8,20,0,89
16,18,5,6,9,7,21,18,5,105
16,18,5,6,9,12,5,0,0,71
16,18,5,6,9,12,5,4,0,75
16,18,5,6,9,12,5,19,0,90
16,18,5,6,9,12,12,0,0,78
16,18,5,6,9,12,12,5,18,101
16,18,5,6,9,12,12,19,0,97
16,18,5,6,9,12,20,5,18,109
16,18,5,6,9,14,1,12,0,81
16,18,5,6,9,14,5,0,0,73
16,18,5,6,9,14,9,19,8,104
16,18,5,6,9,18,5,0,0,77
16,18,5,6,9,18,5,4,0,81
16,18,5,6,9,18,5,19,0,96
16,18,5,6,9,24,0,0,0,78
16,18,5,6,9,24,1,12,0,91
16,18,5,6,9,24,5,4,0,87
16,18,5,6,9,24,5,19,0,102
16,18,5,6,9,24,9,14,7,108
16,18,5,6,9,24,9,15,14,116
16,18,5,6,12,1,13,5,0,76
16,18,5,6,12,1,22,15,18,113
16,18,5,6,12,9,7,8,20,101
16,18,5,6,12,15,15,4,0,91
16,18,5,6,15,3,21,19,0,103
16,18,5,6,15,15,12,0,0,87
16,18,5,6,15,18,13,0,0,91
16,18,5,6,15,18,13,5,4,100
16,18,5,6,15,18,13,19,0,110
16,18,5,6,18,1,3,20,0,87
16,18,5,6,18,1,14,11,0,89
16,18,5,6,18,1,14,11,19,108
16,18,5,6,18,1,21,4,0,89
16,18,5,6,18,5,5,26,5,104
16,18,5,6,18,9,7,8,20,107
16,18,5,6,18,15,26,5,0,109
16,18,5,6,18,15,26,5,14,123
16,18,5,7,1,9,14,0,0,70
16,18,5,7,1,9,14,5,18,93
16,18,5,7,1,13,5,0,0,65
16,18,5,7,1,20,8,5,18,98
16,18,5,7,5,14,9,1,12,87
16,18,5,7,7,5,18,19,0,95
16,18,5,7,8,9,5,18,1,87
16,18,5,7,14,1,2,12,5,80
16,18,5,7,14,1,14,3,5,83
16,18,5,7,14,1,14,3,25,103
16,18,5,7,14,1,14,20,0,95
16,18,5,7,15,12,4,5,14,96
16,18,5,7,18,1,4,5,0,74
16,18,5,7,18,1,4,5,4,78
16,18,5,7,18,5,5,20,0,94
16,18,5,7,18,15,23,20,8,130
16,18,5,7,21,1,18,4,0,90
16,18,5,7,21,5,19,19,0,110
16,18,5,7,21,9,4,5,0,85
16,18,5,7,21,9,4,5,4,89
16,18,5,7,21,9,12,20,0,108
16,18,5,7,21,9,12,20,25,133
16,18,5,7,21,19,20,0,0,106
16,18,5,7,21,19,20,9,3,118
16,18,5,8,1,12,12,21,24,117
16,18,5,8,1,12,20,5,18,103
16,18,5,8,1,14,4,12,5,83
16,18,5,8,1,16,19,0,0,83
16,18,5,8,1,18,4,5,14,89
16,18,5,8,1,18,19,8,0,93
16,18,5,8,1,20,18,5,4,95
16,18,5,8,1,21,14,20,0,103
16,18,5,8,1,26,1,18,4,97
16,18,5,8,5,1,12,0,0,65
16,18,5,8,5,1,20,0,0,73
16,18,5,8,5,1,20,5,4,82
16,18,5,8,5,1,20,5,18,96
16,18,5,8,5,1,20,19,0,92
16,18,5,8,5,14,4,0,0,70
16,18,5,8,5,14,4,5,4,79
16,18,5,8,5,14,19,15,18,118
16,18,5,8,5,18,15,9,3,97
16,18,5,8,14,9,20,5,0,95
16,18,5,8,14,9,20,9,3,102
16,18,5,8,15,12,4,5,18,101
16,18,5,8,15,18,18,15,18,131
16,18,5,8,21,13,1,14,0,96
16,18,5,8,21,13,1,14,19,115
16,18,5,8,21,13,15,18,0,114
16,18,5,8,21,14,7,5,18,112
16,18,5,25,0,0,0,0,0,64
16,18,5,9,4,5,1,0,0,58
16,18,5,25,5,4,0,0,0,73
16,18,5,25,5,18,0,0,0,87
16,18,5,25,5,18,19,0,0,106
16,18,5,25,6,21,12,0,0,103
16,18,5,25,9,14,7,0,0,94
16,18,5,25,9,14,7,12,25,131
16,18,5,9,12,9,21,13,0,103
16,18,5,9,13,1,7,5,0,74
16,18,5,9,13,2,9,2,5,79
16,18,5,9,13,2,21,5,0,89
16,18,5,9,13,2,21,5,4,93
16,18,5,9,13,16,1,9,18,105
16,18,5,9,13,16,1,18,20,116
16,18,5,9,13,16,15,18,20,130
16,18,5,9,13,16,15,19,5,116
16,18,5,9,14,4,21,3,5,95
16,18,5,9,14,6,5,3,20,96
16,18,5,9,14,6,5,18,0,91
16,18,5,9,14,6,15,18,13,114
16,18,5,9,14,8,5,18,5,98
16,18,5,9,14,10,21,18,5,116
16,18,5,9,14,10,21,18,25,136
16,18,5,9,14,19,5,18,20,124
16,18,5,9,14,19,21,12,1,115
16,18,5,9,14,19,21,12,20,134
16,18,5,9,14,19,21,18,5,125
16,18,5,9,14,20,5,14,4,105
16,18,5,9,14,20,15,14,5,116
16,18,5,9,14,22,5,14,20,123
16,18,5,9,14,22,5,19,20,128
16,18,5,9,14,22,9,20,5,118
16,18,5,9,15,20,9,26,5,123
16,18,5,25,19,0,0,0,0,83
16,18,5,9,19,19,21,5,0,112
16,18,5,9,19,19,21,5,4,116
16,18,5,10,1,3,5,14,20,92
16,18,5,10,21,4,7,5,0,86
16,18,5,10,21,4,7,5,4,90
16,18,5,10,21,4,7,5,18,104
16,18,5,10,21,4,7,5,19,105
16,18,5,10,21,4,9,3,5,91
16,18,5,10,21,14,9,15,18,126
16,18,5,11,9,14,4,12,5,94
16,18,5,11,14,5,23,0,0,92
16,18,5,11,14,9,20,0,0,93
16,18,5,11,14,15,23,0,0,102
16,18,5,11,14,15,23,14,0,116
16,18,5,12,1,0,0,0,0,52
16,18,5,12,1,2,5,12,0,71
16,18,5,12,1,2,9,1,12,76
16,18,5,12,1,2,15,18,0,87
16,18,5,12,1,2,18,21,13,106
16,18,5,12,1,3,25,0,0,80
16,18,5,12,1,3,9,5,19,88
16,18,5,12,1,20,5,0,0,77
16,18,5,12,1,20,5,19,0,96
16,18,5,12,1,20,5,19,19,115
16,18,5,12,1,20,25,0,0,97
16,18,5,12,1,20,9,1,12,94
16,18,5,12,1,20,9,3,0,84
16,18,5,12,1,20,9,15,14,110
16,18,5,12,1,20,9,19,8,108
16,18,5,12,1,20,9,19,13,113
16,18,5,12,1,20,9,19,20,120
16,18,5,12,1,20,9,26,5,112
16,18,5,12,1,20,18,25,0,115
16,18,5,12,1,20,21,18,5,116
16,18,5,12,1,21,14,3,8,98
16,18,5,12,1,23,0,0,0,75
16,18,5,12,1,23,6,21,12,114
16,18,5,12,5,1,19,5,0,81
16,18,5,12,5,1,19,5,4,85
16,18,5,12,5,3,20,0,0,79
16,18,5,12,5,3,20,5,4,88
16,18,5,12,5,3,20,15,18,112
16,18,5,12,5,3,20,19,0,98
16,18,5,12,5,7,1,3,25,92
16,18,5,12,5,7,1,12,0,76
16,18,5,12,5,7,1,20,5,89
16,18,5,12,5,7,5,14,4,86
16,18,5,12,9,1,2,12,5,80
16,18,5,12,9,6,5,0,0,71
16,18,5,12,9,13,0,0,0,73
16,18,5,12,9,13,9,20,0,102
16,18,5,12,9,13,9,20,19,121
16,18,5,12,9,13,19,0,0,92
16,18,5,12,9,20,8,9,3,100
16,18,5,12,9,22,5,19,0,106
16,18,5,12,15,1,4,5,4,80
16,18,5,12,15,1,14,0,0,81
16,18,5,12,15,3,1,20,5,95
16,18,5,12,15,7,9,3,0,85
16,18,5,12,15,18,1,12,0,97
16,18,5,12,15,18,5,1,12,102
16,18,5,12,15,19,19,0,0,104
16,18,5,12,21,4,5,0,0,81
16,18,5,12,21,4,5,4,0,85
16,18,5,12,21,4,5,18,0,99
16,18,5,12,21,4,5,18,19,118
16,18,5,12,21,4,5,19,0,100
16,18,5,12,21,4,9,1,12,98
16,18,5,12,21,4,9,14,7,106
16,18,5,12,21,4,9,15,0,100
16,18,5,12,21,4,9,21,13,119
16,18,5,12,21,4,9,26,5,116
16,18,5,12,21,13,2,1,18,106
16,18,5,12,21,14,3,8,0,97
16,18,5,12,21,19,9,15,14,129
16,18,5,12,21,19,9,22,5,127
16,18,5,12,21,19,15,18,25,149
16,18,5,13,1,4,5,0,0,62
16,18,5,13,1,11,5,0,0,69
16,18,5,13,1,11,5,18,0,87
16,18,5,13,1,11,9,14,7,94
16,18,5,13,1,14,0,0,0,67
16,18,5,13,1,18,18,25,0,114
16,18,5,13,1,20,3,8,0,84
16,18,5,13,1,20,5,0,0,78
16,18,5,13,1,20,5,4,0,82
16,18,5,13,1,20,9,14,7,103
16,18,5,13,1,20,21,18,5,117
16,18,5,13,5,1,12,0,0,70
16,18,5,13,5,4,0,0,0,61
16,18,5,13,5,4,9,1,0,71
16,18,5,13,5,4,9,1,12,83
16,18,5,13,5,4,9,1,14,85
16,18,5,13,5,4,9,3,0,73
16,18,5,13,5,4,9,3,19,92
16,18,5,13,5,4,19,0,0,80
16,18,5,13,5,5,20,0,0,82
16,18,5,13,5,13,15,4,1,90
16,18,5,13,5,14,0,0,0,71
16,18,5,13,5,14,1,3,5,80
16,18,5,13,5,18,9,20,0,104
16,18,5,13,9,1,0,0,0,62
16,18,5,13,9,1,12,0,0,74
16,18,5,13,9,1,14,20,0,96
16,18,5,13,9,1,20,5,0,87
16,18,5,13,9,1,20,5,4,91
16,18,5,13,9,5,0,0,0,66
16,18,5,13,9,5,18,0,0,84
16,18,5,13,9,5,18,1,12,97
16,18,5,13,9,5,18,5,0,89
16,18,5,13,9,5,18,5,4,93
16,18,5,13,9,5,18,5,19,108
16,18,5,13,9,5,18,19,0,103
16,18,5,13,9,5,19,0,0,85
16,18,5,13,9,15,0,0,0,76
16,18,5,13,9,15,21,19,0,116
16,18,5,13,9,19,1,12,0,93
16,18,5,13,9,19,5,0,0,85
16,18,5,13,9,19,5,4,0,89
16,18,5,13,9,19,5,19,0,104
16,18,5,13,9,19,9,14,7,110
16,18,5,13,9,19,15,18,25,138
16,18,5,13,9,19,19,0,0,99
16,18,5,13,9,19,19,5,19,123
16,18,5,13,9,20,0,0,0,81
16,18,5,13,9,21,13,0,0,95
16,18,5,13,9,21,13,19,0,114
16,18,5,13,9,24,0,0,0,85
16,18,5,13,9,24,5,4,0,94
16,18,5,13,9,24,5,18,0,108
16,18,5,13,9,24,5,19,0,109
16,18,5,13,9,24,9,14,7,115
16,18,5,13,15,4,5,12,0,88
16,18,5,13,15,4,5,18,14,108
16,18,5,13,15,4,9,6,25,111
16,18,5,13,15,12,1,18,0,98
16,18,5,13,15,12,1,18,19,117
16,18,5,13,15,12,4,0,0,83
16,18,5,13,15,12,4,5,18,106
16,18,5,13,15,12,4,19,0,102
16,18,5,13,15,12,20,0,0,99
16,18,5,13,15,14,9,19,8,117
16,18,5,13,15,18,1,12,0,98
16,18,5,13,15,18,2,9,4,100
16,18,5,13,15,18,19,5,0,109
16,18,5,13,15,18,20,1,12,118
16,18,5,13,15,18,21,12,1,119
16,18,5,13,15,19,1,9,3,99
16,18,5,13,15,20,9,15,14,125
16,18,5,13,15,21,18,14,0,120
16,18,5,13,15,22,5,0,0,94
16,18,5,13,15,22,5,18,0,112
16,18,5,13,21,4,4,12,5,98
16,18,5,13,21,14,5,0,0,92
16,18,5,13,21,14,9,18,5,119
16,18,5,13,21,19,20,5,18,135
16,18,5,13,21,20,9,14,25,141
16,18,5,14,1,13,5,0,0,72
16,18,5,14,1,13,5,19,0,91
16,18,5,14,1,18,5,19,0,96
16,18,5,14,1,18,9,1,12,94
16,18,5,14,1,18,9,19,0,100
16,18,5,14,1,19,1,12,0,86
16,18,5,14,1,20,1,12,0,87
16,18,5,14,1,20,9,22,5,110
16,18,5,14,1,22,1,12,0,89
16,18,5,14,4,5,18,0,0,80
16,18,5,14,4,18,5,0,0,80
16,18,5,14,5,21,18,1,12,110
16,18,5,14,9,7,8,20,0,97
16,18,5,14,15,2,12,5,0,87
16,18,5,14,15,4,1,12,0,85
16,18,5,14,15,13,5,14,0,100
16,18,5,14,15,13,5,14,19,119
16,18,5,14,15,13,9,14,1,105
16,18,5,14,15,15,14,0,0,97
16,18,5,14,15,20,5,0,0,93
16,18,5,14,15,20,5,4,0,97
16,18,5,14,15,20,9,3,5,105
16,18,5,14,15,20,9,6,25,128
16,18,5,14,15,20,9,14,7,118
16,18,5,14,15,20,9,15,14,126
16,18,5,14,20,9,3,5,4,94
16,18,5,14,20,9,3,5,19,109
16,18,5,14,21,13,2,5,18,112
16,18,5,14,26,9,5,0,0,93
16,18,5,15,2,10,5,3,20,94
16,18,5,15,2,12,9,7,5,89
16,18,5,15,2,20,1,9,14,100
16,18,5,15,3,3,21,16,25,122
16,18,5,15,3,3,21,18,0,99
16,18,5,15,3,21,12,1,18,109
16,18,5,15,6,6,5,14,4,89
16,18,5,15,6,6,5,18,0,89
16,18,5,15,13,9,20,0,0,96
16,18,5,15,16,5,14,0,0,89
16,18,5,15,16,16,15,19,5,125
16,18,5,15,16,20,9,3,0,102
16,18,5,15,16,20,9,15,14,128
16,18,5,15,18,1,12,0,0,85
16,18,5,15,18,1,12,12,25,122
16,18,5,15,18,4,1,9,14,100
16,18,5,15,18,4,5,18,0,99
16,18,5,15,20,9,3,0,0,86
16,18,5,15,21,20,6,9,20,130
16,18,5,16,0,0,0,0,0,55
16,18,5,16,1,3,11,0,0,70
16,18,5,16,1,3,11,5,4,79
16,18,5,16,1,3,11,19,0,89
16,18,5,16,1,7,9,14,7,93
16,18,5,16,1,25,0,0,0,81
16,18,5,16,1,9,4,0,0,69
16,18,5,16,1,25,9,14,7,111
16,18,5,16,1,25,19,0,0,100
16,18,5,16,1,14,9,3,0,82
16,18,5,16,1,18,4,15,14,107
16,18,5,16,1,18,5,0,0,79
16,18,5,16,1,18,5,4,0,83
16,18,5,16,1,18,5,18,0,97
16,18,5,16,1,18,5,18,19,116
16,18,5,16,1,18,5,19,0,98
16,18,5,16,1,18,9,14,7,104
16,18,5,16,1,19,20,5,0,100
16,18,5,16,1,20,5,14,20,115
16,18,5,16,1,22,5,0,0,83
16,18,5,16,1,22,5,4,0,87
16,18,5,16,1,22,9,14,7,108
16,18,5,16,4,0,0,0,0,59
16,18,5,16,5,14,4,0,0,78
16,18,5,16,5,14,4,5,4,87
16,18,5,16,5,14,9,1,12,96
16,18,5,16,5,14,19,5,0,98
16,18,5,16,5,14,19,5,4,102
16,18,5,16,5,15,16,12,5,108
16,18,5,16,5,18,21,19,5,123
16,18,5,16,7,0,0,0,0,62
16,18,5,16,9,12,12,0,0,88
16,18,5,16,9,14,5,1,12,96
16,18,5,16,9,14,11,0,0,89
16,18,5,16,9,15,21,19,0,119
16,18,5,16,12,1,3,5,0,76
16,18,5,16,12,1,3,5,4,80
16,18,5,16,12,1,3,5,19,95
16,18,5,16,12,1,14,0,0,82
16,18,5,16,12,1,14,19,0,101
16,18,5,16,12,1,14,20,0,102
16,18,5,16,12,5,4,7,5,88
16,18,5,16,12,15,20,0,0,102
16,18,5,16,14,0,0,0,0,69
16,18,5,16,15,5,20,9,3,107
16,18,5,16,15,9,19,15,14,127
16,18,5,16,15,12,9,3,5,99
16,18,5,16,15,12,9,19,8,118
16,18,5,16,15,12,12,5,24,123
16,18,5,16,15,14,4,5,18,111
16,18,5,16,15,19,5,0,0,94
16,18,5,16,15,19,5,4,0,98
16,18,5,16,15,19,9,14,7,119
16,18,5,16,15,19,20,5,18,132
16,18,5,16,15,19,20,15,18,142
16,18,5,16,15,20,5,14,20,129
16,18,5,16,16,5,4,0,0,80
16,18,5,16,16,25,0,0,0,96
16,18,5,16,16,9,5,0,0,85
16,18,5,16,16,9,5,18,0,103
16,18,5,16,16,9,5,19,0,104
16,18,5,16,16,9,12,25,0,117
16,18,5,16,16,9,14,7,0,101
16,18,5,16,18,5,7,0,0,85
16,18,5,16,18,5,7,19,0,104
16,18,5,16,18,9,3,5,0,90
16,18,5,16,18,9,3,5,4,94
16,18,5,16,18,9,13,5,18,118
16,18,5,16,18,9,14,20,0,116
16,18,5,16,18,9,14,20,19,135
16,18,5,16,18,15,22,5,0,115
16,18,5,16,18,15,22,5,4,119
16,18,5,16,19,0,0,0,0,74
16,18,5,16,21,2,9,3,0,90
16,18,5,16,21,2,9,19,0,106
16,18,5,16,21,3,5,0,0,84
16,18,5,16,21,3,5,19,0,103
16,18,5,16,21,5,2,12,15,110
16,18,5,16,21,14,3,8,0,101
16,18,5,16,21,14,9,19,8,126
16,18,5,16,21,16,1,0,0,93
16,18,5,16,21,16,1,12,0,105
16,18,5,16,21,20,9,1,12,118
16,18,5,16,21,20,9,21,13,139
16,18,5,17,21,5,12,0,0,94
16,18,5,17,21,15,20,5,0,117
16,18,5,17,21,15,20,5,4,121
16,18,5,18,1,3,5,0,0,66
16,18,5,18,1,3,9,14,7,91
16,18,5,18,1,4,9,15,0,86
16,18,5,18,1,13,21,19,0,111
16,18,5,18,5,1,4,25,0,92
16,18,5,18,5,3,9,20,5,99
16,18,5,18,5,3,11,15,14,105
16,18,5,18,5,3,15,18,4,102
16,18,5,18,5,3,20,1,12,98
16,18,5,18,5,4,5,5,13,89
16,18,5,18,5,6,5,18,0,91
16,18,5,18,5,6,9,14,5,96
16,18,5,18,5,6,15,18,13,114
16,18,5,18,5,6,21,19,5,113
16,18,5,18,5,7,1,12,0,82
16,18,5,18,5,10,5,3,20,100
16,18,5,18,5,12,1,20,5,100
16,18,5,18,5,13,9,20,0,104
16,18,5,18,5,13,15,20,5,115
16,18,5,18,5,13,15,22,5,117
16,18,5,18,5,14,1,12,0,89
16,18,5,18,5,14,20,0,0,96
16,18,5,18,5,14,20,1,12,109
16,18,5,18,5,16,15,18,20,131
16,18,5,18,5,19,15,18,20,134
16,18,5,18,5,20,21,18,14,135
16,18,5,18,5,22,5,1,12,102
16,18,5,18,5,22,9,5,23,121
16,18,5,18,5,22,9,19,5,117
16,18,5,18,9,3,8,0,0,77
16,18,5,18,9,14,19,5,0,104
16,18,5,18,9,15,20,0,0,101
16,18,5,18,15,3,11,0,0,86
16,18,5,18,15,25,1,12,0,110
16,18,5,18,15,21,20,5,0,118
16,18,5,18,15,21,20,5,4,122
16,18,5,18,21,16,20,0,0,114
16,18,5,19,1,0,0,0,0,59
16,18,5,19,1,3,18,1,12,93
16,18,5,19,1,7,5,0,0,71
16,18,5,19,1,7,5,4,0,75
16,18,5,19,1,7,5,18,0,89
16,18,5,19,1,7,5,18,19,108
16,18,5,19,1,7,5,19,0,90
16,18,5,19,1,7,9,14,7,96
16,18,5,19,1,25,0,0,0,84
16,18,5,19,1,9,4,0,0,72
16,18,5,19,1,25,9,14,7,114
16,18,5,19,1,12,5,0,0,76
16,18,5,19,1,22,1,7,5,94
16,18,5,19,1,23,0,0,0,82
16,18,5,19,2,25,15,16,5,121
16,18,5,19,2,25,15,16,25,141
16,18,5,19,2,25,20,5,0,110
16,18,5,19,2,25,20,5,18,128
16,18,5,19,2,25,20,9,1,115
16,18,5,19,2,25,20,9,3,117
16,18,5,19,3,1,14,0,0,76
16,18,5,19,3,8,15,15,12,111
16,18,5,19,3,9,5,14,20,109
16,18,5,19,3,9,14,4,0,88
16,18,5,19,3,9,14,4,19,107
16,18,5,19,3,15,18,5,0,99
16,18,5,19,3,15,18,5,4,103
16,18,5,19,3,15,18,5,19,118
16,18,5,19,3,15,21,20,0,117
16,18,5,19,3,18,9,2,5,95
16,18,5,19,3,18,9,16,20,124
16,18,5,19,3,18,9,22,5,115
16,18,5,19,3,21,20,1,12,115
16,18,5,19,3,21,20,21,13,136
16,18,5,19,5,0,0,0,0,63
16,18,5,19,5,1,12,0,0,76
16,18,5,19,5,1,18,3,8,93
16,18,5,19,5,1,19,15,14,112
16,18,5,19,5,3,21,18,5,110
16,18,5,19,5,5,0,0,0,68
16,18,5,19,5,5,9,14,7,98
16,18,5,19,5,5,14,0,0,82
16,18,5,19,5,12,5,3,20,103
16,18,5,19,5,12,12,0,0,87
16,18,5,19,5,12,12,19,0,106
16,18,5,19,5,14,3,5,0,85
16,18,5,19,5,14,3,5,4,89
16,18,5,19,5,14,3,5,19,104
16,18,5,19,5,14,9,12,5,103
16,18,5,19,5,14,20,0,0,97
16,18,5,19,5,14,20,1,12,110
16,18,5,19,5,14,20,5,4,106
16,18,5,19,5,14,20,5,5,107
16,18,5,19,5,14,20,5,18,120
16,18,5,19,5,14,20,12,25,134
16,18,5,19,5,14,20,15,18,130
16,18,5,19,5,14,20,19,0,116
16,18,5,19,5,16,20,1,12,112
16,18,5,19,5,18,0,0,0,81
16,18,5,19,5,18,22,1,12,116
16,18,5,19,5,18,22,5,0,108
16,18,5,19,5,18,22,5,4,112
16,18,5,19,5,18,22,5,18,126
16,18,5,19,5,18,22,5,19,127
16,18,5,19,5,19,0,0,0,82
16,18,5,19,5,20,0,0,0,83
16,18,5,19,5,20,19,0,0,102
16,18,5,19,5,20,20,12,5,120
16,18,5,19,5,24,21,1,12,121
16,18,5,19,8,1,4,15,23,109
16,18,5,19,8,1,16,5,0,88
16,18,5,19,8,1,16,5,4,92
16,18,5,19,8,1,16,5,19,107
16,18,5,19,8,1,18,5,0,90
16,18,5,19,8,1,18,5,4,94
16,18,5,19,8,9,16,0,0,91
16,18,5,19,8,15,23,0,0,104
16,18,5,19,8,15,23,5,4,113
16,18,5,19,8,15,23,14,0,118
16,18,5,19,8,15,23,19,0,123
16,18,5,19,8,18,9,14,11,118
16,18,5,19,8,18,21,14,11,130
16,18,5,19,9,4,5,0,0,76
16,18,5,19,9,4,5,4,0,80
16,18,5,19,9,4,5,14,20,110
16,18,5,19,9,4,5,18,0,94
16,18,5,19,9,4,5,18,19,113
16,18,5,19,9,4,5,19,0,95
16,18,5,19,9,4,25,0,0,96
16,18,5,19,9,4,9,1,0,81
16,18,5,19,9,4,9,1,12,93
16,18,5,19,9,4,9,14,7,101
16,18,5,19,9,4,9,15,19,114
16,18,5,19,9,4,9,21,13,114
16,18,5,19,9,6,20,0,0,93
16,18,5,19,9,6,20,5,4,102
16,18,5,19,9,6,20,19,0,112
16,18,5,19,9,7,14,0,0,88
16,18,5,19,9,7,14,1,12,101
16,18,5,19,9,13,9,1,14,104
16,18,5,19,12,5,5,16,0,96
16,18,5,19,12,9,3,5,0,87
16,18,5,19,13,15,15,20,8,129
16,18,5,19,15,1,11,0,0,85
16,18,5,19,15,1,11,5,4,94
16,18,5,19,15,1,11,19,0,104
16,18,5,19,15,3,9,1,12,98
16,18,5,19,15,12,1,18,0,104
16,18,5,19,15,12,4,0,0,89
16,18,5,19,15,12,22,5,0,112
16,18,5,19,15,12,22,5,4,116
16,18,5,19,15,14,7,0,0,94
16,18,5,19,15,18,20,0,0,111
16,18,5,19,15,18,20,19,0,130
16,18,5,19,15,21,14,4,0,112
16,18,5,19,16,9,14,1,12,110
16,18,5,19,16,12,9,20,0,115
16,18,5,19,16,15,9,12,0,110
16,18,5,19,16,18,5,1,4,102
16,18,5,19,16,21,18,0,0,113
16,18,5,19,19,1,2,12,5,97
16,18,5,19,19,1,7,5,0,90
16,18,5,19,19,4,15,13,0,109
16,18,5,19,19,5,4,0,0,86
16,18,5,19,19,5,12,0,0,94
16,18,5,19,19,5,18,0,0,100
16,18,5,19,19,5,18,19,0,119
16,18,5,19,19,5,19,0,0,101
16,18,5,19,19,6,1,20,0,104
16,18,5,19,19,6,21,12,0,116
16,18,5,19,19,7,1,14,7,106
16,18,5,19,19,9,2,12,5,105
16,18,5,19,19,9,5,0,0,91
16,18,5,19,19,9,14,7,0,107
16,18,5,19,19,9,14,7,19,126
16,18,5,19,19,9,15,14,0,115
16,18,5,19,19,9,22,5,0,113
16,18,5,19,19,12,25,0,0,114
16,18,5,19,19,13,1,18,11,120
16,18,5,19,19,13,5,14,0,109
16,18,5,19,19,15,18,0,0,110
16,18,5,19,19,15,18,19,0,129
16,18,5,19,19,16,1,3,11,108
16,18,5,19,19,18,15,15,13,138
16,18,5,19,19,18,21,14,0,130
16,18,5,19,19,18,21,14,19,149
16,18,5,19,19,21,18,1,12,129
16,18,5,19,19,21,18,5,0,121
16,18,5,19,19,21,18,5,4,125
16,18,5,19,19,21,18,5,19,140
16,18,5,19,19,23,15,18,11,144
16,18,5,19,20,0,0,0,0,78
16,18,5,19,20,1,2,12,5,98
16,18,5,19,20,1,13,16,0,108
16,18,5,19,20,1,13,16,19,127
16,18,5,19,20,1,14,20,0,113
16,18,5,19,20,1,20,5,0,104
16,18,5,19,20,1,20,5,4,108
16,18,5,19,20,5,1,13,0,97
16,18,5,19,20,5,5,12,0,100
16,18,5,19,20,5,18,0,0,101
16,18,5,19,20,5,18,19,0,120
16,18,5,19,20,5,26,26,1,136
16,18,5,19,20,9,7,5,19,118
16,18,5,19,20,12,25,0,0,115
16,18,5,19,20,15,0,0,0,93
16,18,5,19,20,15,3,11,0,107
16,18,5,19,20,15,18,5,0,116
16,18,5,19,20,15,18,5,4,120
16,18,5,19,20,15,19,0,0,112
16,18,5,19,20,18,1,9,14,120
16,18,5,19,20,18,5,19,19,139
16,18,5,19,20,18,9,11,5,121
16,18,5,19,20,19,0,0,0,97
16,18,5,19,20,21,4,25,0,128
16,18,5,19,21,2,4,21,5,111
16,18,5,19,21,2,13,9,20,123
16,18,5,19,21,6,6,5,18,114
16,18,5,19,21,12,0,0,0,91
16,18,5,19,21,13,5,0,0,97
16,18,5,19,21,13,5,4,0,101
16,18,5,19,21,13,5,18,0,115
16,18,5,19,21,13,5,18,19,134
16,18,5,19,21,13,5,19,0,116
16,18,5,19,21,13,9,14,7,122
16,18,5,19,21,16,16,12,25,148
16,18,5,19,21,18,22,5,25,149
16,18,5,20,0,0,0,0,0,59
16,18,5,20,1,0,0,0,0,60
16,18,5,20,1,14,0,0,0,74
16,18,5,20,1,14,14,5,4,97
16,18,5,20,1,16,5,0,0,81
16,18,5,20,1,16,5,4,0,85
16,18,5,20,1,16,5,19,0,100
16,18,5,20,1,18,4,25,0,107
16,18,5,20,1,18,9,6,6,99
16,18,5,20,1,18,19,9,0,106
16,18,5,20,1,18,19,21,19,137
16,18,5,20,1,19,20,5,0,104
16,18,5,20,1,19,20,5,4,108
16,18,5,20,1,19,20,5,18,122
16,18,5,20,1,19,20,5,19,123
16,18,5,20,1,21,7,8,20,116
16,18,5,20,1,24,0,0,0,84
16,18,5,20,5,1,3,8,0,76
16,18,5,20,5,5,14,0,0,83
16,18,5,20,5,5,14,19,0,102
16,18,5,20,5,12,12,0,0,88
16,18,5,20,5,13,16,20,0,113
16,18,5,20,5,14,3,5,0,86
16,18,5,20,5,14,3,5,4,90
16,18,5,20,5,14,3,5,19,105
16,18,5,20,5,14,4,0,0,82
16,18,5,20,5,14,4,5,4,91
16,18,5,20,5,14,4,5,18,105
16,18,5,20,5,14,4,19,0,101
16,18,5,20,5,14,19,5,0,102
16,18,5,20,5,14,19,5,4,106
16,18,5,20,5,14,19,5,19,121
16,18,5,20,5,18,0,0,0,82
16,18,5,20,5,18,9,19,20,130
16,18,5,20,5,18,9,20,0,111
16,18,5,20,5,18,9,20,5,116
16,18,5,20,5,18,9,20,19,130
16,18,5,20,5,18,13,9,20,124
16,18,5,20,5,19,20,0,0,103
16,18,5,20,5,19,20,5,4,112
16,18,5,20,5,19,20,19,0,122
16,18,5,20,5,24,20,0,0,108
16,18,5,20,5,24,20,1,0,109
16,18,5,20,5,24,20,1,5,114
16,18,5,20,5,24,20,5,4,117
16,18,5,20,5,24,20,19,0,127
16,18,5,20,8,18,9,12,12,118
16,18,5,20,8,18,21,19,20,145
16,18,5,20,9,2,9,1,12,92
16,18,5,20,9,12,0,0,0,80
16,18,5,20,9,13,5,12,25,123
16,18,5,20,25,16,5,0,0,105
16,18,5,20,25,16,5,4,0,109
16,18,5,20,25,16,5,19,0,124
16,18,5,20,25,16,9,6,25,140
16,18,5,20,9,18,5,0,0,91
16,18,5,20,9,18,5,4,0,95
16,18,5,20,9,18,9,14,7,116
16,18,5,20,9,21,13,0,0,102
16,18,5,20,15,11,5,14,0,104
16,18,5,20,15,12,4,0,0,90
16,18,5,20,15,14,5,0,0,93
16,18,5,20,15,14,9,3,0,100
16,18,5,20,15,18,0,0,0,92
16,18,5,20,15,18,9,1,12,114
16,18,5,20,15,18,9,1,14,116
16,18,5,20,15,18,9,21,13,135
16,18,5,20,15,18,19,0,0,111
16,18,5,20,18,1,3,5,0,86
16,18,5,20,18,1,3,5,4,90
16,18,5,20,18,1,9,14,0,101
16,18,5,20,18,1,22,5,12,117
16,18,5,20,18,5,1,20,0,103
16,18,5,20,18,5,1,20,25,128
16,18,5,20,18,5,1,20,19,122
16,18,5,20,18,25,0,0,0,102
16,18,5,20,18,9,1,12,0,99
16,18,5,20,18,9,2,1,12,101
16,18,5,20,18,9,5,4,0,95
16,18,5,20,18,25,9,14,7,132
16,18,5,20,18,9,13,0,0,99
16,18,5,20,18,9,13,19,0,118
16,18,5,20,20,25,0,0,0,104
16,18,5,20,20,9,5,4,0,97
16,18,5,20,20,9,5,18,0,111
16,18,5,20,20,9,5,19,0,112
16,18,5,20,20,9,5,19,20,132
16,18,5,20,20,9,6,25,0,119
16,18,5,20,20,25,9,14,7,134
16,18,5,20,20,25,9,19,8,140
16,18,5,20,20,25,9,19,13,145
16,18,5,20,20,9,11,9,14,122
16,18,5,20,20,9,12,25,0,125
16,18,5,20,26,5,12,0,0,102
16,18,5,20,26,5,12,19,0,121
16,18,5,21,14,9,15,14,0,112
16,18,5,21,14,9,15,14,19,131
16,18,5,21,14,9,20,5,0,108
16,18,5,21,14,9,20,5,4,112
16,18,5,21,14,9,20,5,19,127
16,18,5,21,24,0,0,0,0,84
16,18,5,22,0,0,0,0,0,61
16,18,5,22,1,3,1,20,5,91
16,18,5,22,1,9,12,0,0,83
16,18,5,22,1,9,12,5,4,92
16,18,5,22,1,9,12,5,18,106
16,18,5,22,1,9,12,19,0,102
16,18,5,22,1,12,5,14,20,113
16,18,5,22,1,12,9,4,0,87
16,18,5,22,1,12,21,5,0,100
16,18,5,22,1,12,21,5,4,104
16,18,5,22,5,0,0,0,0,66
16,18,5,22,5,12,1,18,0,97
16,18,5,22,5,14,1,14,20,115
16,18,5,22,5,14,5,0,0,85
16,18,5,22,5,14,5,4,0,89
16,18,5,22,5,14,9,14,7,110
16,18,5,22,5,14,20,0,0,100
16,18,5,22,5,14,20,5,4,109
16,18,5,22,5,14,20,5,18,123
16,18,5,22,5,14,20,19,0,119
16,18,5,22,5,18,2,0,0,86
16,18,5,22,5,18,2,1,12,99
16,18,5,22,5,18,9,6,25,124
16,18,5,22,5,18,14,1,12,111
16,18,5,22,5,18,19,5,4,112
16,18,5,22,5,20,15,0,0,101
16,18,5,22,5,20,15,5,4,110
16,18,5,22,5,20,15,5,19,125
16,18,5,22,9,4,5,0,0,79
16,18,5,22,9,5,23,0,0,98
16,18,5,22,9,5,23,5,4,107
16,18,5,22,9,5,23,19,0,117
16,18,5,22,9,15,21,19,0,125
16,18,5,22,9,19,5,0,0,94
16,18,5,22,9,19,5,4,0,98
16,18,5,22,9,19,5,19,0,113
16,18,5,22,9,19,9,14,7,119
16,18,5,22,9,19,9,15,14,127
16,18,5,22,9,19,9,20,0,118
16,18,5,22,9,19,9,22,5,125
16,18,5,22,9,19,15,18,0,122
16,18,5,22,9,19,15,18,19,141
16,18,5,22,9,26,5,0,0,101
16,18,5,22,15,3,1,12,0,92
16,18,5,22,15,7,21,5,0,109
16,18,5,22,15,25,1,14,20,136
16,18,5,22,15,9,4,0,0,89
16,18,5,22,15,13,5,18,0,112
16,18,5,22,15,20,1,12,0,109
16,18,5,22,15,20,5,0,0,101
16,18,5,22,15,20,5,4,0,105
16,18,5,22,15,20,9,14,7,126
16,18,5,22,21,5,0,0,0,87
16,18,5,22,21,5,4,0,0,91
16,18,5,22,21,5,19,0,0,106
16,18,5,22,21,9,14,7,0,112
16,18,5,23,1,18,0,0,0,81
16,18,5,23,1,18,13,0,0,94
16,18,5,23,1,18,13,5,4,103
16,18,5,23,1,18,13,19,0,113
16,18,5,23,1,18,14,0,0,95
16,18,5,23,1,18,14,5,4,104
16,18,5,23,1,18,14,19,0,114
16,18,5,23,1,19,8,0,0,90
16,18,5,23,1,19,8,5,4,99
16,18,5,23,1,19,8,5,19,114
16,18,5,23,5,9,7,8,0,91
16,18,5,23,8,9,16,0,0,95
16,18,5,23,9,18,5,0,0,94
16,18,5,23,9,18,5,4,0,98
16,18,5,23,9,18,9,14,7,119
16,18,5,23,15,14,4,5,18,118
16,18,5,23,15,18,11,0,0,106
16,18,5,23,15,18,20,8,25,148
16,18,5,23,15,21,14,4,0,116
16,18,5,23,18,1,16,0,0,97
16,18,5,23,18,1,16,19,0,116
16,18,5,24,0,0,0,0,0,63
16,18,5,24,5,19,0,0,0,87
16,18,5,24,25,0,0,0,0,88
16,18,5,24,9,5,19,0,0,96
16,18,5,26,0,0,0,0,0,65
16,18,5,26,5,19,0,0,0,89
16,18,5,26,15,14,1,12,0,107
16,18,5,26,15,14,5,0,0,99
16,18,6,0,0,0,0,0,0,40
16,18,9,1,0,0,0,0,0,44
16,18,9,1,16,9,0,0,0,69
16,18,9,1,16,9,19,13,0,101
16,18,9,1,16,9,19,13,19,120
16,18,9,1,16,9,20,9,19,117
16,18,9,1,16,21,12,9,4,106
16,18,9,1,16,21,19,5,19,124
16,18,9,2,2,12,5,0,0,64
16,18,9,3,5,1,2,12,5,71
16,18,9,3,5,1,2,12,25,91
16,18,9,3,5,4,0,0,0,55
16,18,9,3,5,25,0,0,0,76
16,18,9,3,5,9,20,5,0,85
16,18,9,3,5,12,5,19,19,106
16,18,9,3,5,18,0,0,0,69
16,18,9,3,5,18,19,0,0,88
16,18,9,3,5,19,0,0,0,70
16,18,9,3,8,0,0,0,0,54
16,18,9,3,25,0,0,0,0,71
16,18,9,3,9,5,18,0,0,78
16,18,9,3,9,5,19,20,0,99
16,18,9,3,9,14,7,0,0,76
16,18,9,3,11,0,0,0,0,57
16,18,9,3,11,1,4,15,0,77
16,18,9,3,11,1,14,20,0,92
16,18,9,3,11,5,4,0,0,66
16,18,9,3,11,5,18,0,0,80
16,18,9,3,11,5,18,19,0,99
16,18,9,3,11,5,20,0,0,82
16,18,9,3,11,5,20,19,0,101
16,18,9,3,11,6,15,15,20,113
16,18,9,3,11,25,0,0,0,82
16,18,9,3,11,9,5,18,0,89
16,18,9,3,11,9,5,19,20,110
16,18,9,3,11,9,14,7,0,87
16,18,9,3,11,9,19,8,0,93
16,18,9,3,11,12,5,0,0,74
16,18,9,3,11,12,5,4,0,78
16,18,9,3,11,12,5,19,0,93
16,18,9,3,11,12,5,19,19,112
16,18,9,3,11,12,25,0,0,94
16,18,9,3,11,12,9,5,18,101
16,18,9,3,11,12,9,14,7,99
16,18,9,3,11,19,0,0,0,76
16,18,9,3,11,19,5,1,13,95
16,18,9,3,11,19,8,15,20,119
16,18,9,3,11,19,16,21,18,131
16,18,9,3,11,23,15,15,4,114
16,18,9,4,5,4,0,0,0,56
16,18,9,4,5,6,21,12,0,91
16,18,9,4,5,12,5,19,19,107
16,18,9,4,5,12,9,14,7,94
16,18,9,4,5,19,0,0,0,71
16,18,9,4,5,23,5,5,4,89
16,18,9,4,25,0,0,0,0,72
16,18,9,4,9,1,14,0,0,71
16,18,9,4,9,14,7,0,0,77
16,18,9,4,9,14,7,12,25,114
16,18,9,5,0,0,0,0,0,48
16,18,9,5,4,0,0,0,0,52
16,18,9,5,4,9,5,21,0,87
16,18,9,5,4,9,5,21,19,106
16,18,9,5,4,9,5,21,24,111
16,18,9,5,18,0,0,0,0,66
16,18,25,5,18,0,0,0,0,82
16,18,9,5,18,19,0,0,0,85
16,18,25,5,18,19,0,0,0,101
16,18,9,5,19,0,0,0,0,67
16,18,9,5,19,20,1,12,0,100
16,18,9,5,19,20,3,1,16,107
16,18,9,5,19,20,4,15,13,119
16,18,9,5,19,20,5,4,0,96
16,18,9,5,19,20,5,5,14,111
16,18,9,5,19,20,5,18,25,135
16,18,9,5,19,20,5,19,19,130
16,18,9,5,19,20,9,14,7,117
16,18,9,5,19,20,9,19,8,123
16,18,9,5,19,20,9,19,13,128
16,18,9,5,19,20,12,5,20,124
16,18,9,5,19,20,12,25,0,124
16,18,9,5,19,20,19,0,0,106
16,18,9,7,0,0,0,0,0,50
16,18,9,7,4,15,13,0,0,82
16,18,9,7,7,5,4,0,0,66
16,18,9,7,7,5,18,0,0,80
16,18,9,7,7,5,18,25,0,105
16,18,9,7,7,5,19,19,0,100
16,18,9,7,7,9,14,7,0,87
16,18,9,7,7,9,19,8,0,93
16,18,9,7,7,9,19,13,0,98
16,18,9,7,7,9,19,13,19,117
16,18,9,7,8,15,15,4,0,92
16,18,9,7,13,1,14,0,0,78
16,18,9,7,19,0,0,0,0,69
16,18,9,7,19,20,5,18,0,112
16,18,25,9,14,7,0,0,0,89
16,18,25,9,14,7,12,25,0,126
16,18,25,12,5,18,0,0,0,94
16,18,9,12,12,0,0,0,0,67
16,18,9,12,12,5,4,0,0,76
16,18,9,12,12,9,14,7,0,97
16,18,9,12,12,9,15,14,0,105
16,18,9,12,12,19,0,0,0,86
16,18,9,13,0,0,0,0,0,56
16,18,9,13,1,3,25,0,0,85
16,18,9,13,1,3,9,5,19,93
16,18,9,13,1,3,15,18,4,97
16,18,9,13,1,5,22,1,12,97
16,18,9,13,1,7,5,0,0,69
16,18,9,13,1,7,5,19,0,88
16,18,9,13,1,12,0,0,0,69
16,18,9,13,1,12,9,20,25,123
16,18,9,13,1,12,12,25,0,106
16,18,9,13,1,18,0,0,0,75
16,18,9,13,1,18,25,0,0,100
16,18,9,13,1,18,9,1,14,99
16,18,9,13,1,18,9,5,4,93
16,18,9,13,1,18,9,5,19,108
16,18,9,13,1,18,9,12,25,121
16,18,9,13,1,19,0,0,0,76
16,18,9,13,1,20,1,12,0,90
16,18,9,13,1,20,5,0,0,82
16,18,9,13,1,20,9,1,12,99
16,18,9,13,1,20,9,3,0,89
16,18,9,13,5,0,0,0,0,61
16,18,9,13,5,4,0,0,0,65
16,18,9,13,5,7,9,12,20,109
16,18,9,13,5,12,25,0,0,98
16,18,9,13,5,14,5,19,19,118
16,18,9,13,5,18,0,0,0,79
16,18,9,13,5,18,15,0,0,94
16,18,9,13,5,18,15,12,5,111
16,18,9,13,5,18,15,19,0,113
16,18,9,13,5,18,19,0,0,98
16,18,9,13,5,19,0,0,0,80
16,18,9,13,5,21,18,0,0,100
16,18,9,13,5,22,1,12,0,96
16,18,9,13,5,22,9,20,25,137
16,18,9,13,5,22,15,21,19,138
16,18,9,13,5,22,18,9,14,124
16,18,9,13,9,0,0,0,0,65
16,18,9,13,25,0,0,0,0,81
16,18,9,13,9,3,5,19,0,92
16,18,9,13,9,7,5,14,5,96
16,18,9,13,9,14,5,0,0,84
16,18,9,13,9,14,5,19,0,103
16,18,9,13,9,14,7,0,0,86
16,18,9,13,9,14,7,19,0,105
16,18,9,13,9,16,1,18,1,101
16,18,9,13,9,20,25,0,0,110
16,18,9,13,9,20,9,1,5,100
16,18,9,13,9,20,9,1,12,107
16,18,9,13,9,20,9,1,19,114
16,18,9,13,9,20,9,22,5,121
16,18,9,13,12,25,0,0,0,93
16,18,9,13,13,5,4,0,0,78
16,18,9,13,13,5,18,0,0,92
16,18,9,13,13,5,19,20,0,113
16,18,9,13,13,9,14,7,0,99
16,18,9,13,14,5,19,19,0,113
16,18,9,13,15,13,15,0,0,99
16,18,9,13,15,18,4,9,1,103
16,18,9,13,15,19,0,0,0,90
16,18,9,13,15,19,9,20,25,144
16,18,9,13,15,19,20,0,0,110
16,18,9,13,16,0,0,0,0,72
16,18,9,13,16,5,4,0,0,81
16,18,9,13,16,9,14,7,0,102
16,18,9,13,16,18,9,14,20,133
16,18,9,13,16,19,0,0,0,91
16,18,9,13,18,15,19,5,4,117
16,18,9,13,18,15,19,5,19,132
16,18,9,13,18,15,19,25,0,133
16,18,9,13,19,0,0,0,0,75
16,18,9,13,19,9,5,0,0,89
16,18,9,13,21,12,1,19,0,109
16,18,9,13,21,12,9,3,0,101
16,18,9,13,21,12,9,14,5,117
16,18,9,13,21,19,5,19,0,120
16,18,9,13,23,15,18,20,0,132
16,18,9,14,0,0,0,0,0,57
16,18,9,14,3,5,1,7,5,78
16,18,9,14,3,5,4,15,13,97
16,18,9,14,3,5,11,9,14,99
16,18,9,14,3,5,12,5,20,102
16,18,9,14,3,5,12,25,0,102
16,18,9,14,3,5,16,19,0,100
16,18,9,14,3,5,19,0,0,84
16,18,9,14,3,5,19,19,5,108
16,18,9,14,3,9,6,25,0,100
16,18,9,14,3,9,16,1,12,98
16,18,9,14,3,9,16,9,0,94
16,18,9,14,3,9,16,12,25,122
16,18,9,14,3,15,3,11,0,89
16,18,9,14,3,15,3,11,19,108
16,18,9,14,3,15,4,0,0,79
16,18,9,14,3,15,24,0,0,99
16,18,9,14,3,15,24,5,19,123
16,18,9,14,5,0,0,0,0,62
16,18,9,14,11,0,0,0,0,68
16,18,9,14,11,5,4,0,0,77
16,18,9,14,11,5,18,0,0,91
16,18,9,14,11,5,18,19,0,110
16,18,9,14,11,25,0,0,0,93
16,18,9,14,11,9,14,7,0,98
16,18,9,14,11,12,5,0,0,85
16,18,9,14,11,19,0,0,0,87
16,18,9,14,15,19,0,0,0,91
16,18,9,14,20,0,0,0,0,77
16,18,9,14,20,1,2,12,5,97
16,18,9,14,20,1,2,12,25,117
16,18,9,14,20,5,4,0,0,86
16,18,9,14,20,5,18,25,0,125
16,18,9,14,20,5,18,19,0,119
16,18,9,14,20,9,14,7,0,107
16,18,9,14,20,9,14,7,19,126
16,18,9,14,20,12,5,19,19,132
16,18,9,14,20,12,9,14,5,117
16,18,9,14,20,13,1,11,5,107
16,18,9,14,20,15,21,20,0,133
16,18,9,14,20,15,21,20,19,152
16,18,9,14,20,19,0,0,0,96
16,18,9,14,20,19,8,15,16,135
16,18,9,15,0,0,0,0,0,58
16,18,9,15,4,15,14,20,0,111
16,18,9,15,14,0,0,0,0,72
16,18,9,15,14,9,4,0,0,85
16,18,9,15,14,9,14,5,0,100
16,18,9,15,18,1,3,25,0,105
16,18,9,15,18,1,12,0,0,89
16,18,9,15,18,1,20,5,0,102
16,18,9,15,18,1,20,5,19,121
16,18,9,15,18,5,19,19,0,119
16,18,9,15,18,9,0,0,0,85
16,18,9,15,18,25,0,0,0,101
16,18,9,15,18,9,5,19,0,109
16,18,9,15,18,9,20,5,0,110
16,18,9,15,18,9,20,25,0,130
16,18,9,15,18,12,25,0,0,113
16,18,9,15,18,19,0,0,0,95
16,18,9,15,18,19,8,9,16,128
16,18,25,16,18,15,15,6,0,129
16,18,25,19,0,0,0,0,0,78
16,18,9,19,1,2,12,5,0,82
16,18,9,19,1,7,5,0,0,75
16,18,9,19,1,12,0,0,0,75
16,18,9,19,3,1,14,0,0,80
16,18,9,19,5,0,0,0,0,67
16,18,9,19,5,4,0,0,0,71
16,18,9,19,5,18,5,0,0,90
16,18,9,19,5,18,5,19,0,109
16,18,9,19,5,19,0,0,0,86
16,18,9,19,9,1,4,11,1,88
16,18,9,19,9,14,7,0,0,92
16,18,9,19,13,1,12,0,0,88
16,18,9,19,13,1,20,9,3,108
16,18,9,19,13,5,4,0,0,84
16,18,9,19,13,25,0,0,0,100
16,18,9,19,13,15,9,4,0,103
16,18,9,19,13,15,9,4,19,122
16,18,9,19,13,19,0,0,0,94
16,18,9,19,15,14,0,0,0,91
16,18,9,19,15,14,4,15,13,123
16,18,9,19,15,14,5,4,0,100
16,18,9,19,15,14,5,18,0,114
16,18,9,19,15,14,5,18,19,133
16,18,9,19,15,14,6,21,12,130
16,18,9,19,15,14,9,14,7,121
16,18,9,19,15,14,15,21,19,146
16,18,9,19,15,14,19,0,0,110
16,18,9,19,19,0,0,0,0,81
16,18,9,19,19,5,4,0,0,90
16,18,9,19,19,5,19,0,0,105
16,18,9,19,19,9,5,18,0,113
16,18,9,19,19,9,5,19,0,114
16,18,9,19,19,9,5,19,20,134
16,18,9,19,19,9,12,25,0,127
16,18,9,19,19,9,14,7,0,111
16,18,9,19,20,1,14,5,0,102
16,18,9,19,20,1,14,5,19,121
16,18,9,19,20,1,22,0,0,105
16,18,9,19,20,1,23,0,0,106
16,18,9,19,20,9,14,5,0,110
16,18,25,20,1,14,5,21,13,133
16,18,25,20,1,14,25,0,0,119
16,18,25,20,1,14,9,26,5,134
16,18,9,20,3,8,0,0,0,74
16,18,9,20,3,8,5,12,0,91
16,18,9,20,8,5,5,0,0,81
16,18,25,20,8,5,5,0,0,97
16,18,9,20,20,12,5,0,0,100
16,18,9,21,19,0,0,0,0,83
16,18,9,22,0,0,0,0,0,65
16,18,9,22,1,3,25,0,0,94
16,18,9,22,1,3,9,5,19,102
16,18,9,22,1,3,9,20,25,123
16,18,9,22,1,4,15,0,0,85
16,18,9,22,1,14,20,0,0,100
16,18,9,22,1,20,1,0,0,87
16,18,9,22,1,20,5,0,0,91
16,18,9,22,1,20,5,5,18,114
16,18,9,22,1,20,5,12,25,128
16,18,9,22,1,20,5,18,0,109
16,18,9,22,1,20,5,19,0,110
16,18,9,22,1,20,5,19,20,130
16,18,9,22,1,20,9,15,14,124
16,18,9,22,1,20,9,19,13,127
16,18,9,22,1,20,9,22,5,122
16,18,9,22,1,20,9,26,5,126
16,18,9,22,1,20,21,13,0,120
16,18,9,22,5,20,0,0,0,90
16,18,9,22,5,20,19,0,0,109
16,18,9,22,25,0,0,0,0,90
16,18,9,22,9,5,18,0,0,97
16,18,9,22,9,5,19,0,0,98
16,18,9,22,9,5,19,20,0,118
16,18,9,22,9,12,5,7,5,103
16,18,9,22,9,12,25,0,0,111
16,18,9,22,9,14,5,19,19,131
16,18,9,22,9,20,25,0,0,119
16,18,9,22,9,20,9,5,19,127
16,18,9,26,1,2,12,5,0,89
16,18,9,26,5,0,0,0,0,74
16,18,9,26,5,1,2,12,5,94
16,18,9,26,5,4,0,0,0,78
16,18,9,26,5,13,1,14,0,102
16,18,9,26,5,13,5,14,0,106
16,18,9,26,5,18,0,0,0,92
16,18,9,26,5,18,25,0,0,117
16,18,9,26,5,18,19,0,0,111
16,18,9,26,5,19,0,0,0,93
16,18,9,26,9,14,7,0,0,99
16,18,12,1,20,5,0,0,0,72
16,18,14,0,0,0,0,0,0,48
16,18,15,1,0,0,0,0,0,50
16,18,15,1,3,8,0,0,0,61
16,18,15,1,3,20,9,14,7,103
16,18,15,1,3,20,9,15,14,111
16,18,15,1,3,20,9,22,5,109
16,18,15,1,3,20,15,18,0,106
16,18,15,1,7,15,14,0,0,86
16,18,15,1,7,15,14,5,19,110
16,18,15,1,7,21,12,5,0,95
16,18,15,1,12,0,0,0,0,62
16,18,15,1,12,9,5,14,0,90
16,18,15,1,13,14,9,15,14,115
16,18,15,1,18,3,20,9,3,103
16,18,15,1,18,13,25,0,0,106
16,18,15,1,18,20,0,0,0,88
16,18,15,1,19,0,0,0,0,69
16,18,15,1,20,12,1,19,0,102
16,18,15,1,20,20,1,3,11,105
16,18,15,1,21,12,9,15,14,121
16,18,15,1,21,20,8,15,18,132
16,18,15,1,22,9,1,14,0,96
16,18,15,1,23,1,18,4,0,96
16,18,15,2,0,0,0,0,0,51
16,18,15,2,1,2,12,0,0,66
16,18,15,2,1,2,12,5,0,71
16,18,15,2,1,2,12,25,0,91
16,18,15,2,1,12,0,0,0,64
16,18,15,2,1,14,4,0,0,70
16,18,15,2,1,14,4,9,0,79
16,18,15,2,1,14,4,19,0,89
16,18,15,2,1,14,7,0,0,73
16,18,15,2,1,14,7,19,0,92
16,18,15,2,1,14,20,0,0,86
16,18,15,2,1,20,1,0,0,73
16,18,15,2,1,20,5,0,0,77
16,18,15,2,1,20,5,4,0,81
16,18,15,2,1,20,5,19,0,96
16,18,15,2,1,20,9,14,7,102
16,18,15,2,1,20,9,15,14,110
16,18,15,2,1,20,9,22,5,108
16,18,15,2,1,20,15,18,0,105
16,18,15,2,1,20,15,18,25,130
16,18,15,2,1,20,20,12,5,109
16,18,15,2,1,20,21,13,0,106
16,18,15,2,5,0,0,0,0,56
16,18,15,2,5,1,2,12,5,76
16,18,15,2,5,4,0,0,0,60
16,18,15,2,5,5,18,0,0,79
16,18,15,2,5,18,19,0,0,93
16,18,15,2,5,19,0,0,0,75
16,18,15,2,9,14,7,0,0,81
16,18,15,2,9,14,7,19,0,100
16,18,15,2,9,20,0,0,0,80
16,18,15,2,9,20,25,0,0,105
16,18,15,2,9,20,9,5,19,113
16,18,15,2,9,20,19,0,0,99
16,18,15,2,12,5,13,0,0,81
16,18,15,2,12,5,13,19,0,100
16,18,15,2,15,14,21,19,0,120
16,18,15,2,15,19,3,9,19,116
16,18,15,2,15,24,9,14,7,120
16,18,15,2,18,9,3,11,0,92
16,18,15,2,18,9,4,7,5,94
16,18,15,2,21,4,7,5,20,108
16,18,15,2,21,25,9,14,7,127
16,18,15,3,0,0,0,0,0,52
16,18,15,3,1,3,3,9,1,69
16,18,15,3,1,3,3,9,15,83
16,18,15,3,1,3,9,20,25,110
16,18,15,3,1,9,14,5,0,81
16,18,15,3,1,9,14,5,19,100
16,18,15,3,1,14,1,12,0,80
16,18,15,3,1,18,16,0,0,87
16,18,15,3,1,18,16,19,0,106
16,18,15,3,2,1,12,0,0,67
16,18,15,3,5,4,5,19,0,85
16,18,15,3,5,4,21,18,5,105
16,18,15,3,5,5,4,0,0,66
16,18,15,3,5,5,4,5,4,75
16,18,15,3,5,5,4,5,18,89
16,18,15,3,5,5,4,19,0,85
16,18,15,3,5,12,12,1,19,101
16,18,15,3,5,12,12,15,0,96
16,18,15,3,5,18,5,0,0,80
16,18,15,3,5,18,5,1,12,93
16,18,15,3,5,18,5,19,0,99
16,18,15,3,5,18,9,20,5,109
16,18,15,3,5,18,9,20,25,129
16,18,15,3,5,18,21,19,0,115
16,18,15,3,5,19,19,0,0,95
16,18,15,3,5,19,19,1,12,108
16,18,15,3,5,19,19,5,4,104
16,18,15,3,5,19,19,5,18,118
16,18,15,3,5,19,19,5,19,119
16,18,15,3,5,19,19,15,18,128
16,18,15,3,5,19,19,21,19,135
16,18,15,3,8,1,9,14,0,84
16,18,15,3,8,5,9,14,0,88
16,18,15,3,8,15,15,9,0,99
16,18,15,3,8,15,15,19,0,109
16,18,15,3,8,21,18,3,8,110
16,18,15,3,9,4,5,14,20,104
16,18,15,3,9,14,3,20,0,98
16,18,15,3,9,20,25,0,0,106
16,18,15,3,9,22,9,3,0,95
16,18,15,3,9,22,9,19,13,124
16,18,15,3,12,1,9,13,0,87
16,18,15,3,12,1,9,13,19,106
16,18,15,3,12,5,9,0,0,78
16,18,15,3,12,5,18,7,25,119
16,18,15,3,12,9,13,1,24,111
16,18,15,3,12,9,14,5,0,92
16,18,15,3,12,9,19,9,19,120
16,18,15,3,12,9,20,9,3,105
16,18,15,3,12,9,22,5,0,100
16,18,15,3,15,13,2,1,20,103
16,18,15,3,15,13,5,4,25,114
16,18,15,3,15,14,19,21,12,133
16,18,15,3,15,20,15,12,19,133
16,18,15,3,15,20,20,15,14,136
16,18,15,3,15,21,18,20,0,126
16,18,15,3,18,5,1,14,20,110
16,18,15,3,18,5,1,20,5,101
16,18,15,3,18,9,20,9,3,111
16,18,15,3,20,1,12,0,0,85
16,18,15,3,20,1,12,7,25,117
16,18,15,3,20,9,20,9,19,129
16,18,15,3,20,15,4,5,1,97
16,18,15,3,20,15,18,1,12,118
16,18,15,3,20,15,18,5,4,114
16,18,15,3,20,15,18,19,0,124
16,18,15,3,21,18,1,3,25,120
16,18,15,3,21,18,1,12,0,104
16,18,15,3,21,18,1,12,19,123
16,18,15,3,21,18,1,20,5,117
16,18,15,3,21,18,5,0,0,96
16,18,15,3,21,18,5,4,0,100
16,18,15,3,21,18,5,18,0,114
16,18,15,3,21,18,5,18,19,133
16,18,15,3,21,18,5,19,0,115
16,18,15,3,21,18,5,19,19,134
16,18,15,3,21,18,5,21,18,135
16,18,15,3,21,18,9,14,7,121
16,18,15,3,21,18,22,5,4,122
16,18,15,4,0,0,0,0,0,53
16,18,15,4,1,20,1,18,25,118
16,18,15,4,4,0,0,0,0,57
16,18,15,4,4,5,4,0,0,66
16,18,15,4,4,5,18,0,0,80
16,18,15,4,4,5,18,19,0,99
16,18,15,4,4,9,14,7,0,87
16,18,15,4,4,12,5,0,0,74
16,18,15,4,5,12,1,25,0,96
16,18,15,4,9,7,1,12,0,82
16,18,15,4,9,7,1,12,19,101
16,18,15,4,9,7,25,0,0,94
16,18,15,4,9,7,9,5,19,102
16,18,15,4,9,7,21,19,0,109
16,18,15,4,9,20,9,15,14,120
16,18,15,4,9,20,15,18,0,115
16,18,15,4,15,13,15,9,0,105
16,18,15,4,15,13,15,19,0,115
16,18,15,4,16,18,15,15,6,123
16,18,15,4,18,15,13,1,0,100
16,18,15,4,18,15,13,1,12,112
16,18,15,4,18,15,13,5,0,104
16,18,15,4,18,15,13,5,19,123
16,18,15,4,18,15,13,9,3,111
16,18,15,4,18,15,13,21,19,139
16,18,15,4,19,0,0,0,0,72
16,18,15,4,21,3,1,12,0,90
16,18,15,4,21,3,5,0,0,82
16,18,15,4,21,3,5,4,0,86
16,18,15,4,21,3,5,14,20,116
16,18,15,4,21,3,5,18,0,100
16,18,15,4,21,3,5,18,19,119
16,18,15,4,21,3,5,19,0,101
16,18,15,4,21,3,9,14,7,107
16,18,15,4,21,3,20,0,0,97
16,18,15,4,21,3,20,5,4,106
16,18,15,4,21,3,20,9,4,110
16,18,15,4,21,3,20,15,18,130
16,18,15,4,21,3,20,19,0,116
16,18,15,5,13,0,0,0,0,67
16,18,15,5,13,2,18,25,15,127
16,18,15,5,13,9,1,12,0,89
16,18,15,5,13,9,21,13,0,110
16,18,15,5,13,16,9,18,5,115
16,18,15,5,13,19,0,0,0,86
16,18,15,5,14,26,25,13,0,132
16,18,15,5,14,26,25,13,5,137
16,18,15,5,19,20,18,21,19,151
16,18,15,5,20,8,14,9,3,108
16,18,15,5,20,9,4,0,0,87
16,18,15,5,20,20,5,0,0,99
16,18,15,5,20,20,5,19,0,118
16,18,15,5,24,16,5,18,20,137
16,18,15,6,1,3,5,0,0,64
16,18,15,6,1,14,5,0,0,75
16,18,15,6,1,14,5,4,0,79
16,18,15,6,1,14,5,12,25,112
16,18,15,6,1,14,5,18,0,93
16,18,15,6,1,14,5,18,19,112
16,18,15,6,1,14,5,19,0,94
16,18,15,6,1,14,9,14,7,100
16,18,15,6,1,14,9,19,13,111
16,18,15,6,1,14,9,20,25,124
16,18,15,6,1,14,9,26,5,110
16,18,15,6,1,18,13,5,18,110
16,18,15,6,5,18,0,0,0,78
16,18,15,6,5,18,20,0,0,98
16,18,15,6,5,19,19,0,0,98
16,18,15,6,5,19,19,5,4,107
16,18,15,6,5,19,19,5,19,122
16,18,15,6,5,19,19,15,18,131
16,18,15,6,6,5,18,0,0,84
16,18,15,6,6,5,18,5,4,93
16,18,15,6,6,5,18,5,18,107
16,18,15,6,6,5,18,19,0,103
16,18,15,6,9,3,8,9,0,84
16,18,15,6,9,12,5,0,0,81
16,18,15,6,9,12,5,4,0,85
16,18,15,6,9,12,5,18,0,99
16,18,15,6,9,12,5,18,19,118
16,18,15,6,9,12,5,19,0,100
16,18,15,6,9,12,9,14,7,106
16,18,15,6,9,12,9,19,20,124
16,18,15,6,9,20,0,0,0,84
16,18,15,6,9,20,5,4,0,93
16,18,15,6,9,20,5,5,18,112
16,18,15,6,9,20,5,18,0,107
16,18,15,6,9,20,5,18,19,126
16,18,15,6,9,20,9,14,7,114
16,18,15,6,9,20,19,0,0,103
16,18,15,6,9,20,20,5,4,113
16,18,15,6,9,20,20,5,18,127
16,18,15,6,12,1,20,5,4,97
16,18,15,6,12,21,5,14,20,127
16,18,15,6,15,14,4,5,0,93
16,18,15,6,15,18,13,1,0,102
16,18,15,6,15,21,14,4,0,109
16,18,15,6,15,21,14,4,19,128
16,18,15,6,18,5,0,0,0,78
16,18,15,6,21,7,1,20,5,109
16,18,15,6,21,14,4,1,0,95
16,18,15,6,21,14,4,1,5,100
16,18,15,6,21,19,5,0,0,100
16,18,15,6,21,19,5,12,25,137
16,18,15,6,21,19,5,18,0,118
16,18,15,6,21,19,9,15,14,133
16,18,15,6,21,19,9,22,5,131
16,18,15,7,1,13,5,20,5,100
16,18,15,7,1,13,9,3,0,82
16,18,15,7,5,14,25,0,0,100
16,18,15,7,5,14,9,5,19,108
16,18,15,7,5,14,9,20,25,129
16,18,15,7,5,18,9,1,0,89
16,18,15,7,5,19,20,9,14,123
16,18,15,7,7,5,4,0,0,72
16,18,15,7,7,5,18,0,0,86
16,18,15,7,7,5,18,19,0,105
16,18,15,7,7,9,14,7,0,93
16,18,15,7,25,16,19,25,0,141
16,18,15,7,14,1,20,8,9,108
16,18,15,7,14,1,20,8,25,124
16,18,15,7,14,5,0,0,0,75
16,18,15,7,14,15,19,5,0,109
16,18,15,7,14,15,19,5,4,113
16,18,15,7,14,15,19,5,19,128
16,18,15,7,14,15,19,9,19,132
16,18,15,7,15,19,16,5,12,123
16,18,15,7,18,1,4,5,0,84
16,18,15,7,18,1,13,0,0,88
16,18,15,7,18,1,13,5,4,97
16,18,15,7,18,1,13,5,18,111
16,18,15,7,18,1,13,13,1,102
16,18,15,7,18,1,13,13,5,106
16,18,15,7,18,1,13,19,0,107
16,18,15,7,18,1,22,9,4,110
16,18,15,7,18,5,4,5,0,88
16,18,15,7,18,5,19,19,0,117
16,18,15,7,19,0,0,0,0,75
16,18,15,8,1,19,20,5,0,102
16,18,15,8,5,9,13,0,0,84
16,18,15,8,9,2,9,20,0,97
16,18,15,8,9,2,9,20,1,98
16,18,15,8,9,2,9,20,19,116
16,18,15,8,21,13,1,14,0,106
16,18,15,10,5,3,20,0,0,87
16,18,15,10,5,3,20,5,4,96
16,18,15,10,5,3,20,15,18,120
16,18,15,10,5,3,20,19,0,106
16,18,15,10,5,20,0,0,0,84
16,18,15,10,5,20,19,0,0,103
16,18,15,11,5,0,0,0,0,65
16,18,15,11,5,18,0,0,0,83
16,18,15,12,1,2,9,21,13,107
16,18,15,12,1,2,15,18,0,97
16,18,15,12,1,3,20,9,14,108
16,18,15,12,1,13,9,14,0,98
16,18,15,12,1,13,9,14,5,103
16,18,15,12,1,13,9,14,19,117
16,18,15,12,1,14,0,0,0,76
16,18,15,12,1,14,19,0,0,95
16,18,15,12,1,16,19,5,0,102
16,18,15,12,1,16,19,5,4,106
16,18,15,12,1,16,19,5,19,121
16,18,15,12,1,16,19,21,19,137
16,18,15,12,1,18,22,1,0,103
16,18,15,12,1,18,22,1,12,115
16,18,15,12,1,20,5,0,0,87
16,18,15,12,1,20,5,12,25,124
16,18,15,12,1,20,9,15,14,120
16,18,15,12,1,20,9,22,5,118
16,18,15,12,5,1,7,21,5,100
16,18,15,12,5,7,0,0,0,73
16,18,15,12,5,7,1,20,5,99
16,18,15,12,5,7,19,0,0,92
16,18,15,12,5,16,19,5,19,125
16,18,15,12,5,16,19,9,19,129
16,18,15,12,5,16,20,9,3,114
16,18,15,12,5,19,0,0,0,85
16,18,15,12,5,20,1,18,25,130
16,18,15,12,9,1,0,0,0,71
16,18,15,12,9,3,9,4,5,91
16,18,15,12,9,6,25,0,0,101
16,18,15,12,9,6,9,3,0,88
16,18,15,12,9,6,9,3,25,113
16,18,15,12,25,12,0,0,0,98
16,18,15,12,9,14,0,0,0,84
16,18,15,12,9,14,5,0,0,89
16,18,15,12,9,14,5,19,0,108
16,18,15,12,9,17,21,15,18,141
16,18,15,12,9,24,0,0,0,94
16,18,15,12,9,24,9,20,25,148
16,18,15,12,9,24,12,25,0,131
16,18,15,12,12,5,18,0,0,96
16,18,15,12,15,7,5,4,0,92
16,18,15,12,15,7,9,0,0,92
16,18,15,12,15,7,9,14,7,113
16,18,15,12,15,7,9,19,5,116
16,18,15,12,15,7,9,19,20,131
16,18,15,12,15,7,9,26,5,123
16,18,15,12,15,7,15,19,0,117
16,18,15,12,15,7,19,0,0,102
16,18,15,12,15,7,21,5,0,109
16,18,15,12,15,7,21,5,4,113
16,18,15,12,15,7,21,5,18,127
16,18,15,12,15,7,21,5,19,128
16,18,15,12,15,7,21,19,0,123
16,18,15,12,15,14,7,0,0,97
16,18,15,12,15,14,7,5,0,102
16,18,15,12,15,14,7,5,4,106
16,18,15,12,15,14,7,5,18,120
16,18,15,12,15,14,7,5,19,121
16,18,15,12,15,14,7,19,0,116
16,18,15,12,21,19,9,15,14,139
16,18,15,12,21,19,15,18,25,159
16,18,15,13,1,3,8,15,19,108
16,18,15,13,1,13,13,1,12,102
16,18,15,13,1,26,9,14,5,117
16,18,15,13,5,14,1,4,5,91
16,18,15,13,5,18,3,25,0,113
16,18,15,13,5,18,7,5,18,115
16,18,15,13,5,18,9,20,0,114
16,18,15,13,5,18,15,16,19,135
16,18,15,13,9,3,0,0,0,74
16,18,15,13,9,14,5,0,0,90
16,18,15,13,9,14,5,14,20,124
16,18,15,13,9,14,5,19,0,109
16,18,15,13,9,19,5,0,0,95
16,18,15,13,9,19,5,4,0,99
16,18,15,13,9,19,5,5,0,100
16,18,15,13,9,19,5,5,19,119
16,18,15,13,9,19,5,18,0,113
16,18,15,13,9,19,5,18,19,132
16,18,15,13,9,19,5,19,0,114
16,18,15,13,9,19,9,14,7,120
16,18,15,13,9,19,15,18,0,123
16,18,15,13,9,19,15,18,19,142
16,18,15,13,9,19,19,0,0,109
16,18,15,13,9,19,19,15,18,142
16,18,15,13,9,20,0,0,0,91
16,18,15,13,25,20,8,9,3,127
16,18,15,13,9,20,20,15,18,144
16,18,15,13,14,5,19,9,1,110
16,18,15,13,15,0,0,0,0,77
16,18,15,13,15,4,5,18,14,118
16,18,15,13,15,18,1,12,0,108
16,18,15,13,15,18,16,8,0,119
16,18,15,13,15,19,0,0,0,96
16,18,15,13,15,20,5,0,0,102
16,18,15,13,15,20,5,4,0,106
16,18,15,13,15,20,5,18,0,120
16,18,15,13,15,20,5,18,19,139
16,18,15,13,15,20,5,19,0,121
16,18,15,13,15,20,9,14,7,127
16,18,15,13,15,20,9,15,14,135
16,18,15,13,15,20,9,22,5,133
16,18,15,13,15,20,15,18,0,130
16,18,15,13,15,20,18,9,24,148
16,18,15,13,15,22,1,12,0,112
16,18,15,13,15,22,5,0,0,104
16,18,15,13,15,22,5,14,20,138
16,18,15,13,16,20,0,0,0,98
16,18,15,13,16,20,5,4,0,107
16,18,15,13,16,20,5,18,0,121
16,18,15,13,16,20,5,18,19,140
16,18,15,13,16,20,5,19,20,142
16,18,15,13,16,20,9,14,7,128
16,18,15,13,16,20,9,22,5,134
16,18,15,13,16,20,12,25,0,135
16,18,15,13,16,20,19,0,0,117
16,18,15,13,16,20,21,18,5,142
16,18,15,13,19,0,0,0,0,81
16,18,15,13,21,12,7,5,0,107
16,18,15,13,21,12,7,5,4,111
16,18,15,13,21,12,7,5,18,125
16,18,15,13,21,12,7,5,19,126
16,18,15,13,21,19,3,9,19,133
16,18,15,14,0,0,0,0,0,63
16,18,15,14,1,15,9,0,0,88
16,18,15,14,1,15,19,0,0,98
16,18,15,14,1,20,5,0,0,89
16,18,15,14,1,20,5,4,0,93
16,18,15,14,1,20,5,19,0,108
16,18,15,14,1,20,9,14,7,114
16,18,15,14,1,20,9,15,14,122
16,18,15,14,1,20,9,22,5,120
16,18,15,14,1,20,15,18,0,117
16,18,15,14,1,20,15,18,19,136
16,18,15,14,1,22,1,12,0,99
16,18,15,14,1,22,25,0,0,111
16,18,15,14,5,0,0,0,0,68
16,18,15,14,5,7,18,15,0,108
16,18,15,14,5,12,25,0,0,105
16,18,15,14,5,14,5,19,19,125
16,18,15,14,5,21,18,0,0,107
16,18,15,14,7,0,0,0,0,70
16,18,15,14,7,2,21,3,11,107
16,18,15,14,7,5,4,0,0,79
16,18,15,14,7,5,18,0,0,93
16,18,15,14,7,8,15,18,14,125
16,18,15,14,7,25,0,0,0,95
16,18,15,14,7,9,14,7,0,100
16,18,15,14,7,12,9,11,5,107
16,18,15,14,7,19,0,0,0,89
16,18,15,14,9,3,0,0,0,75
16,18,15,14,25,13,16,8,0,125
16,18,15,14,9,20,25,0,0,117
16,18,15,14,15,13,9,1,12,113
16,18,15,14,15,14,3,5,0,100
16,18,15,14,15,20,1,0,0,99
16,18,15,14,15,20,1,12,0,111
16,18,15,14,15,20,21,13,0,132
16,18,15,14,15,21,14,0,0,113
16,18,15,14,15,21,14,1,12,126
16,18,15,14,15,21,14,3,5,121
16,18,15,14,15,21,14,19,0,132
16,18,15,14,16,12,0,0,0,91
16,18,15,14,20,15,0,0,0,98
16,18,15,14,21,2,9,1,12,108
16,18,15,14,21,3,12,5,9,113
16,18,15,14,21,13,2,5,18,122
16,18,15,15,0,0,0,0,0,64
16,18,15,15,4,5,0,0,0,73
16,18,15,15,5,13,9,1,3,95
16,18,15,15,5,13,9,15,14,120
16,18,15,15,5,13,9,21,13,125
16,18,15,15,6,0,0,0,0,70
16,18,15,15,6,5,4,0,0,79
16,18,15,15,6,5,18,0,0,93
16,18,15,15,6,5,18,19,0,112
16,18,15,15,6,6,21,12,0,109
16,18,15,15,6,25,0,0,0,95
16,18,15,15,6,9,14,7,0,100
16,18,15,15,6,12,5,19,19,125
16,18,15,15,6,12,9,11,5,107
16,18,15,15,6,14,5,19,19,127
16,18,15,15,6,18,5,1,4,98
16,18,15,15,6,18,15,15,13,131
16,18,15,15,6,19,0,0,0,89
16,18,15,16,0,0,0,0,0,65
16,18,15,16,1,7,1,14,4,92
16,18,15,16,1,7,1,20,5,99
16,18,15,16,1,7,15,0,0,88
16,18,15,16,1,7,21,12,1,107
16,18,15,16,1,7,21,12,5,111
16,18,15,16,1,12,5,0,0,83
16,18,15,16,1,14,5,0,0,85
16,18,15,16,1,14,5,19,0,104
16,18,15,16,1,14,15,12,0,107
16,18,15,16,1,14,15,14,5,114
16,18,15,16,1,16,9,19,20,130
16,18,15,16,1,18,5,14,20,123
16,18,15,16,1,18,7,25,12,128
16,18,15,16,1,18,9,1,14,108
16,18,15,16,5,12,0,0,0,82
16,18,15,16,5,12,12,5,4,103
16,18,15,16,5,12,12,5,18,117
16,18,15,16,5,12,12,15,18,127
16,18,15,16,5,12,19,0,0,101
16,18,15,16,5,14,4,0,0,88
16,18,15,16,5,14,4,5,4,97
16,18,15,16,5,14,4,19,0,107
16,18,15,16,5,14,5,0,0,89
16,18,15,16,5,14,5,19,0,108
16,18,15,16,5,14,25,12,0,121
16,18,15,16,5,14,15,9,3,111
16,18,15,16,5,14,15,12,0,111
16,18,15,16,5,14,15,12,19,130
16,18,15,16,5,14,19,5,0,108
16,18,15,16,5,18,0,0,0,88
16,18,15,16,5,18,4,9,14,115
16,18,15,16,5,18,5,18,0,111
16,18,15,16,5,18,5,19,20,132
16,18,15,16,5,18,12,25,0,125
16,18,15,16,5,18,19,0,0,107
16,18,15,16,5,18,20,25,0,133
16,18,15,16,8,1,7,5,0,86
16,18,15,16,8,1,7,5,19,105
16,18,15,16,8,1,19,5,0,98
16,18,15,16,8,1,19,5,19,117
16,18,15,16,8,1,19,9,3,105
16,18,15,16,8,1,19,9,19,121
16,18,15,16,8,5,3,25,0,106
16,18,15,16,8,5,19,25,0,122
16,18,15,16,8,5,20,9,3,110
16,18,15,16,8,5,20,18,25,141
16,18,15,16,8,25,12,12,0,122
16,18,15,16,8,12,15,5,13,118
16,18,15,16,8,15,18,9,3,118
16,18,15,16,25,12,0,0,0,102
16,18,15,16,25,12,1,0,0,103
16,18,15,16,25,12,1,5,1,109
16,18,15,16,25,12,5,14,5,126
16,18,15,16,25,12,9,3,0,114
16,18,15,16,25,12,9,20,5,136
16,18,15,16,25,12,15,14,0,131
16,18,15,16,25,12,19,0,0,121
16,18,15,16,9,14,5,0,0,93
16,18,15,16,25,14,5,0,0,109
16,18,15,16,9,14,5,4,0,97
16,18,15,16,9,14,5,19,0,112
16,18,15,16,9,14,9,14,7,118
16,18,15,16,9,14,15,9,3,115
16,18,15,16,25,14,15,9,3,131
16,18,15,16,9,14,17,21,5,131
16,18,15,16,9,15,0,0,0,89
16,18,15,16,9,15,12,9,3,113
16,18,15,16,9,15,14,5,0,108
16,18,15,16,9,15,14,9,3,115
16,18,15,16,9,15,14,25,12,140
16,18,15,16,9,20,9,1,12,116
16,18,15,16,10,5,20,0,0,100
16,18,15,16,10,5,20,19,0,119
16,18,15,16,12,1,19,13,0,110
16,18,15,16,12,1,19,13,1,111
16,18,15,16,12,5,19,19,0,120
16,18,15,16,12,5,24,0,0,106
16,18,15,16,12,5,24,21,19,146
16,18,15,16,13,1,14,0,0,93
16,18,15,16,13,5,14,0,0,97
16,18,15,16,15,4,5,1,12,102
16,18,15,16,15,4,5,15,14,118
16,18,15,16,15,4,5,21,13,123
16,18,15,16,15,4,9,1,12,106
16,18,15,16,15,4,9,20,5,118
16,18,15,16,15,4,9,21,13,127
16,18,15,16,15,12,9,19,0,120
16,18,15,16,15,12,9,26,5,132
16,18,15,16,15,13,1,0,0,94
16,18,15,16,15,13,1,20,1,115
16,18,15,16,15,14,5,0,0,99
16,18,15,16,15,14,5,4,0,103
16,18,15,16,15,14,5,14,20,133
16,18,15,16,15,14,5,18,0,117
16,18,15,16,15,14,5,19,0,118
16,18,15,16,15,14,9,14,7,124
16,18,15,16,15,14,19,0,0,113
16,18,15,16,15,16,5,18,25,144
16,18,15,16,15,18,20,0,0,118
16,18,15,16,15,19,0,0,0,99
16,18,15,16,15,19,1,12,0,112
16,18,15,16,15,19,1,12,19,131
16,18,15,16,15,19,1,14,20,134
16,18,15,16,15,19,5,0,0,104
16,18,15,16,15,19,5,4,0,108
16,18,15,16,15,19,5,18,0,122
16,18,15,16,15,19,5,18,19,141
16,18,15,16,15,19,5,19,0,123
16,18,15,16,15,19,9,14,7,129
16,18,15,16,15,19,9,20,9,137
16,18,15,16,15,21,14,4,0,119
16,18,15,16,15,21,14,4,19,138
16,18,15,16,15,24,25,0,0,129
16,18,15,16,16,1,7,5,0,94
16,18,15,16,16,5,4,0,0,90
16,18,15,16,16,5,18,0,0,104
16,18,15,16,16,9,14,7,0,111
16,18,15,16,18,0,0,0,0,83
16,18,15,16,18,5,20,15,18,141
16,18,15,16,18,9,1,0,0,93
16,18,15,16,18,9,5,20,25,142
16,18,15,16,18,9,21,13,0,126
16,18,15,16,18,15,6,9,20,133
16,18,15,16,19,0,0,0,0,84
16,18,15,16,20,5,18,0,0,108
16,18,15,16,20,15,19,5,4,128
16,18,15,16,20,15,19,5,19,143
16,18,15,16,20,15,19,9,19,147
16,18,15,16,21,7,14,0,0,107
16,18,15,16,21,7,14,5,18,130
16,18,15,16,21,12,19,5,0,122
16,18,15,16,21,12,19,15,18,150
16,18,15,16,21,16,1,0,0,103
16,18,15,16,21,16,1,12,0,115
16,18,15,16,23,15,15,4,0,122
16,18,15,18,1,3,9,14,7,101
16,18,15,18,1,20,1,0,0,89
16,18,15,18,1,20,5,0,0,93
16,18,15,18,1,20,5,4,0,97
16,18,15,18,1,20,5,18,0,111
16,18,15,18,1,20,5,19,0,112
16,18,15,18,1,20,9,14,7,118
16,18,15,18,1,20,9,15,14,126
16,18,15,18,5,0,0,0,0,72
16,18,15,18,5,1,4,5,18,100
16,18,15,18,5,1,14,0,0,87
16,18,15,18,5,2,1,20,5,100
16,18,15,18,5,2,5,12,0,91
16,18,15,18,5,3,1,12,12,100
16,18,15,18,5,3,20,15,18,128
16,18,15,18,5,6,15,18,13,124
16,18,15,18,5,7,5,14,20,118
16,18,15,18,5,24,0,0,0,96
16,18,15,18,8,9,14,1,12,111
16,18,15,18,9,20,21,1,12,130
16,18,15,18,15,7,1,20,5,115
16,18,15,18,15,7,21,5,0,115
16,18,15,18,15,7,21,5,4,119
16,18,15,18,15,7,21,5,18,133
16,18,15,18,15,7,21,5,19,134
16,18,15,18,15,25,1,12,0,120
16,18,15,18,19,1,4,0,0,91
16,18,15,18,19,1,12,0,0,99
16,18,15,18,21,13,16,0,0,117
16,18,15,19,1,3,18,1,12,103
16,18,15,19,1,9,3,0,0,81
16,18,15,19,1,9,3,1,12,94
16,18,15,19,1,9,19,13,0,110
16,18,15,19,1,9,19,13,19,129
16,18,15,19,1,9,19,20,0,117
16,18,15,19,1,9,19,20,19,136
16,18,15,19,1,12,0,0,0,81
16,18,15,19,1,16,25,0,0,110
16,18,15,19,1,18,0,0,0,87
16,18,15,19,1,20,5,21,18,133
16,18,15,19,3,5,14,9,1,100
16,18,15,19,3,8,15,15,12,121
16,18,15,19,3,9,14,4,0,98
16,18,15,19,3,15,12,5,24,127
16,18,15,19,3,18,9,2,5,105
16,18,15,19,3,18,9,16,20,134
16,18,15,19,5,0,0,0,0,73
16,18,15,19,5,3,20,0,0,96
16,18,15,19,5,3,20,5,4,105
16,18,15,19,5,3,20,15,18,129
16,18,15,19,5,3,20,19,0,115
16,18,15,19,5,3,21,20,5,122
16,18,15,19,5,4,0,0,0,77
16,18,15,19,5,9,20,25,0,127
16,18,15,19,5,12,25,0,0,110
16,18,15,19,5,12,9,11,5,110
16,18,15,19,5,12,25,20,5,135
16,18,15,19,5,13,1,14,0,101
16,18,15,19,5,17,21,9,0,120
16,18,15,19,5,18,0,0,0,91
16,18,15,19,5,18,19,0,0,110
16,18,15,19,5,19,0,0,0,92
16,18,15,19,5,21,3,8,1,106
16,18,15,19,5,21,3,8,5,110
16,18,15,19,25,0,0,0,0,93
16,18,15,19,9,5,18,0,0,100
16,18,15,19,9,5,19,20,0,121
16,18,15,19,9,6,25,0,0,108
16,18,15,19,9,6,9,5,18,115
16,18,15,19,9,12,25,0,0,114
16,18,15,19,9,13,9,1,14,114
16,18,15,19,9,14,5,19,19,134
16,18,15,19,9,14,7,0,0,98
16,18,15,19,9,14,7,12,25,135
16,18,15,19,9,16,8,15,14,130
16,18,15,19,9,19,8,0,0,104
16,18,15,19,9,19,20,0,0,116
16,18,15,19,9,20,0,0,0,97
16,18,15,19,12,1,22,5,0,108
16,18,15,19,12,1,22,5,18,126
16,18,15,19,12,25,20,5,4,134
16,18,15,19,15,0,0,0,0,83
16,18,15,19,15,3,5,12,5,108
16,18,15,19,15,4,1,12,0,100
16,18,15,19,15,4,5,0,0,92
16,18,15,19,15,4,25,0,0,112
16,18,15,19,15,4,9,1,3,100
16,18,15,19,15,4,9,1,12,109
16,18,15,19,15,4,9,1,14,111
16,18,15,19,15,4,9,3,0,99
16,18,15,19,15,4,9,3,19,118
16,18,15,19,15,4,9,5,19,120
16,18,15,19,15,4,9,15,14,125
16,18,15,19,15,4,9,19,20,135
16,18,15,19,15,4,21,19,0,127
16,18,15,19,15,13,1,0,0,97
16,18,15,19,15,13,1,12,0,109
16,18,15,19,15,13,1,19,0,116
16,18,15,19,15,16,9,3,0,111
16,18,15,19,15,16,25,12,0,136
16,18,15,19,15,16,25,12,5,141
16,18,15,19,15,16,9,20,5,133
16,18,15,19,15,16,15,14,0,128
16,18,15,19,15,18,21,19,0,141
16,18,15,19,15,19,0,0,0,102
16,18,15,19,16,5,3,20,0,112
16,18,15,19,16,5,3,20,19,131
16,18,15,19,16,5,18,5,4,116
16,18,15,19,16,5,18,5,18,130
16,18,15,19,16,5,18,19,0,126
16,18,15,19,16,8,15,18,1,126
16,18,15,19,16,9,3,5,0,101
16,18,15,19,16,15,18,20,0,137
16,18,15,19,19,0,0,0,0,87
16,18,15,19,19,5,19,0,0,111
16,18,15,19,19,25,0,0,0,112
16,18,15,19,19,9,5,0,0,101
16,18,15,19,19,9,5,19,0,120
16,18,15,19,19,20,15,1,0,123
16,18,15,19,20,0,0,0,0,88
16,18,15,19,20,1,4,5,19,117
16,18,15,19,20,1,19,0,0,108
16,18,15,19,20,1,19,9,19,136
16,18,15,19,20,1,20,5,0,114
16,18,15,19,20,1,20,5,19,133
16,18,15,19,20,1,20,9,3,121
16,18,15,19,20,5,18,14,0,125
16,18,15,19,20,5,18,14,1,126
16,18,15,19,20,8,5,3,1,105
16,18,15,19,20,8,9,15,14,134
16,18,15,19,20,9,5,0,0,102
16,18,15,19,20,9,5,19,0,121
16,18,15,19,20,25,12,5,0,130
16,18,15,19,20,25,12,5,19,149
16,18,15,19,20,25,12,15,19,159
16,18,15,19,20,15,1,0,0,104
16,18,15,19,20,15,13,9,1,126
16,18,15,19,20,15,15,14,0,132
16,18,15,19,20,18,1,20,5,132
16,18,15,19,20,18,9,11,5,131
16,18,15,20,1,3,20,9,3,105
16,18,15,20,1,7,15,14,0,106
16,18,15,20,1,13,9,14,0,106
16,18,15,20,1,13,9,14,5,111
16,18,15,20,1,13,9,14,19,125
16,18,15,20,1,14,4,18,25,131
16,18,15,20,1,14,15,16,5,120
16,18,15,20,1,18,7,9,14,118
16,18,15,20,1,18,9,6,6,109
16,18,15,20,1,18,19,1,12,120
16,18,15,20,1,18,19,21,19,147
16,18,15,20,1,19,5,19,0,113
16,18,15,20,1,19,9,19,0,117
16,18,15,20,1,19,16,9,19,133
16,18,15,20,1,20,9,3,0,102
16,18,15,20,1,24,0,0,0,94
16,18,15,20,1,24,9,1,12,116
16,18,15,20,1,24,9,19,0,122
16,18,15,20,5,0,0,0,0,74
16,18,15,20,5,1,4,0,0,79
16,18,15,20,5,1,14,0,0,89
16,18,15,20,5,1,14,12,25,126
16,18,15,20,5,1,14,19,0,108
16,18,15,20,5,1,19,0,0,94
16,18,15,20,5,1,19,5,0,99
16,18,15,20,5,1,19,5,19,118
16,18,15,20,5,3,20,0,0,97
16,18,15,20,5,3,20,5,4,106
16,18,15,20,5,3,20,5,5,107
16,18,15,20,5,3,20,19,0,116
16,18,15,20,5,7,5,0,0,86
16,18,15,20,5,7,5,5,0,91
16,18,15,20,5,7,5,5,19,110
16,18,15,20,5,7,5,19,0,105
16,18,15,20,5,9,0,0,0,83
16,18,15,20,5,9,3,0,0,86
16,18,15,20,5,9,4,0,0,87
16,18,15,20,5,9,4,5,0,92
16,18,15,20,5,9,4,5,19,111
16,18,15,20,5,9,4,19,0,106
16,18,15,20,5,9,14,0,0,97
16,18,15,20,5,9,14,9,3,109
16,18,15,20,5,9,14,19,0,116
16,18,15,20,5,14,4,0,0,92
16,18,15,20,5,14,4,5,4,101
16,18,15,20,5,14,4,19,0,111
16,18,15,20,5,14,19,5,0,112
16,18,15,20,5,15,19,5,0,113
16,18,15,20,5,15,19,5,19,132
16,18,15,20,5,18,22,5,0,119
16,18,15,20,5,19,20,0,0,113
16,18,15,20,5,19,20,5,4,122
16,18,15,20,5,19,20,5,18,136
16,18,15,20,5,19,20,15,18,146
16,18,15,20,5,19,20,19,0,132
16,18,15,20,5,24,20,0,0,118
16,18,15,20,8,1,12,12,9,111
16,18,15,20,8,5,3,1,0,86
16,18,15,20,8,5,19,5,19,125
16,18,15,20,8,5,19,9,19,129
16,18,15,20,8,5,20,9,3,114
16,18,15,20,8,25,12,0,0,114
16,18,15,20,8,13,9,1,0,100
16,18,15,20,8,15,18,1,24,135
16,18,15,20,8,18,9,6,20,130
16,18,15,20,9,4,0,0,0,82
16,18,15,20,9,4,5,0,0,87
16,18,15,20,25,12,0,0,0,106
16,18,15,20,25,12,5,0,0,111
16,18,15,20,25,12,5,19,0,130
16,18,15,20,25,12,19,0,0,125
16,18,15,20,25,16,5,0,0,115
16,18,15,20,9,19,20,0,0,117
16,18,15,20,9,19,20,1,14,132
16,18,15,20,9,19,20,9,3,129
16,18,15,20,9,19,20,15,14,146
16,18,15,20,9,19,20,19,0,136
16,18,15,20,9,21,13,19,0,131
16,18,15,20,15,0,0,0,0,84
16,18,15,20,15,3,15,12,0,114
16,18,15,20,15,3,15,12,19,133
16,18,15,20,15,3,15,14,5,121
16,18,15,20,15,3,15,18,13,133
16,18,15,20,15,4,5,18,13,124
16,18,15,20,15,4,15,14,20,137
16,18,15,20,15,7,9,14,5,119
16,18,15,20,15,7,25,14,25,155
16,18,15,20,15,7,15,4,0,110
16,18,15,20,15,8,15,13,15,135
16,18,15,20,15,25,16,5,19,149
16,18,15,20,15,9,18,15,14,140
16,18,15,20,15,12,15,7,0,118
16,18,15,20,15,12,15,16,8,135
16,18,15,20,15,13,1,0,0,98
16,18,15,20,15,13,1,12,1,111
16,18,15,20,15,13,5,0,0,102
16,18,15,20,15,14,1,20,5,124
16,18,15,20,15,14,5,0,0,103
16,18,15,20,15,14,5,13,1,117
16,18,15,20,15,14,5,13,5,121
16,18,15,20,15,14,9,3,0,110
16,18,15,20,15,14,25,13,0,136
16,18,15,20,15,14,19,0,0,117
16,18,15,20,15,16,9,14,0,123
16,18,15,20,15,16,9,14,5,128
16,18,15,20,15,16,15,4,0,119
16,18,15,20,15,16,15,4,19,138
16,18,15,20,15,16,15,16,5,136
16,18,15,20,15,18,5,0,0,107
16,18,15,20,15,19,1,12,20,136
16,18,15,20,15,19,20,1,18,142
16,18,15,20,15,20,25,16,5,150
16,18,15,20,15,22,21,13,0,140
16,18,15,20,15,24,9,4,0,121
16,18,15,20,15,24,9,4,5,126
16,18,15,20,15,24,9,4,19,140
16,18,15,20,15,26,15,1,12,138
16,18,15,20,15,26,15,1,14,140
16,18,15,20,15,26,15,5,1,131
16,18,15,20,15,26,15,9,3,137
16,18,15,20,15,26,15,15,14,154
16,18,15,20,15,26,26,15,1,152
16,18,15,20,18,1,3,20,0,111
16,18,15,20,18,1,3,20,19,130
16,18,15,20,18,1,4,5,0,97
16,18,15,20,18,1,7,9,5,109
16,18,15,20,18,1,22,5,12,127
16,18,15,20,18,5,1,20,25,138
16,18,15,20,18,21,4,5,0,117
16,18,15,20,18,21,4,5,4,121
16,18,15,20,18,21,4,5,19,136
16,18,15,20,21,18,1,14,0,123
16,18,15,20,21,20,15,18,0,143
16,18,15,20,21,20,15,18,25,168
16,18,15,21,4,5,18,0,0,97
16,18,15,21,4,5,19,20,0,118
16,18,15,21,4,6,21,12,0,113
16,18,15,21,4,9,19,8,0,110
16,18,15,21,4,12,25,0,0,111
16,18,15,21,4,12,9,14,7,116
16,18,15,21,4,14,5,19,19,131
16,18,15,21,14,9,15,14,0,122
16,18,15,21,19,20,9,20,5,143
16,18,15,22,1,2,12,5,0,91
16,18,15,22,1,2,12,25,0,111
16,18,15,22,1,14,4,0,0,90
16,18,15,22,1,14,20,0,0,106
16,18,15,22,5,0,0,0,0,76
16,18,15,22,5,3,20,0,0,99
16,18,15,22,5,4,0,0,0,80
16,18,15,22,5,4,12,25,0,117
16,18,15,22,5,4,15,18,0,113
16,18,15,22,5,4,15,18,5,118
16,18,15,22,5,14,0,0,0,90
16,18,15,22,5,14,4,0,0,94
16,18,15,22,5,14,4,5,18,117
16,18,15,22,5,14,5,0,0,95
16,18,15,22,5,14,12,25,0,127
16,18,15,22,5,14,20,0,0,110
16,18,15,22,5,18,0,0,0,94
16,18,15,22,5,18,2,0,0,96
16,18,15,22,5,18,2,5,4,105
16,18,15,22,5,18,2,9,3,108
16,18,15,22,5,18,19,0,0,113
16,18,15,22,5,19,0,0,0,95
16,18,15,22,9,1,14,20,0,115
16,18,15,22,9,3,1,18,0,102
16,18,15,22,9,4,5,0,0,89
16,18,15,22,9,4,5,4,0,93
16,18,15,22,9,4,5,14,20,123
16,18,15,22,9,4,5,18,0,107
16,18,15,22,9,4,5,18,19,126
16,18,15,22,9,4,5,19,0,108
16,18,15,22,9,4,9,14,7,114
16,18,15,22,9,4,15,18,5,122
16,18,15,22,9,14,3,5,0,102
16,18,15,22,9,14,3,5,19,121
16,18,15,22,9,14,5,0,0,99
16,18,15,22,9,14,7,0,0,101
16,18,15,22,9,14,7,12,25,138
16,18,15,22,9,18,1,12,0,111
16,18,15,22,9,18,21,19,0,138
16,18,15,22,9,19,9,15,14,137
16,18,15,22,9,19,9,22,5,135
16,18,15,22,9,19,15,0,0,114
16,18,15,22,9,19,15,5,19,138
16,18,15,22,9,19,15,18,0,132
16,18,15,22,9,19,15,18,25,157
16,18,15,22,9,19,15,19,0,133
16,18,15,22,15,3,1,14,20,124
16,18,15,22,15,11,5,0,0,102
16,18,15,22,15,11,5,4,0,106
16,18,15,22,15,11,5,5,0,107
16,18,15,22,15,11,5,18,0,120
16,18,15,22,15,11,5,18,19,139
16,18,15,22,15,11,5,19,0,121
16,18,15,22,15,11,9,14,7,127
16,18,15,22,15,12,1,0,0,99
16,18,15,22,15,19,20,0,0,125
16,18,15,22,15,19,20,1,12,138
16,18,15,22,15,19,20,18,25,168
16,18,15,22,15,19,20,19,0,144
16,18,15,23,0,0,0,0,0,72
16,18,15,23,1,18,0,0,0,91
16,18,15,23,1,18,4,5,14,114
16,18,15,23,5,4,0,0,0,81
16,18,15,23,5,18,0,0,0,95
16,18,15,23,5,19,19,0,0,115
16,18,15,23,5,19,19,5,4,124
16,18,15,23,5,19,19,5,19,139
16,18,15,23,5,19,20,0,0,116
16,18,15,23,6,9,19,8,0,114
16,18,15,23,12,0,0,0,0,84
16,18,15,23,12,5,4,0,0,93
16,18,15,23,12,5,18,0,0,107
16,18,15,23,12,5,18,19,0,126
16,18,15,23,12,9,14,7,0,114
16,18,15,23,12,19,0,0,0,103
16,18,15,23,19,0,0,0,0,91
16,18,15,24,0,0,0,0,0,73
16,18,15,24,5,13,9,3,0,103
16,18,15,24,5,13,9,3,19,122
16,18,15,24,5,14,5,20,0,117
16,18,15,24,5,14,5,20,5,122
16,18,15,24,5,14,25,0,0,117
16,18,15,24,5,14,15,19,0,126
16,18,15,24,5,14,21,19,0,132
16,18,15,24,25,0,0,0,0,98
16,18,15,24,9,5,4,0,0,91
16,18,15,24,9,5,19,0,0,106
16,18,15,24,25,9,14,7,0,128
16,18,15,24,9,13,1,4,0,100
16,18,15,24,9,13,1,12,0,108
16,18,15,24,9,13,1,20,5,121
16,18,15,24,9,13,5,0,0,100
16,18,15,24,9,13,9,20,25,149
16,18,15,24,9,13,15,0,0,110
16,18,15,24,25,19,8,9,16,150
16,18,15,24,25,19,13,0,0,130
16,18,15,26,25,13,9,20,5,147
16,18,15,26,15,14,5,0,0,109
16,18,15,26,15,14,9,14,7,134
16,18,16,0,0,0,0,0,0,50
16,18,21,4,5,0,0,0,0,64
16,18,21,4,5,12,25,0,0,101
16,18,21,4,5,12,9,11,5,101
16,18,21,4,5,14,3,5,19,105
16,18,21,4,5,14,20,0,0,98
16,18,21,4,5,14,20,12,25,135
16,18,21,4,5,18,25,0,0,107
16,18,21,4,5,18,9,5,19,115
16,18,21,4,5,19,0,0,0,83
16,18,21,4,8,15,13,13,5,113
16,18,21,4,9,19,8,0,0,95
16,18,21,4,9,19,8,12,25,132
16,18,21,4,9,19,20,0,0,107
16,18,21,4,9,20,25,0,0,113
16,18,21,8,0,0,0,0,0,63
16,18,21,9,7,15,0,0,0,86
16,18,21,9,14,1,20,5,0,104
16,18,21,9,14,15,19,5,0,117
16,18,21,9,14,15,21,19,0,133
16,18,21,14,1,2,12,5,0,89
16,18,21,14,1,2,12,25,0,109
16,18,21,14,1,19,5,0,0,94
16,18,21,14,1,19,9,14,0,112
16,18,21,14,5,0,0,0,0,74
16,18,21,14,5,4,0,0,0,78
16,18,21,14,5,12,12,0,0,98
16,18,21,14,5,12,12,1,19,118
16,18,21,14,5,12,12,5,0,103
16,18,21,14,5,12,12,5,19,122
16,18,21,14,5,12,12,15,0,113
16,18,21,14,5,12,12,15,19,132
16,18,21,14,5,18,0,0,0,92
16,18,21,14,5,18,19,0,0,111
16,18,21,14,5,19,0,0,0,93
16,18,21,14,5,20,9,14,0,117
16,18,21,14,5,20,15,12,0,121
16,18,21,14,9,6,15,18,13,130
16,18,21,14,9,14,7,0,0,99
16,18,21,14,9,20,18,9,14,139
16,18,21,14,20,0,0,0,0,89
16,18,21,14,20,5,4,0,0,98
16,18,21,18,9,5,14,3,5,109
16,18,21,18,9,5,14,3,25,129
16,18,21,18,9,5,14,20,0,121
16,18,21,18,9,7,15,0,0,104
16,18,21,18,9,7,15,19,0,123
16,18,21,18,9,20,9,3,0,114
16,18,21,18,9,20,21,19,0,142
16,18,21,19,9,1,14,15,0,113
16,18,21,19,19,9,1,14,19,136
16,18,21,19,19,9,1,20,5,128
16,18,21,19,19,9,3,0,0,105
16,18,21,19,19,9,14,0,0,116
16,18,21,19,19,9,14,5,0,121
16,18,21,20,1,0,0,0,0,76
16,18,21,20,1,8,0,0,0,84
16,18,21,20,5,14,9,3,0,106
16,18,21,20,15,20,0,0,0,110
16,18,21,20,15,20,8,0,0,118
16,19,3,8,5,14,20,0,0,85
16,19,3,8,5,14,20,19,0,104
16,19,5,3,0,0,0,0,0,43
16,19,5,12,12,9,19,13,0,105
16,19,5,14,4,0,0,0,0,58
16,19,5,16,8,9,19,13,0,105
16,19,5,16,8,9,19,13,1,106
16,19,5,16,8,9,20,5,0,98
16,19,5,16,8,9,20,5,19,117
16,19,5,16,8,9,20,9,3,105
16,19,5,21,4,0,0,0,0,65
16,19,5,21,4,1,24,9,19,118
16,19,5,21,4,15,0,0,0,80
16,19,5,21,4,15,2,9,1,92
16,19,5,21,4,15,4,15,24,123
16,19,5,21,4,15,9,19,13,121
16,19,5,21,4,15,13,5,18,116
16,19,5,21,4,15,14,25,13,132
16,19,5,21,4,15,16,15,4,115
16,19,5,21,4,15,19,0,0,99
16,19,5,21,4,15,22,1,12,115
16,19,5,21,4,15,22,21,13,136
16,19,5,21,4,19,0,0,0,84
16,19,8,1,0,0,0,0,0,44
16,19,8,1,23,0,0,0,0,67
16,19,8,1,23,5,4,0,0,76
16,19,8,1,23,9,14,7,0,97
16,19,8,1,23,19,0,0,0,86
16,19,9,1,0,0,0,0,0,45
16,19,25,3,8,0,0,0,0,71
16,19,25,3,8,1,12,0,0,84
16,19,25,3,8,5,4,0,0,80
16,19,25,3,8,5,19,0,0,95
16,19,25,3,8,9,3,0,0,83
16,19,25,3,8,9,3,1,12,96
16,19,25,3,8,9,3,19,0,102
16,19,25,3,8,9,4,0,0,84
16,19,25,3,8,9,14,7,0,101
16,19,25,3,8,9,19,13,0,112
16,19,25,3,8,9,19,20,0,119
16,19,25,3,8,15,0,0,0,86
16,19,25,3,8,15,9,4,0,99
16,19,25,3,8,15,14,0,0,100
16,19,25,3,8,15,14,25,0,125
16,19,25,3,8,15,19,0,0,105
16,19,25,3,8,15,19,5,19,129
16,19,25,3,8,15,19,9,19,133
16,19,25,3,8,15,20,9,3,118
16,19,25,3,8,19,0,0,0,90
16,19,25,3,8,21,18,7,25,142
16,19,25,3,20,5,18,0,0,106
16,19,9,4,0,0,0,0,0,48
16,19,9,7,0,0,0,0,0,51
16,19,25,11,20,5,18,0,0,114
16,19,25,11,20,5,18,19,0,133
16,19,9,12,1,20,18,15,0,110
16,19,25,12,12,1,19,0,0,104
16,19,25,12,12,9,4,0,0,97
16,19,25,12,12,9,4,19,0,116
16,19,25,12,12,9,21,13,0,127
16,19,9,12,15,3,9,14,0,97
16,19,9,12,15,9,0,0,0,80
16,19,9,12,15,12,15,7,25,130
16,19,9,12,15,19,5,19,0,114
16,19,9,12,15,19,9,19,0,118
16,19,9,12,15,20,9,3,0,103
16,19,9,19,0,0,0,0,0,63
16,19,25,23,1,18,0,0,0,102
16,19,25,23,1,18,19,0,0,121
16,19,9,26,5,0,0,0,0,75
16,19,15,1,4,9,3,0,0,67
16,19,15,1,5,0,0,0,0,56
16,19,15,1,9,0,0,0,0,60
16,19,15,1,19,0,0,0,0,70
16,19,15,1,20,9,3,0,0,83
16,19,15,3,9,4,0,0,0,66
16,19,15,3,9,4,19,0,0,85
16,19,15,3,9,14,5,0,0,81
16,19,15,9,20,9,19,0,0,107
16,19,15,18,1,0,0,0,0,69
16,19,15,18,1,12,5,1,19,106
16,19,15,18,1,12,5,14,0,100
16,19,15,18,9,1,19,5,19,121
16,19,15,18,9,1,19,9,3,109
16,19,15,18,9,1,19,9,19,125
16,19,15,18,9,1,20,9,3,110
16,19,15,18,9,3,0,0,0,80
16,19,15,18,15,9,4,0,0,96
16,19,15,18,15,16,20,9,3,131
16,19,15,18,15,19,9,19,0,130
16,19,15,18,15,21,19,0,0,123
16,19,15,22,9,5,0,0,0,86
16,19,19,20,0,0,0,0,0,74
16,19,21,5,4,15,0,0,0,80
16,20,5,18,1,19,16,9,4,108
16,20,5,18,5,1,12,0,0,77
16,20,5,18,9,3,0,0,0,71
16,20,5,18,9,4,9,21,13,115
16,20,5,18,9,4,15,9,4,100
16,20,5,18,25,7,9,1,0,101
16,20,5,18,25,7,9,1,12,113
16,20,5,18,25,7,9,21,13,134
16,20,5,18,25,7,15,4,5,115
16,20,5,18,25,7,15,9,4,119
16,20,5,18,25,7,15,20,5,131
16,20,5,18,25,12,1,0,0,97
16,20,5,18,25,12,1,5,0,102
16,20,5,18,9,14,0,0,0,82
16,20,5,18,9,14,19,0,0,101
16,20,5,18,9,15,14,0,0,97
16,20,5,18,14,1,0,0,0,74
16,20,5,18,15,9,4,0,0,87
16,20,5,18,15,13,1,0,0,88
16,20,5,18,15,13,1,20,1,109
16,20,5,18,15,14,0,0,0,88
16,20,5,18,15,16,9,4,0,103
16,20,5,18,15,16,9,14,5,118
16,20,5,18,15,16,15,4,0,109
16,20,5,18,15,16,15,4,19,128
16,20,5,18,15,19,1,21,18,133
16,20,5,18,15,20,9,3,0,106
16,20,5,18,15,21,19,0,0,114
16,20,7,0,0,0,0,0,0,43
16,20,25,0,0,0,0,0,0,61
16,20,25,1,12,9,14,0,0,97
16,20,25,1,12,9,14,19,0,116
16,20,25,1,12,9,19,13,0,115
16,20,25,1,12,9,19,13,19,134
16,20,25,1,12,9,26,5,0,114
16,20,25,1,12,9,26,5,4,118
16,20,9,12,9,14,1,12,0,93
16,20,9,12,9,14,21,13,0,114
16,20,9,12,15,19,9,19,0,119
16,20,9,14,9,4,0,0,0,72
16,20,9,14,15,9,4,0,0,87
16,20,9,19,1,14,0,0,0,79
16,20,9,19,1,14,19,0,0,98
16,20,25,24,9,19,0,0,0,113
16,20,15,13,1,9,14,0,0,88
16,20,15,13,1,9,14,5,0,93
16,20,15,13,1,9,14,5,19,112
16,20,15,13,1,9,14,9,3,100
16,20,15,13,1,9,14,19,0,107
16,20,15,19,5,19,0,0,0,94
16,20,15,19,9,19,0,0,0,98
16,20,15,20,9,3,0,0,0,83
16,20,19,0,0,0,0,0,0,55
16,20,20,19,0,0,0,0,0,75
16,21,2,0,0,0,0,0,0,39
16,21,2,1,12,0,0,0,0,52
16,21,2,2,12,5,0,0,0,58
16,21,2,5,18,1,12,0,0,75
16,21,2,5,18,20,1,12,0,95
16,21,2,5,18,20,25,0,0,107
16,21,2,5,18,20,9,3,0,94
16,21,2,5,18,20,9,5,19,115
16,21,2,5,19,0,0,0,0,63
16,21,2,5,19,3,5,14,20,105
16,21,2,9,1,14,0,0,0,63
16,21,2,9,3,0,0,0,0,51
16,21,2,9,15,20,15,13,25,136
16,21,2,9,19,0,0,0,0,67
16,21,2,12,0,0,0,0,0,51
16,21,2,12,9,3,1,0,0,64
16,21,2,12,9,3,1,5,0,69
16,21,2,12,9,3,1,14,19,97
16,21,2,12,9,3,1,20,5,89
16,21,2,12,9,3,5,0,0,68
16,21,2,12,9,3,9,0,0,72
16,21,2,12,9,3,9,19,13,104
16,21,2,12,9,3,9,19,20,111
16,21,2,12,9,3,9,20,25,117
16,21,2,12,9,3,9,26,5,103
16,21,2,12,9,3,12,25,0,100
16,21,2,12,9,3,19,0,0,82
16,21,2,12,9,3,21,13,0,97
16,21,2,12,9,3,21,20,5,109
16,21,2,12,9,19,8,0,0,87
16,21,2,12,9,19,8,5,4,96
16,21,2,12,9,19,8,5,18,110
16,21,2,12,9,19,8,5,19,111
16,21,2,15,9,12,9,1,3,88
16,21,2,19,0,0,0,0,0,58
16,21,3,1,0,0,0,0,0,41
16,21,3,3,9,14,15,9,4,94
16,21,3,3,15,15,14,0,0,87
16,21,3,3,15,15,14,19,0,106
16,21,3,5,0,0,0,0,0,45
16,21,3,5,12,1,7,5,0,70
16,21,3,5,12,12,1,7,5,82
16,21,3,5,12,12,1,19,0,89
16,21,3,5,12,12,5,0,0,74
16,21,3,5,18,15,14,0,0,92
16,21,3,5,19,0,0,0,0,64
16,21,3,8,5,18,1,0,0,72
16,21,3,8,5,18,9,20,5,105
16,21,3,8,5,18,15,0,0,86
16,21,3,11,1,0,0,0,0,52
16,21,3,11,2,1,12,12,0,78
16,21,3,11,5,18,0,0,0,74
16,21,3,11,5,18,5,4,0,83
16,21,3,11,5,18,5,12,0,91
16,21,3,11,5,18,5,18,0,97
16,21,3,11,5,18,5,18,19,116
16,21,3,11,5,18,25,0,0,99
16,21,3,11,5,18,9,5,18,106
16,21,3,11,5,18,9,14,7,104
16,21,3,11,5,18,19,0,0,93
16,21,3,11,6,9,19,20,0,105
16,21,3,11,6,15,9,19,20,120
16,21,3,11,9,19,8,0,0,87
16,21,3,11,9,19,8,12,25,124
16,21,3,11,12,5,0,0,0,68
16,21,3,11,12,9,11,5,0,88
16,21,3,11,12,9,14,7,0,93
16,21,3,11,18,5,12,0,0,86
16,21,3,11,19,0,0,0,0,70
16,21,3,11,19,5,25,0,0,100
16,21,3,11,19,20,5,18,0,113
16,21,4,4,1,0,0,0,0,46
16,21,4,4,5,5,0,0,0,55
16,21,4,4,5,14,9,14,7,94
16,21,4,4,5,18,0,0,0,68
16,21,4,4,25,0,0,0,0,70
16,21,4,4,9,14,7,0,0,75
16,21,4,4,9,14,7,25,0,100
16,21,4,4,9,14,7,19,0,94
16,21,4,4,12,5,0,0,0,62
16,21,4,4,12,5,2,1,18,83
16,21,4,4,12,5,4,0,0,66
16,21,4,4,12,5,18,0,0,80
16,21,4,4,12,5,18,19,0,99
16,21,4,4,12,5,19,0,0,81
16,21,4,4,12,25,0,0,0,82
16,21,4,4,12,9,5,18,0,89
16,21,4,4,12,9,5,19,20,110
16,21,4,4,12,9,14,7,0,87
16,21,4,4,12,9,14,7,19,106
16,21,4,4,15,3,11,0,0,74
16,21,4,5,14,3,25,0,0,88
16,21,4,5,14,3,9,5,19,96
16,21,4,5,14,4,1,0,0,65
16,21,4,5,14,4,1,12,0,77
16,21,4,5,14,4,15,21,19,119
16,21,4,5,14,4,21,13,0,98
16,21,4,5,14,20,0,0,0,80
16,21,4,7,5,0,0,0,0,53
16,21,4,7,25,0,0,0,0,73
16,21,4,7,9,5,18,0,0,80
16,21,4,7,9,5,19,20,0,101
16,21,4,7,9,12,25,0,0,94
16,21,4,7,9,14,5,19,19,114
16,21,4,9,1,14,15,0,0,80
16,21,4,9,2,21,14,4,0,91
16,21,4,9,3,0,0,0,0,53
16,21,4,9,3,1,12,0,0,66
16,21,4,9,3,9,20,25,0,107
16,21,4,9,3,9,20,9,1,92
16,21,4,19,0,0,0,0,0,60
16,21,4,19,25,0,0,0,0,85
16,21,5,2,12,9,20,15,0,100
16,21,5,2,12,15,9,26,5,111
16,21,5,2,12,15,19,0,0,90
16,21,5,18,5,18,0,0,0,83
16,21,5,18,9,12,5,0,0,86
16,21,5,18,9,12,5,12,25,123
16,21,5,18,9,12,9,19,13,122
16,21,5,18,9,12,9,20,25,135
16,21,5,18,13,1,14,0,0,88
16,21,5,18,16,5,18,1,0,100
16,21,5,18,16,5,18,1,5,105
16,21,5,18,16,5,18,1,12,112
16,21,5,18,16,5,18,25,0,124
16,21,5,18,16,5,18,9,1,109
16,21,6,6,2,1,3,11,0,66
16,21,6,6,2,1,12,12,0,76
16,21,6,6,2,1,12,12,19,95
16,21,6,6,2,9,18,4,0,82
16,21,6,6,5,4,0,0,0,58
16,21,6,6,5,18,0,0,0,72
16,21,6,6,5,18,25,0,0,97
16,21,6,6,5,18,9,5,19,105
16,21,6,6,5,18,19,0,0,91
16,21,6,6,25,0,0,0,0,74
16,21,6,6,9,5,18,0,0,81
16,21,6,6,9,5,19,20,0,102
16,21,6,6,9,12,25,0,0,95
16,21,6,6,9,14,0,0,0,72
16,21,6,6,9,14,5,19,19,115
16,21,6,6,9,14,5,20,0,97
16,21,6,6,9,14,7,0,0,79
16,21,6,6,9,14,7,12,25,116
16,21,6,6,9,14,19,0,0,91
16,21,6,6,12,5,20,0,0,86
16,21,6,6,19,0,0,0,0,68
16,21,6,6,20,14,0,0,0,83
16,21,6,6,23,9,7,0,0,88
16,21,7,0,0,0,0,0,0,44
16,21,7,1,18,5,5,0,0,73
16,21,7,1,18,5,5,19,0,92
16,21,7,4,15,7,0,0,0,70
16,21,7,5,14,5,12,12,15,107
16,21,7,5,20,0,0,0,0,69
16,21,7,7,1,18,5,5,0,80
16,21,7,7,1,18,5,5,19,99
16,21,7,7,5,4,0,0,0,60
16,21,7,7,5,18,0,0,0,74
16,21,7,7,9,0,0,0,0,60
16,21,7,7,25,0,0,0,0,76
16,21,7,7,9,5,18,0,0,83
16,21,7,7,9,5,19,20,0,104
16,21,7,7,9,14,5,19,19,117
16,21,7,7,9,14,7,0,0,81
16,21,7,7,9,19,8,0,0,87
16,21,7,7,12,5,0,0,0,68
16,21,7,7,18,5,5,0,0,79
16,21,7,7,18,5,5,19,0,98
16,21,7,7,18,25,0,0,0,94
16,21,7,7,18,9,5,19,0,102
16,21,7,9,12,0,0,0,0,65
16,21,7,9,12,1,14,20,0,100
16,21,7,9,12,9,19,13,0,106
16,21,7,9,12,9,19,13,19,125
16,21,7,9,12,9,19,20,0,113
16,21,7,9,12,9,19,20,19,132
16,21,7,13,1,14,0,0,0,72
16,21,7,13,1,18,11,0,0,87
16,21,7,13,1,18,11,19,0,106
16,21,7,13,9,12,12,0,0,90
16,21,7,13,9,12,12,5,18,113
16,21,7,14,1,3,9,20,25,116
16,21,7,18,5,5,0,0,0,72
16,21,7,18,5,5,19,0,0,91
16,21,7,19,0,0,0,0,0,63
16,21,25,0,0,0,0,0,0,62
16,21,9,18,0,0,0,0,0,64
16,21,9,18,14,5,19,19,0,121
16,21,9,18,20,9,20,8,0,121
16,21,9,19,14,5,0,0,0,84
16,21,9,19,14,5,19,0,0,103
16,21,9,19,14,25,0,0,0,104
16,21,9,19,19,1,14,3,5,107
16,21,9,19,19,1,14,20,0,119
16,21,9,19,20,0,0,0,0,85
16,21,9,19,20,9,5,0,0,99
16,21,10,1,0,0,0,0,0,48
16,21,10,1,8,0,0,0,0,56
16,21,10,1,8,19,0,0,0,75
16,21,10,1,18,9,0,0,0,75
16,21,10,1,19,0,0,0,0,67
16,21,11,1,0,0,0,0,0,49
16,21,11,1,20,5,1,0,0,75
16,21,11,1,20,5,9,14,5,102
16,21,11,5,0,0,0,0,0,53
16,21,11,5,4,0,0,0,0,57
16,21,11,5,11,1,0,0,0,65
16,21,11,5,11,15,0,0,0,79
16,21,11,5,18,0,0,0,0,71
16,21,11,5,19,0,0,0,0,72
16,21,11,5,23,5,5,4,0,90
16,21,11,25,0,0,0,0,0,73
16,21,11,9,14,7,0,0,0,78
16,21,11,9,19,8,0,0,0,84
16,21,11,11,1,0,0,0,0,60
16,21,11,18,1,19,0,0,0,86
16,21,11,21,0,0,0,0,0,69
16,21,12,1,8,1,14,0,0,73
16,21,12,1,8,1,14,5,19,97
16,21,12,1,10,1,14,0,0,75
16,21,12,1,19,0,0,0,0,69
16,21,12,1,19,1,14,0,0,84
16,21,12,1,19,11,9,20,5,114
16,21,12,3,8,18,9,6,25,118
16,21,12,5,0,0,0,0,0,54
16,21,12,5,4,0,0,0,0,58
16,21,12,5,7,15,12,0,0,88
16,21,12,5,7,15,14,5,0,95
16,21,12,5,25,14,0,0,0,93
16,21,12,5,18,0,0,0,0,72
16,21,12,5,18,19,0,0,0,91
16,21,12,5,19,0,0,0,0,73
16,21,12,7,1,4,1,0,0,62
16,21,12,7,8,5,18,5,0,92
16,21,12,9,0,0,0,0,0,58
16,21,12,25,0,0,0,0,0,74
16,21,12,9,3,1,20,0,0,82
16,21,12,9,3,1,20,5,0,87
16,21,12,9,3,5,14,5,0,85
16,21,12,9,3,9,4,0,0,74
16,21,12,9,3,9,4,1,12,87
16,21,12,9,3,9,4,5,0,79
16,21,12,9,3,9,4,5,19,98
16,21,12,9,3,9,14,5,0,89
16,21,12,9,3,15,9,4,0,89
16,21,12,9,3,15,19,5,0,100
16,21,12,9,3,15,21,19,0,116
16,21,12,9,10,1,14,0,0,83
16,21,12,9,11,0,0,0,0,69
16,21,12,9,14,7,0,0,0,79
16,21,12,9,14,7,12,25,0,116
16,21,12,9,14,7,19,0,0,98
16,21,12,9,15,12,0,0,0,85
16,21,12,9,19,0,0,0,0,77
16,21,12,9,19,8,0,0,0,85
16,21,12,11,0,0,0,0,0,60
16,21,12,11,1,0,0,0,0,61
16,21,12,12,0,0,0,0,0,61
16,21,12,12,1,2,12,5,0,81
16,21,12,12,1,9,12,5,0,88
16,21,12,12,1,12,21,5,0,100
16,21,12,12,2,1,3,11,0,78
16,21,12,12,2,1,3,11,19,97
16,21,12,12,2,15,1,20,0,99
16,21,12,12,4,5,22,9,12,113
16,21,12,12,4,15,15,0,0,95
16,21,12,12,4,15,23,14,0,117
16,21,12,12,4,18,9,22,5,119
16,21,12,12,5,4,0,0,0,70
16,21,12,12,5,25,0,0,0,91
16,21,12,12,5,25,19,0,0,110
16,21,12,12,5,14,0,0,0,80
16,21,12,12,5,18,0,0,0,84
16,21,12,12,5,18,25,0,0,109
16,21,12,12,5,18,9,5,19,117
16,21,12,12,5,18,19,0,0,103
16,21,12,12,5,20,0,0,0,86
16,21,12,12,5,20,19,0,0,105
16,21,12,12,9,0,0,0,0,70
16,21,12,12,9,3,1,20,0,94
16,21,12,12,9,3,1,20,5,99
16,21,12,12,9,14,7,19,0,110
16,21,12,12,9,19,5,5,0,99
16,21,12,12,15,3,11,0,0,90
16,21,12,12,15,18,21,13,0,128
16,21,12,12,15,21,20,0,0,117
16,21,12,12,15,21,20,19,0,136
16,21,12,12,15,22,5,18,0,121
16,21,12,12,15,22,5,18,19,140
16,21,12,12,19,0,0,0,0,80
16,21,12,12,21,12,1,14,20,129
16,21,12,12,21,12,1,20,5,120
16,21,12,12,21,16,0,0,0,98
16,21,12,12,21,16,19,0,0,117
16,21,12,12,21,19,0,0,0,101
16,21,12,13,5,14,20,0,0,101
16,21,12,13,15,14,1,12,0,104
16,21,12,13,15,14,1,18,0,110
16,21,12,13,15,14,1,18,25,135
16,21,12,13,15,14,1,20,5,117
16,21,12,13,15,14,9,3,0,103
16,21,12,13,15,20,15,18,19,149
16,21,12,16,0,0,0,0,0,65
16,21,12,16,1,12,0,0,0,78
16,21,12,16,1,12,7,9,1,95
16,21,12,16,1,12,12,25,0,115
16,21,12,16,1,18,0,0,0,84
16,21,12,16,1,20,15,14,5,120
16,21,12,16,1,20,15,15,14,130
16,21,12,16,2,15,1,18,4,105
16,21,12,16,5,4,0,0,0,74
16,21,12,16,5,18,0,0,0,88
16,21,12,16,5,18,9,1,0,98
16,21,12,16,5,18,19,0,0,107
16,21,12,16,25,0,0,0,0,90
16,21,12,16,9,5,18,0,0,97
16,21,12,16,9,5,19,20,0,118
16,21,12,16,9,6,25,0,0,105
16,21,12,16,9,6,9,5,4,98
16,21,12,16,9,6,9,5,18,112
16,21,12,16,9,12,25,0,0,111
16,21,12,16,9,14,5,19,19,131
16,21,12,16,9,14,7,0,0,95
16,21,12,16,9,20,0,0,0,94
16,21,12,16,9,20,1,12,0,107
16,21,12,16,9,20,5,5,18,122
16,21,12,16,9,20,5,18,0,117
16,21,12,16,9,20,6,21,12,133
16,21,12,16,9,20,9,3,0,106
16,21,12,16,9,20,9,19,0,122
16,21,12,16,9,20,9,19,8,130
16,21,12,16,9,20,9,19,13,135
16,21,12,16,9,20,9,26,5,134
16,21,12,16,9,20,12,25,0,131
16,21,12,16,9,20,18,25,0,137
16,21,12,16,9,20,19,0,0,113
16,21,12,16,9,20,21,13,0,128
16,21,12,16,12,5,19,19,0,120
16,21,12,16,12,9,11,5,0,102
16,21,12,16,15,20,15,13,25,153
16,21,12,16,15,21,19,0,0,120
16,21,12,16,19,0,0,0,0,84
16,21,12,16,19,20,15,14,5,138
16,21,12,16,23,15,15,4,0,122
16,21,12,16,23,15,15,4,19,141
16,21,12,17,21,5,0,0,0,92
16,21,12,17,21,5,19,0,0,111
16,21,12,19,0,0,0,0,0,68
16,21,12,19,1,14,20,0,0,103
16,21,12,19,1,18,0,0,0,87
16,21,12,19,1,18,19,0,0,106
16,21,12,19,1,20,5,0,0,94
16,21,12,19,1,20,5,4,0,98
16,21,12,19,1,20,5,19,0,113
16,21,12,19,1,20,9,12,5,115
16,21,12,19,1,20,9,14,7,119
16,21,12,19,1,20,9,15,14,127
16,21,12,19,1,20,9,22,5,125
16,21,12,19,1,20,15,18,0,122
16,21,12,19,1,20,15,18,25,147
16,21,12,19,1,20,15,18,19,141
16,21,12,19,5,0,0,0,0,73
16,21,12,19,5,2,5,1,20,101
16,21,12,19,5,4,0,0,0,77
16,21,12,19,5,10,5,20,0,108
16,21,12,19,5,10,5,20,19,127
16,21,12,19,5,12,5,19,19,128
16,21,12,19,5,12,9,11,5,110
16,21,12,19,5,12,12,21,13,131
16,21,12,19,5,18,0,0,0,91
16,21,12,19,5,18,19,0,0,110
16,21,12,19,5,19,0,0,0,92
16,21,12,19,9,4,7,5,0,93
16,21,12,19,9,6,9,3,0,95
16,21,12,19,9,14,7,0,0,98
16,21,12,19,9,15,14,0,0,106
16,21,12,19,9,15,14,19,0,125
16,21,12,19,9,22,5,0,0,104
16,21,12,19,15,10,5,20,0,118
16,21,12,19,15,10,5,20,19,137
16,21,12,19,21,19,0,0,0,108
16,21,12,20,15,14,0,0,0,98
16,21,12,20,15,19,20,0,0,123
16,21,12,20,21,14,0,0,0,104
16,21,12,20,21,18,5,0,0,113
16,21,12,21,0,0,0,0,0,70
16,21,12,22,0,0,0,0,0,71
16,21,12,22,5,18,1,14,20,129
16,21,12,22,5,18,1,20,5,120
16,21,12,22,5,18,9,14,0,117
16,21,12,22,5,18,9,14,5,122
16,21,12,22,5,18,9,19,5,127
16,21,12,22,5,18,9,26,5,134
16,21,12,22,5,18,15,21,19,149
16,21,12,22,9,3,0,0,0,83
16,21,12,22,9,12,0,0,0,92
16,21,12,22,9,12,9,15,0,116
16,21,12,22,9,12,12,1,18,123
16,21,12,22,9,12,12,9,0,113
16,21,12,22,9,12,12,21,19,144
16,21,12,22,9,14,1,18,0,113
16,21,12,22,9,14,1,20,5,120
16,21,12,22,9,14,9,0,0,103
16,21,12,22,9,14,9,3,0,106
16,21,12,22,9,14,14,9,0,117
16,21,12,22,9,14,15,0,0,109
16,21,12,22,9,14,21,12,5,132
16,21,12,22,9,14,21,19,0,134
16,21,12,23,1,18,0,0,0,91
16,21,13,1,0,0,0,0,0,51
16,21,13,1,19,0,0,0,0,70
16,21,13,5,12,15,0,0,0,82
16,21,13,5,12,15,19,0,0,101
16,21,13,5,24,0,0,0,0,79
16,21,13,9,3,1,20,5,0,88
16,21,13,9,3,1,20,5,4,92
16,21,13,9,3,5,0,0,0,67
16,21,13,9,3,5,4,0,0,71
16,21,13,9,3,5,15,21,19,122
16,21,13,9,3,5,18,0,0,85
16,21,13,9,3,5,18,19,0,104
16,21,13,9,3,5,19,0,0,86
16,21,13,9,3,9,14,7,0,92
16,21,13,9,3,9,20,5,0,96
16,21,13,9,3,9,20,5,19,115
16,21,13,9,3,15,19,5,0,101
16,21,13,13,5,12,0,0,0,80
16,21,13,13,5,12,5,4,0,89
16,21,13,13,5,12,9,14,7,110
16,21,13,13,5,12,12,5,4,101
16,21,13,13,5,12,19,0,0,99
16,21,13,13,9,3,5,0,0,80
16,21,13,16,1,2,12,5,0,86
16,21,13,16,1,7,5,0,0,79
16,21,13,16,5,4,0,0,0,75
16,21,13,16,5,18,0,0,0,89
16,21,13,16,5,18,19,0,0,108
16,21,13,16,5,20,0,0,0,91
16,21,13,16,9,14,7,0,0,96
16,21,13,16,11,9,14,0,0,100
16,21,13,16,11,9,14,19,0,119
16,21,13,16,11,14,15,20,0,126
16,21,13,16,12,5,0,0,0,83
16,21,13,16,12,5,19,19,0,121
16,21,13,16,12,9,11,5,0,103
16,21,13,16,13,1,14,0,0,94
16,21,13,16,13,5,14,0,0,98
16,21,13,16,19,0,0,0,0,85
16,21,13,16,19,13,1,14,0,113
16,21,13,16,23,5,12,12,0,118
16,21,14,0,0,0,0,0,0,51
16,21,14,1,0,0,0,0,0,52
16,21,14,1,9,19,5,0,0,85
16,21,14,1,12,21,1,0,0,86
16,21,14,1,12,21,1,14,0,100
16,21,14,1,13,21,0,0,0,86
16,21,14,1,19,0,0,0,0,71
16,21,14,1,20,15,15,0,0,102
16,21,14,3,5,0,0,0,0,59
16,21,14,3,8,1,2,12,5,82
16,21,14,3,8,1,25,5,20,113
16,21,14,3,8,2,1,12,12,89
16,21,14,3,8,2,15,23,12,114
16,21,14,3,8,5,4,0,0,71
16,21,14,3,8,5,15,14,19,115
16,21,14,3,8,5,18,0,0,85
16,21,14,3,8,5,18,19,0,104
16,21,14,3,8,5,19,0,0,86
16,21,14,3,8,25,0,0,0,87
16,21,14,3,8,9,5,18,0,94
16,21,14,3,8,9,5,19,20,115
16,21,14,3,8,9,12,25,0,108
16,21,14,3,8,9,14,7,0,92
16,21,14,3,8,12,5,19,19,117
16,21,14,3,8,12,9,11,5,99
16,21,14,3,20,0,0,0,0,74
16,21,14,3,20,1,12,0,0,87
16,21,14,3,20,1,20,5,0,100
16,21,14,3,20,1,20,5,4,104
16,21,14,3,20,1,20,9,13,117
16,21,14,3,20,1,20,15,18,128
16,21,14,3,20,9,12,9,15,119
16,21,14,3,20,9,15,14,0,112
16,21,14,3,20,9,19,20,0,122
16,21,14,3,20,21,1,12,0,108
16,21,14,3,20,21,1,20,5,121
16,21,14,3,20,21,9,19,20,143
16,21,14,3,20,21,12,5,0,112
16,21,14,3,20,21,12,21,13,141
16,21,14,3,20,21,13,0,0,108
16,21,14,3,20,21,18,5,0,118
16,21,14,3,20,21,18,5,4,122
16,21,14,3,20,21,18,5,18,136
16,21,14,3,20,21,18,5,19,137
16,21,14,3,20,21,19,0,0,114
16,21,14,4,9,20,0,0,0,84
16,21,14,4,9,20,1,0,0,85
16,21,14,4,9,20,9,3,0,96
16,21,14,4,9,20,18,25,0,127
16,21,14,4,9,20,19,0,0,103
16,21,14,4,15,14,15,18,0,117
16,21,14,4,21,13,0,0,0,89
16,21,14,5,3,1,0,0,0,60
16,21,14,5,19,5,0,0,0,80
16,21,14,7,0,0,0,0,0,58
16,21,14,7,1,0,0,0,0,59
16,21,14,7,1,16,21,14,7,117
16,21,14,7,1,18,0,0,0,77
16,21,14,7,5,25,0,0,0,88
16,21,14,7,5,14,3,5,0,85
16,21,14,7,5,14,3,25,0,105
16,21,14,7,5,14,20,0,0,97
16,21,14,7,5,14,20,12,25,134
16,21,14,7,5,18,0,0,0,81
16,21,14,7,9,0,0,0,0,67
16,21,14,7,25,0,0,0,0,83
16,21,14,7,9,5,0,0,0,72
16,21,14,7,9,5,19,0,0,91
16,21,14,7,25,9,0,0,0,92
16,21,14,7,12,5,0,0,0,75
16,21,14,7,12,5,4,0,0,79
16,21,14,7,12,5,19,0,0,94
16,21,14,7,12,9,14,7,0,100
16,21,14,7,19,0,0,0,0,77
16,21,14,25,0,0,0,0,0,76
16,21,14,9,3,5,15,21,19,123
16,21,14,9,3,9,1,12,0,85
16,21,14,9,3,9,14,0,0,86
16,21,14,9,3,9,14,5,0,91
16,21,14,9,5,18,0,0,0,83
16,21,14,9,5,19,20,0,0,104
16,21,14,25,9,19,8,0,0,112
16,21,14,25,9,19,13,0,0,117
16,21,14,9,12,25,0,0,0,97
16,21,14,9,14,5,19,19,0,117
16,21,14,9,19,8,0,0,0,87
16,21,14,9,19,8,5,4,0,96
16,21,14,9,19,8,5,18,0,110
16,21,14,9,19,8,5,18,19,129
16,21,14,9,19,8,5,19,0,111
16,21,14,9,19,8,9,14,7,117
16,21,14,25,19,8,9,16,0,128
16,21,14,9,20,9,15,14,0,118
16,21,14,9,20,9,15,14,19,137
16,21,14,9,20,9,22,5,0,116
16,21,14,9,20,15,18,25,0,138
16,21,14,9,20,21,18,0,0,119
16,21,14,10,21,13,0,0,0,95
16,21,14,11,0,0,0,0,0,62
16,21,14,11,1,0,0,0,0,63
16,21,14,11,1,8,0,0,0,71
16,21,14,11,1,8,19,0,0,90
16,21,14,11,1,19,0,0,0,82
16,21,14,11,5,25,0,0,0,92
16,21,14,11,5,25,19,0,0,111
16,21,14,11,5,18,0,0,0,85
16,21,14,11,5,19,20,0,0,106
16,21,14,11,5,20,20,15,0,122
16,21,14,11,25,0,0,0,0,87
16,21,14,11,9,5,0,0,0,76
16,21,14,11,9,5,18,0,0,94
16,21,14,11,9,5,19,0,0,95
16,21,14,11,9,5,19,20,0,115
16,21,14,11,9,14,0,0,0,85
16,21,14,11,9,14,5,19,19,128
16,21,14,11,9,14,19,0,0,104
16,21,14,11,9,19,8,0,0,98
16,21,14,11,12,9,14,7,0,104
16,21,14,11,19,0,0,0,0,81
16,21,14,11,20,0,0,0,0,82
16,21,14,11,23,15,15,4,0,119
16,21,14,12,5,19,19,0,0,106
16,21,14,12,5,20,0,0,0,88
16,21,14,14,1,2,12,5,0,85
16,21,14,14,1,7,5,0,0,78
16,21,14,14,5,4,0,0,0,74
16,21,14,14,5,18,0,0,0,88
16,21,14,14,5,18,19,0,0,107
16,21,14,14,5,20,0,0,0,90
16,21,14,14,5,20,19,0,0,109
16,21,14,14,25,0,0,0,0,90
16,21,14,14,9,3,0,0,0,77
16,21,14,14,9,3,1,12,0,90
16,21,14,14,9,5,18,0,0,97
16,21,14,14,9,5,19,20,0,118
16,21,14,14,9,7,18,1,13,113
16,21,14,14,9,14,7,0,0,95
16,21,14,14,9,14,7,12,25,132
16,21,14,14,15,12,15,7,25,139
16,21,14,16,18,15,15,6,0,121
16,21,14,19,0,0,0,0,0,70
16,21,14,19,20,5,18,0,0,113
16,21,14,19,20,5,18,19,0,132
16,21,14,19,20,18,5,19,19,151
16,21,14,20,1,2,15,21,20,130
16,21,14,20,1,12,0,0,0,84
16,21,14,20,5,4,0,0,0,80
16,21,14,20,5,12,0,0,0,88
16,21,14,20,5,12,12,15,0,115
16,21,14,20,5,18,0,0,0,94
16,21,14,20,5,18,19,0,0,113
16,21,14,20,9,0,0,0,0,80
16,21,14,20,25,0,0,0,0,96
16,21,14,20,9,5,19,0,0,104
16,21,14,20,9,12,0,0,0,92
16,21,14,20,9,12,12,1,0,105
16,21,14,20,9,12,12,1,19,124
16,21,14,20,9,14,7,0,0,101
16,21,14,20,9,19,20,0,0,119
16,21,14,20,15,0,0,0,0,86
16,21,14,20,15,19,0,0,0,105
16,21,14,20,15,21,20,0,0,127
16,21,14,20,19,0,0,0,0,90
16,21,14,20,19,13,1,14,0,118
16,21,16,1,0,0,0,0,0,54
16,21,16,1,5,0,0,0,0,59
16,21,16,1,8,15,15,4,0,96
16,21,16,1,12,0,0,0,0,66
16,21,16,1,18,9,1,0,0,82
16,21,16,1,18,9,1,12,0,94
16,21,16,1,18,9,21,13,0,115
16,21,16,1,19,0,0,0,0,73
16,21,16,1,20,5,0,0,0,79
16,21,16,1,20,5,4,0,0,83
16,21,16,1,20,5,19,0,0,98
16,21,16,1,20,9,14,7,0,104
16,21,16,1,20,9,15,14,0,112
16,21,16,1,20,9,15,14,19,131
16,21,16,5,12,15,0,0,0,85
16,21,16,6,9,19,8,0,0,95
16,21,16,6,9,19,8,5,19,119
16,21,16,9,6,15,18,13,0,114
16,21,16,9,12,0,0,0,0,74
16,21,16,9,12,1,7,5,0,87
16,21,16,9,12,1,7,5,19,106
16,21,16,9,12,1,18,0,0,93
16,21,16,9,12,1,18,25,0,118
16,21,16,9,12,1,20,5,0,100
16,21,16,9,12,4,15,13,0,106
16,21,16,9,12,5,4,0,0,83
16,21,16,9,12,9,26,5,0,114
16,21,16,9,12,12,1,7,5,99
16,21,16,9,12,12,1,18,0,105
16,21,16,9,12,12,1,18,25,130
16,21,16,9,12,12,1,20,5,112
16,21,16,9,12,12,5,4,0,95
16,21,16,9,12,12,5,19,19,129
16,21,16,9,12,12,9,26,5,126
16,21,16,9,12,19,0,0,0,93
16,21,16,9,22,15,18,5,0,122
16,21,16,12,9,11,5,0,0,90
16,21,16,15,9,4,0,0,0,81
16,21,16,16,5,4,0,0,0,78
16,21,16,16,5,20,0,0,0,94
16,21,16,16,5,20,4,15,13,126
16,21,16,16,5,20,5,5,18,122
16,21,16,16,5,20,9,19,8,130
16,21,16,16,5,20,9,19,13,135
16,21,16,16,5,20,9,26,5,134
16,21,16,16,5,20,12,25,0,131
16,21,16,16,5,20,13,1,14,122
16,21,16,16,5,20,18,25,0,137
16,21,16,16,5,20,19,0,0,113
16,21,16,16,25,0,0,0,0,94
16,21,16,16,25,4,15,13,0,126
16,21,16,16,25,4,15,13,19,145
16,21,16,16,9,5,4,0,0,87
16,21,16,16,9,5,19,0,0,102
16,21,16,16,25,6,5,5,20,130
16,21,16,16,9,6,25,0,0,109
16,21,16,16,25,6,9,19,8,136
16,21,16,16,25,6,15,15,20,150
16,21,16,16,25,8,15,15,4,136
16,21,16,16,25,9,14,7,0,124
16,21,16,16,25,9,19,8,0,130
16,21,16,16,25,9,19,13,0,135
16,21,16,16,9,12,25,0,0,115
16,21,16,16,25,12,9,11,5,131
16,21,16,16,9,14,7,0,0,99
16,21,16,19,0,0,0,0,0,72
16,21,16,21,12,15,0,0,0,101
16,21,16,21,14,8,1,0,0,97
16,21,18,1,14,1,19,0,0,90
16,21,18,1,17,21,5,0,0,99
16,21,18,1,21,0,0,0,0,77
16,21,18,2,12,9,14,4,0,96
16,21,18,3,8,1,19,5,0,91
16,21,18,3,8,1,19,5,4,95
16,21,18,3,8,1,19,5,18,109
16,21,18,3,8,1,19,5,19,110
16,21,18,4,1,0,0,0,0,60
16,21,18,4,1,8,0,0,0,68
16,21,18,4,1,8,19,0,0,87
16,21,18,4,1,19,0,0,0,79
16,21,18,5,0,0,0,0,0,60
16,21,18,5,1,25,14,0,0,100
16,21,18,5,2,12,15,15,4,108
16,21,18,5,2,18,5,4,0,89
16,21,18,5,2,18,5,4,19,108
16,21,18,5,4,0,0,0,0,64
16,21,18,5,4,5,5,0,0,74
16,21,18,5,5,0,0,0,0,65
16,21,18,5,5,4,0,0,0,69
16,21,18,5,5,9,14,7,0,95
16,21,18,5,5,19,0,0,0,84
16,21,18,5,25,0,0,0,0,85
16,21,18,5,12,25,0,0,0,97
16,21,18,5,14,5,19,19,0,117
16,21,18,5,18,0,0,0,0,78
16,21,18,5,19,20,0,0,0,99
16,21,18,6,12,5,0,0,0,78
16,21,18,6,12,5,4,0,0,82
16,21,18,6,12,5,18,0,0,96
16,21,18,6,12,5,19,0,0,97
16,21,18,6,12,25,0,0,0,98
16,21,18,6,12,9,14,7,0,103
16,21,18,6,12,9,14,7,19,122
16,21,18,7,1,0,0,0,0,63
16,21,18,7,1,13,5,14,20,115
16,21,18,7,1,20,9,15,14,121
16,21,18,7,1,20,9,22,5,119
16,21,18,7,1,20,15,18,25,141
16,21,18,7,5,0,0,0,0,67
16,21,18,7,5,1,2,12,5,87
16,21,18,7,5,4,0,0,0,71
16,21,18,7,5,18,0,0,0,85
16,21,18,7,5,18,25,0,0,110
16,21,18,7,5,18,19,0,0,104
16,21,18,7,5,19,0,0,0,86
16,21,18,7,9,14,7,0,0,92
16,21,18,7,9,14,7,19,0,111
16,21,18,9,6,25,0,0,0,95
16,21,18,9,6,9,5,4,0,88
16,21,18,9,6,9,5,18,0,102
16,21,18,9,6,9,5,18,19,121
16,21,18,9,6,9,5,19,0,103
16,21,18,9,6,25,9,14,7,125
16,21,18,9,6,15,18,13,0,116
16,21,18,9,14,0,0,0,0,78
16,21,18,9,14,5,0,0,0,83
16,21,18,9,14,5,19,0,0,102
16,21,18,9,14,19,0,0,0,97
16,21,18,9,18,9,0,0,0,91
16,21,18,9,19,0,0,0,0,83
16,21,18,9,19,13,0,0,0,96
16,21,18,9,19,13,19,0,0,115
16,21,18,9,19,20,0,0,0,103
16,21,18,9,19,20,9,3,0,115
16,21,18,9,19,20,19,0,0,122
16,21,18,9,20,1,14,9,3,111
16,21,18,9,20,1,14,15,0,114
16,21,18,9,20,1,14,19,0,118
16,21,18,9,20,9,5,19,0,117
16,21,18,12,0,0,0,0,0,67
16,21,18,12,5,4,0,0,0,76
16,21,18,12,5,18,0,0,0,90
16,21,18,12,8,15,21,19,5,135
16,21,18,12,9,3,21,5,0,105
16,21,18,12,9,3,21,5,19,124
16,21,18,12,9,5,21,0,0,102
16,21,18,12,9,5,21,19,0,121
16,21,18,12,9,14,0,0,0,90
16,21,18,12,9,14,5,0,0,95
16,21,18,12,9,14,5,19,0,114
16,21,18,12,9,14,19,0,0,109
16,21,18,12,13,1,14,0,0,95
16,21,18,12,15,9,14,0,0,105
16,21,18,12,15,9,14,5,4,114
16,21,18,12,15,9,14,5,18,128
16,21,18,12,15,9,14,19,0,124
16,21,18,12,19,0,0,0,0,86
16,21,18,15,8,9,20,0,0,107
16,21,18,15,12,25,13,16,8,144
16,21,18,15,13,25,3,9,14,134
16,21,18,16,1,18,20,0,0,110
16,21,18,16,1,18,20,25,0,135
16,21,18,16,5,14,19,5,0,114
16,21,18,16,9,5,0,0,0,85
16,21,18,16,12,5,0,0,0,88
16,21,18,16,12,5,4,0,0,92
16,21,18,16,12,5,12,25,0,125
16,21,18,16,12,5,12,9,16,125
16,21,18,16,12,5,18,0,0,106
16,21,18,16,12,5,19,0,0,107
16,21,18,16,12,5,19,20,0,127
16,21,18,16,12,25,0,0,0,108
16,21,18,16,12,9,14,7,0,113
16,21,18,16,12,9,19,8,0,119
16,21,18,16,15,18,20,0,0,124
16,21,18,16,15,18,20,5,4,133
16,21,18,16,15,18,20,5,18,147
16,21,18,16,15,18,20,5,19,148
16,21,18,16,15,18,20,19,0,143
16,21,18,16,15,19,5,0,0,110
16,21,18,16,15,19,5,4,0,114
16,21,18,16,15,19,5,12,25,147
16,21,18,16,15,19,5,18,0,128
16,21,18,16,15,19,5,19,0,129
16,21,18,16,15,19,9,14,7,135
16,21,18,16,15,19,9,22,5,141
16,21,18,16,18,9,19,5,0,122
16,21,18,16,21,18,1,19,0,130
16,21,18,16,21,18,1,20,5,136
16,21,18,16,21,18,5,0,0,115
16,21,18,16,21,18,5,1,12,128
16,21,18,16,21,18,5,1,14,130
16,21,18,16,21,18,5,19,0,134
16,21,18,16,21,18,9,3,0,122
16,21,18,16,21,18,9,14,0,133
16,21,18,16,21,18,9,14,5,138
16,21,18,16,21,18,9,14,19,152
16,21,18,16,21,18,9,20,5,144
16,21,18,16,21,18,9,26,5,150
16,21,18,16,21,18,15,9,4,138
16,21,18,18,0,0,0,0,0,73
16,21,18,18,1,8,0,0,0,82
16,21,18,18,5,0,0,0,0,78
16,21,18,18,5,4,0,0,0,82
16,21,18,18,5,5,0,0,0,83
16,21,18,18,5,9,3,0,0,90
16,21,18,18,5,12,0,0,0,90
16,21,18,18,5,18,0,0,0,96
16,21,18,18,25,0,0,0,0,98
16,21,18,18,9,14,7,0,0,103
16,21,18,18,9,14,7,12,25,140
16,21,18,18,15,14,5,0,0,107
16,21,18,18,19,0,0,0,0,92
16,21,18,19,0,0,0,0,0,74
16,21,18,19,5,4,0,0,0,83
16,21,18,19,5,6,21,12,0,118
16,21,18,19,5,12,5,19,19,134
16,21,18,19,5,12,9,11,5,116
16,21,18,19,5,18,0,0,0,97
16,21,18,19,5,18,19,0,0,116
16,21,18,19,5,19,0,0,0,98
16,21,18,19,5,20,0,0,0,99
16,21,18,19,25,0,0,0,0,99
16,21,18,19,9,5,18,0,0,106
16,21,18,19,9,5,19,20,0,127
16,21,18,19,9,12,25,0,0,120
16,21,18,19,9,14,5,19,19,140
16,21,18,19,9,14,7,0,0,104
16,21,18,19,9,22,5,0,0,110
16,21,18,19,12,1,14,5,0,106
16,21,18,19,12,1,14,5,19,125
16,21,18,19,12,5,25,0,0,116
16,21,18,19,12,5,20,0,0,111
16,21,18,19,21,1,2,12,5,115
16,21,18,19,21,1,12,0,0,108
16,21,18,19,21,1,14,3,5,118
16,21,18,19,21,1,14,20,0,130
16,21,18,19,21,5,0,0,0,100
16,21,18,19,21,5,4,0,0,104
16,21,18,19,21,5,18,0,0,118
16,21,18,19,21,5,18,19,0,137
16,21,18,19,21,5,19,0,0,119
16,21,18,19,21,9,14,7,0,125
16,21,18,19,21,9,20,0,0,124
16,21,18,19,21,9,20,19,0,143
16,21,18,20,25,0,0,0,0,100
16,21,18,21,12,5,14,3,5,115
16,21,18,21,12,5,14,3,25,135
16,21,18,21,12,5,14,20,0,127
16,21,18,21,12,15,9,4,0,116
16,21,18,21,19,8,1,0,0,104
16,21,18,22,5,25,0,0,0,107
16,21,18,22,5,25,1,12,0,120
16,21,18,22,5,25,5,4,0,116
16,21,18,22,5,25,9,14,7,137
16,21,18,22,5,25,15,18,0,140
16,21,18,22,5,25,15,18,19,159
16,21,18,22,5,25,19,0,0,126
16,21,18,22,9,5,23,0,0,114
16,21,18,22,9,5,23,19,0,133
16,21,18,22,15,5,0,0,0,97
16,21,18,23,1,14,14,1,8,116
16,21,19,0,0,0,0,0,0,56
16,21,19,5,19,0,0,0,0,80
16,21,19,7,21,20,0,0,0,104
16,21,19,8,0,0,0,0,0,64
16,21,19,8,2,1,12,12,0,91
16,21,19,8,2,1,12,12,19,110
16,21,19,8,3,1,18,4,0,90
16,21,19,8,3,1,18,20,0,106
16,21,19,8,3,1,18,20,19,125
16,21,19,8,3,8,1,9,18,103
16,21,19,8,4,15,23,14,0,120
16,21,19,8,4,15,23,14,19,139
16,21,19,8,5,4,0,0,0,73
16,21,19,8,5,18,0,0,0,87
16,21,19,8,5,18,19,0,0,106
16,21,19,8,5,19,0,0,0,88
16,21,19,8,6,21,12,0,0,103
16,21,19,8,6,21,12,12,25,140
16,21,19,8,25,0,0,0,0,89
16,21,19,8,9,5,18,0,0,96
16,21,19,8,9,5,19,20,0,117
16,21,19,8,9,12,25,0,0,110
16,21,19,8,9,14,5,19,19,130
16,21,19,8,9,14,7,0,0,94
16,21,19,8,9,14,7,12,25,131
16,21,19,8,13,9,14,1,0,101
16,21,19,8,15,21,20,0,0,120
16,21,19,8,15,22,5,18,0,124
16,21,19,8,15,22,5,18,19,143
16,21,19,8,16,9,14,0,0,103
16,21,19,8,16,9,14,19,0,122
16,21,19,8,18,15,4,0,0,101
16,21,19,8,18,15,4,19,0,120
16,21,19,8,21,13,0,0,0,98
16,21,19,8,21,16,0,0,0,101
16,21,19,8,21,16,19,0,0,120
16,21,19,9,12,12,0,0,0,89
16,21,19,12,5,25,0,0,0,98
16,21,19,12,5,25,19,0,0,117
16,21,19,12,9,11,5,0,0,93
16,21,19,19,3,1,20,0,0,99
16,21,19,19,5,19,0,0,0,99
16,21,19,19,25,3,1,20,0,124
16,21,19,19,25,3,1,20,19,143
16,21,19,19,9,5,18,0,0,107
16,21,19,19,9,5,19,0,0,108
16,21,19,19,9,5,19,20,0,128
16,21,19,19,25,6,15,15,20,156
16,21,19,19,9,14,5,19,19,141
16,21,19,19,25,20,15,5,0,140
16,21,19,19,12,5,25,0,0,117
16,21,19,19,12,5,25,19,0,136
16,21,19,19,12,25,0,0,0,112
16,21,19,19,12,9,5,19,0,120
16,21,19,19,12,9,11,5,0,112
16,21,19,20,21,12,1,14,20,144
16,21,19,20,21,12,1,18,0,128
16,21,19,20,21,12,1,20,5,135
16,21,19,20,21,12,5,0,0,114
16,21,19,20,21,12,5,4,0,118
16,21,19,20,21,12,5,19,0,133
16,21,19,20,21,12,15,19,5,148
16,21,19,20,21,12,15,21,19,164
16,21,19,26,20,1,0,0,0,103
16,21,20,0,0,0,0,0,0,57
16,21,20,1,7,5,0,0,0,70
16,21,20,1,9,14,0,0,0,81
16,21,20,1,13,5,14,0,0,90
16,21,20,1,13,9,14,1,0,95
16,21,20,1,14,9,19,13,0,113
16,21,20,1,20,9,15,14,0,116
16,21,20,1,20,9,22,5,0,114
16,21,20,2,1,3,11,0,0,74
16,21,20,3,8,5,14,0,0,87
16,21,20,3,8,5,18,0,0,91
16,21,20,3,8,21,11,0,0,100
16,21,20,4,15,23,14,0,0,113
16,21,20,4,15,23,14,19,0,132
16,21,20,5,1,12,0,0,0,75
16,21,20,5,12,5,5,0,0,84
16,21,20,5,12,9,0,0,0,83
16,21,20,8,5,18,0,0,0,88
16,21,20,8,5,18,25,0,0,113
16,21,20,9,4,0,0,0,0,70
16,21,20,9,4,12,25,0,0,107
16,21,20,9,4,14,5,19,19,127
16,21,20,9,14,7,0,0,0,87
16,21,20,12,15,3,11,0,0,98
16,21,20,12,15,7,0,0,0,91
16,21,20,12,15,7,19,0,0,110
16,21,20,15,6,6,0,0,0,84
16,21,20,15,6,6,19,0,0,103
16,21,20,15,9,19,0,0,0,100
16,21,20,15,14,0,0,0,0,86
16,21,20,15,14,19,0,0,0,105
16,21,20,15,21,20,0,0,0,113
16,21,20,15,21,20,19,0,0,132
16,21,20,18,5,6,25,0,0,111
16,21,20,18,5,6,9,5,4,104
16,21,20,18,5,6,9,5,18,118
16,21,20,18,5,6,9,5,19,119
16,21,20,18,5,19,3,5,0,107
16,21,20,18,9,3,9,4,5,105
16,21,20,18,9,4,0,0,0,88
16,21,20,18,9,4,9,20,25,142
16,21,20,18,9,4,12,25,0,125
16,21,20,18,9,6,15,18,13,136
16,21,20,18,9,12,1,7,5,109
16,21,20,19,0,0,0,0,0,76
16,21,20,19,3,8,5,19,0,111
16,21,20,19,3,8,9,19,13,128
16,21,20,19,3,8,9,19,20,135
16,21,20,20,0,0,0,0,0,77
16,21,20,20,1,14,0,0,0,92
16,21,20,20,5,4,0,0,0,86
16,21,20,20,5,5,0,0,0,87
16,21,20,20,5,5,19,0,0,106
16,21,20,20,5,18,0,0,0,100
16,21,20,20,5,18,5,4,0,109
16,21,20,20,5,18,5,18,0,123
16,21,20,20,5,18,5,18,19,142
16,21,20,20,5,18,9,14,7,130
16,21,20,20,5,18,19,0,0,119
16,21,20,20,9,0,0,0,0,86
16,21,20,20,25,0,0,0,0,102
16,21,20,20,9,5,0,0,0,91
16,21,20,20,9,5,4,0,0,95
16,21,20,20,9,5,18,0,0,109
16,21,20,20,9,5,18,19,0,128
16,21,20,20,9,5,19,0,0,110
16,21,20,20,25,8,5,1,4,120
16,21,20,20,25,9,14,7,0,132
16,21,20,20,25,12,9,11,5,139
16,21,20,20,9,14,7,0,0,107
16,21,20,20,25,18,15,15,20,170
16,21,20,20,25,23,15,18,11,169
16,21,20,20,15,0,0,0,0,92
16,21,20,20,15,3,11,0,0,106
16,21,20,20,15,15,0,0,0,107
16,21,20,20,19,0,0,0,0,96
16,21,20,21,18,5,0,0,0,101
16,21,20,26,0,0,0,0,0,83
16,21,20,26,5,4,0,0,0,92
16,21,20,26,5,19,0,0,0,107
16,21,20,26,9,14,7,0,0,113
16,21,24,25,0,0,0,0,0,86
16,21,26,26,12,5,0,0,0,106
16,21,26,26,12,5,4,0,0,110
16,21,26,26,12,5,4,12,25,147
16,21,26,26,12,5,4,15,13,138
16,21,26,26,12,5,13,1,14,134
16,21,26,26,12,5,18,0,0,124
16,21,26,26,12,5,18,19,0,143
16,21,26,26,12,5,19,0,0,125
16,21,26,26,12,9,14,7,0,131
16,21,26,26,12,9,14,7,19,150
16,21,26,26,15,12,1,14,0,131
16,21,26,26,15,12,1,14,1,132
16,23,3,1,0,0,0,0,0,43
16,23,18,0,0,0,0,0,0,57
16,23,20,0,0,0,0,0,0,59
17,5,18,5,0,0,0,0,0,45
17,5,18,9,0,0,0,0,0,49
17,9,2,12,1,0,0,0,0,41
17,9,25,1,19,0,0,0,0,71
17,9,14,4,1,18,0,0,0,63
17,9,14,4,1,18,11,1,0,75
17,9,14,4,1,18,19,0,0,82
17,9,14,20,1,18,0,0,0,79
17,9,14,20,1,18,19,0,0,98
17,9,22,9,21,20,0,0,0,98
17,9,22,9,21,20,19,0,0,117
17,15,16,8,0,0,0,0,0,56
17,15,16,8,19,0,0,0,0,75
17,18,19,0,0,0,0,0,0,54
17,20,4,0,0,0,0,0,0,41
17,20,15,0,0,0,0,0,0,52
17,20,18,0,0,0,0,0,0,55
17,20,19,0,0,0,0,0,0,56
17,21,2,2,1,0,0,0,0,43
17,21,5,1,3,8,0,0,0,55
17,21,5,1,3,8,25,0,0,80
17,21,5,1,3,8,9,5,18,87
17,21,5,1,11,0,0,0,0,55
17,21,5,1,12,0,0,0,0,56
17,21,5,1,14,0,0,0,0,58
17,21,5,1,14,9,19,8,0,94
17,21,5,1,14,12,9,11,5,95
17,21,5,1,14,19,0,0,0,77
17,21,5,1,19,5,0,0,0,68
17,21,5,1,19,25,0,0,0,88
17,21,5,1,19,9,5,18,0,95
17,21,5,1,19,9,5,19,20,116
17,21,5,1,19,9,12,25,0,109
17,21,5,1,19,15,13,0,0,91
17,21,5,1,26,5,14,0,0,89
17,21,5,1,26,25,0,0,0,95
17,21,5,1,26,9,5,18,0,102
17,21,5,1,26,9,5,19,20,123
17,21,5,2,18,1,3,8,15,90
17,21,5,2,18,1,4,1,0,69
17,21,5,2,18,9,20,8,0,100
17,21,5,4,6,21,12,0,0,86
17,21,5,4,12,25,0,0,0,84
17,21,5,4,14,5,19,19,0,104
17,21,5,4,19,8,9,16,0,99
17,21,5,5,3,8,25,0,0,84
17,21,5,5,14,3,1,11,5,82
17,21,5,5,14,3,21,16,0,102
17,21,5,5,14,4,15,13,0,94
17,21,5,5,14,5,4,0,0,71
17,21,5,5,14,6,9,19,8,104
17,21,5,5,14,8,15,15,4,104
17,21,5,5,14,9,14,7,0,92
17,21,5,5,14,9,20,5,0,96
17,21,5,5,14,12,5,19,19,117
17,21,5,5,14,12,5,20,0,99
17,21,5,5,14,12,25,0,0,99
17,21,5,5,14,12,9,5,18,106
17,21,5,5,14,12,9,11,5,99
17,21,5,5,14,18,15,15,20,130
17,21,5,5,14,19,8,9,16,114
17,21,5,5,14,23,5,5,4,99
17,21,5,5,14,23,15,15,4,119
17,21,5,5,18,0,0,0,0,66
17,21,5,5,18,5,4,0,0,75
17,21,5,5,18,5,18,0,0,89
17,21,5,5,18,5,19,20,0,110
17,21,5,5,18,25,0,0,0,91
17,21,5,5,18,9,14,7,0,96
17,21,5,5,18,9,19,8,0,102
17,21,5,5,18,9,20,25,0,120
17,21,5,5,18,12,25,0,0,103
17,21,5,5,18,14,5,19,19,123
17,21,5,5,18,19,0,0,0,85
17,21,5,5,18,19,15,13,5,118
17,21,5,5,19,20,0,0,0,87
17,21,5,5,19,20,9,14,7,117
17,21,5,5,20,0,0,0,0,68
17,21,5,5,22,5,0,0,0,75
17,21,5,7,8,0,0,0,0,58
17,21,5,9,0,0,0,0,0,52
17,21,5,25,0,0,0,0,0,68
17,21,5,9,14,7,0,0,0,73
17,21,5,9,14,20,9,19,5,119
17,21,5,25,19,0,0,0,0,87
17,21,5,12,3,8,0,0,0,66
17,21,5,12,9,20,5,0,0,89
17,21,5,12,12,0,0,0,0,67
17,21,5,12,12,1,2,12,5,87
17,21,5,12,12,5,4,0,0,76
17,21,5,12,12,5,18,0,0,90
17,21,5,12,12,5,18,19,0,109
17,21,5,12,12,9,14,7,0,97
17,21,5,12,12,9,15,0,0,91
17,21,5,12,12,19,0,0,0,86
17,21,5,12,12,21,14,7,0,109
17,21,5,12,13,5,0,0,0,73
17,21,5,12,20,0,0,0,0,75
17,21,5,13,0,0,0,0,0,56
17,21,5,13,5,0,0,0,0,61
17,21,5,13,5,6,21,12,0,100
17,21,5,13,5,12,25,0,0,98
17,21,5,14,3,8,0,0,0,68
17,21,5,14,3,8,5,4,0,77
17,21,5,14,3,8,5,18,0,91
17,21,5,14,3,8,5,18,19,110
17,21,5,14,3,8,5,19,0,92
17,21,5,14,3,8,9,14,7,98
17,21,5,14,4,1,0,0,0,62
17,21,5,14,5,12,12,5,0,91
17,21,5,14,5,12,12,5,19,110
17,21,5,14,9,20,5,0,0,91
17,21,5,14,20,9,19,5,0,110
17,21,5,18,3,5,20,9,3,101
17,21,5,18,3,5,20,9,14,112
17,21,5,18,3,5,20,21,13,123
17,21,5,18,3,9,3,0,0,76
17,21,5,18,3,9,14,0,0,87
17,21,5,18,3,9,14,5,0,92
17,21,5,18,3,9,14,9,3,99
17,21,5,18,3,9,20,5,0,98
17,21,5,18,3,9,20,9,14,116
17,21,5,18,3,9,20,15,12,120
17,21,5,18,5,12,1,0,0,79
17,21,5,18,5,12,1,5,0,84
17,21,5,18,5,12,5,0,0,83
17,21,5,18,5,14,3,9,1,93
17,21,5,18,5,14,20,0,0,100
17,21,5,18,25,0,0,0,0,86
17,21,5,18,9,4,15,0,0,89
17,21,5,18,9,4,15,19,0,108
17,21,5,18,9,5,4,0,0,79
17,21,5,18,9,5,18,0,0,93
17,21,5,18,9,5,18,19,0,112
17,21,5,18,9,5,19,0,0,94
17,21,5,18,25,9,14,7,0,116
17,21,5,18,25,9,19,20,0,134
17,21,5,18,9,13,1,14,0,98
17,21,5,18,9,13,1,14,19,117
17,21,5,18,9,13,15,14,25,137
17,21,5,18,9,19,20,0,0,109
17,21,5,18,9,19,20,19,0,128
17,21,5,18,11,5,14,0,0,91
17,21,5,18,12,0,0,0,0,73
17,21,5,18,14,0,0,0,0,75
17,21,5,18,14,1,12,0,0,88
17,21,5,18,14,19,0,0,0,94
17,21,5,18,18,5,0,0,0,84
17,21,5,18,21,12,1,14,20,129
17,21,5,18,21,12,5,14,20,133
17,21,5,18,21,12,9,19,20,142
17,21,5,18,21,12,9,20,25,148
17,21,5,18,21,12,15,21,19,149
17,21,5,19,0,0,0,0,0,62
17,21,5,19,1,12,0,0,0,75
17,21,5,19,9,20,5,4,0,100
17,21,5,19,9,20,9,22,5,127
17,21,5,19,20,0,0,0,0,82
17,21,5,19,20,5,4,0,0,91
17,21,5,19,20,5,18,0,0,105
17,21,5,19,20,5,18,19,0,124
17,21,5,19,20,5,21,18,0,126
17,21,5,19,20,6,21,12,0,121
17,21,5,19,20,9,14,7,0,112
17,21,5,19,20,9,15,14,0,120
17,21,5,19,20,9,15,14,19,139
17,21,5,19,20,13,1,14,0,110
17,21,5,19,20,13,5,14,0,114
17,21,5,19,20,15,18,0,0,115
17,21,5,19,20,15,18,19,0,134
17,21,5,19,20,18,9,19,20,148
17,21,5,19,20,19,0,0,0,101
17,21,5,20,0,0,0,0,0,63
17,21,5,20,3,8,0,0,0,74
17,21,5,20,5,14,9,20,5,116
17,21,5,20,8,5,0,0,0,76
17,21,5,20,19,3,8,0,0,93
17,21,5,20,26,1,12,0,0,102
17,21,5,20,26,1,12,5,19,126
17,21,5,20,26,1,12,19,0,121
17,21,5,21,5,0,0,0,0,69
17,21,5,21,5,4,0,0,0,73
17,21,5,21,5,9,14,7,0,99
17,21,5,21,5,18,0,0,0,87
17,21,5,21,5,18,19,0,0,106
17,21,5,21,5,19,0,0,0,88
17,21,5,21,9,14,7,0,0,94
17,21,5,26,1,12,0,0,0,82
17,21,5,26,1,12,5,19,0,106
17,21,5,26,1,12,19,0,0,101
17,21,9,0,0,0,0,0,0,47
17,21,9,1,0,0,0,0,0,48
17,21,9,1,16,15,0,0,0,79
17,21,9,1,17,21,9,1,0,96
17,21,9,2,0,0,0,0,0,49
17,21,9,2,2,12,5,0,0,68
17,21,9,2,2,12,5,4,0,72
17,21,9,2,2,12,5,18,0,86
17,21,9,2,2,12,5,18,19,105
17,21,9,2,2,12,5,19,0,87
17,21,9,2,2,12,9,14,7,93
17,21,9,2,12,5,20,0,0,86
17,21,9,2,21,19,0,0,0,89
17,21,9,3,1,0,0,0,0,51
17,21,9,3,8,5,19,0,0,82
17,21,9,3,11,2,5,1,13,82
17,21,9,3,11,2,15,18,14,110
17,21,9,3,11,5,4,0,0,70
17,21,9,3,11,5,14,0,0,80
17,21,9,3,11,5,14,5,4,89
17,21,9,3,11,5,14,5,18,103
17,21,9,3,11,5,14,19,0,99
17,21,9,3,11,5,18,0,0,84
17,21,9,3,11,5,19,20,0,105
17,21,9,3,11,6,15,15,20,117
17,21,9,3,11,9,5,0,0,75
17,21,9,3,11,9,5,19,0,94
17,21,9,3,11,9,14,7,0,91
17,21,9,3,11,12,25,0,0,98
17,21,9,3,11,12,9,13,5,100
17,21,9,3,11,14,5,19,19,118
17,21,9,3,11,19,0,0,0,80
17,21,9,3,11,19,1,14,4,99
17,21,9,3,11,19,5,20,0,105
17,21,9,3,11,19,5,20,19,124
17,21,9,3,11,19,9,4,5,98
17,21,9,3,11,19,20,5,16,121
17,21,9,3,11,23,15,18,11,128
17,21,9,4,0,0,0,0,0,51
17,21,9,4,1,13,0,0,0,65
17,21,9,4,4,1,14,25,0,95
17,21,9,4,4,5,18,0,0,78
17,21,9,4,4,9,20,0,0,84
17,21,9,4,4,9,20,25,0,109
17,21,9,4,4,12,5,0,0,72
17,21,9,4,4,12,5,4,0,76
17,21,9,4,4,12,5,18,0,90
17,21,9,4,4,12,9,14,7,97
17,21,9,4,14,21,14,3,0,103
17,21,9,4,14,21,14,3,19,122
17,21,9,4,19,0,0,0,0,70
17,21,9,5,14,1,12,0,0,79
17,21,9,5,19,3,5,0,0,79
17,21,9,5,19,3,5,4,0,83
17,21,9,5,19,3,5,14,20,113
17,21,9,5,19,3,9,14,7,104
17,21,9,5,20,0,0,0,0,72
17,21,9,5,20,1,0,0,0,73
17,21,9,5,20,1,2,12,5,92
17,21,9,5,20,1,7,5,0,85
17,21,9,5,20,5,4,0,0,81
17,21,9,5,20,5,14,0,0,91
17,21,9,5,20,5,14,5,4,100
17,21,9,5,20,5,14,5,18,114
17,21,9,5,20,5,14,19,0,110
17,21,9,5,20,5,18,0,0,95
17,21,9,5,20,5,18,19,0,114
17,21,9,5,20,5,19,20,0,116
17,21,9,5,20,9,0,0,0,81
17,21,9,5,20,9,14,7,0,102
17,21,9,5,20,9,19,13,0,113
17,21,9,5,20,9,19,13,19,132
17,21,9,5,20,9,19,20,0,120
17,21,9,5,20,9,19,20,19,139
17,21,9,5,20,9,22,5,0,108
17,21,9,5,20,12,25,0,0,109
17,21,9,5,20,12,9,11,5,109
17,21,9,5,20,14,5,19,19,129
17,21,9,5,20,19,0,0,0,91
17,21,9,5,20,19,15,13,5,124
17,21,9,5,20,21,4,5,0,102
17,21,9,5,20,21,4,5,19,121
17,21,9,5,20,21,19,0,0,112
17,21,9,5,20,21,19,5,19,136
17,21,9,6,6,0,0,0,0,59
17,21,9,6,6,9,14,7,0,89
17,21,9,6,6,19,0,0,0,78
17,21,9,12,1,0,0,0,0,60
17,21,9,12,1,20,5,0,0,85
17,21,9,12,5,3,5,19,0,91
17,21,9,12,5,19,0,0,0,83
17,21,9,12,5,19,5,19,0,107
17,21,9,12,5,26,0,0,0,90
17,21,9,12,9,19,13,1,0,101
17,21,9,12,11,9,14,0,0,93
17,21,9,12,12,1,9,0,0,81
17,21,9,12,12,1,9,1,0,82
17,21,9,12,12,1,9,1,19,101
17,21,9,12,12,1,9,3,0,84
17,21,9,12,12,1,9,19,0,100
17,21,9,12,12,1,10,1,19,102
17,21,9,12,12,1,10,9,3,94
17,21,9,12,12,2,1,3,11,88
17,21,9,12,12,5,4,0,0,80
17,21,9,12,12,5,18,0,0,94
17,21,9,12,12,5,20,0,0,96
17,21,9,12,12,5,20,5,4,105
17,21,9,12,12,5,20,19,0,115
17,21,9,12,12,6,9,19,8,113
17,21,9,12,12,25,0,0,0,96
17,21,9,12,12,9,14,7,0,101
17,21,9,12,12,9,20,25,0,125
17,21,9,12,12,19,0,0,0,90
17,21,9,12,12,20,1,9,12,113
17,21,9,12,12,23,15,18,11,138
17,21,9,12,12,23,15,18,20,147
17,21,9,12,20,0,0,0,0,79
17,21,9,12,20,5,4,0,0,88
17,21,9,12,20,5,18,0,0,102
17,21,9,12,20,5,18,19,0,121
17,21,9,12,20,9,14,7,0,109
17,21,9,12,20,9,14,7,19,128
17,21,9,12,20,19,0,0,0,98
17,21,9,13,0,0,0,0,0,60
17,21,9,14,1,0,0,0,0,62
17,21,9,14,1,12,4,9,3,90
17,21,9,14,1,12,4,25,12,115
17,21,9,14,1,12,4,9,14,101
17,21,9,14,1,13,9,14,0,98
17,21,9,14,1,13,9,14,5,103
17,21,9,14,1,18,25,0,0,105
17,21,9,14,1,18,9,1,14,104
17,21,9,14,1,18,9,5,19,113
17,21,9,14,1,18,9,9,0,98
17,21,9,14,1,18,9,21,19,129
17,21,9,14,1,19,0,0,0,81
17,21,9,14,1,20,5,0,0,87
17,21,9,14,3,5,19,0,0,88
17,21,9,14,3,8,0,0,0,72
17,21,9,14,3,9,5,19,0,97
17,21,9,14,3,21,14,24,0,123
17,21,9,14,4,5,3,1,4,78
17,21,9,14,4,5,3,9,13,95
17,21,9,14,4,5,14,5,0,89
17,21,9,14,5,12,1,0,0,79
17,21,9,14,5,12,1,19,0,98
17,21,9,14,5,12,12,1,0,91
17,21,9,14,5,12,12,1,19,110
17,21,9,14,5,20,0,0,0,86
17,21,9,14,5,20,21,13,0,120
17,21,9,14,9,1,0,0,0,71
17,21,9,14,9,2,12,5,0,89
17,21,9,14,9,3,0,0,0,73
17,21,9,14,9,3,9,14,0,96
17,21,9,14,9,3,9,14,5,101
17,21,9,14,9,4,9,1,0,84
17,21,9,14,9,4,9,14,0,97
17,21,9,14,9,4,9,14,5,102
17,21,9,14,9,5,12,1,0,88
17,21,9,14,9,5,12,1,19,107
17,21,9,14,25,9,5,0,0,100
17,21,9,14,25,12,0,0,0,98
17,21,9,14,9,14,0,0,0,84
17,21,9,14,9,14,1,0,0,85
17,21,9,14,9,14,1,19,0,104
17,21,9,14,9,14,5,0,0,89
17,21,9,14,9,14,5,19,0,108
17,21,9,14,9,14,9,3,0,96
17,21,9,14,9,14,9,19,13,125
17,21,9,14,9,14,9,26,5,124
17,21,9,14,9,14,19,0,0,103
17,21,9,14,9,19,5,24,20,138
17,21,9,14,9,19,13,0,0,102
17,21,9,14,9,20,5,0,0,95
17,21,9,14,9,20,15,12,0,117
17,21,9,14,9,26,5,0,0,101
17,21,9,14,11,0,0,0,0,72
17,21,9,14,14,1,20,0,0,96
17,21,9,14,14,1,20,19,0,115
17,21,9,14,14,5,20,0,0,100
17,21,9,14,15,1,0,0,0,77
17,21,9,14,15,1,19,0,0,96
17,21,9,14,15,6,15,18,13,128
17,21,9,14,15,7,5,14,0,102
17,21,9,14,15,9,4,0,0,89
17,21,9,14,15,9,4,1,12,102
17,21,9,14,15,9,4,9,14,112
17,21,9,14,15,9,4,19,0,108
17,21,9,14,15,25,12,0,0,113
17,21,9,14,15,12,0,0,0,88
17,21,9,14,15,12,1,19,0,108
17,21,9,14,15,12,25,12,0,125
17,21,9,14,15,12,9,14,0,111
17,21,9,14,15,12,9,14,5,116
17,21,9,14,15,12,9,14,19,130
17,21,9,14,15,12,15,7,25,135
17,21,9,14,15,12,19,0,0,107
17,21,9,14,15,14,0,0,0,90
17,21,9,14,15,14,5,0,0,95
17,21,9,14,15,14,5,19,0,114
17,21,9,14,15,14,9,3,0,102
17,21,9,14,15,14,25,12,0,127
17,21,9,14,15,14,9,26,5,130
17,21,9,14,15,14,15,9,4,118
17,21,9,14,15,22,1,0,0,99
17,21,9,14,15,22,1,20,5,124
17,21,9,14,15,22,9,3,0,110
17,21,9,14,15,22,9,14,0,121
17,21,9,14,15,22,15,19,5,137
17,21,9,14,17,21,9,14,1,123
17,21,9,14,17,21,9,14,15,137
17,21,9,14,19,0,0,0,0,80
17,21,9,14,19,5,0,0,0,85
17,21,9,14,19,25,0,0,0,105
17,21,9,14,19,9,5,4,0,98
17,21,9,14,19,9,5,19,0,113
17,21,9,14,20,1,4,0,0,86
17,21,9,14,20,1,9,14,0,105
17,21,9,14,20,1,9,14,19,124
17,21,9,14,20,1,12,0,0,94
17,21,9,14,20,1,12,19,0,113
17,21,9,14,20,1,14,0,0,96
17,21,9,14,20,1,14,19,0,115
17,21,9,14,20,1,14,20,0,116
17,21,9,14,20,1,18,0,0,100
17,21,9,14,20,1,18,25,0,125
17,21,9,14,20,1,18,19,0,119
17,21,9,14,20,1,20,5,14,121
17,21,9,14,20,1,20,15,0,117
17,21,9,14,20,5,0,0,0,86
17,21,9,14,20,5,18,15,14,133
17,21,9,14,20,5,19,0,0,105
17,21,9,14,20,5,20,0,0,106
17,21,9,14,20,5,20,19,0,125
17,21,9,14,20,5,20,20,5,131
17,21,9,14,20,5,20,20,15,141
17,21,9,14,20,6,15,9,12,123
17,21,9,14,20,9,3,0,0,93
17,21,9,14,20,9,3,19,0,112
17,21,9,14,20,9,12,5,0,107
17,21,9,14,20,9,12,5,19,126
17,21,9,14,20,9,14,19,0,123
17,21,9,14,20,9,16,5,4,115
17,21,9,14,20,15,0,0,0,96
17,21,9,14,20,15,12,5,0,113
17,21,9,14,20,15,14,19,0,129
17,21,9,14,20,18,15,15,14,143
17,21,9,14,20,19,0,0,0,100
17,21,9,14,20,21,16,12,5,135
17,21,9,14,21,1,0,0,0,83
17,21,9,14,26,1,9,14,5,116
17,21,9,14,26,5,0,0,0,92
17,21,9,14,26,9,5,13,5,119
17,21,9,16,0,0,0,0,0,63
17,21,9,16,6,21,12,0,0,102
17,21,9,16,15,0,0,0,0,78
17,21,9,16,16,5,0,0,0,84
17,21,9,16,16,5,4,0,0,88
17,21,9,16,16,5,18,0,0,102
17,21,9,16,16,25,0,0,0,104
17,21,9,16,16,9,14,7,0,109
17,21,9,16,16,9,19,8,0,115
17,21,9,16,16,21,0,0,0,100
17,21,9,16,16,21,19,0,0,119
17,21,9,16,19,0,0,0,0,82
17,21,9,16,19,15,13,5,0,115
17,21,9,16,19,20,5,18,0,125
17,21,9,16,19,20,5,18,19,144
17,21,9,16,21,0,0,0,0,84
17,21,9,16,21,19,0,0,0,103
17,21,9,18,1,0,0,0,0,66
17,21,9,18,3,1,12,0,0,81
17,21,9,18,5,0,0,0,0,70
17,21,9,18,5,4,0,0,0,74
17,21,9,18,5,19,0,0,0,89
17,21,9,18,5,23,9,19,5,126
17,21,9,18,9,14,3,1,0,92
17,21,9,18,9,14,7,0,0,95
17,21,9,18,9,20,1,18,25,138
17,21,9,18,11,5,4,0,0,85
17,21,9,18,11,25,0,0,0,101
17,21,9,18,11,9,5,18,0,108
17,21,9,18,11,9,5,19,20,129
17,21,9,18,11,9,12,25,0,122
17,21,9,18,11,9,14,7,0,106
17,21,9,18,11,9,19,8,0,112
17,21,9,18,11,19,0,0,0,95
17,21,9,18,11,19,5,25,0,125
17,21,9,18,11,19,15,13,5,128
17,21,9,18,12,0,0,0,0,77
17,21,9,18,20,0,0,0,0,85
17,21,9,18,20,5,4,0,0,94
17,21,9,18,20,9,14,7,0,115
17,21,9,18,20,19,0,0,0,104
17,21,9,19,0,0,0,0,0,66
17,21,9,19,2,25,0,0,0,93
17,21,9,19,3,15,19,0,0,103
17,21,9,19,12,5,0,0,0,83
17,21,9,19,12,5,18,0,0,101
17,21,9,19,12,9,14,7,19,127
17,21,9,19,17,21,15,21,19,159
17,21,9,19,20,0,0,0,0,86
17,21,9,19,20,9,20,9,0,124
17,21,9,19,20,18,15,14,0,133
17,21,9,19,21,20,19,3,8,137
17,21,9,20,0,0,0,0,0,67
17,21,9,20,1,14,20,9,5,116
17,21,9,20,3,8,0,0,0,78
17,21,9,20,3,8,5,19,0,102
17,21,9,20,3,12,1,9,13,105
17,21,9,20,5,0,0,0,0,72
17,21,9,20,5,12,25,0,0,109
17,21,9,20,5,22,5,0,0,99
17,21,9,20,9,14,7,0,0,97
17,21,9,20,18,5,14,20,0,124
17,21,9,20,18,5,14,20,19,143
17,21,9,20,19,0,0,0,0,86
17,21,9,20,20,1,2,12,5,107
17,21,9,20,20,1,12,0,0,100
17,21,9,20,20,1,14,3,5,110
17,21,9,20,20,5,4,0,0,96
17,21,9,20,20,5,18,0,0,110
17,21,9,20,20,5,18,19,0,129
17,21,9,20,20,9,14,7,0,117
17,21,9,20,20,15,18,0,0,120
17,21,9,20,20,15,18,19,0,139
17,21,9,22,5,18,0,0,0,92
17,21,9,22,5,18,5,4,0,101
17,21,9,22,5,18,5,18,0,115
17,21,9,22,5,18,5,18,19,134
17,21,9,22,5,18,6,21,12,131
17,21,9,22,5,18,25,0,0,117
17,21,9,22,5,18,9,14,7,122
17,21,9,22,5,18,9,19,8,128
17,21,9,22,5,18,19,0,0,111
17,21,9,24,15,20,5,19,0,130
17,21,9,24,15,20,9,3,0,118
17,21,9,24,15,20,9,19,13,147
17,21,9,24,15,20,9,26,5,146
17,21,9,24,15,20,18,25,0,149
17,21,9,26,0,0,0,0,0,73
17,21,9,26,26,1,2,12,5,119
17,21,9,26,26,5,4,0,0,108
17,21,9,26,26,5,5,0,0,109
17,21,9,26,26,5,18,0,0,122
17,21,9,26,26,5,18,25,0,147
17,21,9,26,26,5,18,19,0,141
17,21,9,26,26,5,19,0,0,123
17,21,9,26,26,25,0,0,0,124
17,21,9,26,26,9,3,1,12,124
17,21,9,26,26,9,6,25,0,139
17,21,9,26,26,9,14,7,0,129
17,21,9,26,26,9,19,8,0,135
17,21,9,26,26,9,19,13,0,140
17,21,9,26,26,9,20,25,0,153
17,21,15,0,0,0,0,0,0,53
17,21,15,1,4,0,0,0,0,58
17,21,15,4,0,0,0,0,0,57
17,21,15,4,4,5,4,0,0,70
17,21,15,4,4,9,5,19,0,94
17,21,15,4,4,9,14,7,0,91
17,21,15,4,4,9,20,25,0,115
17,21,15,4,12,9,2,5,20,105
17,21,15,4,12,9,14,7,0,99
17,21,15,4,19,0,0,0,0,76
17,21,15,8,15,7,0,0,0,83
17,21,15,8,15,7,19,0,0,102
17,21,15,9,12,5,18,19,0,116
17,21,15,9,14,0,0,0,0,76
17,21,15,9,14,5,4,0,0,85
17,21,15,9,14,9,14,7,0,106
17,21,15,9,14,19,0,0,0,95
17,21,15,9,20,0,0,0,0,82
17,21,15,9,20,5,4,0,0,91
17,21,15,9,20,5,18,0,0,105
17,21,15,9,20,9,14,7,0,112
17,21,15,9,20,12,9,11,5,119
17,21,15,9,20,19,0,0,0,101
17,21,15,11,11,1,0,0,0,76
17,21,15,11,11,1,19,0,0,95
17,21,15,13,9,14,21,19,0,129
17,21,15,13,15,4,15,0,0,100
17,21,15,13,15,4,15,19,0,119
17,21,15,14,4,1,13,0,0,85
17,21,15,14,4,1,13,12,25,122
17,21,15,14,9,1,13,0,0,90
17,21,15,14,11,9,14,7,0,108
17,21,15,14,19,5,20,0,0,111
17,21,15,16,0,0,0,0,0,69
17,21,15,18,0,0,0,0,0,71
17,21,15,18,21,13,0,0,0,105
17,21,15,18,21,13,19,0,0,124
17,21,15,19,0,0,0,0,0,72
17,21,15,20,0,0,0,0,0,73
17,21,15,20,1,0,0,0,0,74
17,21,15,20,1,2,12,5,0,93
17,21,15,20,1,2,12,25,0,113
17,21,15,20,1,19,0,0,0,93
17,21,15,20,1,20,9,15,14,132
17,21,15,20,1,20,9,22,5,130
17,21,15,20,5,0,0,0,0,78
17,21,15,20,5,4,0,0,0,82
17,21,15,20,5,5,0,0,0,83
17,21,15,20,5,12,5,19,19,133
17,21,15,20,5,18,0,0,0,96
17,21,15,20,5,18,19,0,0,115
17,21,15,20,5,19,0,0,0,97
17,21,15,20,8,0,0,0,0,81
17,21,15,20,8,1,0,0,0,82
17,21,15,20,9,4,0,0,0,86
17,21,15,20,9,4,9,1,14,110
17,21,15,20,9,5,14,20,0,121
17,21,15,20,9,5,14,20,19,140
17,21,15,20,9,5,19,0,0,106
17,21,15,20,9,5,20,25,0,132
17,21,15,20,9,14,7,0,0,103
17,21,15,20,9,14,7,12,25,140
17,21,15,20,9,20,25,0,0,127
17,21,15,20,12,9,2,5,20,121
17,21,15,20,20,0,0,0,0,93
17,21,15,20,21,13,0,0,0,107
17,21,18,19,8,0,0,0,0,83
17,21,18,19,8,5,19,0,0,107
17,21,18,21,19,8,0,0,0,104
17,21,18,21,19,8,5,19,0,128
18,2,15,21,14,4,0,0,0,74
18,3,4,0,0,0,0,0,0,25
18,3,8,1,21,6,6,0,0,63
18,3,8,9,20,5,3,20,0,86
18,3,12,1,13,5,0,0,0,52
18,3,16,20,0,0,0,0,0,57
18,5,2,1,2,0,0,0,0,28
18,5,2,1,3,11,0,0,0,40
18,5,2,1,7,0,0,0,0,33
18,5,2,1,9,20,0,0,0,55
18,5,2,1,9,20,5,4,0,64
18,5,2,1,9,20,9,14,7,85
18,5,2,1,9,20,19,0,0,74
18,5,2,1,11,5,0,0,0,42
18,5,2,1,11,5,4,0,0,46
18,5,2,1,11,9,14,7,0,67
18,5,2,1,12,1,14,3,5,61
18,5,2,1,12,5,0,0,0,43
18,5,2,1,12,5,4,0,0,47
18,5,2,1,12,9,14,7,0,68
18,5,2,1,12,12,1,19,20,90
18,5,2,1,12,12,15,20,0,85
18,5,2,1,14,0,0,0,0,40
18,5,2,1,14,4,1,7,5,57
18,5,2,1,14,9,19,8,0,76
18,5,2,1,14,11,0,0,0,51
18,5,2,1,16,20,9,19,13,103
18,5,2,1,16,20,9,26,5,102
18,5,2,1,18,0,0,0,0,44
18,5,2,1,18,7,1,9,14,75
18,5,2,1,19,5,0,0,0,50
18,5,2,1,19,9,19,0,0,73
18,5,2,1,20,1,2,12,5,66
18,5,2,1,20,5,0,0,0,51
18,5,2,1,20,5,4,0,0,55
18,5,2,1,20,5,18,0,0,69
18,5,2,1,20,5,18,19,0,88
18,5,2,1,20,5,19,0,0,70
18,5,2,1,20,8,5,0,0,59
18,5,2,1,20,8,5,4,0,63
18,5,2,1,20,8,9,14,7,84
18,5,2,1,20,9,14,7,0,76
18,5,2,1,20,15,0,0,0,61
18,5,2,1,20,15,19,0,0,80
18,5,2,1,23,12,0,0,0,61
18,5,2,2,5,0,0,0,0,32
18,5,2,2,5,19,0,0,0,51
18,5,2,2,18,5,4,0,0,54
18,5,2,5,1,13,5,18,0,67
18,5,2,5,1,18,0,0,0,49
18,5,2,5,1,20,0,0,0,51
18,5,2,5,3,0,0,0,0,33
18,5,2,5,3,11,0,0,0,44
18,5,2,5,3,11,19,0,0,63
18,5,2,5,3,15,13,5,0,66
18,5,2,5,3,19,0,0,0,52
18,5,2,5,4,0,0,0,0,34
18,5,2,5,7,0,0,0,0,37
18,5,2,5,7,5,20,0,0,62
18,5,2,5,7,7,1,18,0,63
18,5,2,5,7,9,14,0,0,60
18,5,2,5,7,21,9,12,5,84
18,5,2,5,8,15,12,4,0,69
18,5,2,5,12,4,15,13,0,74
18,5,2,5,12,4,15,13,19,93
18,5,2,5,12,9,5,6,0,62
18,5,2,5,12,9,5,22,5,83
18,5,2,5,12,12,5,4,0,63
18,5,2,5,12,12,5,18,0,77
18,5,2,5,12,12,25,0,0,79
18,5,2,5,12,12,9,11,5,79
18,5,2,5,12,12,9,14,7,84
18,5,2,5,12,12,9,15,14,92
18,5,2,5,12,12,15,23,0,92
18,5,2,5,12,15,14,7,0,78
18,5,2,5,12,15,22,5,0,84
18,5,2,5,12,19,0,0,0,61
18,5,2,5,13,9,18,5,0,75
18,5,2,5,14,4,0,0,0,48
18,5,2,5,14,4,9,14,7,78
18,5,2,5,14,5,6,9,20,84
18,5,2,5,14,20,0,0,0,64
18,5,2,5,19,5,20,0,0,74
18,5,2,5,19,9,5,7,5,75
18,5,2,5,19,20,15,23,0,107
18,5,2,5,20,1,11,5,0,67
18,5,2,5,20,18,1,25,0,94
18,5,2,5,23,1,9,12,0,75
18,5,2,9,1,0,0,0,0,35
18,5,2,9,1,19,0,0,0,54
18,5,2,9,4,0,0,0,0,38
18,5,2,9,4,4,5,14,0,61
18,5,2,9,4,4,9,14,7,72
18,5,2,9,4,19,0,0,0,57
18,5,2,9,12,12,0,0,0,58
18,5,2,9,12,12,5,4,0,67
18,5,2,9,12,12,5,20,0,83
18,5,2,9,12,12,9,14,7,88
18,5,2,9,12,12,19,0,0,77
18,5,2,9,14,4,0,0,0,52
18,5,2,9,14,4,9,14,7,82
18,5,2,9,14,4,19,0,0,71
18,5,2,9,18,20,8,0,0,80
18,5,2,9,18,20,8,19,0,99
18,5,2,9,20,5,0,0,0,59
18,5,2,12,1,4,5,0,0,47
18,5,2,12,1,13,5,0,0,56
18,5,2,12,1,19,20,0,0,77
18,5,2,12,5,1,3,8,0,54
18,5,2,12,5,14,4,0,0,60
18,5,2,12,5,14,4,5,4,69
18,5,2,12,5,14,4,19,0,79
18,5,2,12,5,19,19,0,0,80
18,5,2,12,9,19,20,5,18,108
18,5,2,12,15,3,11,0,0,66
18,5,2,12,15,15,13,0,0,80
18,5,2,12,15,15,13,5,4,89
18,5,2,12,15,15,13,19,0,99
18,5,2,12,15,19,19,15,13,118
18,5,2,12,15,20,0,0,0,72
18,5,2,12,15,23,0,0,0,75
18,5,2,12,15,23,14,0,0,89
18,5,2,12,21,5,0,0,0,63
18,5,2,12,21,6,6,0,0,70
18,5,2,12,21,14,4,5,18,99
18,5,2,15,1,14,20,0,0,75
18,5,2,15,1,14,20,9,3,87
18,5,2,15,1,18,4,0,0,63
18,5,2,15,1,18,4,5,4,72
18,5,2,15,1,18,4,19,0,82
18,5,2,15,1,19,20,0,0,80
18,5,2,15,1,20,9,15,14,99
18,5,2,15,2,0,0,0,0,42
18,5,2,15,4,25,0,0,0,69
18,5,2,15,4,9,5,4,0,62
18,5,2,15,4,9,5,19,0,77
18,5,2,15,9,12,0,0,0,61
18,5,2,15,9,12,5,4,0,70
18,5,2,15,9,12,5,18,0,84
18,5,2,15,9,12,9,14,7,91
18,5,2,15,9,12,19,0,0,80
18,5,2,15,9,19,5,0,0,73
18,5,2,15,11,5,0,0,0,56
18,5,2,15,12,4,0,0,0,56
18,5,2,15,12,5,18,1,0,76
18,5,2,15,12,20,0,0,0,72
18,5,2,15,14,5,0,0,0,59
18,5,2,15,15,11,0,0,0,66
18,5,2,15,15,11,5,4,0,75
18,5,2,15,15,11,19,0,0,85
18,5,2,15,15,20,0,0,0,75
18,5,2,15,15,20,5,4,0,84
18,5,2,15,15,20,9,14,7,105
18,5,2,15,15,20,19,0,0,94
18,5,2,15,16,0,0,0,0,56
18,5,2,15,16,19,0,0,0,75
18,5,2,15,18,5,0,0,0,63
18,5,2,15,18,5,4,0,0,67
18,5,2,15,18,5,19,0,0,82
18,5,2,15,18,9,14,7,0,88
18,5,2,15,18,14,0,0,0,72
18,5,2,15,18,18,15,23,0,114
18,5,2,15,19,1,0,0,0,60
18,5,2,15,19,15,0,0,0,74
18,5,2,15,19,15,19,0,0,93
18,5,2,15,20,5,0,0,0,65
18,5,2,15,20,20,12,5,0,97
18,5,2,15,21,7,8,20,0,96
18,5,2,15,21,14,3,5,0,83
18,5,2,15,21,14,4,0,0,79
18,5,2,15,21,14,4,5,4,88
18,5,2,15,21,14,4,5,18,102
18,5,2,15,21,14,4,19,0,98
18,5,2,15,24,0,0,0,0,64
18,5,2,15,26,15,0,0,0,81
18,5,2,15,26,15,19,0,0,100
18,5,2,18,1,3,5,0,0,52
18,5,2,18,1,3,5,4,0,56
18,5,2,18,1,3,9,14,7,77
18,5,2,18,1,9,4,0,0,57
18,5,2,18,1,14,3,8,0,69
18,5,2,18,1,14,4,0,0,62
18,5,2,18,5,1,20,8,5,82
18,5,2,18,5,4,0,0,0,52
18,5,2,18,5,5,4,0,0,57
18,5,2,18,5,23,0,0,0,71
18,5,2,18,9,2,5,0,0,59
18,5,2,18,9,3,11,0,0,66
18,5,2,18,9,4,7,5,0,68
18,5,2,18,9,14,7,0,0,73
18,5,2,18,9,14,7,5,18,96
18,5,2,18,15,1,3,8,0,70
18,5,2,18,15,1,4,5,14,82
18,5,2,18,15,14,26,5,0,103
18,5,2,18,15,23,14,0,0,95
18,5,2,18,21,19,8,0,0,91
18,5,2,19,0,0,0,0,0,44
18,5,2,21,2,2,12,5,0,67
18,5,2,21,3,11,12,5,0,77
18,5,2,21,3,11,12,5,4,81
18,5,2,21,4,0,0,0,0,50
18,5,2,21,4,7,5,20,0,82
18,5,2,21,6,6,0,0,0,58
18,5,2,21,6,6,5,4,0,67
18,5,2,21,6,6,5,20,0,83
18,5,2,21,6,6,9,14,7,88
18,5,2,21,6,6,19,0,0,77
18,5,2,21,25,0,0,0,0,71
18,5,2,21,25,9,14,7,0,101
18,5,2,21,9,12,4,0,0,71
18,5,2,21,9,12,4,5,4,80
18,5,2,21,9,12,4,5,18,94
18,5,2,21,9,12,4,19,0,90
18,5,2,21,9,12,20,0,0,87
18,5,2,21,25,19,0,0,0,90
18,5,2,21,11,1,2,12,5,77
18,5,2,21,11,5,0,0,0,62
18,5,2,21,11,5,4,0,0,66
18,5,2,21,11,5,6,21,12,101
18,5,2,21,11,5,18,0,0,80
18,5,2,21,11,5,18,19,0,99
18,5,2,21,11,5,19,0,0,81
18,5,2,21,11,9,14,7,0,87
18,5,2,21,12,11,0,0,0,69
18,5,2,21,14,3,8,0,0,71
18,5,2,21,14,4,12,5,0,81
18,5,2,21,14,11,5,18,0,94
18,5,2,21,15,25,0,0,0,86
18,5,2,21,15,25,1,7,5,99
18,5,2,21,18,4,5,14,0,87
18,5,2,21,18,7,5,15,14,105
18,5,2,21,18,25,0,0,0,89
18,5,2,21,18,9,1,12,0,86
18,5,2,21,18,9,1,12,19,105
18,5,2,21,18,9,5,4,0,82
18,5,2,21,18,9,5,19,0,97
18,5,2,21,18,25,9,14,7,119
18,5,2,21,18,14,0,0,0,78
18,5,2,21,18,14,9,19,8,114
18,5,2,21,18,19,5,0,0,88
18,5,2,21,18,19,20,0,0,103
18,5,2,21,19,0,0,0,0,65
18,5,2,21,19,5,4,0,0,74
18,5,2,21,19,5,19,0,0,89
18,5,2,21,19,8,0,0,0,73
18,5,2,21,19,25,0,0,0,90
18,5,2,21,19,9,14,7,0,95
18,5,2,21,20,0,0,0,0,66
18,5,2,21,20,5,0,0,0,71
18,5,2,21,20,13,5,14,20,118
18,5,2,21,20,19,0,0,0,85
18,5,2,21,20,20,1,12,0,99
18,5,2,21,20,20,1,12,19,118
18,5,2,21,20,20,5,4,0,95
18,5,2,21,20,20,5,18,0,109
18,5,2,21,20,20,5,18,19,128
18,5,2,21,20,20,9,14,7,116
18,5,2,21,20,20,15,14,0,115
18,5,2,21,20,20,15,14,19,134
18,5,3,1,2,12,5,0,0,46
18,5,3,1,2,12,5,4,0,50
18,5,3,1,2,12,9,14,7,71
18,5,3,1,4,5,14,3,25,78
18,5,3,1,4,15,0,0,0,46
18,5,3,1,7,5,0,0,0,39
18,5,3,1,7,5,4,0,0,43
18,5,3,1,7,9,14,7,0,64
18,5,3,1,12,3,9,14,5,70
18,5,3,1,12,5,19,3,5,71
18,5,3,1,12,11,0,0,0,50
18,5,3,1,12,12,0,0,0,51
18,5,3,1,12,12,5,4,0,60
18,5,3,1,12,12,5,18,0,74
18,5,3,1,12,12,5,18,19,93
18,5,3,1,12,12,9,14,7,81
18,5,3,1,12,12,9,19,20,99
18,5,3,1,12,12,19,0,0,70
18,5,3,1,13,5,18,1,0,64
18,5,3,1,14,3,5,12,0,61
18,5,3,1,14,5,0,0,0,46
18,5,3,1,14,5,4,0,0,50
18,5,3,1,14,5,19,0,0,65
18,5,3,1,14,9,14,7,0,71
18,5,3,1,14,20,0,0,0,61
18,5,3,1,14,20,5,4,0,70
18,5,3,1,14,20,5,18,0,84
18,5,3,1,14,20,5,18,19,103
18,5,3,1,14,20,9,14,7,91
18,5,3,1,14,20,19,0,0,80
18,5,3,1,14,22,1,19,0,83
18,5,3,1,16,0,0,0,0,43
18,5,3,1,16,16,5,4,0,68
18,5,3,1,16,16,5,18,0,82
18,5,3,1,16,16,9,14,7,89
18,5,3,1,16,19,0,0,0,62
18,5,3,1,16,20,9,15,14,101
18,5,3,1,16,20,15,18,0,96
18,5,3,1,16,20,21,18,5,107
18,5,3,1,18,2,15,14,0,76
18,5,3,1,18,14,9,6,25,99
18,5,3,1,18,16,5,20,0,86
18,5,3,1,18,18,25,0,0,88
18,5,3,1,18,18,9,5,4,81
18,5,3,1,18,18,9,5,18,95
18,5,3,1,18,18,9,5,19,96
18,5,3,1,18,20,0,0,0,65
18,5,3,1,18,22,5,0,0,72
18,5,3,1,18,22,5,4,0,76
18,5,3,1,18,22,9,14,7,97
18,5,3,1,19,5,0,0,0,51
18,5,3,1,19,8,0,0,0,54
18,5,3,1,19,11,5,20,0,82
18,5,3,1,19,20,0,0,0,66
18,5,3,1,19,20,5,18,0,89
18,5,3,1,19,20,9,14,7,96
18,5,3,1,19,20,19,0,0,85
18,5,3,1,20,1,12,15,7,82
18,5,3,1,20,3,8,0,0,58
18,5,3,1,21,20,9,15,14,106
18,5,3,3,5,0,0,0,0,34
18,5,3,3,8,5,0,0,0,42
18,5,3,3,8,15,19,5,0,76
18,5,3,3,8,15,19,5,14,90
18,5,3,3,25,0,0,0,0,54
18,5,3,3,15,0,0,0,0,44
18,5,3,4,0,0,0,0,0,30
18,5,3,5,4,5,0,0,0,40
18,5,3,5,4,5,4,0,0,44
18,5,3,5,4,5,14,3,5,62
18,5,3,5,4,5,14,20,0,74
18,5,3,5,4,5,18,0,0,58
18,5,3,5,4,5,19,0,0,59
18,5,3,5,4,9,14,7,0,65
18,5,3,5,9,16,20,0,0,76
18,5,3,5,9,16,20,5,4,85
18,5,3,5,9,16,20,5,18,99
18,5,3,5,9,16,20,15,18,109
18,5,3,5,9,16,20,19,0,95
18,5,3,5,9,22,1,12,0,75
18,5,3,5,9,22,5,0,0,67
18,5,3,5,9,22,5,4,0,71
18,5,3,5,9,22,5,18,0,85
18,5,3,5,9,22,5,18,19,104
18,5,3,5,9,22,5,19,0,86
18,5,3,5,9,22,9,14,7,92
18,5,3,5,13,5,14,20,0,83
18,5,3,5,14,3,25,0,0,73
18,5,3,5,14,3,9,5,19,81
18,5,3,5,14,19,5,0,0,69
18,5,3,5,14,19,9,15,14,102
18,5,3,5,14,19,15,18,0,97
18,5,3,5,14,19,21,18,5,108
18,5,3,5,14,19,21,19,0,104
18,5,3,5,14,20,5,18,0,88
18,5,3,5,14,20,5,19,20,109
18,5,3,5,14,20,12,25,0,102
18,5,3,5,14,20,18,5,0,88
18,5,3,5,16,20,0,0,0,67
18,5,3,5,16,20,1,14,20,102
18,5,3,5,16,20,1,18,25,111
18,5,3,5,16,20,9,15,14,105
18,5,3,5,16,20,9,22,5,103
18,5,3,5,16,20,15,18,0,100
18,5,3,5,16,20,15,18,19,119
18,5,3,5,16,20,19,0,0,86
18,5,3,5,16,20,21,1,12,101
18,5,3,5,18,3,5,12,5,74
18,5,3,5,18,20,9,6,25,109
18,5,3,5,19,19,0,0,0,69
18,5,3,5,19,19,5,4,0,78
18,5,3,5,19,19,5,18,0,92
18,5,3,5,19,19,5,19,0,93
18,5,3,5,19,19,9,14,7,99
18,5,3,5,19,19,9,15,14,107
18,5,3,5,19,19,9,22,5,105
18,5,3,5,19,19,15,18,0,102
18,5,3,8,1,6,5,0,0,46
18,5,3,8,1,9,14,0,0,58
18,5,3,8,1,12,0,0,0,47
18,5,3,8,1,13,2,5,18,73
18,5,3,8,1,14,7,5,0,61
18,5,3,8,1,14,7,5,4,65
18,5,3,8,1,14,7,5,19,80
18,5,3,8,1,14,14,5,12,80
18,5,3,8,1,14,20,0,0,69
18,5,3,8,1,15,19,0,0,69
18,5,3,8,1,18,0,0,0,53
18,5,3,8,1,18,7,5,0,65
18,5,3,8,1,18,7,5,4,69
18,5,3,8,1,18,7,5,18,83
18,5,3,8,1,18,7,5,19,84
18,5,3,8,1,18,20,0,0,73
18,5,3,8,1,18,20,5,4,82
18,5,3,8,1,18,20,5,18,96
18,5,3,8,1,18,20,19,0,92
18,5,3,8,1,19,5,0,0,59
18,5,3,8,1,19,5,18,0,77
18,5,3,8,1,19,20,5,14,93
18,5,3,8,1,20,5,0,0,60
18,5,3,8,1,21,6,6,5,73
18,5,3,8,1,23,0,0,0,58
18,5,3,8,5,1,20,0,0,60
18,5,3,8,5,1,20,19,0,79
18,5,3,8,5,3,11,0,0,53
18,5,3,8,5,3,11,5,4,62
18,5,3,8,5,3,11,19,0,72
18,5,3,8,5,5,18,0,0,62
18,5,3,8,5,18,3,8,0,68
18,5,3,8,5,18,3,8,5,73
18,5,3,8,5,23,0,0,0,62
18,5,3,8,5,23,5,4,0,71
18,5,3,8,5,23,19,0,0,81
18,5,3,8,9,16,0,0,0,59
18,5,3,8,9,19,5,12,0,79
18,5,3,8,15,15,19,5,0,88
18,5,3,8,15,15,19,5,19,107
18,5,3,8,15,19,5,0,0,73
18,5,3,8,15,19,5,14,0,87
18,5,3,8,21,3,11,0,0,69
18,5,3,8,21,18,14,0,0,87
18,5,3,25,3,12,5,0,0,71
18,5,3,25,3,12,5,4,0,75
18,5,3,25,3,12,5,18,0,89
18,5,3,25,3,12,5,19,0,90
18,5,3,25,3,12,9,14,7,96
18,5,3,9,4,5,0,0,0,44
18,5,3,9,4,9,22,5,0,75
18,5,3,9,16,0,0,0,0,51
18,5,3,9,16,5,0,0,0,56
18,5,3,9,16,5,19,0,0,75
18,5,3,9,16,9,5,14,4,83
18,5,3,9,16,9,5,14,20,99
18,5,3,9,18,3,12,5,0,73
18,5,3,9,18,3,12,5,4,77
18,5,3,9,18,3,12,5,19,92
18,5,3,9,19,9,15,14,0,92
18,5,3,9,19,9,15,14,19,111
18,5,3,9,19,19,9,15,14,111
18,5,3,9,19,19,15,18,25,131
18,5,3,9,20,1,2,12,5,75
18,5,3,9,20,1,12,0,0,68
18,5,3,9,20,1,12,19,0,87
18,5,3,9,20,1,14,4,15,89
18,5,3,9,20,1,20,9,6,91
18,5,3,9,20,5,0,0,0,60
18,5,3,9,20,5,4,0,0,64
18,5,3,9,20,5,18,0,0,78
18,5,3,9,20,5,18,19,0,97
18,5,3,9,20,5,19,0,0,79
18,5,3,9,20,9,14,7,0,85
18,5,3,11,0,0,0,0,0,37
18,5,3,11,5,4,0,0,0,46
18,5,3,11,9,14,7,0,0,67
18,5,3,11,12,1,0,0,0,50
18,5,3,11,12,5,19,19,0,92
18,5,3,11,12,9,14,7,0,79
18,5,3,11,15,14,0,0,0,66
18,5,3,11,15,14,5,4,0,75
18,5,3,11,15,14,5,18,0,89
18,5,3,11,15,14,5,18,19,108
18,5,3,11,15,14,9,14,7,96
18,5,3,11,15,14,19,0,0,85
18,5,3,11,19,0,0,0,0,56
18,5,3,12,1,4,0,0,0,43
18,5,3,12,1,9,13,0,0,61
18,5,3,12,1,9,13,5,4,70
18,5,3,12,1,9,13,5,18,84
18,5,3,12,1,9,13,19,0,80
18,5,3,12,1,13,1,0,0,53
18,5,3,12,1,13,5,0,0,57
18,5,3,12,1,13,5,19,0,76
18,5,3,12,1,14,7,0,0,60
18,5,3,12,1,19,16,0,0,74
18,5,3,12,1,19,16,5,4,83
18,5,3,12,1,19,16,19,0,93
18,5,3,12,1,19,19,0,0,77
18,5,3,12,5,1,14,0,0,58
18,5,3,12,5,1,14,5,4,67
18,5,3,12,5,1,14,5,18,81
18,5,3,12,5,1,14,19,0,77
18,5,3,12,5,1,14,19,5,82
18,5,3,12,5,1,18,0,0,62
18,5,3,12,9,13,2,0,0,62
18,5,3,12,9,13,2,5,4,71
18,5,3,12,9,14,1,14,20,96
18,5,3,12,9,14,1,20,5,87
18,5,3,12,9,14,5,0,0,66
18,5,3,12,9,14,5,4,0,70
18,5,3,12,9,14,5,18,0,84
18,5,3,12,9,14,5,18,19,103
18,5,3,12,9,14,5,19,0,85
18,5,3,12,9,14,9,14,7,91
18,5,3,12,9,22,1,20,5,95
18,5,3,12,15,19,5,0,0,77
18,5,3,12,15,20,8,5,0,86
18,5,3,12,15,20,8,5,4,90
18,5,3,12,15,20,8,5,19,105
18,5,3,12,21,4,5,0,0,68
18,5,3,12,21,19,5,0,0,83
18,5,3,12,21,19,5,12,25,120
18,5,3,12,21,19,5,18,25,126
18,5,3,12,21,19,5,19,0,102
18,5,3,12,21,19,9,15,14,116
18,5,3,12,21,19,9,22,5,114
18,5,3,12,21,19,15,18,25,136
18,5,3,15,1,3,8,0,0,53
18,5,3,15,1,12,0,0,0,54
18,5,3,15,1,12,5,4,0,63
18,5,3,15,1,12,9,14,7,84
18,5,3,15,1,12,19,0,0,73
18,5,3,15,1,19,20,0,0,81
18,5,3,15,1,20,0,0,0,62
18,5,3,15,3,11,0,0,0,55
18,5,3,15,3,11,5,4,0,64
18,5,3,15,3,11,9,14,7,85
18,5,3,15,3,11,19,0,0,74
18,5,3,15,3,20,0,0,0,64
18,5,3,15,3,20,9,15,14,102
18,5,3,15,4,5,0,0,0,50
18,5,3,15,4,5,4,0,0,54
18,5,3,15,4,5,19,0,0,69
18,5,3,15,4,9,6,25,0,85
18,5,3,15,4,9,14,7,0,75
18,5,3,15,7,14,9,19,5,95
18,5,3,15,7,14,9,20,1,92
18,5,3,15,7,14,9,26,5,102
18,5,3,15,9,12,0,0,0,62
18,5,3,15,9,12,5,4,0,71
18,5,3,15,9,12,5,18,0,85
18,5,3,15,9,12,5,18,19,104
18,5,3,15,9,12,9,14,7,92
18,5,3,15,9,12,19,0,0,81
18,5,3,15,9,14,0,0,0,64
18,5,3,15,9,14,1,7,5,77
18,5,3,15,9,14,5,4,0,73
18,5,3,15,9,14,5,18,0,87
18,5,3,15,9,14,9,14,7,94
18,5,3,15,9,14,19,0,0,83
18,5,3,15,11,5,0,0,0,57
18,5,3,15,12,12,1,20,5,91
18,5,3,15,12,15,18,0,0,86
18,5,3,15,12,15,18,5,4,95
18,5,3,15,12,15,18,19,0,105
18,5,3,15,12,15,21,18,0,107
18,5,3,15,13,2,0,0,0,56
18,5,3,15,13,2,5,4,0,65
18,5,3,15,13,2,9,14,5,84
18,5,3,15,13,2,9,14,7,86
18,5,3,15,13,2,19,0,0,75
18,5,3,15,13,6,15,18,20,113
18,5,3,15,13,13,1,14,4,86
18,5,3,15,13,13,5,14,4,90
18,5,3,15,13,13,9,20,0,96
18,5,3,15,13,13,9,20,19,115
18,5,3,15,13,16,1,3,20,94
18,5,3,15,13,16,1,18,5,94
18,5,3,15,13,16,1,19,19,109
18,5,3,15,13,16,5,12,0,87
18,5,3,15,13,16,5,20,5,100
18,5,3,15,13,16,9,12,5,96
18,5,3,15,13,16,12,25,0,107
18,5,3,15,13,16,15,19,5,109
18,5,3,15,13,16,21,20,5,116
18,5,3,15,14,3,5,1,12,76
18,5,3,15,14,3,5,4,5,72
18,5,3,15,14,3,5,18,20,101
18,5,3,15,14,3,9,12,5,84
18,5,3,15,14,3,15,3,20,96
18,5,3,15,14,3,21,18,0,97
18,5,3,15,14,4,0,0,0,59
18,5,3,15,14,4,5,13,14,91
18,5,3,15,14,4,9,20,5,93
18,5,3,15,14,4,15,12,5,91
18,5,3,15,14,4,21,3,20,103
18,5,3,15,14,6,5,18,0,84
18,5,3,15,14,6,5,19,19,104
18,5,3,15,14,6,9,4,5,79
18,5,3,15,14,6,9,14,5,89
18,5,3,15,14,6,9,18,13,101
18,5,3,15,14,6,15,18,13,107
18,5,3,15,14,6,21,19,5,106
18,5,3,15,14,7,5,1,12,80
18,5,3,15,14,7,5,19,20,106
18,5,3,15,14,10,15,9,14,103
18,5,3,15,14,14,5,3,20,97
18,5,3,15,14,17,21,5,18,116
18,5,3,15,14,19,0,0,0,74
18,5,3,15,14,19,5,14,20,113
18,5,3,15,14,19,9,7,14,104
18,5,3,15,14,19,15,12,5,106
18,5,3,15,14,19,21,12,20,127
18,5,3,15,14,20,1,3,20,99
18,5,3,15,14,20,5,14,4,98
18,5,3,15,14,20,5,18,0,98
18,5,3,15,14,20,5,19,20,119
18,5,3,15,14,20,18,15,12,120
18,5,3,15,14,22,5,25,0,107
18,5,3,15,14,22,5,25,19,126
18,5,3,15,14,22,5,14,5,101
18,5,3,15,14,22,5,18,20,120
18,5,3,15,14,22,9,3,20,109
18,5,3,15,14,22,15,11,5,108
18,5,3,15,15,11,0,0,0,67
18,5,3,15,15,11,5,4,0,76
18,5,3,15,15,11,9,14,7,97
18,5,3,15,15,11,19,0,0,86
18,5,3,15,15,12,0,0,0,68
18,5,3,15,15,16,5,18,0,95
18,5,3,15,16,25,0,0,0,82
18,5,3,15,16,9,5,4,0,75
18,5,3,15,16,9,5,19,0,90
18,5,3,15,16,25,9,14,7,112
18,5,3,15,16,16,5,18,0,96
18,5,3,15,18,4,0,0,0,63
18,5,3,15,18,4,1,14,20,98
18,5,3,15,18,4,5,4,0,72
18,5,3,15,18,4,5,18,0,86
18,5,3,15,18,4,5,18,19,105
18,5,3,15,18,4,9,14,7,93
18,5,3,15,18,4,9,19,20,111
18,5,3,15,18,11,0,0,0,70
18,5,3,15,18,11,5,4,0,79
18,5,3,15,18,11,19,0,0,89
18,5,3,15,18,18,5,3,20,105
18,5,3,15,18,18,21,16,20,134
18,5,3,15,19,20,0,0,0,80
18,5,3,15,19,20,21,13,5,119
18,5,3,15,21,14,19,5,12,112
18,5,3,15,21,14,20,0,0,96
18,5,3,15,21,14,20,1,12,109
18,5,3,15,21,14,20,5,4,105
18,5,3,15,21,14,20,5,18,119
18,5,3,15,21,14,20,19,0,115
18,5,3,15,21,16,0,0,0,78
18,5,3,15,21,16,5,0,0,83
18,5,3,15,21,16,5,4,0,87
18,5,3,15,21,16,5,18,0,101
18,5,3,15,21,16,9,14,7,108
18,5,3,15,21,16,12,5,0,95
18,5,3,15,21,16,12,5,4,99
18,5,3,15,21,16,12,5,19,114
18,5,3,15,21,16,19,0,0,97
18,5,3,15,21,18,0,0,0,80
18,5,3,15,21,18,19,0,0,99
18,5,3,15,21,18,19,5,0,104
18,5,3,15,21,18,19,5,19,123
18,5,3,15,22,5,18,0,0,86
18,5,3,15,22,5,18,5,4,95
18,5,3,15,22,5,18,5,5,96
18,5,3,15,22,5,18,5,18,109
18,5,3,15,22,5,18,25,0,111
18,5,3,15,22,5,18,15,18,119
18,5,3,15,22,5,18,19,0,105
18,5,3,16,20,0,0,0,0,62
18,5,3,18,1,25,5,4,0,79
18,5,3,18,1,13,16,0,0,74
18,5,3,18,1,14,11,0,0,70
18,5,3,18,1,20,5,0,0,70
18,5,3,18,1,20,5,4,0,74
18,5,3,18,1,20,5,19,0,89
18,5,3,18,1,20,9,14,7,95
18,5,3,18,5,1,14,3,5,72
18,5,3,18,5,1,14,3,25,92
18,5,3,18,5,1,14,20,0,84
18,5,3,18,5,1,14,20,19,103
18,5,3,18,5,1,19,5,0,74
18,5,3,18,5,1,20,5,0,75
18,5,3,18,5,1,20,5,4,79
18,5,3,18,5,1,20,5,19,94
18,5,3,18,5,1,20,15,18,103
18,5,3,18,5,4,9,20,0,82
18,5,3,18,5,13,5,14,20,101
18,5,3,18,5,23,0,0,0,72
18,5,3,18,15,15,14,0,0,88
18,5,3,18,15,16,0,0,0,75
18,5,3,18,15,19,19,0,0,97
18,5,3,18,15,19,19,5,4,106
18,5,3,18,15,19,19,5,19,121
18,5,3,18,15,23,4,0,0,86
18,5,3,18,15,23,14,0,0,96
18,5,3,18,15,23,14,5,4,105
18,5,3,18,15,23,14,19,0,115
18,5,3,18,21,3,9,6,25,108
18,5,3,18,21,9,20,0,0,94
18,5,3,18,21,9,20,1,12,107
18,5,3,18,21,9,20,5,4,103
18,5,3,18,21,9,20,5,5,104
18,5,3,18,21,9,20,5,18,117
18,5,3,18,21,9,20,25,0,119
18,5,3,18,21,9,20,19,0,113
18,5,3,18,21,19,8,0,0,92
18,5,3,18,21,19,8,5,18,115
18,5,3,19,0,0,0,0,0,45
18,5,3,20,1,0,0,0,0,47
18,5,3,20,1,12,0,0,0,59
18,5,3,20,1,12,7,9,1,76
18,5,3,20,1,12,12,25,0,96
18,5,3,20,1,14,7,12,5,85
18,5,3,20,9,0,0,0,0,55
18,5,3,20,9,6,25,0,0,86
18,5,3,20,9,6,9,5,4,79
18,5,3,20,9,6,9,5,18,93
18,5,3,20,9,6,9,5,19,94
18,5,3,20,9,15,14,0,0,84
18,5,3,20,9,20,9,3,0,87
18,5,3,20,9,20,9,19,0,103
18,5,3,20,9,20,21,4,5,105
18,5,3,20,15,0,0,0,0,61
18,5,3,20,15,3,5,12,5,86
18,5,3,20,15,16,5,24,25,131
18,5,3,20,15,18,1,12,0,92
18,5,3,20,15,18,1,20,5,105
18,5,3,20,15,18,5,19,19,122
18,5,3,20,15,18,25,0,0,104
18,5,3,20,15,18,9,1,12,101
18,5,3,20,15,18,9,5,19,112
18,5,3,20,15,18,19,0,0,98
18,5,3,20,15,19,0,0,0,80
18,5,3,20,15,20,15,13,5,114
18,5,3,20,15,20,15,13,25,134
18,5,3,20,18,5,19,19,0,107
18,5,3,20,18,9,3,5,19,100
18,5,3,20,18,9,24,0,0,97
18,5,3,20,21,13,0,0,0,80
18,5,3,20,21,13,19,0,0,99
18,5,3,20,21,19,0,0,0,86
18,5,3,21,2,1,14,20,0,84
18,5,3,21,2,1,20,5,0,75
18,5,3,21,5,9,12,0,0,73
18,5,3,21,12,1,4,5,0,69
18,5,3,21,12,5,0,0,0,64
18,5,3,21,13,2,0,0,0,62
18,5,3,21,13,2,5,14,20,101
18,5,3,21,16,5,18,5,20,111
18,5,3,21,18,0,0,0,0,65
18,5,3,21,18,5,0,0,0,70
18,5,3,21,18,5,6,21,12,109
18,5,3,21,18,12,0,0,0,77
18,5,3,21,18,18,5,4,0,92
18,5,3,21,18,18,5,14,20,122
18,5,3,21,18,18,5,18,0,106
18,5,3,21,18,18,9,14,7,113
18,5,3,21,18,19,0,0,0,84
18,5,3,21,18,19,1,14,20,119
18,5,3,21,18,19,5,0,0,89
18,5,3,21,18,19,5,4,0,93
18,5,3,21,18,19,5,19,0,108
18,5,3,21,18,19,9,14,7,114
18,5,3,21,18,19,9,15,14,122
18,5,3,21,18,19,9,22,5,120
18,5,3,21,18,20,1,9,14,109
18,5,3,21,18,22,1,14,20,122
18,5,3,21,18,22,1,20,5,113
18,5,3,21,18,22,5,0,0,92
18,5,3,21,18,22,5,4,0,96
18,5,3,21,18,22,5,19,0,111
18,5,3,21,18,22,9,14,7,117
18,5,3,21,18,22,9,20,25,141
18,5,3,21,18,22,15,21,19,142
18,5,3,21,19,1,12,0,0,79
18,5,3,21,19,1,14,3,5,89
18,5,3,21,19,1,14,3,25,109
18,5,3,21,19,1,14,20,0,101
18,5,3,21,19,1,14,20,19,120
18,5,3,21,19,1,20,15,18,120
18,5,3,21,19,5,0,0,0,71
18,5,3,21,19,5,4,0,0,75
18,5,3,21,19,5,19,0,0,90
18,5,3,21,19,6,0,0,0,72
18,5,3,21,19,8,9,15,14,112
18,5,3,21,19,9,14,7,0,96
18,5,3,21,19,19,9,15,14,123
18,5,3,21,20,0,0,0,0,67
18,5,3,21,20,19,0,0,0,86
18,5,3,21,20,20,9,14,7,117
18,5,4,0,0,0,0,0,0,27
18,5,4,1,3,20,0,0,0,51
18,5,4,1,3,20,5,4,0,60
18,5,4,1,3,20,5,21,18,95
18,5,4,1,3,20,9,14,7,81
18,5,4,1,3,20,9,15,14,89
18,5,4,1,3,20,15,18,0,84
18,5,4,1,3,20,15,18,19,103
18,5,4,1,3,20,19,0,0,70
18,5,4,1,13,1,7,5,0,54
18,5,4,1,13,1,7,5,4,58
18,5,4,1,13,5,0,0,0,46
18,5,4,1,14,19,0,0,0,61
18,5,4,1,18,5,0,0,0,51
18,5,4,1,18,5,4,0,0,55
18,5,4,1,18,7,21,5,0,79
18,5,4,1,18,7,21,5,4,83
18,5,4,1,18,7,21,5,19,98
18,5,4,1,18,9,14,7,0,76
18,5,4,1,18,11,5,14,0,76
18,5,4,1,18,14,0,0,0,60
18,5,4,1,20,5,0,0,0,53
18,5,4,1,20,5,4,0,0,57
18,5,4,1,20,5,19,0,0,72
18,5,4,1,20,9,14,7,0,78
18,5,4,1,21,2,0,0,0,51
18,5,4,1,23,14,0,0,0,65
18,5,4,2,1,3,11,0,0,44
18,5,4,2,1,25,0,0,0,55
18,5,4,2,1,25,19,0,0,74
18,5,4,2,1,9,20,0,0,59
18,5,4,2,1,9,20,5,4,68
18,5,4,2,1,9,20,19,0,78
18,5,4,2,5,1,18,4,0,57
18,5,4,2,5,12,12,25,0,83
18,5,4,2,5,18,18,25,0,95
18,5,4,2,9,12,12,0,0,62
18,5,4,2,9,18,4,0,0,60
18,5,4,2,9,18,4,19,0,79
18,5,4,2,15,14,5,0,0,63
18,5,4,2,15,14,5,19,0,82
18,5,4,2,18,5,1,19,20,92
18,5,4,2,18,9,3,11,0,70
18,5,4,2,18,9,3,11,19,89
18,5,4,2,18,21,19,8,0,95
18,5,4,2,21,3,11,0,0,64
18,5,4,2,21,4,0,0,0,54
18,5,4,2,21,4,19,0,0,73
18,5,4,2,21,7,0,0,0,57
18,5,4,2,21,7,19,0,0,76
18,5,4,3,1,16,0,0,0,47
18,5,4,3,1,16,19,0,0,66
18,5,4,3,15,1,20,0,0,66
18,5,4,3,15,1,20,19,0,85
18,5,4,3,15,12,12,0,0,69
18,5,4,4,5,4,0,0,0,40
18,5,4,4,5,14,0,0,0,50
18,5,4,4,5,14,4,1,0,55
18,5,4,4,5,14,4,15,0,69
18,5,4,4,5,14,4,21,13,88
18,5,4,4,5,14,5,4,0,59
18,5,4,4,5,14,9,14,7,80
18,5,4,4,5,14,19,0,0,69
18,5,4,4,5,18,0,0,0,54
18,5,4,4,5,18,19,0,0,73
18,5,4,4,5,19,20,0,0,75
18,5,4,4,9,19,8,0,0,67
18,5,4,4,9,19,8,12,25,104
18,5,4,4,9,20,9,15,14,98
18,5,4,4,9,20,9,22,5,96
18,5,4,4,12,5,0,0,0,48
18,5,4,4,12,5,4,0,0,52
18,5,4,4,12,5,13,1,14,76
18,5,4,4,12,5,13,5,14,80
18,5,4,4,12,5,19,0,0,67
18,5,4,4,12,9,14,7,0,73
18,5,4,4,15,3,11,0,0,60
18,5,4,4,19,0,0,0,0,50
18,5,4,4,19,13,1,14,0,78
18,5,4,5,0,0,0,0,0,32
18,5,4,5,1,12,0,0,0,45
18,5,4,5,1,12,9,14,7,75
18,5,4,5,1,12,20,0,0,65
18,5,4,5,1,18,0,0,0,51
18,5,4,5,1,18,19,0,0,70
18,5,4,5,2,1,20,5,0,60
18,5,4,5,2,9,20,0,0,63
18,5,4,5,3,1,25,0,0,61
18,5,4,5,3,5,9,22,5,76
18,5,4,5,3,9,4,5,0,53
18,5,4,5,3,9,4,5,4,57
18,5,4,5,3,11,0,0,0,46
18,5,4,5,3,12,1,18,5,71
18,5,4,5,3,12,9,14,5,75
18,5,4,5,4,0,0,0,0,36
18,5,4,5,4,21,3,20,0,80
18,5,4,5,5,4,0,0,0,41
18,5,4,5,5,13,0,0,0,50
18,5,4,5,5,13,5,4,0,59
18,5,4,5,5,13,5,18,19,92
18,5,4,5,5,13,9,14,7,80
18,5,4,5,5,13,19,0,0,69
18,5,4,5,6,1,21,12,20,92
18,5,4,5,6,5,1,20,0,64
18,5,4,5,6,5,1,20,19,83
18,5,4,5,6,5,3,20,0,66
18,5,4,5,6,5,18,0,0,61
18,5,4,5,6,25,0,0,0,63
18,5,4,5,6,9,5,4,0,56
18,5,4,5,6,9,5,19,0,71
18,5,4,5,6,25,9,14,7,93
18,5,4,5,6,9,14,5,0,66
18,5,4,5,6,9,14,5,4,70
18,5,4,5,6,9,14,5,19,85
18,5,4,5,6,12,5,3,20,78
18,5,4,5,25,5,19,0,0,81
18,5,4,5,9,6,25,0,0,72
18,5,4,5,12,1,25,0,0,70
18,5,4,5,12,5,19,19,0,87
18,5,4,5,12,5,20,5,0,74
18,5,4,5,12,5,20,5,4,78
18,5,4,5,12,25,0,0,0,69
18,5,4,5,12,9,22,5,18,98
18,5,4,5,13,1,14,4,0,64
18,5,4,5,13,1,14,4,19,83
18,5,4,5,13,9,19,5,0,78
18,5,4,5,13,9,19,5,4,82
18,5,4,5,13,16,20,15,18,114
18,5,4,5,14,25,0,0,0,71
18,5,4,5,14,9,1,12,0,68
18,5,4,5,14,9,5,4,0,64
18,5,4,5,14,9,5,19,0,79
18,5,4,5,14,25,9,14,7,101
18,5,4,5,16,5,14,4,0,71
18,5,4,5,16,12,15,25,0,100
18,5,4,5,16,12,15,25,19,119
18,5,4,5,16,15,19,9,20,111
18,5,4,5,16,18,9,22,5,102
18,5,4,5,19,0,0,0,0,51
18,5,4,5,19,3,5,14,4,77
18,5,4,5,19,3,5,14,20,93
18,5,4,5,19,5,18,20,0,94
18,5,4,5,19,5,18,22,5,101
18,5,4,5,19,9,7,14,0,81
18,5,4,5,19,9,7,14,19,100
18,5,4,5,19,9,18,5,0,83
18,5,4,5,19,13,1,14,0,79
18,5,4,5,19,16,9,19,5,100
18,5,4,5,20,5,3,20,0,80
18,5,4,5,22,1,2,12,5,74
18,5,4,5,22,5,12,15,16,102
18,5,4,5,22,9,19,5,0,87
18,5,4,5,22,15,20,5,0,94
18,5,4,6,9,14,0,0,0,56
18,5,4,6,9,14,3,8,0,67
18,5,4,6,9,14,19,0,0,75
18,5,4,6,9,19,8,0,0,69
18,5,4,6,9,19,8,5,19,93
18,5,4,6,15,15,20,0,0,83
18,5,4,8,5,1,4,0,0,45
18,5,4,8,5,1,4,5,4,54
18,5,4,8,5,1,4,19,0,64
18,5,4,8,5,1,18,20,0,79
18,5,4,8,15,15,16,0,0,81
18,5,4,8,15,18,19,5,0,92
18,5,4,8,15,18,19,5,19,111
18,5,4,9,1,0,0,0,0,37
18,5,4,9,1,5,0,0,0,42
18,5,4,9,1,12,0,0,0,49
18,5,4,9,1,19,0,0,0,56
18,5,4,9,3,20,1,20,5,85
18,5,4,9,4,0,0,0,0,40
18,5,4,25,5,0,0,0,0,57
18,5,4,25,5,4,0,0,0,61
18,5,4,25,5,9,14,7,0,87
18,5,4,9,5,14,20,0,0,75
18,5,4,25,5,19,0,0,0,76
18,5,4,9,6,6,21,19,5,93
18,5,4,9,7,5,19,20,0,87
18,5,4,9,7,5,19,20,19,106
18,5,4,25,9,14,7,0,0,82
18,5,4,9,12,1,20,5,0,74
18,5,4,9,12,1,20,5,4,78
18,5,4,9,14,7,0,0,0,57
18,5,4,9,14,7,15,20,5,97
18,5,4,9,16,0,0,0,0,52
18,5,4,9,16,16,5,4,0,77
18,5,4,9,16,16,5,18,0,91
18,5,4,9,16,16,9,14,7,98
18,5,4,9,16,19,0,0,0,71
18,5,4,9,16,20,0,0,0,72
18,5,4,9,18,5,3,20,0,82
18,5,4,9,18,5,3,20,19,101
18,5,4,9,19,1,2,12,5,75
18,5,4,9,19,3,21,19,19,117
18,5,4,9,19,13,9,19,19,115
18,5,4,9,19,16,5,12,0,88
18,5,4,9,19,16,12,1,25,109
18,5,4,9,19,16,15,19,5,110
18,5,4,9,19,16,21,20,5,117
18,5,4,9,19,19,5,3,20,102
18,5,4,9,19,20,5,14,4,98
18,5,4,9,19,20,9,12,12,108
18,5,4,9,19,20,21,18,2,116
18,5,4,9,20,9,15,14,0,94
18,5,4,9,22,5,0,0,0,63
18,5,4,9,22,5,18,20,0,101
18,5,4,9,22,9,4,5,0,76
18,5,4,9,22,9,4,5,4,80
18,5,4,9,22,9,4,5,19,95
18,5,4,9,22,9,22,5,0,94
18,5,4,9,22,9,22,21,19,129
18,5,4,9,22,15,18,3,5,99
18,5,4,9,22,21,12,7,5,103
18,5,4,10,1,3,11,5,20,77
18,5,4,11,14,5,5,19,0,81
18,5,4,12,5,7,19,0,0,70
18,5,4,12,25,0,0,0,0,64
18,5,4,12,9,14,5,0,0,67
18,5,4,12,9,14,5,4,0,71
18,5,4,12,9,14,5,19,0,86
18,5,4,12,9,14,9,14,7,92
18,5,4,13,15,21,20,8,0,104
18,5,4,14,5,3,11,0,0,60
18,5,4,14,5,3,11,19,0,79
18,5,4,14,5,19,19,0,0,84
18,5,4,14,5,19,19,5,19,108
18,5,4,15,0,0,0,0,0,42
18,5,4,15,3,11,0,0,0,56
18,5,4,15,3,11,5,4,0,65
18,5,4,15,3,11,5,20,0,81
18,5,4,15,3,11,9,14,7,86
18,5,4,15,3,11,19,0,0,75
18,5,4,15,4,9,4,0,0,59
18,5,4,15,4,15,9,14,7,91
18,5,4,15,4,15,14,5,0,80
18,5,4,15,5,19,0,0,0,66
18,5,4,15,9,14,7,0,0,72
18,5,4,15,12,5,14,3,5,81
18,5,4,15,12,5,14,3,25,101
18,5,4,15,12,5,14,20,0,93
18,5,4,15,14,5,0,0,0,61
18,5,4,15,14,14,5,4,0,79
18,5,4,15,14,19,0,0,0,75
18,5,4,15,15,13,0,0,0,70
18,5,4,15,19,0,0,0,0,61
18,5,4,15,21,2,12,5,0,82
18,5,4,15,21,2,12,5,4,86
18,5,4,15,21,2,12,5,18,100
18,5,4,15,21,2,12,5,19,101
18,5,4,15,21,2,20,0,0,85
18,5,4,15,21,2,20,5,4,94
18,5,4,15,21,2,20,19,0,104
18,5,4,15,21,14,4,0,0,81
18,5,4,15,21,14,4,5,4,90
18,5,4,15,21,14,4,19,0,100
18,5,4,15,21,20,0,0,0,83
18,5,4,15,21,20,5,0,0,88
18,5,4,15,21,20,19,0,0,102
18,5,4,15,23,1,0,0,0,66
18,5,4,15,23,1,19,0,0,85
18,5,4,15,24,0,0,0,0,66
18,5,4,15,24,5,19,0,0,90
18,5,4,16,15,12,12,0,0,82
18,5,4,16,15,12,12,19,0,101
18,5,4,18,1,6,20,0,0,72
18,5,4,18,1,6,20,5,4,81
18,5,4,18,1,6,20,19,0,91
18,5,4,18,1,7,0,0,0,53
18,5,4,18,1,16,5,0,0,67
18,5,4,18,1,23,0,0,0,69
18,5,4,18,1,23,5,18,0,92
18,5,4,18,1,23,5,18,19,111
18,5,4,18,1,23,9,14,7,99
18,5,4,18,1,23,14,0,0,83
18,5,4,18,1,23,19,0,0,88
18,5,4,18,5,1,13,0,0,64
18,5,4,18,5,1,13,19,0,83
18,5,4,18,5,1,13,20,0,84
18,5,4,18,5,4,7,5,0,66
18,5,4,18,5,19,19,0,0,88
18,5,4,18,5,19,19,1,12,101
18,5,4,18,5,19,19,5,4,97
18,5,4,18,5,19,19,5,18,111
18,5,4,18,5,19,19,5,19,112
18,5,4,18,5,19,19,15,18,121
18,5,4,18,5,23,0,0,0,73
18,5,4,18,25,0,0,0,0,70
18,5,4,18,9,5,4,0,0,63
18,5,4,18,9,5,19,0,0,78
18,5,4,18,25,9,14,7,0,100
18,5,4,18,9,12,12,0,0,78
18,5,4,18,9,12,12,5,4,87
18,5,4,18,9,12,12,19,0,97
18,5,4,18,9,22,5,0,0,81
18,5,4,18,9,22,5,14,0,95
18,5,4,18,9,22,5,19,0,100
18,5,4,18,9,22,9,14,7,106
18,5,4,18,15,15,16,0,0,91
18,5,4,18,15,15,20,0,0,95
18,5,4,18,15,15,20,19,0,114
18,5,4,18,15,22,5,0,0,87
18,5,4,18,21,7,0,0,0,73
18,5,4,18,21,7,7,5,4,89
18,5,4,19,0,0,0,0,0,46
18,5,4,19,5,1,18,0,0,70
18,5,4,19,8,1,14,11,0,80
18,5,4,19,8,1,14,11,19,99
18,5,4,19,8,9,6,20,0,89
18,5,4,19,8,9,18,5,0,86
18,5,4,19,8,9,18,20,0,101
18,5,4,19,8,9,18,20,19,120
18,5,4,19,11,9,14,0,0,80
18,5,4,19,11,9,14,19,0,99
18,5,4,19,20,1,18,20,0,105
18,5,4,19,20,1,18,20,19,124
18,5,4,19,20,18,5,1,11,101
18,5,4,20,1,2,0,0,0,50
18,5,4,20,1,9,12,0,0,69
18,5,4,20,1,16,9,19,13,105
18,5,4,20,8,18,15,1,20,109
18,5,4,20,15,16,0,0,0,78
18,5,4,20,15,16,19,0,0,97
18,5,4,21,2,0,0,0,0,50
18,5,4,21,2,2,5,4,0,61
18,5,4,21,2,2,5,18,0,75
18,5,4,21,2,19,0,0,0,69
18,5,4,21,3,3,9,15,14,92
18,5,4,21,3,5,0,0,0,56
18,5,4,21,3,5,4,0,0,60
18,5,4,21,3,5,14,20,0,90
18,5,4,21,3,5,18,0,0,74
18,5,4,21,3,5,18,19,0,93
18,5,4,21,3,5,19,0,0,75
18,5,4,21,3,9,2,12,5,79
18,5,4,21,3,9,2,12,25,99
18,5,4,21,3,9,14,7,0,81
18,5,4,21,3,20,0,0,0,71
18,5,4,21,3,20,1,14,20,106
18,5,4,21,3,20,1,19,5,96
18,5,4,21,3,20,9,15,0,95
18,5,4,21,3,20,9,15,14,109
18,5,4,21,3,20,9,22,5,107
18,5,4,21,3,20,15,18,0,104
18,5,4,21,5,0,0,0,0,53
18,5,4,21,7,0,0,0,0,55
18,5,4,21,9,20,0,0,0,77
18,5,4,21,14,4,1,14,20,101
18,5,4,21,16,12,0,0,0,76
18,5,4,21,19,20,0,0,0,87
18,5,4,21,22,9,9,4,0,92
18,5,4,21,22,9,9,4,19,111
18,5,4,21,22,9,15,9,4,107
18,5,4,21,24,0,0,0,0,72
18,5,4,21,26,1,20,5,0,100
18,5,4,23,1,18,4,0,0,73
18,5,4,23,1,18,5,0,0,74
18,5,4,23,1,18,5,19,0,93
18,5,4,23,5,5,4,0,0,64
18,5,4,23,9,14,7,19,0,99
18,5,4,23,9,20,8,5,0,92
18,5,4,23,15,15,4,0,0,84
18,5,4,23,15,15,4,19,0,103
18,5,4,23,21,4,0,0,0,75
18,5,5,1,18,14,0,0,0,61
18,5,5,1,18,14,5,4,0,70
18,5,5,1,18,14,9,14,7,91
18,5,5,1,18,14,19,0,0,80
18,5,5,2,15,11,0,0,0,56
18,5,5,3,8,25,0,0,0,64
18,5,5,3,8,9,5,18,0,71
18,5,5,3,8,15,0,0,0,54
18,5,5,3,8,15,5,4,0,63
18,5,5,3,8,15,5,19,0,78
18,5,5,3,8,15,9,14,7,84
18,5,5,4,2,9,18,4,0,65
18,5,5,4,2,9,18,4,19,84
18,5,5,4,2,21,3,11,0,69
18,5,5,4,2,21,3,11,19,88
18,5,5,4,2,21,19,8,0,82
18,5,5,4,5,4,0,0,0,41
18,5,5,4,5,14,0,0,0,51
18,5,5,4,9,5,18,0,0,64
18,5,5,4,9,5,19,20,0,85
18,5,5,4,9,6,25,0,0,72
18,5,5,4,9,6,9,5,4,65
18,5,5,4,9,6,9,5,19,80
18,5,5,4,9,12,25,0,0,78
18,5,5,4,9,14,5,19,19,98
18,5,5,4,9,14,7,0,0,62
18,5,5,4,9,14,7,19,0,81
18,5,5,4,9,19,8,0,0,68
18,5,5,4,9,20,0,0,0,61
18,5,5,4,9,20,5,4,0,70
18,5,5,4,9,20,9,14,7,91
18,5,5,4,9,20,9,15,14,99
18,5,5,4,9,20,19,0,0,80
18,5,5,4,12,5,19,19,0,87
18,5,5,4,12,9,11,5,0,69
18,5,5,4,12,9,14,7,0,74
18,5,5,4,12,9,14,7,19,93
18,5,5,4,13,1,11,5,18,80
18,5,5,4,13,1,14,0,0,60
18,5,5,4,13,5,14,0,0,64
18,5,5,4,16,12,15,20,0,95
18,5,5,4,21,3,1,20,5,82
18,5,5,4,23,15,18,11,0,99
18,5,5,6,1,2,12,5,0,54
18,5,5,6,5,4,0,0,0,43
18,5,5,6,5,18,0,0,0,57
18,5,5,6,5,18,19,0,0,76
18,5,5,6,6,9,19,8,0,76
18,5,5,6,25,0,0,0,0,59
18,5,5,6,9,5,18,0,0,66
18,5,5,6,9,5,19,20,0,87
18,5,5,6,9,14,7,0,0,64
18,5,5,6,19,0,0,0,0,53
18,5,5,10,5,3,20,0,0,66
18,5,5,10,5,3,20,5,4,75
18,5,5,10,5,3,20,19,0,85
18,5,5,11,0,0,0,0,0,39
18,5,5,11,5,4,0,0,0,48
18,5,5,11,5,18,0,0,0,62
18,5,5,11,5,18,19,0,0,81
18,5,5,11,25,0,0,0,0,64
18,5,5,11,9,5,18,0,0,71
18,5,5,11,9,5,19,20,0,92
18,5,5,11,9,14,7,0,0,69
18,5,5,11,9,14,7,12,25,106
18,5,5,11,19,0,0,0,0,58
18,5,5,12,1,2,12,5,0,60
18,5,5,12,5,3,20,0,0,68
18,5,5,12,5,3,20,5,4,77
18,5,5,12,5,3,20,19,0,87
18,5,5,12,5,4,0,0,0,49
18,5,5,12,5,4,9,4,0,62
18,5,5,12,5,4,15,14,5,83
18,5,5,12,5,18,0,0,0,63
18,5,5,12,5,18,19,0,0,82
18,5,5,12,5,22,1,20,5,93
18,5,5,12,9,14,7,0,0,70
18,5,5,12,9,14,7,12,25,107
18,5,5,12,18,1,12,12,0,83
18,5,5,12,19,0,0,0,0,59
18,5,5,13,0,0,0,0,0,41
18,5,5,13,1,14,1,20,5,82
18,5,5,13,2,1,18,11,0,73
18,5,5,13,2,1,18,11,19,92
18,5,5,13,2,15,4,25,0,87
18,5,5,13,2,18,1,3,5,70
18,5,5,13,5,18,7,5,0,76
18,5,5,13,5,18,7,5,4,80
18,5,5,13,5,18,7,5,19,95
18,5,5,13,9,14,7,0,0,71
18,5,5,13,9,19,8,0,0,77
18,5,5,13,9,20,0,0,0,70
18,5,5,13,9,20,19,0,0,89
18,5,5,13,9,20,20,5,4,99
18,5,5,13,16,12,15,25,0,109
18,5,5,13,16,12,15,25,19,128
18,5,5,14,0,0,0,0,0,42
18,5,5,14,1,2,12,5,0,62
18,5,5,14,1,2,12,5,4,66
18,5,5,14,1,3,20,0,0,66
18,5,5,14,1,3,20,5,4,75
18,5,5,14,1,3,20,19,0,85
18,5,5,14,3,12,15,19,5,96
18,5,5,14,4,15,18,19,5,103
18,5,5,14,4,15,23,0,0,84
18,5,5,14,4,15,23,5,4,93
18,5,5,14,4,15,23,19,0,103
18,5,5,14,6,15,18,3,5,89
18,5,5,14,7,1,7,5,0,62
18,5,5,14,7,1,7,5,4,66
18,5,5,14,7,1,7,5,19,81
18,5,5,14,7,5,0,0,0,54
18,5,5,14,7,18,1,22,5,95
18,5,5,14,7,18,15,19,19,120
18,5,5,14,10,15,25,0,0,92
18,5,5,14,10,15,25,5,4,101
18,5,5,14,10,15,9,14,0,90
18,5,5,14,10,15,25,19,0,111
18,5,5,14,12,1,18,7,5,85
18,5,5,14,12,9,19,20,0,102
18,5,5,14,12,9,19,20,19,121
18,5,5,14,18,15,12,12,0,99
18,5,5,14,19,12,1,22,5,101
18,5,5,14,20,5,18,0,0,85
18,5,5,14,20,5,18,5,4,94
18,5,5,14,20,5,18,19,0,104
18,5,5,14,20,18,1,14,20,115
18,5,5,14,20,18,25,0,0,105
18,5,5,14,20,18,9,5,19,113
18,5,5,16,5,18,0,0,0,67
18,5,5,17,21,9,16,0,0,91
18,5,5,17,21,9,16,19,0,110
18,5,5,17,21,9,16,20,0,111
18,5,5,18,5,3,20,0,0,74
18,5,5,18,5,3,20,5,4,83
18,5,5,18,5,3,20,19,0,93
18,5,5,18,21,16,20,0,0,103
18,5,5,19,8,9,5,0,0,69
18,5,5,19,8,12,5,0,0,72
18,5,5,19,11,0,0,0,0,58
18,5,5,19,12,5,0,0,0,64
18,5,5,19,20,0,0,0,0,67
18,5,5,19,20,5,4,0,0,76
18,5,5,19,20,5,18,0,0,90
18,5,5,19,20,25,0,0,0,92
18,5,5,19,20,9,14,7,0,97
18,5,5,19,20,12,5,0,0,84
18,5,5,19,20,19,0,0,0,86
18,5,5,20,0,0,0,0,0,48
18,5,5,20,1,13,0,0,0,62
18,5,5,20,12,5,0,0,0,65
18,5,5,22,1,19,9,15,14,108
18,5,5,22,5,4,0,0,0,59
18,5,5,22,5,12,1,14,4,86
18,5,5,22,5,19,8,9,16,107
18,5,5,22,9,14,7,0,0,80
18,5,5,22,15,11,5,0,0,81
18,5,5,22,15,11,5,4,0,85
18,5,5,22,15,11,5,19,0,100
18,5,5,22,15,11,9,14,7,106
18,5,5,24,1,13,9,14,5,94
18,5,5,24,5,3,21,20,5,106
18,5,5,24,8,9,2,9,20,100
18,5,5,24,16,1,14,4,0,87
18,5,5,24,16,5,12,0,0,85
18,5,5,24,16,5,12,19,0,104
18,5,5,24,16,12,1,9,14,104
18,5,5,24,16,12,15,18,5,118
18,5,5,24,16,15,18,20,0,121
18,5,5,24,16,15,18,20,19,140
18,5,5,24,16,15,19,5,0,107
18,5,5,24,16,15,19,5,4,111
18,5,5,24,16,18,5,19,19,129
18,5,6,0,0,0,0,0,0,29
18,5,6,1,3,5,0,0,0,38
18,5,6,1,3,5,4,0,0,42
18,5,6,1,3,5,19,0,0,57
18,5,6,1,3,9,14,7,0,63
18,5,6,1,3,20,9,15,14,91
18,5,6,1,9,20,0,0,0,59
18,5,6,1,12,12,0,0,0,54
18,5,6,1,12,12,5,14,0,73
18,5,6,1,12,12,9,14,7,84
18,5,6,1,12,12,15,23,0,92
18,5,6,1,12,12,19,0,0,73
18,5,6,1,14,0,0,0,0,44
18,5,6,1,19,8,9,15,14,95
18,5,6,1,19,20,5,14,0,88
18,5,6,1,19,20,5,14,19,107
18,5,6,1,22,15,18,0,0,85
18,5,6,5,3,20,0,0,0,57
18,5,6,5,3,20,5,4,0,66
18,5,6,5,3,20,9,14,7,87
18,5,6,5,3,20,9,15,14,95
18,5,6,5,3,20,9,22,5,93
18,5,6,5,3,20,15,18,25,115
18,5,6,5,3,20,19,0,0,76
18,5,6,5,4,0,0,0,0,38
18,5,6,5,5,4,0,0,0,43
18,5,6,5,5,4,9,14,7,73
18,5,6,5,5,4,19,0,0,62
18,5,6,5,5,12,0,0,0,51
18,5,6,5,5,12,9,14,7,81
18,5,6,5,5,12,19,0,0,70
18,5,6,5,9,7,14,0,0,64
18,5,6,5,12,0,0,0,0,46
18,5,6,5,12,12,0,0,0,58
18,5,6,5,12,12,5,4,0,67
18,5,6,5,12,12,9,14,7,88
18,5,6,5,12,19,0,0,0,65
18,5,6,5,12,20,0,0,0,66
18,5,6,5,14,3,5,0,0,56
18,5,6,5,14,3,5,4,0,60
18,5,6,5,14,3,5,19,0,75
18,5,6,5,18,0,0,0,0,52
18,5,6,5,18,1,2,12,5,72
18,5,6,5,18,4,1,0,0,57
18,5,6,5,18,5,4,0,0,61
18,5,6,5,18,5,5,0,0,62
18,5,6,5,18,5,5,4,0,66
18,5,6,5,18,5,5,19,0,81
18,5,6,5,18,5,14,3,5,79
18,5,6,5,18,5,14,4,1,76
18,5,6,5,18,5,14,20,0,91
18,5,6,5,18,5,14,20,19,110
18,5,6,5,18,13,5,14,20,104
18,5,6,5,18,18,1,12,0,83
18,5,6,5,18,18,1,12,19,102
18,5,6,5,18,18,5,4,0,79
18,5,6,5,18,18,5,18,0,93
18,5,6,5,18,18,5,18,19,112
18,5,6,5,18,18,9,14,7,100
18,5,6,5,18,19,0,0,0,71
18,5,6,5,20,3,8,0,0,65
18,5,6,5,20,5,0,0,0,59
18,5,6,6,5,4,0,0,0,44
18,5,6,6,5,12,20,0,0,72
18,5,6,6,9,14,7,0,0,65
18,5,6,6,15,0,0,0,0,50
18,5,6,6,15,19,0,0,0,69
18,5,6,6,18,15,26,5,0,99
18,5,6,6,18,15,26,5,14,113
18,5,6,9,7,8,20,0,0,73
18,5,6,9,7,8,20,19,0,92
18,5,6,9,7,21,18,5,0,89
18,5,6,9,7,21,18,5,4,93
18,5,6,9,7,21,18,5,19,108
18,5,6,9,12,5,0,0,0,55
18,5,6,9,12,5,4,0,0,59
18,5,6,9,12,5,19,0,0,74
18,5,6,9,12,9,14,7,0,80
18,5,6,9,12,12,0,0,0,62
18,5,6,9,12,12,5,4,0,71
18,5,6,9,12,12,9,14,7,92
18,5,6,9,12,12,19,0,0,81
18,5,6,9,12,13,0,0,0,63
18,5,6,9,12,13,5,4,0,72
18,5,6,9,12,13,9,14,7,93
18,5,6,9,12,13,19,0,0,82
18,5,6,9,12,20,5,18,0,93
18,5,6,9,12,20,5,18,19,112
18,5,6,9,14,1,2,12,5,72
18,5,6,9,14,1,7,5,0,65
18,5,6,9,14,1,14,3,5,75
18,5,6,9,14,4,0,0,0,56
18,5,6,9,14,4,9,14,7,86
18,5,6,9,14,4,19,0,0,75
18,5,6,9,14,5,0,0,0,57
18,5,6,9,14,5,4,0,0,61
18,5,6,9,14,5,4,12,25,98
18,5,6,9,14,5,18,0,0,75
18,5,6,9,14,5,18,25,0,100
18,5,6,9,14,5,18,19,0,94
18,5,6,9,14,5,19,0,0,76
18,5,6,9,14,7,5,18,0,82
18,5,6,9,14,9,14,7,0,82
18,5,6,9,14,9,19,8,0,88
18,5,6,9,18,5,0,0,0,61
18,5,6,9,18,5,4,0,0,65
18,5,6,9,18,5,19,0,0,80
18,5,6,9,18,9,14,7,0,86
18,5,6,9,20,0,0,0,0,58
18,5,6,9,20,13,5,14,20,110
18,5,6,9,20,19,0,0,0,77
18,5,6,9,20,20,5,4,0,87
18,5,6,9,20,20,9,14,7,108
18,5,6,9,24,0,0,0,0,62
18,5,6,9,24,5,4,0,0,71
18,5,6,9,24,5,19,0,0,86
18,5,6,9,24,9,14,7,0,92
18,5,6,9,24,20,21,18,5,126
18,5,6,12,0,0,0,0,0,41
18,5,6,12,1,7,0,0,0,49
18,5,6,12,1,9,18,0,0,69
18,5,6,12,1,13,5,0,0,60
18,5,6,12,1,19,8,0,0,69
18,5,6,12,1,20,5,0,0,67
18,5,6,12,1,20,5,4,0,71
18,5,6,12,1,20,5,19,0,86
18,5,6,12,1,20,9,14,7,92
18,5,6,12,1,20,9,15,14,100
18,5,6,12,5,3,20,0,0,69
18,5,6,12,5,3,20,5,4,78
18,5,6,12,5,3,20,5,18,92
18,5,6,12,5,3,20,15,18,102
18,5,6,12,5,3,20,19,0,88
18,5,6,12,5,4,7,5,0,62
18,5,6,12,5,5,0,0,0,51
18,5,6,12,5,20,0,0,0,66
18,5,6,12,5,20,19,0,0,85
18,5,6,12,5,23,0,0,0,69
18,5,6,12,5,24,5,4,0,79
18,5,6,12,5,24,5,19,0,94
18,5,6,12,5,24,9,14,7,100
18,5,6,12,5,24,9,15,14,108
18,5,6,12,5,24,9,19,13,111
18,5,6,12,5,24,9,21,5,105
18,5,6,12,5,24,9,22,5,106
18,5,6,12,5,24,12,25,0,107
18,5,6,12,25,0,0,0,0,66
18,5,6,12,9,5,19,0,0,74
18,5,6,12,25,9,14,7,0,96
18,5,6,12,9,14,7,0,0,71
18,5,6,12,15,1,20,0,0,77
18,5,6,12,15,1,20,5,4,86
18,5,6,12,15,1,20,19,0,96
18,5,6,12,15,7,0,0,0,63
18,5,6,12,15,15,4,0,0,75
18,5,6,12,15,15,4,5,4,84
18,5,6,12,15,15,4,19,0,94
18,5,6,12,15,15,18,0,0,89
18,5,6,12,15,23,0,0,0,79
18,5,6,12,15,23,5,4,0,88
18,5,6,12,15,23,5,18,0,102
18,5,6,12,15,23,5,18,19,121
18,5,6,12,15,23,9,14,7,109
18,5,6,12,15,23,14,0,0,93
18,5,6,12,15,23,19,0,0,98
18,5,6,12,21,5,14,3,5,89
18,5,6,12,21,5,14,3,25,109
18,5,6,12,21,5,14,20,0,101
18,5,6,12,21,15,21,19,0,117
18,5,6,12,21,19,8,0,0,89
18,5,6,12,21,24,0,0,0,86
18,5,6,12,21,24,5,4,0,95
18,5,6,12,21,24,5,19,0,110
18,5,6,12,21,24,9,14,7,116
18,5,6,15,3,21,19,0,0,87
18,5,6,15,3,21,19,5,4,96
18,5,6,15,3,21,19,5,19,111
18,5,6,15,12,4,0,0,0,60
18,5,6,15,12,4,5,4,0,69
18,5,6,15,12,4,9,14,7,90
18,5,6,15,12,4,19,0,0,79
18,5,6,15,13,5,14,20,0,96
18,5,6,15,14,20,0,0,0,78
18,5,6,15,15,12,0,0,0,71
18,5,6,15,15,20,0,0,0,79
18,5,6,15,18,2,9,4,0,77
18,5,6,15,18,3,5,0,0,70
18,5,6,15,18,4,0,0,0,66
18,5,6,15,18,5,19,20,0,106
18,5,6,15,18,5,19,20,19,125
18,5,6,15,18,6,5,9,20,102
18,5,6,15,18,7,5,0,0,74
18,5,6,15,18,7,5,4,0,78
18,5,6,15,18,7,5,18,0,92
18,5,6,15,18,7,5,19,0,93
18,5,6,15,18,7,5,20,0,94
18,5,6,15,18,7,9,14,7,99
18,5,6,15,18,7,9,22,5,105
18,5,6,15,18,13,1,4,15,95
18,5,6,15,18,13,1,20,0,96
18,5,6,15,18,13,1,20,5,101
18,5,6,15,18,13,1,20,19,115
18,5,6,15,18,13,5,18,0,98
18,5,6,15,18,13,5,18,19,117
18,5,6,15,18,13,9,14,7,105
18,5,6,15,18,13,9,19,13,116
18,5,6,15,18,13,9,19,20,123
18,5,6,15,18,13,19,0,0,94
18,5,6,15,18,19,1,11,5,98
18,5,6,15,18,20,9,6,25,122
18,5,6,15,18,23,1,18,4,108
18,5,6,15,21,7,8,20,0,100
18,5,6,15,21,14,4,0,0,83
18,5,6,15,21,14,4,5,4,92
18,5,6,15,21,14,4,5,18,106
18,5,6,15,21,14,4,19,0,102
18,5,6,18,0,0,0,0,0,47
18,5,6,18,1,3,20,0,0,71
18,5,6,18,1,3,20,5,4,80
18,5,6,18,1,3,20,15,18,104
18,5,6,18,1,3,20,19,0,90
18,5,6,18,1,7,1,20,5,81
18,5,6,18,1,9,14,0,0,71
18,5,6,18,1,9,14,5,4,80
18,5,6,18,1,9,14,5,18,94
18,5,6,18,1,9,14,19,0,90
18,5,6,18,1,13,5,0,0,66
18,5,6,18,1,13,5,4,0,70
18,5,6,18,1,13,5,19,0,85
18,5,6,18,1,13,9,14,7,91
18,5,6,18,5,5,26,5,0,88
18,5,6,18,5,5,26,5,19,107
18,5,6,18,5,9,4,0,0,65
18,5,6,18,5,9,20,0,0,81
18,5,6,18,5,14,26,25,0,117
18,5,6,18,5,19,3,15,0,89
18,5,6,18,5,19,8,0,0,79
18,5,6,18,5,19,8,5,4,88
18,5,6,18,5,19,8,5,14,98
18,5,6,18,5,19,8,5,18,102
18,5,6,18,5,19,8,5,19,103
18,5,6,18,25,0,0,0,0,72
18,5,6,18,9,3,1,20,5,85
18,5,6,18,9,5,4,0,0,65
18,5,6,18,9,5,19,0,0,80
18,5,6,18,9,7,0,0,0,63
18,5,6,18,25,9,14,7,0,102
18,5,6,18,9,14,7,5,0,82
18,5,6,18,15,9,4,0,0,75
18,5,6,18,15,14,20,0,0,96
18,5,6,18,15,14,20,5,4,105
18,5,6,18,15,14,20,19,0,115
18,5,6,18,15,26,5,0,0,93
18,5,6,18,15,26,5,14,0,107
18,5,6,19,0,0,0,0,0,48
18,5,6,20,0,0,0,0,0,49
18,5,6,21,5,12,0,0,0,67
18,5,6,21,5,12,5,4,0,76
18,5,6,21,5,12,9,14,7,97
18,5,6,21,5,12,12,5,4,88
18,5,6,21,5,12,19,0,0,86
18,5,6,21,7,5,0,0,0,62
18,5,6,21,7,5,4,0,0,66
18,5,6,21,7,5,5,0,0,67
18,5,6,21,7,5,5,19,0,86
18,5,6,21,7,5,19,0,0,81
18,5,6,21,7,9,1,0,0,67
18,5,6,21,7,9,14,7,0,87
18,5,6,21,7,9,21,13,0,100
18,5,6,21,12,7,5,0,0,74
18,5,6,21,12,7,5,14,20,108
18,5,6,21,14,4,0,0,0,68
18,5,6,21,14,4,5,4,0,77
18,5,6,21,14,4,5,18,0,91
18,5,6,21,14,4,5,18,19,110
18,5,6,21,14,4,9,14,7,98
18,5,6,21,14,4,19,0,0,87
18,5,6,21,18,2,9,19,8,106
18,5,6,21,18,12,0,0,0,80
18,5,6,21,18,14,9,19,8,118
18,5,6,21,19,1,2,12,5,89
18,5,6,21,19,1,12,0,0,82
18,5,6,21,19,1,12,19,0,101
18,5,6,21,19,5,0,0,0,74
18,5,6,21,19,5,4,0,0,78
18,5,6,21,19,5,14,9,11,108
18,5,6,21,19,5,18,0,0,92
18,5,6,21,19,5,18,19,0,111
18,5,6,21,19,5,19,0,0,93
18,5,6,21,19,9,14,7,0,99
18,5,6,21,19,9,15,14,0,107
18,5,6,21,19,9,22,5,0,105
18,5,6,21,19,14,9,11,0,103
18,5,6,21,20,1,2,12,5,90
18,5,6,21,20,1,2,12,25,110
18,5,6,21,20,1,12,0,0,83
18,5,6,21,20,1,12,19,0,102
18,5,6,21,20,5,0,0,0,75
18,5,6,21,20,5,4,0,0,79
18,5,6,21,20,5,18,0,0,93
18,5,6,21,20,5,18,19,0,112
18,5,6,21,20,5,19,0,0,94
18,5,6,21,20,9,14,7,0,100
18,5,7,1,9,14,5,4,0,63
18,5,7,1,9,14,5,18,0,77
18,5,7,1,9,14,5,18,19,96
18,5,7,1,9,14,9,14,7,84
18,5,7,1,9,14,19,0,0,73
18,5,7,1,12,0,0,0,0,43
18,5,7,1,12,1,4,15,0,63
18,5,7,1,12,4,0,0,0,47
18,5,7,1,12,5,0,0,0,48
18,5,7,1,12,5,4,0,0,52
18,5,7,1,12,5,18,0,0,66
18,5,7,1,12,5,18,19,0,85
18,5,7,1,12,5,19,0,0,67
18,5,7,1,12,9,1,0,0,53
18,5,7,1,12,9,1,14,0,67
18,5,7,1,12,9,14,7,0,73
18,5,7,1,12,9,15,0,0,67
18,5,7,1,12,9,19,13,0,84
18,5,7,1,12,9,19,20,0,91
18,5,7,1,12,9,20,25,0,97
18,5,7,1,12,9,26,5,0,83
18,5,7,1,12,12,25,0,0,80
18,5,7,1,12,12,15,16,0,86
18,5,7,1,12,14,5,19,19,100
18,5,7,1,12,15,0,0,0,58
18,5,7,1,12,20,25,0,0,88
18,5,7,1,13,2,12,5,0,63
18,5,7,1,13,2,12,5,4,67
18,5,7,1,18,4,0,0,0,53
18,5,7,1,18,4,1,14,20,88
18,5,7,1,18,4,5,4,0,62
18,5,7,1,18,4,5,18,0,76
18,5,7,1,18,4,6,21,12,92
18,5,7,1,18,4,9,14,7,83
18,5,7,1,18,4,19,0,0,72
18,5,7,1,18,13,5,14,20,101
18,5,7,1,18,14,9,19,8,99
18,5,7,1,20,8,5,18,0,82
18,5,7,1,20,8,5,18,19,101
18,5,7,1,20,20,1,0,0,72
18,5,7,1,20,20,1,19,0,91
18,5,7,1,21,7,5,0,0,64
18,5,7,1,21,7,5,4,0,68
18,5,7,1,21,7,5,19,0,83
18,5,7,1,21,7,9,14,7,89
18,5,7,1,22,5,0,0,0,58
18,5,7,4,0,0,0,0,0,34
18,5,7,5,1,18,0,0,0,54
18,5,7,5,1,18,5,4,0,63
18,5,7,5,1,18,9,14,7,84
18,5,7,5,1,18,19,0,0,73
18,5,7,5,12,0,0,0,0,47
18,5,7,5,12,1,20,5,0,73
18,5,7,5,12,1,20,5,4,77
18,5,7,5,12,1,20,5,19,92
18,5,7,5,12,12,5,4,0,68
18,5,7,5,12,12,9,14,7,89
18,5,7,5,14,3,9,5,19,85
18,5,7,5,14,5,19,9,19,101
18,5,7,5,14,20,0,0,0,69
18,5,7,5,14,20,1,12,0,82
18,5,7,5,14,20,5,19,19,112
18,5,7,5,14,20,19,0,0,88
18,5,7,5,19,0,0,0,0,54
18,5,7,5,19,20,0,0,0,74
18,5,7,5,20,0,0,0,0,55
18,5,7,7,1,5,0,0,0,43
18,5,7,7,1,5,19,0,0,62
18,5,7,9,1,0,0,0,0,40
18,5,7,9,1,14,0,0,0,54
18,5,7,9,3,9,4,1,12,68
18,5,7,9,3,9,4,5,0,60
18,5,7,9,3,9,4,5,19,79
18,5,7,9,4,15,18,0,0,76
18,5,7,9,5,0,0,0,0,44
18,5,7,9,6,20,0,0,0,65
18,5,7,9,6,21,7,5,0,78
18,5,7,9,12,4,0,0,0,55
18,5,7,9,12,4,5,4,0,64
18,5,7,9,12,4,9,14,7,85
18,5,7,9,12,4,19,0,0,74
18,5,7,9,12,12,0,0,0,63
18,5,7,9,12,20,0,0,0,71
18,5,7,9,13,5,0,0,0,57
18,5,7,9,13,5,14,0,0,71
18,5,7,9,13,5,14,1,12,84
18,5,7,9,13,5,14,19,0,90
18,5,7,9,13,5,14,20,0,91
18,5,7,9,13,5,14,20,19,110
18,5,7,9,13,5,19,0,0,76
18,5,7,9,13,9,14,1,12,88
18,5,7,9,14,1,5,0,0,59
18,5,7,9,14,1,12,0,0,66
18,5,7,9,14,1,19,0,0,73
18,5,7,9,15,9,4,5,0,72
18,5,7,9,15,14,0,0,0,68
18,5,7,9,15,14,1,12,0,81
18,5,7,9,15,14,1,12,19,100
18,5,7,9,15,14,1,18,25,112
18,5,7,9,15,14,5,4,0,77
18,5,7,9,15,14,19,0,0,87
18,5,7,9,18,4,0,0,0,61
18,5,7,9,19,19,5,21,18,121
18,5,7,9,19,20,5,18,19,120
18,5,7,9,19,20,18,1,12,109
18,5,7,9,19,20,18,1,18,115
18,5,7,9,19,20,18,5,18,119
18,5,7,9,19,20,18,25,0,121
18,5,7,9,20,9,22,5,0,95
18,5,7,9,21,19,0,0,0,79
18,5,7,9,22,5,0,0,0,66
18,5,7,9,22,5,14,0,0,80
18,5,7,9,22,5,19,0,0,85
18,5,7,9,22,9,14,7,0,91
18,5,7,12,1,4,4,5,14,70
18,5,7,12,1,9,18,0,0,70
18,5,7,12,1,26,5,0,0,74
18,5,7,12,1,26,5,4,0,78
18,5,7,12,1,26,5,19,0,93
18,5,7,12,1,26,9,14,7,99
18,5,7,12,5,0,0,0,0,47
18,5,7,12,5,13,5,14,20,99
18,5,7,12,5,20,0,0,0,67
18,5,7,12,5,20,19,0,0,86
18,5,7,12,15,18,9,6,25,115
18,5,7,12,15,19,19,0,0,95
18,5,7,12,15,19,19,5,4,104
18,5,7,12,15,19,19,5,19,119
18,5,7,12,15,22,5,0,0,84
18,5,7,12,15,23,0,0,0,80
18,5,7,12,15,23,5,4,0,89
18,5,7,12,15,23,9,14,7,110
18,5,7,12,15,23,19,0,0,99
18,5,7,12,21,5,0,0,0,68
18,5,7,12,21,5,4,0,0,72
18,5,7,12,21,5,19,0,0,87
18,5,7,12,21,9,14,7,0,93
18,5,7,13,1,0,0,0,0,44
18,5,7,13,1,3,1,18,16,82
18,5,7,13,1,20,1,0,0,65
18,5,7,14,1,0,0,0,0,45
18,5,7,14,1,12,0,0,0,57
18,5,7,14,1,14,3,25,0,87
18,5,7,14,1,14,20,0,0,79
18,5,7,14,21,13,0,0,0,78
18,5,7,15,12,9,20,8,0,94
18,5,7,15,12,9,20,8,19,113
18,5,7,15,18,7,5,0,0,75
18,5,7,15,18,7,5,4,0,79
18,5,7,15,18,7,5,19,0,94
18,5,7,15,18,7,9,14,7,100
18,5,7,15,19,15,12,0,0,91
18,5,7,15,19,15,12,19,0,110
18,5,7,15,22,5,18,14,0,104
18,5,7,18,0,0,0,0,0,48
18,5,7,18,1,2,0,0,0,51
18,5,7,18,1,2,2,5,4,62
18,5,7,18,1,3,25,0,0,77
18,5,7,18,1,4,1,20,5,79
18,5,7,18,1,4,5,0,0,58
18,5,7,18,1,4,5,4,0,62
18,5,7,18,1,4,5,19,0,77
18,5,7,18,1,4,9,14,7,83
18,5,7,18,1,6,20,0,0,75
18,5,7,18,1,6,20,5,4,84
18,5,7,18,1,6,20,19,0,94
18,5,7,18,1,14,20,0,0,83
18,5,7,18,1,14,20,5,4,92
18,5,7,18,1,14,20,19,0,102
18,5,7,18,1,16,8,0,0,73
18,5,7,18,1,19,16,0,0,84
18,5,7,18,1,19,19,0,0,87
18,5,7,18,1,20,5,0,0,74
18,5,7,18,1,20,5,4,0,78
18,5,7,18,1,20,5,18,0,92
18,5,7,18,1,20,5,19,0,93
18,5,7,18,1,20,9,6,25,109
18,5,7,18,1,20,9,14,7,99
18,5,7,18,1,20,15,18,0,102
18,5,7,18,1,22,5,12,0,88
18,5,7,18,5,1,19,5,0,78
18,5,7,18,5,1,19,5,4,82
18,5,7,18,5,4,5,0,0,62
18,5,7,18,5,5,14,0,0,72
18,5,7,18,5,5,14,19,0,91
18,5,7,18,5,5,20,0,0,78
18,5,7,18,5,5,20,5,4,87
18,5,7,18,5,5,20,19,0,97
18,5,7,18,5,19,19,0,0,91
18,5,7,18,5,19,19,5,4,100
18,5,7,18,5,19,19,5,19,115
18,5,7,18,5,19,19,15,18,124
18,5,7,18,5,20,0,0,0,73
18,5,7,18,5,20,6,21,12,112
18,5,7,18,5,20,19,0,0,92
18,5,7,18,5,20,20,5,4,102
18,5,7,18,5,20,20,5,18,116
18,5,7,18,5,23,0,0,0,76
18,5,7,18,9,14,4,0,0,75
18,5,7,18,9,14,4,5,18,98
18,5,7,18,9,14,4,19,0,94
18,5,7,18,9,16,0,0,0,73
18,5,7,18,9,16,16,5,4,98
18,5,7,18,15,15,13,0,0,91
18,5,7,18,15,15,13,19,0,110
18,5,7,18,15,15,22,5,0,105
18,5,7,18,15,15,22,5,4,109
18,5,7,18,15,15,22,5,19,124
18,5,7,18,15,21,14,4,0,102
18,5,7,18,15,21,16,0,0,100
18,5,7,18,15,21,16,5,4,109
18,5,7,18,15,21,16,19,0,119
18,5,7,18,15,23,0,0,0,86
18,5,7,18,15,23,9,14,7,116
18,5,7,18,15,23,14,0,0,100
18,5,7,18,15,23,19,0,0,105
18,5,7,18,15,23,20,8,0,114
18,5,7,18,15,23,20,8,19,133
18,5,7,19,0,0,0,0,0,49
18,5,7,21,1,18,4,0,0,74
18,5,7,21,9,4,5,0,0,69
18,5,7,21,9,4,5,4,0,73
18,5,7,21,9,4,9,14,7,94
18,5,7,21,12,1,0,0,0,64
18,5,7,21,12,1,2,12,5,83
18,5,7,21,12,1,18,0,0,82
18,5,7,21,12,1,18,12,25,119
18,5,7,21,12,1,18,19,0,101
18,5,7,21,12,1,20,5,0,89
18,5,7,21,12,1,20,5,4,93
18,5,7,21,12,1,20,5,19,108
18,5,7,21,12,1,20,15,18,117
18,5,7,21,12,9,0,0,0,72
18,5,7,21,12,9,14,5,0,91
18,5,7,21,12,9,26,5,0,103
18,5,7,21,12,21,19,5,19,127
18,5,7,21,18,0,0,0,0,69
18,5,7,21,18,7,5,0,0,81
18,5,7,21,19,8,0,0,0,78
18,5,8,0,0,0,0,0,0,31
18,5,8,1,2,0,0,0,0,34
18,5,8,1,2,2,5,4,0,45
18,5,8,1,2,2,5,18,0,59
18,5,8,1,2,19,0,0,0,53
18,5,8,1,9,18,0,0,0,59
18,5,8,1,25,20,5,0,0,82
18,5,8,1,12,5,0,0,0,49
18,5,8,1,12,12,15,23,0,94
18,5,8,1,13,13,5,18,0,81
18,5,8,1,13,13,5,18,19,100
18,5,8,1,14,4,12,5,0,67
18,5,8,1,14,4,12,5,4,71
18,5,8,1,14,4,12,5,18,85
18,5,8,1,14,4,12,5,19,86
18,5,8,1,14,7,0,0,0,53
18,5,8,1,14,7,5,4,0,62
18,5,8,1,14,7,9,14,7,83
18,5,8,1,14,7,19,0,0,72
18,5,8,1,16,16,5,14,0,83
18,5,8,1,18,4,5,14,0,73
18,5,8,1,18,4,5,14,19,92
18,5,8,1,18,13,0,0,0,63
18,5,8,1,18,14,5,19,19,107
18,5,8,1,18,18,15,23,0,106
18,5,8,1,18,22,5,19,20,116
18,5,8,1,19,8,0,0,0,59
18,5,8,1,19,8,5,4,0,68
18,5,8,1,19,8,5,19,0,83
18,5,8,1,19,8,9,14,7,89
18,5,8,1,21,12,0,0,0,65
18,5,8,1,26,1,18,4,0,81
18,5,8,2,15,3,0,0,0,51
18,5,8,5,1,4,0,0,0,41
18,5,8,5,1,12,0,0,0,49
18,5,8,5,1,16,0,0,0,53
18,5,8,5,1,18,0,0,0,55
18,5,8,5,1,18,4,0,0,59
18,5,8,5,1,18,9,14,7,85
18,5,8,5,1,18,19,0,0,74
18,5,8,5,1,18,19,1,12,87
18,5,8,5,1,18,19,5,0,79
18,5,8,5,1,18,19,5,4,83
18,5,8,5,1,18,19,5,18,97
18,5,8,5,1,18,19,5,19,98
18,5,8,5,1,18,20,5,14,94
18,5,8,5,1,20,0,0,0,57
18,5,8,5,1,20,5,4,0,66
18,5,8,5,1,20,5,18,0,80
18,5,8,5,1,20,5,18,19,99
18,5,8,5,1,20,9,14,7,87
18,5,8,5,1,20,19,0,0,76
18,5,8,5,4,7,5,0,0,52
18,5,8,5,5,12,0,0,0,53
18,5,8,5,5,12,5,4,0,62
18,5,8,5,5,12,9,14,7,83
18,5,8,5,5,12,19,0,0,72
18,5,8,5,13,0,0,0,0,49
18,5,8,5,13,13,5,4,0,71
18,5,8,5,13,13,9,14,7,92
18,5,8,5,13,19,0,0,0,68
18,5,8,5,20,5,0,0,0,61
18,5,8,9,4,0,0,0,0,44
18,5,8,9,4,4,5,14,0,67
18,5,8,9,4,5,0,0,0,49
18,5,8,25,4,18,1,20,5,104
18,5,8,9,14,7,5,0,0,66
18,5,8,9,14,7,5,4,0,70
18,5,8,9,14,7,5,19,0,85
18,5,8,9,14,7,9,14,7,91
18,5,8,9,18,5,0,0,0,63
18,5,8,9,18,5,4,0,0,67
18,5,8,9,18,5,19,0,0,82
18,5,8,9,18,9,14,7,0,88
18,5,8,15,5,0,0,0,0,51
18,5,8,15,9,19,20,0,0,94
18,5,8,15,12,12,15,23,0,108
18,5,8,15,14,5,0,0,0,65
18,5,8,15,14,5,4,0,0,69
18,5,8,15,14,9,14,7,0,90
18,5,8,15,14,15,18,0,0,93
18,5,8,15,14,15,21,18,0,114
18,5,8,15,15,4,0,0,0,65
18,5,8,15,15,11,0,0,0,72
18,5,8,15,15,16,0,0,0,77
18,5,8,15,21,19,5,0,0,91
18,5,8,15,21,19,5,4,0,95
18,5,8,15,21,19,5,19,0,110
18,5,8,15,21,19,9,14,7,116
18,5,8,21,13,2,12,5,0,84
18,5,8,21,14,7,0,0,0,73
18,5,9,0,0,0,0,0,0,32
18,5,9,3,5,0,0,0,0,40
18,5,9,3,5,4,0,0,0,44
18,5,9,3,9,14,7,0,0,65
18,5,9,6,0,0,0,0,0,38
18,5,9,6,25,0,0,0,0,63
18,5,9,6,9,5,4,0,0,56
18,5,9,6,9,5,18,0,0,70
18,5,9,6,9,5,18,19,0,89
18,5,9,6,9,5,19,0,0,71
18,5,9,6,25,9,14,7,0,93
18,5,9,6,19,0,0,0,0,57
18,5,9,7,14,0,0,0,0,53
18,5,9,7,14,5,4,0,0,62
18,5,9,7,14,5,18,0,0,76
18,5,9,7,14,9,14,7,0,83
18,5,9,7,14,9,20,5,0,87
18,5,9,7,14,9,20,5,4,91
18,5,9,7,14,9,20,5,19,106
18,5,9,7,14,15,18,5,0,91
18,5,9,7,14,19,0,0,0,72
18,5,25,9,5,12,4,0,0,78
18,5,9,12,12,21,13,5,0,95
18,5,9,13,0,0,0,0,0,45
18,5,9,13,1,7,5,0,0,58
18,5,9,13,1,7,5,4,0,62
18,5,9,13,1,7,5,19,0,77
18,5,9,13,1,7,9,14,5,81
18,5,9,13,1,7,9,14,7,83
18,5,9,13,2,1,18,11,0,77
18,5,9,13,2,9,2,5,0,63
18,5,9,13,2,15,4,25,0,91
18,5,9,13,2,21,18,19,5,110
18,5,9,13,2,21,19,8,0,95
18,5,9,13,13,5,18,7,5,93
18,5,9,13,13,5,18,19,5,105
18,5,9,13,16,1,3,20,0,85
18,5,9,13,16,1,18,11,0,91
18,5,9,13,16,1,18,20,0,100
18,5,9,13,16,5,12,0,0,78
18,5,9,13,16,12,1,14,20,108
18,5,9,13,16,12,25,0,0,98
18,5,9,13,16,12,9,5,4,91
18,5,9,13,16,15,18,20,0,114
18,5,9,13,16,15,18,20,19,133
18,5,9,13,16,15,19,5,0,100
18,5,9,13,16,15,19,5,4,104
18,5,9,13,16,15,19,5,19,119
18,5,9,13,16,18,5,19,19,122
18,5,9,13,16,18,9,14,20,122
18,5,9,13,16,18,15,22,5,121
18,5,9,13,16,21,12,19,5,118
18,5,25,14,1,18,4,19,0,104
18,5,9,14,3,5,14,19,5,92
18,5,9,14,3,9,20,5,0,83
18,5,9,14,3,9,20,5,4,87
18,5,9,14,3,9,20,5,19,102
18,5,9,14,3,12,9,14,5,89
18,5,9,14,3,12,21,4,5,91
18,5,9,14,3,21,18,0,0,88
18,5,9,14,3,21,18,19,0,107
18,5,9,14,4,5,5,18,0,78
18,5,9,14,4,5,5,18,19,97
18,5,9,14,4,5,24,0,0,79
18,5,9,14,4,5,24,5,4,88
18,5,9,14,4,5,24,5,19,103
18,5,9,14,4,9,3,20,0,82
18,5,9,14,4,15,18,19,5,107
18,5,9,14,4,21,3,5,0,79
18,5,9,14,4,21,3,5,4,83
18,5,9,14,4,21,3,5,19,98
18,5,9,14,4,21,3,20,0,94
18,5,9,14,4,21,3,20,19,113
18,5,9,14,4,21,5,0,0,76
18,5,9,14,4,21,12,7,5,95
18,5,9,14,5,4,0,0,0,55
18,5,9,14,5,20,20,5,0,96
18,5,9,14,6,5,3,20,0,80
18,5,9,14,6,5,3,20,19,99
18,5,9,14,6,5,18,0,0,75
18,5,9,14,6,5,19,20,0,96
18,5,9,14,6,12,1,13,5,83
18,5,9,14,6,12,1,20,5,90
18,5,9,14,6,12,9,3,20,96
18,5,9,14,6,15,18,3,5,93
18,5,9,14,6,15,18,13,0,98
18,5,9,14,6,15,18,13,19,117
18,5,9,14,6,21,14,4,0,91
18,5,9,14,6,21,19,5,0,97
18,5,9,14,6,21,19,5,4,101
18,5,9,14,6,21,19,5,19,116
18,5,9,14,7,18,1,6,20,98
18,5,9,14,7,18,5,19,19,114
18,5,9,14,8,1,2,9,20,86
18,5,9,14,8,5,18,9,20,106
18,5,9,14,9,14,7,0,0,76
18,5,9,14,10,5,3,20,0,84
18,5,9,14,10,21,18,5,0,100
18,5,9,14,10,21,18,5,4,104
18,5,9,14,10,21,18,5,19,119
18,5,9,14,10,21,18,25,0,120
18,5,9,14,11,0,0,0,0,57
18,5,9,14,11,5,4,0,0,66
18,5,9,14,11,9,14,7,0,87
18,5,9,14,11,19,0,0,0,76
18,5,9,14,12,5,19,19,0,101
18,5,9,14,17,21,9,18,5,116
18,5,9,14,17,21,9,18,25,136
18,5,9,14,19,0,0,0,0,65
18,5,9,14,19,1,14,5,0,85
18,5,9,14,19,5,18,20,0,108
18,5,9,14,19,5,18,20,19,127
18,5,9,14,19,9,19,20,0,113
18,5,9,14,19,13,1,14,0,93
18,5,9,14,19,13,5,14,0,97
18,5,9,14,19,16,5,3,20,109
18,5,9,14,19,16,9,18,5,113
18,5,9,14,19,20,1,12,12,110
18,5,9,14,19,20,1,20,5,111
18,5,9,14,19,20,9,12,0,106
18,5,9,14,19,20,9,12,12,118
18,5,9,14,19,21,12,20,0,118
18,5,9,14,19,21,18,5,0,109
18,5,9,14,19,21,18,5,4,113
18,5,9,14,19,21,18,5,18,127
18,5,9,14,19,21,18,5,19,128
18,5,9,14,20,5,14,4,0,89
18,5,9,14,20,5,18,0,0,89
18,5,9,14,20,5,18,19,0,108
18,5,9,14,20,18,21,4,5,114
18,5,9,14,22,1,4,5,0,78
18,5,9,14,22,1,4,5,4,82
18,5,9,14,22,5,14,20,0,107
18,5,9,14,22,5,14,20,19,126
18,5,9,14,22,5,18,20,0,111
18,5,9,14,22,5,19,20,0,112
18,5,9,14,22,5,19,20,19,131
18,5,9,14,22,9,20,5,0,102
18,5,9,14,22,9,20,5,4,106
18,5,9,14,22,9,20,5,19,121
18,5,9,14,22,15,9,3,5,100
18,5,9,14,22,15,11,5,0,99
18,5,9,14,22,15,11,5,4,103
18,5,9,14,22,15,11,5,19,118
18,5,9,14,22,15,12,22,5,122
18,5,25,15,11,5,0,0,0,79
18,5,25,15,11,5,4,0,0,83
18,5,25,15,11,9,14,7,0,104
18,5,25,15,21,20,8,0,0,112
18,5,9,19,14,5,18,0,0,88
18,5,9,19,15,12,1,20,5,104
18,5,25,19,15,14,0,0,0,96
18,5,9,19,19,21,5,0,0,96
18,5,9,19,19,21,5,4,0,100
18,5,9,19,19,21,5,18,0,114
18,5,9,19,19,21,5,18,19,133
18,5,9,19,19,21,5,19,0,115
18,5,9,19,19,21,9,14,7,121
18,5,9,19,20,0,0,0,0,71
18,5,9,19,20,5,18,0,0,94
18,5,9,20,0,0,0,0,0,52
18,5,9,20,2,15,11,0,0,80
18,5,9,20,2,15,11,19,0,99
18,5,9,20,2,21,3,11,0,89
18,5,9,20,5,13,9,26,5,110
18,5,9,20,5,18,1,14,20,110
18,5,9,20,5,18,1,20,5,101
18,5,9,22,5,0,0,0,0,59
18,5,9,22,5,4,0,0,0,63
18,5,9,22,5,18,0,0,0,77
18,5,9,22,5,18,19,0,0,96
18,5,9,22,5,19,0,0,0,78
18,5,9,22,9,14,7,0,0,84
18,5,10,1,3,11,5,20,0,73
18,5,10,1,9,12,0,0,0,55
18,5,10,5,3,20,0,0,0,61
18,5,10,5,3,20,1,7,5,74
18,5,10,5,3,20,5,4,0,70
18,5,10,5,3,20,5,5,0,71
18,5,10,5,3,20,5,5,19,90
18,5,10,5,3,20,5,18,0,84
18,5,10,5,3,20,5,18,19,103
18,5,10,5,3,20,9,14,7,91
18,5,10,5,3,20,9,15,14,99
18,5,10,5,3,20,9,22,5,97
18,5,10,5,3,20,15,18,0,94
18,5,10,5,3,20,15,18,19,113
18,5,10,5,3,20,19,0,0,80
18,5,10,5,18,11,0,0,0,67
18,5,10,9,7,0,0,0,0,49
18,5,10,9,7,7,5,18,0,79
18,5,10,9,7,7,5,18,19,98
18,5,10,15,9,3,5,0,0,65
18,5,10,15,9,3,5,4,0,69
18,5,10,15,9,3,5,18,0,83
18,5,10,15,9,3,5,18,19,102
18,5,10,15,9,3,5,19,0,84
18,5,10,15,9,3,9,14,7,90
18,5,10,15,9,14,0,0,0,71
18,5,10,15,9,14,4,5,18,98
18,5,10,15,9,14,5,4,0,80
18,5,10,15,9,14,9,14,7,101
18,5,10,15,9,14,19,0,0,90
18,5,10,15,12,20,0,0,0,80
18,5,10,15,14,5,15,0,0,82
18,5,10,15,21,14,3,5,0,91
18,5,10,15,21,18,14,0,0,101
18,5,10,15,21,18,14,5,25,131
18,5,10,21,4,7,5,0,0,70
18,5,10,21,4,7,5,4,0,74
18,5,10,21,4,7,5,19,0,89
18,5,10,21,4,7,9,14,7,95
18,5,10,21,7,7,12,5,0,85
18,5,10,21,13,2,12,5,0,86
18,5,10,21,19,20,9,6,25,133
18,5,11,5,25,0,0,0,0,64
18,5,11,5,25,5,4,0,0,73
18,5,11,5,25,9,14,7,0,94
18,5,11,5,25,19,0,0,0,83
18,5,11,8,20,9,0,0,0,71
18,5,11,9,3,11,0,0,0,57
18,5,11,9,12,12,0,0,0,67
18,5,11,9,14,4,12,5,0,78
18,5,11,9,14,4,12,5,4,82
18,5,11,9,14,4,12,5,18,96
18,5,11,9,14,4,12,5,19,97
18,5,11,9,14,7,0,0,0,64
18,5,11,9,14,15,12,5,0,89
18,5,11,9,19,19,0,0,0,81
18,5,11,14,5,1,4,0,0,58
18,5,11,14,9,20,0,0,0,77
18,5,11,14,9,20,19,0,0,96
18,5,11,14,9,20,20,5,4,106
18,5,11,14,15,3,11,0,0,77
18,5,11,14,15,20,0,0,0,83
18,5,11,14,15,20,20,5,4,112
18,5,11,14,15,23,0,0,0,86
18,5,12,0,0,0,0,0,0,35
18,5,12,1,2,5,12,0,0,55
18,5,12,1,2,5,12,5,4,64
18,5,12,1,2,5,12,19,0,74
18,5,12,1,3,5,0,0,0,44
18,5,12,1,3,5,4,0,0,48
18,5,12,1,3,5,19,0,0,63
18,5,12,1,3,8,5,0,0,52
18,5,12,1,3,9,14,7,0,69
18,5,12,1,3,17,21,5,18,100
18,5,12,1,4,5,0,0,0,45
18,5,12,1,4,5,14,0,0,59
18,5,12,1,4,12,5,0,0,57
18,5,12,1,4,12,5,4,0,61
18,5,12,1,4,12,9,14,7,82
18,5,12,1,9,4,0,0,0,49
18,5,12,1,25,5,4,0,0,70
18,5,12,1,25,5,18,0,0,84
18,5,12,1,25,9,14,7,0,91
18,5,12,1,25,13,1,14,0,89
18,5,12,1,9,19,0,0,0,64
18,5,12,1,25,19,0,0,0,80
18,5,12,1,13,5,14,20,0,88
18,5,12,1,13,16,0,0,0,65
18,5,12,1,14,3,5,0,0,58
18,5,12,1,14,3,5,4,0,62
18,5,12,1,14,3,9,14,7,83
18,5,12,1,14,4,0,0,0,54
18,5,12,1,16,0,0,0,0,52
18,5,12,1,16,16,5,18,0,91
18,5,12,1,16,19,5,0,0,76
18,5,12,1,16,19,5,4,0,80
18,5,12,1,16,19,5,18,0,94
18,5,12,1,16,19,5,18,19,113
18,5,12,1,16,19,5,19,0,95
18,5,12,1,16,19,9,14,7,101
18,5,12,1,19,20,0,0,0,75
18,5,12,1,19,20,5,18,0,98
18,5,12,1,20,1,0,0,0,57
18,5,12,1,20,1,2,12,5,76
18,5,12,1,20,3,8,0,0,67
18,5,12,1,20,5,0,0,0,61
18,5,12,1,20,5,4,0,0,65
18,5,12,1,20,5,4,12,25,102
18,5,12,1,20,5,18,0,0,79
18,5,12,1,20,5,18,19,0,98
18,5,12,1,20,5,19,0,0,80
18,5,12,1,20,9,14,7,0,86
18,5,12,1,20,9,15,14,0,94
18,5,12,1,20,9,15,14,5,99
18,5,12,1,20,9,15,14,19,113
18,5,12,1,20,9,22,1,12,100
18,5,12,1,20,9,22,5,0,92
18,5,12,1,20,9,22,5,19,111
18,5,12,1,20,15,18,0,0,89
18,5,12,1,20,15,18,19,0,108
18,5,12,1,20,18,9,24,0,107
18,5,12,1,20,21,13,0,0,90
18,5,12,1,21,14,3,8,0,82
18,5,12,1,21,14,4,5,18,98
18,5,12,1,24,0,0,0,0,60
18,5,12,1,24,1,2,12,5,80
18,5,12,1,24,1,14,20,0,95
18,5,12,1,24,1,14,20,19,114
18,5,12,1,24,5,4,0,0,69
18,5,12,1,24,5,4,12,25,106
18,5,12,1,24,5,18,0,0,83
18,5,12,1,24,5,18,19,0,102
18,5,12,1,24,5,19,0,0,84
18,5,12,1,24,9,14,0,0,83
18,5,12,1,24,9,14,7,0,90
18,5,12,1,24,9,14,19,0,102
18,5,12,2,21,14,0,0,0,72
18,5,12,5,1,4,0,0,0,45
18,5,12,5,1,16,0,0,0,57
18,5,12,5,1,18,14,0,0,73
18,5,12,5,1,18,14,5,4,82
18,5,12,5,1,18,14,19,0,92
18,5,12,5,1,18,14,20,0,93
18,5,12,5,1,19,5,0,0,65
18,5,12,5,1,19,5,4,0,69
18,5,12,5,1,19,5,5,0,70
18,5,12,5,1,19,5,18,0,83
18,5,12,5,1,19,5,18,19,102
18,5,12,5,1,19,5,19,0,84
18,5,12,5,1,19,9,14,7,90
18,5,12,5,1,19,15,18,0,93
18,5,12,5,1,20,8,5,18,92
18,5,12,5,3,20,9,15,14,101
18,5,12,5,7,1,2,12,5,67
18,5,12,5,7,1,20,5,0,73
18,5,12,5,7,1,20,5,4,77
18,5,12,5,7,1,20,5,19,92
18,5,12,5,9,22,15,0,0,86
18,5,12,5,9,22,15,19,0,105
18,5,12,5,14,4,0,0,0,58
18,5,12,5,14,4,9,14,7,88
18,5,12,5,14,4,19,0,0,77
18,5,12,5,14,20,0,0,0,74
18,5,12,5,14,20,5,4,0,83
18,5,12,5,14,20,9,14,7,104
18,5,12,5,14,20,19,0,0,93
18,5,12,5,19,0,0,0,0,59
18,5,12,5,19,19,1,0,0,79
18,5,12,5,19,19,5,5,0,88
18,5,12,5,19,19,15,18,0,111
18,5,12,5,20,0,0,0,0,60
18,5,12,5,20,19,0,0,0,79
18,5,12,5,20,20,5,18,0,103
18,5,12,5,20,20,5,18,19,122
18,5,12,5,20,20,9,14,7,110
18,5,12,5,22,1,14,3,5,85
18,5,12,5,22,1,14,3,25,105
18,5,12,5,22,1,14,20,0,97
18,5,12,5,22,1,20,5,0,88
18,5,12,5,22,1,20,15,18,116
18,5,12,5,22,5,0,0,0,67
18,5,12,5,22,5,12,0,0,79
18,5,12,5,22,5,12,5,4,88
18,5,12,5,22,5,14,20,0,101
18,5,12,5,22,5,18,0,0,85
18,5,12,5,22,5,19,0,0,86
18,5,12,5,22,25,0,0,0,87
18,5,12,5,22,9,5,4,0,80
18,5,12,5,22,25,9,14,7,117
18,5,12,25,0,0,0,0,0,60
18,5,12,9,1,2,12,5,0,64
18,5,12,9,1,2,12,25,0,84
18,5,12,9,1,14,3,5,19,86
18,5,12,9,1,14,20,0,0,79
18,5,12,9,1,14,20,12,25,116
18,5,12,9,3,0,0,0,0,47
18,5,12,9,3,1,18,25,0,91
18,5,12,9,3,5,14,19,5,90
18,5,12,9,3,11,0,0,0,58
18,5,12,9,3,12,9,11,5,84
18,5,12,9,3,19,0,0,0,66
18,5,12,9,3,20,0,0,0,67
18,5,12,9,3,20,1,5,0,73
18,5,12,9,3,20,5,4,0,76
18,5,12,9,3,20,9,0,0,76
18,5,12,9,3,20,9,15,14,105
18,5,12,9,3,20,19,0,0,86
18,5,12,9,4,5,0,0,0,53
18,5,12,9,5,4,0,0,0,53
18,5,12,9,5,6,0,0,0,55
18,5,12,9,5,6,5,18,0,78
18,5,12,9,5,6,19,0,0,74
18,5,12,9,5,18,0,0,0,67
18,5,12,9,5,18,19,0,0,86
18,5,12,9,5,19,0,0,0,68
18,5,12,9,5,22,5,0,0,76
18,5,12,9,5,22,5,4,0,80
18,5,12,9,5,22,5,18,0,94
18,5,12,9,5,22,5,18,19,113
18,5,12,9,5,22,5,19,0,95
18,5,12,9,5,22,9,14,7,101
18,5,12,9,5,22,15,0,0,86
18,5,12,9,5,22,15,19,0,105
18,5,12,9,6,20,0,0,0,70
18,5,12,9,7,0,0,0,0,51
18,5,12,9,7,1,20,5,0,77
18,5,12,9,7,8,20,0,0,79
18,5,12,9,7,8,20,5,4,88
18,5,12,9,7,8,20,5,14,98
18,5,12,9,7,8,20,5,18,102
18,5,12,9,7,8,20,19,0,98
18,5,12,9,7,9,5,21,24,110
18,5,12,9,7,9,15,0,0,75
18,5,12,9,7,9,15,14,0,89
18,5,12,9,7,9,15,14,19,108
18,5,12,9,7,9,15,19,5,99
18,5,12,9,7,9,15,19,15,109
18,5,12,9,7,9,15,21,19,115
18,5,12,9,9,1,14,20,0,88
18,5,12,25,9,14,7,0,0,90
18,5,12,9,13,5,0,0,0,62
18,5,12,9,13,9,20,0,0,86
18,5,12,9,14,5,0,0,0,63
18,5,12,9,14,5,4,0,0,67
18,5,12,9,14,5,18,0,0,81
18,5,12,9,14,5,19,0,0,82
18,5,12,9,14,9,14,7,0,88
18,5,12,9,14,11,0,0,0,69
18,5,12,9,14,11,5,4,0,78
18,5,12,9,14,11,19,0,0,88
18,5,12,9,17,21,1,18,25,126
18,5,12,9,17,21,5,0,0,87
18,5,12,9,17,21,5,6,25,118
18,5,12,9,17,21,5,19,0,106
18,5,12,9,17,21,9,1,5,97
18,5,12,9,17,21,9,1,14,106
18,5,12,9,17,21,9,19,13,123
18,5,12,9,19,8,0,0,0,71
18,5,12,9,19,8,5,4,0,80
18,5,12,9,19,8,5,18,0,94
18,5,12,9,19,8,5,19,0,95
18,5,12,9,19,8,25,0,0,96
18,5,12,9,19,8,9,14,7,101
18,5,12,9,19,20,0,0,0,83
18,5,12,9,19,20,5,4,0,92
18,5,12,9,19,20,5,14,0,102
18,5,12,9,19,20,9,14,7,113
18,5,12,9,19,20,19,0,0,102
18,5,12,9,20,0,0,0,0,64
18,5,12,9,22,1,2,12,5,86
18,5,12,9,22,5,0,0,0,71
18,5,12,9,22,5,4,0,0,75
18,5,12,9,22,5,18,0,0,89
18,5,12,9,22,5,19,0,0,90
18,5,12,9,22,9,14,7,0,96
18,5,12,15,1,4,0,0,0,55
18,5,12,15,1,4,5,4,0,64
18,5,12,15,1,4,5,18,0,78
18,5,12,15,1,4,5,18,19,97
18,5,12,15,1,4,9,14,7,85
18,5,12,15,1,4,19,0,0,74
18,5,12,15,1,14,0,0,0,65
18,5,12,15,1,14,5,4,0,74
18,5,12,15,1,14,9,14,7,95
18,5,12,15,1,14,19,0,0,84
18,5,12,15,3,1,2,12,5,73
18,5,12,15,3,1,20,5,0,79
18,5,12,15,3,1,20,5,4,83
18,5,12,15,3,1,20,5,5,84
18,5,12,15,3,1,20,5,19,98
18,5,12,15,3,1,20,15,18,107
18,5,12,15,3,11,0,0,0,64
18,5,12,15,3,11,5,4,0,73
18,5,12,15,3,11,19,0,0,83
18,5,12,15,4,7,5,0,0,66
18,5,12,15,14,7,0,0,0,71
18,5,12,15,15,11,0,0,0,76
18,5,12,15,19,5,0,0,0,74
18,5,12,15,19,9,14,7,0,99
18,5,12,15,19,20,0,0,0,89
18,5,12,15,20,0,0,0,0,70
18,5,12,15,22,5,0,0,0,77
18,5,12,15,23,5,18,0,0,96
18,5,12,21,3,5,0,0,0,64
18,5,12,21,3,5,14,20,0,98
18,5,12,21,3,20,0,0,0,79
18,5,12,21,3,20,1,14,20,114
18,5,12,21,3,20,1,20,5,105
18,5,12,21,3,20,5,4,0,88
18,5,12,21,3,20,9,14,7,109
18,5,12,21,3,20,19,0,0,98
18,5,12,21,13,5,0,0,0,74
18,5,12,21,13,5,4,0,0,78
18,5,12,21,13,5,19,0,0,93
18,5,12,21,13,9,14,5,0,97
18,5,12,21,13,9,14,5,4,101
18,5,12,21,13,9,14,5,19,116
18,5,12,21,13,9,14,7,0,99
18,5,13,1,4,5,0,0,0,46
18,5,13,1,7,14,9,6,25,98
18,5,13,1,9,12,0,0,0,58
18,5,13,1,9,12,5,4,0,67
18,5,13,1,9,12,9,14,7,88
18,5,13,1,9,12,19,0,0,77
18,5,13,1,9,13,0,0,0,59
18,5,13,1,9,14,0,0,0,60
18,5,13,1,9,14,4,5,18,87
18,5,13,1,9,14,5,4,0,69
18,5,13,1,9,14,5,18,0,83
18,5,13,1,9,14,9,14,7,90
18,5,13,1,9,14,19,0,0,79
18,5,13,1,11,5,0,0,0,53
18,5,13,1,11,5,18,0,0,71
18,5,13,1,11,5,19,0,0,72
18,5,13,1,11,9,14,7,0,78
18,5,13,1,14,0,0,0,0,51
18,5,13,1,14,1,7,5,0,64
18,5,13,1,14,4,0,0,0,55
18,5,13,1,14,4,5,4,0,64
18,5,13,1,14,4,9,14,7,85
18,5,13,1,14,4,19,0,0,74
18,5,13,1,14,5,14,3,5,78
18,5,13,1,14,5,14,3,25,98
18,5,13,1,14,5,14,20,0,90
18,5,13,1,14,5,20,0,0,76
18,5,13,1,14,9,5,0,0,65
18,5,13,1,14,14,5,4,0,74
18,5,13,1,14,14,9,14,7,95
18,5,13,1,14,19,0,0,0,70
18,5,13,1,14,20,12,5,0,88
18,5,13,1,14,21,18,5,0,95
18,5,13,1,16,0,0,0,0,53
18,5,13,1,16,16,5,4,0,78
18,5,13,1,16,16,9,14,7,99
18,5,13,1,16,19,0,0,0,72
18,5,13,1,18,3,8,0,0,66
18,5,13,1,18,7,9,14,0,85
18,5,13,1,18,11,0,0,0,66
18,5,13,1,18,11,5,4,0,75
18,5,13,1,18,11,5,18,0,89
18,5,13,1,18,11,5,18,19,108
18,5,13,1,18,11,5,20,0,91
18,5,13,1,18,11,9,14,7,96
18,5,13,1,18,11,19,0,0,85
18,5,13,1,18,17,21,5,19,117
18,5,13,1,18,18,25,0,0,98
18,5,13,1,18,18,9,5,4,91
18,5,13,1,18,18,9,5,19,106
18,5,13,1,18,19,8,1,12,95
18,5,13,1,19,11,0,0,0,67
18,5,13,1,19,19,0,0,0,75
18,5,13,1,19,20,0,0,0,76
18,5,13,1,19,20,5,18,0,99
18,5,13,1,19,20,5,18,25,124
18,5,13,1,20,3,8,0,0,68
18,5,13,1,20,3,8,5,4,77
18,5,13,1,20,3,8,5,19,92
18,5,13,1,20,5,0,0,0,62
18,5,13,1,20,5,4,0,0,66
18,5,13,1,20,5,19,0,0,81
18,5,13,1,20,9,14,7,0,87
18,5,13,2,12,1,9,0,0,60
18,5,13,2,12,5,0,0,0,55
18,5,13,2,12,5,18,5,0,78
18,5,13,5,1,14,20,0,0,76
18,5,13,5,1,19,21,18,5,105
18,5,13,5,4,5,0,0,0,50
18,5,13,5,4,25,0,0,0,70
18,5,13,5,4,9,1,12,0,67
18,5,13,5,4,9,1,20,5,80
18,5,13,5,4,9,5,4,0,63
18,5,13,5,4,9,5,19,0,78
18,5,13,5,4,25,9,14,7,100
18,5,13,5,4,9,21,13,0,88
18,5,13,5,5,20,0,0,0,66
18,5,13,5,5,20,9,14,7,96
18,5,13,5,5,20,19,0,0,85
18,5,13,5,12,20,0,0,0,73
18,5,13,5,12,20,5,4,0,82
18,5,13,5,12,20,9,14,7,103
18,5,13,5,12,20,19,0,0,92
18,5,13,5,13,2,5,18,0,79
18,5,13,5,13,2,5,18,19,98
18,5,13,5,14,0,0,0,0,55
18,5,13,5,14,1,3,5,0,64
18,5,13,5,14,1,14,20,0,90
18,5,13,5,14,4,0,0,0,59
18,5,13,5,14,4,5,4,0,68
18,5,13,5,14,4,9,14,7,89
18,5,13,5,14,4,19,0,0,78
18,5,13,5,14,5,0,0,0,60
18,5,13,5,14,20,9,15,14,113
18,5,13,5,18,3,25,0,0,87
18,5,13,5,18,7,5,0,0,71
18,5,13,5,18,7,5,4,0,75
18,5,13,5,18,7,5,19,0,90
18,5,13,5,18,7,9,14,7,96
18,5,13,5,20,0,0,0,0,61
18,5,13,5,20,1,12,0,0,74
18,5,13,5,24,0,0,0,0,65
18,5,13,9,3,1,0,0,0,49
18,5,13,9,3,1,20,5,0,74
18,5,13,9,3,12,5,0,0,65
18,5,13,9,6,15,18,13,0,97
18,5,13,9,7,1,20,5,0,78
18,5,13,9,7,5,19,0,0,76
18,5,13,9,7,9,1,12,0,74
18,5,13,9,7,18,1,14,20,105
18,5,13,9,7,18,1,20,5,96
18,5,13,9,12,12,0,0,0,69
18,5,13,9,13,9,3,0,0,70
18,5,13,9,14,4,0,0,0,63
18,5,13,9,14,4,1,12,0,76
18,5,13,9,14,4,5,4,0,72
18,5,13,9,14,4,5,18,0,86
18,5,13,9,14,4,5,18,19,105
18,5,13,9,14,4,6,21,12,102
18,5,13,9,14,4,9,14,7,93
18,5,13,9,14,4,19,0,0,82
18,5,13,9,14,7,12,5,0,83
18,5,13,9,14,7,12,5,4,87
18,5,13,9,14,9,19,3,5,95
18,5,13,9,14,20,0,0,0,79
18,5,13,9,14,20,5,4,0,88
18,5,13,9,14,20,9,14,7,109
18,5,13,9,14,20,19,0,0,98
18,5,13,9,16,5,4,0,0,70
18,5,13,9,18,18,15,18,0,114
18,5,13,9,19,5,0,0,0,69
18,5,13,9,19,5,4,0,0,73
18,5,13,9,19,5,19,0,0,88
18,5,13,9,19,9,14,7,0,94
18,5,13,9,19,19,0,0,0,83
18,5,13,9,19,19,6,21,12,122
18,5,13,9,19,19,9,15,14,121
18,5,13,9,19,19,9,22,5,119
18,5,13,9,19,19,12,25,0,120
18,5,13,9,19,19,15,18,25,141
18,5,13,9,20,0,0,0,0,65
18,5,13,9,20,1,12,0,0,78
18,5,13,9,20,13,5,14,20,117
18,5,13,9,20,19,0,0,0,84
18,5,13,9,20,20,1,12,0,98
18,5,13,9,20,20,1,12,19,117
18,5,13,9,20,20,5,4,0,94
18,5,13,9,20,20,5,5,0,95
18,5,13,9,20,20,5,14,20,124
18,5,13,9,20,20,5,18,0,108
18,5,13,9,20,20,5,18,19,127
18,5,13,9,20,20,9,14,7,115
18,5,13,9,20,20,15,18,0,118
18,5,13,9,20,20,15,18,19,137
18,5,13,9,24,0,0,0,0,69
18,5,13,9,24,5,4,0,0,78
18,5,13,9,24,5,19,0,0,93
18,5,13,9,24,9,14,7,0,99
18,5,13,9,24,20,0,0,0,89
18,5,13,9,24,20,21,18,5,133
18,5,13,14,1,14,20,0,0,85
18,5,13,14,1,14,20,1,12,98
18,5,13,14,1,14,20,19,0,104
18,5,13,15,3,11,0,0,0,65
18,5,13,15,4,5,12,0,0,72
18,5,13,15,4,5,12,5,4,81
18,5,13,15,4,5,12,5,18,95
18,5,13,15,4,5,12,19,0,91
18,5,13,15,4,9,6,25,0,95
18,5,13,15,9,19,20,5,14,118
18,5,13,15,12,1,4,5,0,73
18,5,13,15,12,1,4,5,19,92
18,5,13,15,12,4,0,0,0,67
18,5,13,15,12,4,5,4,0,76
18,5,13,15,12,4,9,14,7,97
18,5,13,15,12,4,19,0,0,86
18,5,13,15,12,12,9,6,25,115
18,5,13,15,14,20,1,4,15,105
18,5,13,15,14,20,1,14,20,120
18,5,13,15,14,20,15,9,18,127
18,5,13,15,16,0,0,0,0,67
18,5,13,15,18,1,0,0,0,70
18,5,13,15,18,1,19,0,0,89
18,5,13,15,18,1,20,5,0,95
18,5,13,15,18,4,0,0,0,73
18,5,13,15,18,5,0,0,0,74
18,5,13,15,18,9,4,0,0,82
18,5,13,15,18,19,5,0,0,93
18,5,13,15,18,19,5,19,0,112
18,5,13,15,20,5,0,0,0,76
18,5,13,15,20,5,4,0,0,80
18,5,13,15,20,5,12,25,0,113
18,5,13,15,20,5,18,0,0,94
18,5,13,15,20,5,19,0,0,95
18,5,13,15,20,5,19,20,0,115
18,5,13,15,20,9,15,14,0,109
18,5,13,15,20,9,15,14,19,128
18,5,13,15,20,9,22,5,0,107
18,5,13,15,21,12,1,4,5,94
18,5,13,15,21,12,4,0,0,88
18,5,13,15,21,14,20,0,0,106
18,5,13,15,21,14,20,5,4,115
18,5,13,15,21,14,20,19,0,125
18,5,13,15,22,1,2,12,5,93
18,5,13,15,22,1,2,12,25,113
18,5,13,15,22,1,12,0,0,86
18,5,13,15,22,1,12,19,0,105
18,5,13,15,22,5,0,0,0,78
18,5,13,15,22,5,4,0,0,82
18,5,13,15,22,5,4,12,25,119
18,5,13,15,22,5,18,0,0,96
18,5,13,15,22,5,18,19,0,115
18,5,13,15,22,5,19,0,0,97
18,5,13,15,22,9,14,7,0,103
18,5,13,19,0,0,0,0,0,55
18,5,13,21,1,2,12,5,0,77
18,5,13,21,4,1,0,0,0,62
18,5,13,21,4,1,19,0,0,81
18,5,13,21,5,0,0,0,0,62
18,5,13,21,18,13,21,18,0,127
18,5,13,21,19,20,5,18,0,119
18,5,14,1,2,12,5,0,0,57
18,5,14,1,2,12,25,0,0,77
18,5,14,1,25,0,0,0,0,63
18,5,14,1,9,12,0,0,0,59
18,5,14,1,9,12,5,4,0,68
18,5,14,1,9,12,19,0,0,78
18,5,14,1,12,0,0,0,0,50
18,5,14,1,13,5,0,0,0,56
18,5,14,1,13,5,4,0,0,60
18,5,14,1,13,5,19,0,0,75
18,5,14,1,13,9,14,7,0,81
18,5,14,1,19,3,5,14,20,99
18,5,14,1,20,21,18,5,0,102
18,5,14,1,20,21,18,5,4,106
18,5,14,1,20,21,18,5,19,121
18,5,14,3,15,14,20,18,5,112
18,5,14,3,21,12,21,19,0,113
18,5,14,4,0,0,0,0,0,41
18,5,14,4,5,4,0,0,0,50
18,5,14,4,5,13,5,14,20,98
18,5,14,4,5,18,0,0,0,64
18,5,14,4,5,18,5,4,0,73
18,5,14,4,5,18,5,18,0,87
18,5,14,4,5,18,5,18,19,106
18,5,14,4,5,18,9,14,7,94
18,5,14,4,5,18,19,0,0,83
18,5,14,4,5,18,19,5,20,108
18,5,14,4,9,2,12,5,0,69
18,5,14,4,9,14,7,0,0,71
18,5,14,4,9,20,9,15,14,108
18,5,14,4,15,21,14,0,0,91
18,5,14,4,18,15,3,11,0,88
18,5,14,4,19,0,0,0,0,60
18,5,14,4,21,0,0,0,0,62
18,5,14,4,26,9,14,1,0,91
18,5,14,4,26,9,14,1,19,110
18,5,14,5,1,7,21,5,0,76
18,5,14,5,7,0,0,0,0,49
18,5,14,5,7,1,4,5,0,59
18,5,14,5,7,1,4,5,4,63
18,5,14,5,7,1,4,5,19,78
18,5,14,5,7,1,4,15,0,69
18,5,14,5,7,1,4,15,19,88
18,5,14,5,7,1,20,5,0,75
18,5,14,5,7,1,20,5,4,79
18,5,14,5,7,5,0,0,0,54
18,5,14,5,7,5,4,0,0,58
18,5,14,5,7,5,18,0,0,72
18,5,14,5,7,5,18,19,0,91
18,5,14,5,7,5,19,0,0,73
18,5,14,5,7,9,14,7,0,79
18,5,14,5,7,12,5,3,20,89
18,5,14,5,7,21,5,0,0,75
18,5,14,5,18,22,5,0,0,87
18,5,14,5,19,0,0,0,0,61
18,5,14,5,19,20,0,0,0,81
18,5,14,5,19,20,5,4,0,90
18,5,14,5,19,20,19,0,0,100
18,5,14,5,20,0,0,0,0,62
18,5,14,5,20,20,5,0,0,87
18,5,14,5,23,0,0,0,0,65
18,5,14,5,23,1,2,12,5,85
18,5,14,5,23,1,2,12,25,105
18,5,14,5,23,1,12,0,0,78
18,5,14,5,23,1,12,19,0,97
18,5,14,5,23,5,4,0,0,74
18,5,14,5,23,5,4,12,25,111
18,5,14,5,23,5,18,0,0,88
18,5,14,5,23,5,18,19,0,107
18,5,14,5,23,9,14,7,0,95
18,5,14,5,23,13,5,14,20,117
18,5,14,5,23,19,0,0,0,84
18,5,14,6,15,18,3,5,0,84
18,5,14,7,1,0,0,0,0,45
18,5,14,7,21,5,0,0,0,70
18,5,14,7,21,5,18,1,0,89
18,5,14,9,3,11,5,12,0,77
18,5,14,9,3,21,12,21,19,122
18,5,14,9,4,9,6,25,0,90
18,5,14,9,6,15,18,13,0,98
18,5,14,9,7,0,0,0,0,53
18,5,14,9,7,7,5,4,0,69
18,5,14,9,7,7,9,14,7,90
18,5,14,9,7,19,0,0,0,72
18,5,14,9,14,0,0,0,0,60
18,5,14,9,14,19,0,0,0,79
18,5,14,9,19,8,0,0,0,73
18,5,14,9,19,8,12,25,0,110
18,5,14,9,20,5,14,3,5,93
18,5,14,9,20,5,14,3,25,113
18,5,14,9,20,5,14,20,0,105
18,5,14,11,0,0,0,0,0,48
18,5,14,11,25,0,0,0,0,73
18,5,14,13,9,14,2,9,0,84
18,5,14,14,0,0,0,0,0,51
18,5,14,14,1,19,5,0,0,76
18,5,14,14,1,19,5,19,0,95
18,5,14,14,5,0,0,0,0,56
18,5,14,14,5,20,0,0,0,76
18,5,14,14,5,20,9,14,7,106
18,5,14,14,5,20,19,0,0,95
18,5,14,14,9,14,0,0,0,74
18,5,14,14,9,14,19,0,0,93
18,5,14,14,9,15,7,5,14,101
18,5,14,15,7,18,1,13,0,91
18,5,14,15,7,18,1,13,19,110
18,5,14,15,13,5,5,0,0,75
18,5,14,15,13,13,5,0,0,83
18,5,14,15,13,13,5,5,0,88
18,5,14,15,14,5,0,0,0,71
18,5,14,15,20,9,3,5,0,89
18,5,14,15,20,9,3,5,4,93
18,5,14,15,20,9,6,25,0,112
18,5,14,15,21,14,3,5,0,95
18,5,14,15,21,14,3,5,4,99
18,5,14,15,21,14,3,5,18,113
18,5,14,15,21,14,3,5,19,114
18,5,14,15,21,18,9,19,8,127
18,5,14,15,22,1,18,5,0,98
18,5,14,15,22,1,20,5,0,100
18,5,14,15,22,1,20,5,4,104
18,5,14,15,22,1,20,5,18,118
18,5,14,15,22,1,20,5,19,119
18,5,14,15,22,1,20,15,18,128
18,5,14,15,22,5,0,0,0,79
18,5,14,15,22,5,12,0,0,91
18,5,14,15,22,9,26,5,0,114
18,5,14,15,23,14,0,0,0,89
18,5,14,15,23,14,5,4,0,98
18,5,14,15,23,14,5,18,0,112
18,5,14,15,23,14,6,21,12,128
18,5,14,15,23,14,9,14,7,119
18,5,14,15,23,14,19,0,0,108
18,5,14,20,0,0,0,0,0,57
18,5,14,20,1,2,12,5,0,77
18,5,14,20,1,7,5,0,0,70
18,5,14,20,1,12,0,0,0,70
18,5,14,20,1,12,5,18,0,93
18,5,14,20,1,12,12,5,18,105
18,5,14,20,1,12,19,0,0,89
18,5,14,20,5,0,0,0,0,62
18,5,14,20,5,4,0,0,0,66
18,5,14,20,5,5,0,0,0,67
18,5,14,20,5,18,0,0,0,80
18,5,14,20,5,18,19,0,0,99
18,5,14,20,5,19,0,0,0,81
18,5,14,20,9,5,18,0,0,89
18,5,14,20,9,5,18,19,0,108
18,5,14,20,9,14,7,0,0,87
18,5,14,20,12,5,19,19,0,112
18,5,14,20,18,1,14,20,0,110
18,5,14,20,18,5,5,0,0,85
18,5,14,20,19,0,0,0,0,76
18,5,14,21,0,0,0,0,0,58
18,5,14,21,12,5,0,0,0,75
18,5,14,21,12,12,9,6,25,122
18,5,14,21,13,2,5,18,0,96
18,5,14,21,13,2,5,18,19,115
18,5,14,22,5,18,19,5,0,106
18,5,14,22,15,9,0,0,0,83
18,5,14,22,15,25,0,0,0,99
18,5,14,22,15,9,19,0,0,102
18,5,15,2,10,5,3,20,0,78
18,5,15,2,10,5,3,20,19,97
18,5,15,2,12,9,7,5,0,73
18,5,15,2,12,9,7,5,4,77
18,5,15,2,19,3,21,18,5,106
18,5,15,2,19,5,18,22,5,109
18,5,15,2,20,1,9,14,0,84
18,5,15,2,20,1,9,14,19,103
18,5,15,3,3,21,16,25,0,106
18,5,15,3,3,21,18,0,0,83
18,5,15,3,3,21,18,19,0,102
18,5,15,6,6,5,14,4,0,73
18,5,15,6,6,5,14,19,5,93
18,5,15,6,6,5,18,0,0,73
18,5,15,6,6,5,18,5,4,82
18,5,15,6,6,5,18,19,0,92
18,5,15,6,6,19,5,20,0,94
18,5,15,9,12,0,0,0,0,59
18,5,15,9,12,5,4,0,0,68
18,5,15,9,12,9,14,7,0,89
18,5,15,9,12,19,0,0,0,78
18,5,15,13,5,20,5,18,0,99
18,5,15,13,9,20,0,0,0,80
18,5,15,16,5,14,0,0,0,73
18,5,15,16,5,14,5,4,0,82
18,5,15,16,5,14,5,18,0,96
18,5,15,16,5,14,9,14,7,103
18,5,15,16,5,14,19,0,0,92
18,5,15,16,5,18,1,20,5,103
18,5,15,16,8,15,18,5,0,100
18,5,15,16,16,15,19,5,0,109
18,5,15,16,16,15,19,5,4,113
18,5,15,16,16,15,19,5,19,128
18,5,15,16,16,18,5,19,19,131
18,5,15,18,4,1,9,14,0,84
18,5,15,18,4,1,9,14,19,103
18,5,15,18,4,5,18,0,0,83
18,5,15,18,4,5,18,5,4,92
18,5,15,18,4,5,18,19,0,102
18,5,15,18,9,5,14,20,0,104
18,5,15,18,9,5,14,20,19,123
18,5,15,21,20,6,9,20,0,114
18,5,15,21,20,12,9,14,5,119
18,5,15,21,20,16,21,20,0,136
18,5,15,21,20,18,1,7,5,110
18,5,15,22,9,18,21,19,0,127
18,5,15,23,14,0,0,0,0,75
18,5,15,24,9,4,9,19,5,108
18,5,15,24,9,4,9,26,5,115
18,5,16,1,3,5,0,0,0,48
18,5,16,1,3,9,6,25,0,83
18,5,16,1,3,11,0,0,0,54
18,5,16,1,3,11,1,7,5,67
18,5,16,1,3,11,5,4,0,63
18,5,16,1,3,11,5,18,0,77
18,5,16,1,3,11,9,14,7,84
18,5,16,1,3,11,19,0,0,73
18,5,16,1,4,0,0,0,0,44
18,5,16,1,4,4,5,4,0,57
18,5,16,1,4,4,9,14,7,78
18,5,16,1,7,5,0,0,0,52
18,5,16,1,25,0,0,0,0,65
18,5,16,1,25,1,2,12,5,85
18,5,16,1,25,1,12,0,0,78
18,5,16,1,9,4,0,0,0,53
18,5,16,1,25,5,4,0,0,74
18,5,16,1,25,9,14,7,0,95
18,5,16,1,25,13,5,14,20,117
18,5,16,1,9,14,20,0,0,83
18,5,16,1,9,14,20,5,4,92
18,5,16,1,9,14,20,19,0,102
18,5,16,1,9,18,0,0,0,67
18,5,16,1,9,18,5,4,0,76
18,5,16,1,9,18,5,18,0,90
18,5,16,1,9,18,5,18,19,109
18,5,16,1,9,18,9,14,7,97
18,5,16,1,9,18,13,1,14,95
18,5,16,1,9,18,13,5,14,99
18,5,16,1,9,18,19,0,0,86
18,5,16,1,25,19,0,0,0,84
18,5,16,1,12,5,0,0,0,57
18,5,16,1,14,4,0,0,0,58
18,5,16,1,14,4,12,25,0,95
18,5,16,1,14,4,15,21,19,113
18,5,16,1,14,5,12,0,0,71
18,5,16,1,14,5,12,5,4,80
18,5,16,1,14,5,12,19,0,90
18,5,16,1,16,5,18,0,0,79
18,5,16,1,16,5,18,5,4,88
18,5,16,1,16,5,18,19,0,98
18,5,16,1,18,1,2,12,5,78
18,5,16,1,18,1,2,12,25,98
18,5,16,1,18,1,20,5,0,84
18,5,16,1,18,5,12,0,0,75
18,5,16,1,18,11,0,0,0,69
18,5,16,1,18,11,5,4,0,78
18,5,16,1,18,11,19,0,0,88
18,5,16,1,18,20,0,0,0,78
18,5,16,1,18,20,1,11,5,95
18,5,16,1,18,20,5,5,0,88
18,5,16,1,18,20,5,5,19,107
18,5,16,1,19,0,0,0,0,59
18,5,16,1,19,19,0,0,0,78
18,5,16,1,19,19,1,7,5,91
18,5,16,1,19,19,1,14,20,113
18,5,16,1,19,19,5,4,0,87
18,5,16,1,19,19,5,18,0,101
18,5,16,1,19,19,5,19,0,102
18,5,16,1,19,19,9,14,7,108
18,5,16,1,19,20,0,0,0,79
18,5,16,1,19,20,5,0,0,84
18,5,16,1,19,20,5,4,0,88
18,5,16,1,19,20,9,14,7,109
18,5,16,1,19,20,19,0,0,98
18,5,16,1,19,20,21,18,5,123
18,5,16,1,20,3,8,0,0,71
18,5,16,1,20,5,14,3,25,107
18,5,16,1,20,5,14,20,0,99
18,5,16,1,20,18,15,12,0,105
18,5,16,1,20,20,5,18,14,117
18,5,16,1,22,5,0,0,0,67
18,5,16,1,22,5,4,0,0,71
18,5,16,1,22,5,19,0,0,86
18,5,16,1,22,9,14,7,0,92
18,5,16,1,23,14,0,0,0,77
18,5,16,5,1,12,5,4,0,66
18,5,16,5,1,12,5,18,0,80
18,5,16,5,1,12,5,18,19,99
18,5,16,5,1,12,9,14,7,87
18,5,16,5,1,12,9,19,20,105
18,5,16,5,1,12,19,0,0,76
18,5,16,5,1,20,0,0,0,65
18,5,16,5,1,20,1,12,0,78
18,5,16,5,1,20,5,4,0,74
18,5,16,5,1,20,5,18,0,88
18,5,16,5,1,20,5,18,19,107
18,5,16,5,1,20,9,14,7,95
18,5,16,5,1,20,19,0,0,84
18,5,16,5,3,8,1,7,5,68
18,5,16,5,4,4,12,5,0,69
18,5,16,5,4,4,12,5,4,73
18,5,16,5,7,0,0,0,0,51
18,5,16,5,7,7,5,4,0,67
18,5,16,5,7,19,0,0,0,70
18,5,16,5,12,0,0,0,0,56
18,5,16,5,12,12,1,14,20,103
18,5,16,5,12,12,5,4,0,77
18,5,16,5,12,12,5,14,20,107
18,5,16,5,12,12,5,18,0,91
18,5,16,5,12,12,5,18,19,110
18,5,16,5,12,12,9,14,7,98
18,5,16,5,12,19,0,0,0,75
18,5,16,5,14,0,0,0,0,58
18,5,16,5,14,14,5,4,0,81
18,5,16,5,14,14,9,14,7,102
18,5,16,5,14,19,9,15,14,115
18,5,16,5,14,20,0,0,0,78
18,5,16,5,14,20,1,14,20,113
18,5,16,5,14,20,5,4,0,87
18,5,16,5,14,20,5,18,0,101
18,5,16,5,14,20,5,18,19,120
18,5,16,5,14,20,9,14,7,108
18,5,16,5,14,20,19,0,0,97
18,5,16,5,15,16,12,5,0,92
18,5,16,5,15,16,12,5,4,96
18,5,16,5,15,16,12,5,19,111
18,5,16,5,18,3,5,16,20,106
18,5,16,5,18,3,21,19,19,124
18,5,16,5,18,6,15,18,13,114
18,5,16,5,18,6,21,13,5,107
18,5,16,5,18,9,2,12,5,90
18,5,16,5,18,11,0,0,0,73
18,5,16,5,18,11,5,4,0,82
18,5,16,5,18,11,9,14,7,103
18,5,16,5,18,11,19,0,0,92
18,5,16,5,18,13,9,20,0,104
18,5,16,5,18,16,12,5,24,119
18,5,16,5,18,20,15,18,25,140
18,5,16,5,18,21,19,1,12,115
18,5,16,5,18,21,19,5,0,107
18,5,16,5,18,21,19,5,4,111
18,5,16,5,20,5,14,4,0,87
18,5,16,5,20,5,14,4,19,106
18,5,16,5,20,9,20,1,5,99
18,5,16,5,20,15,9,18,5,111
18,5,16,5,23,0,0,0,0,67
18,5,16,8,1,19,5,0,0,72
18,5,16,8,15,14,1,20,5,102
18,5,16,8,18,1,19,5,0,90
18,5,16,8,18,1,19,5,4,94
18,5,16,8,18,1,19,5,19,109
18,5,16,9,3,0,0,0,0,51
18,5,16,9,3,11,0,0,0,62
18,5,16,9,3,20,21,18,5,115
18,5,16,9,5,3,5,0,0,61
18,5,16,9,12,5,0,0,0,65
18,5,16,9,14,0,0,0,0,62
18,5,16,9,14,5,0,0,0,67
18,5,16,9,14,5,4,0,0,71
18,5,16,9,14,5,6,21,12,106
18,5,16,9,14,5,18,0,0,85
18,5,16,9,14,5,18,19,0,104
18,5,16,9,14,5,19,0,0,86
18,5,16,9,14,9,14,7,0,92
18,5,16,9,14,14,5,4,0,85
18,5,16,9,14,14,9,14,7,106
18,5,16,9,14,19,0,0,0,81
18,5,16,9,16,5,0,0,0,69
18,5,16,9,17,21,5,0,0,91
18,5,16,9,17,21,5,4,0,95
18,5,16,9,17,21,9,14,7,116
18,5,16,9,20,3,8,0,0,79
18,5,16,11,9,5,0,0,0,64
18,5,16,12,0,0,0,0,0,51
18,5,16,12,1,3,5,0,0,60
18,5,16,12,1,3,5,4,0,64
18,5,16,12,1,3,5,18,0,78
18,5,16,12,1,3,5,18,19,97
18,5,16,12,1,3,5,19,0,79
18,5,16,12,1,3,9,14,7,85
18,5,16,12,1,25,0,0,0,77
18,5,16,12,1,25,5,4,0,86
18,5,16,12,1,25,9,14,7,107
18,5,16,12,1,25,19,0,0,96
18,5,16,12,1,9,20,0,0,81
18,5,16,12,1,14,0,0,0,66
18,5,16,12,1,14,5,0,0,71
18,5,16,12,1,14,5,4,0,75
18,5,16,12,1,14,9,14,7,96
18,5,16,12,1,14,14,5,4,89
18,5,16,12,1,14,19,0,0,85
18,5,16,12,1,14,20,0,0,86
18,5,16,12,1,14,20,5,4,95
18,5,16,12,1,14,20,5,18,109
18,5,16,12,1,14,20,19,0,105
18,5,16,12,1,19,20,5,18,114
18,5,16,12,1,20,5,0,0,77
18,5,16,12,1,20,5,4,0,81
18,5,16,12,1,20,5,19,0,96
18,5,16,12,1,20,9,14,7,102
18,5,16,12,5,1,4,0,0,61
18,5,16,12,5,1,4,5,18,84
18,5,16,12,5,1,4,19,0,80
18,5,16,12,5,1,20,0,0,77
18,5,16,12,5,4,0,0,0,60
18,5,16,12,5,4,7,5,0,72
18,5,16,12,5,4,7,5,4,76
18,5,16,12,5,4,7,5,18,90
18,5,16,12,5,4,7,5,19,91
18,5,16,12,5,14,9,19,8,106
18,5,16,12,5,20,5,0,0,81
18,5,16,12,5,20,5,12,25,118
18,5,16,12,5,20,9,15,14,114
18,5,16,12,5,20,9,22,5,112
18,5,16,12,5,20,15,18,25,134
18,5,16,12,5,22,5,0,0,83
18,5,16,12,5,22,25,0,0,103
18,5,16,12,5,22,9,5,4,96
18,5,16,12,5,22,9,5,19,111
18,5,16,12,5,22,9,14,0,101
18,5,16,12,5,22,9,14,19,120
18,5,16,12,25,0,0,0,0,76
18,5,16,12,9,1,12,0,0,73
18,5,16,12,9,1,14,20,0,95
18,5,16,12,9,3,1,0,0,64
18,5,16,12,9,3,1,14,20,98
18,5,16,12,9,3,1,19,0,83
18,5,16,12,9,3,1,20,5,89
18,5,16,12,9,3,15,14,0,92
18,5,16,12,9,5,4,0,0,69
18,5,16,12,9,5,18,0,0,83
18,5,16,12,9,5,18,19,0,102
18,5,16,12,9,5,19,0,0,84
18,5,16,12,9,7,8,20,0,95
18,5,16,12,25,9,14,7,0,106
18,5,16,12,9,17,21,5,0,103
18,5,16,12,15,4,0,0,0,70
18,5,16,12,15,20,0,0,0,86
18,5,16,12,15,20,19,0,0,105
18,5,16,12,15,20,20,5,4,115
18,5,16,12,15,20,20,5,18,129
18,5,16,12,15,21,7,8,0,102
18,5,16,12,15,23,0,0,0,89
18,5,16,12,15,23,5,4,0,98
18,5,16,12,15,23,9,14,7,119
18,5,16,12,21,13,0,0,0,85
18,5,16,12,21,13,2,0,0,87
18,5,16,12,21,13,2,19,0,106
18,5,16,12,21,13,5,0,0,90
18,5,16,12,21,13,5,4,0,94
18,5,16,12,21,13,9,14,7,115
18,5,16,12,21,14,4,5,18,113
18,5,16,12,21,14,7,5,0,98
18,5,16,12,21,14,7,5,4,102
18,5,16,12,21,14,7,5,19,117
18,5,16,15,0,0,0,0,0,54
18,5,16,15,3,11,5,20,0,93
18,5,16,15,9,14,20,0,0,97
18,5,16,15,12,9,19,8,0,102
18,5,16,15,12,12,0,0,0,78
18,5,16,15,12,12,5,4,0,87
18,5,16,15,12,12,19,0,0,97
18,5,16,15,12,12,21,20,5,124
18,5,16,15,12,15,14,0,0,95
18,5,16,15,14,4,5,18,0,95
18,5,16,15,14,4,5,26,0,103
18,5,16,15,14,5,0,0,0,73
18,5,16,15,16,5,0,0,0,75
18,5,16,15,18,20,0,0,0,92
18,5,16,15,18,20,1,7,5,105
18,5,16,15,18,20,5,4,0,101
18,5,16,15,18,20,5,18,0,115
18,5,16,15,18,20,5,18,19,134
18,5,16,15,18,20,9,14,7,122
18,5,16,15,18,20,9,15,14,130
18,5,16,15,18,20,19,0,0,111
18,5,16,15,19,0,0,0,0,73
18,5,16,15,19,1,12,0,0,86
18,5,16,15,19,1,12,19,0,105
18,5,16,15,19,5,0,0,0,78
18,5,16,15,19,5,4,0,0,82
18,5,16,15,19,5,4,12,25,119
18,5,16,15,19,5,6,21,12,117
18,5,16,15,19,5,18,0,0,96
18,5,16,15,19,5,18,19,0,115
18,5,16,15,19,5,19,0,0,97
18,5,16,15,19,9,14,7,0,103
18,5,16,15,19,9,20,0,0,102
18,5,16,15,19,9,20,5,4,111
18,5,16,15,19,9,20,15,18,135
18,5,16,15,19,9,20,19,0,121
18,5,16,15,19,15,9,18,0,115
18,5,16,15,19,19,5,19,19,135
18,5,16,15,19,20,0,0,0,93
18,5,16,15,19,21,18,5,0,117
18,5,16,15,20,0,0,0,0,74
18,5,16,15,20,19,0,0,0,93
18,5,16,15,20,20,5,4,0,103
18,5,16,15,21,14,4,0,0,93
18,5,16,15,21,18,0,0,0,93
18,5,16,15,21,18,5,4,0,102
18,5,16,15,21,18,9,14,7,123
18,5,16,15,21,18,19,0,0,112
18,5,16,15,21,19,19,0,0,113
18,5,16,15,21,19,19,5,0,118
18,5,16,15,21,19,19,5,19,137
18,5,16,15,23,4,5,18,0,104
18,5,16,15,23,5,18,0,0,100
18,5,16,15,23,5,18,5,4,109
18,5,16,15,23,5,18,19,0,119
18,5,16,16,0,0,0,0,0,55
18,5,16,16,5,4,0,0,0,64
18,5,16,16,19,0,0,0,0,74
18,5,16,18,0,0,0,0,0,57
18,5,16,18,1,25,0,0,0,83
18,5,16,18,1,9,19,5,0,91
18,5,16,18,1,9,19,5,4,95
18,5,16,18,5,1,3,8,0,74
18,5,16,18,5,4,9,3,20,98
18,5,16,18,5,6,5,18,0,91
18,5,16,18,5,8,5,14,4,93
18,5,16,18,5,13,9,19,5,108
18,5,16,18,5,16,1,18,5,102
18,5,16,18,5,19,5,14,20,120
18,5,16,18,5,19,9,4,5,99
18,5,16,18,5,19,19,0,0,100
18,5,16,18,5,19,19,5,4,109
18,5,16,18,5,19,19,5,18,123
18,5,16,18,5,19,19,5,19,124
18,5,16,18,5,19,19,15,18,133
18,5,16,18,25,0,0,0,0,82
18,5,16,18,9,3,5,0,0,74
18,5,16,18,9,3,5,4,0,78
18,5,16,18,9,3,5,19,0,93
18,5,16,18,9,3,9,14,7,99
18,5,16,18,9,5,22,1,12,106
18,5,16,18,9,5,22,5,0,98
18,5,16,18,9,5,22,5,4,102
18,5,16,18,9,5,22,5,18,116
18,5,16,18,9,5,22,5,19,117
18,5,16,18,9,13,1,14,4,98
18,5,16,18,9,13,5,0,0,84
18,5,16,18,9,13,5,4,0,88
18,5,16,18,9,13,5,18,0,102
18,5,16,18,9,13,9,14,7,109
18,5,16,18,9,14,20,0,0,100
18,5,16,18,9,14,20,5,4,109
18,5,16,18,9,14,20,5,18,123
18,5,16,18,9,14,20,19,0,119
18,5,16,18,9,19,1,12,0,98
18,5,16,18,9,19,1,12,19,117
18,5,16,18,9,19,5,0,0,90
18,5,16,18,9,19,5,4,0,94
18,5,16,18,9,19,5,19,0,109
18,5,16,18,9,19,9,14,7,115
18,5,16,18,15,0,0,0,0,72
18,5,16,18,15,1,3,8,0,84
18,5,16,18,15,2,1,3,25,103
18,5,16,18,15,2,1,20,5,100
18,5,16,18,15,2,5,0,0,79
18,5,16,18,15,2,5,4,0,83
18,5,16,18,15,2,5,19,0,98
18,5,16,18,15,2,9,14,7,104
18,5,16,18,15,3,5,5,4,89
18,5,16,18,15,3,5,19,19,118
18,5,16,18,15,3,21,18,5,119
18,5,16,18,15,4,21,3,5,105
18,5,16,18,15,6,1,14,5,98
18,5,16,18,15,6,5,19,19,121
18,5,16,18,15,6,6,5,18,107
18,5,16,18,15,7,18,1,13,111
18,5,16,18,15,10,5,3,20,110
18,5,16,18,15,13,9,19,5,118
18,5,16,18,15,15,6,0,0,93
18,5,16,18,15,15,6,19,0,112
18,5,16,18,15,16,15,19,5,127
18,5,16,18,15,19,0,0,0,91
18,5,16,18,15,19,16,5,18,130
18,5,16,18,15,20,5,3,20,120
18,5,16,18,15,20,5,19,20,136
18,5,16,18,15,22,1,12,0,107
18,5,16,18,15,22,1,12,19,126
18,5,16,18,15,22,5,0,0,99
18,5,16,18,15,22,5,4,0,103
18,5,16,18,15,22,5,18,0,117
18,5,16,18,15,22,5,18,19,136
18,5,16,18,15,22,5,19,0,118
18,5,16,18,15,22,9,4,5,112
18,5,16,18,15,22,9,14,7,124
18,5,16,18,15,22,15,11,5,125
18,5,16,18,21,14,5,0,0,97
18,5,16,18,21,14,5,4,0,101
18,5,16,18,21,14,9,14,7,122
18,5,16,19,0,0,0,0,0,58
18,5,16,20,0,0,0,0,0,59
18,5,16,20,1,14,20,0,0,94
18,5,16,20,1,20,9,15,14,118
18,5,16,20,1,20,15,18,25,138
18,5,16,20,9,12,5,0,0,85
18,5,16,20,9,12,5,19,0,104
18,5,16,20,9,12,9,1,14,104
18,5,16,20,9,12,9,19,13,121
18,5,16,20,9,12,9,20,25,134
18,5,16,20,9,12,15,9,4,108
18,5,16,21,2,12,9,3,0,86
18,5,16,21,2,12,9,3,1,87
18,5,16,21,2,12,9,3,19,105
18,5,16,21,2,12,9,19,8,110
18,5,16,21,4,4,12,5,0,85
18,5,16,21,4,9,1,20,5,99
18,5,16,21,6,6,0,0,0,72
18,5,16,21,7,14,0,0,0,81
18,5,16,21,7,14,1,14,20,116
18,5,16,21,7,14,1,20,5,107
18,5,16,21,7,14,5,4,0,90
18,5,16,21,7,14,5,18,0,104
18,5,16,21,7,14,9,14,7,111
18,5,16,21,7,14,19,0,0,100
18,5,16,21,12,16,9,20,0,117
18,5,16,21,12,19,5,0,0,96
18,5,16,21,12,19,5,4,0,100
18,5,16,21,12,19,5,18,0,114
18,5,16,21,12,19,5,18,19,133
18,5,16,21,12,19,5,19,0,115
18,5,16,21,12,19,9,14,7,121
18,5,16,21,12,19,9,15,14,129
18,5,16,21,12,19,9,22,5,127
18,5,16,21,12,19,15,18,0,124
18,5,16,21,12,19,15,18,25,149
18,5,16,21,13,16,0,0,0,89
18,5,16,21,13,16,5,4,0,98
18,5,16,21,13,16,19,0,0,108
18,5,16,21,14,3,8,0,0,85
18,5,16,21,14,9,19,8,0,110
18,5,16,21,18,5,0,0,0,83
18,5,16,21,18,7,5,0,0,90
18,5,16,21,18,9,6,25,0,118
18,5,16,21,18,16,12,5,0,111
18,5,16,21,18,16,15,19,5,133
18,5,16,21,18,19,21,5,0,123
18,5,16,21,18,19,21,5,4,127
18,5,16,21,18,19,21,5,19,142
18,5,16,21,18,19,21,9,20,147
18,5,16,21,20,1,2,12,5,100
18,5,16,21,20,1,2,12,25,120
18,5,16,21,20,5,0,0,0,85
18,5,16,21,20,5,4,0,0,89
18,5,16,21,20,5,4,12,25,126
18,5,16,21,20,5,19,0,0,104
18,5,16,21,20,9,14,7,0,110
18,5,17,0,0,0,0,0,0,40
18,5,17,4,0,0,0,0,0,44
18,5,17,21,1,12,9,6,25,114
18,5,17,21,5,5,14,0,0,85
18,5,17,21,5,14,3,8,0,91
18,5,17,21,5,19,20,0,0,105
18,5,17,21,5,19,20,5,4,114
18,5,17,21,5,19,20,5,18,128
18,5,17,21,5,19,20,15,18,138
18,5,17,21,5,19,20,19,0,124
18,5,17,21,5,21,5,4,0,96
18,5,17,21,9,3,11,5,14,103
18,5,17,21,9,5,13,19,0,107
18,5,17,21,9,14,0,0,0,84
18,5,17,21,9,14,19,0,0,103
18,5,17,21,9,18,5,0,0,93
18,5,17,21,9,18,5,4,0,97
18,5,17,21,9,18,5,18,0,111
18,5,17,21,9,18,5,18,19,130
18,5,17,21,9,18,5,19,0,112
18,5,17,21,9,18,9,14,7,118
18,5,17,21,9,19,9,20,5,123
18,5,17,21,9,20,0,0,0,90
18,5,17,21,9,20,1,12,0,103
18,5,17,21,9,20,1,12,19,122
18,5,17,21,9,20,5,0,0,95
18,5,17,21,9,20,5,4,0,99
18,5,17,21,9,20,5,18,0,113
18,5,17,21,9,20,5,18,19,132
18,5,17,21,9,20,5,19,0,114
18,5,17,21,9,20,9,14,7,120
18,5,17,21,9,26,0,0,0,96
18,5,17,21,15,20,5,0,0,101
18,5,17,21,15,20,5,4,0,105
18,5,17,21,15,20,9,14,7,126
18,5,18,1,3,11,0,0,0,56
18,5,18,1,3,11,5,4,0,65
18,5,18,1,3,11,5,18,0,79
18,5,18,1,3,11,19,0,0,75
18,5,18,1,4,9,1,20,5,81
18,5,18,1,9,12,0,0,0,63
18,5,18,1,9,12,5,18,0,86
18,5,18,1,9,19,5,0,0,75
18,5,18,1,9,19,5,4,0,79
18,5,18,1,9,19,5,19,0,94
18,5,18,1,11,5,0,0,0,58
18,5,18,1,14,0,0,0,0,56
18,5,18,1,14,11,0,0,0,67
18,5,18,1,20,5,0,0,0,67
18,5,18,1,20,5,4,0,0,71
18,5,18,1,20,9,14,7,0,92
18,5,18,5,1,4,0,0,0,51
18,5,18,5,1,4,5,18,0,74
18,5,18,5,1,4,9,14,7,81
18,5,18,5,1,4,19,0,0,70
18,5,18,5,2,18,1,3,5,75
18,5,18,5,3,15,18,4,0,86
18,5,18,5,3,15,18,4,19,105
18,5,18,5,4,15,19,0,0,84
18,5,18,5,4,15,19,5,19,108
18,5,18,5,5,0,0,0,0,51
18,5,18,5,5,12,0,0,0,63
18,5,18,5,5,22,5,0,0,78
18,5,18,5,6,9,5,6,0,72
18,5,18,5,9,7,14,0,0,76
18,5,18,5,12,5,1,19,5,88
18,5,18,5,13,9,3,5,0,76
18,5,18,5,13,9,14,4,0,86
18,5,18,5,13,13,9,3,5,89
18,5,18,5,13,15,21,19,5,119
18,5,18,5,14,20,0,0,0,80
18,5,18,5,14,20,1,12,0,93
18,5,18,5,16,5,1,20,0,88
18,5,18,5,22,9,5,23,0,105
18,5,18,5,23,1,18,4,0,92
18,5,18,5,23,1,18,4,19,111
18,5,18,9,7,0,0,0,0,57
18,5,18,9,14,7,0,0,0,71
18,5,18,9,19,5,0,0,0,74
18,5,18,9,19,5,14,0,0,88
18,5,18,9,19,5,19,0,0,93
18,5,18,9,19,9,14,7,0,99
18,5,18,9,22,1,12,0,0,85
18,5,18,9,22,5,20,0,0,97
18,5,18,15,2,0,0,0,0,58
18,5,18,15,2,5,0,0,0,63
18,5,18,15,12,12,0,0,0,80
18,5,18,15,12,12,5,4,0,89
18,5,18,15,12,12,5,18,0,103
18,5,18,15,12,12,5,18,19,122
18,5,18,15,12,12,9,14,7,110
18,5,18,15,12,12,19,0,0,99
18,5,18,15,15,6,0,0,0,77
18,5,18,15,15,6,5,4,0,86
18,5,18,15,15,6,19,0,0,96
18,5,18,15,15,20,0,0,0,91
18,5,18,15,16,5,0,0,0,77
18,5,18,15,19,5,0,0,0,80
18,5,18,15,21,20,5,0,0,102
18,5,18,15,21,20,5,4,0,106
18,5,18,15,21,20,5,19,0,121
18,5,18,15,21,20,9,14,7,127
18,5,18,15,23,0,0,0,0,79
18,5,18,21,2,0,0,0,0,64
18,5,18,21,13,13,1,7,5,101
18,5,18,21,14,0,0,0,0,76
18,5,18,21,14,14,9,14,7,120
18,5,18,21,14,19,0,0,0,95
18,5,19,0,0,0,0,0,0,42
18,5,19,1,3,11,0,0,0,57
18,5,19,1,4,4,12,5,0,68
18,5,19,1,4,4,12,5,4,72
18,5,19,1,4,4,12,5,19,87
18,5,19,1,25,0,0,0,0,68
18,5,19,1,9,4,0,0,0,56
18,5,19,1,25,9,14,7,0,98
18,5,19,1,9,12,0,0,0,64
18,5,19,1,9,12,5,4,0,73
18,5,19,1,9,12,9,14,7,94
18,5,19,1,9,12,19,0,0,83
18,5,19,1,25,19,0,0,0,87
18,5,19,1,12,1,2,12,5,75
18,5,19,1,12,5,0,0,0,60
18,5,19,1,12,5,19,0,0,79
18,5,19,1,12,7,1,18,0,81
18,5,19,1,12,20,0,0,0,75
18,5,19,1,12,21,20,5,0,101
18,5,19,1,12,21,20,5,4,105
18,5,19,1,12,21,20,5,19,120
18,5,19,1,12,22,1,7,5,90
18,5,19,1,13,16,12,5,0,89
18,5,19,1,13,16,12,5,4,93
18,5,19,1,13,16,12,5,19,108
18,5,19,1,20,0,0,0,0,63
18,5,19,1,20,9,19,6,25,122
18,5,19,1,22,5,0,0,0,70
18,5,19,1,23,0,0,0,0,66
18,5,19,1,23,5,4,0,0,75
18,5,19,1,23,5,18,0,0,89
18,5,19,1,23,25,5,18,0,114
18,5,19,1,23,9,14,7,0,96
18,5,19,1,23,14,0,0,0,80
18,5,19,1,23,19,0,0,0,85
18,5,19,1,26,21,18,9,14,131
18,5,19,3,1,12,5,0,0,63
18,5,19,3,1,12,5,4,0,67
18,5,19,3,1,12,5,19,0,82
18,5,19,3,1,12,9,14,7,88
18,5,19,3,1,14,0,0,0,60
18,5,19,3,8,15,15,12,0,95
18,5,19,3,9,14,4,0,0,72
18,5,19,3,9,14,4,5,4,81
18,5,19,3,9,14,4,5,18,95
18,5,19,3,9,14,4,19,0,91
18,5,19,3,15,18,5,0,0,83
18,5,19,3,15,18,5,4,0,87
18,5,19,3,15,18,5,19,0,102
18,5,19,3,15,18,9,14,7,108
18,5,19,3,15,21,19,0,0,100
18,5,19,3,18,1,20,3,8,95
18,5,19,3,18,5,5,14,0,87
18,5,19,3,18,5,5,14,19,106
18,5,19,3,18,9,2,5,0,79
18,5,19,3,18,9,16,20,0,108
18,5,19,3,18,9,16,20,19,127
18,5,19,3,18,21,2,0,0,86
18,5,19,3,21,1,2,12,5,86
18,5,19,3,21,5,0,0,0,71
18,5,19,3,21,5,4,0,0,75
18,5,19,3,21,5,18,0,0,89
18,5,19,3,21,5,18,19,0,108
18,5,19,3,21,5,19,0,0,90
18,5,19,3,21,9,14,7,0,96
18,5,19,3,21,12,16,20,0,114
18,5,19,3,21,19,19,5,18,127
18,5,19,5,1,12,0,0,0,60
18,5,19,5,1,12,5,4,0,69
18,5,19,5,1,12,9,14,7,90
18,5,19,5,1,12,19,0,0,79
18,5,19,5,1,13,0,0,0,61
18,5,19,5,1,18,3,8,0,77
18,5,19,5,1,19,15,14,0,96
18,5,19,5,1,20,0,0,0,68
18,5,19,5,1,20,5,4,0,77
18,5,19,5,1,20,9,14,7,98
18,5,19,5,1,20,19,0,0,87
18,5,19,5,1,21,0,0,0,69
18,5,19,5,1,21,19,0,0,88
18,5,19,5,1,21,24,0,0,93
18,5,19,5,3,1,20,5,0,76
18,5,19,5,3,18,5,20,5,98
18,5,19,5,3,20,0,0,0,70
18,5,19,5,3,20,5,4,0,79
18,5,19,5,3,20,9,14,7,100
18,5,19,5,3,20,9,15,14,108
18,5,19,5,3,20,19,0,0,89
18,5,19,5,3,21,18,5,0,94
18,5,19,5,3,21,18,5,4,98
18,5,19,5,4,1,19,0,0,71
18,5,19,5,5,4,0,0,0,56
18,5,19,5,5,4,5,4,0,65
18,5,19,5,5,4,9,14,7,86
18,5,19,5,5,4,19,0,0,75
18,5,19,5,5,9,14,7,0,82
18,5,19,5,5,11,0,0,0,63
18,5,19,5,5,11,9,14,7,93
18,5,19,5,5,11,19,0,0,82
18,5,19,5,5,14,0,0,0,66
18,5,19,5,5,19,0,0,0,71
18,5,19,5,7,13,5,14,20,106
18,5,19,5,9,19,5,0,0,80
18,5,19,5,9,19,5,18,0,98
18,5,19,5,9,26,5,0,0,87
18,5,19,5,9,26,5,4,0,91
18,5,19,5,9,26,5,18,0,105
18,5,19,5,9,26,5,19,0,106
18,5,19,5,9,26,9,14,7,112
18,5,19,5,9,26,21,18,5,126
18,5,19,5,12,5,3,20,0,87
18,5,19,5,12,5,3,20,19,106
18,5,19,5,12,6,0,0,0,65
18,5,19,5,12,12,0,0,0,71
18,5,19,5,12,12,5,18,0,94
18,5,19,5,12,12,5,18,19,113
18,5,19,5,12,12,9,14,7,101
18,5,19,5,12,12,19,0,0,90
18,5,19,5,13,2,12,5,0,79
18,5,19,5,13,2,12,5,4,83
18,5,19,5,13,2,12,5,18,97
18,5,19,5,13,2,12,5,19,98
18,5,19,5,14,4,0,0,0,65
18,5,19,5,14,4,9,14,7,95
18,5,19,5,14,4,19,0,0,84
18,5,19,5,14,5,0,0,0,66
18,5,19,5,14,20,0,0,0,81
18,5,19,5,14,20,5,4,0,90
18,5,19,5,14,20,5,18,0,104
18,5,19,5,14,20,6,21,12,120
18,5,19,5,14,20,9,14,7,111
18,5,19,5,14,20,9,22,5,117
18,5,19,5,14,20,19,0,0,100
18,5,19,5,17,21,5,14,20,124
18,5,19,5,18,1,20,5,0,91
18,5,19,5,18,5,14,5,0,89
18,5,19,5,18,16,9,14,5,109
18,5,19,5,18,22,1,12,0,100
18,5,19,5,18,22,5,0,0,92
18,5,19,5,18,22,5,4,0,96
18,5,19,5,18,22,5,5,0,97
18,5,19,5,18,22,5,18,0,110
18,5,19,5,18,22,5,18,25,135
18,5,19,5,18,22,5,18,19,129
18,5,19,5,18,22,5,19,0,111
18,5,19,5,18,22,9,3,5,104
18,5,19,5,18,22,9,14,7,117
18,5,19,5,18,22,9,19,20,135
18,5,19,5,18,22,15,9,18,129
18,5,19,5,18,22,15,18,0,120
18,5,19,5,20,0,0,0,0,67
18,5,19,5,20,19,0,0,0,86
18,5,19,5,20,20,5,18,0,110
18,5,19,5,20,20,5,18,19,129
18,5,19,5,20,20,9,14,7,117
18,5,19,5,20,20,12,5,0,104
18,5,19,5,20,20,12,5,4,108
18,5,19,5,20,20,12,5,19,123
18,5,19,5,22,5,18,0,0,92
18,5,19,5,23,0,0,0,0,70
18,5,19,5,23,5,4,0,0,79
18,5,19,5,23,9,14,7,0,100
18,5,19,5,23,14,0,0,0,84
18,5,19,5,23,19,0,0,0,89
18,5,19,5,24,0,0,0,0,71
18,5,19,7,1,20,0,0,0,70
18,5,19,8,0,0,0,0,0,50
18,5,19,8,1,11,5,0,0,67
18,5,19,8,1,11,5,14,0,81
18,5,19,8,1,11,9,14,7,92
18,5,19,8,1,16,5,0,0,72
18,5,19,8,1,16,5,4,0,76
18,5,19,8,1,16,5,18,0,90
18,5,19,8,1,16,5,18,19,109
18,5,19,8,1,16,5,19,0,91
18,5,19,8,1,16,9,14,7,97
18,5,19,8,1,18,5,0,0,74
18,5,19,8,1,18,5,4,0,78
18,5,19,8,1,18,9,14,7,99
18,5,19,8,1,18,16,5,14,104
18,5,19,8,1,22,5,0,0,78
18,5,19,8,1,22,5,4,0,82
18,5,19,8,1,22,5,14,0,92
18,5,19,8,1,22,5,19,0,97
18,5,19,8,1,22,9,14,7,103
18,5,19,8,5,1,18,0,0,74
18,5,19,8,5,1,18,5,18,97
18,5,19,8,5,1,20,8,5,89
18,5,19,8,5,12,22,5,0,94
18,5,19,8,5,19,0,0,0,74
18,5,19,8,5,23,0,0,0,78
18,5,19,8,9,6,20,0,0,85
18,5,19,8,9,14,5,0,0,78
18,5,19,8,9,14,5,4,0,82
18,5,19,8,9,14,5,19,0,97
18,5,19,8,9,14,7,12,5,97
18,5,19,8,9,14,9,14,7,103
18,5,19,8,9,16,0,0,0,75
18,5,19,8,9,16,16,5,4,100
18,5,19,8,9,16,16,5,18,114
18,5,19,8,9,16,19,0,0,94
18,5,19,8,15,4,0,0,0,69
18,5,19,8,15,5,0,0,0,70
18,5,19,8,15,5,9,14,7,100
18,5,19,8,15,5,19,0,0,89
18,5,19,8,15,14,5,0,0,84
18,5,19,8,15,15,11,0,0,91
18,5,19,8,15,15,20,0,0,100
18,5,19,8,15,15,20,19,0,119
18,5,19,8,15,18,20,5,14,122
18,5,19,8,15,20,0,0,0,85
18,5,19,8,15,22,5,12,0,104
18,5,19,8,15,23,0,0,0,88
18,5,19,8,15,23,5,4,0,97
18,5,19,8,15,23,5,18,0,111
18,5,19,8,15,23,9,14,7,118
18,5,19,8,15,23,14,0,0,102
18,5,19,8,15,23,19,0,0,107
18,5,19,8,18,9,14,5,0,96
18,5,19,8,21,6,6,12,5,100
18,5,19,8,21,14,0,0,0,85
18,5,19,8,21,14,20,0,0,105
18,5,19,8,21,20,0,0,0,91
18,5,19,8,21,20,20,12,5,128
18,5,19,9,1,14,3,5,0,74
18,5,19,9,1,14,3,25,0,94
18,5,19,9,1,14,20,0,0,86
18,5,19,9,3,3,1,20,5,83
18,5,19,9,3,11,5,14,0,84
18,5,19,9,4,0,0,0,0,55
18,5,19,9,4,5,0,0,0,60
18,5,19,9,4,5,4,0,0,64
18,5,19,9,4,5,14,3,5,82
18,5,19,9,4,5,14,3,25,102
18,5,19,9,4,5,14,20,0,94
18,5,19,9,4,5,14,20,19,113
18,5,19,9,4,5,18,0,0,78
18,5,19,9,4,5,18,19,0,97
18,5,19,9,4,5,19,0,0,79
18,5,19,9,4,9,14,7,0,85
18,5,19,9,4,9,21,21,13,119
18,5,19,9,4,19,0,0,0,74
18,5,19,9,4,21,1,0,0,77
18,5,19,9,4,21,1,12,0,89
18,5,19,9,4,21,1,12,19,108
18,5,19,9,4,21,1,18,25,120
18,5,19,9,4,21,5,0,0,81
18,5,19,9,4,21,5,14,20,115
18,5,19,9,4,21,5,19,0,100
18,5,19,9,4,21,15,21,19,131
18,5,19,9,4,21,21,1,0,98
18,5,19,9,4,21,21,13,0,110
18,5,19,9,4,21,21,13,19,129
18,5,19,9,6,20,0,0,0,77
18,5,19,9,6,20,5,4,0,86
18,5,19,9,6,20,9,14,7,107
18,5,19,9,6,20,19,0,0,96
18,5,19,9,7,8,0,0,0,66
18,5,19,9,7,8,20,0,0,86
18,5,19,9,7,8,20,19,0,105
18,5,19,9,7,14,0,0,0,72
18,5,19,9,7,14,1,12,0,85
18,5,19,9,7,14,5,4,0,81
18,5,19,9,7,14,5,5,0,82
18,5,19,9,7,14,5,18,0,95
18,5,19,9,7,14,5,18,19,114
18,5,19,9,7,14,6,21,12,111
18,5,19,9,7,14,9,14,7,102
18,5,19,9,7,14,19,0,0,91
18,5,19,9,12,5,0,0,0,68
18,5,19,9,12,5,4,0,0,72
18,5,19,9,12,5,19,0,0,87
18,5,19,9,12,9,1,0,0,73
18,5,19,9,12,9,1,12,0,85
18,5,19,9,12,9,1,20,5,98
18,5,19,9,12,9,5,14,20,111
18,5,19,9,12,9,6,5,18,101
18,5,19,9,12,9,14,7,0,93
18,5,19,9,12,9,21,13,0,106
18,5,19,9,12,22,5,18,0,108
18,5,19,9,12,22,5,18,19,127
18,5,19,9,13,13,5,18,0,100
18,5,19,9,14,0,0,0,0,65
18,5,19,9,14,1,0,0,0,66
18,5,19,9,14,1,20,5,0,91
18,5,19,9,14,1,20,5,4,95
18,5,19,9,14,1,20,5,19,110
18,5,19,9,14,2,21,19,8,115
18,5,19,9,14,5,4,0,0,74
18,5,19,9,14,5,18,0,0,88
18,5,19,9,14,7,0,0,0,72
18,5,19,9,14,25,0,0,0,90
18,5,19,9,14,9,3,0,0,77
18,5,19,9,14,9,6,25,0,105
18,5,19,9,14,9,14,7,0,95
18,5,19,9,14,9,26,5,0,105
18,5,19,9,14,11,0,0,0,76
18,5,19,9,14,12,9,11,5,102
18,5,19,9,14,15,9,4,0,93
18,5,19,9,14,15,9,4,19,112
18,5,19,9,14,15,12,0,0,92
18,5,19,9,14,15,12,9,3,104
18,5,19,9,14,15,19,9,19,127
18,5,19,9,14,15,21,19,0,120
18,5,19,9,14,19,0,0,0,84
18,5,19,9,19,20,0,0,0,90
18,5,19,9,19,20,1,14,20,125
18,5,19,9,19,20,1,20,5,116
18,5,19,9,19,20,5,4,0,99
18,5,19,9,19,20,5,14,20,129
18,5,19,9,19,20,5,18,0,113
18,5,19,9,19,20,5,18,19,132
18,5,19,9,19,20,6,21,12,129
18,5,19,9,19,20,9,14,7,120
18,5,19,9,19,20,9,22,5,126
18,5,19,9,19,20,15,18,0,123
18,5,19,9,19,20,15,18,19,142
18,5,19,9,19,20,19,0,0,109
18,5,19,9,20,0,0,0,0,71
18,5,19,9,20,5,0,0,0,76
18,5,19,9,20,5,4,0,0,80
18,5,19,9,20,5,19,0,0,95
18,5,19,9,20,9,14,7,0,101
18,5,19,9,20,20,9,14,7,121
18,5,19,9,20,21,1,20,5,118
18,5,19,9,26,5,0,0,0,82
18,5,19,9,26,5,4,0,0,86
18,5,19,9,26,5,18,0,0,100
18,5,19,9,26,5,19,0,0,101
18,5,19,9,26,9,14,7,0,107
18,5,19,11,5,20,3,8,0,89
18,5,19,11,5,23,0,0,0,81
18,5,19,11,9,14,0,0,0,76
18,5,19,12,1,25,0,0,0,80
18,5,19,12,1,14,4,5,18,96
18,5,19,12,1,19,8,0,0,82
18,5,19,12,1,20,5,0,0,80
18,5,19,12,1,20,5,4,0,84
18,5,19,12,1,20,5,19,0,99
18,5,19,12,9,4,5,0,0,72
18,5,19,12,15,20,0,0,0,89
18,5,19,13,5,12,12,0,0,84
18,5,19,13,5,12,20,0,0,92
18,5,19,13,5,12,20,5,4,101
18,5,19,13,5,12,20,19,0,111
18,5,19,13,9,12,5,0,0,81
18,5,19,13,15,15,20,8,0,113
18,5,19,13,15,15,20,8,19,132
18,5,19,14,1,16,0,0,0,73
18,5,19,14,1,20,3,8,0,88
18,5,19,14,1,20,18,15,14,124
18,5,19,14,21,2,0,0,0,79
18,5,19,15,1,11,0,0,0,69
18,5,19,15,1,11,5,4,0,78
18,5,19,15,1,11,19,0,0,88
18,5,19,15,1,16,0,0,0,74
18,5,19,15,4,0,0,0,0,61
18,5,19,15,4,4,5,4,0,74
18,5,19,15,4,19,0,0,0,80
18,5,19,15,6,20,5,14,0,102
18,5,19,15,9,12,0,0,0,78
18,5,19,15,10,5,20,0,0,92
18,5,19,15,10,5,20,19,0,111
18,5,19,15,10,15,21,18,14,135
18,5,19,15,12,4,0,0,0,73
18,5,19,15,12,4,5,18,0,96
18,5,19,15,12,4,5,18,19,115
18,5,19,15,12,5,0,0,0,74
18,5,19,15,12,5,4,0,0,78
18,5,19,15,12,5,19,0,0,93
18,5,19,15,12,9,3,9,20,110
18,5,19,15,12,9,14,7,0,99
18,5,19,15,12,21,2,12,5,109
18,5,19,15,12,21,20,5,0,115
18,5,19,15,12,21,20,5,18,133
18,5,19,15,12,21,20,5,19,134
18,5,19,15,12,22,5,0,0,96
18,5,19,15,12,22,5,4,0,100
18,5,19,15,12,22,5,14,4,114
18,5,19,15,12,22,5,14,20,130
18,5,19,15,12,22,5,18,0,114
18,5,19,15,12,22,5,18,19,133
18,5,19,15,12,22,5,19,0,115
18,5,19,15,12,22,9,14,7,121
18,5,19,15,14,1,14,3,5,94
18,5,19,15,14,1,14,3,25,114
18,5,19,15,14,1,14,20,0,106
18,5,19,15,14,1,14,20,19,125
18,5,19,15,14,1,20,5,0,97
18,5,19,15,14,1,20,5,4,101
18,5,19,15,14,1,20,5,19,116
18,5,19,15,14,1,20,15,18,125
18,5,19,15,15,20,8,5,0,105
18,5,19,15,18,2,0,0,0,77
18,5,19,15,18,2,5,4,0,86
18,5,19,15,18,2,5,14,20,116
18,5,19,15,18,2,9,14,7,107
18,5,19,15,18,2,19,0,0,96
18,5,19,15,18,3,9,14,0,101
18,5,19,15,18,3,9,14,5,106
18,5,19,15,18,3,9,14,19,120
18,5,19,15,18,20,0,0,0,95
18,5,19,15,18,20,5,4,0,104
18,5,19,15,18,20,5,18,0,118
18,5,19,15,18,20,5,18,19,137
18,5,19,15,18,20,9,14,7,125
18,5,19,15,18,20,19,0,0,114
18,5,19,15,18,21,6,9,14,125
18,5,19,15,21,7,8,20,0,113
18,5,19,15,21,14,4,0,0,96
18,5,19,15,21,14,4,5,4,105
18,5,19,15,21,14,4,5,18,119
18,5,19,15,21,14,4,19,0,115
18,5,19,15,21,18,3,5,0,104
18,5,19,15,21,18,3,5,19,123
18,5,19,15,21,20,9,22,5,134
18,5,19,15,23,0,0,0,0,80
18,5,19,15,23,5,4,0,0,89
18,5,19,15,23,9,14,7,0,110
18,5,19,15,23,14,0,0,0,94
18,5,19,15,23,19,0,0,0,99
18,5,19,16,0,0,0,0,0,58
18,5,19,16,1,3,5,0,0,67
18,5,19,16,1,3,5,4,0,71
18,5,19,16,1,3,5,19,0,86
18,5,19,16,1,3,9,14,7,92
18,5,19,16,1,4,5,0,0,68
18,5,19,16,1,4,5,4,0,72
18,5,19,16,1,4,5,19,0,87
18,5,19,16,1,4,9,14,7,93
18,5,19,16,1,14,0,0,0,73
18,5,19,16,1,14,7,12,5,97
18,5,19,16,1,18,11,12,5,105
18,5,19,16,1,19,19,5,0,102
18,5,19,16,5,1,11,0,0,75
18,5,19,16,5,1,11,19,0,94
18,5,19,16,5,3,9,6,25,106
18,5,19,16,5,3,20,0,0,86
18,5,19,16,5,3,20,5,4,95
18,5,19,16,5,3,20,5,18,109
18,5,19,16,5,3,20,19,0,105
18,5,19,16,5,3,20,21,13,120
18,5,19,16,5,12,12,0,0,87
18,5,19,16,5,12,12,5,4,96
18,5,19,16,5,12,12,19,0,106
18,5,19,16,5,12,20,0,0,95
18,5,19,16,9,3,5,0,0,75
18,5,19,16,9,3,5,4,0,79
18,5,19,16,9,3,9,14,7,100
18,5,19,16,9,14,0,0,0,81
18,5,19,16,9,18,5,0,0,90
18,5,19,16,9,18,5,4,0,94
18,5,19,16,9,18,5,19,0,109
18,5,19,16,9,18,9,14,7,115
18,5,19,16,9,18,9,20,0,114
18,5,19,16,9,20,5,0,0,92
18,5,19,16,9,20,5,4,0,96
18,5,19,16,9,20,5,19,0,111
18,5,19,16,9,20,9,14,7,117
18,5,19,16,12,5,14,4,0,93
18,5,19,16,12,9,3,5,0,87
18,5,19,16,12,9,3,5,4,91
18,5,19,16,12,9,20,0,0,99
18,5,19,16,12,9,20,19,0,118
18,5,19,16,15,11,5,0,0,89
18,5,19,16,15,11,5,14,0,103
18,5,19,16,15,14,4,0,0,91
18,5,19,16,15,14,4,5,0,96
18,5,19,16,15,14,4,5,4,100
18,5,19,16,15,14,4,5,18,114
18,5,19,16,15,14,4,19,0,110
18,5,19,16,15,14,19,1,12,119
18,5,19,16,15,14,19,5,0,111
18,5,19,16,15,14,19,5,18,129
18,5,19,16,15,14,19,5,19,130
18,5,19,16,15,14,19,15,18,139
18,5,19,16,15,14,19,21,13,140
18,5,19,16,15,20,0,0,0,93
18,5,19,16,15,20,19,0,0,112
18,5,19,16,18,1,25,0,0,102
18,5,19,16,18,1,25,19,0,121
18,5,19,16,18,1,14,7,0,98
18,5,19,16,18,5,1,4,0,86
18,5,19,16,18,5,1,4,19,105
18,5,19,16,18,9,14,7,0,106
18,5,19,16,18,9,14,7,19,125
18,5,19,16,18,15,21,20,0,132
18,5,19,16,18,21,14,7,0,118
18,5,19,16,21,5,0,0,0,84
18,5,19,17,21,1,18,5,0,104
18,5,19,17,21,5,1,11,0,97
18,5,19,19,1,9,4,1,18,94
18,5,19,19,1,12,1,0,0,75
18,5,19,19,1,12,1,8,0,83
18,5,19,19,1,12,4,1,18,97
18,5,19,19,1,21,20,0,0,103
18,5,19,19,8,15,20,0,0,104
18,5,19,19,15,18,20,0,0,114
18,5,19,20,0,0,0,0,0,62
18,5,19,20,1,2,0,0,0,65
18,5,19,20,1,2,2,5,4,76
18,5,19,20,1,2,12,5,0,82
18,5,19,20,1,2,12,5,4,86
18,5,19,20,1,3,11,0,0,77
18,5,19,20,1,3,11,5,4,86
18,5,19,20,1,3,11,19,0,96
18,5,19,20,1,6,6,0,0,75
18,5,19,20,1,6,6,5,4,84
18,5,19,20,1,6,6,19,0,94
18,5,19,20,1,7,5,0,0,75
18,5,19,20,1,7,5,4,0,79
18,5,19,20,1,7,5,19,0,94
18,5,19,20,1,7,9,14,7,100
18,5,19,20,1,9,14,0,0,86
18,5,19,20,1,11,5,0,0,79
18,5,19,20,1,13,16,0,0,92
18,5,19,20,1,13,16,5,4,101
18,5,19,20,1,13,16,19,0,111
18,5,19,20,1,14,20,0,0,97
18,5,19,20,1,18,20,0,0,101
18,5,19,20,1,18,20,5,4,110
18,5,19,20,1,18,20,19,0,120
18,5,19,20,1,20,5,0,0,88
18,5,19,20,1,20,5,4,0,92
18,5,19,20,1,20,5,19,0,107
18,5,19,20,1,20,9,14,7,113
18,5,19,20,1,20,9,15,14,121
18,5,19,20,1,21,18,0,0,102
18,5,19,20,2,1,12,11,0,88
18,5,19,20,5,1,12,0,0,80
18,5,19,20,5,4,0,0,0,71
18,5,19,20,5,5,12,0,0,84
18,5,19,20,5,5,16,0,0,88
18,5,19,20,5,13,0,0,0,80
18,5,19,20,5,16,0,0,0,83
18,5,19,20,5,18,0,0,0,85
18,5,19,20,5,18,19,0,0,104
18,5,19,20,5,19,0,0,0,86
18,5,19,20,6,21,12,0,0,101
18,5,19,20,6,21,12,12,25,138
18,5,19,20,8,15,21,19,5,130
18,5,19,20,25,0,0,0,0,87
18,5,19,20,9,1,4,0,0,76
18,5,19,20,9,6,6,0,0,83
18,5,19,20,9,6,6,5,14,102
18,5,19,20,9,6,12,5,0,94
18,5,19,20,9,6,15,18,13,123
18,5,19,20,25,12,5,0,0,104
18,5,19,20,25,12,5,4,0,108
18,5,19,20,25,12,5,19,0,123
18,5,19,20,25,12,9,14,7,129
18,5,19,20,9,14,5,19,19,128
18,5,19,20,9,14,7,0,0,92
18,5,19,20,9,14,7,12,25,129
18,5,19,20,9,18,0,0,0,89
18,5,19,20,9,18,18,5,4,116
18,5,19,20,9,19,0,0,0,90
18,5,19,20,9,20,3,8,0,102
18,5,19,20,9,20,21,5,0,117
18,5,19,20,9,20,21,20,5,137
18,5,19,20,9,22,5,0,0,98
18,5,19,20,9,22,5,12,25,135
18,5,19,20,12,5,19,19,0,117
18,5,19,20,15,3,11,0,0,91
18,5,19,20,15,3,11,5,4,100
18,5,19,20,15,3,11,19,0,110
18,5,19,20,15,16,16,5,18,132
18,5,19,20,15,18,1,12,0,108
18,5,19,20,15,18,1,12,19,127
18,5,19,20,15,18,5,0,0,100
18,5,19,20,15,18,5,4,0,104
18,5,19,20,15,18,5,18,0,118
18,5,19,20,15,18,5,18,19,137
18,5,19,20,15,18,5,19,0,119
18,5,19,20,15,18,9,14,7,125
18,5,19,20,15,23,0,0,0,100
18,5,19,20,15,23,1,12,0,113
18,5,19,20,16,18,15,15,6,132
18,5,19,20,18,0,0,0,0,80
18,5,19,20,18,1,9,14,0,104
18,5,19,20,18,1,9,14,19,123
18,5,19,20,18,1,9,14,20,124
18,5,19,20,18,1,16,0,0,97
18,5,19,20,18,5,1,13,0,99
18,5,19,20,18,5,19,19,0,123
18,5,19,20,18,5,20,3,8,116
18,5,19,20,18,9,3,20,0,112
18,5,19,20,18,9,3,20,19,131
18,5,19,20,18,9,11,5,0,105
18,5,19,20,18,9,11,5,19,124
18,5,19,20,18,9,14,7,0,110
18,5,19,20,18,9,14,7,5,115
18,5,19,20,18,9,14,7,19,129
18,5,19,20,18,9,16,0,0,105
18,5,19,20,18,9,22,5,0,116
18,5,19,20,18,9,22,5,14,130
18,5,19,20,18,9,22,5,19,135
18,5,19,20,18,15,11,5,0,111
18,5,19,20,18,15,15,13,0,123
18,5,19,20,18,15,22,5,0,122
18,5,19,20,18,21,3,11,0,115
18,5,19,20,18,21,14,7,0,122
18,5,19,20,19,0,0,0,0,81
18,5,19,20,21,4,25,0,0,112
18,5,19,20,21,4,9,5,4,105
18,5,19,20,21,4,9,5,19,120
18,5,19,20,21,6,6,0,0,95
18,5,19,20,21,6,6,5,4,104
18,5,19,20,21,6,6,19,0,114
18,5,19,20,21,14,7,0,0,104
18,5,19,20,23,1,18,4,0,108
18,5,19,20,23,1,18,4,19,127
18,5,19,21,2,10,5,3,20,103
18,5,19,21,2,12,9,13,5,104
18,5,19,21,2,13,9,20,0,107
18,5,19,21,2,13,9,20,19,126
18,5,19,21,3,3,5,5,4,83
18,5,19,21,3,11,0,0,0,77
18,5,19,21,5,0,0,0,0,68
18,5,19,21,6,6,5,18,0,98
18,5,19,21,7,7,5,19,20,121
18,5,19,21,9,14,7,0,0,93
18,5,19,21,9,20,0,0,0,92
18,5,19,21,12,20,0,0,0,95
18,5,19,21,12,20,1,14,20,130
18,5,19,21,12,20,5,4,0,104
18,5,19,21,12,20,6,21,12,134
18,5,19,21,12,20,9,14,7,125
18,5,19,21,12,20,9,22,5,131
18,5,19,21,12,20,19,0,0,114
18,5,19,21,13,1,2,12,5,96
18,5,19,21,13,5,0,0,0,81
18,5,19,21,13,5,4,0,0,85
18,5,19,21,13,5,9,14,7,111
18,5,19,21,13,5,18,0,0,99
18,5,19,21,13,5,18,19,0,118
18,5,19,21,13,5,19,0,0,100
18,5,19,21,13,9,14,7,0,106
18,5,19,21,13,13,15,14,0,118
18,5,19,21,13,13,15,14,19,137
18,5,19,21,14,0,0,0,0,77
18,5,19,21,16,0,0,0,0,79
18,5,19,21,16,9,14,5,0,107
18,5,19,21,16,16,12,25,0,132
18,5,19,21,16,16,15,18,20,148
18,5,19,21,16,16,15,19,5,134
18,5,19,21,18,6,1,3,5,96
18,5,19,21,18,7,1,13,0,102
18,5,19,21,18,7,5,0,0,93
18,5,19,21,18,7,5,4,0,97
18,5,19,21,18,7,5,14,20,127
18,5,19,21,18,7,5,19,0,112
18,5,19,21,18,7,9,14,7,118
18,5,19,21,18,18,5,3,20,127
18,5,19,21,18,22,5,25,0,133
18,5,19,21,18,22,5,25,19,152
18,5,19,21,19,16,5,3,20,126
18,5,19,21,19,16,5,14,4,121
18,5,19,23,1,7,5,0,0,78
18,5,19,23,1,12,12,15,23,128
18,5,19,23,1,18,4,0,0,88
18,5,19,23,1,18,13,0,0,97
18,5,19,23,5,1,18,0,0,89
18,5,19,23,5,1,20,0,0,91
18,5,19,23,5,5,16,0,0,91
18,5,19,23,5,5,20,5,14,114
18,5,19,23,5,12,12,0,0,94
18,5,19,23,5,16,20,0,0,106
18,5,19,23,9,12,12,0,0,98
18,5,19,23,9,13,0,0,0,87
18,5,19,23,15,18,5,0,0,103
18,5,20,0,0,0,0,0,0,43
18,5,20,1,2,12,5,0,0,63
18,5,20,1,2,12,5,19,0,82
18,5,20,1,2,12,15,0,0,73
18,5,20,1,3,11,0,0,0,58
18,5,20,1,3,11,5,4,0,67
18,5,20,1,3,11,12,5,0,75
18,5,20,1,3,11,19,0,0,77
18,5,20,1,7,0,0,0,0,51
18,5,20,1,7,7,5,4,0,67
18,5,20,1,7,19,0,0,0,70
18,5,20,1,9,12,0,0,0,65
18,5,20,1,9,12,5,4,0,74
18,5,20,1,9,12,5,18,0,88
18,5,20,1,9,12,5,18,19,107
18,5,20,1,9,12,9,14,7,95
18,5,20,1,9,12,15,18,0,98
18,5,20,1,9,12,15,18,19,117
18,5,20,1,9,12,19,0,0,84
18,5,20,1,9,14,0,0,0,67
18,5,20,1,9,14,1,12,0,80
18,5,20,1,9,14,4,5,18,94
18,5,20,1,9,14,5,4,0,76
18,5,20,1,9,14,5,18,0,90
18,5,20,1,9,14,5,18,19,109
18,5,20,1,9,14,9,14,7,97
18,5,20,1,9,14,19,0,0,86
18,5,20,1,11,5,0,0,0,60
18,5,20,1,11,5,14,0,0,74
18,5,20,1,11,5,18,0,0,78
18,5,20,1,11,5,18,19,0,97
18,5,20,1,11,5,19,0,0,79
18,5,20,1,11,9,14,7,0,85
18,5,20,1,12,0,0,0,0,56
18,5,20,1,12,9,1,20,5,91
18,5,20,1,12,11,0,0,0,67
18,5,20,1,12,12,25,0,0,93
18,5,20,1,12,12,9,5,19,101
18,5,20,1,13,1,0,0,0,58
18,5,20,1,13,5,0,0,0,62
18,5,20,1,14,0,0,0,0,58
18,5,20,1,14,14,5,4,0,81
18,5,20,1,14,14,5,18,0,95
18,5,20,1,14,14,9,14,7,102
18,5,20,1,16,5,0,0,0,65
18,5,20,1,16,5,4,0,0,69
18,5,20,1,16,5,19,0,0,84
18,5,20,1,16,9,14,7,0,90
18,5,20,1,18,0,0,0,0,62
18,5,20,1,18,4,0,0,0,66
18,5,20,1,18,4,1,14,20,101
18,5,20,1,18,4,1,20,5,92
18,5,20,1,18,4,5,4,0,75
18,5,20,1,18,4,5,5,0,76
18,5,20,1,18,4,5,14,20,105
18,5,20,1,18,4,5,18,0,89
18,5,20,1,18,4,5,18,19,108
18,5,20,1,18,4,9,14,7,96
18,5,20,1,18,4,9,22,5,102
18,5,20,1,18,4,19,0,0,85
18,5,20,1,18,4,21,18,5,110
18,5,20,1,18,5,0,0,0,67
18,5,20,1,18,7,5,20,0,94
18,5,20,1,18,9,6,6,0,83
18,5,20,1,18,18,5,4,0,89
18,5,20,1,18,18,9,14,7,110
18,5,20,1,19,20,5,0,0,88
18,5,20,1,19,20,5,4,0,92
18,5,20,1,19,20,5,19,0,107
18,5,20,1,19,20,9,14,7,113
18,5,20,1,20,9,15,14,0,102
18,5,20,1,20,20,12,5,0,101
18,5,20,1,21,7,8,20,0,100
18,5,20,1,24,0,0,0,0,68
18,5,20,1,24,5,4,0,0,77
18,5,20,1,24,5,19,0,0,92
18,5,20,1,24,9,14,7,0,98
18,5,20,3,8,0,0,0,0,54
18,5,20,3,8,5,4,0,0,63
18,5,20,3,8,5,19,0,0,78
18,5,20,3,8,9,14,7,0,84
18,5,20,3,8,12,5,19,19,109
18,5,20,4,0,0,0,0,0,47
18,5,20,5,0,0,0,0,0,48
18,5,20,5,1,3,8,0,0,60
18,5,20,5,1,3,8,5,19,84
18,5,20,5,1,13,0,0,0,62
18,5,20,5,1,13,5,4,0,71
18,5,20,5,1,13,19,0,0,81
18,5,20,5,1,18,0,0,0,67
18,5,20,5,1,18,9,14,7,97
18,5,20,5,1,18,19,0,0,86
18,5,20,5,3,9,15,21,19,115
18,5,20,5,12,12,0,0,0,72
18,5,20,5,12,12,9,14,7,102
18,5,20,5,12,12,19,0,0,91
18,5,20,5,13,0,0,0,0,61
18,5,20,5,13,16,5,18,0,100
18,5,20,5,13,16,20,0,0,97
18,5,20,5,13,19,0,0,0,80
18,5,20,5,14,1,14,20,0,97
18,5,20,5,14,4,5,18,0,89
18,5,20,5,14,5,0,0,0,67
18,5,20,5,14,5,19,0,0,86
18,5,20,5,14,20,0,0,0,82
18,5,20,5,14,20,9,15,14,120
18,5,20,5,14,20,9,22,5,118
18,5,20,5,14,20,15,18,0,115
18,5,20,5,14,21,5,0,0,88
18,5,20,5,16,15,18,5,0,102
18,5,20,5,19,20,0,0,0,87
18,5,20,5,19,20,5,4,0,96
18,5,20,5,19,20,9,6,25,127
18,5,20,5,19,20,9,14,7,117
18,5,20,5,19,20,19,0,0,106
18,5,20,5,24,20,21,18,5,136
18,5,20,8,1,14,11,0,0,77
18,5,20,8,1,20,3,8,0,83
18,5,20,8,1,23,0,0,0,75
18,5,20,8,5,0,0,0,0,56
18,5,20,8,5,14,5,19,19,113
18,5,20,8,5,18,0,0,0,74
18,5,20,8,9,3,11,5,14,93
18,5,20,8,9,14,11,0,0,85
18,5,20,8,9,14,11,5,18,108
18,5,20,8,9,14,11,19,0,104
18,5,20,8,15,21,7,8,20,122
18,5,20,8,18,1,19,8,0,97
18,5,20,8,18,5,1,4,0,79
18,5,20,8,18,5,1,4,19,98
18,5,20,8,18,5,19,8,0,101
18,5,20,8,18,9,12,12,0,102
18,5,20,8,18,9,22,5,0,105
18,5,20,8,18,15,14,5,0,103
18,5,20,8,18,15,23,0,0,107
18,5,20,8,18,21,19,20,0,129
18,5,20,8,21,14,4,5,18,113
18,5,20,9,1,0,0,0,0,53
18,5,20,9,1,12,0,0,0,65
18,5,20,9,1,18,25,0,0,96
18,5,20,9,1,18,9,1,14,95
18,5,20,9,1,18,9,9,0,89
18,5,20,9,1,18,9,21,19,120
18,5,20,9,3,5,12,12,1,85
18,5,20,9,3,5,12,12,15,99
18,5,20,9,3,5,14,3,5,82
18,5,20,9,3,5,14,3,25,102
18,5,20,9,3,5,14,20,0,94
18,5,20,9,3,11,5,20,0,91
18,5,20,9,3,12,5,0,0,72
18,5,20,9,3,12,5,19,0,91
18,5,20,9,3,21,12,1,0,89
18,5,20,9,3,21,12,1,18,107
18,5,20,9,3,21,12,5,0,93
18,5,20,9,3,21,12,5,4,97
18,5,20,9,3,21,12,5,19,112
18,5,20,9,3,21,12,9,0,97
18,5,20,9,3,21,12,9,14,111
18,5,20,9,5,0,0,0,0,57
18,5,20,9,5,4,0,0,0,61
18,5,20,9,5,18,0,0,0,75
18,5,20,9,5,19,0,0,0,76
18,5,20,9,6,15,18,13,0,104
18,5,20,9,7,8,20,5,14,106
18,5,20,25,9,14,7,0,0,98
18,5,20,9,12,5,0,0,0,69
18,5,20,9,12,5,4,0,0,73
18,5,20,9,12,9,14,7,0,94
18,5,20,9,12,12,0,0,0,76
18,5,20,9,13,2,5,18,0,90
18,5,20,9,13,5,0,0,0,70
18,5,20,9,13,5,4,0,0,74
18,5,20,9,13,5,19,0,0,89
18,5,20,9,13,9,14,7,0,95
18,5,20,9,14,0,0,0,0,66
18,5,20,9,14,1,0,0,0,67
18,5,20,9,14,1,5,0,0,72
18,5,20,9,14,1,12,0,0,79
18,5,20,9,14,1,12,19,0,98
18,5,20,9,14,1,19,0,0,86
18,5,20,9,14,5,0,0,0,71
18,5,20,9,14,5,14,5,0,90
18,5,20,9,14,5,14,5,19,109
18,5,20,9,14,5,19,0,0,90
18,5,20,9,14,7,5,0,0,78
18,5,20,9,14,7,5,4,0,82
18,5,20,9,14,9,1,14,0,90
18,5,20,9,14,9,3,0,0,78
18,5,20,9,14,9,20,5,0,100
18,5,20,9,14,9,20,5,19,119
18,5,20,9,14,9,20,9,19,123
18,5,20,9,14,9,26,5,0,106
18,5,20,9,14,11,5,18,0,100
18,5,20,9,14,14,5,4,0,89
18,5,20,9,14,14,9,14,7,110
18,5,20,9,14,15,9,4,0,94
18,5,20,9,14,15,12,0,0,93
18,5,20,9,14,15,12,19,0,112
18,5,20,9,14,20,0,0,0,86
18,5,20,9,14,20,5,4,0,95
18,5,20,9,14,20,9,14,7,116
18,5,20,9,14,20,19,0,0,105
18,5,20,9,14,21,5,0,0,92
18,5,20,9,14,21,5,4,0,96
18,5,20,9,14,21,5,19,0,111
18,5,20,9,14,21,12,1,0,100
18,5,20,9,14,21,12,1,5,105
18,5,20,9,14,21,12,1,18,118
18,5,20,9,14,21,12,1,19,119
18,5,20,9,14,21,12,5,0,104
18,5,20,9,16,0,0,0,0,68
18,5,20,25,16,5,0,0,0,89
18,5,20,25,16,5,4,0,0,93
18,5,20,25,16,5,19,0,0,108
18,5,20,25,16,9,14,7,0,114
18,5,20,9,18,1,3,25,0,99
18,5,20,9,18,1,4,5,0,80
18,5,20,9,18,1,12,0,0,83
18,5,20,9,18,1,14,20,0,105
18,5,20,9,18,1,14,20,19,124
18,5,20,9,18,5,0,0,0,75
18,5,20,9,18,5,4,0,0,79
18,5,20,9,18,5,4,12,25,116
18,5,20,9,18,5,5,0,0,80
18,5,20,9,18,5,5,19,0,99
18,5,20,9,18,5,18,0,0,93
18,5,20,9,18,5,18,19,0,112
18,5,20,9,18,5,19,0,0,94
18,5,20,9,18,9,14,7,0,100
18,5,20,9,19,20,5,14,5,115
18,5,20,9,20,12,5,0,0,89
18,5,20,9,20,12,5,4,0,93
18,5,20,9,20,12,5,19,0,108
18,5,20,9,20,12,9,14,7,114
18,5,20,12,5,4,0,0,0,64
18,5,20,12,9,14,7,0,0,85
18,5,20,15,1,19,20,0,0,98
18,5,20,15,12,4,0,0,0,74
18,5,20,15,13,2,0,0,0,73
18,5,20,15,15,11,0,0,0,84
18,5,20,15,15,12,0,0,0,85
18,5,20,15,15,12,5,4,0,94
18,5,20,15,15,12,9,14,7,115
18,5,20,15,15,12,19,0,0,104
18,5,20,15,15,20,8,0,0,101
18,5,20,15,15,20,8,5,18,124
18,5,20,15,18,5,0,0,0,81
18,5,20,15,18,14,0,0,0,90
18,5,20,15,18,19,9,15,14,133
18,5,20,15,18,20,0,0,0,96
18,5,20,15,18,20,5,4,0,105
18,5,20,15,18,20,5,18,0,119
18,5,20,15,18,20,5,18,19,138
18,5,20,15,18,20,9,14,7,126
18,5,20,15,18,20,9,15,14,134
18,5,20,15,18,20,9,22,5,132
18,5,20,15,18,20,19,0,0,115
18,5,20,15,18,20,21,18,5,140
18,5,20,15,19,19,0,0,0,96
18,5,20,15,20,1,12,0,0,91
18,5,20,15,20,1,12,5,4,100
18,5,20,15,21,3,8,0,0,90
18,5,20,15,21,3,8,5,4,99
18,5,20,15,21,3,8,5,18,113
18,5,20,15,21,3,8,5,19,114
18,5,20,15,21,18,0,0,0,97
18,5,20,18,1,3,5,0,0,70
18,5,20,18,1,3,5,4,0,74
18,5,20,18,1,3,5,19,0,89
18,5,20,18,1,3,9,14,7,95
18,5,20,18,1,3,11,0,0,76
18,5,20,18,1,3,11,5,4,85
18,5,20,18,1,3,11,19,0,95
18,5,20,18,1,3,20,0,0,85
18,5,20,18,1,3,20,5,4,94
18,5,20,18,1,3,20,15,18,118
18,5,20,18,1,3,20,19,0,104
18,5,20,18,1,4,0,0,0,66
18,5,20,18,1,4,5,0,0,71
18,5,20,18,1,4,5,4,0,75
18,5,20,18,1,4,9,14,7,96
18,5,20,18,1,8,5,14,20,109
18,5,20,18,1,9,3,20,0,94
18,5,20,18,1,9,14,0,0,85
18,5,20,18,1,9,14,5,4,94
18,5,20,18,1,9,14,5,5,95
18,5,20,18,1,9,14,19,0,104
18,5,20,18,1,9,20,0,0,91
18,5,20,18,1,12,0,0,0,74
18,5,20,18,1,12,12,25,0,111
18,5,20,18,1,13,16,0,0,91
18,5,20,18,1,13,16,12,5,108
18,5,20,18,1,14,19,9,20,124
18,5,20,18,1,22,5,12,0,101
18,5,20,18,1,24,9,20,0,115
18,5,20,18,5,1,4,0,0,71
18,5,20,18,5,1,4,5,4,80
18,5,20,18,5,1,4,19,0,90
18,5,20,18,5,1,20,0,0,87
18,5,20,18,5,1,20,1,12,100
18,5,20,18,5,1,20,5,4,96
18,5,20,18,5,1,20,5,18,110
18,5,20,18,5,1,20,19,0,106
18,5,20,18,5,5,0,0,0,71
18,5,20,18,5,14,3,8,0,91
18,5,20,18,25,0,0,0,0,86
18,5,20,18,9,1,12,0,0,83
18,5,20,18,9,1,12,19,0,102
18,5,20,18,9,2,21,20,5,118
18,5,20,18,9,3,11,5,4,93
18,5,20,18,9,5,4,0,0,79
18,5,20,18,9,5,18,0,0,93
18,5,20,18,9,5,18,19,0,112
18,5,20,18,9,5,19,0,0,94
18,5,20,18,9,5,22,1,12,110
18,5,20,18,9,5,22,5,0,102
18,5,20,18,9,5,22,5,4,106
18,5,20,18,9,5,22,5,18,120
18,5,20,18,9,5,22,5,19,121
18,5,20,18,25,9,14,7,0,116
18,5,20,18,9,13,0,0,0,83
18,5,20,18,9,13,13,5,4,105
18,5,20,18,9,13,13,5,18,119
18,5,20,18,9,13,19,0,0,102
18,5,20,18,9,16,0,0,0,86
18,5,20,18,15,0,0,0,0,76
18,5,20,18,15,1,3,20,0,100
18,5,20,18,15,1,3,20,19,119
18,5,20,18,15,3,5,4,5,93
18,5,20,18,15,4,0,0,0,80
18,5,20,18,15,4,1,20,5,106
18,5,20,18,15,4,4,5,14,103
18,5,20,18,15,6,9,18,5,114
18,5,20,18,15,6,9,20,0,111
18,5,20,18,15,6,9,20,19,130
18,5,20,18,15,6,12,5,24,123
18,5,20,18,15,6,12,21,24,139
18,5,20,18,15,6,15,18,13,128
18,5,20,18,15,10,5,3,20,114
18,5,20,18,15,16,1,3,11,107
18,5,20,18,15,18,19,5,0,118
18,5,20,18,15,19,0,0,0,95
18,5,20,18,15,20,0,0,0,96
18,5,20,18,15,21,19,19,0,135
18,5,20,18,15,21,19,19,5,140
18,5,20,18,15,22,5,18,20,141
18,5,20,18,21,4,5,0,0,91
18,5,20,18,21,4,5,4,0,95
18,5,20,18,21,4,9,14,7,116
18,5,20,18,21,5,0,0,0,87
18,5,20,18,21,19,5,0,0,106
18,5,20,18,21,19,9,15,14,139
18,5,20,18,21,19,9,22,5,137
18,5,20,18,21,19,20,0,0,121
18,5,20,19,0,0,0,0,0,62
18,5,20,19,9,14,1,0,0,86
18,5,20,19,9,14,1,19,0,105
18,5,20,20,5,4,0,0,0,72
18,5,20,20,5,18,0,0,0,86
18,5,20,20,5,18,25,0,0,111
18,5,20,20,5,18,9,5,19,119
18,5,20,20,9,14,7,0,0,93
18,5,20,20,15,18,5,0,0,101
18,5,20,20,15,18,25,0,0,121
18,5,20,20,15,18,14,0,0,110
18,5,20,21,2,5,0,0,0,71
18,5,20,21,3,11,0,0,0,78
18,5,20,21,13,2,12,5,0,96
18,5,20,21,14,4,0,0,0,82
18,5,20,21,14,4,5,4,0,91
18,5,20,21,14,4,9,14,7,112
18,5,20,21,14,5,0,0,0,83
18,5,20,21,14,5,4,0,0,87
18,5,20,21,14,5,19,0,0,102
18,5,20,21,14,9,14,7,0,108
18,5,20,21,18,2,1,14,0,99
18,5,20,21,18,6,0,0,0,88
18,5,20,21,18,6,5,18,0,111
18,5,20,21,18,14,0,0,0,96
18,5,20,21,18,14,5,4,0,105
18,5,20,21,18,14,5,5,0,106
18,5,20,21,18,14,5,5,19,125
18,5,20,21,18,14,5,18,0,119
18,5,20,21,18,14,5,18,19,138
18,5,20,21,18,14,9,14,7,126
18,5,20,21,18,14,19,0,0,115
18,5,20,21,19,5,0,0,0,88
18,5,20,23,9,14,5,0,0,94
18,5,20,23,9,14,5,4,0,98
18,5,20,23,9,14,9,14,7,119
18,5,20,23,9,19,20,0,0,114
18,5,20,23,9,19,20,5,4,123
18,5,20,23,9,19,20,19,0,133
18,5,20,26,9,1,14,0,0,93
18,5,21,14,4,5,18,7,15,107
18,5,21,14,5,0,0,0,0,63
18,5,21,14,6,15,12,4,0,95
18,5,21,14,9,6,25,0,0,98
18,5,21,14,9,6,9,5,4,91
18,5,21,14,9,6,9,5,19,106
18,5,21,14,9,15,14,19,0,115
18,5,21,14,9,20,5,0,0,92
18,5,21,14,9,20,5,4,0,96
18,5,21,14,9,20,5,18,0,110
18,5,21,14,9,20,5,18,19,129
18,5,21,14,9,20,5,19,0,111
18,5,21,14,9,20,9,14,7,117
18,5,21,14,9,20,9,15,14,125
18,5,21,14,9,20,9,22,5,123
18,5,21,14,16,1,3,11,0,89
18,5,21,16,8,15,12,4,0,99
18,5,21,16,12,9,6,20,0,107
18,5,21,18,7,5,0,0,0,74
18,5,21,19,1,2,12,5,0,83
18,5,21,19,5,0,0,0,0,68
18,5,21,19,5,1,2,12,5,88
18,5,21,19,5,4,0,0,0,72
18,5,21,19,5,19,0,0,0,87
18,5,21,19,9,14,7,0,0,93
18,5,21,20,9,12,9,19,5,118
18,5,21,20,9,12,9,26,5,125
18,5,21,20,20,5,18,0,0,107
18,5,21,20,20,5,18,5,4,116
18,5,21,20,20,5,18,19,0,126
18,5,22,1,3,1,20,5,0,75
18,5,22,1,3,1,20,5,4,79
18,5,22,1,25,0,0,0,0,71
18,5,22,1,12,5,14,20,1,98
18,5,22,1,12,21,1,20,5,105
18,5,22,1,12,21,5,0,0,84
18,5,22,1,12,21,5,4,0,88
18,5,22,1,12,21,5,19,0,103
18,5,22,1,12,21,9,14,7,109
18,5,22,1,13,16,0,0,0,75
18,5,22,1,13,16,5,4,0,84
18,5,22,1,13,16,5,18,0,98
18,5,22,1,13,16,5,18,19,117
18,5,22,1,13,16,9,14,7,105
18,5,22,1,13,16,19,0,0,94
18,5,22,1,14,3,8,5,0,76
18,5,22,1,14,3,8,5,19,95
18,5,22,1,18,25,0,0,0,89
18,5,22,1,18,14,9,19,8,114
18,5,22,5,0,0,0,0,0,50
18,5,22,5,1,12,0,0,0,63
18,5,22,5,1,12,5,4,0,72
18,5,22,5,1,12,5,18,0,86
18,5,22,5,1,12,5,18,19,105
18,5,22,5,1,12,9,14,7,93
18,5,22,5,1,12,19,0,0,82
18,5,22,5,8,5,14,20,0,97
18,5,22,5,9,12,0,0,0,71
18,5,22,5,9,12,12,5,0,88
18,5,22,5,9,12,12,5,19,107
18,5,22,5,12,0,0,0,0,62
18,5,22,5,12,1,14,20,0,97
18,5,22,5,12,1,20,15,18,116
18,5,22,5,12,5,4,0,0,71
18,5,22,5,12,5,18,0,0,85
18,5,22,5,12,5,18,19,0,104
18,5,22,5,12,9,14,7,0,92
18,5,22,5,12,12,5,4,0,83
18,5,22,5,12,12,5,14,20,113
18,5,22,5,12,12,5,18,0,97
18,5,22,5,12,12,5,18,19,116
18,5,22,5,12,12,25,0,0,99
18,5,22,5,12,12,9,14,7,104
18,5,22,5,12,13,5,14,20,114
18,5,22,5,12,15,21,19,0,117
18,5,22,5,12,18,25,0,0,105
18,5,22,5,12,18,9,5,19,113
18,5,22,5,12,18,15,21,19,135
18,5,22,5,12,18,15,21,20,136
18,5,22,5,12,19,0,0,0,81
18,5,22,5,14,1,14,20,0,99
18,5,22,5,14,1,14,20,19,118
18,5,22,5,14,4,0,0,0,68
18,5,22,5,14,4,5,18,0,91
18,5,22,5,14,5,5,18,0,92
18,5,22,5,14,7,5,0,0,76
18,5,22,5,14,7,5,4,0,80
18,5,22,5,14,7,5,18,0,94
18,5,22,5,14,7,5,18,19,113
18,5,22,5,14,7,5,19,0,95
18,5,22,5,14,7,9,14,7,101
18,5,22,5,14,20,0,0,0,84
18,5,22,5,14,20,21,18,5,128
18,5,22,5,14,21,1,12,0,98
18,5,22,5,14,21,5,0,0,90
18,5,22,5,14,21,5,4,0,94
18,5,22,5,14,21,5,18,0,108
18,5,22,5,14,21,5,18,19,127
18,5,22,5,14,21,5,19,0,109
18,5,22,5,18,0,0,0,0,68
18,5,22,5,18,1,2,12,5,88
18,5,22,5,18,2,0,0,0,70
18,5,22,5,18,2,5,4,0,79
18,5,22,5,18,2,19,0,0,89
18,5,22,5,18,4,9,0,0,81
18,5,22,5,18,4,21,18,5,116
18,5,22,5,18,5,4,0,0,77
18,5,22,5,18,5,5,0,0,78
18,5,22,5,18,5,14,4,19,110
18,5,22,5,18,5,14,20,0,107
18,5,22,5,18,5,18,0,0,91
18,5,22,5,18,5,18,19,0,110
18,5,22,5,18,5,19,0,0,92
18,5,22,5,18,25,0,0,0,93
18,5,22,5,18,9,5,0,0,82
18,5,22,5,18,9,5,19,0,101
18,5,22,5,18,9,6,25,0,108
18,5,22,5,18,9,14,7,0,98
18,5,22,5,18,9,19,20,0,116
18,5,22,5,18,19,0,0,0,87
18,5,22,5,18,19,1,12,0,100
18,5,22,5,18,19,1,12,19,119
18,5,22,5,18,19,5,0,0,92
18,5,22,5,18,19,5,4,0,96
18,5,22,5,18,19,5,12,25,129
18,5,22,5,18,19,5,18,0,110
18,5,22,5,18,19,5,18,19,129
18,5,22,5,18,19,5,19,0,111
18,5,22,5,18,19,9,0,0,96
18,5,22,5,18,19,9,6,25,127
18,5,22,5,18,19,9,14,7,117
18,5,22,5,18,19,9,15,14,125
18,5,22,5,18,19,9,19,0,115
18,5,22,5,18,19,9,19,20,135
18,5,22,5,18,19,9,22,5,123
18,5,22,5,18,19,15,0,0,102
18,5,22,5,18,19,15,19,0,121
18,5,22,5,18,20,0,0,0,88
18,5,22,5,18,20,1,12,0,101
18,5,22,5,18,20,5,4,0,97
18,5,22,5,18,20,5,18,0,111
18,5,22,5,18,20,5,18,19,130
18,5,22,5,18,20,9,14,7,118
18,5,22,5,18,20,9,22,5,124
18,5,22,5,18,20,19,0,0,107
18,5,22,5,19,20,0,0,0,89
18,5,22,5,19,20,5,4,0,98
18,5,22,5,19,20,9,14,7,119
18,5,22,5,19,20,18,25,0,132
18,5,22,5,19,20,19,0,0,108
18,5,22,5,20,0,0,0,0,70
18,5,22,5,20,5,0,0,0,75
18,5,22,5,20,13,5,14,20,122
18,5,22,5,20,15,0,0,0,85
18,5,22,5,20,15,5,4,0,94
18,5,22,5,20,15,9,14,7,115
18,5,22,5,20,19,0,0,0,89
18,5,22,5,20,20,5,4,0,99
18,5,22,5,20,20,9,14,7,120
18,5,22,9,2,18,1,14,20,109
18,5,22,9,2,18,1,20,5,100
18,5,22,9,3,20,15,18,25,135
18,5,22,9,3,20,21,1,12,111
18,5,22,9,5,0,0,0,0,59
18,5,22,9,5,23,0,0,0,82
18,5,22,9,5,23,1,7,5,95
18,5,22,9,5,23,1,12,0,95
18,5,22,9,5,23,1,12,19,114
18,5,22,9,5,23,5,4,0,91
18,5,22,9,5,23,5,18,0,105
18,5,22,9,5,23,5,18,19,124
18,5,22,9,5,23,9,14,7,112
18,5,22,9,5,23,9,19,8,118
18,5,22,9,5,23,19,0,0,101
18,5,22,9,7,15,18,0,0,94
18,5,22,9,7,15,21,18,0,115
18,5,22,9,12,5,0,0,0,71
18,5,22,9,12,5,4,0,0,75
18,5,22,9,12,5,18,0,0,89
18,5,22,9,12,5,18,19,0,108
18,5,22,9,12,5,19,0,0,90
18,5,22,9,12,9,14,7,0,96
18,5,22,9,14,3,5,0,0,76
18,5,22,9,15,12,1,20,5,107
18,5,22,9,18,1,4,15,0,92
18,5,22,9,19,1,12,0,0,86
18,5,22,9,19,1,12,19,0,105
18,5,22,9,19,5,0,0,0,78
18,5,22,9,19,5,4,0,0,82
18,5,22,9,19,5,5,0,0,83
18,5,22,9,19,5,18,0,0,96
18,5,22,9,19,5,18,19,0,115
18,5,22,9,19,5,19,0,0,97
18,5,22,9,19,9,2,12,5,101
18,5,22,9,19,9,14,7,0,103
18,5,22,9,19,9,15,14,0,111
18,5,22,9,19,9,15,14,19,130
18,5,22,9,19,9,20,0,0,102
18,5,22,9,19,9,20,5,4,111
18,5,22,9,19,9,20,19,0,121
18,5,22,9,19,15,18,0,0,106
18,5,22,9,19,15,18,25,0,131
18,5,22,9,19,15,18,19,0,125
18,5,22,9,22,1,2,12,5,96
18,5,22,9,22,1,2,12,25,116
18,5,22,9,22,1,12,0,0,89
18,5,22,9,22,1,12,19,0,108
18,5,22,9,22,5,0,0,0,81
18,5,22,9,22,5,4,0,0,85
18,5,22,9,22,5,18,0,0,99
18,5,22,9,22,5,18,19,0,118
18,5,22,9,22,5,19,0,0,100
18,5,22,9,22,9,6,25,0,116
18,5,22,9,22,9,14,7,0,106
18,5,22,9,22,15,18,0,0,109
18,5,22,15,3,1,2,12,5,83
18,5,22,15,3,1,2,12,25,103
18,5,22,15,3,1,14,4,9,91
18,5,22,15,3,1,20,5,0,89
18,5,22,15,25,1,7,5,0,98
18,5,22,15,25,1,7,5,4,102
18,5,22,15,9,3,5,0,0,77
18,5,22,15,9,3,5,4,0,81
18,5,22,15,9,3,5,19,0,96
18,5,22,15,9,3,9,14,7,102
18,5,22,15,9,18,0,0,0,87
18,5,22,15,11,1,2,12,5,91
18,5,22,15,11,5,0,0,0,76
18,5,22,15,11,5,4,0,0,80
18,5,22,15,11,5,18,0,0,94
18,5,22,15,11,5,18,19,0,113
18,5,22,15,11,5,19,0,0,95
18,5,22,15,11,9,14,7,0,101
18,5,22,15,12,1,14,20,0,107
18,5,22,15,12,20,0,0,0,92
18,5,22,15,12,20,5,4,0,101
18,5,22,15,12,20,5,18,0,115
18,5,22,15,12,20,5,18,19,134
18,5,22,15,12,20,9,14,7,122
18,5,22,15,12,20,19,0,0,111
18,5,22,15,12,21,2,12,5,112
18,5,22,15,12,21,2,12,25,132
18,5,22,15,12,21,20,5,0,118
18,5,22,15,12,21,20,5,4,122
18,5,22,15,12,22,5,0,0,99
18,5,22,15,12,22,5,4,0,103
18,5,22,15,12,22,5,18,0,117
18,5,22,15,12,22,5,18,19,136
18,5,22,15,12,22,5,19,0,118
18,5,22,15,12,22,9,14,7,124
18,5,22,15,13,9,20,0,0,102
18,5,22,15,20,5,0,0,0,85
18,5,22,15,20,5,4,0,0,89
18,5,22,15,20,5,19,0,0,104
18,5,22,15,20,9,14,7,0,110
18,5,22,19,0,0,0,0,0,64
18,5,22,21,5,0,0,0,0,71
18,5,22,21,5,19,0,0,0,90
18,5,22,21,5,20,20,5,0,116
18,5,22,21,9,19,20,0,0,114
18,5,22,21,9,19,20,19,0,133
18,5,22,21,12,19,1,14,20,132
18,5,22,21,12,19,5,0,0,102
18,5,22,21,12,19,5,4,0,106
18,5,22,21,12,19,9,15,14,135
18,5,22,21,12,19,9,22,5,133
18,5,22,22,5,4,0,0,0,76
18,5,22,22,9,14,7,0,0,97
18,5,23,1,4,5,0,0,0,56
18,5,23,1,7,5,18,0,0,77
18,5,23,1,25,2,9,12,12,107
18,5,23,1,25,12,5,0,0,89
18,5,23,1,11,5,0,0,0,63
18,5,23,1,11,5,4,0,0,67
18,5,23,1,11,5,14,0,0,77
18,5,23,1,11,5,14,5,4,86
18,5,23,1,11,5,14,19,0,96
18,5,23,1,11,5,19,0,0,82
18,5,23,1,11,9,14,7,0,88
18,5,23,1,12,12,0,0,0,71
18,5,23,1,12,12,15,23,0,109
18,5,23,1,14,0,0,0,0,61
18,5,23,1,18,4,0,0,0,69
18,5,23,1,18,4,5,4,0,78
18,5,23,1,18,4,5,18,0,92
18,5,23,1,18,4,5,18,19,111
18,5,23,1,18,4,6,21,12,108
18,5,23,1,18,4,9,14,7,99
18,5,23,1,18,4,19,0,0,88
18,5,23,1,18,13,0,0,0,78
18,5,23,1,18,13,5,4,0,87
18,5,23,1,18,13,9,14,7,108
18,5,23,1,18,13,19,0,0,97
18,5,23,1,18,14,0,0,0,79
18,5,23,1,18,18,1,14,20,118
18,5,23,1,19,8,0,0,0,74
18,5,23,1,19,8,5,4,0,83
18,5,23,1,19,8,5,19,0,98
18,5,23,1,19,8,9,14,7,104
18,5,23,1,20,5,18,0,0,90
18,5,23,1,22,5,0,0,0,74
18,5,23,1,24,0,0,0,0,71
18,5,23,1,24,5,4,0,0,80
18,5,23,1,24,5,19,0,0,95
18,5,23,1,24,9,14,7,0,101
18,5,23,5,1,11,5,14,0,82
18,5,23,5,1,18,0,0,0,70
18,5,23,5,1,18,9,14,7,100
18,5,23,5,1,22,5,0,0,79
18,5,23,5,1,22,5,4,0,83
18,5,23,5,1,22,5,19,0,98
18,5,23,5,1,22,9,14,7,104
18,5,23,5,4,0,0,0,0,55
18,5,23,5,4,4,5,4,0,68
18,5,23,5,4,4,9,14,7,89
18,5,23,5,4,19,0,0,0,74
18,5,23,5,9,7,8,0,0,75
18,5,23,5,9,7,8,5,4,84
18,5,23,5,9,7,8,5,18,98
18,5,23,5,9,7,8,19,0,94
18,5,23,5,9,7,8,20,0,95
18,5,23,5,12,3,15,13,5,99
18,5,23,5,12,4,0,0,0,67
18,5,23,5,12,4,5,4,0,76
18,5,23,5,12,4,9,14,7,97
18,5,23,5,12,4,19,0,0,86
18,5,23,5,14,4,0,0,0,69
18,5,23,5,20,0,0,0,0,71
18,5,23,5,20,19,0,0,0,90
18,5,23,5,20,20,5,4,0,100
18,5,23,8,5,12,16,0,0,87
18,5,23,8,9,18,12,0,0,93
18,5,23,8,9,19,16,5,18,121
18,5,23,8,9,20,5,14,0,102
18,5,23,9,4,5,14,0,0,78
18,5,23,9,4,5,14,5,4,87
18,5,23,9,4,5,14,19,0,97
18,5,23,9,14,0,0,0,0,69
18,5,23,9,14,4,0,0,0,73
18,5,23,9,14,4,5,4,0,82
18,5,23,9,14,4,5,18,0,96
18,5,23,9,14,4,5,18,19,115
18,5,23,9,14,4,9,14,7,103
18,5,23,9,14,4,19,0,0,92
18,5,23,9,14,7,0,0,0,76
18,5,23,9,14,14,9,14,7,113
18,5,23,9,14,19,0,0,0,88
18,5,23,9,18,1,2,12,5,93
18,5,23,9,18,5,0,0,0,78
18,5,23,9,18,5,4,0,0,82
18,5,23,9,18,5,19,0,0,97
18,5,23,9,18,9,14,7,0,103
18,5,23,9,19,8,0,0,0,82
18,5,23,15,11,5,0,0,0,77
18,5,23,15,11,5,14,0,0,91
18,5,23,15,14,0,0,0,0,75
18,5,23,15,15,4,0,0,0,80
18,5,23,15,18,4,0,0,0,83
18,5,23,15,18,4,5,4,0,92
18,5,23,15,18,4,9,14,7,113
18,5,23,15,18,4,19,0,0,102
18,5,23,15,18,5,0,0,0,84
18,5,23,15,18,11,0,0,0,90
18,5,23,15,18,11,5,4,0,99
18,5,23,15,18,11,9,14,7,120
18,5,23,15,18,11,19,0,0,109
18,5,23,15,21,14,4,0,0,100
18,5,23,15,22,5,0,0,0,88
18,5,23,15,22,5,14,0,0,102
18,5,23,18,1,16,0,0,0,81
18,5,23,18,1,16,16,5,4,106
18,5,23,18,1,16,19,0,0,100
18,5,23,18,1,16,20,0,0,101
18,5,23,18,9,20,5,0,0,98
18,5,23,18,9,20,5,18,0,116
18,5,23,18,9,20,5,18,19,135
18,5,23,18,9,20,5,19,0,117
18,5,23,18,9,20,9,14,7,123
18,5,23,18,9,20,20,5,14,132
18,5,23,18,15,20,5,0,0,104
18,5,23,18,15,21,7,8,20,135
18,5,23,23,15,18,5,0,0,107
18,5,23,23,15,22,5,0,0,111
18,5,24,5,14,0,0,0,0,66
18,5,24,5,19,0,0,0,0,71
18,5,26,15,14,5,0,0,0,83
18,5,26,15,14,5,4,0,0,87
18,5,26,15,14,5,19,0,0,102
18,5,26,15,14,9,14,7,0,108
18,6,2,0,0,0,0,0,0,26
18,6,15,21,14,4,0,0,0,78
18,6,18,5,5,0,0,0,0,52
18,6,26,0,0,0,0,0,0,50
18,7,9,19,19,5,21,18,0,116
18,7,12,5,13,5,14,20,0,94
18,8,2,0,0,0,0,0,0,28
18,8,4,0,0,0,0,0,0,30
18,8,5,0,0,0,0,0,0,31
18,8,5,1,4,9,14,5,0,64
18,8,5,1,19,0,0,0,0,51
18,8,5,2,15,11,0,0,0,59
18,8,5,2,15,11,19,0,0,78
18,8,5,2,15,19,9,19,0,95
18,8,5,4,1,0,0,0,0,36
18,8,5,4,1,5,0,0,0,41
18,8,5,4,1,19,0,0,0,55
18,8,5,5,2,15,3,0,0,56
18,8,5,5,2,15,11,0,0,64
18,8,5,5,14,0,0,0,0,50
18,8,5,9,3,0,0,0,0,43
18,8,5,9,14,9,3,0,0,66
18,8,5,13,1,0,0,0,0,45
18,8,5,13,1,20,9,3,0,77
18,8,5,13,5,0,0,0,0,49
18,8,5,14,5,1,0,0,0,51
18,8,5,14,9,3,0,0,0,57
18,8,5,14,9,21,13,0,0,88
18,8,5,14,9,21,13,19,0,107
18,8,5,15,0,0,0,0,0,46
18,8,5,15,2,1,19,5,0,73
18,8,5,15,2,1,19,5,19,92
18,8,5,15,3,18,1,20,0,88
18,8,5,15,12,15,7,25,0,105
18,8,5,15,12,15,7,9,3,92
18,8,5,15,13,5,20,5,18,107
18,8,5,15,13,5,20,18,25,127
18,8,5,15,16,5,24,25,0,116
18,8,5,15,16,8,9,12,0,91
18,8,5,15,16,8,9,12,5,96
18,8,5,15,16,8,15,18,5,108
18,8,5,15,19,3,15,16,5,104
18,8,5,15,19,20,1,20,0,106
18,8,5,15,19,20,1,20,19,125
18,8,5,15,20,1,14,0,0,81
18,8,5,15,20,1,24,9,19,119
18,8,5,15,20,15,13,5,0,99
18,8,5,15,20,18,15,14,0,113
18,8,5,15,20,18,15,16,5,120
18,8,5,19,9,1,14,0,0,74
18,8,5,19,9,19,0,0,0,78
18,8,5,19,21,19,5,19,0,114
18,8,5,20,0,0,0,0,0,51
18,8,5,20,15,18,0,0,0,84
18,8,5,20,15,18,9,3,0,96
18,8,5,20,15,18,9,3,19,115
18,8,5,20,15,18,9,26,5,124
18,8,5,20,15,18,19,0,0,103
18,8,5,21,13,1,20,9,3,98
18,8,5,21,13,1,20,9,26,121
18,8,5,21,13,5,4,0,0,74
18,8,5,21,13,25,0,0,0,90
18,8,5,21,13,9,3,0,0,77
18,8,5,21,13,9,5,18,0,97
18,8,5,21,13,9,5,19,20,118
18,8,5,21,13,9,12,25,0,111
18,8,5,21,13,19,0,0,0,84
18,8,5,24,5,19,0,0,0,79
18,8,5,24,9,19,0,0,0,83
18,8,9,2,9,1,0,0,0,47
18,8,9,7,15,12,5,14,5,93
18,8,9,7,15,19,9,19,0,104
18,8,9,7,15,20,9,3,0,89
18,8,9,12,1,0,0,0,0,48
18,8,25,13,5,0,0,0,0,69
18,8,25,13,5,4,0,0,0,73
18,8,25,13,5,12,5,19,19,124
18,8,25,13,5,12,5,20,0,106
18,8,25,13,5,18,0,0,0,87
18,8,25,13,5,18,25,0,0,112
18,8,25,13,5,18,19,0,0,106
18,8,25,13,5,19,0,0,0,88
18,8,25,13,5,19,20,5,18,131
18,8,25,13,5,23,9,19,5,125
18,8,25,13,25,0,0,0,0,89
18,8,25,13,9,3,0,0,0,76
18,8,25,13,9,14,7,0,0,94
18,8,25,13,9,19,20,0,0,112
18,8,9,14,1,12,0,0,0,62
18,8,9,14,1,12,7,9,1,79
18,8,9,14,1,18,9,1,0,78
18,8,9,14,1,18,9,21,13,111
18,8,25,14,3,8,15,20,5,116
18,8,9,14,5,0,0,0,0,54
18,8,9,14,9,15,14,0,0,87
18,8,9,14,9,20,9,19,0,106
18,8,9,14,15,0,0,0,0,64
18,8,9,14,15,2,25,15,14,120
18,8,9,14,15,3,1,21,12,101
18,8,9,14,15,3,5,12,5,89
18,8,9,14,15,3,5,18,9,99
18,8,9,14,15,12,9,20,5,110
18,8,9,14,15,12,9,20,8,113
18,8,9,14,15,12,15,7,25,123
18,8,9,14,15,19,0,0,0,83
18,8,25,15,12,9,20,5,0,112
18,8,25,15,12,9,20,5,19,131
18,8,25,15,12,9,20,9,3,119
18,8,9,16,9,4,1,20,5,90
18,8,9,16,9,4,9,15,14,102
18,8,9,16,9,4,9,21,13,107
18,8,25,16,20,9,3,0,0,99
18,8,25,16,20,9,3,1,12,112
18,8,25,20,1,0,0,0,0,72
18,8,25,20,8,13,0,0,0,92
18,8,25,20,8,13,1,12,0,105
18,8,25,20,8,13,5,4,0,101
18,8,25,20,8,13,9,3,0,104
18,8,25,20,8,13,9,3,19,123
18,8,25,20,8,13,9,19,20,140
18,8,25,20,8,13,9,26,5,132
18,8,25,20,8,13,19,0,0,111
18,8,25,20,8,13,21,19,0,132
18,8,25,20,9,4,15,13,5,117
18,8,25,20,15,14,0,0,0,100
18,8,25,20,20,1,0,0,0,92
18,8,9,26,1,0,0,0,0,62
18,8,9,26,1,14,20,8,0,104
18,8,9,26,9,14,5,0,0,89
18,8,9,26,9,14,15,21,19,139
18,8,9,26,15,2,9,1,0,88
18,8,9,26,15,3,1,18,16,114
18,8,9,26,15,3,1,21,12,113
18,8,9,26,15,3,15,18,13,125
18,8,9,26,15,7,5,14,0,102
18,8,9,26,15,9,4,0,0,89
18,8,9,26,15,9,4,1,12,102
18,8,9,26,15,9,4,19,0,108
18,8,9,26,15,13,1,0,0,90
18,8,9,26,15,13,1,20,1,111
18,8,9,26,15,13,5,0,0,94
18,8,9,26,15,13,5,19,0,113
18,8,9,26,15,13,9,3,0,101
18,8,9,26,15,16,9,0,0,101
18,8,9,26,15,16,15,4,0,111
18,8,9,26,15,16,15,4,19,130
18,8,9,26,15,20,1,24,25,146
18,8,9,26,15,20,5,0,0,101
18,8,9,26,15,20,9,3,0,108
18,8,9,26,15,20,15,13,9,133
18,8,9,26,15,20,15,13,25,149
18,8,15,0,0,0,0,0,0,41
18,8,15,4,1,12,9,14,5,86
18,8,15,4,1,13,9,14,0,82
18,8,15,4,1,13,9,14,19,101
18,8,15,4,1,14,1,20,5,86
18,8,15,4,1,14,9,3,0,72
18,8,15,4,1,14,9,14,5,88
18,8,15,4,1,14,20,8,5,93
18,8,15,4,5,15,19,5,0,89
18,8,15,4,9,3,0,0,0,57
18,8,15,4,9,14,1,12,0,81
18,8,15,4,9,14,7,0,0,75
18,8,15,4,9,14,15,12,0,95
18,8,15,4,9,20,5,0,0,79
18,8,15,4,9,21,13,0,0,88
18,8,15,4,9,21,13,19,0,107
18,8,15,4,9,26,9,20,5,114
18,8,15,4,15,3,25,20,5,113
18,8,15,4,15,12,9,20,5,106
18,8,15,4,15,14,9,20,5,108
18,8,15,4,15,16,19,9,14,118
18,8,15,4,15,18,1,19,0,98
18,8,15,5,1,0,0,0,0,47
18,8,15,13,2,0,0,0,0,56
18,8,15,13,2,5,14,12,1,88
18,8,15,13,2,9,0,0,0,65
18,8,15,13,2,9,3,0,0,68
18,8,15,13,2,9,3,1,12,81
18,8,15,13,2,15,9,4,0,84
18,8,15,13,2,15,9,4,19,103
18,8,15,13,2,15,19,0,0,90
18,8,15,13,2,19,0,0,0,75
18,8,15,13,2,21,19,0,0,96
18,8,15,13,2,21,19,5,19,120
18,8,15,14,3,1,12,0,0,71
18,8,15,14,3,8,1,12,0,79
18,8,15,14,3,8,9,0,0,75
18,8,15,14,3,8,9,1,12,88
18,8,15,14,3,8,21,19,0,106
18,8,15,16,1,12,9,3,0,82
18,8,15,16,1,12,9,19,13,111
18,8,15,16,1,12,9,21,13,113
18,8,15,19,0,0,0,0,0,60
18,8,15,20,1,3,9,19,13,106
18,8,15,20,1,3,9,19,20,113
18,8,15,20,1,3,9,26,5,105
18,8,15,20,9,3,0,0,0,73
18,8,21,2,1,18,2,0,0,70
18,8,21,2,1,18,2,25,0,95
18,8,21,2,1,18,2,19,0,89
18,8,21,13,2,0,0,0,0,62
18,8,21,13,2,1,0,0,0,63
18,8,21,13,2,1,5,4,0,72
18,8,21,13,2,1,9,14,7,93
18,8,21,13,2,1,19,0,0,82
18,8,21,13,2,19,0,0,0,81
18,8,21,19,5,19,0,0,0,90
18,9,2,0,0,0,0,0,0,29
18,9,2,1,12,4,0,0,0,46
18,9,2,1,12,4,9,19,8,82
18,9,2,1,12,4,12,25,0,83
18,9,2,1,12,4,18,25,0,89
18,9,2,1,12,4,19,0,0,65
18,9,2,1,14,4,0,0,0,48
18,9,2,1,14,4,18,25,0,91
18,9,2,1,14,4,19,0,0,67
18,9,2,1,20,0,0,0,0,50
18,25,2,1,20,0,0,0,0,66
18,9,2,1,21,4,18,5,4,82
18,9,2,1,26,21,2,1,0,80
18,9,2,2,1,14,4,0,0,50
18,9,2,2,1,14,4,18,25,93
18,9,2,2,1,14,4,19,0,69
18,9,2,2,5,4,0,0,0,40
18,9,2,2,5,18,0,0,0,54
18,9,2,2,5,18,19,0,0,73
18,9,2,2,5,20,0,0,0,56
18,9,2,2,25,0,0,0,0,56
18,9,2,2,9,4,7,5,0,56
18,9,2,2,9,5,18,0,0,63
18,9,2,2,9,5,19,20,0,84
18,9,2,2,9,14,7,0,0,61
18,9,2,2,9,14,7,19,0,80
18,9,2,2,15,14,0,0,0,60
18,9,2,2,15,14,5,4,0,69
18,9,2,2,15,14,5,18,0,83
18,9,2,2,15,14,25,0,0,85
18,9,2,2,15,14,9,14,7,90
18,9,2,2,15,14,18,25,0,103
18,9,2,2,15,14,19,0,0,79
18,9,2,5,0,0,0,0,0,34
18,9,2,7,18,1,19,19,0,93
18,9,2,9,2,5,0,0,0,45
18,9,2,9,5,18,0,0,0,61
18,9,2,9,5,18,19,0,0,80
18,9,2,12,5,19,19,0,0,84
18,9,2,12,5,20,0,0,0,66
18,9,2,12,5,20,19,0,0,85
18,9,2,12,9,11,5,0,0,66
18,9,2,15,14,9,3,0,0,70
18,9,2,15,19,5,0,0,0,68
18,9,2,15,19,5,19,0,0,87
18,9,2,15,19,15,0,0,0,78
18,9,2,15,19,15,13,1,12,104
18,9,2,15,19,15,13,5,0,96
18,9,2,15,19,15,13,5,19,115
18,9,2,15,19,15,19,0,0,97
18,9,2,15,26,1,0,0,0,71
18,9,2,15,26,15,0,0,0,85
18,9,2,15,26,15,19,0,0,104
18,9,2,18,15,1,19,20,0,102
18,9,2,19,0,0,0,0,0,48
18,9,2,19,11,9,14,0,0,82
18,9,2,19,16,1,18,5,0,88
18,9,2,23,15,18,11,0,0,96
18,9,2,23,15,18,20,0,0,105
18,9,2,23,15,18,20,19,0,124
18,9,2,26,21,2,1,0,0,79
18,9,3,1,19,19,15,0,0,84
18,9,3,5,2,9,18,4,0,68
18,9,3,5,2,9,18,4,19,87
18,9,3,5,3,1,18,0,0,57
18,9,3,5,3,1,18,19,0,76
18,9,3,5,4,0,0,0,0,39
18,9,3,5,7,18,1,19,19,99
18,9,3,5,25,0,0,0,0,60
18,9,3,5,12,1,14,4,0,66
18,9,3,5,18,0,0,0,0,53
18,9,3,5,18,3,1,18,0,75
18,9,3,5,18,3,1,18,5,80
18,9,3,5,18,3,1,18,9,84
18,9,3,5,18,3,1,18,19,94
18,9,3,5,18,3,1,20,1,78
18,9,3,5,18,19,0,0,0,72
18,9,3,5,19,0,0,0,0,54
18,9,3,8,4,15,13,0,0,70
18,9,3,8,5,0,0,0,0,43
18,9,3,8,5,14,0,0,0,57
18,9,3,8,5,14,5,4,0,66
18,9,3,8,5,14,9,14,7,87
18,9,3,8,5,14,19,0,0,76
18,9,3,8,5,19,0,0,0,62
18,9,3,8,5,19,19,5,0,86
18,9,3,8,5,19,20,0,0,82
18,9,3,8,5,20,5,4,0,72
18,9,3,8,5,20,9,14,7,93
18,9,3,8,5,20,20,5,4,92
18,9,3,8,12,25,0,0,0,75
18,9,3,8,12,9,14,7,0,80
18,9,3,8,14,5,19,19,0,95
18,9,3,8,20,0,0,0,0,58
18,9,3,8,23,5,5,4,0,75
18,9,3,8,23,5,5,4,19,94
18,9,3,9,14,0,0,0,0,53
18,9,3,9,14,5,0,0,0,58
18,9,3,9,14,7,0,0,0,60
18,9,3,9,14,9,3,0,0,65
18,9,3,9,14,9,14,5,0,81
18,9,3,9,14,9,14,9,3,88
18,9,3,9,14,9,21,13,0,96
18,9,3,9,14,15,12,9,3,92
18,9,3,9,14,19,0,0,0,72
18,9,3,9,14,21,19,5,19,117
18,9,3,11,5,4,0,0,0,50
18,9,3,11,5,25,19,0,0,90
18,9,3,11,5,20,0,0,0,66
18,9,3,11,5,20,25,0,0,91
18,9,3,11,5,20,9,5,18,98
18,9,3,11,5,20,9,12,25,112
18,9,3,11,5,20,9,19,8,102
18,9,3,11,5,20,19,0,0,85
18,9,3,11,25,1,18,4,0,89
18,9,3,11,9,14,7,0,0,71
18,9,3,11,12,5,0,0,0,58
18,9,3,11,13,1,20,9,3,87
18,9,3,11,18,1,3,11,0,74
18,9,3,11,18,1,3,11,19,93
18,9,3,11,19,0,0,0,0,60
18,9,3,11,19,8,1,0,0,69
18,9,3,11,19,8,1,19,0,88
18,9,3,11,19,8,1,23,0,92
18,9,3,11,19,8,1,23,19,111
18,9,3,11,19,20,1,14,4,99
18,9,3,11,19,20,9,3,11,103
18,9,3,15,3,8,5,20,0,81
18,9,3,15,3,8,5,20,19,100
18,9,3,15,20,20,1,0,0,86
18,9,3,15,20,20,1,19,0,105
18,9,3,18,1,3,0,0,0,52
18,9,3,18,1,3,19,0,0,71
18,9,3,20,1,12,0,0,0,63
18,9,3,20,21,19,0,0,0,90
18,9,3,20,21,19,5,19,0,114
18,9,4,1,2,12,5,0,0,51
18,9,4,1,2,12,25,0,0,71
18,9,4,4,1,13,0,0,0,49
18,9,4,4,1,14,3,5,0,58
18,9,4,4,1,14,3,5,19,77
18,9,4,4,5,4,0,0,0,44
18,9,4,4,5,12,0,0,0,52
18,9,4,4,5,14,0,0,0,54
18,9,4,4,5,18,0,0,0,58
18,9,4,4,5,18,19,0,0,77
18,9,4,4,9,14,7,0,0,65
18,9,4,4,12,5,4,0,0,56
18,9,4,4,12,5,18,0,0,70
18,9,4,4,12,5,18,19,0,89
18,9,4,4,12,5,19,0,0,71
18,9,4,4,12,9,14,7,0,77
18,9,4,4,12,9,14,7,19,96
18,9,4,5,0,0,0,0,0,36
18,9,4,5,1,2,12,5,0,56
18,9,4,5,1,21,0,0,0,58
18,9,4,5,14,0,0,0,0,50
18,9,4,5,14,20,0,0,0,70
18,9,4,5,18,5,4,0,0,63
18,9,4,5,18,5,19,19,0,97
18,9,4,5,18,12,5,19,19,109
18,9,4,5,18,19,0,0,0,73
18,9,4,5,18,19,8,9,16,106
18,9,4,5,19,0,0,0,0,55
18,9,4,7,5,0,0,0,0,43
18,9,4,7,5,2,1,14,4,64
18,9,4,7,5,2,15,14,5,79
18,9,4,7,5,4,0,0,0,47
18,9,4,7,5,12,0,0,0,55
18,9,4,7,5,12,5,20,0,80
18,9,4,7,5,12,9,11,5,80
18,9,4,7,5,12,9,14,7,85
18,9,4,7,5,12,19,0,0,74
18,9,4,7,5,16,15,12,5,91
18,9,4,7,5,18,0,0,0,61
18,9,4,7,5,18,15,16,5,97
18,9,4,7,5,19,0,0,0,62
18,9,4,7,5,20,18,5,5,91
18,9,4,7,5,23,9,19,5,99
18,9,4,7,25,0,0,0,0,63
18,9,4,7,9,5,18,0,0,70
18,9,4,7,9,5,19,20,0,91
18,9,4,7,9,12,0,0,0,59
18,9,4,7,9,12,19,0,0,78
18,9,4,7,9,14,7,0,0,68
18,9,4,7,9,14,7,12,25,105
18,9,4,7,12,9,14,7,0,80
18,9,4,7,12,9,14,7,19,99
18,9,4,9,2,21,14,4,0,81
18,9,4,9,3,21,12,5,0,81
18,9,4,9,3,21,12,5,4,85
18,9,4,9,3,21,12,5,18,99
18,9,4,9,3,21,12,5,19,100
18,9,4,9,5,19,20,0,0,84
18,9,4,9,14,7,0,0,0,61
18,9,4,9,14,7,13,1,14,89
18,9,4,9,14,7,13,5,14,93
18,9,4,9,14,7,19,0,0,80
18,9,4,12,5,25,19,0,0,92
18,9,4,15,20,20,15,0,0,101
18,9,4,15,20,20,15,19,0,120
18,9,4,19,0,0,0,0,0,50
18,25,5,7,18,1,19,19,0,112
18,9,5,12,19,0,0,0,0,63
18,9,5,13,0,0,0,0,0,45
18,9,5,13,16,9,5,0,0,75
18,25,5,14,0,0,0,0,0,62
18,25,5,16,5,3,11,0,0,83
18,9,5,18,0,0,0,0,0,50
18,25,5,19,0,0,0,0,0,67
18,9,5,22,5,18,0,0,0,77
18,9,5,22,5,18,19,0,0,96
18,9,6,1,13,16,9,14,0,86
18,9,6,1,18,20,0,0,0,72
18,9,6,5,0,0,0,0,0,38
18,9,6,5,12,25,0,0,0,75
18,9,6,5,14,5,19,19,0,95
18,9,6,5,18,0,0,0,0,56
18,9,6,5,19,20,0,0,0,77
18,9,6,6,5,4,0,0,0,48
18,9,6,6,9,14,7,0,0,69
18,9,6,6,12,5,4,0,0,60
18,9,6,6,12,5,18,0,0,74
18,9,6,6,12,5,18,19,0,93
18,9,6,6,12,5,19,0,0,75
18,9,6,6,12,9,14,7,0,81
18,9,6,6,18,1,6,6,0,70
18,9,6,6,18,1,6,6,19,89
18,9,6,12,5,0,0,0,0,50
18,9,6,12,5,2,9,18,4,83
18,9,6,12,5,4,0,0,0,54
18,9,6,12,5,4,15,13,0,82
18,9,6,12,5,9,20,5,0,84
18,9,6,12,5,13,1,14,0,78
18,9,6,12,5,13,5,14,0,82
18,9,6,12,5,18,0,0,0,68
18,9,6,12,5,18,25,0,0,93
18,9,6,12,5,18,9,5,19,101
18,9,6,12,5,18,19,0,0,87
18,9,6,12,5,19,0,0,0,69
18,9,6,12,5,19,8,15,20,112
18,9,6,12,9,14,7,0,0,75
18,9,6,12,9,14,7,19,0,94
18,9,6,19,0,0,0,0,0,52
18,9,6,20,0,0,0,0,0,53
18,9,6,20,5,4,0,0,0,62
18,9,6,20,5,18,0,0,0,76
18,9,6,20,25,0,0,0,0,78
18,9,6,20,9,14,7,0,0,83
18,9,6,20,12,5,19,19,0,108
18,9,6,20,19,0,0,0,0,72
18,9,7,0,0,0,0,0,0,34
18,9,7,1,4,9,7,0,0,55
18,9,7,1,4,15,14,0,0,68
18,9,7,1,4,15,15,14,0,83
18,9,7,1,4,15,15,14,19,102
18,9,7,1,13,1,10,9,7,75
18,9,7,1,20,9,15,14,0,93
18,9,7,1,20,15,14,9,0,93
18,9,7,1,20,15,14,9,19,112
18,9,7,1,21,4,15,14,0,89
18,9,7,1,21,4,15,14,19,108
18,9,7,2,1,14,5,0,0,56
18,9,7,5,19,3,5,14,20,100
18,9,7,7,1,12,0,0,0,54
18,9,7,7,1,12,4,0,0,58
18,9,7,7,5,4,0,0,0,50
18,9,7,7,5,18,0,0,0,64
18,9,7,7,5,18,19,0,0,83
18,9,7,7,9,14,7,0,0,71
18,9,7,7,9,14,7,19,0,90
18,9,7,7,9,19,8,0,0,77
18,9,7,7,9,20,5,0,0,75
18,9,7,7,15,20,0,0,0,76
18,9,7,8,20,0,0,0,0,62
18,9,7,8,20,1,2,12,5,82
18,9,7,8,20,5,4,0,0,71
18,9,7,8,20,5,14,0,0,81
18,9,7,8,20,5,15,21,19,122
18,9,7,8,20,5,18,0,0,85
18,9,7,8,20,5,18,19,0,104
18,9,7,8,20,5,19,20,0,106
18,9,7,8,20,6,21,12,0,101
18,9,7,8,20,8,1,14,4,89
18,9,7,8,20,25,0,0,0,87
18,9,7,8,20,9,5,19,0,95
18,9,7,8,20,9,14,7,0,92
18,9,7,8,20,9,19,8,0,98
18,9,7,8,20,9,19,13,0,103
18,9,7,8,20,9,19,13,19,122
18,9,7,8,20,9,19,20,0,110
18,9,7,8,20,9,19,20,19,129
18,9,7,8,20,12,5,0,0,79
18,9,7,8,20,12,5,19,19,117
18,9,7,8,20,12,25,0,0,99
18,9,7,8,20,13,15,19,20,129
18,9,7,8,20,14,5,19,19,119
18,9,7,8,20,15,0,0,0,77
18,9,7,8,20,19,0,0,0,81
18,9,7,8,20,19,8,9,16,114
18,9,7,8,20,23,1,18,4,108
18,9,7,9,4,0,0,0,0,47
18,9,7,9,4,9,6,25,0,87
18,9,7,9,4,9,19,20,0,95
18,9,7,9,4,9,20,25,0,101
18,9,7,9,4,12,25,0,0,84
18,9,7,9,4,14,5,19,19,104
18,9,7,9,14,1,12,0,0,70
18,9,7,12,5,20,0,0,0,71
18,9,7,12,9,14,7,0,0,76
18,9,7,13,1,18,5,5,0,76
18,9,7,13,1,18,15,12,5,98
18,9,7,14,21,13,0,0,0,82
18,9,7,15,4,15,14,0,0,82
18,9,7,15,12,0,0,0,0,61
18,9,7,15,12,5,0,0,0,66
18,9,7,15,12,5,20,0,0,86
18,9,7,15,12,5,20,20,5,111
18,9,7,15,18,0,0,0,0,67
18,9,7,15,18,9,19,13,0,108
18,9,7,15,18,9,19,13,19,127
18,9,7,15,18,9,19,20,0,115
18,9,7,15,18,9,19,20,19,134
18,9,7,15,18,15,21,19,0,122
18,9,7,15,18,19,0,0,0,86
18,9,7,15,21,18,0,0,0,88
18,9,7,15,21,18,9,19,13,129
18,9,7,15,21,18,9,19,20,136
18,9,7,15,21,18,19,0,0,107
18,9,7,19,0,0,0,0,0,53
18,9,7,19,2,25,0,0,0,80
18,9,7,19,4,1,12,5,18,93
18,9,7,21,5,21,18,0,0,99
18,9,7,23,9,4,4,25,0,99
18,9,7,23,9,4,4,9,5,88
18,9,7,23,15,15,4,9,5,105
18,9,25,1,12,0,0,0,0,65
18,9,25,1,12,19,0,0,0,84
18,25,11,5,0,0,0,0,0,59
18,25,11,5,4,0,0,0,0,63
18,25,11,5,19,0,0,0,0,78
18,25,11,9,14,7,0,0,0,84
18,9,11,9,19,8,1,0,0,75
18,9,11,9,19,8,1,19,0,94
18,9,11,11,0,0,0,0,0,49
18,9,11,19,8,1,0,0,0,66
18,9,11,19,8,1,19,0,0,85
18,9,11,19,8,1,23,0,0,89
18,9,11,19,8,1,23,19,0,108
18,9,12,1,23,1,0,0,0,64
18,9,12,5,0,0,0,0,0,44
18,9,12,5,4,0,0,0,0,48
18,9,12,5,19,0,0,0,0,63
18,9,12,9,5,22,9,0,0,84
18,9,12,9,5,22,15,0,0,90
18,9,12,9,14,7,0,0,0,69
18,9,12,12,0,0,0,0,0,51
18,9,12,12,5,0,0,0,0,56
18,9,12,12,5,4,0,0,0,60
18,9,12,12,5,19,0,0,0,75
18,9,12,12,5,20,0,0,0,76
18,9,12,12,5,20,19,0,0,95
18,9,12,12,5,20,20,0,0,96
18,9,12,12,5,20,20,5,0,101
18,9,12,12,5,20,20,5,19,120
18,9,12,12,25,0,0,0,0,76
18,9,12,12,9,14,7,0,0,81
18,9,12,12,15,3,11,0,0,80
18,9,12,12,15,23,0,0,0,89
18,9,12,12,19,0,0,0,0,70
18,9,12,12,19,20,15,14,5,124
18,9,13,1,12,0,0,0,0,53
18,9,13,1,20,5,0,0,0,66
18,9,13,1,20,9,15,14,0,99
18,9,13,2,1,19,5,0,0,67
18,9,13,5,0,0,0,0,0,45
18,25,13,5,0,0,0,0,0,61
18,9,13,5,4,0,0,0,0,49
18,9,13,5,12,5,19,19,0,100
18,9,13,5,18,0,0,0,0,63
18,9,13,5,18,25,0,0,0,88
18,9,13,5,18,19,0,0,0,82
18,9,13,5,19,0,0,0,0,64
18,9,13,5,19,20,5,18,0,107
18,9,13,5,19,20,5,18,19,126
18,9,13,6,9,18,5,0,0,78
18,9,13,6,9,18,5,19,0,97
18,9,13,25,0,0,0,0,0,65
18,9,13,9,5,18,0,0,0,72
18,9,13,9,5,19,20,0,0,93
18,9,13,9,6,15,18,13,0,101
18,9,13,9,14,5,19,19,0,106
18,9,13,9,14,7,0,0,0,70
18,9,13,12,1,14,4,0,0,71
18,9,13,12,1,14,4,19,0,90
18,9,13,12,5,19,19,0,0,95
18,9,13,13,1,11,5,18,0,88
18,9,13,13,1,11,9,14,7,95
18,9,13,13,5,4,0,0,0,62
18,9,13,13,5,18,0,0,0,76
18,9,13,13,5,18,19,0,0,95
18,9,13,13,9,14,7,0,0,83
18,9,13,15,19,5,0,0,0,79
18,9,13,15,19,5,12,25,0,116
18,9,13,15,19,9,20,25,0,128
18,9,13,15,21,19,0,0,0,95
18,9,13,16,9,0,0,0,0,65
18,9,13,16,12,5,0,0,0,73
18,9,13,16,12,5,4,0,0,77
18,9,13,16,12,5,19,0,0,92
18,9,13,16,12,9,14,7,0,98
18,9,13,16,20,9,15,14,0,114
18,9,13,16,20,9,15,14,19,133
18,9,13,18,15,3,11,0,0,87
18,9,13,18,15,3,11,19,0,106
18,9,13,19,0,0,0,0,0,59
18,9,13,19,20,15,14,5,0,113
18,9,13,21,0,0,0,0,0,61
18,9,13,21,12,1,0,0,0,74
18,9,13,21,12,15,19,5,0,112
18,9,14,0,0,0,0,0,0,41
18,9,14,3,5,1,21,0,0,71
18,9,14,3,5,1,21,24,0,95
18,9,14,3,8,0,0,0,0,52
18,25,14,4,0,0,0,0,0,61
18,9,14,4,5,4,0,0,0,54
18,9,14,4,25,0,0,0,0,70
18,9,14,4,12,5,0,0,0,62
18,9,14,4,12,5,19,19,0,100
18,9,14,4,19,0,0,0,0,64
18,25,14,4,19,0,0,0,0,80
18,9,14,5,0,0,0,0,0,46
18,9,14,7,1,2,12,5,0,68
18,9,14,7,2,1,18,11,0,80
18,9,14,7,2,1,18,11,19,99
18,9,14,7,2,9,12,12,0,83
18,9,14,7,2,9,18,4,0,81
18,9,14,7,2,15,12,20,0,97
18,9,14,7,2,15,12,20,19,116
18,9,14,7,2,15,14,5,0,84
18,9,14,7,2,15,14,5,4,88
18,9,14,7,2,15,14,5,19,103
18,9,14,7,3,18,1,6,20,96
18,9,14,7,4,15,22,5,0,94
18,9,14,7,4,15,22,5,19,113
18,9,14,7,5,4,0,0,0,57
18,9,14,7,5,25,5,0,0,83
18,9,14,7,5,14,20,0,0,87
18,9,14,7,5,18,0,0,0,71
18,9,14,7,5,18,19,0,0,90
18,9,14,7,7,9,20,0,0,84
18,9,14,7,7,9,22,5,18,109
18,9,14,7,7,15,5,18,0,93
18,9,14,7,8,1,12,19,0,88
18,9,14,7,8,5,1,4,0,66
18,9,14,7,25,0,0,0,0,73
18,9,14,7,9,14,5,19,19,114
18,9,14,7,9,14,7,0,0,78
18,9,14,7,9,14,7,12,25,115
18,9,14,7,9,14,7,19,0,97
18,9,14,7,9,20,5,0,0,82
18,9,14,7,12,5,1,4,0,70
18,9,14,7,12,5,19,19,0,103
18,9,14,7,12,5,20,0,0,85
18,9,14,7,12,5,20,5,4,94
18,9,14,7,12,5,20,25,0,110
18,9,14,7,12,5,20,19,0,104
18,9,14,7,12,9,11,5,0,85
18,9,14,7,13,1,11,5,18,96
18,9,14,7,13,1,14,0,0,76
18,9,14,7,14,5,3,11,0,81
18,9,14,7,14,5,3,11,19,100
18,9,14,7,19,0,0,0,0,67
18,9,14,7,19,1,9,12,0,89
18,9,14,7,19,9,4,5,0,85
18,9,14,7,19,9,4,5,18,103
18,9,14,7,19,9,4,5,19,104
18,9,14,7,19,20,5,18,0,110
18,9,14,7,19,20,9,3,11,110
18,9,14,7,20,1,9,12,0,90
18,9,14,7,20,1,9,12,19,109
18,9,14,7,20,1,23,0,0,92
18,9,14,7,20,1,23,19,0,111
18,9,14,7,20,9,13,5,0,95
18,9,14,7,20,15,19,19,0,121
18,9,14,7,23,1,12,11,0,95
18,9,14,7,23,1,12,12,0,96
18,9,14,7,23,9,19,5,0,104
18,9,14,7,23,15,18,13,0,117
18,9,14,7,23,15,18,13,19,136
18,9,14,11,0,0,0,0,0,52
18,9,14,11,1,0,0,0,0,53
18,9,14,11,5,18,0,0,0,75
18,9,14,11,9,20,5,0,0,86
18,9,14,11,19,0,0,0,0,71
18,9,14,14,5,9,20,5,0,94
18,9,14,14,5,18,0,0,0,78
18,9,14,14,9,14,7,0,0,85
18,9,14,19,0,0,0,0,0,60
18,9,14,19,1,2,12,5,0,80
18,9,14,19,5,0,0,0,0,65
18,9,14,19,5,4,0,0,0,69
18,9,14,19,5,18,0,0,0,83
18,9,14,19,5,18,19,0,0,102
18,9,14,19,5,19,0,0,0,84
18,9,14,19,9,2,12,5,0,88
18,9,14,19,9,14,7,0,0,90
18,9,14,19,9,14,7,19,0,109
18,25,14,20,0,0,0,0,0,77
18,9,15,2,9,20,19,21,0,113
18,9,15,10,1,19,0,0,0,72
18,25,15,11,1,14,0,0,0,84
18,25,15,11,1,14,19,0,0,103
18,9,15,20,0,0,0,0,0,62
18,25,15,20,0,0,0,0,0,78
18,9,15,20,5,4,0,0,0,71
18,9,15,20,5,18,0,0,0,85
18,9,15,20,5,18,19,0,0,104
18,9,15,20,9,14,7,0,0,92
18,9,15,20,9,14,7,12,25,129
18,9,15,20,9,19,5,0,0,95
18,9,15,20,9,19,20,0,0,110
18,9,15,20,9,19,20,9,3,122
18,9,15,20,15,21,19,0,0,117
18,9,15,20,15,21,19,12,25,154
18,9,15,20,16,18,15,15,6,132
18,9,15,20,18,25,0,0,0,105
18,9,15,20,19,0,0,0,0,81
18,25,15,20,19,0,0,0,0,97
18,25,15,20,23,1,18,0,0,120
18,25,15,20,23,1,18,9,0,129
18,25,15,20,23,1,18,25,0,145
18,9,16,1,0,0,0,0,0,44
18,9,16,1,12,0,0,0,0,56
18,9,16,1,18,9,1,12,0,84
18,9,16,1,18,9,1,14,0,86
18,9,16,1,18,9,15,21,19,126
18,9,16,3,15,18,4,0,0,83
18,9,16,3,15,18,4,19,0,102
18,25,16,5,0,0,0,0,0,64
18,25,16,5,3,11,0,0,0,78
18,9,16,5,4,0,0,0,0,52
18,9,16,5,12,25,0,0,0,85
18,9,16,5,12,9,11,5,0,85
18,9,16,5,14,0,0,0,0,62
18,9,16,5,14,5,4,0,0,71
18,9,16,5,14,5,18,0,0,85
18,9,16,5,14,5,18,19,0,104
18,9,16,5,14,5,19,19,0,105
18,9,16,5,14,9,14,7,0,92
18,9,16,5,14,19,0,0,0,81
18,9,16,5,18,0,0,0,0,66
18,9,16,5,19,0,0,0,0,67
18,9,16,5,19,20,0,0,0,87
18,9,16,7,21,20,0,0,0,91
18,9,16,9,5,14,9,0,0,80
18,9,16,9,5,14,9,19,20,119
18,9,16,9,5,14,15,0,0,86
18,9,16,9,5,14,15,19,0,105
18,9,16,9,5,18,0,0,0,75
18,9,16,9,14,7,0,0,0,73
18,9,16,15,6,6,0,0,0,70
18,9,16,15,6,6,19,0,0,89
18,9,16,15,19,20,0,0,0,97
18,9,16,15,19,20,5,0,0,102
18,9,16,15,19,20,5,4,0,106
18,9,16,15,19,20,5,19,0,121
18,9,16,15,19,20,9,14,7,127
18,9,16,15,19,20,19,0,0,116
18,9,16,16,1,2,12,5,0,79
18,9,16,16,5,4,0,0,0,68
18,9,16,16,5,18,0,0,0,82
18,9,16,16,5,18,13,1,14,110
18,9,16,16,5,18,13,5,14,114
18,9,16,16,5,18,19,0,0,101
18,9,16,16,5,20,0,0,0,84
18,9,16,16,9,5,18,0,0,91
18,9,16,16,9,14,7,0,0,89
18,9,16,16,9,14,7,12,25,126
18,9,16,16,9,20,0,0,0,88
18,9,16,16,12,5,0,0,0,76
18,9,16,16,12,5,4,0,0,80
18,9,16,16,12,5,18,0,0,94
18,9,16,16,12,5,18,19,0,113
18,9,16,16,12,5,19,0,0,95
18,9,16,16,12,5,20,0,0,96
18,9,16,16,12,5,20,19,0,115
18,9,16,16,12,25,0,0,0,96
18,9,16,16,12,9,5,18,0,103
18,9,16,16,12,9,5,19,20,124
18,9,16,16,12,9,14,7,0,101
18,9,16,18,1,16,0,0,0,78
18,9,16,18,1,16,16,5,4,103
18,9,16,18,1,16,19,0,0,97
18,9,16,19,1,3,11,0,0,77
18,9,16,19,1,23,0,0,0,86
18,9,16,19,1,23,19,0,0,105
18,9,16,19,20,15,14,5,0,116
18,9,16,19,20,15,16,0,0,113
18,9,16,19,20,15,16,19,0,132
18,9,16,20,9,4,5,0,0,81
18,9,16,20,9,4,5,19,0,100
18,9,16,21,16,0,0,0,0,80
18,9,18,15,18,9,18,15,0,120
18,9,19,1,12,1,0,0,0,60
18,9,19,1,12,4,1,18,0,82
18,9,19,2,5,18,13,0,0,84
18,9,19,4,1,12,5,18,0,86
18,9,19,5,14,0,0,0,0,65
18,9,19,5,18,0,0,0,0,69
18,9,19,5,18,19,0,0,0,88
18,9,19,5,18,22,1,0,0,92
18,9,19,5,19,0,0,0,0,70
18,9,19,8,9,0,0,0,0,63
18,9,19,8,9,19,0,0,0,82
18,9,19,8,20,1,4,1,18,98
18,9,19,9,2,12,5,0,0,74
18,9,19,9,2,12,5,19,0,93
18,9,19,9,2,12,25,0,0,94
18,9,19,9,14,7,0,0,0,76
18,9,19,9,14,7,19,0,0,95
18,9,19,11,0,0,0,0,0,57
18,9,19,11,5,4,0,0,0,66
18,9,19,11,5,18,0,0,0,80
18,9,19,11,5,18,19,0,0,99
18,9,19,11,6,21,12,0,0,96
18,9,19,11,25,0,0,0,0,82
18,9,19,11,9,5,18,0,0,89
18,9,19,11,9,5,19,20,0,110
18,9,19,11,9,12,25,0,0,103
18,9,19,11,9,14,5,19,19,123
18,9,19,11,9,14,7,0,0,87
18,9,19,11,9,19,8,0,0,93
18,9,19,11,12,5,19,19,0,112
18,9,19,11,16,18,15,15,6,127
18,9,19,11,19,0,0,0,0,76
18,9,19,15,18,9,1,12,0,101
18,9,19,15,18,9,21,19,0,128
18,9,19,15,18,19,5,0,0,103
18,9,19,15,20,20,15,0,0,116
18,9,19,15,20,20,15,19,0,135
18,9,19,16,0,0,0,0,0,62
18,9,19,16,5,18,0,0,0,85
18,9,19,16,5,20,20,15,0,122
18,9,19,16,15,19,20,1,0,117
18,9,19,17,21,0,0,0,0,84
18,9,19,17,21,5,0,0,0,89
18,9,19,17,21,5,5,0,0,94
18,9,19,19,5,12,0,0,0,82
18,9,19,19,12,5,0,0,0,82
18,9,19,19,15,9,4,0,0,93
18,9,19,19,15,12,5,0,0,97
18,9,19,19,15,12,5,19,0,116
18,9,19,19,15,13,0,0,0,93
18,9,19,20,15,18,9,0,0,108
18,9,19,21,19,0,0,0,0,86
18,9,19,21,19,5,19,0,0,110
18,9,20,1,12,25,14,14,5,118
18,9,20,1,18,4,0,0,0,70
18,9,20,1,18,4,19,0,0,89
18,9,20,3,8,5,25,0,0,88
18,9,20,5,0,0,0,0,0,52
18,9,20,5,12,5,19,19,0,107
18,9,20,5,12,25,0,0,0,89
18,9,20,5,14,21,20,15,0,122
18,9,20,5,19,0,0,0,0,71
18,9,20,8,5,0,0,0,0,60
18,25,20,9,4,15,19,9,19,138
18,9,20,12,9,14,7,0,0,89
18,9,20,13,1,19,20,5,18,123
18,9,20,15,18,14,5,12,0,111
18,9,20,18,1,20,20,15,0,121
18,9,20,19,21,0,0,0,0,87
18,9,20,20,5,18,19,0,0,109
18,9,20,20,15,3,11,0,0,96
18,9,20,21,1,12,0,0,0,81
18,9,20,21,1,12,5,0,0,86
18,9,20,21,1,12,9,19,5,114
18,9,20,21,1,12,9,19,13,122
18,9,20,21,1,12,9,19,20,129
18,9,20,21,1,12,9,20,25,135
18,9,20,21,1,12,9,26,5,121
18,9,20,21,1,12,12,25,0,118
18,9,20,21,1,12,19,0,0,100
18,9,20,21,19,0,0,0,0,87
18,9,20,26,5,19,0,0,0,97
18,9,20,26,25,0,0,0,0,98
18,9,20,26,9,5,18,0,0,105
18,9,20,26,9,5,19,20,0,126
18,9,20,26,9,12,25,0,0,119
18,9,20,26,9,14,5,19,19,139
18,9,22,0,0,0,0,0,0,49
18,9,22,1,7,5,0,0,0,62
18,9,22,1,7,5,19,0,0,81
18,9,22,1,12,0,0,0,0,62
18,9,22,1,12,1,2,12,5,82
18,9,22,1,12,5,4,0,0,71
18,9,22,1,12,5,19,19,0,105
18,9,22,1,12,9,14,7,0,92
18,9,22,1,12,9,19,13,0,103
18,9,22,1,12,9,20,25,0,116
18,9,22,1,12,9,26,5,0,102
18,9,22,1,12,12,5,4,0,83
18,9,22,1,12,12,5,19,19,117
18,9,22,1,12,12,9,14,7,104
18,9,22,1,12,18,25,0,0,105
18,9,22,1,12,18,9,5,19,113
18,9,22,1,12,18,15,21,19,135
18,9,22,1,12,19,0,0,0,81
18,9,22,1,12,19,8,9,16,114
18,9,22,5,0,0,0,0,0,54
18,9,22,5,4,0,0,0,0,58
18,9,22,5,4,5,18,3,9,93
18,9,22,5,12,0,0,0,0,66
18,9,22,5,12,5,4,0,0,75
18,9,22,5,12,9,14,7,0,96
18,9,22,5,12,12,0,0,0,78
18,9,22,5,12,12,5,4,0,87
18,9,22,5,14,0,0,0,0,68
18,9,22,5,18,1,9,14,0,96
18,9,22,5,18,2,5,4,0,83
18,9,22,5,18,2,5,4,19,102
18,9,22,5,18,2,15,1,20,110
18,9,22,5,18,2,21,19,8,122
18,9,22,5,18,4,1,13,16,106
18,9,22,5,18,5,4,0,0,81
18,9,22,5,18,5,20,0,0,97
18,9,22,5,18,8,15,15,4,114
18,9,22,5,18,25,0,0,0,97
18,9,22,5,18,9,14,5,0,100
18,9,22,5,18,9,14,5,19,119
18,9,22,5,18,9,19,8,0,108
18,9,22,5,18,12,5,19,19,127
18,9,22,5,18,12,5,20,0,109
18,9,22,5,18,12,25,0,0,109
18,9,22,5,18,12,9,11,5,109
18,9,22,5,18,12,9,14,7,114
18,9,22,5,18,13,1,14,0,100
18,9,22,5,18,13,5,14,0,104
18,9,22,5,18,23,1,25,0,121
18,9,22,5,18,23,1,18,4,118
18,9,22,5,18,23,1,19,8,123
18,9,22,5,18,23,5,5,4,109
18,9,22,5,18,23,9,19,5,128
18,9,22,5,20,0,0,0,0,74
18,9,22,5,20,5,4,0,0,83
18,9,22,5,20,5,18,0,0,97
18,9,22,5,20,5,18,19,0,116
18,9,22,5,20,8,5,1,4,92
18,9,22,5,20,9,14,7,0,104
18,9,22,5,20,12,5,19,19,129
18,9,22,5,20,12,9,11,5,111
18,9,22,5,20,19,0,0,0,93
18,9,22,5,20,20,5,4,0,103
18,9,22,5,20,20,9,14,7,124
18,9,22,9,5,18,1,19,0,101
18,9,22,9,5,18,5,0,0,86
18,9,22,9,5,18,5,19,0,105
18,9,22,9,14,7,0,0,0,79
18,9,22,9,14,7,12,25,0,116
18,9,22,15,0,0,0,0,0,64
18,9,22,15,19,5,0,0,0,88
18,9,22,21,12,5,20,0,0,107
18,9,22,21,12,5,20,19,0,126
18,9,22,21,12,15,19,5,0,121
18,9,22,21,12,21,19,0,0,122
18,9,24,0,0,0,0,0,0,51
18,9,24,1,20,18,9,24,0,123
18,9,24,4,1,12,5,18,0,91
18,9,24,25,0,0,0,0,0,76
18,9,26,1,18,0,0,0,0,72
18,9,26,9,6,15,18,13,0,114
18,9,26,26,1,18,0,0,0,98
18,9,26,26,5,18,0,0,0,102
18,9,26,26,12,5,0,0,0,96
18,9,26,26,15,13,0,0,0,107
18,9,26,26,15,13,5,4,0,116
18,9,26,26,15,14,9,20,5,142
18,12,5,0,0,0,0,0,0,35
18,12,25,0,0,0,0,0,0,55
18,13,15,21,12,1,4,5,0,89
18,14,4,0,0,0,0,0,0,36
18,15,2,1,12,9,20,15,0,92
18,15,2,1,12,15,0,0,0,63
18,15,2,1,12,15,19,0,0,82
18,15,2,1,14,4,0,0,0,54
18,15,2,1,14,4,19,0,0,73
18,15,2,2,5,4,0,0,0,46
18,15,2,2,5,18,0,0,0,60
18,15,2,2,5,18,25,0,0,85
18,15,2,2,5,18,9,5,19,93
18,15,2,2,5,18,19,0,0,79
18,15,2,2,9,14,7,0,0,67
18,15,2,5,0,0,0,0,0,40
18,15,2,5,4,0,0,0,0,44
18,15,2,5,12,5,19,19,0,95
18,15,2,5,18,0,0,0,0,58
18,15,2,5,18,4,0,0,0,62
18,15,2,5,19,0,0,0,0,59
18,15,2,8,1,8,0,0,0,52
18,15,2,9,14,7,0,0,0,65
18,15,2,9,14,9,14,0,0,81
18,15,2,12,5,0,0,0,0,52
18,15,2,12,5,19,0,0,0,71
18,15,2,15,13,2,0,0,0,65
18,15,2,15,18,1,14,20,0,103
18,15,2,15,18,1,14,20,19,122
18,15,2,15,18,1,20,5,0,94
18,15,2,15,18,5,1,14,0,88
18,15,2,15,18,5,15,21,19,128
18,15,2,15,20,0,0,0,0,70
18,15,2,15,20,9,1,14,0,94
18,15,2,15,20,9,3,0,0,82
18,15,2,15,20,9,3,19,0,101
18,15,2,15,20,9,19,13,0,111
18,15,2,15,20,9,19,13,19,130
18,15,2,15,20,9,26,5,0,110
18,15,2,15,20,9,26,5,4,114
18,15,2,15,20,9,26,5,19,129
18,15,2,15,20,12,9,11,5,107
18,15,2,15,20,18,25,0,0,113
18,15,2,15,20,18,9,5,19,121
18,15,2,15,20,19,0,0,0,89
18,15,2,19,0,0,0,0,0,54
18,15,2,21,18,0,0,0,0,74
18,15,2,21,18,9,20,5,0,108
18,15,2,21,19,20,0,0,0,95
18,15,2,21,19,20,5,18,0,118
18,15,2,21,19,20,5,19,20,139
18,15,2,21,19,20,6,21,12,134
18,15,2,21,19,20,9,3,0,107
18,15,2,21,19,20,9,20,25,149
18,15,2,21,19,20,12,25,0,132
18,15,3,1,9,12,12,5,0,75
18,15,3,1,13,2,15,12,5,84
18,15,3,3,5,12,12,9,3,80
18,15,3,3,5,12,12,9,14,91
18,15,3,8,5,12,9,13,5,88
18,15,3,8,5,20,0,0,0,69
18,15,3,8,5,20,5,4,0,78
18,15,3,8,5,20,19,0,0,88
18,15,3,8,9,14,7,0,0,74
18,15,3,9,5,19,20,0,0,89
18,15,3,11,1,2,25,0,0,75
18,15,3,11,1,2,25,5,0,80
18,15,3,11,1,2,9,5,19,83
18,15,3,11,1,2,25,5,19,99
18,15,3,11,1,2,12,5,0,67
18,15,3,11,1,2,12,25,0,87
18,15,3,11,1,20,0,0,0,68
18,15,3,11,1,23,1,25,19,116
18,15,3,11,2,5,12,12,0,78
18,15,3,11,2,5,18,18,25,115
18,15,3,11,2,9,18,4,0,80
18,15,3,11,2,15,18,14,0,96
18,15,3,11,2,15,21,14,4,103
18,15,3,11,2,18,21,19,8,115
18,15,3,11,3,9,19,20,0,98
18,15,3,11,3,18,1,6,20,95
18,15,3,11,5,4,0,0,0,56
18,15,3,11,5,12,1,25,0,90
18,15,3,11,5,18,5,4,0,79
18,15,3,11,5,18,25,0,0,95
18,15,3,11,5,18,9,5,19,103
18,15,3,11,5,18,19,0,0,89
18,15,3,11,5,20,0,0,0,72
18,15,3,11,5,20,5,4,0,81
18,15,3,11,5,20,5,5,18,100
18,15,3,11,5,20,5,18,0,95
18,15,3,11,5,20,5,18,19,114
18,15,3,11,5,20,25,0,0,97
18,15,3,11,5,20,9,14,7,102
18,15,3,11,5,20,15,18,0,105
18,15,3,11,5,20,18,25,0,115
18,15,3,11,5,20,19,0,0,91
18,15,3,11,6,1,12,12,19,97
18,15,3,11,6,9,19,8,0,89
18,15,3,11,6,15,9,12,0,89
18,15,3,11,8,1,9,18,0,83
18,15,3,11,9,5,18,0,0,79
18,15,3,11,9,5,19,20,0,100
18,15,3,11,9,14,5,19,19,113
18,15,3,11,9,14,7,0,0,77
18,15,3,11,9,14,7,12,25,114
18,15,3,11,9,19,8,0,0,83
18,15,3,11,12,1,25,0,0,85
18,15,3,11,12,5,19,19,0,102
18,15,3,11,12,5,20,0,0,84
18,15,3,11,12,9,11,5,0,84
18,15,3,11,12,9,14,7,0,89
18,15,3,11,12,9,14,7,19,108
18,15,3,11,13,1,14,0,0,75
18,15,3,11,15,15,14,0,0,91
18,15,3,11,15,15,14,19,0,110
18,15,3,11,18,15,19,5,0,104
18,15,3,11,18,15,19,5,19,123
18,15,3,11,19,0,0,0,0,66
18,15,3,11,19,8,1,6,20,101
18,15,3,11,19,12,9,4,5,96
18,15,3,11,19,20,1,6,6,99
18,15,3,11,20,18,5,5,0,95
18,15,3,11,23,1,18,4,0,93
18,15,3,11,23,1,18,4,19,112
18,15,3,11,23,5,5,4,0,84
18,15,3,11,23,5,5,4,19,103
18,15,3,11,23,15,18,11,0,114
18,15,3,11,23,15,18,11,19,133
18,15,3,15,3,15,0,0,0,69
18,15,3,15,3,15,19,0,0,88
18,15,3,15,12,15,0,0,0,78
18,15,3,19,0,0,0,0,0,55
18,15,3,20,1,0,0,0,0,57
18,15,4,4,5,4,0,0,0,50
18,15,4,4,5,14,0,0,0,60
18,15,4,4,5,18,0,0,0,64
18,15,4,4,5,18,19,0,0,83
18,15,4,4,9,11,9,14,0,84
18,15,4,4,9,14,0,0,0,64
18,15,4,4,9,14,7,0,0,71
18,15,4,5,0,0,0,0,0,42
18,15,4,5,14,20,0,0,0,76
18,15,4,5,14,20,9,1,12,98
18,15,4,5,14,20,9,1,14,100
18,15,4,5,14,20,19,0,0,95
18,15,4,5,15,0,0,0,0,57
18,15,4,5,15,19,0,0,0,76
18,15,4,8,1,13,0,0,0,59
18,15,4,9,14,7,0,0,0,67
18,15,4,9,14,7,9,20,5,101
18,15,4,11,14,9,7,8,20,106
18,15,4,12,5,19,19,0,0,92
18,15,4,12,5,20,0,0,0,74
18,15,4,12,9,11,5,0,0,74
18,15,4,13,1,11,5,18,0,85
18,15,4,13,5,14,0,0,0,69
18,15,4,15,13,15,14,20,0,114
18,15,4,19,0,0,0,0,0,56
18,15,4,19,13,1,14,0,0,84
18,15,4,19,13,5,14,0,0,88
18,15,4,19,20,5,18,0,0,99
18,15,4,23,15,15,4,0,0,94
18,15,5,2,21,3,11,0,0,75
18,15,5,2,21,3,11,19,0,94
18,15,5,4,0,0,0,0,0,42
18,15,5,25,0,0,0,0,0,63
18,15,5,12,9,11,5,0,0,75
18,15,5,13,5,18,0,0,0,74
18,15,5,13,5,18,19,0,0,93
18,15,5,14,5,14,7,0,0,78
18,15,5,14,20,7,5,14,19,117
18,15,5,19,0,0,0,0,0,57
18,15,5,19,20,15,14,5,0,111
18,15,7,1,14,0,0,0,0,55
18,15,7,1,20,9,15,14,0,99
18,15,7,1,20,9,15,14,19,118
18,15,7,1,20,9,22,5,0,97
18,15,7,1,20,15,18,25,0,119
18,15,7,5,18,9,1,14,0,87
18,15,7,5,18,19,9,20,5,116
18,15,7,7,12,5,0,0,0,64
18,15,7,14,15,14,0,0,0,83
18,15,7,14,15,14,19,0,0,102
18,15,7,21,5,0,0,0,0,66
18,15,7,21,5,4,0,0,0,70
18,15,7,21,5,4,15,13,0,98
18,15,7,21,5,9,14,7,0,96
18,15,7,21,5,12,9,14,7,108
18,15,7,21,5,18,25,0,0,109
18,15,7,21,5,18,9,5,19,117
18,15,7,21,5,19,0,0,0,85
18,15,7,21,5,19,8,9,16,118
18,15,7,21,25,0,0,0,0,86
18,15,7,21,9,14,7,0,0,91
18,15,7,21,9,19,8,0,0,97
18,15,7,21,9,19,8,12,25,134
18,15,8,1,14,0,0,0,0,56
18,15,8,15,2,0,0,0,0,58
18,15,8,21,14,0,0,0,0,76
18,15,8,21,14,1,0,0,0,77
18,15,25,1,12,5,0,0,0,76
18,15,25,1,12,5,20,0,0,96
18,15,25,1,12,9,19,5,0,104
18,15,25,1,12,9,19,5,4,108
18,15,25,1,12,9,19,13,0,112
18,15,25,1,12,9,19,13,19,131
18,15,25,1,12,9,19,20,0,119
18,15,25,1,12,9,19,20,19,138
18,15,25,1,12,9,26,5,0,111
18,15,25,1,12,9,26,5,4,115
18,15,25,1,12,12,25,0,0,108
18,15,25,1,12,13,1,19,20,124
18,15,25,1,12,13,5,0,0,89
18,15,25,1,12,19,0,0,0,90
18,15,25,1,12,20,25,0,0,116
18,15,25,1,12,20,9,5,19,124
18,15,25,5,20,0,0,0,0,83
18,15,25,5,20,14,5,19,19,140
18,15,25,5,20,15,21,19,0,138
18,15,9,12,0,0,0,0,0,54
18,15,9,12,5,4,0,0,0,63
18,15,9,12,25,0,0,0,0,79
18,15,9,12,9,5,18,0,0,86
18,15,9,12,9,5,19,20,0,107
18,15,9,12,9,14,7,0,0,84
18,15,9,12,19,0,0,0,0,73
18,15,9,14,0,0,0,0,0,56
18,15,9,14,9,19,8,0,0,92
18,15,25,14,15,21,19,0,0,127
18,15,25,15,21,0,0,0,0,94
18,15,9,19,20,5,18,0,0,104
18,15,25,19,20,5,18,0,0,120
18,15,9,19,20,5,18,5,4,113
18,15,25,19,20,5,18,5,4,129
18,15,9,19,20,5,18,5,18,127
18,15,9,19,20,5,18,12,25,141
18,15,9,19,20,5,18,19,0,123
18,15,25,19,20,5,18,19,0,139
18,15,9,20,0,0,0,0,0,62
18,15,25,20,0,0,0,0,0,78
18,15,9,20,5,12,5,20,0,104
18,15,10,1,11,0,0,0,0,55
18,15,11,1,0,0,0,0,0,45
18,15,11,5,0,0,0,0,0,49
18,15,11,5,1,7,5,0,0,62
18,15,11,5,5,0,0,0,0,54
18,15,11,5,25,0,0,0,0,74
18,15,11,5,12,1,25,0,0,87
18,15,11,5,18,0,0,0,0,67
18,15,11,25,0,0,0,0,0,69
18,15,12,1,13,9,20,5,0,93
18,15,12,1,13,9,20,5,19,112
18,15,12,5,0,0,0,0,0,50
18,15,12,5,15,0,0,0,0,65
18,15,12,5,19,0,0,0,0,69
18,15,12,12,0,0,0,0,0,57
18,15,12,12,1,2,12,5,0,77
18,15,12,12,1,23,1,25,0,107
18,15,12,12,2,1,3,11,0,74
18,15,12,12,2,1,3,11,19,93
18,15,12,12,2,1,18,0,0,78
18,15,12,12,5,4,0,0,0,66
18,15,12,12,5,25,0,0,0,87
18,15,12,12,5,25,23,1,25,136
18,15,12,12,5,10,5,5,0,82
18,15,12,12,5,18,0,0,0,80
18,15,12,12,5,18,5,18,0,103
18,15,12,12,5,18,13,1,14,108
18,15,12,12,5,18,19,0,0,99
18,15,12,12,9,3,8,5,0,82
18,15,12,12,9,3,8,9,5,91
18,15,12,12,9,3,11,0,0,80
18,15,12,12,9,3,11,5,4,89
18,15,12,12,9,3,11,5,18,103
18,15,12,12,9,3,11,25,0,105
18,15,12,12,9,3,11,19,0,99
18,15,12,12,9,14,7,0,0,87
18,15,12,12,9,14,7,12,25,124
18,15,12,12,9,14,7,19,0,106
18,15,12,12,9,24,0,0,0,90
18,15,12,12,13,1,14,0,0,85
18,15,12,12,13,15,16,0,0,101
18,15,12,12,13,15,16,19,0,120
18,15,12,12,14,5,3,11,0,90
18,15,12,12,15,3,11,0,0,86
18,15,12,12,15,21,20,0,0,113
18,15,12,12,15,21,20,19,0,132
18,15,12,12,15,22,5,18,0,117
18,15,12,12,15,22,5,18,19,136
18,15,12,12,19,0,0,0,0,76
18,15,12,12,20,15,16,0,0,108
18,15,12,12,23,1,25,0,0,106
18,15,12,12,23,1,25,19,0,125
18,15,12,15,23,1,25,0,0,109
18,15,12,16,5,14,19,0,0,99
18,15,13,1,9,11,1,0,0,68
18,15,13,1,9,14,5,19,0,94
18,15,13,1,12,0,0,0,0,59
18,15,13,1,14,1,0,0,0,62
18,15,13,1,14,3,5,1,14,84
18,15,13,1,14,3,5,4,0,73
18,15,13,1,14,3,5,18,0,87
18,15,13,1,14,3,5,18,19,106
18,15,13,1,14,3,5,19,0,88
18,15,13,1,14,3,25,0,0,89
18,15,13,1,14,3,9,14,7,94
18,15,13,1,14,3,9,19,20,112
18,15,13,1,14,9,21,13,0,104
18,15,13,1,14,9,26,5,4,105
18,15,13,1,14,9,26,5,19,120
18,15,13,1,14,15,19,0,0,95
18,15,13,1,14,20,9,3,0,93
18,15,13,1,14,20,9,3,19,112
18,15,13,1,14,20,9,19,13,122
18,15,13,1,14,20,9,19,20,129
18,15,13,1,14,26,1,0,0,88
18,15,13,1,21,14,20,0,0,102
18,15,13,1,21,14,20,19,0,121
18,15,13,2,12,5,0,0,0,65
18,15,13,2,15,19,0,0,0,82
18,15,13,5,9,14,5,0,0,79
18,15,13,5,9,20,5,0,0,85
18,15,13,5,15,19,0,0,0,85
18,15,13,5,18,9,12,12,15,117
18,15,13,5,18,15,0,0,0,84
18,15,13,5,18,15,19,0,0,103
18,15,13,25,11,15,0,0,0,97
18,15,13,13,1,3,11,0,0,74
18,15,13,16,0,0,0,0,0,62
18,15,13,16,5,4,0,0,0,71
18,15,13,16,5,5,0,0,0,72
18,15,13,16,5,18,0,0,0,85
18,15,13,16,5,18,19,0,0,104
18,15,13,16,25,0,0,0,0,87
18,15,13,16,9,14,7,0,0,92
18,15,13,16,9,14,7,12,25,129
18,15,13,16,9,19,8,0,0,98
18,15,13,16,9,19,8,12,25,135
18,15,13,16,19,0,0,0,0,81
18,15,13,16,21,0,0,0,0,83
18,15,13,19,0,0,0,0,0,65
18,15,14,3,1,4,15,18,0,88
18,15,14,3,5,20,0,0,0,75
18,15,14,3,8,15,0,0,0,73
18,15,14,3,15,19,0,0,0,84
18,15,14,4,0,0,0,0,0,51
18,15,14,4,1,3,8,5,0,68
18,15,14,4,1,3,8,5,18,86
18,15,14,4,1,23,5,12,0,92
18,15,14,4,5,0,0,0,0,56
18,15,14,4,5,1,21,0,0,78
18,15,14,4,5,1,21,24,0,102
18,15,14,4,5,12,0,0,0,68
18,15,14,4,5,12,5,20,0,93
18,15,14,4,5,12,5,20,19,112
18,15,14,4,5,12,9,5,18,100
18,15,14,4,5,12,12,5,0,85
18,15,14,4,5,12,12,5,19,104
18,15,14,4,5,12,19,0,0,87
18,15,14,4,9,14,15,0,0,89
18,15,14,4,12,5,0,0,0,68
18,15,14,4,15,0,0,0,0,66
18,15,14,4,15,19,0,0,0,85
18,15,14,4,21,18,5,0,0,95
18,15,14,4,21,18,5,19,0,114
18,15,14,7,5,21,18,0,0,98
18,15,14,7,7,5,14,7,0,87
18,15,14,9,5,18,0,0,0,79
18,15,14,9,14,0,0,0,0,70
18,15,14,9,15,14,0,0,0,85
18,15,14,25,15,14,0,0,0,101
18,15,14,9,15,14,19,0,0,104
18,15,14,25,15,14,19,0,0,120
18,15,14,14,5,12,0,0,0,78
18,15,14,14,5,12,19,0,0,97
18,15,14,17,21,9,12,0,0,106
18,15,14,20,7,5,14,19,0,112
18,15,15,0,0,0,0,0,0,48
18,15,15,4,0,0,0,0,0,52
18,15,15,4,5,2,15,11,0,85
18,15,15,4,12,5,0,0,0,69
18,15,15,4,12,5,19,0,0,88
18,15,15,4,19,0,0,0,0,71
18,15,15,4,19,20,15,14,5,125
18,15,15,5,4,0,0,0,0,57
18,15,15,6,0,0,0,0,0,54
18,15,15,6,1,7,5,0,0,67
18,15,15,6,5,4,0,0,0,63
18,15,15,6,5,18,0,0,0,77
18,15,15,6,5,18,19,0,0,96
18,15,15,6,25,0,0,0,0,79
18,15,15,6,9,14,7,0,0,84
18,15,15,6,9,14,7,19,0,103
18,15,15,6,12,5,19,19,0,109
18,15,15,6,12,5,20,0,0,91
18,15,15,6,12,9,11,5,0,91
18,15,15,6,12,9,14,5,0,94
18,15,15,6,12,9,14,5,19,113
18,15,15,6,13,1,14,0,0,82
18,15,15,6,13,5,14,0,0,86
18,15,15,6,16,15,12,5,0,102
18,15,15,6,19,0,0,0,0,73
18,15,15,6,20,15,16,0,0,105
18,15,15,6,20,15,16,19,0,124
18,15,15,6,20,18,5,5,0,102
18,15,15,6,20,18,5,5,19,121
18,15,15,6,23,1,18,4,0,100
18,15,15,6,23,9,19,5,0,110
18,15,15,9,2,15,11,0,0,85
18,15,15,25,5,2,15,11,0,106
18,15,15,9,14,5,11,0,0,87
18,15,15,9,14,7,0,0,0,78
18,15,15,11,0,0,0,0,0,59
18,15,15,11,5,4,0,0,0,68
18,15,15,11,5,18,25,0,0,107
18,15,15,11,5,18,9,5,4,100
18,15,15,11,5,18,9,5,19,115
18,15,15,11,25,0,0,0,0,84
18,15,15,11,9,5,0,0,0,73
18,15,15,11,9,5,18,0,0,91
18,15,15,11,9,5,19,0,0,92
18,15,15,11,9,5,19,20,0,112
18,15,15,11,9,14,7,0,0,89
18,15,15,11,9,19,8,0,0,95
18,15,15,11,12,5,20,0,0,96
18,15,15,11,12,9,11,5,0,96
18,15,15,11,19,0,0,0,0,78
18,15,15,11,21,19,0,0,0,99
18,15,15,12,0,0,0,0,0,60
18,15,15,13,0,0,0,0,0,61
18,15,15,13,1,7,5,0,0,74
18,15,15,13,5,4,0,0,0,70
18,15,15,13,5,18,0,0,0,84
18,15,15,13,5,18,19,0,0,103
18,15,15,13,5,20,20,5,0,111
18,15,15,13,5,20,20,5,19,130
18,15,15,13,6,21,12,0,0,100
18,15,15,13,6,21,12,19,0,119
18,15,15,13,25,0,0,0,0,86
18,15,15,13,9,5,0,0,0,75
18,15,15,13,9,5,18,0,0,93
18,15,15,13,9,5,19,0,0,94
18,15,15,13,9,5,19,20,0,114
18,15,15,13,9,12,25,0,0,107
18,15,15,13,9,14,5,19,19,127
18,15,15,13,9,14,7,0,0,91
18,15,15,13,12,5,19,19,0,116
18,15,15,13,12,5,20,0,0,98
18,15,15,13,13,1,20,5,0,100
18,15,15,13,13,1,20,5,19,119
18,15,15,13,19,0,0,0,0,80
18,15,15,13,19,6,21,12,0,119
18,15,15,13,19,15,13,5,0,113
18,15,15,13,19,20,5,1,4,110
18,15,15,13,20,8,0,0,0,89
18,15,15,13,20,8,25,0,0,114
18,15,15,13,20,8,9,12,25,135
18,15,15,13,23,1,18,4,0,107
18,15,15,14,0,0,0,0,0,62
18,15,15,16,0,0,0,0,0,64
18,15,15,18,2,1,3,8,0,80
18,15,15,18,2,1,3,11,0,83
18,15,15,18,2,1,3,11,19,102
18,15,15,19,1,0,0,0,0,68
18,15,15,19,5,4,0,0,0,76
18,15,15,19,5,18,0,0,0,90
18,15,15,19,5,18,19,0,0,109
18,15,15,19,5,19,0,0,0,91
18,15,15,19,9,14,7,0,0,97
18,15,15,19,20,5,4,0,0,96
18,15,15,19,20,5,18,0,0,110
18,15,15,19,20,5,18,19,0,129
18,15,15,19,20,25,0,0,0,112
18,15,15,19,20,9,14,7,0,117
18,15,15,19,20,19,0,0,0,106
18,15,15,20,1,7,5,0,0,81
18,15,15,20,1,7,5,19,0,100
18,15,15,20,3,1,16,0,0,88
18,15,15,20,5,4,0,0,0,77
18,15,15,20,5,4,12,25,0,114
18,15,15,20,5,18,0,0,0,91
18,15,15,20,5,18,25,0,0,116
18,15,15,20,5,18,19,0,0,110
18,15,15,20,6,1,19,20,0,114
18,15,15,20,8,15,12,4,0,107
18,15,15,20,8,15,12,4,19,126
18,15,15,20,9,0,0,0,0,77
18,15,15,20,25,0,0,0,0,93
18,15,15,20,9,5,18,0,0,100
18,15,15,20,9,5,19,20,0,121
18,15,15,20,9,14,5,19,19,134
18,15,15,20,9,14,7,0,0,98
18,15,15,20,12,5,0,0,0,85
18,15,15,20,12,5,19,19,0,123
18,15,15,20,12,5,20,0,0,105
18,15,15,20,12,5,20,19,0,124
18,15,15,20,12,9,11,5,0,105
18,15,15,20,12,9,14,7,0,110
18,15,15,20,19,20,1,12,11,131
18,15,15,20,19,20,15,3,11,136
18,15,15,20,23,1,12,20,0,124
18,15,15,20,23,1,18,4,0,114
18,15,15,20,23,9,19,5,0,124
18,15,15,20,23,15,18,13,0,137
18,15,15,22,5,0,0,0,0,75
18,15,15,22,5,4,0,0,0,79
18,15,15,22,9,14,7,0,0,100
18,15,16,1,2,12,5,0,0,69
18,15,16,1,14,4,0,0,0,68
18,15,16,1,14,9,0,0,0,73
18,15,16,5,0,0,0,0,0,54
18,15,16,5,1,2,12,5,0,74
18,15,16,5,2,1,14,4,0,75
18,15,16,5,2,1,18,11,0,86
18,15,16,5,4,0,0,0,0,58
18,15,16,5,4,1,14,3,5,81
18,15,16,5,25,0,0,0,0,79
18,15,16,5,12,1,25,5,18,115
18,15,16,5,12,9,11,5,0,91
18,15,16,5,13,1,11,5,18,102
18,15,16,5,13,1,14,0,0,82
18,15,16,5,13,5,14,0,0,86
18,15,16,5,18,25,0,0,0,97
18,15,16,5,18,9,5,19,0,105
18,15,16,5,18,9,16,5,0,102
18,15,16,5,18,19,0,0,0,91
18,15,16,5,19,0,0,0,0,73
18,15,16,5,19,13,9,20,8,123
18,15,16,5,20,18,9,3,11,115
18,15,16,5,23,1,25,0,0,103
18,15,16,5,23,1,25,19,0,122
18,15,16,5,23,1,12,11,0,101
18,15,16,5,23,1,12,11,19,120
18,15,16,5,23,15,18,11,0,121
18,15,16,25,0,0,0,0,0,74
18,15,16,9,5,18,0,0,0,81
18,15,16,9,5,19,20,0,0,102
18,15,16,9,12,25,0,0,0,95
18,15,16,9,14,5,19,19,0,115
18,15,16,9,14,7,0,0,0,79
18,15,16,9,19,8,0,0,0,85
18,15,16,12,15,3,8,0,0,87
18,15,16,16,0,0,0,0,0,65
18,15,17,21,5,18,0,0,0,94
18,15,17,21,5,19,0,0,0,95
18,15,17,21,5,20,0,0,0,96
18,15,17,21,5,20,5,4,0,105
18,15,17,21,5,20,9,14,7,126
18,15,17,21,5,20,19,0,0,115
18,15,17,21,5,20,20,5,0,121
18,15,17,21,9,12,12,5,0,109
18,15,17,21,9,19,20,0,0,119
18,15,18,1,12,0,0,0,0,64
18,15,18,1,20,15,18,9,15,129
18,15,18,9,3,0,0,0,0,63
18,15,18,9,4,0,0,0,0,64
18,15,18,17,21,1,12,0,0,102
18,15,18,17,21,1,12,19,0,121
18,15,18,19,3,8,1,3,8,93
18,15,18,20,0,0,0,0,0,71
18,15,18,20,25,0,0,0,0,96
18,15,18,21,12,5,14,20,0,123
18,15,19,1,3,5,0,0,0,61
18,15,19,1,3,5,1,14,0,76
18,15,19,1,3,5,15,21,19,116
18,15,19,1,11,5,18,0,0,87
18,15,19,1,12,0,0,0,0,65
18,15,19,1,12,7,5,18,0,95
18,15,19,1,14,9,12,9,14,111
18,15,19,1,18,9,1,0,0,81
18,15,19,1,18,9,1,14,0,95
18,15,19,1,18,9,1,14,19,114
18,15,19,1,18,9,5,19,0,104
18,15,19,1,18,9,9,1,0,90
18,15,19,1,18,9,21,13,0,114
18,15,19,1,18,9,21,13,19,133
18,15,19,1,18,21,2,25,0,119
18,15,19,1,20,5,4,0,0,82
18,15,19,2,9,6,0,0,0,69
18,15,19,3,9,4,0,0,0,68
18,15,19,3,15,5,19,0,0,94
18,15,19,5,1,12,0,0,0,70
18,15,19,5,1,20,5,0,0,83
18,15,19,5,1,20,5,12,25,120
18,15,19,5,2,1,25,0,0,85
18,15,19,5,2,1,25,19,0,104
18,15,19,5,2,21,4,19,0,103
18,15,19,5,2,21,19,8,0,107
18,15,19,5,4,0,0,0,0,61
18,15,19,5,4,18,15,16,0,110
18,15,19,5,6,9,19,8,0,99
18,15,19,5,8,5,1,4,0,75
18,15,19,5,8,9,12,12,0,98
18,15,19,5,8,9,16,0,0,90
18,15,19,5,9,14,5,0,0,85
18,15,19,5,12,5,19,19,0,112
18,15,19,5,12,5,20,0,0,94
18,15,19,5,12,9,11,5,0,94
18,15,19,5,12,9,20,5,0,103
18,15,19,5,12,12,1,20,5,107
18,15,19,5,12,12,5,19,0,105
18,15,19,5,15,12,1,0,0,85
18,15,19,5,15,12,1,18,0,103
18,15,19,5,15,12,1,19,0,104
18,15,19,5,15,12,15,21,19,139
18,15,19,5,15,21,19,0,0,112
18,15,19,5,18,0,0,0,0,75
18,15,19,5,18,25,0,0,0,100
18,15,19,5,18,9,5,19,0,108
18,15,19,5,18,15,15,20,0,125
18,15,19,5,18,15,15,20,19,144
18,15,19,5,19,0,0,0,0,76
18,15,19,5,19,12,21,7,0,116
18,15,19,5,20,0,0,0,0,77
18,15,19,5,20,1,14,0,0,92
18,15,19,5,20,25,0,0,0,102
18,15,19,5,20,9,13,5,0,104
18,15,19,5,20,19,0,0,0,96
18,15,19,5,20,20,5,4,0,106
18,15,19,5,20,20,5,19,0,121
18,15,19,5,20,20,25,0,0,122
18,15,19,5,20,21,13,0,0,111
18,15,19,5,23,1,25,19,0,125
18,15,19,5,23,1,20,5,18,124
18,15,19,5,23,9,19,5,0,113
18,15,19,5,23,15,15,4,19,133
18,15,19,5,23,15,18,20,0,133
18,15,19,8,9,0,0,0,0,69
18,15,19,9,5,4,0,0,0,70
18,15,19,9,5,18,0,0,0,84
18,15,19,9,5,19,20,0,0,105
18,15,19,9,12,25,0,0,0,98
18,15,19,9,12,12,1,0,0,86
18,15,19,9,12,12,15,0,0,100
18,15,19,9,14,0,0,0,0,75
18,15,19,9,14,1,20,5,0,101
18,15,19,9,14,5,4,0,0,84
18,15,19,9,14,5,19,19,0,118
18,15,19,9,14,7,0,0,0,82
18,15,19,9,14,25,0,0,0,100
18,15,19,9,14,9,14,7,0,105
18,15,19,9,14,15,12,0,0,102
18,15,19,9,14,15,12,19,0,121
18,15,19,9,14,15,21,19,0,130
18,15,19,9,14,19,0,0,0,94
18,15,19,9,14,23,5,5,4,112
18,15,19,9,14,23,15,15,4,132
18,15,19,12,1,14,4,0,0,83
18,15,19,13,1,18,9,14,5,112
18,15,19,15,12,9,0,0,0,88
18,15,19,15,12,9,3,0,0,91
18,15,19,15,12,9,15,0,0,103
18,15,19,15,12,9,15,19,0,122
18,15,19,15,12,9,20,5,0,113
18,15,19,15,18,9,1,12,0,107
18,15,19,19,9,20,5,0,0,105
18,15,19,20,5,12,0,0,0,89
18,15,19,20,5,12,12,1,0,102
18,15,19,20,5,12,12,1,18,120
18,15,19,20,5,12,12,21,13,135
18,15,19,20,5,18,0,0,0,95
18,15,19,20,5,18,19,0,0,114
18,15,19,20,18,1,0,0,0,91
18,15,19,20,18,1,12,0,0,103
18,15,19,20,18,1,12,12,25,140
18,15,19,20,18,1,20,5,0,116
18,15,19,20,18,1,20,5,4,120
18,15,19,20,18,15,9,4,0,118
18,15,19,20,18,21,12,1,18,142
18,15,19,20,18,21,12,21,13,157
18,15,19,20,18,21,13,0,0,124
18,15,19,20,18,21,13,19,0,143
18,15,19,20,20,18,1,0,0,111
18,15,19,21,12,1,18,0,0,104
18,15,19,21,12,1,20,5,0,111
18,15,20,1,3,9,19,13,0,98
18,15,20,1,12,9,1,14,0,90
18,15,20,1,13,1,14,0,0,82
18,15,20,1,13,5,14,0,0,86
18,15,20,1,14,7,0,0,0,75
18,15,20,1,18,9,5,19,0,105
18,15,20,1,19,0,0,0,0,73
18,15,20,1,19,3,15,16,5,112
18,15,20,1,20,1,2,12,5,94
18,15,20,1,20,1,2,12,25,114
18,15,20,1,20,5,0,0,0,79
18,15,20,1,20,5,4,0,0,83
18,15,20,1,20,5,19,0,0,98
18,15,20,1,20,9,14,7,0,104
18,15,20,1,20,9,15,14,0,112
18,15,20,1,20,9,15,14,19,131
18,15,20,1,20,9,22,5,0,110
18,15,20,1,20,15,18,0,0,107
18,15,20,1,20,15,18,5,19,131
18,15,20,1,20,15,18,25,0,132
18,15,20,1,20,15,18,19,0,126
18,15,20,1,22,9,19,20,0,124
18,15,20,3,8,0,0,0,0,64
18,15,20,3,8,5,0,0,0,69
18,15,20,3,8,5,19,0,0,88
18,15,20,5,0,0,0,0,0,58
18,15,20,5,12,12,1,0,0,83
18,15,20,5,14,15,14,5,0,106
18,15,20,5,14,15,14,5,19,125
18,15,20,5,19,0,0,0,0,77
18,15,20,7,5,0,0,0,0,65
18,15,20,7,21,20,0,0,0,101
18,15,20,7,21,20,19,0,0,120
18,15,20,9,6,5,18,0,0,91
18,15,20,9,6,5,18,1,12,104
18,15,20,9,6,5,18,1,14,106
18,15,20,9,6,5,18,19,0,110
18,15,20,9,6,15,18,13,0,114
18,15,20,12,19,0,0,0,0,84
18,15,20,15,0,0,0,0,0,68
18,15,20,15,3,18,1,6,20,116
18,15,20,15,4,25,14,5,0,116
18,15,20,15,7,18,1,16,8,118
18,15,20,15,13,5,20,5,18,129
18,15,20,15,14,4,1,0,0,87
18,15,20,15,14,4,5,0,0,91
18,15,20,15,18,0,0,0,0,86
18,15,20,15,18,19,0,0,0,105
18,15,20,15,19,0,0,0,0,87
18,15,20,15,20,9,12,12,0,121
18,15,20,15,20,9,12,12,19,140
18,15,20,16,18,15,15,6,0,123
18,15,20,20,1,0,0,0,0,74
18,15,20,20,1,14,0,0,0,88
18,15,20,20,5,0,0,0,0,78
18,15,20,20,5,4,0,0,0,82
18,15,20,20,5,14,0,0,0,92
18,15,20,20,5,14,5,18,0,115
18,15,20,20,5,14,5,19,20,136
18,15,20,20,5,14,9,19,8,128
18,15,20,20,5,14,12,25,0,129
18,15,20,20,5,18,0,0,0,96
18,15,20,20,5,18,19,0,0,115
18,15,20,20,5,19,0,0,0,97
18,15,20,20,9,14,7,0,0,103
18,15,20,20,12,5,0,0,0,90
18,15,20,20,12,5,18,1,0,109
18,15,20,20,12,5,18,9,14,131
18,15,20,20,15,3,11,0,0,102
18,15,20,20,15,12,15,0,0,115
18,15,20,21,12,1,0,0,0,87
18,15,20,21,12,1,4,0,0,91
18,15,20,21,12,1,18,0,0,105
18,15,20,21,12,5,20,0,0,111
18,15,20,21,12,9,1,14,0,110
18,15,20,21,12,21,19,0,0,126
18,15,20,21,14,4,0,0,0,92
18,15,20,21,14,4,1,0,0,93
18,15,20,21,14,4,1,19,0,112
18,15,20,21,14,4,1,20,5,118
18,15,20,21,14,4,9,6,25,132
18,15,20,21,14,4,9,20,25,146
18,15,20,21,14,4,12,25,0,129
18,15,20,21,14,4,15,0,0,107
18,15,20,21,18,5,0,0,0,97
18,15,20,21,18,9,5,18,0,124
18,15,20,21,18,9,5,18,19,143
18,15,21,2,0,0,0,0,0,56
18,15,21,2,12,5,0,0,0,73
18,15,21,2,12,5,19,0,0,92
18,15,21,2,15,21,8,0,0,100
18,15,21,3,8,5,0,0,0,70
18,15,21,3,8,5,19,0,0,89
18,15,21,3,15,21,0,0,0,93
18,15,21,4,0,0,0,0,0,58
18,15,21,4,1,19,0,0,0,78
18,15,21,5,0,0,0,0,0,59
18,15,21,5,12,12,5,0,0,88
18,15,21,5,14,19,0,0,0,92
18,15,21,5,18,9,5,0,0,91
18,15,21,5,19,0,0,0,0,78
18,15,21,7,5,0,0,0,0,66
18,15,21,7,5,1,21,0,0,88
18,15,21,7,5,4,0,0,0,70
18,15,21,7,5,12,9,11,5,103
18,15,21,7,5,15,20,0,0,101
18,15,21,7,5,19,0,0,0,85
18,15,21,7,8,0,0,0,0,69
18,15,21,7,8,1,7,5,0,82
18,15,21,7,8,1,7,5,19,101
18,15,21,7,8,3,1,19,20,112
18,15,21,7,8,4,18,1,23,115
18,15,21,7,8,4,18,25,0,116
18,15,21,7,8,5,4,0,0,78
18,15,21,7,8,5,14,0,0,88
18,15,21,7,8,5,14,5,4,97
18,15,21,7,8,5,14,5,18,111
18,15,21,7,8,5,14,19,0,107
18,15,21,7,8,5,18,0,0,92
18,15,21,7,8,5,18,19,0,111
18,15,21,7,8,5,19,20,0,113
18,15,21,7,8,5,20,0,0,94
18,15,21,7,8,8,5,23,0,105
18,15,21,7,8,8,5,23,14,119
18,15,21,7,8,8,5,23,19,124
18,15,21,7,8,25,0,0,0,94
18,15,21,7,8,9,5,0,0,83
18,15,21,7,8,9,14,7,0,99
18,15,21,7,8,9,14,7,19,118
18,15,21,7,8,9,19,8,0,105
18,15,21,7,8,12,5,7,0,93
18,15,21,7,8,12,5,7,19,112
18,15,21,7,8,12,25,0,0,106
18,15,21,7,8,14,5,3,11,102
18,15,21,7,8,14,5,19,19,126
18,15,21,7,8,18,9,4,5,105
18,15,21,7,8,18,15,15,20,137
18,15,21,7,8,19,0,0,0,88
18,15,21,7,8,19,8,15,4,115
18,15,21,7,8,19,15,13,5,121
18,15,21,7,8,20,0,0,0,89
18,15,21,7,8,20,1,9,12,111
18,15,21,7,8,23,15,18,11,136
18,15,21,7,25,0,0,0,0,86
18,15,21,7,9,14,7,0,0,91
18,15,21,9,12,12,5,0,0,92
18,15,21,9,12,12,5,19,0,111
18,15,21,11,25,0,0,0,0,90
18,15,21,12,1,4,5,0,0,76
18,15,21,12,1,4,5,19,0,95
18,15,21,12,5,1,21,0,0,93
18,15,21,12,5,1,21,19,0,112
18,15,21,12,5,1,21,24,0,117
18,15,21,12,5,20,20,5,0,116
18,15,21,12,5,20,20,5,4,120
18,15,21,12,5,20,20,5,19,135
18,15,21,14,0,0,0,0,0,68
18,15,21,14,3,5,0,0,0,76
18,15,21,14,3,5,22,1,12,111
18,15,21,14,3,25,0,0,0,96
18,15,21,14,3,9,22,1,12,115
18,15,21,14,4,0,0,0,0,72
18,15,21,14,4,5,4,0,0,81
18,15,21,14,4,5,4,12,25,118
18,15,21,14,4,5,12,0,0,89
18,15,21,14,4,5,12,1,25,115
18,15,21,14,4,5,12,19,0,108
18,15,21,14,4,5,18,0,0,95
18,15,21,14,4,5,18,19,0,114
18,15,21,14,4,5,19,20,0,116
18,15,21,14,4,6,9,19,8,114
18,15,21,14,4,8,5,5,12,102
18,15,21,14,4,25,0,0,0,97
18,15,21,14,4,9,14,7,0,102
18,15,21,14,4,9,19,8,0,108
18,15,21,14,4,12,5,0,0,89
18,15,21,14,4,12,5,20,0,109
18,15,21,14,4,12,5,20,19,128
18,15,21,14,4,12,25,0,0,109
18,15,21,14,4,12,9,14,5,112
18,15,21,14,4,14,5,19,19,129
18,15,21,14,4,14,15,19,5,125
18,15,21,14,4,15,6,6,0,99
18,15,21,14,4,19,0,0,0,91
18,15,21,14,4,19,5,1,13,110
18,15,21,14,4,19,13,1,14,119
18,15,21,14,4,20,1,9,12,114
18,15,21,14,4,20,15,16,0,123
18,15,21,14,4,20,18,5,5,120
18,15,21,14,4,21,16,0,0,109
18,15,21,14,4,21,16,19,0,128
18,15,21,14,4,21,18,5,0,116
18,15,21,14,4,23,9,19,5,128
18,15,21,14,4,23,15,15,4,129
18,15,21,14,4,23,15,18,13,141
18,15,21,14,7,5,0,0,0,80
18,15,21,14,19,16,9,11,0,123
18,15,21,14,20,18,5,5,0,116
18,15,21,16,0,0,0,0,0,70
18,15,21,16,5,4,0,0,0,79
18,15,21,16,5,18,0,0,0,93
18,15,21,16,5,20,0,0,0,95
18,15,21,16,25,0,0,0,0,95
18,15,21,16,9,5,0,0,0,84
18,15,21,16,9,5,18,0,0,102
18,15,21,16,9,5,19,20,0,123
18,15,21,16,9,12,25,0,0,116
18,15,21,16,9,14,7,0,0,100
18,15,21,16,9,20,0,0,0,99
18,15,21,16,19,0,0,0,0,89
18,15,21,19,1,14,20,0,0,108
18,15,21,19,5,0,0,0,0,78
18,15,21,19,5,4,0,0,0,82
18,15,21,19,5,13,5,14,20,130
18,15,21,19,5,18,0,0,0,96
18,15,21,19,5,18,19,0,0,115
18,15,21,19,5,19,0,0,0,97
18,15,21,19,5,20,20,5,0,123
18,15,21,19,9,14,7,0,0,103
18,15,21,19,9,14,7,12,25,140
18,15,21,19,19,5,1,21,19,138
18,15,21,19,19,5,20,20,5,142
18,15,21,19,20,0,0,0,0,93
18,15,21,19,20,5,4,0,0,102
18,15,21,19,20,5,18,0,0,116
18,15,21,19,20,5,18,19,0,135
18,15,21,19,20,9,14,7,0,123
18,15,21,19,20,19,0,0,0,112
18,15,21,20,0,0,0,0,0,74
18,15,21,20,5,0,0,0,0,79
18,15,21,20,5,4,0,0,0,83
18,15,21,20,5,13,1,14,0,107
18,15,21,20,5,13,5,14,0,111
18,15,21,20,5,18,0,0,0,97
18,15,21,20,5,18,19,0,0,116
18,15,21,20,5,19,0,0,0,98
18,15,21,20,5,23,1,25,0,128
18,15,21,20,5,23,1,25,19,147
18,15,21,20,8,25,0,0,0,107
18,15,21,20,8,9,5,0,0,96
18,15,21,20,8,19,0,0,0,101
18,15,21,20,9,5,18,0,0,106
18,15,21,20,9,14,1,18,25,141
18,15,21,20,9,14,5,0,0,102
18,15,21,20,9,14,5,5,18,125
18,15,21,20,9,14,5,12,25,139
18,15,21,20,9,14,5,19,0,121
18,15,21,20,9,14,7,0,0,104
18,15,21,20,9,14,7,19,0,123
18,15,21,20,9,14,9,19,8,133
18,15,21,20,9,14,9,19,13,138
18,15,21,20,9,14,9,19,20,145
18,15,21,20,9,14,9,26,5,137
18,15,21,20,15,21,19,0,0,129
18,15,21,20,15,21,19,12,25,166
18,15,21,20,19,0,0,0,0,93
18,15,22,5,0,0,0,0,0,60
18,15,22,5,4,0,0,0,0,64
18,15,22,5,14,0,0,0,0,74
18,15,22,5,18,19,0,0,0,97
18,15,22,5,19,0,0,0,0,79
18,15,22,5,19,3,9,15,0,106
18,15,22,5,20,0,0,0,0,80
18,15,22,5,20,20,15,0,0,115
18,15,22,9,14,7,0,0,0,85
18,15,22,9,14,7,12,25,0,122
18,15,22,9,14,7,19,0,0,104
18,15,23,1,2,12,5,0,0,76
18,15,23,1,14,19,0,0,0,90
18,15,23,2,15,1,20,0,0,94
18,15,23,2,15,1,20,19,0,113
18,15,23,4,25,0,0,0,0,85
18,15,23,4,25,4,15,23,0,127
18,15,23,4,9,5,18,0,0,92
18,15,23,4,9,5,19,0,0,93
18,15,23,4,9,5,19,20,0,113
18,15,23,4,25,9,19,8,0,121
18,15,23,4,25,9,19,13,0,126
18,15,23,4,25,9,19,13,19,145
18,15,23,4,9,12,25,0,0,106
18,15,23,4,9,14,5,19,19,126
18,15,23,5,4,0,0,0,0,65
18,15,23,5,12,0,0,0,0,73
18,15,23,5,12,5,4,0,0,82
18,15,23,5,12,8,5,1,4,91
18,15,23,5,12,9,14,7,0,103
18,15,23,5,12,12,5,4,0,94
18,15,23,5,12,12,9,14,7,115
18,15,23,5,12,19,0,0,0,92
18,15,23,5,14,19,0,0,0,94
18,15,23,5,18,0,0,0,0,79
18,15,23,5,18,19,0,0,0,98
18,15,23,5,20,0,0,0,0,81
18,15,23,25,0,0,0,0,0,81
18,15,23,9,14,5,19,19,0,122
18,15,23,9,14,7,0,0,0,86
18,15,23,9,14,7,19,0,0,105
18,15,23,12,5,20,0,0,0,93
18,15,23,12,15,3,11,0,0,97
18,15,23,12,15,3,11,19,0,116
18,15,23,16,15,18,20,0,0,125
18,15,23,19,0,0,0,0,0,75
18,15,23,20,0,0,0,0,0,76
18,15,23,20,5,0,0,0,0,81
18,15,23,20,5,4,0,0,0,85
18,15,23,20,8,0,0,0,0,84
18,15,23,20,8,19,0,0,0,103
18,15,23,20,25,0,0,0,0,101
18,15,23,20,9,14,7,0,0,106
18,15,24,2,21,18,7,8,5,118
18,15,26,5,14,5,18,0,0,101
18,15,26,21,13,0,0,0,0,93
18,15,26,26,5,18,0,0,0,108
18,15,26,26,5,18,19,0,0,127
18,16,20,0,0,0,0,0,0,54
18,18,8,1,7,9,1,0,0,62
18,18,8,5,1,0,0,0,0,50
18,18,8,9,14,5,0,0,0,72
18,18,8,9,26,1,0,0,0,80
18,18,8,15,5,1,0,0,0,65
18,19,21,13,0,0,0,0,0,71
18,20,5,0,0,0,0,0,0,43
18,20,9,0,0,0,0,0,0,47
18,20,23,0,0,0,0,0,0,61
18,21,2,0,0,0,0,0,0,41
18,21,2,1,2,15,15,0,0,74
18,21,2,1,2,15,15,19,0,93
18,21,2,1,3,5,0,0,0,50
18,21,2,1,3,5,19,0,0,69
18,21,2,1,9,25,1,20,0,97
18,21,2,1,19,19,5,0,0,85
18,21,2,1,19,19,5,19,0,104
18,21,2,1,20,15,0,0,0,77
18,21,2,1,20,15,19,0,0,96
18,21,2,2,1,2,15,15,0,76
18,21,2,2,1,2,15,15,19,95
18,21,2,2,5,4,0,0,0,52
18,21,2,2,5,5,0,0,0,53
18,21,2,2,5,18,0,0,0,66
18,21,2,2,5,18,5,4,0,75
18,21,2,2,5,18,5,18,0,89
18,21,2,2,5,18,25,0,0,91
18,21,2,2,5,18,9,19,5,99
18,21,2,2,5,18,9,26,5,106
18,21,2,2,5,18,19,0,0,85
18,21,2,2,25,0,0,0,0,68
18,21,2,2,9,14,7,0,0,73
18,21,2,2,9,14,7,19,0,92
18,21,2,2,9,15,0,0,0,67
18,21,2,2,9,19,8,0,0,79
18,21,2,2,9,19,8,5,19,103
18,21,2,2,9,19,8,25,0,104
18,21,2,2,9,19,8,12,25,116
18,21,2,2,9,19,8,18,25,122
18,21,2,2,9,19,25,0,0,96
18,21,2,2,12,5,0,0,0,60
18,21,2,2,12,5,4,0,0,64
18,21,2,2,12,5,18,0,0,78
18,21,2,2,12,5,19,0,0,79
18,21,2,2,12,25,0,0,0,80
18,21,2,2,12,9,5,18,0,87
18,21,2,2,12,9,5,19,20,108
18,21,2,2,12,9,14,7,0,85
18,21,2,4,15,23,14,0,0,97
18,21,2,4,15,23,14,19,0,116
18,21,2,5,4,9,20,25,0,104
18,21,2,5,6,25,0,0,0,77
18,21,2,5,12,5,20,0,0,83
18,21,2,5,12,12,1,0,0,71
18,21,2,5,12,12,1,19,0,90
18,21,2,5,12,12,5,0,0,75
18,21,2,5,12,12,9,20,5,104
18,21,2,5,15,12,1,0,0,74
18,21,2,5,15,12,1,18,0,92
18,21,2,5,15,12,1,19,0,93
18,21,2,5,15,12,15,9,4,101
18,21,2,5,19,0,0,0,0,65
18,21,2,5,19,3,5,14,20,107
18,21,2,9,1,3,9,14,0,77
18,21,2,9,1,14,0,0,0,65
18,21,2,9,1,14,9,3,0,77
18,21,2,9,1,20,5,0,0,76
18,21,2,9,1,20,15,18,0,104
18,21,2,9,2,12,5,0,0,69
18,21,2,9,3,1,14,0,0,68
18,21,2,9,3,5,12,12,5,87
18,21,2,9,3,15,14,5,4,91
18,21,2,9,3,21,14,4,0,92
18,21,2,9,4,9,3,0,0,66
18,21,2,9,4,9,14,5,0,82
18,21,2,9,4,9,21,13,0,97
18,21,2,9,4,9,21,13,19,116
18,21,2,9,5,4,0,0,0,59
18,21,2,9,5,18,0,0,0,73
18,21,2,9,5,19,0,0,0,74
18,21,2,9,5,19,20,0,0,94
18,21,2,9,6,25,0,0,0,81
18,21,2,9,6,9,3,0,0,68
18,21,2,9,7,15,0,0,0,72
18,21,2,9,7,15,19,0,0,91
18,21,2,25,9,14,7,0,0,96
18,21,2,25,12,9,11,5,0,103
18,21,2,9,14,5,0,0,0,69
18,21,2,9,14,5,15,21,19,124
18,21,2,9,15,21,19,0,0,105
18,21,2,25,20,1,9,12,0,108
18,21,2,25,23,9,19,5,0,122
18,21,2,12,5,0,0,0,0,58
18,21,2,12,5,19,0,0,0,77
18,21,2,12,9,19,0,0,0,81
18,21,2,15,6,6,0,0,0,68
18,21,2,15,6,6,19,0,0,87
18,21,2,15,18,0,0,0,0,74
18,21,2,15,21,20,0,0,0,97
18,21,2,15,21,20,19,0,0,116
18,21,2,18,1,9,12,0,0,81
18,21,2,18,9,3,0,0,0,71
18,21,2,18,9,3,1,0,0,72
18,21,2,18,9,3,1,12,0,84
18,21,2,18,9,3,1,20,5,97
18,21,2,18,9,3,9,1,14,95
18,21,2,18,9,3,9,19,13,112
18,21,2,18,9,3,9,19,20,119
18,21,2,18,9,3,9,20,25,125
18,21,2,18,9,3,9,26,5,111
18,21,2,18,9,3,15,19,5,110
18,21,2,18,9,3,19,0,0,90
18,21,2,18,9,6,25,0,0,99
18,21,2,18,9,6,9,3,0,86
18,21,2,18,9,19,8,5,18,118
18,21,2,19,0,0,0,0,0,60
18,21,2,19,20,15,14,5,0,114
18,21,3,5,18,22,9,14,5,115
18,21,3,8,5,0,0,0,0,55
18,21,3,8,5,4,0,0,0,59
18,21,3,8,5,19,0,0,0,74
18,21,3,8,9,14,7,0,0,80
18,21,3,8,9,14,7,19,0,99
18,21,3,11,0,0,0,0,0,53
18,21,3,11,5,4,0,0,0,62
18,21,3,11,25,0,0,0,0,78
18,21,3,11,9,14,7,0,0,83
18,21,3,11,12,5,0,0,0,70
18,21,3,11,12,5,4,0,0,74
18,21,3,11,12,5,19,0,0,89
18,21,3,11,12,9,14,7,0,95
18,21,3,11,19,0,0,0,0,72
18,21,3,11,19,1,3,11,0,87
18,21,3,11,19,1,3,11,19,106
18,21,3,11,19,5,25,0,0,102
18,21,3,11,21,19,0,0,0,93
18,21,3,11,21,19,5,19,0,117
18,21,3,20,1,20,9,15,14,121
18,21,3,20,9,15,14,0,0,100
18,21,3,20,9,15,14,19,0,119
18,21,3,20,9,15,21,19,0,126
18,21,4,0,0,0,0,0,0,43
18,21,4,1,3,5,15,21,19,107
18,21,4,1,19,0,0,0,0,63
18,21,4,4,5,18,0,0,0,70
18,21,4,4,5,18,19,0,0,89
18,21,4,4,9,5,4,0,0,65
18,21,4,4,9,5,18,0,0,79
18,21,4,4,9,5,19,20,0,100
18,21,4,4,25,9,19,8,0,108
18,21,4,4,9,12,25,0,0,93
18,21,4,4,9,14,5,19,19,113
18,21,4,4,9,19,8,0,0,83
18,21,4,4,12,5,0,0,0,64
18,21,4,4,12,5,4,0,0,68
18,21,4,4,12,5,13,1,14,92
18,21,4,4,12,5,13,5,14,96
18,21,4,4,12,5,19,0,0,83
18,21,4,4,12,9,14,7,0,89
18,21,4,4,15,3,11,0,0,76
18,21,4,4,15,3,11,19,0,95
18,21,4,4,19,0,0,0,0,66
18,21,4,5,12,25,0,0,0,85
18,21,4,5,14,5,19,19,0,105
18,21,4,5,14,20,5,4,0,91
18,21,4,5,14,20,21,18,5,126
18,21,4,5,18,1,0,0,0,67
18,21,4,5,18,1,12,0,0,79
18,21,4,5,18,1,12,19,0,98
18,21,4,5,18,1,20,5,0,92
18,21,4,5,19,2,25,0,0,94
18,21,4,5,19,2,9,5,19,102
18,21,4,5,19,20,0,0,0,87
18,21,4,7,5,0,0,0,0,55
18,21,4,9,13,5,14,20,0,104
18,21,4,9,13,5,14,20,19,123
18,21,4,9,14,19,11,25,0,121
18,21,4,9,19,8,0,0,0,79
18,21,4,9,19,20,1,14,0,106
18,21,4,9,19,20,9,4,0,104
18,21,4,9,20,25,0,0,0,97
18,21,4,12,15,6,6,0,0,82
18,21,4,15,21,19,0,0,0,98
18,21,5,4,0,0,0,0,0,48
18,21,5,6,21,12,0,0,0,83
18,21,5,6,21,12,12,25,0,120
18,21,5,12,25,0,0,0,0,81
18,21,5,12,9,11,5,0,0,81
18,21,5,14,0,0,0,0,0,58
18,21,5,18,0,0,0,0,0,62
18,21,5,18,19,0,0,0,0,81
18,21,5,19,0,0,0,0,0,63
18,21,5,19,15,13,5,0,0,96
18,21,5,23,15,18,20,0,0,120
18,21,6,5,19,3,5,14,20,111
18,21,6,6,1,2,12,5,0,71
18,21,6,6,5,0,0,0,0,56
18,21,6,6,5,4,0,0,0,60
18,21,6,6,5,18,0,0,0,74
18,21,6,6,5,19,0,0,0,75
18,21,6,6,9,1,14,0,0,75
18,21,6,6,9,1,14,12,25,112
18,21,6,6,9,1,14,15,0,90
18,21,6,6,9,1,14,19,0,94
18,21,6,6,9,14,7,0,0,81
18,21,6,6,12,5,0,0,0,68
18,21,6,6,12,5,4,0,0,72
18,21,6,6,12,5,18,0,0,86
18,21,6,6,12,5,18,19,0,105
18,21,6,6,12,5,19,0,0,87
18,21,6,6,12,25,0,0,0,88
18,21,6,6,12,9,5,18,0,95
18,21,6,6,12,9,11,5,0,88
18,21,6,6,12,9,14,7,0,93
18,21,6,6,13,1,14,19,0,98
18,21,6,6,19,0,0,0,0,70
18,21,6,9,25,1,1,0,0,81
18,21,6,15,19,9,20,25,0,133
18,21,6,15,21,19,0,0,0,100
18,21,6,20,5,18,0,0,0,88
18,21,6,21,12,15,21,19,0,133
18,21,7,0,0,0,0,0,0,46
18,21,7,1,0,0,0,0,0,47
18,21,7,1,5,0,0,0,0,52
18,21,7,1,12,0,0,0,0,59
18,21,7,1,20,5,0,0,0,72
18,21,7,2,9,5,19,0,0,81
18,21,7,7,5,4,0,0,0,62
18,21,7,7,5,4,5,18,0,85
18,21,7,7,5,4,5,19,20,106
18,21,7,7,5,4,9,26,5,102
18,21,7,7,5,4,12,25,0,99
18,21,7,7,5,18,19,0,0,95
18,21,7,7,25,0,0,0,0,78
18,21,7,7,9,14,7,0,0,83
18,21,7,7,12,5,0,0,0,70
18,21,7,7,15,23,14,0,0,105
18,21,7,8,5,1,4,5,4,73
18,21,7,9,14,5,0,0,0,74
18,21,7,12,9,11,5,0,0,83
18,21,7,13,1,11,5,18,0,94
18,21,7,13,1,11,9,14,7,101
18,21,7,15,12,1,0,0,0,74
18,21,7,15,12,1,19,0,0,93
18,21,7,15,19,5,0,0,0,85
18,21,7,15,19,5,12,25,0,122
18,21,7,15,19,9,20,25,0,134
18,21,7,15,21,19,0,0,0,101
18,21,7,19,0,0,0,0,0,65
18,21,7,21,12,15,19,5,0,118
18,21,9,14,0,0,0,0,0,62
18,21,9,14,1,2,12,5,0,82
18,21,9,14,1,20,5,0,0,88
18,21,9,14,1,20,5,4,0,92
18,21,9,14,1,20,5,19,0,107
18,21,9,14,1,20,9,14,7,113
18,21,9,14,1,20,9,15,14,121
18,21,9,14,1,20,15,18,0,116
18,21,9,14,5,4,0,0,0,71
18,21,9,14,5,18,0,0,0,85
18,21,9,14,5,18,19,0,0,104
18,21,9,14,7,0,0,0,0,69
18,21,9,14,9,6,15,18,13,123
18,21,9,14,9,14,7,0,0,92
18,21,9,14,12,9,11,5,0,99
18,21,9,14,15,21,19,0,0,117
18,21,9,14,15,21,19,12,25,154
18,21,9,14,16,18,15,15,6,132
18,21,9,14,19,0,0,0,0,81
18,21,11,8,0,0,0,0,0,58
18,21,12,1,2,12,5,0,0,71
18,21,12,5,0,0,0,0,0,56
18,21,12,5,4,0,0,0,0,60
18,21,12,5,4,15,13,0,0,88
18,21,12,5,12,5,19,19,0,111
18,21,12,5,18,0,0,0,0,74
18,21,12,5,18,19,0,0,0,93
18,21,12,5,18,19,8,9,16,126
18,21,12,25,0,0,0,0,0,76
18,21,12,9,14,7,0,0,0,81
18,21,12,9,14,7,12,25,0,118
18,21,12,9,14,7,19,0,0,100
18,21,12,12,0,0,0,0,0,63
18,21,12,12,5,18,0,0,0,86
18,21,12,12,9,15,14,0,0,101
18,21,12,12,15,3,11,0,0,92
18,21,13,1,7,5,0,0,0,65
18,21,13,1,7,5,4,0,0,69
18,21,13,1,7,9,14,7,0,90
18,21,13,1,11,9,0,0,0,73
18,21,13,1,11,9,19,0,0,92
18,21,13,1,12,0,0,0,0,65
18,21,13,1,14,9,1,14,19,110
18,21,13,1,14,9,20,5,0,101
18,21,13,2,0,0,0,0,0,54
18,21,13,2,1,0,0,0,0,55
18,21,13,2,1,5,4,0,0,64
18,21,13,2,1,9,14,7,0,85
18,21,13,2,1,18,7,5,0,85
18,21,13,2,1,19,0,0,0,74
18,21,13,2,5,12,15,23,0,109
18,21,13,2,12,5,0,0,0,71
18,21,13,2,12,5,4,0,0,75
18,21,13,2,12,5,18,0,0,89
18,21,13,2,12,5,18,19,0,108
18,21,13,2,12,5,19,0,0,90
18,21,13,2,12,25,0,0,0,91
18,21,13,2,12,9,14,7,0,96
18,21,13,2,12,9,14,7,19,115
18,21,13,2,15,0,0,0,0,69
18,21,13,2,15,15,26,5,0,115
18,21,13,4,21,13,0,0,0,90
18,21,13,5,0,0,0,0,0,57
18,21,13,5,14,0,0,0,0,71
18,21,13,5,14,9,20,9,19,128
18,21,13,5,14,19,0,0,0,90
18,21,13,9,3,9,14,0,0,87
18,21,13,9,14,1,12,0,0,88
18,21,13,9,14,1,14,20,0,110
18,21,13,9,14,1,14,20,19,129
18,21,13,9,14,1,20,5,0,101
18,21,13,9,14,1,20,5,4,105
18,21,13,9,14,1,20,5,19,120
18,21,13,9,14,1,20,15,18,129
18,21,13,11,9,14,0,0,0,86
18,21,13,12,5,19,19,0,0,107
18,21,13,12,25,0,0,0,0,89
18,21,13,13,1,7,5,0,0,78
18,21,13,13,1,7,5,4,0,82
18,21,13,13,1,7,5,18,0,96
18,21,13,13,1,7,5,18,19,115
18,21,13,13,1,7,5,19,0,97
18,21,13,13,1,7,25,0,0,98
18,21,13,13,1,7,9,14,7,103
18,21,13,13,5,18,0,0,0,88
18,21,13,13,5,18,25,0,0,113
18,21,13,13,5,18,19,0,0,107
18,21,13,13,5,19,0,0,0,89
18,21,13,13,5,19,20,0,0,109
18,21,13,13,25,0,0,0,0,90
18,21,13,13,9,5,18,0,0,97
18,21,13,13,9,5,19,0,0,98
18,21,13,13,9,5,19,20,0,118
18,21,13,13,9,12,25,0,0,111
18,21,13,13,9,14,5,19,19,131
18,21,13,13,9,19,8,0,0,101
18,21,13,13,12,5,0,0,0,82
18,21,13,14,5,19,19,0,0,109
18,21,13,15,18,5,4,0,0,94
18,21,13,15,18,5,18,0,0,108
18,21,13,15,18,9,14,7,0,115
18,21,13,15,18,15,21,19,0,140
18,21,13,15,18,19,0,0,0,104
18,21,13,15,21,18,0,0,0,106
18,21,13,15,21,18,5,4,0,115
18,21,13,15,21,18,5,18,0,129
18,21,13,15,21,18,9,14,7,136
18,21,13,15,21,18,19,0,0,125
18,21,13,16,0,0,0,0,0,68
18,21,13,16,1,4,0,0,0,73
18,21,13,16,1,4,4,5,18,100
18,21,13,16,1,4,5,0,0,78
18,21,13,16,25,0,0,0,0,93
18,21,13,16,12,5,0,0,0,85
18,21,13,16,12,5,4,0,0,89
18,21,13,16,12,5,19,0,0,104
18,21,13,16,12,5,19,19,0,123
18,21,13,16,12,25,0,0,0,105
18,21,13,16,12,9,5,18,0,112
18,21,13,16,12,9,5,19,20,133
18,21,13,16,12,9,14,7,0,110
18,21,13,16,15,20,0,0,0,103
18,21,13,16,19,0,0,0,0,87
18,21,13,16,21,19,0,0,0,108
18,21,13,16,21,19,5,19,0,132
18,21,13,18,21,14,14,5,18,142
18,21,13,19,0,0,0,0,0,71
18,21,13,19,8,15,16,0,0,110
18,21,13,20,25,20,15,15,0,147
18,21,14,0,0,0,0,0,0,53
18,21,14,1,2,15,21,20,0,112
18,21,14,1,2,15,21,20,19,131
18,21,14,1,7,1,4,15,0,81
18,21,14,1,7,1,20,5,0,87
18,21,14,1,7,1,20,5,19,106
18,21,14,1,18,15,21,14,4,126
18,21,14,1,23,1,25,0,0,103
18,21,14,1,23,1,25,19,0,122
18,21,14,2,1,3,11,0,0,70
18,21,14,2,1,3,11,19,0,89
18,21,14,2,25,0,0,0,0,80
18,21,14,2,15,1,18,4,0,93
18,21,14,3,8,0,0,0,0,64
18,21,14,3,8,23,5,5,4,101
18,21,14,3,9,14,1,20,5,105
18,21,14,4,1,12,5,0,0,75
18,21,14,4,5,12,0,0,0,74
18,21,14,4,12,5,0,0,0,74
18,21,14,4,12,5,19,0,0,93
18,21,14,4,12,5,20,0,0,94
18,21,14,4,12,5,20,19,0,113
18,21,14,4,15,23,14,0,0,109
18,21,14,4,15,23,14,19,0,128
18,21,14,5,0,0,0,0,0,58
18,21,14,5,3,18,1,6,20,106
18,21,14,5,4,0,0,0,0,62
18,21,14,5,6,15,12,11,0,102
18,21,14,5,12,5,19,19,0,113
18,21,14,5,12,9,11,5,0,95
18,21,14,5,18,0,0,0,0,76
18,21,14,5,19,0,0,0,0,77
18,21,14,5,19,13,9,20,8,127
18,21,14,5,19,20,1,6,6,110
18,21,14,5,23,15,18,4,0,118
18,21,14,6,9,19,8,0,0,95
18,21,14,7,0,0,0,0,0,60
18,21,14,7,8,5,1,4,0,78
18,21,14,7,12,5,19,19,0,115
18,21,14,7,19,0,0,0,0,79
18,21,14,8,15,12,4,5,18,115
18,21,14,9,3,0,0,0,0,65
18,21,14,9,3,1,12,12,25,115
18,21,14,9,6,15,18,13,0,114
18,21,14,9,20,5,0,0,0,87
18,21,14,11,5,5,16,5,18,113
18,21,14,11,12,5,4,0,0,85
18,21,14,11,12,5,19,0,0,100
18,21,14,11,12,25,0,0,0,101
18,21,14,11,12,9,14,7,0,106
18,21,14,12,5,19,19,0,0,108
18,21,14,12,5,20,0,0,0,90
18,21,14,12,5,20,19,0,0,109
18,21,14,13,1,14,0,0,0,81
18,21,14,14,1,2,12,5,0,87
18,21,14,14,5,12,0,0,0,84
18,21,14,14,5,12,19,0,0,103
18,21,14,14,5,18,0,0,0,90
18,21,14,14,5,18,19,0,0,109
18,21,14,14,5,20,0,0,0,92
18,21,14,14,5,20,8,0,0,100
18,21,14,14,25,0,0,0,0,92
18,21,14,14,9,5,18,0,0,99
18,21,14,14,9,5,19,20,0,120
18,21,14,14,9,14,7,0,0,97
18,21,14,14,9,14,7,12,25,134
18,21,14,14,9,14,7,19,0,116
18,21,14,14,9,15,14,0,0,105
18,21,14,15,6,6,0,0,0,80
18,21,14,15,6,6,19,0,0,99
18,21,14,15,12,15,7,25,0,127
18,21,14,15,21,20,0,0,0,109
18,21,14,15,21,20,19,0,0,128
18,21,14,15,22,5,18,0,0,113
18,21,14,15,22,5,18,19,0,132
18,21,14,16,18,15,15,6,0,123
18,21,14,18,9,7,0,0,0,87
18,21,14,18,15,21,14,4,0,125
18,21,14,18,15,21,14,4,19,144
18,21,14,19,0,0,0,0,0,72
18,21,14,19,25,0,0,0,0,97
18,21,14,20,0,0,0,0,0,73
18,21,14,20,5,4,0,0,0,82
18,21,14,20,5,5,0,0,0,83
18,21,14,20,25,0,0,0,0,98
18,21,14,20,9,5,18,0,0,105
18,21,14,20,9,5,19,20,0,126
18,21,14,20,9,13,5,0,0,100
18,21,14,20,9,14,5,19,19,139
18,21,14,20,9,19,8,0,0,109
18,21,14,20,9,19,8,12,25,146
18,21,14,20,19,0,0,0,0,92
18,21,14,23,1,25,0,0,0,102
18,21,14,23,1,25,19,0,0,121
18,21,16,1,0,0,0,0,0,56
18,21,16,5,5,0,0,0,0,65
18,21,16,5,5,19,0,0,0,84
18,21,16,5,12,12,1,18,25,128
18,21,16,5,19,20,18,1,12,130
18,21,16,9,1,0,0,0,0,65
18,21,16,9,1,8,0,0,0,73
18,21,16,9,1,8,19,0,0,92
18,21,16,9,1,12,0,0,0,77
18,21,16,9,5,0,0,0,0,69
18,21,16,9,20,9,3,0,0,96
18,21,16,20,9,12,5,0,0,101
18,21,16,20,9,15,14,0,0,113
18,21,16,20,9,22,5,0,0,111
18,21,16,20,21,1,18,25,0,140
18,21,16,20,21,18,5,0,0,119
18,21,16,20,21,18,5,4,0,123
18,21,16,20,21,18,5,19,0,138
18,21,16,20,21,18,9,14,7,144
18,21,18,1,12,0,0,0,0,70
18,21,18,1,12,9,19,5,0,103
18,21,18,1,12,9,19,5,4,107
18,21,18,1,12,9,19,5,19,122
18,21,18,1,12,9,19,13,0,111
18,21,18,1,12,9,19,13,19,130
18,21,18,1,12,9,19,20,0,118
18,21,18,1,12,9,19,20,19,137
18,21,18,1,12,9,20,5,0,104
18,21,18,1,12,9,20,5,19,123
18,21,18,1,12,9,20,25,0,124
18,21,18,1,12,9,26,5,0,110
18,21,18,1,12,9,26,5,4,114
18,21,18,1,12,9,26,5,19,129
18,21,18,1,12,12,25,0,0,107
18,21,18,1,12,14,5,19,19,127
18,21,18,2,1,14,0,0,0,74
18,21,18,21,0,0,0,0,0,78
18,21,19,5,19,0,0,0,0,82
18,21,19,8,2,21,19,8,0,116
18,21,19,8,5,4,0,0,0,75
18,21,19,8,5,5,0,0,0,76
18,21,19,8,5,5,19,0,0,95
18,21,19,8,5,14,0,0,0,85
18,21,19,8,5,18,0,0,0,89
18,21,19,8,5,18,19,0,0,108
18,21,19,8,5,19,0,0,0,90
18,21,19,8,25,0,0,0,0,91
18,21,19,8,9,5,18,0,0,98
18,21,19,8,9,5,19,20,0,119
18,21,19,8,9,14,5,19,19,132
18,21,19,8,9,14,7,12,25,133
18,21,19,8,9,14,7,19,0,115
18,21,19,8,12,9,7,8,20,122
18,21,19,8,12,9,11,5,0,103
18,21,19,8,12,9,20,0,0,107
18,21,19,8,23,15,18,11,0,133
18,21,19,9,14,5,0,0,0,86
18,21,19,9,14,5,19,0,0,105
18,21,19,11,25,0,0,0,0,94
18,21,19,11,19,0,0,0,0,88
18,21,19,13,1,0,0,0,0,72
18,21,19,15,20,0,0,0,0,93
18,21,19,16,15,14,5,0,0,108
18,21,19,19,5,0,0,0,0,82
18,21,19,19,5,12,5,20,0,119
18,21,19,19,5,20,0,0,0,102
18,21,19,19,5,20,25,0,0,127
18,21,19,19,5,20,9,14,7,132
18,21,19,19,5,20,9,19,8,138
18,21,19,19,5,20,19,0,0,121
18,21,19,19,9,1,14,19,0,120
18,21,19,19,9,6,9,5,4,110
18,21,19,19,9,6,9,5,19,125
18,21,19,19,21,4,0,0,0,102
18,21,19,20,1,2,12,5,0,98
18,21,19,20,5,4,0,0,0,87
18,21,19,20,6,21,12,0,0,117
18,21,19,20,25,2,1,3,11,120
18,21,19,20,9,3,0,0,0,90
18,21,19,20,9,3,1,12,0,103
18,21,19,20,9,3,1,20,5,116
18,21,19,20,9,3,9,1,12,112
18,21,19,20,9,3,9,19,13,131
18,21,19,20,9,3,9,20,25,144
18,21,19,20,9,3,9,26,5,130
18,21,19,20,9,3,12,25,0,127
18,21,19,20,9,3,15,1,20,126
18,21,19,20,9,3,19,0,0,109
18,21,19,20,9,3,21,13,0,124
18,21,19,20,9,5,18,0,0,110
18,21,19,20,9,5,19,20,0,131
18,21,19,20,25,9,19,8,0,139
18,21,19,20,9,12,25,0,0,124
18,21,19,20,9,14,5,19,19,144
18,21,19,20,9,14,7,0,0,108
18,21,19,20,12,5,0,0,0,95
18,21,19,20,12,5,4,0,0,99
18,21,19,20,12,5,18,0,0,113
18,21,19,20,12,5,18,19,0,132
18,21,19,20,12,5,19,0,0,114
18,21,19,20,12,5,19,19,0,133
18,21,19,20,12,25,0,0,0,115
18,21,19,20,12,9,14,7,0,120
18,21,19,20,16,18,15,15,6,148
18,21,19,20,18,5,0,0,0,101
18,21,19,20,18,5,4,0,0,105
18,21,19,20,19,0,0,0,0,97
18,21,19,23,21,20,0,0,0,122
18,21,20,0,0,0,0,0,0,59
18,21,20,1,2,1,7,1,0,71
18,21,20,1,2,1,7,1,19,90
18,21,20,1,3,5,15,21,19,123
18,21,20,1,20,5,0,0,0,85
18,21,20,3,8,0,0,0,0,70
18,21,20,5,12,9,1,14,0,100
18,21,20,8,5,14,1,20,5,112
18,21,20,8,5,14,9,3,0,98
18,21,20,8,5,14,9,21,13,129
18,21,20,8,5,14,15,21,19,141
18,21,20,8,5,18,0,0,0,90
18,21,20,8,6,21,12,0,0,106
18,21,20,8,6,21,12,12,25,143
18,21,20,8,12,5,19,19,0,122
18,21,20,8,19,0,0,0,0,86
18,21,20,9,3,0,0,0,0,71
18,21,20,9,4,15,19,9,19,134
18,21,20,25,12,0,0,0,0,96
18,21,20,9,12,1,14,20,0,115
18,21,20,9,12,1,20,5,0,106
18,21,20,9,12,1,20,5,4,110
18,21,20,9,12,5,0,0,0,85
18,21,20,25,12,5,14,5,0,120
18,21,20,9,12,5,19,0,0,104
18,21,20,9,12,15,21,19,0,135
18,21,20,9,14,0,0,0,0,82
18,21,20,9,14,15,19,5,0,121
18,21,20,9,14,19,0,0,0,101
18,21,20,19,0,0,0,0,0,78
18,21,20,20,5,4,0,0,0,88
18,21,20,20,5,5,0,0,0,89
18,21,20,20,25,0,0,0,0,104
18,21,20,20,9,5,18,0,0,111
18,21,20,20,9,5,19,20,0,132
18,21,20,20,9,12,25,0,0,125
18,21,20,20,9,14,5,19,19,145
18,21,20,20,9,14,7,0,0,109
18,21,20,20,9,19,8,0,0,115
18,21,20,20,9,19,8,12,25,152
18,21,20,20,12,5,0,0,0,96
18,21,22,9,4,0,0,0,0,74
18,21,24,0,0,0,0,0,0,63
18,22,21,12,19,1,14,20,0,127
18,23,4,0,0,0,0,0,0,45
18,23,15,21,14,4,0,0,0,95
19,2,9,18,18,15,0,0,0,81
19,2,12,15,15,4,0,0,0,67
19,2,15,4,9,11,9,14,19,102
19,3,3,12,5,18,1,0,0,61
19,3,5,1,20,0,0,0,0,48
19,3,5,7,7,5,18,0,0,64
19,3,5,12,1,12,7,9,1,69
19,3,5,12,5,18,1,20,0,83
19,3,5,12,5,18,1,20,5,88
19,3,5,12,15,14,3,21,19,111
19,3,5,12,16,0,0,0,0,55
19,3,5,14,1,0,0,0,0,42
19,3,5,14,1,18,25,0,0,85
19,3,5,14,1,18,9,15,0,84
19,3,5,14,1,18,9,15,19,103
19,3,5,14,1,18,9,19,20,108
19,3,5,14,1,18,9,26,5,100
19,3,5,14,1,19,0,0,0,61
19,3,5,14,4,0,0,0,0,45
19,3,5,14,4,5,4,0,0,54
19,3,5,14,4,9,14,7,0,75
19,3,5,14,4,19,0,0,0,64
19,3,5,14,5,0,0,0,0,46
19,3,5,14,5,6,21,12,0,85
19,3,5,14,5,13,1,14,0,74
19,3,5,14,5,18,25,0,0,89
19,3,5,14,5,18,9,5,19,97
19,3,5,14,5,19,0,0,0,65
19,3,5,14,9,3,0,0,0,53
19,3,5,14,9,3,1,12,0,66
19,3,5,14,9,19,20,0,0,89
19,3,5,14,9,20,5,0,0,75
19,3,5,14,19,9,15,14,0,98
19,3,5,14,20,0,0,0,0,61
19,3,5,14,20,5,4,0,0,70
19,3,5,14,20,5,18,0,0,84
19,3,5,14,20,6,21,12,0,100
19,3,5,14,20,9,14,7,0,91
19,3,5,14,20,12,5,19,19,116
19,3,5,14,20,19,0,0,0,80
19,3,5,14,20,23,15,15,4,118
19,3,5,16,19,9,19,0,0,90
19,3,5,16,20,5,18,0,0,86
19,3,5,16,20,5,18,5,4,95
19,3,5,16,20,5,18,19,0,105
19,3,5,16,20,9,2,12,25,111
19,3,5,16,20,9,3,1,12,88
19,3,5,16,20,9,3,19,0,94
19,3,5,16,20,18,1,12,0,94
19,3,5,16,20,18,5,0,0,86
19,3,5,16,20,18,5,4,0,90
19,3,5,16,20,18,5,19,0,105
19,3,5,16,20,18,25,0,0,106
19,3,5,16,20,18,9,14,7,111
19,3,5,18,14,5,0,0,0,64
19,3,5,23,9,14,7,0,0,80
19,3,6,8,0,0,0,0,0,36
19,3,6,13,0,0,0,0,0,41
19,3,8,1,4,3,8,1,14,61
19,3,8,1,12,13,5,9,0,70
19,3,8,1,12,13,5,25,0,86
19,3,8,1,14,19,5,0,0,69
19,3,8,1,14,26,0,0,0,71
19,3,8,1,16,16,5,0,0,68
19,3,8,1,16,16,5,4,0,72
19,3,8,1,16,16,5,19,0,87
19,3,8,1,16,16,9,14,7,93
19,3,8,1,16,19,11,1,0,78
19,3,8,1,20,3,8,5,14,81
19,3,8,1,22,0,0,0,0,53
19,3,8,1,22,19,0,0,0,72
19,3,8,5,4,9,1,19,13,81
19,3,8,5,4,21,12,1,18,91
19,3,8,5,4,21,12,5,0,77
19,3,8,5,4,21,12,5,4,81
19,3,8,5,4,21,12,5,18,95
19,3,8,5,4,21,12,5,19,96
19,3,8,5,5,12,9,14,0,75
19,3,8,5,5,12,9,20,5,86
19,3,8,5,6,6,5,12,0,64
19,3,8,5,12,12,25,0,0,84
19,3,8,5,12,13,0,0,0,60
19,3,8,5,13,1,0,0,0,49
19,3,8,5,13,1,19,0,0,68
19,3,8,5,13,1,20,1,0,70
19,3,8,5,13,1,20,9,0,78
19,3,8,5,13,1,20,9,3,81
19,3,8,5,13,5,0,0,0,53
19,3,8,5,13,5,4,0,0,57
19,3,8,5,13,5,6,21,12,92
19,3,8,5,13,5,18,0,0,71
19,3,8,5,13,5,18,25,0,96
19,3,8,5,13,5,18,19,0,90
19,3,8,5,13,5,19,0,0,72
19,3,8,5,13,25,0,0,0,73
19,3,8,5,13,9,14,7,0,78
19,3,8,5,13,9,19,20,0,96
19,3,8,5,14,5,0,0,0,54
19,3,8,5,16,5,12,0,0,68
19,3,8,5,16,5,14,0,0,70
19,3,8,5,18,13,0,0,0,66
19,3,8,5,18,26,9,0,0,88
19,3,8,5,18,26,15,0,0,94
19,3,8,5,18,26,15,19,0,113
19,3,8,5,18,26,15,19,15,128
19,3,8,5,19,9,19,0,0,82
19,3,8,9,1,22,15,14,1,92
19,3,8,9,1,22,15,14,5,96
19,3,8,9,1,22,15,14,9,100
19,3,8,9,6,6,12,9,0,72
19,3,8,9,12,12,5,18,19,105
19,3,8,9,12,12,21,0,0,84
19,3,8,9,13,13,5,12,0,82
19,3,8,25,14,2,1,12,4,88
19,3,8,9,19,13,0,0,0,71
19,3,8,9,19,13,1,0,0,72
19,3,8,9,19,13,9,3,0,83
19,3,8,9,19,13,19,0,0,90
19,3,8,9,19,20,0,0,0,78
19,3,8,9,19,20,9,3,0,90
19,3,8,9,19,20,15,9,4,106
19,3,8,9,19,20,15,19,5,117
19,3,8,9,19,20,15,21,19,133
19,3,8,9,19,20,19,0,0,97
19,3,8,9,19,20,21,19,0,118
19,3,8,9,26,0,0,0,0,65
19,3,8,9,26,1,24,15,14,119
19,3,8,9,26,25,0,0,0,90
19,3,8,9,26,9,5,18,0,97
19,3,8,9,26,15,0,0,0,80
19,3,8,9,26,15,9,4,0,93
19,3,8,9,26,15,9,4,19,112
19,3,8,9,26,15,14,20,0,114
19,3,8,9,26,15,14,20,19,133
19,3,8,9,26,15,16,15,4,115
19,3,8,9,26,15,19,0,0,99
19,3,8,9,26,20,9,3,0,97
19,3,8,9,26,26,25,0,0,116
19,3,8,9,26,26,15,0,0,106
19,3,8,12,5,13,9,5,12,86
19,3,8,12,5,13,9,8,12,89
19,3,8,12,5,14,20,5,18,104
19,3,8,12,5,16,0,0,0,63
19,3,8,12,5,16,16,0,0,79
19,3,8,12,5,16,16,5,4,88
19,3,8,12,5,16,16,5,18,102
19,3,8,12,5,16,16,19,0,98
19,3,8,12,5,16,19,0,0,82
19,3,8,12,9,5,18,5,0,79
19,3,8,12,9,5,18,5,14,93
19,3,8,12,9,5,18,9,3,86
19,3,8,12,9,13,1,26,12,103
19,3,8,12,15,3,11,0,0,71
19,3,8,12,15,3,11,25,0,96
19,3,8,12,15,3,11,19,0,90
19,3,8,12,15,15,16,0,0,88
19,3,8,12,21,13,16,0,0,92
19,3,8,12,21,13,16,19,0,111
19,3,8,13,1,12,20,26,0,102
19,3,8,13,1,12,20,26,25,127
19,3,8,13,1,12,26,0,0,82
19,3,8,13,1,12,26,5,19,106
19,3,8,13,1,12,26,25,0,107
19,3,8,13,1,20,20,5,0,89
19,3,8,13,5,1,18,0,0,67
19,3,8,13,5,1,18,19,0,86
19,3,8,13,5,5,18,0,0,71
19,3,8,13,5,5,18,5,4,80
19,3,8,13,5,5,18,19,0,90
19,3,8,13,5,9,19,19,0,95
19,3,8,13,5,12,26,0,0,86
19,3,8,13,5,12,26,5,0,91
19,3,8,13,5,12,26,5,19,110
19,3,8,13,15,0,0,0,0,58
19,3,8,13,15,5,0,0,0,63
19,3,8,13,15,5,19,0,0,82
19,3,8,13,15,15,19,0,0,92
19,3,8,13,15,15,19,5,0,97
19,3,8,13,15,15,19,5,4,101
19,3,8,13,15,15,19,5,19,116
19,3,8,13,15,15,26,5,0,104
19,3,8,13,15,15,26,5,4,108
19,3,8,13,15,15,26,5,19,123
19,3,8,13,15,19,0,0,0,77
19,3,8,13,21,3,11,0,0,78
19,3,8,13,21,3,11,19,0,97
19,3,8,14,1,16,16,5,18,100
19,3,8,14,1,16,16,19,0,96
19,3,8,14,1,16,19,0,0,80
19,3,8,14,1,21,26,5,18,115
19,3,8,14,5,3,11,5,0,68
19,3,8,14,5,3,11,5,14,82
19,3,8,14,9,20,26,0,0,99
19,3,8,14,9,20,26,5,12,116
19,3,8,14,15,15,11,0,0,85
19,3,8,14,15,15,11,19,0,104
19,3,8,14,15,18,11,5,12,105
19,3,8,14,15,18,11,12,5,105
19,3,8,14,15,18,18,5,18,118
19,3,8,14,15,26,0,0,0,85
19,3,8,14,15,26,26,0,0,111
19,3,8,14,15,26,26,12,5,128
19,3,8,15,0,0,0,0,0,45
19,3,8,15,3,8,1,20,0,77
19,3,8,15,3,8,5,0,0,61
19,3,8,15,3,8,5,20,0,81
19,3,8,15,11,11,5,18,0,90
19,3,8,15,12,1,0,0,0,58
19,3,8,15,12,1,5,0,0,63
19,3,8,15,12,1,18,0,0,76
19,3,8,15,12,1,18,3,8,87
19,3,8,15,12,1,18,12,25,113
19,3,8,15,12,1,18,19,0,95
19,3,8,15,12,1,19,13,0,90
19,3,8,15,12,9,1,0,0,67
19,3,8,15,12,9,1,19,20,106
19,3,8,15,12,9,15,14,0,95
19,3,8,15,12,9,21,13,0,100
19,3,8,15,12,9,21,13,19,119
19,3,8,15,14,5,0,0,0,64
19,3,8,15,15,12,1,7,5,85
19,3,8,15,15,12,2,1,7,82
19,3,8,15,15,12,2,15,25,114
19,3,8,15,15,12,4,15,13,104
19,3,8,15,15,12,5,4,0,81
19,3,8,15,15,12,5,18,0,95
19,3,8,15,15,12,5,18,25,120
19,3,8,15,15,12,5,18,19,114
19,3,8,15,15,12,6,21,12,111
19,3,8,15,15,12,9,5,0,86
19,3,8,15,15,12,9,14,7,102
19,3,8,15,15,12,9,19,8,108
19,3,8,15,15,12,13,1,0,86
19,3,8,15,15,12,13,5,14,104
19,3,8,15,15,14,0,0,0,74
19,3,8,15,15,14,5,18,0,97
19,3,8,15,15,14,5,18,19,116
19,3,8,15,15,16,5,18,0,99
19,3,8,15,16,16,5,14,0,96
19,3,8,15,18,12,0,0,0,75
19,3,8,15,18,12,25,0,0,100
19,3,8,15,18,12,15,21,19,130
19,3,8,15,18,12,19,0,0,94
19,3,8,15,20,20,9,19,8,121
19,3,8,15,21,20,0,0,0,86
19,3,8,15,21,23,0,0,0,89
19,3,8,18,1,4,1,14,0,68
19,3,8,18,1,14,11,0,0,74
19,3,8,18,5,9,14,5,18,99
19,3,8,18,25,1,18,9,0,101
19,3,8,18,9,11,0,0,0,68
19,3,8,18,9,11,19,0,0,87
19,3,8,18,15,4,0,0,0,67
19,3,8,18,15,4,19,0,0,86
19,3,8,18,15,20,8,5,18,114
19,3,8,20,9,3,11,0,0,73
19,3,8,20,9,3,11,19,0,92
19,3,8,20,9,11,0,0,0,70
19,3,8,20,9,11,19,0,0,89
19,3,8,20,15,6,6,0,0,77
19,3,8,21,8,5,0,0,0,64
19,3,8,21,9,20,0,0,0,80
19,3,8,21,25,20,0,0,0,96
19,3,8,21,9,20,19,0,0,99
19,3,8,21,12,14,0,0,0,77
19,3,8,21,12,20,26,5,0,114
19,3,8,21,14,7,9,20,5,106
19,3,8,21,19,19,0,0,0,89
19,3,8,21,19,19,5,4,0,98
19,3,8,21,19,19,5,18,0,112
19,3,8,21,19,19,5,19,0,113
19,3,8,21,19,19,9,14,7,119
19,3,8,21,20,5,0,0,0,76
19,3,8,23,1,0,0,0,0,54
19,3,8,23,1,14,16,1,14,99
19,3,8,23,1,19,0,0,0,73
19,3,8,23,5,9,26,5,18,116
19,3,9,1,5,14,9,4,0,64
19,3,9,1,5,14,9,4,19,83
19,3,9,1,5,14,15,9,4,79
19,3,9,1,7,5,0,0,0,44
19,3,9,1,7,18,1,16,8,82
19,3,9,1,12,25,20,9,3,101
19,3,9,1,13,1,3,8,25,82
19,3,9,1,13,5,20,18,25,113
19,3,9,1,16,15,4,0,0,67
19,3,9,1,18,9,4,0,0,63
19,3,9,1,19,3,15,16,5,90
19,3,9,1,19,3,15,16,25,110
19,3,9,1,20,8,0,0,0,60
19,3,9,1,20,9,3,0,0,64
19,3,9,1,20,9,3,1,0,65
19,3,9,1,20,9,3,1,12,77
19,3,9,1,20,9,3,1,19,84
19,3,9,1,20,9,3,11,25,100
19,3,9,1,20,9,3,19,0,83
19,3,25,2,1,12,1,0,0,63
19,3,25,2,1,12,15,21,19,117
19,3,25,2,1,12,21,13,0,96
19,3,9,2,9,12,5,0,0,59
19,3,25,5,0,0,0,0,0,52
19,3,25,5,12,9,20,5,0,98
19,3,9,5,14,3,5,0,0,58
19,3,9,5,14,3,5,4,0,62
19,3,9,5,14,3,5,19,0,77
19,3,9,5,14,20,0,0,0,70
19,3,9,5,14,20,5,18,0,93
19,3,9,5,14,20,9,1,0,80
19,3,9,5,14,20,9,1,12,92
19,3,9,5,14,20,9,19,13,111
19,3,9,5,14,20,9,26,5,110
19,3,9,12,0,0,0,0,0,43
19,3,9,12,9,3,5,20,0,80
19,3,9,12,12,1,9,14,0,79
19,3,9,12,12,1,19,0,0,75
19,3,25,12,12,9,15,9,4,108
19,3,25,12,12,9,20,5,0,105
19,3,9,12,12,9,20,9,14,107
19,3,25,12,12,9,20,15,12,127
19,3,9,13,5,20,1,18,0,88
19,3,9,13,5,20,1,18,19,107
19,3,9,13,9,20,1,18,0,92
19,3,9,13,9,20,1,18,19,111
19,3,9,13,9,20,5,18,0,96
19,3,9,13,9,20,5,18,19,115
19,3,9,14,3,9,4,0,0,61
19,3,9,14,3,15,9,4,0,76
19,3,9,14,3,15,9,4,19,95
19,3,9,14,4,0,0,0,0,49
19,3,9,14,9,16,8,0,0,78
19,3,9,14,20,9,12,0,0,86
19,3,9,14,20,9,12,12,1,99
19,3,9,14,20,12,5,0,0,82
19,3,9,14,20,12,5,4,0,86
19,3,9,14,20,12,5,18,0,100
19,3,9,14,20,12,9,14,7,107
19,3,9,15,7,18,1,16,8,96
19,3,9,15,12,9,19,13,0,99
19,3,9,15,12,9,19,13,19,118
19,3,9,15,12,9,19,20,0,106
19,3,9,15,12,9,19,20,19,125
19,3,9,15,12,15,21,19,0,113
19,3,9,15,12,20,15,0,0,93
19,3,9,15,13,1,3,8,25,96
19,3,9,15,13,1,14,3,25,102
19,3,9,15,14,0,0,0,0,60
19,3,9,15,14,19,0,0,0,79
19,3,9,15,16,8,25,20,5,120
19,3,9,15,16,20,9,3,0,94
19,3,9,15,16,20,9,3,19,113
19,3,9,15,16,20,18,9,3,112
19,3,9,15,19,15,16,8,25,129
19,3,9,15,21,19,0,0,0,86
19,3,25,16,8,1,0,0,0,72
19,3,25,16,8,1,5,0,0,77
19,3,25,16,8,1,20,5,0,97
19,3,25,16,8,9,0,0,0,80
19,3,25,16,8,15,9,0,0,95
19,3,25,16,8,15,19,5,0,110
19,3,25,16,8,21,12,1,0,105
19,3,25,16,8,21,12,21,19,144
19,3,25,16,8,21,19,0,0,111
19,3,25,16,16,8,9,0,0,96
19,3,9,18,5,14,7,1,0,76
19,3,9,18,15,3,3,15,0,85
19,3,9,18,15,3,3,15,19,104
19,3,9,18,18,8,9,0,0,84
19,3,9,18,18,8,15,9,4,103
19,3,9,18,18,8,15,13,1,104
19,3,9,18,18,8,15,21,19,130
19,3,9,18,18,8,21,19,0,115
19,3,9,18,20,15,16,15,4,119
19,3,9,19,19,5,12,0,0,86
19,3,9,19,19,9,2,12,5,97
19,3,9,19,19,9,12,0,0,90
19,3,9,19,19,9,12,5,0,95
19,3,9,19,19,9,15,14,0,107
19,3,9,19,19,9,15,14,19,126
19,3,9,19,19,15,18,0,0,102
19,3,9,19,19,15,18,5,4,111
19,3,9,19,19,15,18,5,18,125
19,3,9,19,19,15,18,9,1,112
19,3,9,19,19,15,18,19,0,121
19,3,9,19,19,21,18,1,0,109
19,3,9,19,19,21,18,5,0,113
19,3,9,19,19,21,18,5,19,132
19,3,25,20,0,0,0,0,0,67
19,3,25,20,1,12,5,0,0,85
19,3,25,20,8,5,0,0,0,80
19,3,25,20,8,5,4,0,0,84
19,3,25,20,8,5,13,1,14,108
19,3,25,20,8,5,19,0,0,99
19,3,25,20,8,9,14,7,0,105
19,3,25,20,9,20,9,19,0,124
19,3,9,21,18,9,4,0,0,83
19,3,9,21,18,9,4,19,0,102
19,3,9,21,18,9,14,5,0,98
19,3,9,21,18,9,14,5,19,117
19,3,9,21,18,15,9,4,0,98
19,3,9,21,18,15,9,4,19,117
19,3,9,22,22,25,0,0,0,100
19,3,9,22,22,9,5,19,0,108
19,3,12,1,6,6,0,0,0,47
19,3,12,1,6,6,5,4,0,56
19,3,12,1,6,6,5,18,0,70
19,3,12,1,6,6,5,18,19,89
19,3,12,1,6,6,5,18,20,90
19,3,12,1,6,6,9,14,7,77
19,3,12,1,6,6,19,0,0,66
19,3,12,1,20,0,0,0,0,55
19,3,12,1,20,3,8,0,0,66
19,3,12,1,20,5,0,0,0,60
19,3,12,1,23,0,0,0,0,58
19,3,12,5,14,20,0,0,0,73
19,3,12,5,18,0,0,0,0,57
19,3,12,5,18,1,0,0,0,58
19,3,12,5,18,1,5,0,0,63
19,3,12,5,18,1,12,0,0,70
19,3,12,5,18,1,14,20,8,100
19,3,12,5,18,1,19,0,0,77
19,3,12,5,18,5,0,0,0,62
19,3,12,5,18,5,9,4,0,75
19,3,12,5,18,5,9,4,19,94
19,3,12,5,18,5,13,1,0,76
19,3,12,5,18,9,6,25,0,97
19,3,12,5,18,9,20,5,0,91
19,3,12,5,18,9,20,5,19,110
19,3,12,5,18,9,20,9,3,98
19,3,12,5,18,9,20,9,19,114
19,3,12,5,18,9,26,5,4,101
19,3,12,5,18,15,7,5,14,98
19,3,12,5,18,15,9,4,0,85
19,3,12,5,18,15,13,1,0,86
19,3,12,5,18,15,13,1,19,105
19,3,12,5,18,15,19,1,12,104
19,3,12,5,18,15,19,5,0,96
19,3,12,5,18,15,19,5,4,100
19,3,12,5,18,15,19,5,19,115
19,3,12,5,18,15,19,9,19,119
19,3,12,5,18,15,20,1,12,105
19,3,12,5,18,15,20,5,0,97
19,3,12,5,18,15,20,9,1,102
19,3,12,5,18,15,20,9,3,104
19,3,12,5,18,15,20,9,14,115
19,3,12,5,18,15,21,19,0,112
19,3,12,9,6,6,0,0,0,55
19,3,12,9,13,0,0,0,0,56
19,3,12,9,13,2,0,0,0,58
19,3,15,1,4,0,0,0,0,42
19,3,15,2,0,0,0,0,0,39
19,3,15,2,2,25,0,0,0,66
19,3,15,2,9,6,15,18,13,100
19,3,15,2,19,0,0,0,0,58
19,3,15,4,7,25,0,0,0,73
19,3,15,6,6,0,0,0,0,49
19,3,15,6,6,5,4,0,0,58
19,3,15,6,6,5,18,0,0,72
19,3,15,6,6,5,18,25,0,97
19,3,15,6,6,5,18,19,0,91
19,3,15,6,6,9,14,7,0,79
19,3,15,6,6,12,1,23,0,85
19,3,15,6,6,12,1,23,19,104
19,3,15,6,6,19,0,0,0,68
19,3,15,7,0,0,0,0,0,44
19,3,15,7,7,1,14,0,0,66
19,3,15,7,7,5,18,0,0,74
19,3,15,7,7,9,14,0,0,74
19,3,15,7,9,5,0,0,0,58
19,3,15,9,14,19,15,14,0,108
19,3,15,11,5,0,0,0,0,53
19,3,15,12,2,0,0,0,0,51
19,3,15,12,4,0,0,0,0,53
19,3,15,12,4,1,2,12,5,73
19,3,15,12,4,5,4,0,0,62
19,3,15,12,4,5,18,0,0,76
19,3,15,12,4,5,18,19,0,95
19,3,15,12,4,9,14,7,0,83
19,3,15,12,4,9,14,7,19,102
19,3,15,12,4,19,0,0,0,72
19,3,15,12,5,3,5,19,0,81
19,3,15,12,5,3,9,4,0,70
19,3,15,12,5,3,9,20,5,91
19,3,15,12,5,3,15,9,4,85
19,3,15,12,5,25,0,0,0,79
19,3,15,12,5,18,25,14,7,118
19,3,15,12,5,24,0,0,0,78
19,3,15,12,9,3,5,19,0,85
19,3,15,12,9,9,4,0,0,71
19,3,15,12,9,15,13,1,0,87
19,3,15,12,9,15,13,1,19,106
19,3,15,12,9,15,14,0,0,87
19,3,15,12,9,15,19,9,19,120
19,3,15,12,9,15,20,9,3,105
19,3,15,12,9,20,5,0,0,83
19,3,15,12,25,20,9,4,0,107
19,3,15,12,25,20,9,4,19,126
19,3,15,12,25,20,15,9,4,122
19,3,15,12,12,15,16,0,0,92
19,3,15,12,12,15,16,5,4,101
19,3,15,12,12,15,16,5,18,115
19,3,15,12,12,15,16,19,0,111
19,3,15,12,15,3,0,0,0,67
19,3,15,12,15,7,0,0,0,71
19,3,15,12,15,16,5,19,0,104
19,3,15,12,15,16,19,0,0,99
19,3,15,13,2,18,9,4,0,83
19,3,15,13,2,18,9,14,5,98
19,3,15,13,2,18,15,9,4,98
19,3,15,13,2,18,15,14,5,104
19,3,15,13,6,9,20,0,0,85
19,3,15,13,13,0,0,0,0,63
19,3,15,14,3,5,0,0,0,59
19,3,15,14,3,5,4,0,0,63
19,3,15,14,3,5,18,0,0,77
19,3,15,14,3,5,19,0,0,78
19,3,15,14,3,8,5,15,14,96
19,3,15,14,3,9,2,12,5,82
19,3,15,14,3,9,14,7,0,84
19,3,15,14,5,19,0,0,0,75
19,3,15,15,3,8,0,0,0,63
19,3,15,15,14,0,0,0,0,66
19,3,15,15,16,0,0,0,0,68
19,3,15,15,16,5,4,0,0,77
19,3,15,15,16,5,18,0,0,91
19,3,15,15,16,5,18,19,0,110
19,3,15,15,16,6,21,12,0,107
19,3,15,15,16,6,21,12,19,126
19,3,15,15,16,9,14,7,0,98
19,3,15,15,16,19,6,21,12,126
19,3,15,15,20,0,0,0,0,72
19,3,15,15,20,5,4,0,0,81
19,3,15,15,20,5,18,0,0,95
19,3,15,15,20,5,18,19,0,114
19,3,15,15,20,9,14,7,0,102
19,3,15,15,20,19,0,0,0,91
19,3,15,16,0,0,0,0,0,53
19,3,15,16,1,0,0,0,0,54
19,3,15,16,1,18,9,14,0,95
19,3,15,16,1,18,9,21,13,115
19,3,15,16,1,18,9,21,19,121
19,3,15,16,1,20,5,0,0,79
19,3,15,16,5,0,0,0,0,58
19,3,15,16,5,4,0,0,0,62
19,3,15,16,5,12,5,19,19,113
19,3,15,16,5,12,9,4,0,83
19,3,15,16,5,12,9,19,13,111
19,3,15,16,5,12,15,9,4,98
19,3,15,16,5,20,0,0,0,78
19,3,15,16,8,15,14,25,0,115
19,3,15,16,25,0,0,0,0,78
19,3,15,16,9,3,0,0,0,65
19,3,15,16,9,6,15,18,13,114
19,3,15,16,9,14,5,0,0,81
19,3,15,16,9,14,7,0,0,83
19,3,15,16,9,15,21,19,0,117
19,3,15,16,9,16,5,4,0,87
19,3,15,16,15,12,1,0,0,81
19,3,15,16,15,12,9,14,5,108
19,3,15,16,15,14,5,0,0,87
19,3,15,16,16,5,18,9,12,113
19,3,15,16,19,0,0,0,0,72
19,3,15,16,20,9,3,1,12,98
19,3,15,16,21,12,1,0,0,87
19,3,15,16,21,12,1,5,0,92
19,3,15,16,21,12,1,19,0,106
19,3,15,16,21,12,1,20,5,112
19,3,15,16,21,12,9,20,5,120
19,3,15,16,21,12,15,21,19,141
19,3,15,18,2,21,3,8,0,89
19,3,15,18,2,21,20,5,0,103
19,3,15,18,2,21,20,9,3,110
19,3,15,18,2,21,20,21,19,138
19,3,15,18,3,5,0,0,0,63
19,3,15,18,3,8,0,0,0,66
19,3,15,18,3,8,5,4,0,75
19,3,15,18,3,8,5,18,0,89
19,3,15,18,3,8,5,18,19,108
19,3,15,18,3,8,5,19,0,90
19,3,15,18,3,8,9,14,7,96
19,3,15,18,3,8,19,0,0,85
19,3,15,18,4,1,20,15,0,95
19,3,15,18,4,9,21,13,0,102
19,3,15,18,5,0,0,0,0,60
19,3,15,18,5,2,15,15,11,103
19,3,15,18,5,3,1,18,4,86
19,3,15,18,5,4,0,0,0,64
19,3,15,18,5,12,5,19,19,115
19,3,15,18,5,16,1,4,0,81
19,3,15,18,5,16,1,4,19,100
19,3,15,18,5,18,0,0,0,78
19,3,15,18,5,18,19,0,0,97
19,3,15,18,5,19,0,0,0,79
19,3,15,18,9,1,0,0,0,65
19,3,15,18,9,1,3,0,0,68
19,3,15,18,9,1,5,0,0,70
19,3,15,18,9,6,25,0,0,95
19,3,15,18,9,6,9,5,4,88
19,3,15,18,9,6,9,5,18,102
19,3,15,18,9,6,9,5,19,103
19,3,15,18,9,6,15,18,13,116
19,3,15,18,9,14,7,0,0,85
19,3,15,18,9,14,7,19,0,104
19,3,15,18,9,15,21,19,0,119
19,3,15,18,11,12,5,0,0,83
19,3,15,18,14,0,0,0,0,69
19,3,15,18,14,5,4,0,0,78
19,3,15,18,14,5,18,0,0,92
19,3,15,18,14,5,18,19,0,111
19,3,15,18,14,6,21,12,0,108
19,3,15,18,14,25,0,0,0,94
19,3,15,18,14,9,14,7,0,99
19,3,15,18,14,19,0,0,0,88
19,3,15,18,15,4,9,20,5,108
19,3,15,18,16,5,14,5,0,95
19,3,15,18,16,5,18,0,0,94
19,3,15,18,16,9,15,9,4,108
19,3,15,18,16,9,15,14,19,128
19,3,15,18,16,9,15,19,0,114
19,3,15,18,19,5,0,0,0,79
19,3,15,18,19,5,18,0,0,97
19,3,15,18,26,1,0,0,0,82
19,3,15,20,1,12,0,0,0,70
19,3,15,20,1,12,5,0,0,75
19,3,15,20,3,8,5,4,0,77
19,3,15,20,3,8,5,18,0,91
19,3,15,20,3,8,5,19,0,92
19,3,15,20,3,8,9,14,7,98
19,3,15,20,3,8,13,5,14,100
19,3,15,20,5,0,0,0,0,62
19,3,15,20,5,18,19,0,0,99
19,3,15,20,9,1,19,0,0,86
19,3,15,20,9,14,15,0,0,95
19,3,15,20,15,7,18,1,13,111
19,3,15,20,15,13,1,0,0,86
19,3,15,20,15,13,1,19,0,105
19,3,15,20,15,13,1,20,1,107
19,3,15,20,15,13,25,0,0,110
19,3,15,20,15,13,9,1,0,95
19,3,15,20,15,13,9,3,0,97
19,3,15,20,15,16,9,1,0,98
19,3,15,20,15,16,9,1,19,117
19,3,15,20,15,16,9,3,0,100
19,3,15,20,15,19,9,19,0,119
19,3,15,20,20,9,3,5,0,94
19,3,15,21,3,8,0,0,0,69
19,3,15,21,11,0,0,0,0,69
19,3,15,21,14,4,18,5,12,111
19,3,15,21,16,0,0,0,0,74
19,3,15,21,18,0,0,0,0,76
19,3,15,21,18,1,7,5,0,89
19,3,15,21,18,5,4,0,0,85
19,3,15,21,18,5,18,0,0,99
19,3,15,21,18,5,18,19,0,118
19,3,15,21,18,5,19,19,0,119
19,3,15,21,18,6,9,19,8,118
19,3,15,21,18,7,5,0,0,88
19,3,15,21,18,7,5,4,0,92
19,3,15,21,18,7,5,18,0,106
19,3,15,21,18,7,5,18,19,125
19,3,15,21,18,7,5,19,0,107
19,3,15,21,18,7,9,14,7,113
19,3,15,21,18,25,0,0,0,101
19,3,15,21,18,9,14,7,0,106
19,3,15,21,18,9,14,7,19,125
19,3,15,21,18,19,0,0,0,95
19,3,15,21,18,23,1,25,0,125
19,3,15,21,18,23,5,5,4,113
19,3,15,21,18,23,15,18,20,152
19,3,15,21,19,5,19,0,0,101
19,3,15,21,20,4,15,13,0,110
19,3,15,21,20,5,4,0,0,87
19,3,15,21,20,5,18,0,0,101
19,3,15,21,20,5,18,19,0,120
19,3,15,21,20,8,0,0,0,86
19,3,15,21,20,8,5,18,0,109
19,3,15,21,20,8,5,18,19,128
19,3,15,21,20,8,15,15,4,120
19,3,15,21,20,8,19,0,0,105
19,3,15,21,20,9,14,7,19,127
19,3,15,21,20,9,19,8,0,114
19,3,15,21,20,19,0,0,0,97
19,3,15,22,5,0,0,0,0,64
19,3,15,22,5,12,0,0,0,76
19,3,15,22,25,0,0,0,0,84
19,3,15,23,0,0,0,0,0,60
19,3,15,23,2,1,14,11,0,88
19,3,15,23,4,5,18,0,0,87
19,3,15,23,4,5,18,5,4,96
19,3,15,23,4,5,18,19,0,106
19,3,15,23,5,4,0,0,0,69
19,3,15,23,9,14,7,0,0,90
19,3,15,23,12,0,0,0,0,72
19,3,15,23,12,5,4,0,0,81
19,3,15,23,12,5,18,0,0,95
19,3,15,23,12,5,18,19,0,114
19,3,15,23,12,6,21,12,0,111
19,3,15,23,12,9,14,7,0,102
19,3,15,23,12,19,0,0,0,91
19,3,15,23,13,1,14,0,0,88
19,3,15,23,13,5,14,0,0,92
19,3,15,23,19,0,0,0,0,79
19,3,15,23,20,8,5,18,0,111
19,3,18,1,2,0,0,0,0,43
19,3,18,1,2,2,12,5,4,66
19,3,18,1,2,2,12,5,18,80
19,3,18,1,2,2,12,5,19,81
19,3,18,1,2,2,12,25,0,82
19,3,18,1,2,5,0,0,0,48
19,3,18,1,2,5,18,0,0,66
19,3,18,1,5,0,0,0,0,46
19,3,18,1,6,6,12,5,0,70
19,3,18,1,7,0,0,0,0,48
19,3,18,1,7,7,5,4,0,64
19,3,18,1,7,7,5,18,0,78
19,3,18,1,7,7,25,0,0,80
19,3,18,1,7,7,9,5,18,87
19,3,18,1,7,7,9,12,25,101
19,3,18,1,7,7,9,14,7,85
19,3,18,1,7,7,12,5,0,72
19,3,18,1,7,7,12,5,4,76
19,3,18,1,7,7,12,25,0,92
19,3,18,1,7,19,0,0,0,67
19,3,18,1,25,0,0,0,0,66
19,3,18,1,9,3,8,0,0,61
19,3,18,1,9,3,8,5,4,70
19,3,18,1,9,3,8,19,0,80
19,3,18,1,25,5,0,0,0,71
19,3,18,1,9,7,8,0,0,65
19,3,18,1,9,7,8,5,4,74
19,3,18,1,9,7,8,19,0,84
19,3,18,1,9,12,25,0,0,87
19,3,18,1,13,1,19,1,24,99
19,3,18,1,13,2,0,0,0,56
19,3,18,1,13,2,12,5,0,73
19,3,18,1,13,2,12,5,4,77
19,3,18,1,13,2,12,5,18,91
19,3,18,1,13,2,12,5,19,92
19,3,18,1,13,2,12,25,0,93
19,3,18,1,13,10,5,20,0,89
19,3,18,1,13,13,5,4,0,76
19,3,18,1,13,13,9,14,7,97
19,3,18,1,13,16,21,13,0,104
19,3,18,1,13,19,0,0,0,73
19,3,18,1,14,0,0,0,0,55
19,3,18,1,14,3,8,0,0,66
19,3,18,1,14,11,0,0,0,66
19,3,18,1,14,11,25,0,0,91
19,3,18,1,14,14,5,12,0,86
19,3,18,1,14,14,5,12,19,105
19,3,18,1,14,14,25,0,0,94
19,3,18,1,14,14,9,5,18,101
19,3,18,1,14,14,9,14,7,99
19,3,18,1,16,0,0,0,0,57
19,3,18,1,16,1,2,12,5,77
19,3,18,1,16,2,15,15,11,100
19,3,18,1,16,5,0,0,0,62
19,3,18,1,16,5,1,7,5,75
19,3,18,1,16,5,4,0,0,66
19,3,18,1,16,5,18,0,0,80
19,3,18,1,16,5,18,19,0,99
19,3,18,1,16,5,19,0,0,81
19,3,18,1,16,8,5,1,16,87
19,3,18,1,16,25,0,0,0,82
19,3,18,1,16,9,5,0,0,71
19,3,18,1,16,9,5,19,0,90
19,3,18,1,16,9,14,7,0,87
19,3,18,1,16,9,14,7,19,106
19,3,18,1,16,12,5,18,0,92
19,3,18,1,16,12,5,20,0,94
19,3,18,1,16,12,9,14,7,99
19,3,18,1,16,13,1,14,0,85
19,3,18,1,16,16,1,7,5,86
19,3,18,1,16,16,5,4,0,82
19,3,18,1,16,16,5,18,0,96
19,3,18,1,16,16,5,18,19,115
19,3,18,1,16,16,5,20,0,98
19,3,18,1,16,16,25,0,0,98
19,3,18,1,16,16,9,5,18,105
19,3,18,1,16,16,9,12,25,119
19,3,18,1,16,16,9,14,7,103
19,3,18,1,16,16,12,5,0,90
19,3,18,1,16,16,12,5,18,108
19,3,18,1,16,16,12,5,19,109
19,3,18,1,16,19,0,0,0,76
19,3,18,1,20,0,0,0,0,61
19,3,18,1,20,3,8,5,4,81
19,3,18,1,20,3,8,5,18,95
19,3,18,1,20,3,8,5,19,96
19,3,18,1,20,3,8,25,0,97
19,3,18,1,20,8,0,0,0,69
19,3,18,1,20,20,5,18,0,104
19,3,18,1,20,20,12,5,0,98
19,3,18,1,21,3,8,0,0,73
19,3,18,1,21,3,8,12,5,90
19,3,18,1,21,14,3,8,0,87
19,3,18,1,23,0,0,0,0,64
19,3,18,1,23,11,0,0,0,75
19,3,18,1,23,12,0,0,0,76
19,3,18,1,23,12,5,4,0,85
19,3,18,1,23,12,5,18,0,99
19,3,18,1,23,12,5,18,19,118
19,3,18,1,23,12,25,0,0,101
19,3,18,1,23,12,9,5,18,108
19,3,18,1,23,12,9,14,7,106
19,3,18,1,23,12,19,0,0,95
19,3,18,1,23,13,0,0,0,77
19,3,18,1,23,14,25,0,0,103
19,3,18,1,23,14,9,5,18,110
19,3,18,1,23,14,9,12,25,124
19,3,18,1,26,5,0,0,0,72
19,3,18,5,1,11,0,0,0,57
19,3,18,5,1,11,5,4,0,66
19,3,18,5,1,11,25,0,0,82
19,3,18,5,1,11,9,14,7,87
19,3,18,5,1,11,19,0,0,76
19,3,18,5,1,13,0,0,0,59
19,3,18,5,1,13,5,4,0,68
19,3,18,5,1,13,5,18,0,82
19,3,18,5,1,13,5,18,19,101
19,3,18,5,1,13,25,0,0,84
19,3,18,5,1,13,9,14,7,89
19,3,18,5,1,13,19,0,0,78
19,3,18,5,1,18,0,0,0,64
19,3,18,5,5,0,0,0,0,50
19,3,18,5,5,3,8,0,0,61
19,3,18,5,5,3,8,5,4,70
19,3,18,5,5,3,8,5,18,84
19,3,18,5,5,3,8,5,19,85
19,3,18,5,5,3,8,25,0,86
19,3,18,5,5,4,0,0,0,54
19,3,18,5,5,4,5,4,0,63
19,3,18,5,5,4,9,14,7,84
19,3,18,5,5,4,19,0,0,73
19,3,18,5,5,11,0,0,0,61
19,3,18,5,5,12,0,0,0,62
19,3,18,5,5,13,1,14,0,78
19,3,18,5,5,14,0,0,0,64
19,3,18,5,5,14,1,7,5,77
19,3,18,5,5,14,4,15,13,96
19,3,18,5,5,14,5,4,0,73
19,3,18,5,5,14,5,18,0,87
19,3,18,5,5,14,5,18,19,106
19,3,18,5,5,14,6,21,12,103
19,3,18,5,5,14,25,0,0,89
19,3,18,5,5,14,9,14,7,94
19,3,18,5,5,14,13,1,14,92
19,3,18,5,5,14,15,0,0,79
19,3,18,5,5,19,0,0,0,69
19,3,18,5,5,20,0,0,0,70
19,3,18,5,5,22,5,0,0,77
19,3,18,5,5,22,5,4,0,81
19,3,18,5,5,22,5,18,0,95
19,3,18,5,5,22,9,14,7,102
19,3,18,5,9,3,8,0,0,65
19,3,18,5,9,7,8,0,0,69
19,3,18,5,22,5,0,0,0,72
19,3,18,5,22,5,18,0,0,90
19,3,18,5,23,0,0,0,0,68
19,3,18,5,23,1,2,12,5,88
19,3,18,5,23,1,7,5,0,81
19,3,18,5,23,2,1,12,12,95
19,3,18,5,23,2,5,1,14,90
19,3,18,5,23,5,4,0,0,77
19,3,18,5,23,5,18,0,0,91
19,3,18,5,23,5,18,19,0,110
19,3,18,5,23,6,12,25,0,111
19,3,18,5,23,8,5,1,4,86
19,3,18,5,23,25,0,0,0,93
19,3,18,5,23,9,5,18,0,100
19,3,18,5,23,9,5,19,20,121
19,3,18,5,23,9,14,7,0,98
19,3,18,5,23,9,19,8,0,104
19,3,18,5,23,12,5,19,19,123
19,3,18,5,23,12,9,11,5,105
19,3,18,5,23,13,1,14,0,96
19,3,18,5,23,16,9,12,5,110
19,3,18,5,23,16,15,4,0,103
19,3,18,5,23,19,0,0,0,87
19,3,18,5,23,19,8,9,16,120
19,3,18,5,23,19,13,1,14,115
19,3,18,5,23,19,20,5,13,125
19,3,18,5,23,21,16,0,0,105
19,3,18,5,23,21,16,19,0,124
19,3,18,5,23,23,9,19,5,124
19,3,18,5,23,23,15,18,13,137
19,3,18,6,3,8,1,18,0,76
19,3,18,25,0,0,0,0,0,65
19,3,18,9,2,1,2,12,5,71
19,3,18,9,2,1,12,0,0,64
19,3,18,9,2,1,12,19,0,83
19,3,18,9,2,1,14,14,5,85
19,3,18,9,2,2,5,20,0,78
19,3,18,9,2,2,12,5,0,70
19,3,18,9,2,2,12,5,4,74
19,3,18,9,2,2,12,5,18,88
19,3,18,9,2,2,12,5,19,89
19,3,18,9,2,2,12,25,0,90
19,3,18,9,2,5,4,0,0,60
19,3,18,9,2,5,18,0,0,74
19,3,18,9,2,5,18,19,0,93
19,3,18,9,2,5,19,0,0,75
19,3,18,9,2,9,14,7,0,81
19,3,18,9,2,9,19,13,0,92
19,3,18,9,4,5,0,0,0,58
19,3,18,9,5,4,0,0,0,58
19,3,18,25,5,18,0,0,0,88
19,3,18,9,5,19,0,0,0,73
19,3,18,9,5,22,5,0,0,81
19,3,18,9,5,22,5,4,0,85
19,3,18,9,5,22,5,18,0,99
19,3,18,9,5,22,5,19,0,100
19,3,18,9,5,22,9,14,7,106
19,3,18,9,7,7,12,5,0,80
19,3,18,9,7,7,12,5,18,98
19,3,18,9,7,7,12,25,0,100
19,3,18,25,9,14,7,0,0,95
19,3,18,9,11,5,0,0,0,65
19,3,18,9,13,0,0,0,0,62
19,3,18,9,13,5,0,0,0,67
19,3,18,9,13,5,18,0,0,85
19,3,18,9,13,25,0,0,0,87
19,3,18,9,13,13,1,7,5,88
19,3,18,9,13,16,0,0,0,78
19,3,18,9,13,16,5,4,0,87
19,3,18,9,13,16,5,18,0,101
19,3,18,9,13,16,25,0,0,103
19,3,18,9,13,16,9,5,18,110
19,3,18,9,13,16,9,12,25,124
19,3,18,9,13,16,9,14,7,108
19,3,18,9,13,16,9,20,0,107
19,3,18,9,13,16,12,25,0,115
19,3,18,9,13,16,19,0,0,97
19,3,18,9,13,19,0,0,0,81
19,3,18,9,13,19,8,1,23,113
19,3,18,9,13,19,8,15,14,118
19,3,18,9,14,0,0,0,0,63
19,3,18,9,14,3,8,0,0,74
19,3,18,9,14,5,0,0,0,68
19,3,18,9,14,7,5,0,0,75
19,3,18,9,14,9,1,0,0,73
19,3,18,9,14,9,1,18,25,116
19,3,18,9,14,9,21,13,0,106
19,3,18,9,16,0,0,0,0,65
19,3,18,9,16,5,5,0,0,75
19,3,18,9,16,12,5,19,19,120
19,3,18,9,16,16,1,7,5,94
19,3,18,9,16,19,0,0,0,84
19,3,18,9,16,19,9,20,0,113
19,3,18,9,16,20,5,4,0,94
19,3,18,9,16,20,5,18,0,108
19,3,18,9,16,20,9,14,7,115
19,3,18,9,16,20,9,15,14,123
19,3,18,9,16,20,9,22,5,121
19,3,18,9,16,20,15,0,0,100
19,3,18,9,16,20,15,18,0,118
19,3,18,9,16,20,15,18,25,143
19,3,18,9,16,20,19,0,0,104
19,3,18,9,16,20,21,13,0,119
19,3,18,9,16,21,12,1,0,99
19,3,18,9,16,21,12,21,13,132
19,3,18,9,20,0,0,0,0,69
19,3,18,9,20,3,8,0,0,80
19,3,18,9,20,5,0,0,0,74
19,3,18,9,20,8,5,0,0,82
19,3,18,9,20,15,9,18,5,116
19,3,18,9,22,1,14,0,0,86
19,3,18,9,22,1,14,15,0,101
19,3,18,9,22,5,0,0,0,76
19,3,18,9,22,5,4,0,0,80
19,3,18,9,22,5,12,12,15,115
19,3,18,9,22,5,14,5,18,113
19,3,18,9,22,5,14,12,25,127
19,3,18,9,22,5,18,0,0,94
19,3,18,9,22,5,19,0,0,95
19,3,18,9,22,9,14,7,0,101
19,3,18,15,2,0,0,0,0,57
19,3,18,15,2,2,12,5,0,76
19,3,18,15,2,5,0,0,0,62
19,3,18,15,2,9,19,0,0,85
19,3,18,15,4,0,0,0,0,59
19,3,18,15,4,4,12,5,4,84
19,3,18,15,4,7,9,12,12,99
19,3,18,15,4,19,0,0,0,78
19,3,18,15,6,6,0,0,0,67
19,3,18,15,6,21,12,1,0,95
19,3,18,15,6,21,12,1,19,114
19,3,18,15,7,0,0,0,0,62
19,3,18,15,7,7,5,4,0,78
19,3,18,15,7,7,25,0,0,94
19,3,18,15,7,7,9,5,0,83
19,3,18,15,7,7,9,5,18,101
19,3,18,15,7,9,5,0,0,76
19,3,18,15,7,19,0,0,0,81
19,3,18,15,25,12,5,0,0,97
19,3,18,15,9,14,15,3,8,104
19,3,18,15,9,14,15,7,8,108
19,3,18,15,12,1,18,0,0,86
19,3,18,15,12,12,0,0,0,79
19,3,18,15,12,12,5,4,0,88
19,3,18,15,12,12,5,18,25,127
19,3,18,15,12,12,25,0,0,104
19,3,18,15,12,12,9,14,7,109
19,3,18,15,12,12,19,0,0,98
19,3,18,15,14,1,3,8,0,81
19,3,18,15,15,0,0,0,0,70
19,3,18,15,15,3,8,0,0,81
19,3,18,15,15,7,5,19,0,101
19,3,18,15,15,16,0,0,0,86
19,3,18,15,15,16,5,4,0,95
19,3,18,15,15,16,9,14,7,116
19,3,18,15,15,16,19,0,0,105
19,3,18,15,15,20,3,8,0,101
19,3,18,15,20,1,0,0,0,76
19,3,18,15,20,1,12,0,0,88
19,3,18,15,20,9,20,9,19,132
19,3,18,15,20,20,1,0,0,96
19,3,18,15,20,21,13,0,0,109
19,3,18,15,20,21,13,19,0,128
19,3,18,15,21,7,5,0,0,88
19,3,18,15,21,7,5,4,0,92
19,3,18,15,21,7,5,18,0,106
19,3,18,15,21,7,5,19,0,107
19,3,18,15,21,7,9,14,7,113
19,3,18,15,21,14,7,5,0,102
19,3,18,15,21,14,7,5,4,106
19,3,18,15,21,14,7,5,18,120
19,3,18,15,21,14,7,5,19,121
19,3,18,15,21,14,7,25,0,122
19,3,18,15,21,20,0,0,0,96
19,3,18,15,23,0,0,0,0,78
19,3,18,21,2,0,0,0,0,63
19,3,18,21,2,2,5,4,0,74
19,3,18,21,2,2,5,18,0,88
19,3,18,21,2,2,5,18,25,113
19,3,18,21,2,2,5,18,19,107
19,3,18,21,2,2,25,0,0,90
19,3,18,21,2,2,9,5,18,97
19,3,18,21,2,2,9,12,25,111
19,3,18,21,2,2,9,14,7,95
19,3,18,21,2,2,9,18,4,96
19,3,18,21,2,2,12,25,0,102
19,3,18,21,2,12,1,14,4,94
19,3,18,21,2,12,9,11,5,100
19,3,18,21,2,19,0,0,0,82
19,3,18,21,2,23,15,15,4,120
19,3,18,21,6,0,0,0,0,67
19,3,18,21,6,6,0,0,0,73
19,3,18,21,6,6,25,0,0,98
19,3,18,21,6,6,9,5,18,105
19,3,18,21,6,6,9,12,25,119
19,3,18,21,6,6,12,5,0,90
19,3,18,21,6,6,13,1,14,101
19,3,18,21,6,6,19,0,0,92
19,3,18,21,6,20,0,0,0,87
19,3,18,21,13,0,0,0,0,74
19,3,18,21,13,13,1,7,5,100
19,3,18,21,13,13,5,4,0,96
19,3,18,21,13,16,0,0,0,90
19,3,18,21,13,16,25,0,0,115
19,3,18,21,13,16,12,5,0,107
19,3,18,21,13,19,0,0,0,93
19,3,18,21,14,3,8,0,0,86
19,3,18,21,14,3,8,5,4,95
19,3,18,21,14,3,8,5,19,110
19,3,18,21,14,3,8,25,0,111
19,3,18,21,14,3,8,19,0,105
19,3,18,21,14,7,5,0,0,87
19,3,18,21,14,7,5,18,0,105
19,3,18,21,14,20,0,0,0,95
19,3,18,21,14,20,25,0,0,120
19,3,18,21,16,12,5,0,0,94
19,3,18,21,16,12,5,4,0,98
19,3,18,21,16,12,5,18,0,112
19,3,18,21,16,12,5,19,0,113
19,3,18,21,16,12,9,14,7,119
19,3,18,21,16,21,12,1,0,111
19,3,18,21,16,21,12,1,18,129
19,3,18,21,16,21,12,9,0,119
19,3,18,21,16,21,12,21,13,144
19,3,18,21,16,21,12,21,19,150
19,3,18,21,19,8,0,0,0,88
19,3,18,21,20,1,2,12,5,101
19,3,18,21,20,1,20,5,0,107
19,3,18,21,20,1,20,15,18,135
19,3,18,21,20,9,14,25,0,129
19,3,18,21,20,15,0,0,0,96
19,3,18,21,20,15,9,18,5,128
19,3,18,21,26,5,0,0,0,92
19,3,20,4,0,0,0,0,0,46
19,3,21,2,1,19,0,0,0,65
19,3,21,4,4,1,12,5,18,87
19,3,21,4,4,1,23,14,0,89
19,3,21,4,4,5,4,0,0,60
19,3,21,4,4,5,18,0,0,74
19,3,21,4,4,9,3,11,0,74
19,3,21,4,4,9,14,7,0,81
19,3,21,4,4,12,5,0,0,68
19,3,21,4,9,0,0,0,0,56
19,3,21,4,12,5,18,0,0,82
19,3,21,4,15,0,0,0,0,62
19,3,21,4,19,0,0,0,0,66
19,3,21,6,6,0,0,0,0,55
19,3,21,6,6,5,4,0,0,64
19,3,21,6,6,5,18,0,0,78
19,3,21,6,6,25,0,0,0,80
19,3,21,6,6,9,14,7,0,85
19,3,21,6,6,12,5,0,0,72
19,3,21,6,6,12,5,4,0,76
19,3,21,6,6,12,5,18,0,90
19,3,21,6,6,12,5,18,19,109
19,3,21,6,6,12,5,19,0,91
19,3,21,6,6,12,25,0,0,92
19,3,21,6,6,12,9,14,7,97
19,3,21,6,6,19,0,0,0,74
19,3,21,6,20,0,0,0,0,69
19,3,21,6,20,5,18,0,0,92
19,3,21,7,0,0,0,0,0,50
19,3,21,7,7,5,18,25,0,105
19,3,21,12,3,8,0,0,0,66
19,3,21,12,11,0,0,0,0,66
19,3,21,12,11,5,4,0,0,75
19,3,21,12,11,5,18,0,0,89
19,3,21,12,11,5,18,19,0,108
19,3,21,12,11,9,14,7,0,96
19,3,21,12,11,19,0,0,0,85
19,3,21,12,12,0,0,0,0,67
19,3,21,12,12,5,4,0,0,76
19,3,21,12,12,5,18,0,0,90
19,3,21,12,12,5,18,25,0,115
19,3,21,12,12,5,18,19,0,109
19,3,21,12,12,6,21,12,0,106
19,3,21,12,12,9,14,7,0,97
19,3,21,12,12,9,15,14,0,105
19,3,21,12,12,9,15,14,19,124
19,3,21,12,12,15,7,0,0,89
19,3,21,12,12,15,7,21,5,115
19,3,21,12,12,19,0,0,0,86
19,3,21,12,16,0,0,0,0,71
19,3,21,12,16,5,4,0,0,80
19,3,21,12,16,5,18,0,0,94
19,3,21,12,16,9,14,0,0,94
19,3,21,12,16,9,14,7,0,101
19,3,21,12,16,9,14,19,0,113
19,3,21,12,16,19,0,0,0,90
19,3,21,12,16,19,9,20,0,119
19,3,21,12,16,20,0,0,0,91
19,3,21,12,16,20,5,4,0,100
19,3,21,12,16,20,9,12,5,117
19,3,21,12,16,20,9,14,7,121
19,3,21,12,16,20,15,18,19,143
19,3,21,12,16,20,19,0,0,110
19,3,21,12,16,20,21,18,5,135
19,3,21,12,19,8,0,0,0,82
19,3,21,12,20,0,0,0,0,75
19,3,21,13,0,0,0,0,0,56
19,3,21,13,2,5,18,0,0,81
19,3,21,13,2,12,5,0,0,75
19,3,21,13,2,12,5,4,0,79
19,3,21,13,2,12,5,19,0,94
19,3,21,13,2,12,9,14,7,100
19,3,21,13,2,15,1,18,4,96
19,3,21,13,6,9,19,8,0,98
19,3,21,13,12,5,19,19,0,111
19,3,21,13,12,9,11,5,0,93
19,3,21,13,13,5,4,0,0,78
19,3,21,13,13,5,18,0,0,92
19,3,21,13,13,5,18,19,0,111
19,3,21,13,13,25,0,0,0,94
19,3,21,13,13,9,5,18,0,101
19,3,21,13,13,9,5,19,20,122
19,3,21,13,13,9,14,7,0,99
19,3,21,13,16,18,15,15,6,126
19,3,21,13,19,0,0,0,0,75
19,3,21,14,0,0,0,0,0,57
19,3,21,14,3,8,5,15,14,102
19,3,21,14,4,5,18,0,0,84
19,3,21,14,7,5,0,0,0,69
19,3,21,14,7,25,0,0,0,89
19,3,21,14,7,9,12,9,0,94
19,3,21,14,7,9,12,12,9,106
19,3,21,14,14,5,18,0,0,94
19,3,21,14,14,5,18,5,4,103
19,3,21,14,14,5,18,19,0,113
19,3,21,16,0,0,0,0,0,59
19,3,21,16,6,21,12,0,0,98
19,3,21,16,16,1,21,7,0,104
19,3,21,16,16,1,21,7,19,123
19,3,21,16,16,5,18,0,0,98
19,3,21,16,16,5,18,5,4,107
19,3,21,16,16,5,18,19,0,117
19,3,21,16,16,5,20,0,0,100
19,3,21,16,16,9,20,0,0,104
19,3,21,16,16,12,5,18,0,110
19,3,21,16,19,0,0,0,0,78
19,3,21,18,0,0,0,0,0,61
19,3,21,18,4,25,0,0,0,90
19,3,21,18,6,0,0,0,0,67
19,3,21,18,6,5,18,0,0,90
19,3,21,18,6,25,0,0,0,92
19,3,21,18,6,9,5,18,0,99
19,3,21,18,6,9,5,19,20,120
19,3,21,18,6,9,12,25,0,113
19,3,21,18,6,12,9,11,5,104
19,3,21,18,6,19,0,0,0,86
19,3,21,18,12,9,14,7,0,103
19,3,21,18,18,25,0,0,0,104
19,3,21,18,18,9,5,4,0,97
19,3,21,18,18,9,5,18,0,111
19,3,21,18,18,9,5,19,0,112
19,3,21,18,18,25,9,14,7,134
19,3,21,18,18,9,12,0,0,100
19,3,21,18,18,9,12,5,0,105
19,3,21,18,22,25,0,0,0,108
19,3,21,18,22,9,5,4,0,101
19,3,21,18,22,9,5,18,0,115
19,3,21,18,22,9,5,19,0,116
19,3,21,18,22,9,5,19,20,136
19,3,21,18,22,9,12,25,0,129
19,3,21,18,22,9,19,8,0,119
19,3,21,19,1,20,9,15,14,121
19,3,21,19,5,0,0,0,0,67
19,3,21,19,9,14,0,0,0,85
19,3,21,20,0,0,0,0,0,63
19,3,21,20,1,0,0,0,0,64
19,3,21,20,1,7,5,0,0,76
19,3,21,20,1,7,5,19,0,95
19,3,21,20,1,12,0,0,0,76
19,3,21,20,1,20,5,0,0,89
19,3,21,20,1,20,5,4,0,93
19,3,21,20,1,20,9,15,14,122
19,3,21,20,3,8,0,0,0,74
19,3,21,20,3,8,5,4,0,83
19,3,21,20,3,8,5,15,14,108
19,3,21,20,3,8,5,18,0,97
19,3,21,20,3,8,5,18,19,116
19,3,21,20,3,8,5,19,0,98
19,3,21,20,3,8,9,14,7,104
19,3,21,20,3,8,19,0,0,93
19,3,21,20,5,0,0,0,0,68
19,3,21,20,5,12,0,0,0,80
19,3,21,20,5,12,12,1,0,93
19,3,21,20,5,12,12,1,5,98
19,3,21,20,5,12,12,1,18,111
19,3,21,20,5,12,12,21,13,126
19,3,21,20,5,19,0,0,0,87
19,3,21,20,9,6,5,18,0,101
19,3,21,20,9,6,15,18,13,124
19,3,21,20,9,7,5,18,0,102
19,3,21,20,9,16,5,4,0,97
19,3,21,20,19,0,0,0,0,82
19,3,21,20,20,1,0,0,0,84
19,3,21,20,20,5,18,0,0,106
19,3,21,20,20,5,18,5,4,115
19,3,21,20,20,5,18,19,0,125
19,3,21,20,20,25,0,0,0,108
19,3,21,20,20,12,5,0,0,100
19,3,21,20,20,12,5,4,0,104
19,3,21,20,20,12,5,18,0,118
19,3,21,20,20,12,5,19,0,119
19,3,21,20,20,12,9,14,7,125
19,3,21,20,20,15,3,11,0,112
19,3,21,20,21,12,1,0,0,97
19,3,21,20,21,12,1,18,0,115
19,3,21,20,21,12,1,20,5,122
19,3,21,20,21,12,21,13,0,130
19,3,21,26,0,0,0,0,0,69
19,3,21,26,26,25,0,0,0,120
19,3,21,26,26,9,5,18,0,127
19,4,5,1,20,8,0,0,0,57
19,4,5,9,7,14,0,0,0,58
19,4,21,13,16,0,0,0,0,73
19,5,2,1,3,1,20,5,0,56
19,5,2,1,3,5,15,21,19,90
19,5,2,1,3,9,3,0,0,42
19,5,2,1,7,15,0,0,0,49
19,5,2,1,9,20,0,0,0,56
19,5,2,1,19,9,3,0,0,58
19,5,2,1,19,20,9,14,5,94
19,5,2,1,20,0,0,0,0,47
19,5,2,1,20,5,0,0,0,52
19,5,2,5,19,20,5,14,0,89
19,5,2,9,6,9,3,0,0,53
19,5,2,9,12,12,1,0,0,60
19,5,2,11,8,1,0,0,0,46
19,5,2,15,12,9,20,8,0,90
19,5,2,15,18,18,8,5,1,91
19,5,2,21,13,0,0,0,0,60
19,5,2,21,13,19,0,0,0,79
19,5,2,21,14,4,25,0,0,90
19,5,3,1,2,12,5,0,0,47
19,5,3,1,12,9,14,0,0,63
19,5,3,1,12,9,14,5,0,68
19,5,3,1,12,15,19,5,0,79
19,5,3,1,14,3,25,0,0,70
19,5,3,1,14,20,0,0,0,62
19,5,3,1,14,20,12,25,0,99
19,5,3,1,14,20,19,0,0,81
19,5,3,1,20,5,21,18,0,92
19,5,3,1,20,5,21,18,19,111
19,5,3,3,8,9,15,0,0,62
19,5,3,3,15,0,0,0,0,45
19,5,3,3,15,19,0,0,0,64
19,5,3,3,15,20,9,14,5,93
19,5,3,5,4,5,0,0,0,41
19,5,3,5,4,5,4,0,0,45
19,5,3,5,4,5,18,19,0,78
19,5,3,5,4,5,19,0,0,60
19,5,3,5,4,9,14,7,0,66
19,5,3,5,18,14,0,0,0,64
19,5,3,5,18,14,5,4,0,73
19,5,3,5,18,14,5,14,20,103
19,5,3,5,18,14,9,14,7,94
19,5,3,5,18,14,19,0,0,83
19,5,3,5,19,8,0,0,0,59
19,5,3,5,19,8,5,18,0,82
19,5,3,5,19,19,0,0,0,70
19,5,3,8,0,0,0,0,0,35
19,5,3,25,0,0,0,0,0,52
19,5,3,11,0,0,0,0,0,38
19,5,3,12,21,4,5,0,0,69
19,5,3,12,21,4,5,4,0,73
19,5,3,12,21,4,5,19,0,88
19,5,3,12,21,4,9,14,7,94
19,5,3,12,21,19,5,0,0,84
19,5,3,12,21,19,9,15,14,117
19,5,3,12,21,19,9,22,5,115
19,5,3,14,15,0,0,0,0,56
19,5,3,15,4,15,14,20,0,95
19,5,3,15,8,13,0,0,0,63
19,5,3,15,14,4,0,0,0,60
19,5,3,15,14,4,1,18,0,79
19,5,3,15,14,4,1,18,25,104
19,5,3,15,14,4,5,0,0,65
19,5,3,15,14,4,5,4,0,69
19,5,3,15,14,4,5,18,0,83
19,5,3,15,14,4,5,18,19,102
19,5,3,15,14,4,5,19,0,84
19,5,3,15,14,4,9,0,0,69
19,5,3,15,14,4,9,14,5,88
19,5,3,15,14,4,9,14,7,90
19,5,3,15,14,4,12,25,0,97
19,5,3,15,14,4,15,0,0,75
19,5,3,15,14,4,19,0,0,79
19,5,3,15,19,0,0,0,0,61
19,5,3,15,21,18,19,0,0,100
19,5,3,16,1,18,0,0,0,62
19,5,3,16,1,18,19,0,0,81
19,5,3,17,21,5,0,0,0,70
19,5,3,18,1,20,9,15,14,104
19,5,3,18,5,0,0,0,0,50
19,5,3,18,5,3,25,0,0,78
19,5,3,18,5,3,9,5,19,86
19,5,3,18,5,20,0,0,0,70
19,5,3,18,5,20,1,7,5,83
19,5,3,18,5,20,1,18,0,89
19,5,3,18,5,20,1,18,25,114
19,5,3,18,5,20,5,0,0,75
19,5,3,18,5,20,5,4,0,79
19,5,3,18,5,20,5,18,0,93
19,5,3,18,5,20,5,19,0,94
19,5,3,18,5,20,5,19,20,114
19,5,3,18,5,20,9,14,0,93
19,5,3,18,5,20,9,14,7,100
19,5,3,18,5,20,9,14,19,112
19,5,3,18,5,20,9,15,14,108
19,5,3,18,5,20,9,22,5,106
19,5,3,18,5,20,12,25,0,107
19,5,3,18,5,20,15,0,0,85
19,5,3,18,5,20,15,18,0,103
19,5,3,18,5,20,15,18,25,128
19,5,3,18,5,20,15,18,19,122
19,5,3,18,5,20,19,0,0,89
19,5,3,18,5,20,21,13,0,104
19,5,3,20,0,0,0,0,0,47
19,5,3,20,1,18,9,1,12,88
19,5,3,20,1,18,9,1,14,90
19,5,3,20,1,18,9,5,19,99
19,5,3,20,1,18,9,19,13,107
19,5,3,20,1,18,9,19,20,114
19,5,3,20,1,20,15,18,0,101
19,5,3,20,9,12,5,0,0,73
19,5,3,20,9,12,9,20,25,122
19,5,3,20,9,15,14,0,0,85
19,5,3,20,9,15,14,1,12,98
19,5,3,20,9,15,14,5,4,94
19,5,3,20,9,15,14,19,0,104
19,5,3,20,9,19,13,0,0,88
19,5,3,20,9,19,20,0,0,95
19,5,3,20,9,22,5,0,0,83
19,5,3,20,15,18,0,0,0,80
19,5,3,20,15,18,1,12,0,93
19,5,3,20,15,18,5,4,0,89
19,5,3,20,15,18,9,1,12,102
19,5,3,20,15,18,9,14,7,110
19,5,3,20,15,18,19,0,0,99
19,5,3,20,18,15,9,4,0,93
19,5,3,20,19,0,0,0,0,66
19,5,3,20,21,1,18,25,0,112
19,5,3,20,23,9,19,5,0,103
19,5,3,21,12,1,18,0,0,79
19,5,3,21,12,1,18,12,25,116
19,5,3,21,12,1,18,19,0,98
19,5,3,21,12,21,13,0,0,94
19,5,3,21,14,4,0,0,0,66
19,5,3,21,14,4,1,20,5,92
19,5,3,21,14,4,9,14,5,94
19,5,3,21,14,4,12,25,0,103
19,5,3,21,14,4,21,13,0,100
19,5,3,21,14,4,21,19,0,106
19,5,3,21,18,1,2,12,5,86
19,5,3,21,18,1,14,3,5,89
19,5,3,21,18,5,0,0,0,71
19,5,3,21,18,5,4,0,0,75
19,5,3,21,18,5,6,21,12,110
19,5,3,21,18,5,12,25,0,108
19,5,3,21,18,5,18,0,0,89
19,5,3,21,18,5,18,19,0,108
19,5,3,21,18,5,19,0,0,90
19,5,3,21,18,5,19,20,0,110
19,5,3,21,18,9,6,5,18,104
19,5,3,21,18,9,14,7,0,96
19,5,3,21,18,9,14,7,19,115
19,5,3,21,18,9,20,1,14,110
19,5,3,21,18,9,20,25,0,120
19,5,3,21,19,0,0,0,0,67
19,5,3,21,20,15,18,0,0,101
19,5,4,1,14,9,5,18,0,75
19,5,4,1,14,19,0,0,0,62
19,5,4,1,18,9,13,0,0,69
19,5,4,1,20,0,0,0,0,49
19,5,4,1,20,5,0,0,0,54
19,5,4,1,20,5,4,0,0,58
19,5,4,1,20,5,12,25,0,91
19,5,4,1,20,5,18,0,0,72
19,5,4,1,20,5,19,0,0,73
19,5,4,1,20,5,19,20,0,93
19,5,4,1,20,9,14,7,0,79
19,5,4,1,20,9,15,14,0,87
19,5,4,1,20,9,15,14,19,106
19,5,4,1,20,9,22,5,0,85
19,5,4,1,20,9,22,5,19,104
19,5,4,5,14,20,0,0,0,67
19,5,4,5,14,20,1,18,25,111
19,5,4,5,18,19,0,0,0,70
19,5,4,5,18,21,14,20,0,106
19,5,4,5,18,21,14,20,19,125
19,5,4,7,5,0,0,0,0,40
19,5,4,7,5,4,0,0,0,44
19,5,4,7,5,12,9,11,5,77
19,5,4,7,5,19,0,0,0,59
19,5,4,7,25,0,0,0,0,60
19,5,4,7,9,5,18,0,0,67
19,5,4,7,9,5,19,20,0,88
19,5,4,7,9,14,7,0,0,65
19,5,4,9,12,5,0,0,0,54
19,5,4,9,12,9,1,0,0,59
19,5,4,9,12,9,21,13,0,92
19,5,4,9,13,5,14,20,0,89
19,5,4,9,13,5,14,20,19,108
19,5,4,9,20,9,15,14,0,95
19,5,4,9,20,9,15,14,19,114
19,5,4,9,20,9,15,21,19,121
19,5,4,10,1,4,5,8,0,56
19,5,4,15,22,9,3,0,0,77
19,5,4,21,3,5,0,0,0,57
19,5,4,21,3,5,4,0,0,61
19,5,4,21,3,5,5,0,0,62
19,5,4,21,3,5,18,0,0,75
19,5,4,21,3,5,18,19,0,94
19,5,4,21,3,5,19,0,0,76
19,5,4,21,3,9,2,12,5,80
19,5,4,21,3,9,14,7,0,82
19,5,4,21,3,9,22,5,0,88
19,5,4,21,3,20,0,0,0,72
19,5,4,21,3,20,9,15,14,110
19,5,4,21,3,20,9,22,5,108
19,5,4,21,12,9,20,25,0,115
19,5,4,21,12,15,21,19,0,116
19,5,4,21,13,19,0,0,0,81
19,5,5,1,2,12,5,0,0,49
19,5,5,1,2,12,25,0,0,69
19,5,5,3,1,20,3,8,0,64
19,5,5,3,1,23,11,0,0,67
19,5,5,3,8,0,0,0,0,40
19,5,5,3,8,5,12,20,0,77
19,5,5,4,1,7,5,0,0,46
19,5,5,4,2,1,12,12,0,60
19,5,5,4,2,5,4,0,0,44
19,5,5,4,2,5,4,19,0,63
19,5,5,4,2,9,18,4,0,66
19,5,5,4,2,15,24,0,0,74
19,5,5,4,3,1,11,5,0,53
19,5,5,4,3,1,11,5,19,72
19,5,5,4,3,1,19,5,0,61
19,5,5,4,3,1,19,5,19,80
19,5,5,4,5,1,20,5,18,82
19,5,5,4,5,4,0,0,0,42
19,5,5,4,5,18,19,0,0,75
19,5,5,4,6,21,12,0,0,72
19,5,5,4,7,1,12,12,0,65
19,5,5,4,25,0,0,0,0,58
19,5,5,4,9,5,18,0,0,65
19,5,5,4,9,5,19,20,0,86
19,5,5,4,9,12,25,0,0,79
19,5,5,4,9,14,5,19,19,99
19,5,5,4,9,14,7,0,0,63
19,5,5,4,9,14,7,19,0,82
19,5,5,4,11,9,14,0,0,67
19,5,5,4,12,5,1,6,0,57
19,5,5,4,12,5,19,19,0,88
19,5,5,4,12,5,20,0,0,70
19,5,5,4,12,9,11,5,0,70
19,5,5,4,12,9,14,7,0,75
19,5,5,4,12,9,14,7,19,94
19,5,5,4,12,9,16,0,0,70
19,5,5,4,13,5,14,0,0,65
19,5,5,4,14,5,19,19,0,90
19,5,5,4,16,15,4,0,0,68
19,5,5,4,16,15,4,19,0,87
19,5,5,4,19,0,0,0,0,52
19,5,5,4,19,13,1,14,0,80
19,5,5,4,19,13,5,14,0,84
19,5,5,4,19,20,1,12,11,96
19,5,5,4,19,20,5,18,0,95
19,5,5,4,20,9,13,5,0,80
19,5,5,4,20,9,13,5,19,99
19,5,5,7,5,0,0,0,0,41
19,5,5,9,14,7,0,0,0,59
19,5,5,9,14,7,12,25,0,96
19,5,5,9,14,7,19,0,0,78
19,5,5,11,0,0,0,0,0,40
19,5,5,11,5,18,0,0,0,63
19,5,5,11,5,18,19,0,0,82
19,5,5,11,9,14,7,0,0,70
19,5,5,11,19,0,0,0,0,59
19,5,5,12,5,4,0,0,0,50
19,5,5,12,6,21,12,0,0,80
19,5,5,12,9,12,25,0,0,87
19,5,5,12,9,14,5,19,19,107
19,5,5,12,9,14,7,0,0,71
19,5,5,12,19,0,0,0,0,60
19,5,5,13,1,2,12,5,0,62
19,5,5,13,1,2,12,25,0,82
19,5,5,13,5,4,0,0,0,51
19,5,5,13,5,18,0,0,0,65
19,5,5,13,5,18,19,0,0,84
19,5,5,13,9,14,7,0,0,72
19,5,5,13,9,14,7,12,25,109
19,5,5,13,9,14,7,19,0,91
19,5,5,13,12,5,19,19,0,97
19,5,5,13,12,25,0,0,0,79
19,5,5,13,12,9,5,18,0,86
19,5,5,13,12,9,5,19,20,107
19,5,5,13,12,9,12,25,0,100
19,5,5,13,19,0,0,0,0,61
19,5,5,14,9,5,0,0,0,57
19,5,5,14,9,12,0,0,0,64
19,5,5,14,21,0,0,0,0,64
19,5,5,16,0,0,0,0,0,45
19,5,5,16,1,7,5,0,0,58
19,5,5,16,1,7,5,19,0,77
19,5,5,16,5,4,0,0,0,54
19,5,5,16,25,0,0,0,0,70
19,5,5,16,9,5,18,0,0,77
19,5,5,16,9,5,19,20,0,98
19,5,5,16,9,14,7,0,0,75
19,5,5,16,16,18,15,15,6,115
19,5,5,16,19,0,0,0,0,64
19,5,5,16,23,5,5,4,0,82
19,5,5,18,0,0,0,0,0,47
19,5,5,18,2,1,14,4,0,68
19,5,5,18,3,18,1,6,20,95
19,5,5,18,5,19,19,0,0,90
19,5,5,18,5,19,19,5,19,114
19,5,5,18,6,9,19,8,0,89
19,5,5,18,8,1,14,4,0,74
19,5,5,18,8,15,15,4,0,89
19,5,5,18,12,9,11,5,0,84
19,5,5,18,16,1,23,0,0,87
19,5,5,18,19,0,0,0,0,66
19,5,5,18,19,8,9,16,0,99
19,5,5,19,0,0,0,0,0,48
19,5,5,19,1,23,0,0,0,72
19,5,5,19,1,23,5,4,0,81
19,5,5,19,1,23,9,14,7,102
19,5,5,19,1,23,19,0,0,91
19,5,5,19,5,5,0,0,0,58
19,5,5,20,8,5,0,0,0,62
19,5,5,20,8,5,4,0,0,66
19,5,5,20,8,5,18,0,0,80
19,5,5,20,8,5,19,0,0,81
19,5,5,20,8,9,14,7,0,87
19,5,5,23,5,5,0,0,0,62
19,5,7,0,0,0,0,0,0,31
19,5,7,1,18,0,0,0,0,50
19,5,7,1,20,8,25,0,0,85
19,5,7,5,20,1,12,0,0,69
19,5,7,7,1,18,0,0,0,57
19,5,7,7,1,18,4,0,0,61
19,5,7,7,1,18,19,0,0,76
19,5,7,7,5,4,0,0,0,47
19,5,7,7,25,0,0,0,0,63
19,5,7,7,9,15,0,0,0,62
19,5,7,7,9,15,12,1,0,75
19,5,7,7,18,15,13,0,0,84
19,5,7,8,15,12,0,0,0,66
19,5,7,8,15,12,1,20,5,92
19,5,7,13,5,14,20,0,0,83
19,5,7,13,5,14,20,1,12,96
19,5,7,13,5,14,20,5,4,92
19,5,7,13,5,14,20,5,18,106
19,5,7,13,5,14,20,19,0,102
19,5,7,14,15,0,0,0,0,60
19,5,7,14,15,19,0,0,0,79
19,5,7,15,0,0,0,0,0,46
19,5,7,15,12,0,0,0,0,58
19,5,7,15,12,1,20,5,0,84
19,5,7,15,19,0,0,0,0,65
19,5,7,15,21,0,0,0,0,67
19,5,7,18,5,1,14,20,0,89
19,5,7,18,5,7,1,14,20,96
19,5,7,18,5,7,1,20,5,87
19,5,7,19,0,0,0,0,0,50
19,5,7,21,5,0,0,0,0,57
19,5,7,21,5,4,0,0,0,61
19,5,7,21,5,9,14,7,0,87
19,5,7,21,5,14,4,15,0,90
19,5,7,21,5,19,0,0,0,76
19,5,7,21,9,14,7,0,0,82
19,5,8,25,15,0,0,0,0,72
19,5,25,0,0,0,0,0,0,49
19,5,9,3,5,14,20,15,0,90
19,5,9,3,5,14,20,15,19,109
19,5,9,3,8,5,0,0,0,49
19,5,9,3,8,5,19,0,0,68
19,5,9,4,5,12,19,0,0,73
19,5,9,6,19,0,0,0,0,58
19,5,9,7,5,0,0,0,0,45
19,5,9,7,14,5,21,18,0,98
19,5,9,7,14,5,21,18,25,123
19,5,9,7,14,5,21,18,19,117
19,5,9,7,14,9,15,18,0,96
19,5,9,7,14,9,15,18,25,121
19,5,9,7,14,9,15,18,19,115
19,5,9,7,14,15,18,1,12,100
19,5,9,7,14,15,18,25,0,112
19,5,9,12,5,14,15,9,0,88
19,5,9,12,5,14,15,19,0,98
19,5,9,13,1,19,0,0,0,66
19,5,9,14,5,4,0,0,0,56
19,5,9,14,5,18,0,0,0,70
19,5,9,14,5,18,19,0,0,89
19,5,9,14,5,19,0,0,0,71
19,5,9,14,9,14,7,0,0,77
19,5,9,18,5,14,0,0,0,70
19,5,9,19,0,0,0,0,0,52
19,5,9,19,1,2,12,5,0,72
19,5,9,19,5,0,0,0,0,57
19,5,9,19,5,4,0,0,0,61
19,5,9,19,5,18,0,0,0,75
19,5,9,19,5,18,19,0,0,94
19,5,9,19,5,19,0,0,0,76
19,5,9,19,9,14,0,0,0,75
19,5,9,19,9,14,7,0,0,82
19,5,9,19,9,14,7,19,0,101
19,5,9,19,9,14,19,0,0,94
19,5,9,19,13,0,0,0,0,65
19,5,9,19,13,1,12,0,0,78
19,5,9,19,13,5,20,9,3,102
19,5,9,19,13,9,3,0,0,77
19,5,9,19,13,9,3,1,12,90
19,5,9,19,13,9,19,13,0,106
19,5,9,19,13,9,19,13,19,125
19,5,9,19,13,15,12,0,0,92
19,5,9,19,13,15,20,9,3,112
19,5,9,19,13,19,0,0,0,84
19,5,9,19,15,18,0,0,0,85
19,5,9,19,15,18,19,0,0,104
19,5,9,19,21,18,5,0,0,96
19,5,9,19,21,18,5,19,0,115
19,5,9,20,0,0,0,0,0,53
19,5,9,20,25,0,0,0,0,78
19,5,9,26,1,2,12,5,0,79
19,5,9,26,5,0,0,0,0,64
19,5,9,26,5,4,0,0,0,68
19,5,9,26,5,18,0,0,0,82
19,5,9,26,5,18,19,0,0,101
19,5,9,26,5,19,0,0,0,83
19,5,9,26,9,14,0,0,0,82
19,5,9,26,9,14,7,0,0,89
19,5,9,26,9,14,7,19,0,108
19,5,9,26,9,14,19,0,0,101
19,5,9,26,15,18,0,0,0,92
19,5,9,26,15,18,19,0,0,111
19,5,9,26,21,18,5,0,0,103
19,5,9,26,21,18,5,19,0,122
19,5,10,1,14,20,0,0,0,69
19,5,10,5,1,14,20,0,0,74
19,5,10,5,18,15,0,0,0,72
19,5,10,15,9,14,0,0,0,72
19,5,10,15,9,14,5,4,0,81
19,5,10,15,21,18,0,0,0,88
19,5,10,21,7,1,20,5,0,88
19,5,10,21,7,15,21,19,0,117
19,5,10,21,14,3,20,0,0,92
19,5,10,21,14,3,20,12,25,129
19,5,11,1,18,0,0,0,0,54
19,5,11,5,18,5,0,0,0,63
19,5,11,15,19,0,0,0,0,69
19,5,12,1,3,8,9,1,14,72
19,5,12,1,3,8,15,9,4,76
19,5,12,1,4,1,14,7,0,63
19,5,12,1,4,1,14,7,19,82
19,5,12,1,7,9,20,5,0,78
19,5,12,1,8,19,0,0,0,64
19,5,12,1,13,9,14,0,0,73
19,5,12,1,13,12,9,11,0,82
19,5,12,1,13,12,9,11,19,101
19,5,12,1,14,4,5,18,0,78
19,5,12,3,15,21,20,8,0,103
19,5,12,4,0,0,0,0,0,40
19,5,12,4,15,13,0,0,0,68
19,5,12,4,15,13,3,25,0,96
19,5,12,4,15,13,5,18,0,91
19,5,12,4,15,13,12,25,0,105
19,5,12,4,15,18,0,0,0,73
19,5,12,4,19,5,5,14,0,83
19,5,12,5,0,0,0,0,0,41
19,5,12,5,3,20,0,0,0,64
19,5,12,5,3,20,5,4,0,73
19,5,12,5,3,20,5,5,0,74
19,5,12,5,3,20,5,5,19,93
19,5,12,5,3,20,9,14,7,94
19,5,12,5,3,20,9,15,14,102
19,5,12,5,3,20,9,22,5,100
19,5,12,5,3,20,12,25,0,101
19,5,12,5,3,20,13,1,14,92
19,5,12,5,3,20,13,5,14,96
19,5,12,5,3,20,15,18,0,97
19,5,12,5,3,20,15,18,19,116
19,5,12,5,3,20,19,0,0,83
19,5,12,5,3,20,21,19,0,104
19,5,12,5,14,1,20,5,0,81
19,5,12,5,14,1,20,5,19,100
19,5,12,5,14,9,1,14,0,79
19,5,12,5,14,9,1,20,5,90
19,5,12,5,14,9,3,0,0,67
19,5,12,5,14,9,4,5,0,73
19,5,12,5,14,9,4,5,19,92
19,5,12,5,14,9,15,14,0,93
19,5,12,5,14,9,15,21,19,119
19,5,12,5,14,9,20,5,0,89
19,5,12,5,14,9,20,5,19,108
19,5,12,5,14,9,20,9,3,96
19,5,12,5,14,9,21,13,0,98
19,5,12,5,14,9,21,13,19,117
19,5,12,5,14,15,12,15,7,104
19,5,12,5,14,15,19,9,19,117
19,5,12,5,14,15,21,19,0,110
19,5,12,5,20,1,18,0,0,80
19,5,12,5,20,25,0,0,0,86
19,5,12,6,0,0,0,0,0,42
19,5,12,6,3,9,4,5,0,63
19,5,12,6,4,15,13,0,0,74
19,5,12,6,4,15,13,19,0,93
19,5,12,6,5,4,0,0,0,51
19,5,12,6,6,21,12,0,0,81
19,5,12,6,8,5,1,12,0,68
19,5,12,6,8,5,1,12,19,87
19,5,12,6,8,15,15,4,0,84
19,5,12,6,8,15,15,4,19,103
19,5,12,6,9,14,7,0,0,72
19,5,12,6,9,19,8,0,0,78
19,5,12,6,9,19,8,12,25,115
19,5,12,6,9,19,13,0,0,83
19,5,12,6,9,19,20,0,0,90
19,5,12,6,12,5,19,19,0,97
19,5,12,6,12,25,0,0,0,79
19,5,12,6,12,9,11,5,0,79
19,5,12,6,14,5,19,19,0,99
19,5,12,6,19,0,0,0,0,61
19,5,12,6,19,1,9,4,0,75
19,5,12,6,19,1,13,5,0,80
19,5,12,6,23,1,18,4,0,88
19,5,12,6,23,1,18,4,19,107
19,5,12,9,3,20,1,18,0,87
19,5,12,9,14,7,0,0,0,66
19,5,12,9,15,14,0,0,0,74
19,5,12,12,1,2,12,5,0,68
19,5,12,12,1,2,12,25,0,88
19,5,12,12,1,9,20,5,0,83
19,5,12,12,1,18,0,0,0,67
19,5,12,12,1,18,25,0,0,92
19,5,12,12,1,20,5,0,0,74
19,5,12,12,5,18,0,0,0,71
19,5,12,12,5,19,0,0,0,72
19,5,12,12,25,0,0,0,0,73
19,5,12,12,9,5,0,0,0,62
19,5,12,12,9,6,15,18,13,109
19,5,12,12,9,14,7,0,0,78
19,5,12,12,15,21,20,0,0,104
19,5,12,12,15,21,20,19,0,123
19,5,12,19,0,0,0,0,0,55
19,5,12,19,25,14,0,0,0,94
19,5,12,19,25,14,19,0,0,113
19,5,12,19,15,22,9,5,20,126
19,5,12,20,0,0,0,0,0,56
19,5,12,20,26,5,18,19,0,124
19,5,12,22,1,0,0,0,0,59
19,5,12,22,1,7,5,0,0,71
19,5,12,22,1,7,5,4,0,75
19,5,12,22,1,7,5,5,0,76
19,5,12,22,1,7,5,19,0,90
19,5,12,22,1,19,0,0,0,78
19,5,12,22,5,4,7,5,0,79
19,5,12,22,5,4,7,5,4,83
19,5,12,22,5,4,7,5,19,98
19,5,12,22,5,19,0,0,0,82
19,5,12,26,15,7,5,14,5,108
19,5,13,1,9,14,9,5,18,93
19,5,13,1,9,19,5,0,0,71
19,5,13,1,14,20,5,13,5,95
19,5,13,1,14,20,9,3,0,84
19,5,13,1,14,20,9,3,19,103
19,5,13,1,14,20,18,15,14,119
19,5,13,1,16,8,15,18,5,100
19,5,13,1,18,21,13,0,0,90
19,5,13,1,20,5,13,5,0,81
19,5,13,1,20,9,3,0,0,70
19,5,13,1,20,18,15,16,5,112
19,5,13,2,1,12,12,0,0,64
19,5,13,2,12,1,2,12,5,71
19,5,13,2,12,1,2,12,25,91
19,5,13,2,12,1,14,3,5,74
19,5,13,2,12,1,14,20,0,86
19,5,13,2,12,5,0,0,0,56
19,5,13,2,12,5,14,3,5,78
19,5,13,2,12,9,14,7,0,81
19,5,13,5,0,0,0,0,0,42
19,5,13,5,5,0,0,0,0,47
19,5,13,5,5,4,0,0,0,51
19,5,13,5,9,1,0,0,0,52
19,5,13,5,9,15,14,0,0,80
19,5,13,5,9,15,20,9,3,98
19,5,13,5,12,0,0,0,0,54
19,5,13,5,13,5,0,0,0,60
19,5,13,5,13,5,19,0,0,79
19,5,13,5,13,9,3,0,0,67
19,5,13,5,14,0,0,0,0,56
19,5,13,5,14,3,5,0,0,64
19,5,13,5,14,19,0,0,0,75
19,5,13,5,14,20,0,0,0,76
19,5,13,5,14,20,5,18,1,100
19,5,13,5,19,0,0,0,0,61
19,5,13,5,19,5,0,0,0,66
19,5,13,5,19,20,5,18,0,104
19,5,13,5,19,20,5,18,19,123
19,5,13,5,19,20,18,1,12,112
19,5,13,9,0,0,0,0,0,46
19,5,13,9,1,3,9,4,0,63
19,5,13,9,1,12,9,5,14,87
19,5,13,9,1,14,0,0,0,61
19,5,13,9,1,14,7,12,5,85
19,5,13,9,1,14,14,1,0,76
19,5,13,9,1,16,5,0,0,68
19,5,13,9,1,18,3,0,0,68
19,5,13,9,1,18,3,8,0,76
19,5,13,9,1,18,9,4,0,78
19,5,13,9,1,24,9,19,0,99
19,5,13,9,2,1,25,0,0,74
19,5,13,9,2,1,12,4,0,65
19,5,13,9,2,1,12,12,0,73
19,5,13,9,2,1,14,4,0,67
19,5,13,9,2,1,19,5,0,73
19,5,13,9,2,5,1,13,0,67
19,5,13,9,2,5,10,1,14,78
19,5,13,9,2,9,6,9,4,76
19,5,13,9,2,12,9,14,4,87
19,5,13,9,2,12,21,14,20,115
19,5,13,9,2,15,4,25,0,92
19,5,13,9,2,15,12,4,0,79
19,5,13,9,2,18,5,22,5,98
19,5,13,9,2,21,12,12,0,93
19,5,13,9,3,0,0,0,0,49
19,5,13,9,3,1,14,1,12,77
19,5,13,9,3,5,12,12,0,78
19,5,13,9,3,8,1,0,0,58
19,5,13,9,3,12,15,19,5,100
19,5,13,9,3,15,11,5,0,80
19,5,13,9,3,15,12,15,14,105
19,5,13,9,3,15,13,1,0,78
19,5,13,9,3,15,13,1,19,97
19,5,13,9,3,15,13,9,3,89
19,5,13,9,3,15,14,5,0,83
19,5,13,9,3,15,14,9,3,90
19,5,13,9,3,15,16,5,0,85
19,5,13,9,3,18,5,16,5,93
19,5,13,9,3,18,15,13,1,96
19,5,13,9,3,18,15,13,5,100
19,5,13,9,3,21,2,9,20,101
19,5,13,9,3,21,16,0,0,86
19,5,13,9,3,21,16,5,0,91
19,5,13,9,3,21,18,5,4,97
19,5,13,9,3,21,18,12,0,100
19,5,13,9,4,1,9,12,25,97
19,5,13,9,4,1,18,11,0,80
19,5,13,9,4,5,1,4,0,60
19,5,13,9,4,5,1,6,0,62
19,5,13,9,4,5,3,1,25,84
19,5,13,9,4,5,9,6,25,95
19,5,13,9,4,5,9,20,25,109
19,5,13,9,4,9,14,5,0,78
19,5,13,9,4,9,19,11,0,89
19,5,13,9,4,15,12,5,0,82
19,5,13,9,4,15,13,5,0,83
19,5,13,9,4,15,13,5,4,87
19,5,13,9,4,15,13,5,19,102
19,5,13,9,4,18,5,19,19,111
19,5,13,9,4,18,25,0,0,93
19,5,13,9,4,18,9,5,4,86
19,5,13,9,4,21,12,12,0,95
19,5,13,9,5,1,18,12,25,107
19,5,13,9,5,7,7,0,0,65
19,5,13,9,5,7,18,5,20,101
19,5,13,9,5,16,9,3,0,79
19,5,13,9,5,18,5,3,20,97
19,5,13,9,5,19,19,1,25,115
19,5,13,9,6,1,2,12,5,72
19,5,13,9,6,1,19,20,0,92
19,5,13,9,6,5,18,1,12,88
19,5,13,9,6,25,0,0,0,77
19,5,13,9,6,9,2,0,0,63
19,5,13,9,6,9,14,1,12,88
19,5,13,9,6,9,14,5,0,80
19,5,13,9,6,9,20,0,0,81
19,5,13,9,6,9,24,5,4,94
19,5,13,9,6,12,5,24,0,93
19,5,13,9,6,12,9,14,20,107
19,5,13,9,6,12,21,9,4,98
19,5,13,9,6,15,18,13,0,98
19,5,13,9,6,21,19,5,4,101
19,5,13,9,7,1,12,1,0,67
19,5,13,9,7,12,1,26,5,97
19,5,13,9,7,12,15,2,5,87
19,5,13,9,7,12,15,19,19,118
19,5,13,9,7,15,4,0,0,72
19,5,13,9,7,18,15,21,16,123
19,5,13,9,8,0,0,0,0,54
19,5,13,9,8,1,14,4,0,73
19,5,13,9,8,1,18,4,0,77
19,5,13,9,8,1,18,4,25,102
19,5,13,9,8,9,1,14,20,98
19,5,13,9,8,9,7,8,0,78
19,5,13,9,8,15,2,15,0,86
19,5,13,9,8,15,2,15,19,105
19,5,13,9,8,15,14,15,18,116
19,5,13,9,8,15,18,1,12,100
19,5,13,9,8,15,18,14,25,126
19,5,13,9,8,15,20,0,0,89
19,5,13,9,8,21,13,1,14,103
19,5,13,9,11,1,8,0,0,66
19,5,13,9,12,1,20,5,0,84
19,5,13,9,12,1,20,21,19,119
19,5,13,9,12,5,7,1,12,83
19,5,13,9,12,5,14,19,0,96
19,5,13,9,12,9,14,5,4,90
19,5,13,9,12,25,18,9,3,113
19,5,13,9,12,15,7,0,0,80
19,5,13,9,12,15,14,7,0,94
19,5,13,9,12,15,15,19,5,112
19,5,13,9,12,15,18,0,0,91
19,5,13,9,12,21,14,1,18,112
19,5,13,9,12,21,14,5,0,98
19,5,13,9,13,1,4,5,0,69
19,5,13,9,13,1,10,15,18,103
19,5,13,9,13,1,20,0,0,80
19,5,13,9,13,1,20,20,0,100
19,5,13,9,13,1,20,20,5,105
19,5,13,9,13,5,20,1,12,97
19,5,13,9,13,9,3,18,15,104
19,5,13,9,13,9,12,4,0,84
19,5,13,9,13,9,12,12,0,92
19,5,13,9,13,9,14,9,13,104
19,5,13,9,13,9,14,15,18,115
19,5,13,9,13,15,9,19,20,122
19,5,13,9,13,15,18,15,14,121
19,5,13,9,13,21,20,5,0,105
19,5,13,9,14,1,0,0,0,61
19,5,13,9,14,1,11,5,4,81
19,5,13,9,14,1,12,0,0,73
19,5,13,9,14,1,12,12,25,110
19,5,13,9,14,1,18,0,0,79
19,5,13,9,14,1,18,25,0,104
19,5,13,9,14,1,18,19,0,98
19,5,13,9,14,1,19,1,12,93
19,5,13,9,14,1,19,5,0,85
19,5,13,9,14,1,20,5,0,86
19,5,13,9,14,1,20,5,4,90
19,5,13,9,14,5,7,18,15,105
19,5,13,9,14,5,19,19,0,103
19,5,13,9,14,9,6,9,3,87
19,5,13,9,14,9,19,20,0,108
19,5,13,9,14,9,21,13,0,103
19,5,13,9,14,15,13,1,0,89
19,5,13,9,14,15,13,1,4,93
19,5,13,9,14,15,13,1,19,108
19,5,13,9,14,15,19,5,0,99
19,5,13,9,14,15,22,5,12,114
19,5,13,9,14,21,4,5,0,90
19,5,13,9,14,21,12,5,0,98
19,5,13,9,14,21,18,9,1,109
19,5,13,9,15,12,15,7,25,120
19,5,13,9,15,16,1,12,0,90
19,5,13,9,15,16,5,14,0,96
19,5,13,9,15,18,2,0,0,81
19,5,13,9,15,19,5,19,0,104
19,5,13,9,15,19,9,19,0,108
19,5,13,9,15,20,9,3,0,93
19,5,13,9,15,20,9,3,19,112
19,5,13,9,15,22,1,12,0,96
19,5,13,9,15,22,1,20,5,109
19,5,13,9,15,22,15,9,4,111
19,5,13,9,16,1,7,1,14,85
19,5,13,9,16,1,14,9,3,89
19,5,13,9,16,1,16,1,12,92
19,5,13,9,16,1,19,20,5,107
19,5,13,9,16,1,19,20,25,127
19,5,13,9,16,1,21,19,5,108
19,5,13,9,16,5,1,3,5,76
19,5,13,9,16,5,4,0,0,71
19,5,13,9,16,5,4,1,12,84
19,5,13,9,16,8,1,19,5,95
19,5,13,9,16,9,15,21,19,126
19,5,13,9,16,12,21,13,5,113
19,5,13,9,16,15,12,1,18,108
19,5,13,9,16,15,15,18,0,110
19,5,13,9,16,18,15,0,0,95
19,5,13,9,16,18,15,14,5,114
19,5,13,9,16,18,15,15,6,116
19,5,13,9,16,18,15,19,0,114
19,5,13,9,16,21,16,1,0,100
19,5,13,9,17,21,15,20,5,124
19,5,13,9,18,1,18,5,0,88
19,5,13,9,18,1,23,0,0,88
19,5,13,9,18,1,23,12,25,125
19,5,13,9,18,5,2,5,12,88
19,5,13,9,18,9,7,9,4,93
19,5,13,9,18,9,14,7,0,94
19,5,13,9,18,15,25,1,12,117
19,5,13,9,18,15,12,12,0,103
19,5,13,9,18,15,21,14,4,118
19,5,13,9,18,21,9,14,0,108
19,5,13,9,18,21,18,1,12,116
19,5,13,9,19,0,0,0,0,65
19,5,13,9,19,1,9,14,20,109
19,5,13,9,19,5,18,6,0,94
19,5,13,9,19,5,19,0,0,89
19,5,13,9,19,8,1,4,5,83
19,5,13,9,19,8,1,4,25,103
19,5,13,9,19,8,1,6,20,100
19,5,13,9,19,8,5,5,18,101
19,5,13,9,19,8,18,21,2,114
19,5,13,9,19,9,24,20,8,126
19,5,13,9,19,12,1,22,5,105
19,5,13,9,19,13,9,12,5,104
19,5,13,9,19,15,6,20,0,106
19,5,13,9,19,15,12,9,4,105
19,5,13,9,19,15,16,15,18,129
19,5,13,9,19,15,21,14,0,115
19,5,13,9,19,16,1,14,0,96
19,5,13,9,19,16,15,18,20,134
19,5,13,9,19,20,1,20,5,111
19,5,13,9,19,20,5,5,12,107
19,5,13,9,19,20,9,6,6,106
19,5,13,9,19,20,9,12,12,118
19,5,13,9,19,20,15,3,11,114
19,5,13,9,19,20,15,18,25,143
19,5,13,9,19,23,5,5,20,118
19,5,13,9,20,1,0,0,0,67
19,5,13,9,20,1,3,20,0,90
19,5,13,9,20,1,5,0,0,72
19,5,13,9,20,1,12,0,0,79
19,5,13,9,20,1,21,18,0,106
19,5,13,9,20,5,12,9,3,95
19,5,13,9,20,5,19,0,0,90
19,5,13,9,20,9,13,5,0,93
19,5,13,9,20,9,19,20,19,133
19,5,13,9,20,15,14,1,12,108
19,5,13,9,20,15,14,5,0,100
19,5,13,9,20,15,14,5,19,119
19,5,13,9,20,15,14,9,3,107
19,5,13,9,20,15,21,18,0,120
19,5,13,9,20,18,21,20,8,133
19,5,13,9,21,18,2,1,14,102
19,5,13,9,21,18,14,0,0,99
19,5,13,9,22,1,21,12,20,122
19,5,13,9,22,9,20,1,12,110
19,5,13,9,22,15,3,1,12,99
19,5,13,9,22,15,23,5,12,123
19,5,13,9,23,9,12,4,0,94
19,5,13,9,23,15,15,4,25,128
19,5,13,9,23,15,18,11,19,132
19,5,13,13,5,12,0,0,0,67
19,5,13,13,5,20,0,0,0,75
19,5,13,13,9,20,0,0,0,79
19,5,13,15,9,19,0,0,0,80
19,5,13,15,12,1,0,0,0,65
19,5,13,15,12,5,12,12,1,94
19,5,13,15,12,9,14,1,0,88
19,5,13,15,12,9,14,1,19,107
19,5,13,15,12,15,7,25,0,111
19,5,13,15,20,5,4,0,0,81
19,5,13,15,21,12,5,0,0,90
19,5,13,16,5,18,0,0,0,76
19,5,13,16,9,20,5,18,14,119
19,5,13,16,12,5,0,0,0,70
19,5,13,16,12,5,19,0,0,89
19,5,13,16,12,9,3,5,0,82
19,5,13,16,12,9,3,5,19,101
19,5,13,16,18,5,0,0,0,76
19,5,13,16,18,5,19,0,0,95
19,5,13,16,19,20,5,18,0,115
19,5,13,16,19,20,18,25,0,135
19,5,13,19,5,13,0,0,0,74
19,5,13,19,5,14,0,0,0,75
19,5,13,21,14,3,9,1,0,85
19,5,13,21,14,3,9,1,12,97
19,5,14,1,3,8,9,5,0,64
19,5,14,1,7,5,0,0,0,51
19,5,14,1,9,20,5,0,0,73
19,5,14,1,12,0,0,0,0,51
19,5,14,1,13,0,0,0,0,52
19,5,14,1,18,25,0,0,0,82
19,5,14,1,18,9,1,14,0,81
19,5,14,1,18,9,9,0,0,75
19,5,14,1,18,9,21,19,0,106
19,5,14,1,20,5,19,0,0,83
19,5,14,1,20,15,18,0,0,92
19,5,14,1,20,15,18,25,0,117
19,5,14,1,20,15,18,19,0,111
19,5,14,1,20,18,5,19,19,120
19,5,14,1,20,18,9,24,0,110
19,5,14,1,20,21,19,0,0,99
19,5,14,3,5,0,0,0,0,46
19,5,14,3,9,15,0,0,0,65
19,5,14,3,9,15,14,0,0,79
19,5,14,4,0,0,0,0,0,42
19,5,14,4,1,2,12,5,0,62
19,5,14,4,1,12,0,0,0,55
19,5,14,4,1,12,19,0,0,74
19,5,14,4,5,4,0,0,0,51
19,5,14,4,5,5,0,0,0,52
19,5,14,4,5,18,19,0,0,84
19,5,14,4,9,14,7,0,0,72
19,5,14,4,12,5,0,0,0,59
19,5,14,4,15,6,6,0,0,69
19,5,14,4,15,6,6,19,0,88
19,5,14,4,19,0,0,0,0,61
19,5,14,4,21,16,0,0,0,79
19,5,14,4,21,16,19,0,0,98
19,5,14,5,0,0,0,0,0,43
19,5,14,5,3,1,19,0,0,66
19,5,14,5,3,9,15,9,4,83
19,5,14,5,3,9,15,19,0,89
19,5,14,5,3,20,21,4,5,96
19,5,14,5,7,1,0,0,0,51
19,5,14,5,7,1,19,0,0,70
19,5,14,5,7,9,14,0,0,73
19,5,14,5,19,3,5,0,0,70
19,5,14,5,19,3,5,14,20,104
19,5,14,5,19,3,8,1,12,86
19,5,14,5,24,0,0,0,0,67
19,5,14,7,9,0,0,0,0,54
19,5,14,7,18,5,5,14,0,87
19,5,14,8,15,18,0,0,0,79
19,5,14,8,15,18,1,0,0,80
19,5,14,8,15,18,1,19,0,99
19,5,14,8,15,18,5,19,0,103
19,5,14,8,15,18,9,20,1,109
19,5,14,8,15,18,19,0,0,98
19,5,14,9,3,9,4,5,0,68
19,5,14,9,12,5,0,0,0,64
19,5,14,9,12,5,12,25,0,101
19,5,14,9,12,5,19,0,0,83
19,5,14,9,12,9,19,0,0,87
19,5,14,9,12,9,19,13,0,100
19,5,14,9,12,9,20,25,0,113
19,5,14,9,12,9,26,5,0,99
19,5,14,9,15,18,25,0,0,105
19,5,14,9,15,18,9,20,25,134
19,5,14,9,15,18,19,0,0,99
19,5,14,9,20,0,0,0,0,67
19,5,14,9,20,9,0,0,0,76
19,5,14,9,21,13,0,0,0,81
19,5,14,14,1,3,8,9,5,78
19,5,14,14,1,19,0,0,0,72
19,5,14,14,5,20,0,0,0,77
19,5,14,14,5,20,19,0,0,96
19,5,14,14,9,7,8,20,0,96
19,5,14,14,9,7,8,20,19,115
19,5,14,14,9,20,0,0,0,81
19,5,14,14,9,20,5,0,0,86
19,5,14,14,9,20,19,0,0,100
19,5,14,15,3,21,12,1,18,108
19,5,14,15,16,9,1,0,0,79
19,5,14,15,16,9,1,19,0,98
19,5,14,15,18,0,0,0,0,71
19,5,14,15,18,1,19,0,0,91
19,5,14,15,18,5,19,0,0,95
19,5,14,15,18,9,20,1,0,101
19,5,14,15,18,9,20,1,19,120
19,5,14,15,18,19,0,0,0,90
19,5,14,15,21,6,15,0,0,95
19,5,14,18,25,21,0,0,0,102
19,5,14,19,1,0,0,0,0,58
19,5,14,19,1,2,12,5,0,77
19,5,14,19,1,12,0,0,0,70
19,5,14,19,1,20,5,0,0,83
19,5,14,19,1,20,5,4,0,87
19,5,14,19,1,20,5,12,25,120
19,5,14,19,1,20,5,19,0,102
19,5,14,19,1,20,9,14,7,108
19,5,14,19,1,20,9,15,14,116
19,5,14,19,1,20,15,18,25,136
19,5,14,19,5,0,0,0,0,62
19,5,14,19,5,4,0,0,0,66
19,5,14,19,5,6,21,12,0,101
19,5,14,19,5,12,5,19,19,117
19,5,14,19,5,19,0,0,0,81
19,5,14,19,9,2,12,5,0,85
19,5,14,19,9,2,12,5,18,103
19,5,14,19,9,2,12,5,19,104
19,5,14,19,9,2,12,25,0,105
19,5,14,19,9,3,1,12,0,82
19,5,14,19,9,6,25,0,0,97
19,5,14,19,9,6,9,3,0,84
19,5,14,19,9,6,9,3,19,103
19,5,14,19,9,12,5,0,0,83
19,5,14,19,9,12,9,1,0,88
19,5,14,19,9,12,12,1,0,91
19,5,14,19,9,12,12,1,5,96
19,5,14,19,9,12,12,21,13,124
19,5,14,19,25,14,5,0,0,101
19,5,14,19,9,14,7,0,0,87
19,5,14,19,9,19,13,0,0,98
19,5,14,19,9,19,20,0,0,105
19,5,14,19,9,19,20,9,3,117
19,5,14,19,9,20,9,22,5,122
19,5,14,19,9,20,9,26,5,126
19,5,14,19,9,20,15,18,25,144
19,5,14,19,9,22,5,0,0,93
19,5,14,19,9,26,5,0,0,97
19,5,14,19,15,0,0,0,0,72
19,5,14,19,15,18,0,0,0,90
19,5,14,19,15,18,25,0,0,115
19,5,14,19,15,18,9,1,0,100
19,5,14,19,15,18,9,1,12,112
19,5,14,19,15,18,9,5,19,123
19,5,14,19,15,18,9,21,13,133
19,5,14,19,15,18,19,0,0,109
19,5,14,19,21,0,0,0,0,78
19,5,14,19,21,1,12,0,0,91
19,5,14,19,21,1,12,12,25,128
19,5,14,19,21,9,19,13,0,119
19,5,14,19,21,9,19,20,0,126
19,5,14,19,21,13,0,0,0,91
19,5,14,19,21,15,21,19,0,133
19,5,14,19,21,19,0,0,0,97
19,5,14,20,0,0,0,0,0,58
19,5,14,20,5,14,3,5,0,85
19,5,14,20,5,14,3,5,4,89
19,5,14,20,5,14,3,5,18,103
19,5,14,20,5,14,3,5,19,104
19,5,14,20,5,14,20,9,1,107
19,5,14,20,9,0,0,0,0,67
19,5,14,20,9,5,14,3,5,94
19,5,14,20,9,5,14,3,25,114
19,5,14,20,9,5,14,20,0,106
19,5,14,20,9,5,14,20,19,125
19,5,14,20,9,13,5,14,20,119
19,5,14,20,9,13,15,0,0,95
19,5,14,20,9,13,15,19,0,114
19,5,14,20,9,14,5,0,0,86
19,5,14,20,9,14,5,12,19,117
19,5,14,20,9,20,9,15,14,125
19,5,14,20,18,25,0,0,0,101
19,5,14,20,18,9,5,4,0,94
19,5,14,20,18,9,5,19,0,109
19,5,14,20,18,25,9,14,7,131
19,5,14,20,19,0,0,0,0,77
19,5,14,21,6,15,0,0,0,80
19,5,14,22,25,0,0,0,0,85
19,5,14,26,1,0,0,0,0,65
19,5,15,18,0,0,0,0,0,57
19,5,15,18,1,0,0,0,0,58
19,5,15,18,9,20,1,0,0,87
19,5,16,1,4,0,0,0,0,45
19,5,16,1,12,0,0,0,0,53
19,5,16,1,12,5,4,0,0,62
19,5,16,1,12,9,14,5,0,81
19,5,16,1,12,12,5,4,0,74
19,5,16,1,12,15,4,25,0,97
19,5,16,1,12,15,9,4,0,81
19,5,16,1,12,15,21,19,0,108
19,5,16,1,12,19,0,0,0,72
19,5,16,1,18,1,2,12,5,79
19,5,16,1,18,1,2,12,25,99
19,5,16,1,18,1,20,1,0,81
19,5,16,1,18,1,20,5,0,85
19,5,16,1,18,1,20,5,4,89
19,5,16,1,18,1,20,5,19,104
19,5,16,1,18,1,20,15,18,113
19,5,16,1,18,1,20,21,13,114
19,5,16,1,18,20,5,0,0,84
19,5,16,1,23,14,0,0,0,78
19,5,16,4,0,0,0,0,0,44
19,5,16,7,0,0,0,0,0,47
19,5,16,8,5,14,0,0,0,67
19,5,16,8,9,18,1,8,0,84
19,5,16,8,9,18,9,3,0,87
19,5,16,8,9,18,15,20,8,118
19,5,16,9,1,0,0,0,0,50
19,5,16,9,1,3,5,1,14,73
19,5,16,9,1,5,0,0,0,55
19,5,16,9,1,12,9,11,5,87
19,5,16,9,1,14,0,0,0,64
19,5,16,9,1,18,25,0,0,93
19,5,16,9,1,18,9,1,14,92
19,5,16,9,1,19,0,0,0,69
19,5,16,9,3,0,0,0,0,52
19,5,16,9,13,5,14,20,0,101
19,5,16,9,15,9,4,0,0,77
19,5,16,9,15,12,9,20,5,110
19,5,16,9,15,14,0,0,0,78
19,5,16,9,15,19,20,0,0,103
19,5,16,9,21,13,0,0,0,83
19,5,16,14,0,0,0,0,0,54
19,5,16,15,25,19,0,0,0,99
19,5,16,15,14,5,0,0,0,74
19,5,16,15,19,5,0,0,0,79
19,5,16,16,1,0,0,0,0,57
19,5,16,16,21,11,21,0,0,109
19,5,16,16,21,11,21,19,0,128
19,5,16,19,0,0,0,0,0,59
19,5,16,19,5,19,0,0,0,83
19,5,16,19,9,4,0,0,0,72
19,5,16,19,9,14,0,0,0,82
19,5,16,19,9,14,5,0,0,87
19,5,16,19,9,19,0,0,0,87
19,5,16,20,1,0,0,0,0,61
19,5,16,20,1,5,13,9,1,89
19,5,16,20,1,12,0,0,0,73
19,5,16,20,1,14,0,0,0,75
19,5,16,20,1,14,5,0,0,80
19,5,16,20,1,14,7,12,5,99
19,5,16,20,1,18,9,1,0,89
19,5,16,20,1,18,9,1,14,103
19,5,16,20,1,18,9,21,13,122
19,5,16,20,1,20,5,0,0,86
19,5,16,20,1,20,5,4,0,90
19,5,16,20,1,20,9,15,14,119
19,5,16,20,1,22,5,0,0,88
19,5,16,20,5,13,6,9,4,97
19,5,16,20,5,13,9,1,0,88
19,5,16,20,5,13,22,9,18,127
19,5,16,20,5,14,1,18,0,98
19,5,16,20,5,14,1,18,25,123
19,5,16,20,5,14,1,20,5,105
19,5,16,20,5,14,15,21,19,134
19,5,16,20,5,18,9,21,13,126
19,5,16,20,5,20,0,0,0,85
19,5,16,20,5,20,19,0,0,104
19,5,16,20,5,20,20,5,0,110
19,5,16,20,5,20,20,5,19,129
19,5,16,20,6,15,9,12,0,102
19,5,16,20,9,3,0,0,0,72
19,5,16,20,9,3,1,12,0,85
19,5,16,20,9,3,9,4,5,90
19,5,16,20,9,3,9,20,25,126
19,5,16,20,9,3,19,0,0,91
19,5,16,20,9,5,18,0,0,92
19,5,16,20,9,6,15,18,13,121
19,5,16,20,9,12,5,0,0,86
19,5,16,20,9,13,1,12,0,95
19,5,16,20,9,13,1,14,1,98
19,5,16,20,9,13,5,0,0,87
19,5,16,20,9,13,5,19,0,106
19,5,16,20,9,13,15,12,5,114
19,5,16,20,12,5,22,1,0,100
19,5,16,20,15,7,5,18,13,118
19,5,16,20,15,9,3,0,0,87
19,5,16,20,15,12,5,0,0,92
19,5,16,20,15,12,5,20,0,112
19,5,16,20,15,20,15,13,25,148
19,5,16,20,19,0,0,0,0,79
19,5,16,20,19,8,9,16,0,112
19,5,16,20,21,12,1,0,0,94
19,5,16,20,21,12,1,20,5,119
19,5,16,20,21,12,21,13,0,127
19,5,16,20,21,13,0,0,0,94
19,5,16,20,21,13,19,0,0,113
19,5,16,20,21,15,18,0,0,114
19,5,16,20,21,16,12,5,0,114
19,5,16,20,21,16,12,5,4,118
19,5,16,20,21,16,12,5,19,133
19,5,16,20,21,16,12,5,20,134
19,5,16,21,3,8,18,1,12,103
19,5,16,21,12,3,8,5,18,107
19,5,16,21,12,3,8,18,5,107
19,5,16,21,12,20,0,0,0,93
19,5,16,21,12,20,21,18,5,137
19,5,17,0,0,0,0,0,0,41
19,5,17,5,4,0,0,0,0,50
19,5,17,5,14,3,5,0,0,68
19,5,17,6,3,8,11,0,0,69
19,5,17,17,0,0,0,0,0,58
19,5,17,18,3,8,0,0,0,70
19,5,17,21,1,0,0,0,0,63
19,5,17,21,1,3,5,19,0,90
19,5,17,21,1,3,9,20,25,120
19,5,17,21,5,12,0,0,0,79
19,5,17,21,5,12,1,0,0,80
19,5,17,21,5,12,1,5,0,85
19,5,17,21,5,12,1,14,20,114
19,5,17,21,5,12,19,0,0,98
19,5,17,21,5,14,3,5,0,89
19,5,17,21,5,14,3,5,4,93
19,5,17,21,5,14,3,5,18,107
19,5,17,21,5,14,3,5,19,108
19,5,17,21,5,14,3,25,0,109
19,5,17,21,5,14,20,0,0,101
19,5,17,21,5,14,20,12,25,138
19,5,17,21,5,14,20,19,0,120
19,5,17,21,5,19,20,0,0,106
19,5,17,21,5,19,20,5,18,129
19,5,17,21,5,19,20,18,1,125
19,5,17,21,9,14,0,0,0,85
19,5,17,21,9,14,5,4,0,94
19,5,17,21,9,14,14,5,4,108
19,5,17,21,9,14,19,0,0,104
19,5,17,21,9,20,21,18,0,130
19,5,17,21,9,20,21,18,19,149
19,5,17,21,15,9,1,19,0,106
19,5,17,23,12,0,0,0,0,76
19,5,18,1,2,0,0,0,0,45
19,5,18,1,3,0,0,0,0,46
19,5,18,1,3,19,0,0,0,65
19,5,18,1,7,12,9,0,0,71
19,5,18,1,7,12,9,15,0,86
19,5,18,1,7,12,9,15,19,105
19,5,18,1,8,21,12,9,0,93
19,5,18,1,9,0,0,0,0,52
19,5,18,1,25,1,0,0,0,69
19,5,18,1,9,12,0,0,0,64
19,5,18,1,9,12,19,0,0,83
19,5,18,1,9,14,7,0,0,73
19,5,18,1,9,19,0,0,0,71
19,5,18,1,12,0,0,0,0,55
19,5,18,1,16,5,0,0,0,64
19,5,18,1,16,5,19,0,0,83
19,5,18,1,16,8,0,0,0,67
19,5,18,1,16,8,9,3,0,79
19,5,18,1,16,8,9,13,19,108
19,5,18,1,16,8,9,14,0,90
19,5,18,1,16,8,9,19,13,108
19,5,18,1,16,8,19,0,0,86
19,5,18,1,19,11,5,18,0,96
19,5,18,1,19,11,9,5,18,105
19,5,18,1,21,0,0,0,0,64
19,5,18,1,23,0,0,0,0,66
19,5,18,2,9,1,14,19,0,87
19,5,18,3,9,1,12,0,0,67
19,5,18,3,15,13,0,0,0,73
19,5,18,4,1,2,0,0,0,49
19,5,18,4,1,2,19,0,0,68
19,5,18,4,1,18,0,0,0,65
19,5,18,5,4,0,0,0,0,51
19,5,18,5,8,0,0,0,0,55
19,5,18,5,9,14,0,0,0,70
19,5,18,5,9,14,19,0,0,89
19,5,18,5,13,5,14,20,0,99
19,5,18,5,14,1,4,5,0,71
19,5,18,5,14,1,4,5,4,75
19,5,18,5,14,1,4,5,18,89
19,5,18,5,14,1,4,5,19,90
19,5,18,5,14,1,20,1,0,83
19,5,18,5,14,1,20,1,19,102
19,5,18,5,14,1,20,5,0,87
19,5,18,5,14,4,9,20,5,99
19,5,18,5,14,5,4,0,0,70
19,5,18,5,14,5,12,25,0,103
19,5,18,5,14,5,18,0,0,84
19,5,18,5,14,5,19,0,0,85
19,5,18,5,14,5,19,20,0,105
19,5,18,5,14,9,6,25,0,101
19,5,18,5,14,9,26,5,0,101
19,5,18,5,14,15,0,0,0,76
19,5,18,5,19,20,0,0,0,86
19,5,18,5,23,1,18,4,0,93
19,5,18,6,0,0,0,0,0,48
19,5,18,6,1,7,5,0,0,61
19,5,18,6,1,7,5,19,0,80
19,5,18,6,4,15,13,0,0,80
19,5,18,6,4,15,13,19,0,99
19,5,18,6,8,15,15,4,0,90
19,5,18,6,8,15,15,4,19,109
19,5,18,6,9,19,8,0,0,84
19,5,18,6,9,19,8,12,25,121
19,5,18,6,9,19,13,0,0,89
19,5,18,6,12,9,11,5,0,85
19,5,18,6,19,0,0,0,0,67
19,5,18,6,19,8,9,16,0,100
19,5,18,7,5,1,14,3,25,97
19,5,18,7,5,1,14,20,25,114
19,5,18,7,5,1,14,20,19,108
19,5,18,7,5,12,9,13,0,88
19,5,18,7,5,18,0,0,0,72
19,5,18,7,5,19,0,0,0,73
19,5,18,7,5,20,20,5,0,99
19,5,18,7,9,14,7,0,0,79
19,5,18,7,9,14,7,19,0,98
19,5,18,7,9,21,0,0,0,79
19,5,18,9,1,12,0,0,0,64
19,5,18,9,1,12,9,19,5,97
19,5,18,9,1,12,9,19,13,105
19,5,18,9,1,12,9,19,20,112
19,5,18,9,1,12,9,20,25,118
19,5,18,9,1,12,9,26,5,104
19,5,18,9,1,12,12,25,0,101
19,5,18,9,1,12,19,0,0,83
19,5,18,9,1,18,25,0,0,95
19,5,18,9,1,20,5,0,0,77
19,5,18,9,1,20,5,4,0,81
19,5,18,9,1,20,5,12,25,114
19,5,18,9,1,20,5,19,0,96
19,5,18,9,1,20,9,13,0,94
19,5,18,9,1,20,9,14,7,102
19,5,18,9,1,20,9,15,14,110
19,5,18,9,1,21,14,20,0,107
19,5,18,9,3,1,20,5,0,80
19,5,18,9,3,1,20,5,4,84
19,5,18,9,3,5,1,0,0,60
19,5,18,9,3,5,15,21,19,114
19,5,18,9,3,9,14,0,0,77
19,5,18,9,3,9,14,19,0,96
19,5,18,9,3,9,20,5,0,88
19,5,18,9,3,9,20,9,3,95
19,5,18,9,3,15,14,0,0,83
19,5,18,9,3,20,5,18,25,122
19,5,18,9,5,13,1,0,0,70
19,5,18,9,5,13,1,19,0,89
19,5,18,9,5,19,0,0,0,75
19,5,18,9,6,0,0,0,0,57
19,5,18,9,6,5,4,0,0,66
19,5,18,9,6,6,5,4,0,72
19,5,18,9,6,9,3,0,0,69
19,5,18,9,6,19,0,0,0,76
19,5,18,9,7,18,1,16,8,101
19,5,18,9,13,5,20,5,18,112
19,5,18,9,13,16,9,0,0,89
19,5,18,9,14,0,0,0,0,65
19,5,18,9,14,5,0,0,0,70
19,5,18,9,14,5,19,0,0,89
19,5,18,9,14,5,20,20,5,115
19,5,18,9,14,7,0,0,0,72
19,5,18,9,14,7,1,0,0,73
19,5,18,9,14,7,1,12,0,85
19,5,18,9,14,7,1,19,0,92
19,5,18,9,14,7,8,9,0,89
19,5,18,9,14,19,0,0,0,84
19,5,18,9,15,0,0,0,0,66
19,5,18,9,15,12,9,14,5,106
19,5,18,9,15,19,9,20,25,139
19,5,18,9,15,19,15,0,0,100
19,5,18,9,15,21,19,0,0,106
19,5,18,9,15,21,19,12,25,143
19,5,18,9,16,12,1,14,5,99
19,5,18,10,5,1,14,3,25,100
19,5,18,10,5,1,14,20,0,92
19,5,18,10,5,1,14,20,25,117
19,5,18,10,5,1,14,20,19,111
19,5,18,13,5,14,20,0,0,94
19,5,18,13,15,0,0,0,0,70
19,5,18,13,15,14,0,0,0,84
19,5,18,13,15,14,1,18,25,128
19,5,18,13,15,14,5,5,18,112
19,5,18,13,15,14,5,18,0,107
19,5,18,13,15,14,5,20,0,109
19,5,18,13,15,14,9,3,0,96
19,5,18,13,15,14,9,3,19,115
19,5,18,13,15,14,9,14,7,114
19,5,18,13,15,14,9,19,5,117
19,5,18,13,15,14,9,19,8,120
19,5,18,13,15,14,9,19,13,125
19,5,18,13,15,14,9,19,20,132
19,5,18,13,15,14,9,26,5,124
19,5,18,13,15,14,15,9,4,112
19,5,18,13,15,14,19,0,0,103
19,5,18,13,21,14,3,12,5,110
19,5,18,14,1,13,2,25,0,97
19,5,18,15,0,0,0,0,0,57
19,5,18,15,3,25,19,20,0,124
19,5,18,15,6,12,21,9,4,109
19,5,18,15,12,5,13,13,1,101
19,5,18,15,12,9,14,0,0,92
19,5,18,15,12,15,7,25,0,116
19,5,18,15,12,15,7,9,3,103
19,5,18,15,14,0,0,0,0,71
19,5,18,15,15,14,0,0,0,86
19,5,18,15,15,20,0,0,0,92
19,5,18,15,16,21,19,0,0,113
19,5,18,15,19,1,0,0,0,77
19,5,18,15,19,1,5,0,0,82
19,5,18,15,19,1,12,0,0,89
19,5,18,15,19,1,19,0,0,96
19,5,18,15,19,3,15,16,25,135
19,5,18,15,19,5,0,0,0,81
19,5,18,15,19,9,20,25,0,130
19,5,18,15,19,9,20,9,19,133
19,5,18,15,20,9,14,1,0,101
19,5,18,15,20,9,14,1,12,113
19,5,18,15,20,9,14,5,0,105
19,5,18,15,20,9,14,5,19,124
19,5,18,15,20,25,16,5,0,123
19,5,18,15,20,25,16,5,19,142
19,5,18,15,20,15,14,9,14,129
19,5,18,15,20,15,24,9,14,139
19,5,18,15,21,19,0,0,0,97
19,5,18,15,23,0,0,0,0,80
19,5,18,15,23,19,0,0,0,99
19,5,18,15,26,5,13,0,0,101
19,5,18,15,26,25,13,5,0,126
19,5,18,16,5,14,20,9,14,120
19,5,18,16,5,14,20,12,25,134
19,5,18,16,5,14,20,18,25,140
19,5,18,16,5,14,20,19,0,116
19,5,18,16,5,20,20,5,0,108
19,5,18,16,8,9,4,0,0,79
19,5,18,16,8,15,9,4,0,94
19,5,18,16,9,7,15,0,0,89
19,5,18,16,9,7,15,5,19,113
19,5,18,16,15,12,5,20,0,110
19,5,18,16,21,12,1,14,0,106
19,5,18,16,21,12,9,4,0,104
19,5,18,16,21,12,9,14,5,119
19,5,18,16,21,12,9,20,5,125
19,5,18,16,21,12,15,9,4,119
19,5,18,18,1,5,0,0,0,66
19,5,18,18,1,7,5,0,0,73
19,5,18,18,1,9,0,0,0,70
19,5,18,18,1,14,0,0,0,75
19,5,18,18,1,14,1,0,0,76
19,5,18,18,1,14,9,4,0,88
19,5,18,18,1,14,9,4,19,107
19,5,18,18,1,14,15,9,4,103
19,5,18,18,1,14,15,19,0,109
19,5,18,18,1,20,5,0,0,86
19,5,18,18,1,20,5,4,0,90
19,5,18,18,1,20,5,19,0,105
19,5,18,18,1,20,9,3,0,93
19,5,18,18,1,20,9,12,5,107
19,5,18,18,1,20,9,14,7,111
19,5,18,18,1,20,9,15,14,119
19,5,18,18,1,20,21,18,5,125
19,5,18,18,1,20,21,19,0,121
19,5,18,18,5,6,9,12,5,97
19,5,18,18,5,6,9,14,5,99
19,5,18,18,25,0,0,0,0,85
19,5,18,18,9,3,15,18,14,119
19,5,18,18,9,5,4,0,0,78
19,5,18,18,9,5,4,12,25,115
19,5,18,18,9,5,19,0,0,93
19,5,18,18,9,6,15,18,13,121
19,5,18,18,25,9,14,7,0,115
19,5,18,18,9,14,7,0,0,90
19,5,18,18,9,16,5,4,0,94
19,5,18,18,21,12,1,0,0,94
19,5,18,18,21,12,1,20,5,119
19,5,18,19,0,0,0,0,0,61
19,5,18,20,1,0,0,0,0,63
19,5,18,20,9,14,7,0,0,92
19,5,18,20,9,15,14,0,0,100
19,5,18,20,9,22,5,0,0,98
19,5,18,20,21,12,5,0,0,100
19,5,18,20,21,12,21,13,0,129
19,5,18,20,21,13,0,0,0,96
19,5,18,21,12,5,0,0,0,80
19,5,18,21,13,0,0,0,0,76
19,5,18,21,13,1,12,0,0,89
19,5,18,21,13,19,0,0,0,95
19,5,18,21,20,0,0,0,0,83
19,5,18,22,0,0,0,0,0,64
19,5,18,22,1,2,12,5,0,84
19,5,18,22,1,7,5,0,0,77
19,5,18,22,1,12,0,0,0,77
19,5,18,22,1,12,9,14,5,105
19,5,18,22,1,12,19,0,0,96
19,5,18,22,1,14,20,0,0,99
19,5,18,22,1,14,20,3,25,127
19,5,18,22,1,14,20,18,25,142
19,5,18,22,1,14,20,19,0,118
19,5,18,22,1,20,9,15,14,123
19,5,18,22,5,0,0,0,0,69
19,5,18,22,5,4,0,0,0,73
19,5,18,22,5,14,20,5,0,108
19,5,18,22,5,18,25,0,0,112
19,5,18,22,5,18,19,0,0,106
19,5,18,22,5,19,0,0,0,88
19,5,18,22,5,20,0,0,0,89
19,5,18,22,5,20,20,5,0,114
19,5,18,22,9,1,2,12,5,93
19,5,18,22,9,3,5,4,0,85
19,5,18,22,9,3,5,18,0,99
19,5,18,22,9,3,5,18,19,118
19,5,18,22,9,3,5,19,0,100
19,5,18,22,9,3,9,14,7,106
19,5,18,22,9,5,14,20,0,112
19,5,18,22,9,5,20,20,5,123
19,5,18,22,9,12,5,0,0,90
19,5,18,22,9,12,5,12,25,127
19,5,18,22,9,12,9,19,13,126
19,5,18,22,9,12,9,20,25,139
19,5,18,22,9,12,9,26,5,125
19,5,18,22,9,14,7,0,0,94
19,5,18,22,9,14,7,19,0,113
19,5,18,22,9,19,20,0,0,112
19,5,18,22,9,20,5,21,18,137
19,5,18,22,9,20,9,1,12,115
19,5,18,22,9,20,9,21,13,136
19,5,18,22,9,20,15,18,0,126
19,5,18,22,9,20,15,18,19,145
19,5,18,22,9,20,18,9,24,144
19,5,18,22,9,20,21,4,5,123
19,5,18,22,9,20,21,18,5,137
19,5,18,22,15,0,0,0,0,79
19,5,18,22,15,5,4,0,0,88
19,5,18,22,15,9,14,7,0,109
19,5,18,22,15,12,1,2,0,94
19,5,18,22,15,19,0,0,0,98
19,5,18,22,15,20,1,2,0,102
19,5,18,22,21,12,1,20,5,123
19,5,18,22,21,19,0,0,0,104
19,5,18,23,1,13,2,25,0,106
19,5,19,1,13,5,0,0,0,62
19,5,19,1,13,5,19,0,0,81
19,5,19,1,13,9,14,0,0,80
19,5,19,1,13,9,14,5,0,85
19,5,19,1,13,15,9,4,0,85
19,5,19,1,13,15,9,4,19,104
19,5,19,1,13,15,12,0,0,84
19,5,19,3,21,14,3,9,1,94
19,5,19,3,21,16,12,5,0,100
19,5,19,11,9,14,0,0,0,77
19,5,19,13,1,0,0,0,0,57
19,5,19,16,5,18,1,12,0,95
19,5,19,17,21,9,0,0,0,90
19,5,19,17,21,9,8,0,0,98
19,5,19,19,0,0,0,0,0,62
19,5,19,19,1,0,0,0,0,63
19,5,19,19,5,4,0,0,0,71
19,5,19,19,9,12,5,0,0,88
19,5,19,19,9,12,9,20,25,137
19,5,19,19,9,15,14,0,0,100
19,5,19,19,9,15,14,1,12,113
19,5,19,19,16,15,15,12,0,120
19,5,19,19,16,15,15,12,19,139
19,5,19,20,5,18,3,5,0,94
19,5,19,20,5,18,3,5,19,113
19,5,19,20,5,18,20,9,1,116
19,5,19,20,5,20,0,0,0,88
19,5,19,20,5,20,19,0,0,107
19,5,19,20,5,20,20,15,0,123
19,5,19,20,9,0,0,0,0,72
19,5,19,20,9,1,0,0,0,73
19,5,19,20,9,1,4,0,0,77
19,5,19,20,9,14,1,0,0,87
19,5,19,20,9,14,1,19,0,106
19,5,19,20,9,14,5,0,0,91
19,5,19,20,9,14,5,19,0,110
19,5,19,20,15,12,5,0,0,95
19,5,19,20,15,12,5,20,0,115
19,5,19,20,15,14,0,0,0,92
19,5,19,20,21,15,18,0,0,117
19,5,20,1,3,5,15,21,19,108
19,5,20,1,5,0,0,0,0,50
19,5,20,1,12,0,0,0,0,57
19,5,20,1,18,9,4,0,0,76
19,5,20,1,18,9,15,21,19,127
19,5,20,1,20,9,15,14,0,103
19,5,20,2,1,3,11,0,0,61
19,5,20,2,1,3,11,19,0,80
19,5,20,2,15,12,20,0,0,93
19,5,20,4,15,23,14,0,0,100
19,5,20,5,14,1,14,20,0,98
19,5,20,6,1,19,20,0,0,90
19,5,20,8,5,1,4,0,0,62
19,5,20,9,5,18,0,0,0,76
19,5,20,9,6,15,18,13,0,105
19,5,20,9,7,5,18,0,0,83
19,5,20,9,15,5,18,18,0,109
19,5,20,12,9,14,5,0,0,84
19,5,20,12,9,14,5,19,0,103
19,5,20,12,9,14,7,0,0,86
19,5,20,14,5,19,19,0,0,101
19,5,20,14,5,20,0,0,0,83
19,5,20,15,6,6,0,0,0,71
19,5,20,15,6,6,19,0,0,90
19,5,20,15,14,19,0,0,0,92
19,5,20,15,19,5,0,0,0,83
19,5,20,15,21,19,0,0,0,99
19,5,20,15,21,20,0,0,0,100
19,5,20,15,21,20,19,0,0,119
19,5,20,15,22,5,18,0,0,104
19,5,20,16,6,24,0,0,0,90
19,5,20,19,0,0,0,0,0,63
19,5,20,19,3,18,5,23,0,112
19,5,20,19,3,18,5,23,19,131
19,5,20,19,13,1,14,0,0,91
19,5,20,20,0,0,0,0,0,64
19,5,20,20,1,2,12,5,0,84
19,5,20,20,1,9,14,5,0,93
19,5,20,20,5,5,0,0,0,74
19,5,20,20,5,5,19,0,0,93
19,5,20,20,5,18,0,0,0,87
19,5,20,20,5,18,19,0,0,106
19,5,20,20,9,13,1,0,0,87
19,5,20,20,9,13,15,0,0,101
19,5,20,20,9,14,7,0,0,94
19,5,20,20,9,14,7,19,0,113
19,5,20,20,12,5,4,0,0,85
19,5,20,20,12,5,4,12,25,122
19,5,20,20,12,5,18,0,0,99
19,5,20,20,12,5,18,19,0,118
19,5,20,20,12,5,19,0,0,100
19,5,20,20,12,9,14,7,0,106
19,5,20,20,12,9,14,7,19,125
19,5,20,20,12,15,18,0,0,109
19,5,20,20,12,15,18,19,0,128
19,5,20,20,15,19,0,0,0,98
19,5,20,20,19,0,0,0,0,83
19,5,20,20,19,13,1,14,0,111
19,5,20,21,9,4,0,0,0,78
19,5,20,21,12,1,0,0,0,78
19,5,20,21,12,1,5,0,0,83
19,5,20,21,12,5,0,0,0,82
19,5,20,21,12,15,19,5,0,116
19,5,20,21,12,15,21,19,0,132
19,5,20,21,16,0,0,0,0,81
19,5,20,21,16,19,0,0,0,100
19,5,20,23,1,12,12,0,0,92
19,5,20,23,9,19,5,0,0,100
19,5,20,23,15,18,11,0,0,111
19,5,20,23,15,18,11,19,0,130
19,5,21,4,1,8,0,0,0,58
19,5,21,7,8,0,0,0,0,60
19,5,22,5,14,0,0,0,0,65
19,5,22,5,14,2,1,18,11,97
19,5,22,5,14,6,15,12,4,102
19,5,22,5,14,19,0,0,0,84
19,5,22,5,14,20,5,5,14,109
19,5,22,5,14,20,8,0,0,93
19,5,22,5,14,20,8,12,25,130
19,5,22,5,14,20,8,19,0,112
19,5,22,5,14,20,9,5,19,118
19,5,22,5,18,0,0,0,0,69
19,5,22,5,18,1,2,12,5,89
19,5,22,5,18,1,12,0,0,82
19,5,22,5,18,1,12,12,25,119
19,5,22,5,18,1,12,19,0,101
19,5,22,5,18,1,12,20,8,110
19,5,22,5,18,1,12,20,25,127
19,5,22,5,18,1,20,5,0,95
19,5,22,5,18,5,0,0,0,74
19,5,22,5,18,5,4,0,0,78
19,5,22,5,18,5,4,12,25,115
19,5,22,5,18,5,12,25,0,111
19,5,22,5,18,5,18,0,0,92
19,5,22,5,18,5,18,19,0,111
19,5,22,5,18,5,19,20,0,113
19,5,22,5,18,9,5,19,0,102
19,5,22,5,18,9,14,7,0,99
19,5,22,5,18,9,19,8,0,105
19,5,22,5,18,9,20,25,0,123
19,5,22,5,18,9,26,5,0,109
19,5,22,5,18,19,0,0,0,88
19,5,22,9,3,8,5,0,0,71
19,5,22,9,3,8,5,19,0,90
19,5,22,9,5,18,0,0,0,78
19,5,22,18,5,19,0,0,0,88
19,5,22,21,13,0,0,0,0,80
19,5,23,0,0,0,0,0,0,47
19,5,23,1,2,12,5,0,0,67
19,5,23,1,7,5,0,0,0,60
19,5,23,1,7,5,19,0,0,79
19,5,23,1,14,0,0,0,0,62
19,5,23,1,14,19,0,0,0,81
19,5,23,1,18,0,0,0,0,66
19,5,23,1,18,19,0,0,0,85
19,5,23,5,4,0,0,0,0,56
19,5,23,5,12,12,5,12,0,93
19,5,23,5,14,0,0,0,0,66
19,5,23,5,18,0,0,0,0,70
19,5,23,5,18,1,7,5,0,83
19,5,23,5,18,1,7,5,19,102
19,5,23,5,18,5,4,0,0,79
19,5,23,5,18,25,0,0,0,95
19,5,23,5,18,9,14,7,0,100
19,5,23,5,18,12,5,19,19,125
19,5,23,5,18,12,9,11,5,107
19,5,23,5,18,13,1,14,0,98
19,5,23,5,18,19,0,0,0,89
19,5,23,9,14,0,0,0,0,70
19,5,23,9,14,7,0,0,0,77
19,5,23,9,14,7,19,0,0,96
19,5,23,12,5,19,19,0,0,102
19,5,23,14,0,0,0,0,0,61
19,5,23,18,15,21,14,4,0,119
19,5,23,19,0,0,0,0,0,66
19,5,23,19,20,5,18,0,0,109
19,5,24,1,7,5,14,5,0,80
19,5,24,1,7,15,14,1,12,98
19,5,24,1,14,7,12,5,0,87
19,5,24,1,14,7,12,5,4,91
19,5,24,5,4,0,0,0,0,57
19,5,24,5,14,1,18,25,0,111
19,5,24,5,14,14,9,1,12,103
19,5,24,5,14,14,9,21,13,124
19,5,24,5,18,14,0,0,0,85
19,5,24,5,19,0,0,0,0,72
19,5,24,6,9,4,0,0,0,67
19,5,24,6,15,9,12,0,0,90
19,5,24,8,15,15,4,0,0,90
19,5,24,25,0,0,0,0,0,73
19,5,24,9,5,18,0,0,0,80
19,5,24,9,5,19,20,0,0,101
19,5,24,9,6,9,4,0,0,76
19,5,24,9,12,25,0,0,0,94
19,5,24,9,12,12,9,15,14,119
19,5,24,9,14,5,19,19,0,114
19,5,24,9,14,7,0,0,0,78
19,5,24,9,16,5,4,0,0,82
19,5,24,9,16,15,12,1,18,119
19,5,24,9,19,13,0,0,0,89
19,5,24,9,19,13,19,0,0,108
19,5,24,9,19,20,0,0,0,96
19,5,24,9,19,20,19,0,0,115
19,5,24,12,5,19,19,0,0,103
19,5,24,12,5,19,19,12,25,140
19,5,24,12,25,0,0,0,0,85
19,5,24,12,9,11,5,0,0,85
19,5,24,15,12,15,7,25,0,122
19,5,24,15,12,15,7,9,3,109
19,5,24,16,15,20,0,0,0,99
19,5,24,16,15,20,19,0,0,118
19,5,24,20,0,0,0,0,0,68
19,5,24,20,1,3,20,9,3,104
19,5,24,20,1,9,14,0,0,92
19,5,24,20,1,9,14,19,0,111
19,5,24,20,1,14,0,0,0,83
19,5,24,20,1,14,20,1,12,116
19,5,24,20,1,14,20,19,0,122
19,5,24,20,1,18,0,0,0,87
19,5,24,20,1,18,25,0,0,112
19,5,24,20,1,18,9,9,0,105
19,5,24,20,1,18,9,21,19,136
19,5,24,20,5,18,14,0,0,105
19,5,24,20,5,20,0,0,0,93
19,5,24,20,5,20,19,0,0,112
19,5,24,20,5,20,20,5,0,118
19,5,24,20,5,20,20,5,19,137
19,5,24,20,9,3,0,0,0,80
19,5,24,20,9,12,5,0,0,94
19,5,24,20,9,12,5,19,0,113
19,5,24,20,9,16,1,18,1,113
19,5,24,20,9,16,12,25,0,130
19,5,24,20,15,0,0,0,0,83
19,5,24,20,15,12,5,0,0,100
19,5,24,20,15,12,5,20,0,120
19,5,24,20,15,14,5,19,19,140
19,5,24,20,15,14,19,0,0,116
19,5,24,20,15,19,0,0,0,102
19,5,24,20,18,25,0,0,0,111
19,5,24,20,19,0,0,0,0,87
19,5,24,20,21,12,1,0,0,102
19,5,24,20,21,12,1,18,25,145
19,5,24,20,21,15,18,0,0,122
19,5,24,20,21,16,12,5,0,122
19,5,24,20,21,16,12,5,4,126
19,5,24,20,21,16,12,5,19,141
19,5,24,20,21,16,12,5,20,142
19,5,24,20,21,16,12,5,24,146
19,5,24,20,21,16,12,25,0,142
19,5,24,20,21,18,0,0,0,107
19,5,24,21,1,12,0,0,0,82
19,5,24,21,1,12,5,0,0,87
19,5,24,21,1,12,9,19,13,123
19,5,24,21,1,12,9,19,20,130
19,5,24,21,1,12,9,20,25,136
19,5,24,21,1,12,9,26,5,122
19,5,24,21,1,12,12,25,0,119
19,5,24,21,15,21,19,0,0,124
19,5,24,21,16,1,18,1,0,105
19,6,5,18,9,3,19,0,0,79
19,6,13,0,0,0,0,0,0,38
19,6,15,7,1,20,15,0,0,83
19,6,15,15,20,0,0,0,0,75
19,6,15,18,26,1,14,4,15,118
19,6,15,18,26,1,20,15,0,120
19,6,15,18,26,1,20,15,19,139
19,6,18,5,5,0,0,0,0,53
19,6,21,13,1,20,15,0,0,95
19,6,21,13,1,20,15,19,0,114
19,6,26,0,0,0,0,0,0,51
19,7,4,0,0,0,0,0,0,30
19,7,18,1,6,6,9,20,9,95
19,7,18,1,6,6,9,20,15,101
19,8,5,0,0,0,0,0,0,32
19,8,5,1,4,9,14,7,0,67
19,8,5,1,6,0,0,0,0,39
19,8,5,1,6,1,7,5,0,52
19,8,5,1,6,5,4,0,0,48
19,8,5,1,6,25,0,0,0,64
19,8,5,1,6,9,14,7,0,69
19,8,5,1,6,12,9,11,5,76
19,8,5,1,6,18,9,16,5,87
19,8,5,1,6,19,0,0,0,58
19,8,5,1,12,0,0,0,0,45
19,8,5,1,12,9,14,7,0,75
19,8,5,1,12,9,14,7,19,94
19,8,5,1,12,19,0,0,0,64
19,8,5,1,14,0,0,0,0,47
19,8,5,1,18,2,9,12,12,86
19,8,5,1,18,4,0,0,0,55
19,8,5,1,18,5,4,0,0,60
19,8,5,1,18,5,18,19,0,93
19,8,5,1,18,8,15,7,0,81
19,8,5,1,18,9,14,7,0,81
19,8,5,1,18,12,5,7,19,94
19,8,5,1,18,12,5,19,19,106
19,8,5,1,18,12,9,14,7,93
19,8,5,1,18,13,1,14,0,79
19,8,5,1,18,19,0,0,0,70
19,8,5,1,18,19,13,1,14,98
19,8,5,1,18,20,1,9,12,93
19,8,5,1,19,0,0,0,0,52
19,8,5,1,20,0,0,0,0,53
19,8,5,1,20,6,9,19,8,95
19,8,5,1,20,8,0,0,0,61
19,8,5,1,20,8,5,0,0,66
19,8,5,1,20,8,5,4,0,70
19,8,5,1,20,8,5,18,0,84
19,8,5,1,20,8,5,18,25,109
19,8,5,1,20,8,5,18,19,103
19,8,5,1,20,8,5,19,0,85
19,8,5,1,20,8,25,0,0,86
19,8,5,1,20,8,9,5,18,93
19,8,5,1,20,8,9,14,7,91
19,8,5,1,20,8,19,0,0,80
19,8,5,1,22,5,0,0,0,60
19,8,5,1,22,5,4,0,0,64
19,8,5,1,22,5,13,1,14,88
19,8,5,1,22,5,19,0,0,79
19,8,5,1,22,9,14,7,0,85
19,8,5,2,1,14,7,0,0,56
19,8,5,2,1,14,7,19,0,75
19,8,5,2,1,18,0,0,0,53
19,8,5,2,5,1,14,0,0,54
19,8,5,2,5,1,14,19,0,73
19,8,5,2,5,5,14,0,0,58
19,8,5,2,5,5,14,5,18,81
19,8,5,2,5,5,14,19,0,77
19,8,5,3,8,9,20,1,0,73
19,8,5,3,8,9,20,1,8,81
19,8,5,4,0,0,0,0,0,36
19,8,5,4,1,2,12,5,0,56
19,8,5,4,4,1,2,12,5,60
19,8,5,4,4,5,4,0,0,49
19,8,5,4,4,5,18,0,0,63
19,8,5,4,4,5,18,19,0,82
19,8,5,4,4,9,14,7,0,70
19,8,5,4,5,18,0,0,0,59
19,8,5,4,8,1,14,4,0,63
19,8,5,4,9,13,0,0,0,58
19,8,5,4,12,9,11,5,0,73
19,8,5,4,13,1,14,0,0,64
19,8,5,4,21,0,0,0,0,57
19,8,5,4,23,9,19,5,0,92
19,8,5,5,0,0,0,0,0,37
19,8,5,5,6,9,19,8,0,79
19,8,5,5,12,0,0,0,0,49
19,8,5,5,12,25,0,0,0,74
19,8,5,5,12,9,14,7,0,79
19,8,5,5,14,5,4,0,0,60
19,8,5,5,14,5,25,0,0,81
19,8,5,5,14,5,25,19,0,100
19,8,5,5,14,6,21,12,0,90
19,8,5,5,14,25,0,0,0,76
19,8,5,5,14,9,5,0,0,65
19,8,5,5,14,9,5,18,0,83
19,8,5,5,14,9,5,19,0,84
19,8,5,5,14,9,5,19,20,104
19,8,5,5,14,9,14,7,0,81
19,8,5,5,14,12,5,19,19,106
19,8,5,5,14,12,25,0,0,88
19,8,5,5,14,19,0,0,0,70
19,8,5,5,16,0,0,0,0,53
19,8,5,5,16,2,1,3,11,70
19,8,5,5,16,2,5,12,12,84
19,8,5,5,16,2,9,14,5,83
19,8,5,5,16,3,15,20,0,91
19,8,5,5,16,3,15,20,5,96
19,8,5,5,16,4,9,16,0,82
19,8,5,5,16,4,15,7,0,79
19,8,5,5,16,4,15,7,19,98
19,8,5,5,16,6,15,12,4,90
19,8,5,5,16,6,15,15,20,109
19,8,5,5,16,7,1,20,5,86
19,8,5,5,16,8,5,1,4,71
19,8,5,5,16,8,15,15,11,102
19,8,5,5,16,25,0,0,0,78
19,8,5,5,16,9,6,25,0,93
19,8,5,5,16,9,19,8,0,89
19,8,5,5,16,11,9,12,12,97
19,8,5,5,16,12,5,19,19,108
19,8,5,5,16,12,5,20,0,90
19,8,5,5,16,12,9,11,5,90
19,8,5,5,16,12,9,14,7,95
19,8,5,5,16,13,1,14,0,81
19,8,5,5,16,13,5,14,0,85
19,8,5,5,16,13,9,14,20,109
19,8,5,5,16,14,15,19,5,106
19,8,5,5,16,14,21,20,0,108
19,8,5,5,16,16,5,14,0,88
19,8,5,5,16,19,8,5,4,89
19,8,5,5,16,19,11,9,14,106
19,8,5,5,16,23,1,12,11,100
19,8,5,5,16,23,5,5,4,90
19,8,5,5,18,0,0,0,0,55
19,8,5,5,18,5,4,0,0,64
19,8,5,5,18,5,18,0,0,78
19,8,5,5,18,5,19,20,0,99
19,8,5,5,18,9,14,7,0,85
19,8,5,5,18,12,5,7,19,98
19,8,5,5,18,12,25,0,0,92
19,8,5,5,18,19,0,0,0,74
19,8,5,5,20,0,0,0,0,57
19,8,5,5,20,1,7,5,0,70
19,8,5,5,20,5,4,0,0,66
19,8,5,5,20,5,18,0,0,80
19,8,5,5,20,5,18,19,0,99
19,8,5,5,20,6,5,4,0,72
19,8,5,5,20,6,21,12,0,96
19,8,5,5,20,25,0,0,0,82
19,8,5,5,20,9,14,7,0,87
19,8,5,5,20,9,14,7,19,106
19,8,5,5,20,12,5,19,19,112
19,8,5,5,20,12,5,20,0,94
19,8,5,5,20,12,9,11,5,94
19,8,5,5,20,12,9,14,7,99
19,8,5,5,20,23,1,25,19,125
19,8,5,5,20,23,1,19,8,108
19,8,5,5,20,23,9,19,5,113
19,8,5,5,20,23,15,18,11,124
19,8,5,5,22,5,0,0,0,64
19,8,5,5,22,5,19,0,0,83
19,8,5,7,5,20,19,0,0,83
19,8,5,7,5,20,26,0,0,90
19,8,5,8,9,20,1,0,0,70
19,8,5,8,9,20,1,8,0,78
19,8,5,9,11,0,0,0,0,52
19,8,5,9,11,4,15,13,0,84
19,8,5,9,11,4,15,13,19,103
19,8,5,9,11,8,0,0,0,60
19,8,5,9,11,8,4,15,13,92
19,8,5,9,11,8,12,25,0,97
19,8,5,9,11,8,19,0,0,79
19,8,5,9,11,12,25,0,0,89
19,8,5,9,11,12,9,11,5,89
19,8,5,9,11,19,0,0,0,71
19,8,5,9,12,1,19,0,0,73
19,8,5,25,12,5,0,0,0,74
19,8,5,9,12,9,14,7,0,83
19,8,5,9,20,1,14,19,0,95
19,8,5,9,20,5,12,0,0,78
19,8,5,9,20,12,5,14,0,92
19,8,5,11,5,12,0,0,0,60
19,8,5,11,5,12,19,0,0,79
19,8,5,12,4,0,0,0,0,48
19,8,5,12,4,5,18,0,0,71
19,8,5,12,4,6,15,23,12,104
19,8,5,12,4,18,1,11,5,83
19,8,5,12,4,21,3,11,0,83
19,8,5,12,4,21,3,11,19,102
19,8,5,12,6,0,0,0,0,50
19,8,5,12,6,2,1,3,11,67
19,8,5,12,6,6,21,12,0,89
19,8,5,12,6,6,21,12,19,108
19,8,5,12,6,25,0,0,0,75
19,8,5,12,6,12,9,11,5,87
19,8,5,12,6,12,9,19,20,110
19,8,5,12,6,13,1,20,5,89
19,8,5,12,6,18,15,15,13,111
19,8,5,12,6,23,15,18,14,120
19,8,5,12,12,1,3,0,0,60
19,8,5,12,12,1,3,11,0,71
19,8,5,12,12,1,3,11,19,90
19,8,5,12,12,1,3,19,0,79
19,8,5,12,12,1,11,0,0,68
19,8,5,12,12,2,1,3,11,73
19,8,5,12,12,2,1,18,11,88
19,8,5,12,12,2,12,15,23,108
19,8,5,12,12,5,4,0,0,65
19,8,5,12,12,5,18,0,0,79
19,8,5,12,12,5,18,19,0,98
19,8,5,12,12,6,9,18,5,94
19,8,5,12,12,6,9,19,8,98
19,8,5,12,12,6,21,12,0,95
19,8,5,12,12,8,5,1,4,74
19,8,5,12,12,9,5,18,0,88
19,8,5,12,12,9,5,19,20,109
19,8,5,12,12,9,14,7,0,86
19,8,5,12,12,13,5,14,0,88
19,8,5,12,12,16,1,4,0,77
19,8,5,12,12,16,15,20,0,107
19,8,5,12,12,19,0,0,0,75
19,8,5,12,12,21,13,0,0,90
19,8,5,12,12,23,15,18,11,123
19,8,5,12,20,1,19,0,0,84
19,8,5,12,20,5,18,0,0,87
19,8,5,12,20,5,18,5,4,96
19,8,5,12,20,5,18,5,18,110
19,8,5,12,20,5,18,25,0,112
19,8,5,12,20,5,18,19,0,106
19,8,5,12,20,25,0,0,0,89
19,8,5,12,20,9,5,0,0,78
19,8,5,12,20,9,5,19,0,97
19,8,5,12,20,18,15,14,0,111
19,8,5,12,22,5,0,0,0,71
19,8,5,12,22,5,4,0,0,75
19,8,5,12,22,5,18,0,0,89
19,8,5,12,22,5,18,19,0,108
19,8,5,12,22,5,19,0,0,90
19,8,5,12,22,25,0,0,0,91
19,8,5,12,22,9,5,18,0,98
19,8,5,12,22,9,5,19,20,119
19,8,5,12,22,9,14,7,0,96
19,8,5,12,22,9,14,7,19,115
19,8,5,13,1,1,12,0,0,59
19,8,5,13,9,14,9,20,8,105
19,8,5,13,15,26,26,12,5,129
19,8,5,14,4,0,0,0,0,50
19,8,5,14,4,6,21,12,0,89
19,8,5,14,4,9,14,7,0,80
19,8,5,14,4,19,0,0,0,69
19,8,5,14,20,0,0,0,0,66
19,8,5,15,7,21,5,0,0,80
19,8,5,15,12,9,3,0,0,71
19,8,5,15,12,19,0,0,0,78
19,8,5,16,8,5,18,4,25,108
19,8,5,16,8,5,18,4,19,102
19,8,5,16,16,5,3,11,0,83
19,8,5,16,16,5,25,0,0,94
19,8,5,16,16,9,3,11,0,87
19,8,5,16,19,20,1,18,5,111
19,8,5,16,19,20,5,18,0,110
19,8,5,18,2,1,3,8,1,65
19,8,5,18,2,5,18,20,0,95
19,8,5,18,2,5,18,20,19,114
19,8,5,18,2,5,20,0,0,77
19,8,5,18,2,5,20,19,0,96
19,8,5,18,4,0,0,0,0,54
19,8,5,18,4,19,0,0,0,73
19,8,5,18,5,5,6,0,0,66
19,8,5,18,5,5,6,19,0,85
19,8,5,18,9,1,0,0,0,60
19,8,5,18,9,1,20,0,0,80
19,8,5,18,9,6,0,0,0,65
19,8,5,18,9,6,1,0,0,66
19,8,5,18,9,6,1,20,5,91
19,8,5,18,9,6,6,0,0,71
19,8,5,18,9,6,6,3,25,99
19,8,5,18,9,6,6,18,25,114
19,8,5,18,9,6,6,19,0,90
19,8,5,18,9,6,9,0,0,74
19,8,5,18,9,6,25,0,0,90
19,8,5,18,9,6,9,1,14,89
19,8,5,18,9,6,19,0,0,84
19,8,5,18,12,15,3,11,19,110
19,8,5,18,15,15,20,0,0,100
19,8,5,18,15,15,20,19,0,119
19,8,5,18,16,1,19,0,0,86
19,8,5,18,18,9,5,19,0,101
19,8,5,18,18,9,19,5,19,120
19,8,5,18,23,1,14,9,0,97
19,8,5,19,0,0,0,0,0,51
19,8,5,20,8,0,0,0,0,60
19,8,5,20,12,1,14,4,19,102
19,8,5,21,3,8,0,0,0,64
19,8,5,21,3,8,19,0,0,83
19,8,5,21,7,8,0,0,0,68
19,8,5,21,7,8,19,0,0,87
19,8,5,22,1,0,0,0,0,55
19,8,5,22,5,12,0,0,0,71
19,8,5,22,5,12,5,4,0,80
19,8,5,22,5,18,5,20,0,102
19,8,5,22,18,9,0,0,0,81
19,8,5,23,0,0,0,0,0,55
19,8,5,23,1,0,0,0,0,56
19,8,5,23,2,18,5,1,4,85
19,8,5,23,5,4,0,0,0,64
19,8,5,23,5,12,0,0,0,72
19,8,5,23,5,18,0,0,0,78
19,8,5,23,5,18,19,0,0,97
19,8,5,23,9,14,7,0,0,85
19,8,5,23,14,0,0,0,0,69
19,8,5,23,19,0,0,0,0,74
19,8,6,19,5,16,0,0,0,73
19,8,8,0,0,0,0,0,0,35
19,8,9,0,0,0,0,0,0,36
19,8,25,0,0,0,0,0,0,52
19,8,9,1,9,0,0,0,0,46
19,8,25,1,13,0,0,0,0,66
19,8,9,1,20,19,21,0,0,97
19,8,9,1,20,19,21,19,0,116
19,8,9,1,20,26,21,0,0,104
19,8,9,1,20,26,21,19,0,123
19,8,9,2,1,8,0,0,0,47
19,8,9,2,1,8,19,0,0,66
19,8,9,2,1,18,0,0,0,57
19,8,9,2,2,5,5,14,0,64
19,8,9,2,21,9,3,8,9,88
19,8,9,3,5,0,0,0,0,44
19,8,9,3,5,18,0,0,0,62
19,8,9,3,11,0,0,0,0,50
19,8,9,3,11,5,18,0,0,73
19,8,9,3,11,5,18,5,4,82
19,8,9,3,11,5,18,19,0,92
19,8,9,3,11,19,1,0,0,70
19,8,9,3,11,19,1,19,0,89
19,8,9,4,5,0,0,0,0,45
19,8,25,4,5,16,15,11,5,108
19,8,9,5,4,0,0,0,0,45
19,8,9,5,12,0,0,0,0,53
19,8,9,5,12,4,0,0,0,57
19,8,9,5,12,4,5,4,0,66
19,8,9,5,12,4,5,18,0,80
19,8,9,5,12,4,5,18,19,99
19,8,9,5,12,4,9,14,7,87
19,8,9,5,12,4,13,1,25,96
19,8,9,5,12,9,14,7,0,83
19,8,9,5,12,9,14,7,19,102
19,8,9,5,12,19,0,0,0,72
19,8,9,5,18,0,0,0,0,59
19,8,25,5,18,0,0,0,0,75
19,8,9,5,18,19,0,0,0,78
19,8,25,5,18,19,0,0,0,94
19,8,9,5,19,0,0,0,0,60
19,8,9,5,19,20,0,0,0,80
19,8,25,5,19,20,0,0,0,96
19,8,9,6,20,0,0,0,0,62
19,8,9,6,20,1,2,12,5,82
19,8,9,6,20,1,7,5,0,75
19,8,9,6,20,5,4,0,0,71
19,8,9,6,20,5,18,0,0,85
19,8,9,6,20,5,18,19,0,104
19,8,9,6,20,6,21,12,0,101
19,8,9,6,20,25,0,0,0,87
19,8,9,6,20,9,5,18,0,94
19,8,9,6,20,9,5,19,20,115
19,8,9,6,20,9,12,25,0,108
19,8,9,6,20,9,14,7,0,92
19,8,9,6,20,12,5,19,19,117
19,8,9,6,20,13,1,14,0,90
19,8,9,6,20,19,0,0,0,81
19,8,9,7,5,12,12,1,5,78
19,8,9,7,5,12,12,1,19,92
19,8,9,7,7,1,9,15,14,89
19,8,9,7,18,1,13,0,0,75
19,8,25,9,14,7,0,0,0,82
19,8,25,9,19,8,0,0,0,88
19,8,9,11,1,18,0,0,0,66
19,8,9,11,1,18,1,0,0,67
19,8,9,11,1,18,5,5,0,76
19,8,9,11,1,18,5,5,19,95
19,8,9,11,1,18,7,1,8,82
19,8,9,11,1,18,9,0,0,75
19,8,9,11,1,18,9,19,0,94
19,8,9,11,1,18,18,5,4,93
19,8,9,11,1,18,19,0,0,85
19,8,9,11,1,19,20,1,0,88
19,8,9,11,9,9,0,0,0,65
19,8,9,11,9,13,9,0,0,78
19,8,9,11,9,13,9,3,0,81
19,8,9,11,9,13,15,12,0,96
19,8,9,11,9,13,15,12,5,101
19,8,9,11,11,5,14,0,0,77
19,8,9,11,11,5,18,0,0,81
19,8,9,11,11,5,18,19,0,100
19,8,9,11,15,0,0,0,0,62
19,8,9,11,18,1,0,0,0,66
19,8,9,11,19,1,0,0,0,67
19,8,9,11,19,1,19,0,0,86
19,8,9,11,19,5,0,0,0,71
19,8,9,11,19,5,19,0,0,90
19,8,9,12,6,0,0,0,0,54
19,8,9,12,6,1,0,0,0,55
19,8,9,12,25,0,0,0,0,73
19,8,25,12,25,0,0,0,0,89
19,8,9,12,9,14,7,9,0,87
19,8,9,12,12,0,0,0,0,60
19,8,9,12,12,1,0,0,0,61
19,8,9,12,12,1,2,5,18,86
19,8,9,12,12,1,12,1,0,74
19,8,9,12,12,1,12,1,8,82
19,8,9,12,12,1,12,1,19,93
19,8,9,12,12,5,4,0,0,69
19,8,9,12,12,5,12,1,8,86
19,8,9,12,12,5,20,0,0,85
19,8,9,12,12,5,20,25,0,110
19,8,9,12,12,25,0,0,0,85
19,8,9,12,12,9,14,7,0,90
19,8,9,12,12,9,14,7,19,109
19,8,9,12,12,15,15,0,0,90
19,8,9,12,12,19,0,0,0,79
19,8,25,12,15,3,11,5,4,102
19,8,25,12,15,3,11,19,0,112
19,8,9,12,16,9,20,0,0,93
19,8,9,12,16,9,20,19,0,112
19,8,9,13,0,0,0,0,0,49
19,8,9,13,1,12,0,0,0,62
19,8,9,13,13,5,4,0,0,71
19,8,9,13,13,5,25,0,0,92
19,8,9,13,13,5,18,0,0,85
19,8,9,13,13,5,18,5,4,94
19,8,9,13,13,5,18,25,0,110
19,8,9,13,13,5,18,19,0,104
19,8,9,13,13,25,0,0,0,87
19,8,9,13,13,9,5,4,0,80
19,8,9,13,13,9,5,19,0,95
19,8,9,13,13,25,9,14,7,117
19,8,9,13,13,9,14,7,0,92
19,8,9,13,15,19,5,0,0,88
19,8,9,13,16,5,18,0,0,88
19,8,9,13,19,0,0,0,0,68
19,8,9,14,1,18,21,13,16,119
19,8,9,14,2,15,14,5,0,86
19,8,9,14,2,15,14,5,19,105
19,8,9,14,4,25,0,0,0,79
19,8,9,14,4,9,5,19,0,87
19,8,9,14,4,9,7,0,0,70
19,8,9,14,4,9,7,19,0,89
19,8,9,14,4,25,19,0,0,98
19,8,9,14,4,12,5,0,0,71
19,8,9,14,5,0,0,0,0,55
19,8,9,14,5,4,0,0,0,59
19,8,9,14,5,12,5,19,19,110
19,8,9,14,5,18,19,0,0,92
19,8,9,14,5,19,0,0,0,74
19,8,25,14,5,19,19,0,0,109
19,8,25,14,5,19,19,5,19,133
19,8,9,14,7,12,5,0,0,74
19,8,9,14,7,12,5,4,0,78
19,8,9,14,7,12,5,18,0,92
19,8,9,14,7,12,5,18,19,111
19,8,9,14,7,12,5,19,0,93
19,8,9,14,7,12,25,0,0,94
19,8,9,14,7,12,9,14,7,99
19,8,9,14,7,15,14,0,0,86
19,8,9,14,7,21,1,18,4,101
19,8,9,14,25,0,0,0,0,75
19,8,9,14,9,5,18,0,0,82
19,8,9,14,9,5,19,20,0,103
19,8,9,14,9,12,25,0,0,96
19,8,9,14,9,14,5,19,19,116
19,8,9,14,9,14,7,0,0,80
19,8,9,14,9,14,7,12,25,117
19,8,9,14,11,9,14,0,0,84
19,8,9,14,12,5,1,6,0,74
19,8,9,14,12,5,1,6,19,93
19,8,9,14,14,5,4,0,0,73
19,8,9,14,14,5,25,0,0,94
19,8,9,14,14,5,25,19,0,113
19,8,9,14,14,5,18,0,0,87
19,8,9,14,14,5,18,25,0,112
19,8,9,14,14,25,0,0,0,89
19,8,9,14,14,9,5,4,0,82
19,8,9,14,14,9,5,19,0,97
19,8,9,14,14,25,9,14,7,119
19,8,9,14,14,9,14,7,0,94
19,8,9,14,19,0,0,0,0,69
19,8,9,14,20,1,9,0,0,80
19,8,9,14,20,25,0,0,0,95
19,8,9,14,20,25,1,14,0,110
19,8,9,14,20,9,25,1,14,119
19,8,9,14,23,15,15,4,0,107
19,8,9,14,26,1,0,0,0,77
19,8,9,16,0,0,0,0,0,52
19,8,9,16,2,15,1,18,4,92
19,8,9,16,2,15,25,0,0,94
19,8,9,16,2,15,18,14,5,106
19,8,9,16,2,15,21,14,4,108
19,8,9,16,2,21,9,12,4,100
19,8,9,16,3,18,1,6,20,100
19,8,9,16,6,5,18,4,0,85
19,8,9,16,6,21,12,0,0,91
19,8,9,16,6,21,12,19,0,110
19,8,9,16,8,9,18,5,0,92
19,8,9,16,25,1,18,4,0,100
19,8,9,16,25,1,18,4,19,119
19,8,9,16,12,1,16,0,0,81
19,8,9,16,12,1,16,19,0,100
19,8,9,16,12,5,19,19,0,107
19,8,9,16,12,5,20,0,0,89
19,8,9,16,12,15,1,4,0,84
19,8,9,16,12,15,1,4,19,103
19,8,9,16,13,1,19,20,0,105
19,8,9,16,13,1,20,5,0,91
19,8,9,16,13,1,20,5,19,110
19,8,9,16,13,5,14,0,0,84
19,8,9,16,13,5,14,20,0,104
19,8,9,16,13,5,14,20,19,123
19,8,25,16,15,15,0,0,0,98
19,8,9,16,15,23,14,5,18,127
19,8,9,16,16,1,2,12,5,88
19,8,9,16,16,1,7,5,0,81
19,8,9,16,16,5,4,0,0,77
19,8,9,16,16,5,14,0,0,87
19,8,9,16,16,5,14,19,0,106
19,8,9,16,16,5,18,0,0,91
19,8,9,16,16,5,18,19,0,110
19,8,9,16,16,25,0,0,0,93
19,8,9,16,16,9,14,7,0,98
19,8,9,16,16,9,14,7,19,117
19,8,9,16,16,12,1,14,5,100
19,8,9,16,16,15,0,0,0,83
19,8,9,16,16,15,14,0,0,97
19,8,9,16,16,15,14,19,0,116
19,8,9,16,16,15,21,14,4,122
19,8,9,16,18,1,4,5,0,80
19,8,9,16,19,0,0,0,0,71
19,8,9,16,19,8,1,16,5,101
19,8,9,16,19,9,4,5,0,89
19,8,9,16,19,9,4,5,19,108
19,8,9,16,19,13,9,20,8,121
19,8,9,16,20,0,0,0,0,72
19,8,9,16,23,1,25,0,0,101
19,8,9,16,23,1,25,19,0,120
19,8,9,16,23,1,18,4,0,98
19,8,9,16,23,1,18,4,19,117
19,8,9,16,23,15,18,11,0,119
19,8,9,16,23,15,18,13,0,121
19,8,9,16,23,15,18,13,19,140
19,8,9,16,23,18,5,3,11,112
19,8,9,18,1,12,5,5,0,77
19,8,9,18,1,12,12,5,5,89
19,8,9,18,5,13,1,14,0,87
19,8,9,18,5,13,5,14,0,91
19,8,9,18,5,19,0,0,0,78
19,8,9,18,5,23,9,3,11,105
19,8,9,18,11,5,4,0,0,74
19,8,9,18,11,5,18,0,0,88
19,8,9,18,11,5,18,19,0,107
19,8,9,18,11,25,0,0,0,90
19,8,9,18,11,9,14,7,0,95
19,8,9,18,11,19,0,0,0,84
19,8,9,18,12,3,15,3,11,98
19,8,9,18,16,9,20,0,0,99
19,8,9,18,18,0,0,0,0,72
19,8,9,18,18,1,0,0,0,73
19,8,9,18,18,5,4,0,0,81
19,8,9,18,18,5,12,0,0,89
19,8,9,18,18,9,14,7,0,102
19,8,9,18,18,9,14,7,19,121
19,8,9,18,18,19,0,0,0,91
19,8,9,18,20,0,0,0,0,74
19,8,9,18,20,2,1,14,4,95
19,8,9,18,20,25,0,0,0,99
19,8,9,18,20,9,5,18,0,106
19,8,9,18,20,9,5,19,20,127
19,8,9,18,20,9,14,7,0,104
19,8,9,18,20,9,14,7,19,123
19,8,9,18,20,12,5,19,19,129
19,8,9,18,20,12,9,11,5,111
19,8,9,18,20,13,1,11,5,104
19,8,9,18,20,13,1,14,0,102
19,8,9,18,20,13,5,14,0,106
19,8,9,18,20,19,0,0,0,93
19,8,9,18,20,20,1,9,12,116
19,8,9,19,8,0,0,0,0,63
19,8,9,19,8,1,13,0,0,77
19,8,9,19,8,25,1,0,0,89
19,8,9,19,14,0,0,0,0,69
19,8,9,19,20,0,0,0,0,75
19,8,25,19,20,5,18,0,0,114
19,8,25,19,20,5,18,19,0,133
19,8,9,19,20,19,0,0,0,94
19,8,9,20,0,0,0,0,0,56
19,8,9,20,1,0,0,0,0,57
19,8,9,20,5,16,15,11,5,108
19,8,9,20,8,5,1,4,0,74
19,8,9,20,8,5,5,12,0,86
19,8,9,20,8,5,18,0,0,87
19,8,9,20,19,0,0,0,0,75
19,8,9,20,20,1,8,0,0,85
19,8,9,20,20,1,8,19,0,104
19,8,9,20,20,5,4,0,0,85
19,8,9,20,20,5,14,0,0,95
19,8,9,20,20,25,0,0,0,101
19,8,9,20,20,9,5,18,0,108
19,8,9,20,20,9,5,19,20,129
19,8,9,20,20,9,13,19,0,117
19,8,9,20,20,9,14,7,0,106
19,8,9,20,20,12,5,0,0,93
19,8,9,22,0,0,0,0,0,58
19,8,9,22,1,8,0,0,0,67
19,8,9,22,1,8,19,0,0,86
19,8,9,22,1,18,5,5,0,87
19,8,9,22,1,18,5,5,4,91
19,8,9,22,1,18,5,5,19,106
19,8,9,22,1,19,0,0,0,78
19,8,9,22,5,0,0,0,0,63
19,8,9,22,5,25,0,0,0,88
19,8,9,22,5,18,0,0,0,81
19,8,9,22,5,18,5,4,0,90
19,8,9,22,5,18,5,18,0,104
19,8,9,22,5,18,5,18,19,123
19,8,9,22,5,18,25,0,0,106
19,8,9,22,5,18,9,14,7,111
19,8,9,22,5,19,0,0,0,82
19,8,9,22,25,0,0,0,0,83
19,8,9,22,15,15,0,0,0,88
19,8,9,22,15,15,19,0,0,107
19,8,9,22,19,0,0,0,0,77
19,8,9,22,22,25,0,0,0,105
19,8,9,22,26,15,11,21,0,131
19,8,9,26,15,11,21,0,0,109
19,8,11,15,20,26,9,13,0,121
19,8,12,5,13,9,5,8,12,91
19,8,12,5,13,9,5,12,0,83
19,8,12,5,13,9,5,12,19,102
19,8,12,5,16,0,0,0,0,60
19,8,12,5,16,16,0,0,0,76
19,8,12,5,16,16,5,4,0,85
19,8,12,5,16,16,19,0,0,95
19,8,12,5,16,19,0,0,0,79
19,8,12,9,13,1,26,5,12,105
19,8,12,9,13,1,26,12,0,100
19,8,12,15,3,11,0,0,0,68
19,8,12,15,3,11,19,0,0,87
19,8,12,21,13,16,0,0,0,89
19,8,12,21,13,16,5,4,0,98
19,8,12,21,13,16,25,0,0,114
19,8,12,21,13,16,19,0,0,108
19,8,13,1,12,20,26,0,0,99
19,8,13,1,12,20,26,25,0,124
19,8,13,5,1,18,0,0,0,64
19,8,13,5,1,18,19,0,0,83
19,8,13,15,0,0,0,0,0,55
19,8,13,15,5,19,0,0,0,79
19,8,13,15,15,26,5,0,0,101
19,8,13,15,15,26,5,4,0,105
19,8,13,15,15,26,5,19,0,120
19,8,13,21,3,11,0,0,0,75
19,8,13,21,3,11,19,0,0,94
19,8,14,1,16,19,0,0,0,77
19,8,14,15,15,11,0,0,0,82
19,8,14,15,15,11,19,0,0,101
19,8,15,0,0,0,0,0,0,42
19,8,15,1,4,0,0,0,0,47
19,8,15,1,4,5,18,0,0,70
19,8,15,1,12,0,0,0,0,55
19,8,15,1,12,5,4,0,0,64
19,8,15,1,12,5,18,0,0,78
19,8,15,1,12,5,19,20,0,99
19,8,15,1,12,25,0,0,0,80
19,8,15,1,12,9,5,18,0,87
19,8,15,1,12,9,5,19,20,108
19,8,15,1,12,9,14,7,0,85
19,8,15,1,12,14,5,19,19,112
19,8,15,1,12,23,9,19,5,111
19,8,15,1,20,0,0,0,0,63
19,8,15,1,20,19,0,0,0,82
19,8,15,3,8,5,20,0,0,78
19,8,15,3,8,5,20,9,13,100
19,8,15,3,8,5,20,19,0,97
19,8,15,3,11,0,0,0,0,56
19,8,15,3,11,1,2,12,5,76
19,8,15,3,11,5,4,0,0,65
19,8,15,3,11,5,18,0,0,79
19,8,15,3,11,5,18,19,0,98
19,8,15,3,11,8,5,1,4,74
19,8,15,3,11,9,14,7,0,86
19,8,15,3,11,12,9,11,5,93
19,8,15,3,11,19,0,0,0,75
19,8,15,3,11,23,1,22,5,107
19,8,15,4,0,0,0,0,0,46
19,8,15,4,4,5,14,0,0,69
19,8,15,4,4,25,0,0,0,75
19,8,15,4,4,25,4,15,13,107
19,8,15,4,4,9,5,4,0,68
19,8,15,4,4,9,5,18,0,82
19,8,15,4,4,9,5,19,0,83
19,8,15,4,4,9,5,19,20,103
19,8,15,4,4,25,9,14,7,105
19,8,15,4,4,25,9,19,13,116
19,8,15,4,4,25,9,20,5,109
19,8,15,4,4,9,12,25,0,96
19,8,15,4,5,0,0,0,0,51
19,8,15,4,5,18,0,0,0,69
19,8,15,5,0,0,0,0,0,47
19,8,15,5,2,9,12,12,0,82
19,8,15,5,2,9,12,12,19,101
19,8,15,5,2,9,18,4,0,80
19,8,15,5,2,12,1,3,11,76
19,8,15,5,2,15,25,0,0,89
19,8,15,5,2,18,21,19,8,115
19,8,15,5,3,18,1,6,20,95
19,8,15,5,4,0,0,0,0,51
19,8,15,5,8,15,18,14,0,102
19,8,15,5,8,15,18,14,19,121
19,8,15,5,9,14,7,0,0,77
19,8,15,5,12,1,3,5,0,68
19,8,15,5,12,1,3,5,19,87
19,8,15,5,12,5,19,19,0,102
19,8,15,5,13,1,11,5,0,77
19,8,15,5,13,1,14,0,0,75
19,8,15,5,13,15,12,4,0,91
19,8,15,5,16,1,3,0,0,67
19,8,15,5,16,1,3,11,0,78
19,8,15,5,16,1,3,11,19,97
19,8,15,5,16,1,3,19,0,86
19,8,15,5,18,0,0,0,0,65
19,8,15,5,18,19,0,0,0,84
19,8,15,5,19,0,0,0,0,66
19,8,15,5,19,8,9,14,5,102
19,8,15,5,19,8,15,16,0,105
19,8,15,5,19,13,9,20,8,116
19,8,15,5,20,18,5,5,0,95
19,8,15,5,20,18,5,5,19,114
19,8,15,5,23,15,13,1,14,113
19,8,15,6,1,18,0,0,0,67
19,8,15,6,1,18,19,0,0,86
19,8,15,6,6,18,15,20,8,115
19,8,15,6,18,15,20,8,0,109
19,8,15,6,21,12,0,0,0,81
19,8,15,7,0,0,0,0,0,49
19,8,15,7,1,15,12,0,0,77
19,8,15,7,7,5,4,0,0,65
19,8,15,7,7,9,5,0,0,70
19,8,15,7,7,9,14,7,0,86
19,8,15,7,7,12,5,0,0,73
19,8,15,7,7,12,25,0,0,93
19,8,15,7,9,0,0,0,0,58
19,8,15,7,19,0,0,0,0,68
19,8,15,7,21,14,0,0,0,84
19,8,15,7,21,14,1,12,0,97
19,8,15,7,21,14,1,20,5,110
19,8,15,7,21,14,19,0,0,103
19,8,15,8,5,20,0,0,0,75
19,8,15,8,10,9,0,0,0,69
19,8,15,8,10,9,19,0,0,88
19,8,15,25,1,0,0,0,0,68
19,8,15,25,21,0,0,0,0,88
19,8,15,25,21,19,0,0,0,107
19,8,15,10,9,0,0,0,0,61
19,8,15,10,9,19,0,0,0,80
19,8,15,12,1,0,0,0,0,55
19,8,15,12,5,0,0,0,0,59
19,8,15,12,15,13,19,0,0,101
19,8,15,14,4,5,0,0,0,65
19,8,15,14,5,0,0,0,0,61
19,8,15,14,5,5,14,0,0,80
19,8,15,14,5,5,14,19,0,99
19,8,15,15,0,0,0,0,0,57
19,8,15,15,4,0,0,0,0,61
19,8,15,15,5,4,0,0,0,66
19,8,15,15,6,1,0,0,0,64
19,8,15,15,6,12,25,0,0,100
19,8,15,15,6,12,9,5,19,108
19,8,15,15,7,12,5,0,0,81
19,8,15,15,9,0,0,0,0,66
19,8,15,15,9,14,7,0,0,87
19,8,15,15,11,0,0,0,0,68
19,8,15,15,11,19,0,0,0,87
19,8,15,15,12,0,0,0,0,69
19,8,15,15,12,5,4,0,0,78
19,8,15,15,12,5,18,0,0,92
19,8,15,15,12,9,14,7,0,99
19,8,15,15,12,19,0,0,0,88
19,8,15,15,14,0,0,0,0,71
19,8,15,15,16,0,0,0,0,73
19,8,15,15,18,0,0,0,0,75
19,8,15,15,19,0,0,0,0,76
19,8,15,15,20,0,0,0,0,77
19,8,15,15,20,1,2,12,5,97
19,8,15,15,20,5,5,0,0,87
19,8,15,15,20,5,18,0,0,100
19,8,15,15,20,5,18,19,0,119
19,8,15,15,20,8,5,18,0,108
19,8,15,15,20,9,14,7,0,107
19,8,15,15,20,9,14,7,19,126
19,8,15,15,20,9,19,20,0,125
19,8,15,15,20,13,1,14,0,105
19,8,15,15,20,15,21,20,0,133
19,8,15,15,20,15,21,20,19,152
19,8,15,15,20,19,0,0,0,96
19,8,15,16,0,0,0,0,0,58
19,8,15,16,2,15,1,18,4,98
19,8,15,16,2,15,25,0,0,100
19,8,15,16,2,15,25,19,0,119
19,8,15,16,2,15,15,11,0,101
19,8,15,16,5,0,0,0,0,63
19,8,15,16,6,15,12,11,0,102
19,8,15,16,6,21,12,0,0,97
19,8,15,16,6,21,12,19,0,116
19,8,15,16,7,9,18,12,0,104
19,8,15,16,7,9,18,12,19,123
19,8,15,16,8,1,18,0,0,85
19,8,15,16,8,1,18,19,0,104
19,8,15,16,8,18,15,20,8,127
19,8,15,16,11,5,5,16,0,95
19,8,15,16,12,1,14,4,0,89
19,8,15,16,12,5,20,0,0,95
19,8,15,16,12,9,6,20,0,105
19,8,15,16,12,9,6,20,19,124
19,8,15,16,12,9,11,5,0,95
19,8,15,16,13,1,9,4,0,85
19,8,15,16,13,1,14,0,0,86
19,8,15,16,13,1,18,11,0,101
19,8,15,16,13,1,20,5,0,97
19,8,15,16,13,5,14,0,0,90
19,8,15,16,15,3,18,1,20,115
19,8,15,16,16,5,0,0,0,79
19,8,15,16,16,5,4,0,0,83
19,8,15,16,16,5,18,0,0,97
19,8,15,16,16,5,18,19,0,116
19,8,15,16,16,5,19,0,0,98
19,8,15,16,16,25,0,0,0,99
19,8,15,16,16,9,5,18,0,106
19,8,15,16,16,9,5,19,20,127
19,8,15,16,16,9,14,7,0,104
19,8,15,16,16,9,14,7,19,123
19,8,15,16,16,9,14,9,0,106
19,8,15,16,16,9,19,8,0,110
19,8,15,16,19,0,0,0,0,77
19,8,15,16,19,20,5,18,0,120
19,8,15,16,20,1,12,11,0,102
19,8,15,16,20,1,12,11,19,121
19,8,15,16,23,5,1,18,0,105
19,8,15,16,23,9,6,5,0,101
19,8,15,16,23,15,13,1,14,124
19,8,15,16,23,15,13,5,14,128
19,8,15,16,23,15,18,11,0,125
19,8,15,16,23,15,18,14,0,128
19,8,15,17,0,0,0,0,0,59
19,8,15,18,1,14,0,0,0,75
19,8,15,18,1,14,19,0,0,94
19,8,15,18,5,2,9,18,4,98
19,8,15,18,5,2,21,19,8,115
19,8,15,18,5,4,0,0,0,69
19,8,15,18,5,6,1,3,5,80
19,8,15,18,5,6,9,19,8,107
19,8,15,18,5,25,5,18,0,113
19,8,15,18,5,12,1,14,4,96
19,8,15,18,5,12,5,19,19,120
19,8,15,18,5,12,9,14,5,105
19,8,15,18,5,13,1,14,0,93
19,8,15,18,5,18,0,0,0,83
19,8,15,18,5,19,0,0,0,84
19,8,15,18,5,19,9,4,5,102
19,8,15,18,5,19,13,1,14,112
19,8,15,18,5,23,1,18,4,111
19,8,15,18,5,23,5,5,4,102
19,8,15,18,9,14,7,0,0,90
19,8,15,18,9,14,7,19,0,109
19,8,15,18,12,0,0,0,0,72
19,8,15,18,12,9,14,7,0,102
19,8,15,18,12,19,0,0,0,91
19,8,15,18,14,0,0,0,0,74
19,8,15,18,20,1,7,5,0,93
19,8,15,18,20,1,7,5,19,112
19,8,15,18,20,3,1,11,5,100
19,8,15,18,20,3,15,1,20,119
19,8,15,18,20,3,21,20,0,124
19,8,15,18,20,3,21,20,19,143
19,8,15,18,20,5,4,0,0,89
19,8,15,18,20,5,14,0,0,99
19,8,15,18,20,5,14,5,4,108
19,8,15,18,20,5,14,5,18,122
19,8,15,18,20,5,14,19,0,118
19,8,15,18,20,5,19,20,0,124
19,8,15,18,20,6,1,12,12,111
19,8,15,18,20,8,1,14,4,107
19,8,15,18,20,8,5,1,4,98
19,8,15,18,20,25,0,0,0,105
19,8,15,18,20,9,1,19,0,109
19,8,15,18,20,9,5,0,0,94
19,8,15,18,20,9,5,19,0,113
19,8,15,18,20,9,14,7,0,110
19,8,15,18,20,9,19,8,0,116
19,8,15,18,20,9,20,5,0,114
19,8,15,18,20,12,25,0,0,117
19,8,15,18,20,14,5,19,19,137
19,8,15,18,20,19,0,0,0,99
19,8,15,18,20,19,15,13,5,132
19,8,15,18,20,19,20,15,16,150
19,8,15,18,20,20,1,9,12,122
19,8,15,18,20,23,1,22,5,131
19,8,15,20,0,0,0,0,0,62
19,8,15,20,2,21,19,8,0,112
19,8,15,20,3,18,5,20,5,113
19,8,15,20,5,0,0,0,0,67
19,8,15,20,5,19,0,0,0,86
19,8,15,20,7,21,14,0,0,104
19,8,15,20,7,21,14,19,0,123
19,8,15,20,12,5,19,19,0,117
19,8,15,20,12,9,11,5,0,99
19,8,15,20,13,1,11,5,18,110
19,8,15,20,13,1,14,0,0,90
19,8,15,20,16,18,15,15,6,132
19,8,15,20,19,0,0,0,0,81
19,8,15,20,19,8,5,12,12,118
19,8,15,20,19,13,1,14,0,109
19,8,15,20,19,20,1,18,0,120
19,8,15,20,20,0,0,0,0,82
19,8,15,20,20,5,4,0,0,91
19,8,15,20,20,5,14,0,0,101
19,8,15,20,20,5,18,0,0,105
19,8,15,20,20,25,0,0,0,107
19,8,15,20,20,9,14,7,0,112
19,8,15,20,20,19,0,0,0,101
19,8,15,21,0,0,0,0,0,63
19,8,15,21,7,8,0,0,0,78
19,8,15,21,12,4,0,0,0,79
19,8,15,21,12,4,5,18,0,102
19,8,15,21,12,4,5,18,19,121
19,8,15,21,12,4,5,19,20,123
19,8,15,21,12,4,14,0,0,93
19,8,15,21,12,4,14,1,0,94
19,8,15,21,12,4,14,20,0,113
19,8,15,21,12,4,19,20,0,118
19,8,15,21,12,5,18,4,0,102
19,8,15,21,19,5,0,0,0,87
19,8,15,21,20,0,0,0,0,83
19,8,15,21,20,5,4,0,0,92
19,8,15,21,20,5,18,0,0,106
19,8,15,21,20,5,18,19,0,125
19,8,15,21,20,8,5,18,0,114
19,8,15,21,20,9,14,7,0,113
19,8,15,21,20,19,0,0,0,102
19,8,15,22,1,12,0,0,0,77
19,8,15,22,5,0,0,0,0,69
19,8,15,22,5,4,0,0,0,73
19,8,15,22,5,12,0,0,0,81
19,8,15,22,5,12,1,18,4,104
19,8,15,22,5,12,5,4,0,90
19,8,15,22,5,12,5,18,0,104
19,8,15,22,5,12,5,18,19,123
19,8,15,22,5,12,6,21,12,120
19,8,15,22,5,12,9,14,7,111
19,8,15,22,5,12,12,5,4,102
19,8,15,22,5,12,12,5,18,116
19,8,15,22,5,12,13,1,14,109
19,8,15,22,5,12,19,0,0,100
19,8,15,22,5,18,0,0,0,87
19,8,15,22,5,18,19,0,0,106
19,8,15,22,5,19,0,0,0,88
19,8,15,22,9,14,7,0,0,94
19,8,15,23,0,0,0,0,0,65
19,8,15,23,1,2,12,5,0,85
19,8,15,23,1,14,3,5,0,88
19,8,15,23,2,9,18,4,0,98
19,8,15,23,2,15,1,18,4,105
19,8,15,23,2,15,1,20,0,103
19,8,15,23,2,15,1,20,19,122
19,8,15,23,2,18,5,1,4,95
19,8,15,23,3,1,19,5,0,93
19,8,15,23,3,1,19,5,4,97
19,8,15,23,3,1,19,5,19,112
19,8,15,23,4,0,0,0,0,69
19,8,15,23,4,15,13,0,0,97
19,8,15,23,4,15,23,14,0,121
19,8,15,23,4,15,23,14,19,140
19,8,15,23,5,4,0,0,0,74
19,8,15,23,5,18,0,0,0,88
19,8,15,23,5,18,5,4,0,97
19,8,15,23,5,18,5,18,0,111
19,8,15,23,5,18,6,21,12,127
19,8,15,23,5,18,25,0,0,113
19,8,15,23,5,18,9,5,18,120
19,8,15,23,5,18,9,14,7,118
19,8,15,23,6,15,12,11,0,109
19,8,15,23,6,21,12,0,0,104
19,8,15,23,7,9,18,12,0,111
19,8,15,23,7,9,18,12,19,130
19,8,15,23,25,0,0,0,0,90
19,8,15,23,25,1,18,4,0,113
19,8,15,23,9,5,18,0,0,97
19,8,15,23,9,5,19,20,0,118
19,8,15,23,9,12,25,0,0,111
19,8,15,23,9,14,5,19,19,131
19,8,15,23,9,14,7,0,0,95
19,8,15,23,9,14,7,19,0,114
19,8,15,23,9,19,8,0,0,101
19,8,15,23,12,5,19,19,0,120
19,8,15,23,13,1,14,0,0,93
19,8,15,23,13,1,14,12,25,130
19,8,15,23,13,1,14,18,25,136
19,8,15,23,13,5,14,0,0,97
19,8,15,23,14,0,0,0,0,79
19,8,15,23,15,6,6,0,0,92
19,8,15,23,15,6,6,19,0,111
19,8,15,23,16,9,5,3,5,103
19,8,15,23,16,12,1,3,5,102
19,8,15,23,18,15,15,13,0,126
19,8,15,23,18,15,15,13,19,145
19,8,15,23,19,0,0,0,0,84
19,8,15,23,19,8,15,16,0,123
19,8,15,23,21,16,0,0,0,102
19,8,16,0,0,0,0,0,0,43
19,8,16,20,0,0,0,0,0,63
19,8,18,0,0,0,0,0,0,45
19,8,18,1,2,0,0,0,0,48
19,8,18,1,4,4,0,0,0,54
19,8,18,1,4,4,8,1,0,63
19,8,18,1,4,8,0,0,0,58
19,8,18,1,6,0,0,0,0,52
19,8,18,1,7,0,0,0,0,53
19,8,18,1,13,0,0,0,0,59
19,8,18,1,13,5,0,0,0,64
19,8,18,1,13,13,5,4,0,81
19,8,18,1,14,11,0,0,0,71
19,8,18,1,16,0,0,0,0,62
19,8,18,1,16,5,0,0,0,67
19,8,18,1,16,14,5,12,0,93
19,8,18,1,22,5,0,0,0,73
19,8,18,1,22,5,25,0,0,98
19,8,18,5,1,4,9,14,7,85
19,8,18,5,4,0,0,0,0,54
19,8,18,5,4,3,15,3,11,86
19,8,18,5,4,4,5,4,0,67
19,8,18,5,4,4,5,18,0,81
19,8,18,5,4,4,5,18,19,100
19,8,18,5,4,4,25,0,0,83
19,8,18,5,4,4,9,14,7,88
19,8,18,5,4,12,5,19,19,109
19,8,18,5,4,12,9,11,5,91
19,8,18,5,4,19,0,0,0,73
19,8,18,5,5,22,5,0,0,82
19,8,18,5,14,4,0,0,0,68
19,8,18,5,23,0,0,0,0,73
19,8,18,5,23,4,0,0,0,77
19,8,18,5,23,4,5,18,0,100
19,8,18,5,23,4,5,19,20,121
19,8,18,5,23,4,25,0,0,102
19,8,18,5,23,4,9,5,0,91
19,8,18,5,23,4,9,19,8,113
19,8,18,5,23,4,12,25,0,114
19,8,18,5,23,4,15,13,0,105
19,8,18,5,23,5,4,0,0,82
19,8,18,5,23,9,14,7,0,103
19,8,18,5,23,9,19,8,0,109
19,8,18,5,23,12,25,0,0,110
19,8,18,5,23,12,9,11,5,110
19,8,18,5,23,19,0,0,0,92
19,8,18,9,0,0,0,0,0,54
19,8,18,9,4,5,0,0,0,63
19,8,18,9,5,11,0,0,0,70
19,8,18,9,5,11,5,4,0,79
19,8,18,9,5,11,5,18,0,93
19,8,18,9,5,11,5,18,25,118
19,8,18,9,5,11,5,18,19,112
19,8,18,9,5,11,25,0,0,95
19,8,18,9,5,11,9,5,18,102
19,8,18,9,5,11,9,12,25,116
19,8,18,9,5,11,9,14,7,100
19,8,18,9,5,11,19,0,0,89
19,8,18,9,5,22,1,12,0,94
19,8,18,9,5,22,5,0,0,86
19,8,18,9,5,22,5,4,0,90
19,8,18,9,5,22,5,19,0,105
19,8,18,9,5,22,9,14,7,111
19,8,18,9,6,20,0,0,0,80
19,8,18,9,6,20,19,0,0,99
19,8,18,9,11,5,0,0,0,70
19,8,18,9,11,5,19,0,0,89
19,8,18,9,12,12,0,0,0,78
19,8,18,9,12,12,5,4,0,87
19,8,18,9,12,12,5,18,0,101
19,8,18,9,12,12,5,19,20,122
19,8,18,9,12,12,25,0,0,103
19,8,18,9,12,12,9,14,7,108
19,8,18,9,12,12,9,19,8,114
19,8,18,9,12,12,19,0,0,97
19,8,18,9,13,16,0,0,0,83
19,8,18,9,13,16,5,4,0,92
19,8,18,9,13,16,5,18,0,106
19,8,18,9,13,16,5,18,19,125
19,8,18,9,13,16,9,0,0,92
19,8,18,9,13,16,25,0,0,108
19,8,18,9,13,16,9,5,18,115
19,8,18,9,13,16,9,14,7,113
19,8,18,9,13,16,9,19,8,119
19,8,18,9,13,16,19,0,0,102
19,8,18,9,13,16,20,15,14,132
19,8,18,9,14,1,12,0,0,81
19,8,18,9,14,5,4,0,0,77
19,8,18,9,14,5,12,5,20,110
19,8,18,9,14,5,19,0,0,92
19,8,18,9,14,9,14,7,0,98
19,8,18,9,14,11,0,0,0,79
19,8,18,9,14,11,1,7,5,92
19,8,18,9,14,11,5,18,0,102
19,8,18,9,14,11,5,18,7,109
19,8,18,9,14,11,5,18,19,121
19,8,18,9,14,11,25,0,0,104
19,8,18,9,14,11,9,14,7,109
19,8,18,9,14,11,19,0,0,98
19,8,18,9,16,0,0,0,0,70
19,8,18,9,19,0,0,0,0,73
19,8,18,9,20,5,0,0,0,79
19,8,18,9,22,5,0,0,0,81
19,8,18,9,22,5,4,0,0,85
19,8,18,9,22,5,12,0,0,93
19,8,18,9,22,5,12,5,4,102
19,8,18,9,22,5,12,19,0,112
19,8,18,9,22,5,14,0,0,95
19,8,18,9,22,5,18,19,0,118
19,8,18,9,22,5,19,0,0,100
19,8,18,9,22,9,14,7,0,106
19,8,18,15,6,6,0,0,0,72
19,8,18,15,6,6,5,4,0,81
19,8,18,15,6,6,9,14,7,102
19,8,18,15,6,6,19,0,0,91
19,8,18,15,7,0,0,0,0,67
19,8,18,15,7,19,0,0,0,86
19,8,18,15,21,4,0,0,0,85
19,8,18,15,21,4,5,4,0,94
19,8,18,15,21,4,25,0,0,110
19,8,18,15,21,4,9,14,7,115
19,8,18,15,21,4,19,0,0,104
19,8,18,15,22,5,4,0,0,91
19,8,18,15,22,5,18,0,0,105
19,8,18,15,22,25,0,0,0,107
19,8,18,15,22,9,14,7,0,112
19,8,18,18,9,14,11,14,7,118
19,8,18,21,2,0,0,0,0,68
19,8,18,21,2,2,5,4,0,79
19,8,18,21,2,2,5,18,25,118
19,8,18,21,2,2,25,0,0,95
19,8,18,21,2,2,9,5,18,102
19,8,18,21,2,2,9,19,8,106
19,8,18,21,2,12,1,14,4,99
19,8,18,21,2,12,5,19,19,123
19,8,18,21,2,12,5,20,0,105
19,8,18,21,2,12,9,11,5,105
19,8,18,21,2,19,0,0,0,87
19,8,18,21,2,23,15,15,4,125
19,8,18,21,6,6,0,0,0,78
19,8,18,21,7,0,0,0,0,73
19,8,18,21,7,7,5,4,0,89
19,8,18,21,7,7,9,14,7,110
19,8,18,21,7,19,0,0,0,92
19,8,18,21,14,11,0,0,0,91
19,8,18,21,14,11,5,14,0,110
19,8,18,21,16,19,0,0,0,101
19,8,18,21,20,9,0,0,0,95
19,8,20,0,0,0,0,0,0,47
19,8,20,3,8,5,5,0,0,68
19,8,20,5,20,5,12,0,0,89
19,8,20,5,20,5,12,19,0,108
19,8,20,5,20,12,0,0,0,84
19,8,20,5,20,12,1,3,8,96
19,8,20,5,20,12,19,0,0,103
19,8,20,7,0,0,0,0,0,54
19,8,20,9,3,11,0,0,0,70
19,8,20,9,3,11,19,0,0,89
19,8,20,9,11,0,0,0,0,67
19,8,20,9,11,19,0,0,0,86
19,8,20,18,5,9,13,5,12,109
19,8,21,2,1,0,0,0,0,51
19,8,21,2,21,14,11,9,14,119
19,8,21,3,11,0,0,0,0,62
19,8,21,3,11,5,4,0,0,71
19,8,21,3,11,5,18,0,0,85
19,8,21,3,11,5,18,19,0,104
19,8,21,3,11,9,14,7,0,92
19,8,21,3,11,9,14,7,19,111
19,8,21,3,11,9,14,19,0,104
19,8,21,3,11,16,5,14,0,97
19,8,21,3,11,19,0,0,0,81
19,8,21,4,4,5,18,0,0,79
19,8,21,4,4,5,18,5,4,88
19,8,21,4,4,5,18,25,0,104
19,8,21,4,4,5,18,19,0,98
19,8,21,4,14,1,0,0,0,67
19,8,21,6,6,0,0,0,0,60
19,8,21,6,6,12,5,0,0,77
19,8,21,6,6,12,5,4,0,81
19,8,21,6,6,12,5,18,0,95
19,8,21,6,6,12,5,18,19,114
19,8,21,6,6,12,5,19,0,96
19,8,21,6,6,12,9,14,7,102
19,8,21,6,20,25,0,0,0,99
19,8,21,7,0,0,0,0,0,55
19,8,21,7,7,25,0,0,0,87
19,8,21,12,0,0,0,0,0,60
19,8,21,12,14,0,0,0,0,74
19,8,21,12,19,0,0,0,0,79
19,8,21,12,23,1,18,0,0,102
19,8,21,12,23,1,21,18,19,142
19,8,21,13,1,3,0,0,0,65
19,8,21,13,1,12,0,0,0,74
19,8,21,14,0,0,0,0,0,62
19,8,21,14,5,0,0,0,0,67
19,8,21,14,12,5,19,19,0,117
19,8,21,14,14,1,2,12,5,96
19,8,21,14,14,5,4,0,0,85
19,8,21,14,14,5,18,0,0,99
19,8,21,14,14,5,18,19,0,118
19,8,21,14,14,9,14,7,0,106
19,8,21,14,16,9,11,5,0,103
19,8,21,14,16,9,11,5,4,107
19,8,21,14,16,9,11,5,18,121
19,8,21,14,16,9,11,5,19,122
19,8,21,14,19,0,0,0,0,81
19,8,21,14,20,0,0,0,0,82
19,8,21,14,20,5,4,0,0,91
19,8,21,14,20,5,18,0,0,105
19,8,21,14,20,5,18,19,0,124
19,8,21,14,20,9,14,7,0,112
19,8,21,14,20,19,0,0,0,101
19,8,21,18,5,0,0,0,0,71
19,8,21,18,6,0,0,0,0,72
19,8,21,18,7,5,5,0,0,83
19,8,21,19,8,0,0,0,0,75
19,8,21,19,8,5,4,0,0,84
19,8,21,19,8,5,18,0,0,98
19,8,21,19,8,5,19,0,0,99
19,8,21,19,8,9,14,7,0,105
19,8,21,20,0,0,0,0,0,68
19,8,21,20,4,15,23,14,0,124
19,8,21,20,4,15,23,14,19,143
19,8,21,20,5,4,0,0,0,77
19,8,21,20,5,25,5,0,0,103
19,8,21,20,5,25,5,19,0,122
19,8,21,20,5,19,0,0,0,92
19,8,21,20,9,14,7,0,0,98
19,8,21,20,14,5,19,19,0,125
19,8,21,20,15,6,6,0,0,95
19,8,21,20,15,6,6,19,0,114
19,8,21,20,15,11,21,0,0,115
19,8,21,20,15,21,20,0,0,124
19,8,21,20,15,21,20,19,0,143
19,8,21,20,19,0,0,0,0,87
19,8,21,20,20,1,14,3,5,111
19,8,21,20,20,5,14,0,0,107
19,8,21,20,20,5,18,0,0,111
19,8,21,20,20,5,18,5,4,120
19,8,21,20,20,5,18,19,0,130
19,8,21,20,20,9,14,7,0,118
19,8,21,20,20,12,5,0,0,105
19,8,21,20,20,12,5,4,0,109
19,8,21,20,20,12,5,18,0,123
19,8,21,20,20,12,5,19,0,124
19,8,21,20,20,12,9,14,7,130
19,8,21,22,18,1,0,0,0,89
19,8,23,1,0,0,0,0,0,51
19,8,23,1,14,16,1,14,0,96
19,8,23,1,14,16,1,14,19,115
19,8,23,5,2,15,0,0,0,72
19,25,2,1,18,9,19,13,0,106
19,25,2,1,18,9,19,20,0,113
19,25,2,1,18,9,20,5,19,118
19,9,2,2,0,0,0,0,0,32
19,9,2,2,5,4,0,0,0,41
19,9,2,2,5,14,4,25,0,80
19,9,2,2,5,14,19,0,0,70
19,9,2,2,5,18,0,0,0,55
19,9,2,2,9,14,7,0,0,62
19,9,2,2,15,12,5,20,8,92
19,9,2,2,19,0,0,0,0,51
19,9,2,5,18,9,1,14,19,96
19,9,2,5,18,9,20,5,0,87
19,9,2,9,12,1,14,3,5,74
19,9,2,9,12,1,14,3,25,94
19,9,2,9,12,1,14,20,0,86
19,9,2,9,12,1,14,20,19,105
19,9,2,9,12,1,20,5,0,77
19,9,2,9,12,1,20,5,4,81
19,9,2,9,12,1,20,5,19,96
19,9,2,9,12,1,20,15,18,105
19,9,2,25,12,9,3,0,0,79
19,9,2,25,12,9,19,13,0,108
19,9,2,25,12,12,1,5,0,85
19,9,2,25,12,12,9,3,0,91
19,9,2,25,12,12,9,14,5,107
19,9,2,25,12,12,9,19,13,120
19,9,2,25,12,12,9,19,20,127
19,9,2,9,12,15,21,19,0,106
19,9,2,9,12,21,19,0,0,91
19,9,2,12,9,14,7,0,0,72
19,9,2,12,9,14,7,19,0,91
19,9,2,14,5,19,19,0,0,87
19,25,2,15,0,0,0,0,0,61
19,25,2,15,5,19,0,0,0,85
19,25,2,15,20,9,3,0,0,93
19,25,2,15,20,9,19,13,0,122
19,25,2,15,23,0,0,0,0,84
19,9,2,18,5,4,5,0,0,62
19,9,2,19,0,0,0,0,0,49
19,9,2,19,8,9,16,0,0,82
19,9,2,19,8,9,16,19,0,101
19,9,2,21,3,1,15,0,0,70
19,25,3,1,13,9,14,5,0,89
19,25,3,1,13,9,14,5,19,108
19,25,3,1,13,15,18,5,19,118
19,9,3,1,18,9,1,14,0,74
19,9,3,1,18,9,9,0,0,68
19,9,3,1,18,9,15,21,19,114
19,9,3,1,18,9,21,19,0,99
19,9,3,3,0,0,0,0,0,34
19,9,3,3,1,0,0,0,0,35
19,9,3,3,1,14,0,0,0,49
19,9,3,3,1,14,20,0,0,69
19,9,3,3,1,18,0,0,0,53
19,9,3,3,1,20,5,0,0,60
19,9,3,3,1,20,5,4,0,64
19,9,3,3,1,20,9,14,7,85
19,9,3,3,1,20,9,15,14,93
19,9,3,3,1,20,9,22,5,91
19,9,3,3,5,4,0,0,0,43
19,9,3,3,9,14,7,0,0,64
19,9,3,3,9,20,25,0,0,88
19,9,3,5,0,0,0,0,0,36
19,25,3,5,0,0,0,0,0,52
19,25,3,5,5,0,0,0,0,57
19,25,3,5,5,19,0,0,0,76
19,9,3,5,18,0,0,0,0,54
19,25,3,5,19,0,0,0,0,71
19,9,3,8,0,0,0,0,0,39
19,25,3,8,5,5,0,0,0,65
19,9,3,8,20,0,0,0,0,59
19,9,3,9,12,9,1,14,1,77
19,9,3,9,12,9,1,14,15,91
19,9,3,9,12,9,1,14,19,95
19,9,3,9,12,9,3,1,0,65
19,9,3,9,12,9,3,21,13,98
19,9,3,9,14,14,9,1,14,92
19,25,3,9,20,5,0,0,0,81
19,9,3,11,0,0,0,0,0,42
19,9,3,11,2,1,25,0,0,70
19,9,3,11,2,1,25,19,0,89
19,9,3,11,2,5,4,0,0,53
19,9,3,11,2,5,4,19,0,72
19,9,3,11,5,4,0,0,0,51
19,9,3,11,5,5,0,0,0,52
19,9,3,11,5,5,19,0,0,71
19,9,3,11,5,14,0,0,0,61
19,9,3,11,5,14,5,4,0,70
19,9,3,11,5,14,5,18,0,84
19,9,3,11,5,14,5,18,19,103
19,9,3,11,5,14,9,14,7,91
19,9,3,11,5,14,19,0,0,80
19,9,3,11,5,18,0,0,0,65
19,9,3,11,5,18,12,25,0,102
19,9,3,11,5,19,20,0,0,86
19,9,3,11,5,20,0,0,0,67
19,9,3,11,9,5,0,0,0,56
19,9,3,11,9,5,19,0,0,75
19,9,3,11,9,14,7,0,0,72
19,9,3,11,9,19,8,0,0,78
19,9,3,11,9,19,8,12,25,115
19,9,3,11,12,5,0,0,0,59
19,9,3,11,12,5,4,0,0,63
19,9,3,11,12,5,13,1,14,87
19,9,3,11,12,5,13,5,14,91
19,9,3,11,12,5,13,9,1,82
19,9,3,11,12,5,13,9,3,84
19,9,3,11,12,5,16,15,4,94
19,9,3,11,12,5,18,0,0,77
19,9,3,11,12,5,19,0,0,78
19,9,3,11,12,5,19,19,0,97
19,9,3,11,12,25,0,0,0,79
19,9,3,11,12,9,5,4,0,72
19,9,3,11,12,9,5,18,0,86
19,9,3,11,12,9,5,19,0,87
19,9,3,11,12,9,5,19,20,107
19,9,3,11,12,25,9,14,7,109
19,9,3,11,12,9,12,25,0,100
19,9,3,11,12,9,14,7,0,84
19,9,3,11,14,5,19,19,0,99
19,9,3,11,15,0,0,0,0,57
19,9,3,11,15,19,0,0,0,76
19,9,3,11,15,21,20,0,0,98
19,9,3,11,15,21,20,19,0,117
19,9,3,11,18,15,15,13,0,103
19,9,3,11,18,15,15,13,19,122
19,9,3,11,19,0,0,0,0,61
19,9,3,12,5,0,0,0,0,48
19,9,3,12,9,11,5,0,0,68
19,25,3,15,3,5,18,9,3,100
19,25,3,15,3,11,0,0,0,76
19,25,3,15,13,1,0,0,0,76
19,25,3,15,13,1,14,3,25,118
19,25,3,15,13,15,18,5,0,113
19,25,3,15,13,15,18,5,19,132
19,25,3,15,14,1,20,5,0,102
19,25,3,15,14,9,1,0,0,86
19,25,3,15,14,9,4,0,0,89
19,25,3,15,14,9,21,13,0,119
19,25,3,15,14,15,9,4,0,104
19,25,3,15,14,21,19,0,0,116
19,25,3,15,16,8,1,14,20,121
19,25,3,15,19,5,19,0,0,105
19,25,3,15,19,9,19,0,0,109
19,9,3,19,0,0,0,0,0,50
19,9,3,19,1,3,0,0,0,54
19,9,3,21,12,1,0,0,0,65
19,9,4,4,5,18,0,0,0,59
19,25,4,4,9,18,0,0,0,79
19,9,4,4,15,23,0,0,0,74
19,9,4,4,21,18,0,0,0,75
19,9,4,4,21,18,9,13,0,97
19,9,4,4,21,18,19,0,0,94
19,9,4,5,0,0,0,0,0,37
19,9,4,5,1,7,5,0,0,50
19,9,4,5,1,18,13,0,0,69
19,9,4,5,1,18,13,19,0,88
19,9,4,5,2,1,14,4,0,58
19,9,4,5,2,1,14,4,19,77
19,9,4,5,2,1,18,0,0,58
19,9,4,5,2,1,18,19,0,77
19,9,4,5,2,15,1,18,4,77
19,9,4,5,2,15,14,5,0,73
19,9,4,5,2,15,14,5,19,92
19,9,4,5,2,15,24,0,0,78
19,9,4,5,2,21,18,14,0,92
19,9,4,5,2,21,18,14,19,111
19,9,4,5,3,1,18,0,0,59
19,9,4,5,3,1,18,19,0,78
19,9,4,5,3,8,1,9,18,76
19,9,4,5,3,8,5,3,11,67
19,9,4,5,4,0,0,0,0,41
19,9,4,5,4,14,5,19,19,98
19,9,4,5,4,18,5,19,19,102
19,9,4,5,6,12,1,19,8,83
19,9,4,5,8,5,1,4,0,55
19,9,4,5,8,9,12,12,0,78
19,9,4,5,8,9,12,12,19,97
19,9,4,5,8,15,12,4,0,76
19,9,4,5,11,9,3,11,0,71
19,9,4,5,11,9,3,11,19,90
19,9,4,5,12,1,14,7,0,71
19,9,4,5,12,5,19,19,0,92
19,9,4,5,12,9,7,8,20,93
19,9,4,5,12,9,14,5,0,77
19,9,4,5,12,9,14,5,4,81
19,9,4,5,12,9,14,5,18,95
19,9,4,5,12,9,14,5,19,96
19,9,4,5,12,9,14,7,0,79
19,9,4,5,12,9,14,7,19,98
19,9,4,5,12,9,14,19,0,91
19,9,4,5,12,15,3,11,0,78
19,9,4,5,12,15,14,7,0,85
19,9,4,5,13,1,14,0,0,65
19,9,4,5,13,5,14,0,0,69
19,9,4,5,14,5,19,19,0,94
19,9,4,5,14,15,20,5,0,91
19,9,4,5,16,9,5,3,5,75
19,9,4,5,18,0,0,0,0,55
19,9,4,5,18,1,12,0,0,68
19,9,4,5,18,1,20,5,0,81
19,9,4,5,18,1,20,5,4,85
19,9,4,5,18,5,1,12,0,73
19,9,4,5,18,5,1,14,0,75
19,9,4,5,18,9,14,0,0,78
19,9,4,5,18,9,19,13,0,96
19,9,4,5,18,9,20,5,0,89
19,9,4,5,18,9,20,5,19,108
19,9,4,5,18,9,20,9,3,96
19,9,4,5,18,15,13,1,0,84
19,9,4,5,18,15,14,25,13,122
19,9,4,5,18,15,19,5,0,94
19,9,4,5,18,15,19,9,19,117
19,9,4,5,18,15,20,9,3,102
19,9,4,5,18,15,21,19,0,110
19,9,4,5,18,19,8,9,16,107
19,9,4,5,18,21,18,7,25,126
19,9,4,5,19,0,0,0,0,56
19,9,4,5,19,8,1,11,5,81
19,9,4,5,19,8,15,23,0,102
19,9,4,5,19,8,15,23,19,121
19,9,4,5,19,12,9,16,0,93
19,9,4,5,19,12,9,16,19,112
19,9,4,5,19,13,1,14,0,84
19,9,4,5,19,13,5,14,0,88
19,9,4,5,19,16,9,14,0,95
19,9,4,5,19,16,9,14,19,114
19,9,4,5,19,20,0,0,0,76
19,9,4,5,19,20,5,16,0,97
19,9,4,5,19,20,5,16,19,116
19,9,4,5,19,20,9,3,11,99
19,9,4,5,19,23,1,25,0,105
19,9,4,5,19,23,9,16,5,109
19,9,4,5,20,18,1,3,11,90
19,9,4,5,23,1,25,0,0,86
19,9,4,5,23,1,25,19,0,105
19,9,4,5,23,1,12,11,0,84
19,9,4,5,23,1,12,11,19,103
19,9,4,5,23,1,12,12,0,85
19,9,4,5,23,1,12,12,19,104
19,9,4,5,23,1,18,4,0,83
19,9,4,5,23,1,18,4,19,102
19,9,4,5,23,1,19,8,0,88
19,9,4,5,23,8,5,5,12,90
19,9,4,5,23,9,16,5,0,90
19,9,4,5,23,9,16,5,18,108
19,9,4,5,23,9,19,5,0,93
19,9,4,8,5,0,0,0,0,45
19,9,4,9,0,0,0,0,0,41
19,9,4,25,0,0,0,0,0,57
19,9,4,9,1,0,0,0,0,42
19,9,4,9,14,7,0,0,0,62
19,9,4,9,14,7,19,0,0,81
19,9,4,9,15,14,0,0,0,70
19,9,4,12,5,0,0,0,0,49
19,9,4,12,5,4,0,0,0,53
19,9,4,12,5,18,0,0,0,67
19,9,4,12,5,18,19,0,0,86
19,9,4,12,5,19,0,0,0,68
19,9,4,12,9,14,7,0,0,74
19,9,4,12,9,14,7,12,25,111
19,9,4,12,9,14,19,0,0,86
19,9,4,20,8,0,0,0,0,60
19,9,5,0,0,0,0,0,0,33
19,25,5,0,0,0,0,0,0,49
19,9,5,3,12,5,0,0,0,53
19,9,5,3,12,5,19,0,0,72
19,25,5,4,0,0,0,0,0,53
19,9,5,7,5,0,0,0,0,45
19,9,5,7,5,1,2,12,5,65
19,9,5,7,5,4,0,0,0,49
19,9,5,7,5,14,9,20,5,93
19,9,5,7,5,18,0,0,0,63
19,9,5,7,5,19,0,0,0,64
19,9,5,7,5,23,15,18,11,112
19,9,5,7,9,14,7,0,0,70
19,9,5,7,21,18,4,0,0,83
19,9,5,14,9,20,5,0,0,81
19,25,5,14,9,20,5,0,0,97
19,9,5,14,9,20,5,19,0,100
19,25,5,14,9,20,5,19,0,116
19,9,5,14,9,20,9,3,0,88
19,25,5,14,9,20,9,3,0,104
19,9,5,14,14,1,0,0,0,62
19,9,5,14,14,1,19,0,0,81
19,9,5,18,0,0,0,0,0,51
19,9,5,18,9,14,7,0,0,81
19,9,5,18,15,26,5,13,0,110
19,9,5,18,15,26,5,13,19,129
19,9,5,18,18,1,14,0,0,84
19,9,5,18,18,1,19,0,0,89
19,9,5,19,20,0,0,0,0,72
19,9,5,19,20,1,0,0,0,73
19,9,5,19,20,1,19,0,0,92
19,9,5,21,18,19,0,0,0,91
19,9,5,22,5,0,0,0,0,60
19,9,5,22,5,4,0,0,0,64
19,9,5,22,5,6,21,12,0,99
19,9,5,22,5,12,9,11,5,97
19,9,5,22,5,18,0,0,0,78
19,9,5,22,5,19,0,0,0,79
19,9,5,22,25,0,0,0,0,80
19,9,5,22,9,14,7,0,0,85
19,9,5,22,9,14,7,19,0,104
19,9,6,1,3,0,0,0,0,38
19,9,6,1,11,1,0,0,0,47
19,9,6,1,11,1,19,0,0,66
19,9,6,5,0,0,0,0,0,39
19,9,6,6,9,12,1,20,5,87
19,9,6,6,12,5,0,0,0,57
19,9,6,6,12,5,20,0,0,77
19,9,6,6,12,5,21,18,0,96
19,9,6,6,12,5,21,18,19,115
19,9,6,6,12,5,21,19,5,102
19,9,6,6,12,15,20,0,0,87
19,9,6,20,0,0,0,0,0,54
19,9,6,20,1,7,5,0,0,67
19,9,6,20,5,4,0,0,0,63
19,9,6,20,5,18,0,0,0,77
19,9,6,20,5,18,19,0,0,96
19,9,6,20,9,14,7,0,0,84
19,9,6,20,9,14,7,19,0,103
19,25,6,20,14,0,0,0,0,84
19,9,6,20,19,0,0,0,0,73
19,9,7,1,14,9,4,0,0,63
19,9,7,1,14,9,4,19,0,82
19,9,7,1,20,15,11,1,0,83
19,9,7,6,9,12,5,0,0,67
19,9,7,6,9,12,5,19,0,86
19,9,7,7,5,18,0,0,0,65
19,9,7,8,0,0,0,0,0,43
19,9,7,8,5,4,0,0,0,52
19,9,7,8,5,18,0,0,0,66
19,9,7,8,5,18,19,0,0,85
19,9,7,8,6,21,12,0,0,82
19,9,7,8,6,21,12,12,25,119
19,9,7,8,9,14,7,0,0,73
19,9,7,8,9,14,7,12,25,110
19,9,7,8,12,5,19,19,0,98
19,9,7,8,12,9,11,5,0,80
19,9,7,8,19,0,0,0,0,62
19,9,7,8,20,0,0,0,0,63
19,9,7,8,20,1,2,12,5,83
19,9,7,8,20,5,4,0,0,72
19,9,7,8,20,5,14,0,0,82
19,9,7,8,20,5,18,0,0,86
19,9,7,8,20,5,18,19,0,105
19,9,7,8,20,6,21,12,0,102
19,9,7,8,20,8,15,12,5,103
19,9,7,8,20,25,0,0,0,88
19,9,7,8,20,9,14,7,0,93
19,9,7,8,20,9,14,7,19,112
19,9,7,8,20,12,5,19,19,118
19,9,7,8,20,12,25,0,0,100
19,9,7,8,20,12,9,5,18,107
19,9,7,8,20,12,9,12,25,121
19,9,7,8,20,19,0,0,0,82
19,9,7,8,20,19,1,23,0,106
19,9,7,8,20,19,5,5,0,92
19,9,7,8,20,19,5,5,14,106
19,9,7,8,20,19,5,5,18,110
19,9,7,8,20,19,5,5,19,111
19,9,7,8,20,19,13,1,14,110
19,9,7,9,12,0,0,0,0,56
19,9,7,9,12,12,0,0,0,68
19,9,7,9,12,12,1,18,25,112
19,9,7,9,12,12,1,20,5,94
19,9,7,9,12,12,21,13,0,102
19,9,7,9,12,19,0,0,0,75
19,9,7,12,1,0,0,0,0,48
19,9,7,12,1,18,9,1,14,90
19,9,7,12,15,9,0,0,0,71
19,9,7,12,15,19,0,0,0,81
19,9,7,12,21,13,0,0,0,81
19,9,7,13,1,19,0,0,0,68
19,9,7,13,1,20,5,0,0,74
19,9,7,13,1,20,9,3,0,81
19,9,7,13,1,20,9,15,14,107
19,9,7,13,1,20,9,19,13,110
19,9,7,13,15,4,15,14,20,116
19,9,7,13,15,9,4,0,0,76
19,9,7,13,15,9,4,1,12,89
19,9,7,13,15,9,4,19,0,95
19,9,7,14,0,0,0,0,0,49
19,9,7,14,1,0,0,0,0,50
19,9,7,14,1,2,12,5,0,69
19,9,7,14,1,3,12,5,0,70
19,9,7,14,1,7,5,0,0,62
19,9,7,14,1,7,5,19,0,81
19,9,7,14,1,12,0,0,0,62
19,9,7,14,1,12,5,4,0,71
19,9,7,14,1,12,5,5,0,72
19,9,7,14,1,12,5,18,0,85
19,9,7,14,1,12,5,18,19,104
19,9,7,14,1,12,5,19,5,91
19,9,7,14,1,12,9,14,7,92
19,9,7,14,1,12,9,19,5,95
19,9,7,14,1,12,9,19,13,103
19,9,7,14,1,12,9,19,20,110
19,9,7,14,1,12,9,20,25,116
19,9,7,14,1,12,9,26,5,102
19,9,7,14,1,12,12,5,4,83
19,9,7,14,1,12,12,5,18,97
19,9,7,14,1,12,12,25,0,99
19,9,7,14,1,12,13,1,14,90
19,9,7,14,1,12,13,5,14,94
19,9,7,14,1,12,19,0,0,81
19,9,7,14,1,14,3,5,0,72
19,9,7,14,1,18,25,0,0,93
19,9,7,14,1,20,1,18,25,114
19,9,7,14,1,20,5,0,0,75
19,9,7,14,1,20,9,15,14,108
19,9,7,14,1,20,15,18,0,103
19,9,7,14,1,20,15,18,25,128
19,9,7,14,1,20,21,18,5,114
19,9,7,14,2,15,1,18,4,89
19,9,7,14,5,4,0,0,0,58
19,9,7,14,5,5,0,0,0,59
19,9,7,14,5,5,19,0,0,78
19,9,7,14,5,18,0,0,0,72
19,9,7,14,5,18,19,0,0,91
19,9,7,14,5,20,0,0,0,74
19,9,7,14,5,20,5,4,0,83
19,9,7,14,5,20,9,14,7,104
19,9,7,14,5,20,19,0,0,93
19,9,7,14,5,20,21,18,0,113
19,9,7,14,5,21,18,0,0,93
19,9,7,14,5,21,18,25,0,118
19,9,7,14,9,6,5,18,0,87
19,9,7,14,9,6,25,0,0,89
19,9,7,14,9,6,9,3,0,76
19,9,7,14,9,6,9,3,19,95
19,9,7,14,9,6,9,5,0,78
19,9,7,14,9,6,9,5,4,82
19,9,7,14,9,6,9,5,18,96
19,9,7,14,9,6,9,5,19,97
19,9,7,14,9,14,7,0,0,79
19,9,7,14,9,15,18,0,0,91
19,9,7,14,9,15,18,9,0,100
19,9,7,14,9,15,18,25,0,116
19,9,7,14,9,15,18,19,0,110
19,9,7,14,9,19,20,0,0,97
19,9,7,14,9,20,15,18,0,111
19,9,7,14,12,5,19,19,0,104
19,9,7,14,12,9,11,5,0,86
19,9,7,14,13,1,14,0,0,77
19,9,7,14,15,6,6,0,0,76
19,9,7,14,15,9,0,0,0,73
19,9,7,14,15,14,0,0,0,78
19,9,7,14,15,14,19,0,0,97
19,9,7,14,15,18,1,19,0,102
19,9,7,14,15,18,5,0,0,87
19,9,7,14,15,18,9,0,0,91
19,9,7,14,15,18,25,0,0,107
19,9,7,14,15,18,9,1,0,92
19,9,7,14,15,18,9,1,12,104
19,9,7,14,15,18,9,5,19,115
19,9,7,14,15,18,9,14,1,106
19,9,7,14,15,18,9,14,5,110
19,9,7,14,15,18,9,14,9,114
19,9,7,14,15,18,9,14,15,120
19,9,7,14,15,18,9,26,5,122
19,9,7,14,15,18,19,0,0,101
19,9,7,14,16,15,19,20,0,119
19,9,7,14,16,15,19,20,19,138
19,9,7,14,19,0,0,0,0,68
19,9,7,14,21,13,0,0,0,83
19,9,7,18,9,13,0,0,0,75
19,9,10,9,12,12,0,0,0,71
19,9,11,1,18,0,0,0,0,58
19,9,11,1,18,1,0,0,0,59
19,9,11,1,20,3,8,0,0,71
19,9,11,5,0,0,0,0,0,44
19,25,11,5,0,0,0,0,0,60
19,9,11,5,18,0,0,0,0,62
19,9,11,5,18,12,25,0,0,99
19,25,11,5,18,12,25,0,0,115
19,9,11,5,18,14,5,19,19,119
19,9,11,5,20,0,0,0,0,64
19,9,11,8,1,18,1,0,0,67
19,9,11,8,18,1,0,0,0,66
19,9,11,8,19,0,0,0,0,66
19,9,11,9,13,9,0,0,0,70
19,9,11,18,1,0,0,0,0,58
19,9,12,1,7,5,0,0,0,53
19,9,12,1,7,5,19,0,0,72
19,9,12,1,14,5,0,0,0,60
19,9,12,1,14,5,19,0,0,79
19,9,12,1,14,7,1,0,0,63
19,9,12,3,18,5,20,5,0,91
19,9,12,4,0,0,0,0,0,44
19,9,12,4,19,0,0,0,0,63
19,9,12,5,14,0,0,0,0,59
19,9,12,5,14,3,5,0,0,67
19,9,12,5,14,3,5,4,0,71
19,9,12,5,14,3,5,18,0,85
19,9,12,5,14,3,5,18,19,104
19,9,12,5,14,3,5,19,0,86
19,9,12,5,14,3,25,0,0,87
19,9,12,5,14,3,9,14,7,92
19,25,12,5,14,5,0,0,0,80
19,9,12,5,14,9,0,0,0,68
19,9,12,5,14,9,3,0,0,71
19,9,12,5,14,20,0,0,0,79
19,9,12,5,14,20,5,18,0,102
19,9,12,5,14,20,5,19,20,123
19,9,12,5,14,20,9,1,12,101
19,9,12,5,14,20,9,15,0,103
19,9,12,5,14,20,9,19,8,115
19,9,12,5,14,20,9,21,13,122
19,9,12,5,14,20,12,25,0,116
19,9,12,5,14,20,19,0,0,98
19,9,12,5,19,9,1,19,0,93
19,9,12,5,24,5,19,0,0,93
19,9,12,5,24,9,20,5,0,103
19,9,12,7,18,5,5,14,0,89
19,25,12,9,0,0,0,0,0,65
19,9,12,9,3,1,0,0,0,53
19,9,12,9,3,1,13,0,0,66
19,9,12,9,3,1,14,5,0,72
19,9,12,9,3,1,19,0,0,72
19,9,12,9,3,1,20,5,0,78
19,9,12,9,3,1,20,5,19,97
19,9,12,9,3,5,1,14,0,72
19,9,12,9,3,5,15,21,19,112
19,9,12,9,3,9,3,0,0,64
19,9,12,9,3,9,4,5,0,70
19,9,12,9,3,9,4,5,19,89
19,9,12,9,3,9,6,25,0,92
19,9,12,9,3,25,12,0,0,89
19,9,12,9,3,9,15,21,19,116
19,9,12,9,3,9,21,13,0,95
19,9,12,9,3,9,21,13,19,114
19,9,12,9,3,9,26,5,0,92
19,9,12,9,3,12,5,0,0,69
19,9,12,9,3,12,5,19,0,88
19,9,12,9,3,15,0,0,0,67
19,9,12,9,3,15,14,0,0,81
19,9,12,9,3,15,14,5,0,86
19,9,12,9,3,15,14,5,19,105
19,9,12,9,3,15,14,19,0,100
19,9,12,9,3,15,19,5,19,110
19,9,12,9,3,15,19,9,19,114
19,9,12,9,3,15,20,9,3,99
19,9,12,9,3,21,12,1,0,86
19,9,12,9,3,21,12,1,18,104
19,9,12,9,3,21,12,5,0,90
19,25,12,9,4,0,0,0,0,69
19,9,12,25,12,0,0,0,0,77
19,25,12,9,14,7,0,0,0,86
19,9,12,9,17,21,1,0,0,88
19,9,12,9,17,21,1,5,0,93
19,9,12,9,17,21,5,0,0,92
19,9,12,9,17,21,5,19,0,111
19,9,12,9,17,21,15,19,5,126
19,9,12,9,17,21,15,21,19,142
19,25,12,9,19,0,0,0,0,84
19,9,12,11,0,0,0,0,0,51
19,9,12,11,1,12,5,14,5,88
19,9,12,11,1,12,9,14,5,92
19,9,12,11,5,4,0,0,0,60
19,9,12,11,5,14,0,0,0,70
19,9,12,11,5,18,0,0,0,74
19,9,12,11,25,0,0,0,0,76
19,9,12,11,9,5,0,0,0,65
19,9,12,11,9,5,18,0,0,83
19,9,12,11,9,5,19,20,0,104
19,9,12,11,9,12,25,0,0,97
19,9,12,11,9,14,5,0,0,79
19,9,12,11,9,14,5,19,19,117
19,9,12,11,9,14,7,0,0,81
19,9,12,11,12,9,11,5,0,88
19,9,12,11,13,1,14,0,0,79
19,9,12,11,13,5,14,0,0,83
19,9,12,11,14,5,19,19,0,108
19,9,12,11,15,12,5,14,5,102
19,9,12,11,15,12,9,14,5,106
19,9,12,11,19,0,0,0,0,70
19,9,12,11,19,13,1,14,0,98
19,9,12,11,19,20,15,14,5,124
19,9,12,11,20,1,9,12,0,93
19,9,12,11,23,5,5,4,0,88
19,9,12,11,23,5,5,4,19,107
19,9,12,11,23,15,13,1,14,117
19,9,12,11,23,15,15,4,0,108
19,9,12,11,23,15,18,11,0,118
19,9,12,11,23,15,18,11,19,137
19,9,12,11,23,15,18,13,0,120
19,9,12,11,23,15,18,13,19,139
19,25,12,12,0,0,0,0,0,68
19,25,12,12,1,2,0,0,0,71
19,25,12,12,1,2,1,18,25,115
19,25,12,12,1,2,5,0,0,76
19,25,12,12,1,2,9,0,0,80
19,25,12,12,1,2,9,3,0,83
19,25,12,12,1,2,9,3,19,102
19,25,12,12,1,2,9,6,25,111
19,25,12,12,1,2,9,19,5,104
19,25,12,12,1,2,9,19,13,112
19,25,12,12,1,2,9,26,5,111
19,25,12,12,1,2,12,5,0,88
19,25,12,12,1,2,12,5,4,92
19,25,12,12,1,2,12,5,19,107
19,9,12,12,1,2,21,2,0,78
19,25,12,12,1,2,21,2,0,94
19,9,12,12,1,2,21,2,19,97
19,25,12,12,1,2,21,2,19,113
19,9,12,12,1,4,1,18,0,76
19,9,12,12,1,14,4,1,18,90
19,9,12,12,1,18,0,0,0,71
19,9,12,12,3,15,3,11,0,84
19,25,12,12,5,16,19,5,19,132
19,25,12,12,5,16,19,9,19,136
19,25,12,12,5,16,20,9,3,121
19,9,12,12,5,18,0,0,0,75
19,9,12,12,5,18,19,0,0,94
19,9,12,12,25,0,0,0,0,77
19,9,12,12,9,2,9,2,0,74
19,9,12,12,9,2,9,2,19,93
19,9,12,12,9,2,15,21,11,110
19,9,12,12,9,2,21,2,0,86
19,9,12,12,9,2,21,2,19,105
19,25,12,12,9,4,0,0,0,81
19,25,12,12,9,4,9,1,14,105
19,9,12,12,9,5,18,0,0,84
19,9,12,12,9,5,19,0,0,85
19,9,12,12,9,5,19,20,0,105
19,9,12,12,25,8,15,15,4,119
19,9,12,12,25,8,15,23,0,123
19,9,12,12,25,9,19,8,0,113
19,9,12,12,25,9,19,13,0,118
19,9,12,12,9,11,9,14,0,95
19,9,12,12,9,12,25,0,0,98
19,9,12,12,9,14,5,19,19,118
19,9,12,12,25,20,15,14,0,126
19,9,12,12,15,3,11,0,0,81
19,25,12,12,15,7,5,0,0,95
19,25,12,12,15,7,9,19,13,131
19,25,12,12,15,7,9,19,20,138
19,25,12,12,15,7,9,26,5,130
19,9,12,12,15,14,0,0,0,81
19,9,12,12,19,0,0,0,0,71
19,9,12,15,0,0,0,0,0,55
19,9,12,15,5,4,0,0,0,64
19,9,12,15,9,14,7,0,0,85
19,9,12,15,9,19,20,0,0,103
19,9,12,15,19,0,0,0,0,74
19,9,12,15,24,1,14,5,0,99
19,9,12,15,24,1,14,5,19,118
19,25,12,16,8,0,0,0,0,80
19,25,12,16,8,25,0,0,0,105
19,25,12,16,8,9,3,0,0,92
19,9,12,16,8,9,4,0,0,77
19,25,12,16,8,9,4,0,0,93
19,25,12,16,8,9,4,19,0,112
19,25,12,16,8,9,14,5,0,108
19,25,12,16,8,9,19,8,0,116
19,9,12,16,8,9,21,13,0,107
19,25,12,16,8,9,26,5,0,120
19,25,12,16,8,12,9,11,5,117
19,25,12,16,8,19,0,0,0,99
19,9,12,20,0,0,0,0,0,60
19,9,12,20,1,7,5,0,0,73
19,9,12,20,1,20,9,15,14,119
19,9,12,20,5,4,0,0,0,69
19,9,12,20,25,0,0,0,0,85
19,9,12,20,9,5,18,0,0,92
19,9,12,20,9,5,19,20,0,113
19,9,12,20,9,14,7,0,0,90
19,9,12,20,12,9,11,5,0,97
19,9,12,20,19,0,0,0,0,79
19,9,12,20,19,20,15,14,5,133
19,9,12,21,14,4,21,13,0,113
19,9,12,21,18,5,0,0,0,84
19,9,12,21,18,9,4,0,0,92
19,9,12,21,18,9,4,19,0,111
19,9,12,21,18,15,9,4,0,107
19,9,12,21,18,15,9,4,19,126
19,9,12,22,1,5,0,0,0,68
19,25,12,22,1,5,0,0,0,84
19,25,12,22,1,7,5,0,0,91
19,25,12,22,1,14,9,20,5,127
19,9,12,22,1,14,9,20,25,131
19,25,12,22,1,14,9,20,25,147
19,25,12,22,1,14,9,26,5,133
19,25,12,22,1,14,12,25,0,130
19,9,12,22,1,14,18,25,0,120
19,25,12,22,1,14,18,25,0,136
19,9,12,22,1,14,19,0,0,96
19,25,12,22,1,14,19,0,0,112
19,9,12,22,1,19,0,0,0,82
19,25,12,22,1,19,0,0,0,98
19,25,12,22,1,20,5,0,0,104
19,25,12,22,1,20,9,3,0,111
19,9,12,22,5,14,4,25,0,110
19,9,12,22,5,18,5,4,0,94
19,9,12,22,5,18,5,25,5,120
19,9,12,22,5,18,5,18,0,108
19,9,12,22,5,18,5,18,19,127
19,9,12,22,5,18,6,9,14,114
19,9,12,22,5,18,25,0,0,110
19,9,12,22,5,18,9,5,18,117
19,9,12,22,5,18,9,12,25,131
19,9,12,22,5,18,9,14,7,115
19,9,12,22,5,18,9,19,5,118
19,9,12,22,5,18,9,19,8,121
19,9,12,22,5,18,9,20,5,119
19,9,12,22,5,18,9,26,5,125
19,9,12,22,5,18,12,25,0,122
19,9,12,22,5,18,14,0,0,99
19,9,12,22,5,18,18,15,4,122
19,9,12,22,5,18,20,9,16,130
19,9,12,22,5,18,20,15,16,136
19,9,12,22,5,24,0,0,0,91
19,9,12,22,5,24,5,19,0,115
19,25,12,22,9,3,0,0,0,90
19,9,12,22,9,3,1,12,0,87
19,9,12,22,9,3,19,0,0,93
19,25,12,22,9,9,4,0,0,100
19,25,12,22,9,9,14,5,0,115
19,25,12,22,9,14,0,0,0,101
19,25,12,22,9,14,5,0,0,106
19,25,12,22,9,14,5,19,0,125
19,25,12,22,9,14,9,20,5,135
19,25,12,22,9,14,19,0,0,120
19,25,12,22,9,20,5,0,0,112
19,25,12,22,9,20,5,19,0,131
19,25,12,22,9,21,19,0,0,127
19,25,13,0,0,0,0,0,0,57
19,9,13,1,7,18,5,0,0,72
19,9,13,1,12,0,0,0,0,54
19,9,13,1,18,0,0,0,0,60
19,9,13,1,18,1,0,0,0,61
19,9,13,1,18,18,5,0,0,83
19,9,13,1,18,19,0,0,0,79
19,9,13,1,18,21,2,1,0,84
19,9,13,1,18,21,2,1,19,103
19,9,13,1,19,0,0,0,0,61
19,9,13,1,26,9,14,5,0,96
19,9,13,1,26,9,14,5,19,115
19,9,13,2,1,0,0,0,0,44
19,9,13,2,1,12,12,0,0,68
19,25,13,2,1,19,9,3,0,91
19,25,13,2,1,19,9,19,0,107
19,9,13,2,9,12,0,0,0,64
19,25,13,2,9,15,14,0,0,97
19,25,13,2,9,15,14,9,3,109
19,25,13,2,9,15,14,19,0,116
19,25,13,2,9,15,14,20,0,117
19,25,13,2,9,15,14,20,19,136
19,25,13,2,9,15,19,5,19,126
19,25,13,2,9,15,19,9,19,130
19,25,13,2,9,15,20,0,0,103
19,25,13,2,9,15,20,5,0,108
19,25,13,2,9,15,20,5,19,127
19,25,13,2,9,15,20,9,3,115
19,25,13,2,9,15,20,19,0,122
19,9,13,2,12,9,14,0,0,78
19,9,13,2,12,9,14,7,0,85
19,9,13,2,12,15,20,0,0,90
19,25,13,2,15,12,0,0,0,86
19,25,13,2,15,12,5,4,0,95
19,25,13,2,15,12,9,3,0,98
19,25,13,2,15,12,9,3,19,117
19,25,13,2,15,12,9,14,7,116
19,25,13,2,15,12,9,19,5,119
19,25,13,2,15,12,9,19,13,127
19,25,13,2,15,12,9,19,20,134
19,25,13,2,15,12,9,26,5,126
19,25,13,2,15,12,12,5,4,107
19,25,13,2,15,12,15,7,25,133
19,25,13,2,15,12,18,25,0,129
19,25,13,2,15,12,19,0,0,105
19,25,13,2,15,12,21,13,0,120
19,25,13,2,18,1,14,3,8,103
19,9,13,3,15,14,0,0,0,73
19,9,13,5,0,0,0,0,0,46
19,9,13,9,1,4,0,0,0,55
19,9,13,9,1,12,0,0,0,63
19,9,13,9,1,14,0,0,0,65
19,9,13,9,1,14,9,20,25,119
19,9,13,9,1,14,19,0,0,84
19,9,13,9,5,19,17,21,5,117
19,9,13,9,9,4,0,0,0,63
19,9,13,9,12,1,18,0,0,81
19,9,13,9,12,1,18,25,0,106
19,9,13,9,12,1,18,12,25,118
19,9,13,9,12,1,20,5,0,88
19,9,13,9,12,5,0,0,0,67
19,9,13,9,12,5,19,0,0,86
19,9,13,9,12,9,13,21,13,118
19,9,13,9,12,9,20,5,18,114
19,9,13,9,12,9,20,25,0,116
19,9,13,9,12,9,26,5,0,102
19,9,13,9,12,15,18,0,0,95
19,9,13,9,15,9,4,0,0,78
19,9,13,9,15,21,19,0,0,105
19,9,13,9,20,1,18,0,0,89
19,9,13,9,20,1,18,19,0,108
19,9,13,9,20,25,0,0,0,95
19,9,13,11,9,14,0,0,0,75
19,9,13,12,9,14,0,0,0,76
19,9,13,12,9,14,7,0,0,83
19,9,13,12,9,14,19,0,0,95
19,25,13,13,1,3,8,25,0,107
19,25,13,13,5,4,9,1,14,103
19,25,13,13,5,12,9,1,0,97
19,25,13,13,5,12,9,1,14,111
19,25,13,13,5,12,21,19,0,127
19,9,13,13,5,18,0,0,0,77
19,9,13,13,5,18,5,4,0,86
19,9,13,13,5,18,9,14,7,107
19,9,13,13,5,18,19,0,0,96
19,25,13,13,5,20,18,1,12,126
19,25,13,13,5,20,18,25,0,138
19,25,13,13,5,20,18,9,3,125
19,25,13,13,9,19,20,0,0,118
19,9,13,13,15,14,0,0,0,83
19,25,13,13,15,18,25,0,0,128
19,9,13,14,5,12,0,0,0,72
19,9,13,14,5,12,19,0,0,91
19,9,13,15,12,5,15,14,0,102
19,9,13,15,12,5,15,14,19,121
19,9,13,15,14,25,0,0,0,95
19,9,13,15,14,9,1,3,0,83
19,9,13,15,14,9,1,3,19,102
19,9,13,15,14,9,1,12,0,92
19,9,13,15,14,9,5,19,0,103
19,9,13,15,14,9,15,21,19,134
19,9,13,15,14,9,19,13,0,111
19,9,13,15,14,9,19,20,19,137
19,9,13,15,14,9,26,5,0,110
19,9,13,15,14,9,26,5,4,114
19,9,13,15,14,9,26,5,19,129
19,9,13,15,15,12,0,0,0,83
19,9,13,15,15,13,0,0,0,84
19,9,13,15,15,13,19,0,0,103
19,9,13,15,15,14,0,0,0,85
19,9,13,15,15,14,19,0,0,104
19,9,13,15,21,19,0,0,0,96
19,9,13,16,0,0,0,0,0,57
19,9,13,16,1,9,0,0,0,67
19,25,13,16,1,20,8,25,0,127
19,25,13,16,1,20,8,9,3,114
19,25,13,16,1,20,8,9,14,125
19,9,13,16,1,20,9,3,15,105
19,25,13,16,1,20,18,25,0,137
19,25,13,16,1,20,18,9,3,124
19,9,13,16,5,18,0,0,0,80
19,9,13,16,5,18,5,4,0,89
19,9,13,16,5,18,5,18,0,103
19,9,13,16,5,18,5,18,19,122
19,9,13,16,5,18,9,14,7,110
19,9,13,16,5,18,19,0,0,99
19,25,13,16,5,20,1,12,25,136
19,25,13,16,8,25,12,1,14,133
19,25,13,16,8,9,12,5,0,107
19,25,13,16,8,9,12,25,0,127
19,25,13,16,8,9,12,9,3,114
19,25,13,16,8,25,19,5,19,149
19,25,13,16,8,25,19,25,0,150
19,25,13,16,8,25,19,9,3,137
19,25,13,16,8,25,19,9,19,153
19,25,13,16,8,25,20,9,3,138
19,25,13,16,8,15,14,25,0,135
19,25,13,16,8,15,14,9,1,120
19,25,13,16,8,15,14,9,3,122
19,25,13,16,8,18,1,19,5,124
19,25,13,16,12,1,19,13,0,118
19,25,13,16,12,1,19,20,0,125
19,9,13,16,12,5,0,0,0,74
19,9,13,16,12,5,4,0,0,78
19,9,13,16,12,5,18,0,0,92
19,9,13,16,12,5,19,0,0,93
19,9,13,16,12,5,19,19,5,117
19,9,13,16,12,5,19,20,0,113
19,9,13,16,12,5,20,15,14,123
19,9,13,16,12,5,24,0,0,98
19,9,13,16,12,5,24,5,4,107
19,9,13,16,12,5,24,5,19,122
19,9,13,16,12,25,0,0,0,94
19,9,13,16,12,9,3,5,19,105
19,9,13,16,12,9,3,9,1,91
19,9,13,16,12,9,6,25,0,109
19,9,13,16,12,9,14,7,0,99
19,9,13,16,12,9,19,13,0,110
19,9,13,16,12,9,19,13,19,129
19,9,13,16,12,9,19,20,0,117
19,25,13,16,12,15,3,5,0,108
19,9,13,16,12,21,13,0,0,103
19,25,13,16,15,4,5,0,0,97
19,25,13,16,15,4,9,1,0,102
19,25,13,16,15,4,9,1,12,114
19,25,13,16,15,4,9,21,13,135
19,25,13,16,15,12,9,20,25,154
19,25,13,16,15,19,9,1,0,117
19,25,13,16,15,19,9,1,3,120
19,25,13,16,15,19,9,1,12,129
19,25,13,16,15,19,9,15,14,145
19,25,13,16,15,19,9,21,13,150
19,25,13,16,15,19,19,9,1,136
19,9,13,16,19,0,0,0,0,76
19,9,13,16,20,9,3,15,0,104
19,25,13,16,20,15,13,0,0,121
19,25,13,16,20,15,13,19,0,140
19,25,13,16,20,15,19,9,19,155
19,9,13,16,21,12,1,0,0,91
19,9,13,16,21,12,21,13,0,124
19,25,13,16,21,19,0,0,0,113
19,9,13,19,9,13,0,0,0,82
19,25,13,20,1,2,0,0,0,80
19,9,13,21,12,0,0,0,0,74
19,9,13,21,12,1,0,0,0,75
19,9,13,21,12,1,3,18,1,97
19,9,13,21,12,1,3,18,5,101
19,9,13,21,12,1,14,3,5,97
19,9,13,21,12,1,14,20,0,109
19,9,13,21,12,1,14,20,19,128
19,9,13,21,12,1,18,0,0,93
19,9,13,21,12,1,18,19,0,112
19,9,13,21,12,1,20,5,0,100
19,9,13,21,12,1,20,5,4,104
19,9,13,21,12,1,20,5,19,119
19,9,13,21,12,1,20,15,18,128
19,9,13,21,12,3,1,19,20,117
19,9,13,21,12,5,0,0,0,79
19,9,13,21,12,5,18,0,0,97
19,9,13,21,12,9,9,4,0,96
19,9,13,21,12,9,15,9,4,111
19,9,13,21,12,9,26,5,0,114
19,9,13,21,12,20,25,0,0,119
19,9,13,21,18,7,0,0,0,87
19,9,13,21,18,7,8,0,0,95
19,25,14,1,3,13,5,0,0,80
19,25,14,1,3,13,25,0,0,100
19,25,14,1,3,13,9,3,0,87
19,25,14,1,3,20,9,3,0,94
19,25,14,1,7,15,7,0,0,88
19,25,14,1,7,15,7,1,12,101
19,25,14,1,7,15,7,19,0,107
19,25,14,1,7,15,7,21,5,114
19,9,14,1,9,20,5,0,0,77
19,9,14,1,12,0,0,0,0,55
19,9,14,1,12,2,9,14,0,80
19,25,14,1,12,5,16,8,1,101
19,25,14,1,12,5,16,8,5,105
19,25,14,1,12,7,9,1,0,88
19,25,14,1,12,7,9,3,0,90
19,9,14,1,13,1,25,0,0,82
19,9,14,1,13,9,14,0,0,79
19,9,14,1,13,9,14,5,0,84
19,25,14,1,14,7,5,0,0,85
19,25,14,1,14,7,9,1,0,90
19,25,14,1,14,7,9,1,12,102
19,25,14,1,14,7,9,3,0,92
19,25,14,1,14,7,9,21,13,123
19,25,14,1,14,15,14,19,0,121
19,25,14,1,14,20,8,25,0,126
19,25,14,1,14,20,8,9,3,113
19,9,14,1,16,1,20,5,0,85
19,25,14,1,16,8,5,0,0,88
19,25,14,1,16,8,5,1,0,89
19,25,14,1,16,8,5,9,1,98
19,9,14,1,16,9,3,0,0,71
19,9,14,1,16,9,14,0,0,82
19,9,14,1,16,9,14,5,0,87
19,9,14,1,16,9,14,9,3,94
19,9,14,1,16,9,19,13,0,100
19,9,14,1,16,9,19,13,19,119
19,9,14,1,16,9,26,5,0,99
19,25,14,1,16,19,5,0,0,99
19,25,14,1,16,19,5,4,0,103
19,25,14,1,16,19,5,19,0,118
19,25,14,1,16,19,9,4,0,107
19,25,14,1,16,19,9,14,7,124
19,25,14,1,16,19,9,19,0,122
19,25,14,1,16,20,1,9,0,105
19,25,14,1,16,20,1,19,5,120
19,25,14,1,16,20,5,0,0,100
19,25,14,1,16,20,5,14,5,119
19,25,14,1,16,20,9,3,0,107
19,25,14,1,16,20,9,4,0,108
19,25,14,1,18,3,8,25,0,113
19,25,14,1,18,19,5,19,0,120
19,25,14,1,18,20,5,20,5,127
19,25,14,1,19,20,18,25,0,141
19,9,14,1,23,1,0,0,0,67
19,25,14,1,24,1,18,0,0,102
19,25,14,1,24,1,18,25,0,127
19,25,14,1,24,1,18,9,1,112
19,25,14,1,24,5,19,0,0,107
19,25,14,1,24,9,19,0,0,111
19,25,14,3,0,0,0,0,0,61
19,9,14,3,1,12,9,14,5,86
19,9,14,3,1,13,1,19,0,79
19,25,14,3,1,18,25,15,14,134
19,25,14,3,1,18,16,0,0,96
19,25,14,3,1,18,16,25,0,121
19,25,14,3,1,18,16,9,1,106
19,25,14,3,1,18,16,19,0,115
19,9,14,3,5,0,0,0,0,50
19,25,14,3,5,4,0,0,0,70
19,25,14,3,5,12,12,21,19,130
19,9,14,3,5,18,5,0,0,73
19,9,14,3,5,18,5,12,25,110
19,9,14,3,5,18,5,18,0,91
19,9,14,3,5,18,5,19,20,112
19,9,14,3,5,18,9,20,25,122
19,25,14,3,8,0,0,0,0,69
19,25,14,3,8,5,4,0,0,78
19,25,14,3,8,9,14,7,0,99
19,25,14,3,8,25,19,9,19,141
19,25,14,3,8,9,20,9,3,110
19,25,14,3,8,18,15,0,0,102
19,25,14,3,8,18,15,14,5,121
19,25,14,3,8,18,15,14,25,141
19,25,14,3,8,18,15,19,0,121
19,25,14,3,8,19,0,0,0,88
19,25,14,3,9,14,7,0,0,91
19,9,14,3,9,16,9,20,1,100
19,9,14,3,9,16,21,20,0,111
19,9,14,3,9,16,21,20,19,130
19,25,14,3,25,20,9,1,0,116
19,25,14,3,25,20,9,1,12,128
19,25,14,3,25,20,9,21,13,149
19,25,14,3,12,9,14,1,12,109
19,25,14,3,12,9,14,5,0,101
19,25,14,3,12,9,14,5,19,120
19,25,14,3,12,9,20,9,3,114
19,25,14,3,15,5,12,15,13,121
19,25,14,3,15,13,19,0,0,108
19,25,14,3,15,16,1,12,0,105
19,25,14,3,15,16,1,18,5,116
19,25,14,3,15,16,1,20,5,118
19,25,14,3,15,16,5,0,0,97
19,25,14,3,15,16,5,19,0,116
19,25,14,3,15,16,9,3,0,104
19,25,14,3,15,16,9,19,13,133
19,25,14,3,15,16,9,19,20,140
19,25,14,3,15,16,9,26,5,132
19,25,14,3,18,1,3,25,0,108
19,25,14,3,18,1,19,25,0,124
19,25,14,3,18,5,20,9,3,116
19,25,14,3,18,9,19,9,19,135
19,25,14,3,19,0,0,0,0,80
19,25,14,4,0,0,0,0,0,62
19,25,14,4,1,3,20,25,12,123
19,9,14,4,5,18,0,0,0,69
19,25,14,4,5,19,5,19,0,110
19,25,14,4,5,19,9,19,0,114
19,25,14,4,5,20,0,0,0,87
19,25,14,4,5,20,9,3,0,99
19,25,14,4,5,20,15,14,0,116
19,25,14,4,5,20,19,0,0,106
19,25,14,4,9,3,0,0,0,74
19,25,14,4,9,3,1,12,0,87
19,25,14,4,9,3,1,20,0,95
19,25,14,4,9,3,1,20,5,100
19,25,14,4,9,3,19,0,0,93
19,9,14,4,12,5,0,0,0,63
19,9,14,4,15,3,0,0,0,64
19,25,14,4,15,3,0,0,0,80
19,9,14,4,15,14,0,0,0,75
19,9,14,4,18,25,0,0,0,89
19,25,14,4,18,15,13,5,0,113
19,25,14,4,18,15,13,5,19,132
19,25,14,4,18,15,13,9,3,120
19,25,14,5,0,0,0,0,0,63
19,9,14,5,2,1,4,1,0,55
19,25,14,5,3,8,9,1,0,84
19,25,14,5,3,8,9,1,5,89
19,25,14,5,3,8,9,19,20,122
19,25,14,5,3,9,15,21,19,130
19,25,14,5,3,20,9,3,0,98
19,25,14,5,3,20,9,3,19,117
19,9,14,5,3,21,18,1,12,102
19,9,14,5,3,21,18,5,0,94
19,9,14,5,3,21,18,5,4,98
19,9,14,5,3,21,18,5,19,113
19,25,14,5,4,18,1,12,0,98
19,25,14,5,4,18,9,1,12,107
19,25,14,5,4,18,9,1,14,109
19,25,14,5,4,18,15,21,19,140
19,25,14,5,13,1,0,0,0,77
19,25,14,5,13,1,20,1,0,98
19,25,14,5,18,5,19,9,19,133
19,25,14,5,18,7,25,0,0,113
19,25,14,5,18,7,9,1,0,98
19,25,14,5,18,7,9,1,19,117
19,25,14,5,18,7,9,3,0,100
19,25,14,5,18,7,9,4,0,101
19,25,14,5,18,7,9,4,19,120
19,25,14,5,18,7,9,5,19,121
19,25,14,5,18,7,9,19,13,129
19,25,14,5,18,7,9,19,20,136
19,25,14,5,18,7,9,26,5,128
19,25,14,5,18,9,26,5,0,121
19,9,14,5,19,0,0,0,0,66
19,25,14,5,19,9,19,0,0,110
19,25,14,5,19,9,19,5,19,134
19,25,14,5,20,8,14,9,3,117
19,25,14,5,20,9,3,0,0,95
19,9,14,5,23,0,0,0,0,70
19,9,14,5,23,5,4,0,0,79
19,9,14,5,23,25,0,0,0,95
19,9,14,5,23,9,14,7,0,100
19,9,14,5,23,12,5,19,19,125
19,9,14,5,23,15,21,19,0,125
19,9,14,5,23,19,0,0,0,89
19,25,14,5,26,9,19,9,19,145
19,9,14,6,15,14,9,1,0,87
19,9,14,6,15,14,9,5,0,91
19,25,14,6,21,5,12,0,0,102
19,25,14,6,21,5,12,19,0,121
19,9,14,6,21,12,0,0,0,81
19,9,14,6,21,12,12,25,0,118
19,9,14,7,0,0,0,0,0,49
19,9,14,7,1,2,12,5,0,69
19,9,14,7,1,12,12,25,0,99
19,25,14,7,1,13,25,0,0,104
19,25,14,7,1,13,9,3,0,91
19,25,14,7,1,13,9,5,19,112
19,25,14,7,1,13,15,21,19,134
19,9,14,7,1,18,9,16,0,93
19,25,14,7,1,19,0,0,0,85
19,25,14,7,1,19,5,19,0,109
19,9,14,7,5,0,0,0,0,54
19,9,14,7,5,4,0,0,0,58
19,9,14,7,5,25,0,0,0,79
19,9,14,7,5,9,14,7,0,84
19,25,14,7,5,14,5,9,3,101
19,25,14,7,5,14,9,3,0,96
19,25,14,7,5,14,9,19,13,125
19,25,14,7,5,14,9,20,5,118
19,9,14,7,5,18,5,19,19,115
19,9,14,7,5,18,9,5,0,86
19,9,14,7,5,18,19,0,0,91
19,9,14,7,5,19,0,0,0,73
19,9,14,7,6,5,19,20,0,99
19,9,14,7,9,14,7,0,0,79
19,9,14,7,9,14,7,12,25,116
19,9,14,7,11,1,13,1,19,94
19,9,14,7,12,5,0,0,0,66
19,9,14,7,12,5,2,1,18,87
19,9,14,7,12,5,4,0,0,70
19,9,14,7,12,5,18,0,0,84
19,9,14,7,12,5,19,0,0,85
19,9,14,7,12,5,20,0,0,86
19,9,14,7,12,5,20,19,0,105
19,9,14,7,12,25,0,0,0,86
19,9,14,7,12,9,14,7,0,91
19,9,14,7,12,9,14,7,19,110
19,25,14,7,18,1,16,8,0,108
19,9,14,7,19,0,0,0,0,68
19,9,14,7,19,15,14,7,0,104
19,9,14,7,19,15,14,7,25,129
19,9,14,7,19,15,14,7,19,123
19,9,14,7,21,12,1,18,0,101
19,9,14,7,21,12,1,18,19,120
19,9,14,7,21,12,20,0,0,102
19,9,14,7,21,12,20,21,19,142
19,9,14,8,0,0,0,0,0,50
19,9,14,8,1,12,9,20,5,97
19,9,14,8,1,19,1,14,0,85
19,9,14,8,19,0,0,0,0,69
19,9,14,9,3,1,12,0,0,67
19,9,14,9,3,9,26,5,19,113
19,9,14,9,7,18,9,14,0,99
19,9,14,9,19,20,5,18,0,113
19,9,14,9,19,20,18,1,0,109
19,9,14,9,19,20,18,1,4,113
19,9,14,9,19,20,18,1,12,121
19,9,14,9,19,20,18,9,14,131
19,25,14,9,26,5,19,9,19,145
19,9,14,10,5,18,0,0,0,75
19,9,14,11,1,2,12,5,0,73
19,9,14,11,1,7,5,0,0,66
19,9,14,11,1,7,5,19,0,85
19,25,14,11,1,18,25,15,14,142
19,9,14,11,2,15,1,20,0,91
19,9,14,11,2,15,24,0,0,94
19,9,14,11,5,4,0,0,0,62
19,9,14,11,5,18,0,0,0,76
19,9,14,11,5,18,19,0,0,95
19,9,14,11,6,9,5,12,4,89
19,9,14,11,8,5,1,4,0,71
19,9,14,11,8,15,12,5,0,93
19,9,14,11,8,15,12,5,19,112
19,9,14,11,25,0,0,0,0,78
19,9,14,11,9,14,7,0,0,83
19,9,14,11,9,14,7,12,25,120
19,9,14,11,12,5,19,19,0,108
19,9,14,11,12,9,11,5,0,90
19,9,14,11,18,15,15,13,0,114
19,9,14,11,19,0,0,0,0,72
19,9,14,11,19,20,15,14,5,126
19,9,14,12,5,19,19,0,0,97
19,9,14,12,5,19,19,12,25,134
19,9,14,12,9,11,5,0,0,79
19,9,14,14,1,2,12,5,0,76
19,9,14,14,5,4,0,0,0,65
19,25,14,14,5,13,1,0,0,91
19,25,14,14,5,13,1,20,1,112
19,9,14,14,5,14,0,0,0,75
19,9,14,14,5,18,0,0,0,79
19,9,14,14,5,18,5,19,19,122
19,9,14,14,5,18,19,0,0,98
19,9,14,14,5,20,0,0,0,81
19,25,14,14,5,21,19,9,19,145
19,9,14,14,9,14,7,0,0,86
19,9,14,14,9,14,7,12,25,123
19,9,14,14,15,23,5,4,0,103
19,25,14,15,3,8,1,0,0,85
19,25,14,15,3,8,1,12,0,97
19,25,14,15,3,8,15,9,4,112
19,25,14,15,3,8,15,21,19,139
19,25,14,15,3,8,21,19,0,124
19,25,14,15,4,0,0,0,0,77
19,25,14,15,4,1,12,0,0,90
19,25,14,15,4,1,12,12,25,127
19,25,14,15,4,9,1,14,0,101
19,25,14,15,4,9,3,0,0,89
19,25,14,15,4,9,3,1,12,102
19,25,14,15,4,9,3,15,14,118
19,25,14,15,4,9,19,20,0,125
19,25,14,15,4,9,20,5,0,111
19,25,14,15,4,19,0,0,0,96
19,25,14,15,4,19,13,1,14,124
19,25,14,15,4,19,13,5,14,128
19,25,14,15,5,3,5,20,5,111
19,25,14,15,5,3,25,0,0,106
19,25,14,15,5,3,9,19,13,122
19,25,14,15,5,3,9,26,5,121
19,25,14,15,5,11,5,20,5,119
19,25,14,15,5,11,25,0,0,114
19,25,14,15,5,20,9,3,0,110
19,25,14,15,9,3,15,21,19,140
19,9,14,15,9,4,1,12,0,83
19,25,14,15,13,15,19,25,0,145
19,25,14,15,14,25,13,0,0,125
19,25,14,15,14,25,13,5,0,130
19,25,14,15,14,25,13,5,19,149
19,25,14,15,14,25,13,25,0,150
19,25,14,15,14,25,13,9,3,137
19,25,14,15,14,25,13,19,0,144
19,25,14,15,16,0,0,0,0,89
19,9,14,15,16,5,18,0,0,96
19,9,14,15,16,9,1,0,0,83
19,9,14,15,16,9,1,19,0,102
19,9,14,15,16,9,5,0,0,87
19,9,14,15,16,9,19,0,0,101
19,9,14,15,16,9,20,5,0,107
19,9,14,15,16,12,5,0,0,90
19,25,14,15,16,19,5,19,0,132
19,25,14,15,16,19,25,0,0,133
19,25,14,15,16,19,9,3,0,120
19,25,14,15,16,19,9,19,0,136
19,25,14,15,16,19,9,19,5,141
19,25,14,15,16,19,9,26,5,148
19,25,14,15,16,20,9,3,0,121
19,25,14,15,19,20,15,19,5,151
19,25,14,15,22,9,1,0,0,105
19,25,14,15,22,9,1,12,0,117
19,25,14,15,22,9,1,19,0,124
19,25,14,15,22,9,20,9,3,136
19,25,14,15,22,9,20,9,19,152
19,9,14,16,18,15,15,6,0,112
19,25,14,19,1,3,18,1,12,112
19,25,14,19,1,3,18,21,13,133
19,9,14,19,25,14,5,0,0,105
19,9,14,19,9,15,14,0,0,99
19,9,14,19,18,9,14,7,0,109
19,25,14,20,1,3,20,9,3,114
19,25,14,20,1,7,13,0,0,99
19,25,14,20,1,7,13,1,0,100
19,25,14,20,1,12,9,20,25,145
19,25,14,20,1,14,0,0,0,93
19,25,14,20,1,19,9,19,0,126
19,25,14,20,1,24,0,0,0,103
19,25,14,20,1,24,5,19,0,127
19,25,14,20,1,24,9,19,0,131
19,25,14,20,1,24,9,19,20,151
19,25,14,20,5,3,20,9,3,118
19,25,14,20,5,12,15,13,5,128
19,9,14,20,5,18,0,0,0,85
19,9,14,20,5,18,5,4,0,94
19,9,14,20,5,18,9,14,7,115
19,9,14,20,5,18,19,0,0,104
19,25,14,20,5,24,9,19,0,135
19,25,14,20,8,0,0,0,0,86
19,25,14,20,8,5,13,5,0,109
19,25,14,20,8,5,19,5,19,134
19,25,14,20,8,5,19,9,19,138
19,25,14,20,8,5,20,5,0,116
19,25,14,20,8,5,20,9,3,123
19,25,14,20,8,15,12,0,0,113
19,25,14,20,8,18,15,14,9,142
19,25,14,20,8,19,0,0,0,105
19,25,14,20,25,16,5,0,0,124
19,25,14,20,25,16,9,3,0,131
19,9,14,20,15,3,0,0,0,80
19,25,14,20,15,13,25,0,0,131
19,25,14,20,15,13,9,1,0,116
19,25,14,20,15,14,5,0,0,112
19,25,14,20,15,14,25,0,0,132
19,25,14,20,15,14,9,3,0,119
19,25,14,20,15,14,9,5,19,140
19,25,14,20,15,14,9,14,0,130
19,25,14,20,15,14,9,19,5,140
19,25,14,20,15,14,9,26,5,147
19,25,14,20,15,14,15,21,19,162
19,25,14,20,18,15,16,5,0,132
19,25,14,20,18,15,16,25,0,152
19,25,14,20,18,15,16,9,3,139
19,9,14,21,1,20,5,0,0,89
19,9,14,21,1,20,5,4,0,93
19,9,14,21,1,20,5,12,25,126
19,9,14,21,1,20,5,19,0,108
19,9,14,21,1,20,9,14,7,114
19,9,14,21,1,20,9,15,14,122
19,9,14,21,9,20,9,19,0,120
19,9,14,21,15,19,5,0,0,102
19,9,14,21,15,19,5,12,25,139
19,9,14,21,15,19,9,20,25,151
19,9,14,21,15,21,19,0,0,118
19,9,14,21,15,21,19,12,25,155
19,25,14,21,18,1,5,0,0,103
19,9,14,21,19,1,12,0,0,95
19,9,14,21,19,5,19,0,0,106
19,25,14,21,19,9,1,0,0,108
19,25,14,21,19,9,1,19,20,147
19,9,14,21,19,9,20,9,19,139
19,9,14,21,19,12,9,11,5,119
19,9,14,21,19,15,9,4,0,110
19,9,14,21,19,15,9,4,19,129
19,9,14,23,1,18,4,0,0,88
19,9,14,26,5,18,0,0,0,91
19,25,15,4,9,3,15,14,0,104
19,9,15,12,0,0,0,0,0,55
19,9,15,14,9,14,7,0,0,87
19,9,16,1,7,5,0,0,0,57
19,9,16,1,16,21,0,0,0,82
19,9,16,5,0,0,0,0,0,49
19,9,16,5,4,0,0,0,0,53
19,9,16,5,18,0,0,0,0,67
19,9,16,5,18,19,0,0,0,86
19,9,16,5,19,0,0,0,0,68
19,25,16,8,0,0,0,0,0,68
19,9,16,8,1,3,0,0,0,56
19,25,16,8,5,18,0,0,0,91
19,25,16,8,5,18,5,4,0,100
19,25,16,8,5,18,9,14,7,121
19,25,16,8,5,18,19,0,0,110
19,25,16,8,9,12,9,4,0,102
19,25,16,8,9,12,9,4,5,107
19,25,16,8,9,12,9,19,0,117
19,25,16,8,9,12,9,19,5,122
19,25,16,8,9,12,9,26,5,129
19,25,16,8,9,12,15,9,4,117
19,25,16,8,9,12,15,13,1,118
19,25,16,8,9,12,15,21,19,144
19,9,16,8,15,9,4,0,0,80
19,9,16,8,15,14,0,0,0,81
19,25,16,8,15,14,0,0,0,97
19,9,16,8,15,14,1,7,5,94
19,9,16,8,15,14,1,12,0,94
19,9,16,8,15,14,1,20,5,107
19,9,16,8,15,14,5,4,0,90
19,25,16,8,15,14,5,4,0,106
19,9,16,8,15,14,5,20,0,106
19,9,16,8,15,14,9,1,0,91
19,9,16,8,15,14,9,1,12,103
19,9,16,8,15,14,9,3,0,93
19,9,16,8,15,14,9,14,7,111
19,25,16,8,15,14,9,14,7,127
19,9,16,8,15,14,9,21,13,124
19,9,16,8,15,14,19,0,0,100
19,25,16,8,15,14,19,0,0,116
19,9,16,8,15,14,21,12,1,115
19,9,16,8,15,19,15,13,5,119
19,9,16,8,21,14,3,12,5,107
19,9,16,9,4,0,0,0,0,57
19,9,16,9,4,9,20,25,0,111
19,9,16,25,12,9,20,5,0,115
19,9,16,9,14,7,0,0,0,74
19,9,16,12,9,14,7,0,0,86
19,9,16,16,5,4,0,0,0,69
19,9,16,16,5,18,0,0,0,83
19,9,16,16,5,18,19,0,0,102
19,9,16,16,5,20,0,0,0,85
19,9,16,16,5,20,19,0,0,104
19,9,16,16,25,0,0,0,0,85
19,9,16,16,9,14,7,0,0,90
19,9,16,16,9,14,7,12,25,127
19,9,16,16,9,15,0,0,0,84
19,9,18,3,1,18,0,0,0,68
19,9,18,4,1,18,0,0,0,69
19,9,18,4,1,18,19,0,0,88
19,9,18,5,0,0,0,0,0,51
19,25,18,5,0,0,0,0,0,67
19,9,18,5,4,0,0,0,0,55
19,9,18,5,5,0,0,0,0,56
19,9,18,5,5,19,0,0,0,75
19,9,18,5,12,5,19,19,0,106
19,25,18,5,14,0,0,0,0,81
19,9,18,5,14,5,0,0,0,70
19,9,18,5,14,25,0,0,0,90
19,9,18,5,14,9,1,14,0,89
19,9,18,5,14,9,1,14,19,108
19,9,18,5,14,9,3,0,0,77
19,9,18,5,14,9,3,1,12,90
19,9,18,5,14,9,14,7,0,95
19,9,18,5,14,9,26,5,0,105
19,9,18,5,14,12,9,11,5,102
19,9,18,5,14,15,9,4,0,93
19,9,18,5,14,19,0,0,0,84
19,25,18,5,14,19,0,0,0,100
19,9,18,5,19,0,0,0,0,70
19,9,18,5,19,8,9,16,0,103
19,9,18,5,19,19,0,0,0,89
19,25,18,5,20,20,5,0,0,112
19,9,18,5,24,0,0,0,0,75
19,9,18,7,1,14,7,0,0,75
19,25,18,9,1,14,19,0,0,105
19,9,18,9,1,19,9,19,0,103
19,9,18,9,3,9,4,0,0,71
19,9,18,9,8,0,0,0,0,63
19,9,18,9,14,7,0,0,0,76
19,25,18,9,14,7,1,0,0,93
19,25,18,9,14,7,1,19,0,112
19,25,18,9,14,7,5,0,0,97
19,25,18,9,14,7,5,1,12,110
19,25,18,9,14,7,5,4,0,101
19,25,18,9,14,7,5,19,0,116
19,25,18,9,14,7,9,14,0,115
19,25,18,9,14,7,9,14,7,122
19,25,18,9,14,7,9,21,13,135
19,25,18,9,14,24,5,19,0,133
19,9,18,9,19,0,0,0,0,74
19,9,18,11,1,18,0,0,0,76
19,9,18,11,5,5,18,0,0,85
19,9,18,11,9,0,0,0,0,66
19,9,18,11,25,0,0,0,0,82
19,9,18,12,15,9,14,0,0,96
19,9,18,12,15,9,14,25,0,121
19,9,18,12,15,9,14,19,0,115
19,25,18,13,1,5,1,0,0,82
19,9,18,13,1,18,11,0,0,89
19,9,18,15,3,0,0,0,0,64
19,9,18,15,3,3,15,0,0,82
19,9,18,15,3,3,15,19,0,101
19,9,18,15,16,0,0,0,0,77
19,9,18,15,19,0,0,0,0,80
19,9,18,16,5,1,0,0,0,68
19,25,18,16,8,9,1,14,0,110
19,25,18,16,8,9,1,14,19,129
19,25,18,16,8,9,4,0,0,99
19,25,18,16,8,9,4,19,0,118
19,25,18,16,8,21,19,0,0,126
19,9,18,16,12,5,0,0,0,79
19,9,18,16,15,15,14,0,0,106
19,9,18,18,1,0,0,0,0,65
19,9,18,18,1,8,0,0,0,73
19,9,18,18,1,8,19,0,0,92
19,9,18,18,1,19,0,0,0,84
19,9,18,18,5,5,0,0,0,74
19,9,18,18,5,5,19,0,0,93
19,25,18,18,9,14,7,5,4,119
19,9,18,19,0,0,0,0,0,65
19,9,18,19,8,9,16,0,0,98
19,25,18,20,0,0,0,0,0,82
19,25,18,20,9,3,0,0,0,94
19,9,18,21,5,12,1,19,0,104
19,9,18,21,16,0,0,0,0,83
19,25,18,21,16,0,0,0,0,99
19,9,18,21,16,5,4,0,0,92
19,25,18,21,16,5,4,0,0,108
19,9,18,21,16,5,18,0,0,106
19,25,18,21,16,5,18,0,0,122
19,9,18,21,16,25,0,0,0,108
19,25,18,21,16,25,0,0,0,124
19,25,18,21,16,12,9,11,5,136
19,9,18,21,16,19,0,0,0,102
19,25,18,21,16,19,0,0,0,118
19,25,18,21,19,0,0,0,0,102
19,9,18,22,5,14,20,0,0,107
19,9,18,22,5,14,20,5,0,112
19,9,18,22,5,14,20,5,19,131
19,9,19,0,0,0,0,0,0,47
19,9,19,1,12,1,14,1,0,76
19,9,19,1,12,19,0,0,0,79
19,9,19,3,15,23,5,20,0,113
19,9,19,5,0,0,0,0,0,52
19,9,19,5,12,0,0,0,0,64
19,9,19,5,18,1,18,1,0,90
19,9,19,5,18,1,18,25,0,114
19,9,19,5,19,0,0,0,0,71
19,9,19,8,0,0,0,0,0,55
19,9,19,8,1,13,0,0,0,69
19,9,19,9,0,0,0,0,0,56
19,25,19,9,14,0,0,0,0,86
19,9,19,9,20,8,0,0,0,84
19,9,19,11,9,14,0,0,0,81
19,9,19,11,9,14,19,0,0,100
19,9,19,12,15,23,5,20,0,122
19,25,19,15,21,20,0,0,0,119
19,9,19,19,0,0,0,0,0,66
19,25,19,19,5,12,0,0,0,99
19,25,19,19,5,12,13,1,14,127
19,9,19,19,9,5,18,0,0,98
19,9,19,19,9,5,19,0,0,99
19,9,19,19,9,5,19,20,0,119
19,9,19,19,9,6,25,0,0,106
19,9,19,19,9,6,9,5,4,99
19,9,19,19,25,9,19,8,0,127
19,9,19,19,25,9,19,13,0,132
19,9,19,19,9,14,5,19,19,132
19,9,19,19,9,14,7,0,0,96
19,25,19,19,9,20,1,0,0,112
19,25,19,19,9,20,9,1,0,121
19,25,19,19,9,20,9,15,14,149
19,9,19,19,15,14,5,0,0,100
19,9,19,19,15,14,14,5,0,114
19,9,19,19,15,14,14,5,19,133
19,9,19,19,15,15,0,0,0,96
19,9,19,20,0,0,0,0,0,67
19,25,19,20,1,12,20,9,3,128
19,25,19,20,1,19,9,19,0,131
19,25,19,20,1,20,9,3,0,116
19,25,19,20,5,13,0,0,0,101
19,25,19,20,5,13,1,20,25,147
19,25,19,20,5,13,5,4,0,110
19,25,19,20,5,13,9,3,0,113
19,25,19,20,5,13,9,3,19,132
19,25,19,20,5,13,9,19,5,134
19,25,19,20,5,13,9,19,20,149
19,25,19,20,5,13,9,26,5,141
19,25,19,20,5,13,15,9,4,129
19,9,19,20,5,14,0,0,0,86
19,9,19,20,5,14,3,5,0,94
19,9,19,20,5,14,3,25,0,114
19,9,19,20,5,14,20,0,0,106
19,9,19,20,5,18,5,4,0,99
19,9,19,20,5,18,9,14,0,113
19,9,19,20,5,18,9,14,7,120
19,9,19,20,5,18,9,26,5,130
19,9,19,20,5,18,12,25,0,127
19,9,19,20,5,18,14,0,0,104
19,25,19,20,25,12,5,0,0,125
19,25,19,20,9,12,9,21,19,153
19,25,19,20,25,12,15,21,19,175
19,9,19,20,9,14,7,0,0,97
19,9,19,20,12,5,0,0,0,84
19,25,19,20,15,12,5,0,0,115
19,25,19,20,15,12,5,19,0,134
19,25,19,20,15,12,9,3,0,122
19,9,19,20,18,1,0,0,0,86
19,9,19,20,18,5,14,0,0,104
19,9,19,20,18,15,9,4,0,113
19,9,19,20,18,21,13,0,0,119
19,9,19,20,18,21,13,19,0,138
19,9,20,1,15,0,0,0,0,64
19,9,20,1,18,0,0,0,0,67
19,9,20,1,18,9,19,20,0,115
19,9,20,1,18,9,19,20,19,134
19,9,20,1,18,19,0,0,0,86
19,9,20,1,20,21,14,7,1,112
19,9,20,3,8,0,0,0,0,59
19,9,20,3,15,13,0,0,0,79
19,9,20,3,15,13,19,0,0,98
19,9,20,5,0,0,0,0,0,53
19,9,20,5,4,0,0,0,0,57
19,9,20,5,12,12,1,0,0,78
19,9,20,5,19,0,0,0,0,72
19,9,20,6,1,19,20,0,0,94
19,9,20,8,0,0,0,0,0,56
19,9,20,8,3,21,14,4,0,98
19,9,20,8,5,0,0,0,0,61
19,9,20,8,5,13,5,14,20,113
19,9,20,8,5,14,0,0,0,75
19,9,20,8,5,14,3,5,0,83
19,9,20,8,5,14,19,0,0,94
19,9,20,8,5,19,0,0,0,80
19,9,20,9,0,0,0,0,0,57
19,9,20,9,5,14,20,0,0,96
19,9,20,9,14,7,0,0,0,78
19,9,20,9,15,0,0,0,0,72
19,9,20,9,15,12,15,7,25,131
19,9,20,15,12,15,7,25,0,122
19,9,20,15,13,1,14,9,1,101
19,9,20,18,5,16,0,0,0,87
19,9,20,18,9,14,7,5,5,106
19,9,20,19,0,0,0,0,0,67
19,9,20,20,5,5,0,0,0,78
19,9,20,20,5,14,0,0,0,87
19,9,20,20,5,18,19,0,0,110
19,9,20,20,9,14,5,0,0,96
19,9,20,20,9,14,7,0,0,98
19,9,20,20,9,14,7,19,0,117
19,9,20,20,18,9,14,7,25,141
19,9,20,21,0,0,0,0,0,69
19,9,20,21,1,12,0,0,0,82
19,9,20,21,1,20,5,0,0,95
19,9,20,21,1,20,5,4,0,99
19,9,20,21,1,20,5,19,0,114
19,9,20,21,1,20,9,14,7,120
19,9,20,21,1,20,9,15,14,128
19,9,20,21,12,1,0,0,0,82
19,9,20,21,12,1,5,0,0,87
19,9,20,21,16,0,0,0,0,85
19,9,20,21,16,19,0,0,0,104
19,9,20,21,19,0,0,0,0,88
19,9,20,21,19,5,19,0,0,112
19,9,20,21,20,21,14,7,1,132
19,9,20,26,0,0,0,0,0,74
19,9,20,26,2,1,20,8,0,105
19,9,20,26,11,18,9,5,7,124
19,9,20,26,13,1,18,11,0,117
19,9,20,26,13,1,18,11,19,136
19,25,21,4,0,0,0,0,0,69
19,9,21,13,19,0,0,0,0,81
19,25,21,14,0,0,0,0,0,79
19,9,22,1,20,8,5,18,5,107
19,9,22,5,18,0,0,0,0,73
19,9,22,5,18,19,0,0,0,92
19,9,22,22,5,14,19,0,0,110
19,9,23,1,19,8,5,4,0,88
19,9,23,1,19,8,9,14,7,109
19,9,23,5,14,19,0,0,0,89
19,9,24,1,9,14,0,0,0,76
19,9,24,5,18,0,0,0,0,75
19,9,24,6,15,9,12,0,0,94
19,9,24,6,15,12,4,0,0,89
19,9,24,6,15,12,4,19,0,108
19,9,24,7,21,14,0,0,0,94
19,9,24,8,1,5,14,4,0,84
19,9,24,8,25,14,4,5,0,108
19,9,24,9,14,7,0,0,0,82
19,9,24,9,19,8,0,0,0,88
19,9,24,13,15,0,0,0,0,80
19,9,24,13,15,19,0,0,0,99
19,9,24,16,5,14,3,5,0,95
19,9,24,16,5,14,3,5,19,114
19,9,24,16,5,14,14,25,0,126
19,9,24,19,3,15,18,5,0,112
19,9,24,19,15,13,5,0,0,104
19,9,24,20,5,0,0,0,0,77
19,9,24,20,5,5,14,0,0,96
19,9,24,20,5,5,14,5,18,119
19,9,24,20,5,5,14,13,15,124
19,9,24,20,5,5,14,19,0,115
19,9,24,20,5,5,14,20,8,124
19,9,24,20,5,19,0,0,0,96
19,9,24,20,8,0,0,0,0,80
19,9,24,20,8,5,20,0,0,105
19,9,24,20,8,12,25,0,0,117
19,9,24,20,8,19,0,0,0,99
19,9,24,20,25,0,0,0,0,97
19,9,24,20,9,5,19,0,0,105
19,9,24,20,9,5,20,8,0,114
19,9,24,20,9,5,20,8,19,133
19,9,24,20,25,6,15,12,4,134
19,9,26,1,2,12,5,0,0,74
19,9,26,1,2,12,25,0,0,94
19,9,26,1,12,0,0,0,0,67
19,9,26,1,18,0,0,0,0,73
19,9,26,1,18,19,0,0,0,92
19,9,26,1,18,19,8,9,16,125
19,9,26,5,0,0,0,0,0,59
19,9,26,5,1,2,12,5,0,79
19,9,26,5,1,2,12,25,0,99
19,9,26,5,4,0,0,0,0,63
19,9,26,5,9,14,5,0,0,87
19,9,26,5,13,1,14,0,0,87
19,9,26,5,18,0,0,0,0,77
19,9,26,5,18,19,0,0,0,96
19,9,26,5,19,0,0,0,0,78
19,9,26,25,0,0,0,0,0,79
19,9,26,9,5,18,0,0,0,86
19,9,26,9,5,19,20,0,0,107
19,9,26,9,5,19,20,19,0,126
19,25,26,25,7,1,12,0,0,115
19,25,26,25,7,5,20,9,3,139
19,25,26,25,7,25,0,0,0,127
19,9,26,25,7,9,1,0,0,96
19,25,26,25,7,9,1,0,0,112
19,25,26,25,7,9,1,12,0,124
19,25,26,25,7,9,5,19,0,135
19,9,26,25,7,9,21,13,0,129
19,25,26,25,7,9,21,13,0,145
19,9,26,9,14,5,19,19,0,120
19,9,26,9,14,7,0,0,0,84
19,9,26,9,14,7,19,0,0,103
19,9,26,26,0,0,0,0,0,80
19,9,26,26,1,18,4,0,0,103
19,9,26,26,9,14,7,0,0,110
19,9,26,26,12,5,0,0,0,97
19,9,26,26,12,5,4,0,0,101
19,9,26,26,12,5,18,0,0,115
19,9,26,26,12,5,18,19,0,134
19,9,26,26,12,5,19,0,0,116
19,9,26,26,12,9,14,7,0,122
19,10,15,13,9,12,0,0,0,78
19,10,15,13,9,12,1,0,0,79
19,10,15,21,11,5,0,0,0,81
19,11,5,1,14,0,0,0,0,50
19,11,5,1,14,5,0,0,0,55
19,11,5,1,14,5,19,0,0,74
19,11,5,1,14,19,0,0,0,69
19,11,5,4,0,0,0,0,0,39
19,11,5,4,1,4,4,12,5,65
19,11,5,4,7,5,0,0,0,51
19,11,5,4,12,15,3,11,0,80
19,11,5,5,0,0,0,0,0,40
19,11,5,5,2,1,12,12,0,67
19,11,5,5,3,8,0,0,0,51
19,11,5,5,4,0,0,0,0,44
19,11,5,5,7,0,0,0,0,47
19,11,5,5,9,14,7,0,0,70
19,11,5,5,12,0,0,0,0,52
19,11,5,5,12,25,0,0,0,77
19,11,5,5,12,9,14,7,0,82
19,11,5,5,14,0,0,0,0,54
19,11,5,5,14,25,9,5,0,93
19,11,5,5,14,19,0,0,0,73
19,11,5,5,18,0,0,0,0,58
19,11,5,5,18,5,4,0,0,67
19,11,5,5,18,25,0,0,0,83
19,11,5,5,19,9,3,11,19,101
19,11,5,5,20,0,0,0,0,60
19,11,5,5,20,5,18,0,0,83
19,11,5,5,20,5,18,19,0,102
19,11,5,5,20,19,0,0,0,79
19,11,5,5,26,9,3,11,19,108
19,11,5,5,26,9,24,0,0,99
19,11,5,6,0,0,0,0,0,41
19,11,5,7,0,0,0,0,0,42
19,11,5,7,7,5,18,0,0,72
19,11,5,7,19,0,0,0,0,61
19,11,5,25,0,0,0,0,0,60
19,11,5,9,3,8,0,0,0,55
19,11,5,9,6,0,0,0,0,50
19,11,5,9,7,8,0,0,0,59
19,11,5,9,7,8,9,19,8,95
19,11,5,9,12,25,0,0,0,81
19,11,5,9,14,0,0,0,0,58
19,11,5,9,14,5,4,0,0,67
19,11,5,9,14,5,18,0,0,81
19,11,5,9,14,9,14,7,0,88
19,11,5,9,14,19,0,0,0,77
19,11,5,9,16,16,0,0,0,76
19,11,5,25,20,9,14,7,0,110
19,11,5,12,0,0,0,0,0,47
19,11,5,12,4,5,18,0,0,74
19,11,5,12,4,15,3,11,0,80
19,11,5,12,4,18,1,9,11,90
19,11,5,12,4,18,1,11,5,86
19,11,5,12,5,20,0,0,0,72
19,11,5,12,5,20,1,12,0,85
19,11,5,12,5,20,9,14,0,95
19,11,5,12,5,20,15,14,0,101
19,11,5,12,5,20,15,14,25,126
19,11,5,12,5,20,15,14,19,120
19,11,5,12,6,0,0,0,0,53
19,11,5,12,7,15,15,19,5,108
19,11,5,12,9,3,0,0,0,59
19,11,5,12,12,1,20,0,0,80
19,11,5,12,12,5,18,0,0,82
19,11,5,12,12,15,3,8,0,85
19,11,5,12,12,21,13,0,0,93
19,11,5,12,12,21,13,19,0,112
19,11,5,12,13,0,0,0,0,60
19,11,5,12,13,19,0,0,0,79
19,11,5,12,16,0,0,0,0,63
19,11,5,12,16,5,4,0,0,72
19,11,5,12,16,5,18,0,0,86
19,11,5,12,16,9,14,0,0,86
19,11,5,12,16,9,14,7,0,93
19,11,5,12,16,9,20,0,0,92
19,11,5,12,16,19,0,0,0,82
19,11,5,12,20,5,18,0,0,90
19,11,5,12,20,5,18,5,4,99
19,11,5,12,20,5,18,19,0,109
19,11,5,12,22,25,0,0,0,94
19,11,5,13,13,5,12,0,0,78
19,11,5,13,16,0,0,0,0,64
19,11,5,14,0,0,0,0,0,49
19,11,5,14,1,9,0,0,0,59
19,11,5,14,5,19,0,0,0,73
19,11,5,15,0,0,0,0,0,50
19,11,5,15,21,7,8,0,0,86
19,11,5,16,0,0,0,0,0,51
19,11,5,16,6,21,12,0,0,90
19,11,5,16,6,21,12,19,0,109
19,11,5,16,16,5,0,0,0,72
19,11,5,16,16,9,19,20,0,115
19,11,5,16,16,21,14,4,0,106
19,11,5,16,19,0,0,0,0,70
19,11,5,16,19,9,19,0,0,98
19,11,5,16,19,9,19,5,19,122
19,11,5,16,20,9,3,0,0,83
19,11,5,16,20,9,3,1,12,96
19,11,5,16,20,9,3,19,0,102
19,11,5,18,0,0,0,0,0,53
19,11,5,18,5,0,0,0,0,58
19,11,5,18,18,5,20,0,0,96
19,11,5,18,18,25,0,0,0,96
19,11,5,18,18,9,3,11,0,94
19,11,5,18,18,9,5,19,0,104
19,11,5,18,19,0,0,0,0,72
19,11,5,20,0,0,0,0,0,55
19,11,5,20,3,8,0,0,0,66
19,11,5,20,3,8,5,4,0,75
19,11,5,20,3,8,5,5,0,76
19,11,5,20,3,8,5,18,0,89
19,11,5,20,3,8,5,18,19,108
19,11,5,20,3,8,5,19,0,90
19,11,5,20,3,8,25,0,0,91
19,11,5,20,3,8,9,5,18,98
19,11,5,20,3,8,9,12,25,112
19,11,5,20,3,8,9,14,7,96
19,11,5,20,3,8,9,19,20,114
19,11,5,20,3,8,16,1,4,87
19,11,5,20,5,0,0,0,0,60
19,11,5,20,9,15,20,1,9,109
19,11,5,22,9,19,8,0,0,93
19,11,5,23,0,0,0,0,0,58
19,11,5,23,2,1,3,11,0,75
19,11,5,23,2,1,3,11,19,94
19,11,5,23,2,1,12,4,0,77
19,11,5,23,2,1,12,4,19,96
19,11,5,23,5,4,0,0,0,67
19,11,5,23,5,18,0,0,0,81
19,11,5,23,5,18,5,4,0,90
19,11,5,23,5,18,5,18,0,104
19,11,5,23,5,18,9,14,7,111
19,11,5,23,5,18,19,0,0,100
19,11,5,23,25,0,0,0,0,83
19,11,5,23,9,14,7,0,0,88
19,11,5,23,9,14,7,19,0,107
19,11,5,23,12,0,0,0,0,70
19,11,5,23,12,25,0,0,0,95
19,11,5,23,14,5,19,19,0,115
19,11,5,23,19,0,0,0,0,77
19,11,5,23,23,8,9,6,6,110
19,11,5,23,23,9,19,5,0,114
19,11,8,9,1,14,0,0,0,62
19,11,9,0,0,0,0,0,0,39
19,11,9,1,2,12,5,0,0,59
19,11,9,1,7,18,1,13,0,79
19,11,9,1,7,18,1,13,19,98
19,11,9,1,7,18,1,16,8,90
19,11,9,1,13,1,3,8,25,90
19,11,9,1,13,5,20,5,18,101
19,11,9,1,13,5,20,18,25,121
19,11,9,1,16,15,4,0,0,75
19,11,9,1,19,3,15,16,5,98
19,11,9,1,19,3,15,16,25,118
19,11,9,1,20,18,15,14,0,107
19,11,25,2,1,12,0,0,0,70
19,11,25,2,1,12,4,0,0,74
19,11,9,2,2,5,20,0,0,68
19,11,9,2,2,25,0,0,0,68
19,11,9,2,15,2,0,0,0,58
19,11,9,2,15,2,2,5,18,83
19,11,9,2,15,2,19,0,0,77
19,11,25,2,15,18,14,5,0,109
19,11,9,2,19,12,1,19,20,112
19,11,25,3,1,16,0,0,0,75
19,11,25,3,1,16,19,0,0,94
19,11,9,3,5,0,0,0,0,47
19,11,25,3,15,1,3,8,0,85
19,11,25,3,18,1,6,20,0,103
19,11,9,4,0,0,0,0,0,43
19,11,9,4,4,5,4,0,0,56
19,11,9,4,4,5,18,0,0,70
19,11,9,4,4,5,18,19,0,89
19,11,9,4,4,25,0,0,0,72
19,11,9,4,4,9,5,18,0,79
19,11,9,4,4,9,5,19,20,100
19,11,9,4,4,9,14,7,0,77
19,11,9,4,4,15,15,0,0,77
19,11,9,4,4,15,15,5,4,86
19,11,9,4,4,15,15,19,0,96
19,11,25,4,9,22,5,0,0,95
19,11,25,4,9,22,5,4,0,99
19,11,25,4,9,22,5,18,0,113
19,11,25,4,9,22,5,18,19,132
19,11,25,4,9,22,5,19,0,114
19,11,25,4,9,22,9,14,7,120
19,11,9,4,12,9,4,0,0,68
19,11,9,4,15,15,0,0,0,73
19,11,9,4,15,15,5,4,0,82
19,11,9,4,15,15,9,14,7,103
19,11,9,4,15,15,19,0,0,92
19,11,25,4,15,22,5,0,0,101
19,11,9,4,16,1,14,0,0,74
19,11,9,4,16,18,15,15,6,113
19,11,9,4,19,0,0,0,0,62
19,11,9,4,23,1,25,0,0,92
19,11,9,4,23,1,25,19,0,111
19,11,9,5,3,8,0,0,0,55
19,11,9,5,4,0,0,0,0,48
19,11,25,5,4,0,0,0,0,64
19,11,9,5,7,8,0,0,0,59
19,11,9,5,25,0,0,0,0,69
19,11,25,5,25,0,0,0,0,85
19,11,9,5,16,16,5,0,0,81
19,11,9,5,16,16,5,18,0,99
19,11,9,5,18,19,0,0,0,81
19,11,9,5,19,0,0,0,0,63
19,11,9,5,21,18,0,0,0,83
19,11,9,6,6,0,0,0,0,51
19,11,9,6,6,12,5,0,0,68
19,11,9,6,6,12,5,4,0,72
19,11,9,6,6,12,5,19,0,87
19,11,9,6,6,12,5,19,19,106
19,11,9,6,6,12,9,14,7,93
19,11,9,6,6,19,0,0,0,70
19,11,9,6,20,0,0,0,0,65
19,11,25,6,20,5,0,0,0,86
19,11,25,6,21,12,0,0,0,94
19,11,25,8,15,15,11,0,0,104
19,11,25,8,15,15,11,19,0,123
19,11,25,8,15,15,20,0,0,113
19,11,9,9,14,7,0,0,0,69
19,11,25,9,14,7,0,0,0,85
19,11,9,9,14,7,19,0,0,88
19,11,9,9,19,0,0,0,0,67
19,11,25,9,19,8,0,0,0,91
19,11,25,10,1,3,11,0,0,80
19,11,25,10,1,3,11,5,4,89
19,11,25,10,1,3,11,5,18,103
19,11,25,10,1,3,11,19,0,99
19,11,9,10,15,18,5,0,0,87
19,11,9,10,15,18,5,18,0,105
19,11,9,10,15,18,5,18,19,124
19,11,9,10,15,18,9,14,7,112
19,11,9,12,0,0,0,0,0,51
19,11,25,12,1,18,11,0,0,97
19,11,25,12,1,18,11,5,4,106
19,11,25,12,1,18,11,5,18,120
19,11,25,12,1,18,11,19,0,116
19,11,9,12,4,5,18,0,0,78
19,11,9,12,4,6,5,12,0,78
19,11,25,12,5,19,19,0,0,110
19,11,9,12,6,9,19,8,0,93
19,11,9,12,6,21,12,0,0,90
19,11,9,12,6,21,12,12,25,127
19,11,25,12,9,7,8,20,0,111
19,11,25,12,9,7,8,20,19,130
19,11,25,12,9,11,5,0,0,92
19,11,25,12,9,14,5,0,0,95
19,11,25,12,9,14,5,4,0,99
19,11,25,12,9,14,5,19,0,114
19,11,25,12,9,14,9,14,7,120
19,11,25,12,9,20,0,0,0,96
19,11,9,12,12,5,4,0,0,72
19,11,9,12,12,5,19,19,0,106
19,11,9,12,12,5,20,0,0,88
19,11,9,12,12,5,20,19,0,107
19,11,9,12,12,6,21,12,0,102
19,11,9,12,12,25,0,0,0,88
19,11,9,12,12,9,14,7,0,93
19,11,9,12,12,9,14,7,19,112
19,11,9,12,12,9,15,14,0,101
19,11,9,12,12,15,0,0,0,78
19,11,9,12,12,19,0,0,0,82
19,11,25,12,15,15,11,0,0,108
19,11,25,12,15,21,14,7,5,129
19,11,9,12,16,15,20,0,0,102
19,11,9,12,20,25,0,0,0,96
19,11,9,12,20,19,0,0,0,90
19,11,9,13,0,0,0,0,0,52
19,11,25,13,1,14,0,0,0,83
19,11,9,13,2,1,3,11,0,69
19,11,9,13,5,0,0,0,0,57
19,11,25,13,5,14,0,0,0,87
19,11,9,13,13,5,4,0,0,74
19,11,9,13,13,5,18,0,0,88
19,11,9,13,13,5,18,19,0,107
19,11,9,13,13,9,14,7,0,95
19,11,9,13,13,9,14,7,19,114
19,11,9,13,13,9,20,25,0,119
19,11,9,13,16,0,0,0,0,68
19,11,9,13,16,5,4,0,0,77
19,11,9,13,16,25,0,0,0,93
19,11,9,13,16,9,5,18,0,100
19,11,9,13,16,9,5,19,20,121
19,11,9,13,16,9,12,25,0,114
19,11,9,13,16,9,14,7,0,98
19,11,9,13,16,19,0,0,0,87
19,11,9,13,19,0,0,0,0,71
19,11,9,14,0,0,0,0,0,53
19,11,9,14,2,1,12,12,0,80
19,11,9,14,2,15,21,14,4,109
19,11,9,14,3,8,0,0,0,64
19,11,9,14,4,9,22,5,0,93
19,11,9,14,4,9,22,5,18,111
19,11,9,14,6,12,9,3,11,94
19,11,9,14,6,12,9,14,20,114
19,11,9,14,6,21,12,0,0,92
19,11,9,14,6,21,12,19,0,111
19,11,9,14,8,5,1,4,0,71
19,11,9,14,8,5,1,4,19,90
19,11,9,14,11,0,0,0,0,64
19,11,9,14,11,5,4,0,0,73
19,11,9,14,11,5,18,0,0,87
19,11,9,14,11,5,18,19,0,106
19,11,9,14,11,9,14,7,0,94
19,11,9,14,11,12,5,0,0,81
19,11,9,14,11,19,0,0,0,83
19,11,9,14,12,5,19,19,0,108
19,11,9,14,12,9,11,5,0,90
19,11,9,14,14,5,4,0,0,76
19,11,9,14,14,5,18,25,0,115
19,11,9,14,14,5,18,19,0,109
19,11,9,14,14,25,0,0,0,92
19,11,9,14,14,9,5,18,0,99
19,11,9,14,14,9,5,19,20,120
19,11,9,14,14,9,14,7,0,97
19,11,9,14,19,0,0,0,0,72
19,11,9,14,20,0,0,0,0,73
19,11,9,14,20,9,7,8,20,117
19,11,9,14,20,12,5,0,0,90
19,11,9,14,20,12,5,4,0,94
19,11,9,14,20,12,9,14,7,115
19,11,9,14,23,15,18,13,0,122
19,11,9,15,7,18,1,13,0,93
19,11,9,15,7,18,1,16,8,104
19,11,9,15,16,8,25,20,5,128
19,11,9,15,18,9,14,7,0,102
19,11,9,15,18,9,14,7,19,121
19,11,9,16,2,18,1,9,14,99
19,11,9,16,4,5,14,20,0,98
19,11,25,16,8,15,9,0,0,103
19,11,25,16,8,15,19,0,0,113
19,11,25,16,9,16,5,0,0,101
19,11,9,16,10,1,3,11,0,80
19,11,9,16,10,1,3,11,19,99
19,11,9,16,12,1,14,5,0,87
19,11,9,16,12,1,14,5,19,106
19,11,25,16,12,1,19,20,0,123
19,11,9,16,13,1,14,0,0,83
19,11,25,16,15,18,20,0,0,124
19,11,9,16,16,1,2,12,5,91
19,11,9,16,16,5,4,0,0,80
19,11,9,16,16,5,12,0,0,88
19,11,9,16,16,5,18,5,4,103
19,11,9,16,16,5,18,25,0,119
19,11,9,16,16,5,20,0,0,96
19,11,9,16,16,5,20,19,0,115
19,11,9,16,16,9,14,7,0,101
19,11,9,16,16,12,5,0,0,88
19,11,9,16,16,21,14,4,0,110
19,11,9,16,19,0,0,0,0,74
19,11,9,16,20,1,9,12,0,97
19,11,9,16,23,1,25,0,0,104
19,11,25,18,5,0,0,0,0,78
19,11,25,18,9,4,9,14,7,116
19,11,25,18,9,14,0,0,0,96
19,11,9,18,12,0,0,0,0,69
19,11,9,18,12,3,15,3,11,101
19,11,9,18,12,5,4,0,0,78
19,11,9,18,12,9,14,7,0,99
19,11,9,18,12,19,0,0,0,88
19,11,9,18,13,9,19,8,0,106
19,11,25,18,15,3,11,5,20,127
19,11,9,18,16,0,0,0,0,73
19,11,9,18,18,0,0,0,0,75
19,11,9,18,18,5,4,0,0,84
19,11,9,18,18,5,8,0,0,88
19,11,9,18,18,5,20,0,0,100
19,11,9,18,18,5,20,19,0,119
19,11,9,18,18,9,14,7,0,105
19,11,9,18,18,19,0,0,0,94
19,11,9,18,20,0,0,0,0,77
19,11,9,18,20,5,4,0,0,86
19,11,9,18,20,5,18,0,0,100
19,11,9,18,20,5,18,19,0,119
19,11,9,18,20,25,0,0,0,102
19,11,9,18,20,9,14,7,0,107
19,11,9,18,20,9,14,7,19,126
19,11,9,18,20,12,5,19,19,132
19,11,9,18,20,12,9,11,5,114
19,11,9,18,20,19,0,0,0,96
19,11,9,18,23,8,9,20,0,117
19,11,9,18,23,15,18,20,0,133
19,11,9,19,0,0,0,0,0,58
19,11,25,19,0,0,0,0,0,74
19,11,25,19,1,9,12,0,0,96
19,11,25,19,1,9,12,19,0,115
19,11,25,19,3,1,16,5,0,99
19,11,25,19,3,18,1,16,5,117
19,11,25,19,8,9,14,5,0,110
19,11,25,19,20,15,14,5,0,128
19,11,9,20,0,0,0,0,0,59
19,11,9,20,5,0,0,0,0,64
19,11,25,20,5,0,0,0,0,80
19,11,9,20,5,4,0,0,0,68
19,11,9,20,5,18,0,0,0,82
19,11,9,20,5,19,0,0,0,83
19,11,9,20,8,5,18,0,0,90
19,11,9,20,9,14,7,0,0,89
19,11,9,20,9,19,8,12,25,132
19,11,9,20,19,0,0,0,0,78
19,11,9,20,20,5,18,0,0,102
19,11,9,20,20,5,18,5,4,111
19,11,9,20,20,5,18,25,0,127
19,11,9,20,20,5,18,19,0,121
19,11,9,20,20,25,0,0,0,104
19,11,9,20,20,9,19,8,0,115
19,11,9,20,20,12,5,0,0,96
19,11,9,20,20,12,5,4,0,100
19,11,9,20,20,12,5,18,0,114
19,11,9,20,20,12,5,19,0,115
19,11,9,20,20,12,9,14,7,121
19,11,25,21,7,12,5,0,0,100
19,11,9,22,0,0,0,0,0,61
19,11,9,22,5,0,0,0,0,66
19,11,9,22,5,4,0,0,0,70
19,11,9,22,5,18,0,0,0,84
19,11,9,22,5,18,19,0,0,103
19,11,9,22,5,19,0,0,0,85
19,11,9,22,25,0,0,0,0,86
19,11,9,22,9,5,0,0,0,75
19,11,9,22,9,5,19,0,0,94
19,11,9,22,9,14,7,0,0,91
19,11,9,22,22,25,0,0,0,108
19,11,9,22,22,9,5,4,0,101
19,11,25,23,1,25,0,0,0,104
19,11,25,23,1,25,19,0,0,123
19,11,25,23,1,12,11,0,0,102
19,11,25,23,1,12,11,19,0,121
19,11,25,23,1,18,4,0,0,101
19,11,25,23,1,18,4,19,0,120
19,11,25,23,1,22,5,0,0,106
19,11,9,23,5,1,18,0,0,86
19,11,9,23,5,1,18,19,0,105
19,11,9,23,25,0,0,0,0,87
19,11,9,23,9,5,19,0,0,95
19,11,25,23,18,9,20,5,0,130
19,11,25,23,18,9,20,5,18,148
19,11,25,23,18,9,20,5,19,149
19,11,25,23,18,15,20,5,0,136
19,11,12,1,20,5,0,0,0,68
19,11,12,1,20,5,18,0,0,86
19,11,12,5,14,20,0,0,0,81
19,11,12,5,14,20,5,4,0,90
19,11,12,5,14,20,9,14,7,111
19,11,12,5,14,20,19,0,0,100
19,11,12,9,14,20,5,18,0,108
19,11,15,1,12,0,0,0,0,58
19,11,15,1,12,5,4,0,0,67
19,11,15,1,12,9,14,7,0,88
19,11,15,1,12,19,0,0,0,77
19,11,15,11,9,1,1,14,0,81
19,11,15,12,0,0,0,0,0,57
19,11,15,12,12,25,0,0,0,94
19,11,15,13,5,18,9,20,5,115
19,11,15,15,0,0,0,0,0,60
19,11,15,15,11,21,13,0,0,105
19,11,15,15,20,0,0,0,0,80
19,11,15,16,20,19,25,0,0,125
19,11,15,21,20,0,0,0,0,86
19,11,15,21,20,8,0,0,0,94
19,11,18,1,5,12,9,14,7,96
19,11,18,1,9,7,8,0,0,73
19,11,18,5,5,7,8,0,0,73
19,11,18,5,5,7,8,5,4,82
19,11,18,5,5,7,8,19,0,92
19,11,18,5,5,12,0,0,0,70
19,11,18,5,9,7,8,0,0,77
19,11,18,5,9,7,8,5,4,86
19,11,18,5,9,7,8,19,0,96
19,11,18,25,5,18,0,0,0,96
19,11,18,9,11,5,0,0,0,73
19,11,18,21,16,21,12,0,0,118
19,11,21,1,0,0,0,0,0,52
19,11,21,1,19,0,0,0,0,71
19,11,21,12,11,0,0,0,0,74
19,11,21,12,11,5,4,0,0,83
19,11,21,12,11,5,18,0,0,97
19,11,21,12,11,5,18,19,0,116
19,11,21,12,11,9,14,7,0,104
19,11,21,12,11,19,0,0,0,93
19,11,21,12,12,0,0,0,0,75
19,11,21,12,12,3,1,16,0,95
19,11,21,12,12,3,1,16,19,114
19,11,21,12,12,5,4,0,0,84
19,11,21,12,12,5,18,25,0,123
19,11,21,12,12,6,9,19,8,117
19,11,21,12,12,6,21,12,0,114
19,11,21,12,12,25,0,0,0,100
19,11,21,12,12,19,0,0,0,94
19,11,21,12,16,0,0,0,0,79
19,11,21,14,0,0,0,0,0,65
19,11,21,14,11,0,0,0,0,76
19,11,21,14,11,2,9,12,12,111
19,11,21,14,11,2,21,19,8,126
19,11,21,14,11,4,15,13,0,108
19,11,21,14,11,5,4,0,0,85
19,11,21,14,11,5,18,25,0,124
19,11,21,14,11,8,5,1,4,94
19,11,21,14,11,25,0,0,0,101
19,11,21,14,11,9,14,7,0,106
19,11,21,14,11,9,19,8,0,112
19,11,21,14,11,12,5,20,0,113
19,11,21,14,11,19,0,0,0,95
19,11,21,14,11,20,15,16,0,127
19,11,21,14,11,23,5,5,4,113
19,11,21,18,18,25,0,0,0,112
19,11,21,19,5,0,0,0,0,75
19,12,4,0,0,0,0,0,0,35
19,12,5,1,20,8,25,0,0,90
19,12,5,1,22,5,0,0,0,64
19,12,5,1,22,5,4,0,0,68
19,12,5,1,22,5,19,0,0,83
19,12,5,1,22,9,14,7,0,89
19,12,5,1,26,5,0,0,0,68
19,12,5,1,26,5,19,0,0,87
19,12,5,1,26,25,0,0,0,88
19,12,5,1,26,9,5,18,0,95
19,12,5,1,26,9,5,19,20,116
19,12,5,1,26,9,12,25,0,109
19,12,5,1,26,15,0,0,0,78
19,12,5,3,11,0,0,0,0,50
19,12,5,4,4,5,4,0,0,53
19,12,5,4,4,5,18,0,0,67
19,12,5,4,4,5,18,19,0,86
19,12,5,4,4,9,14,7,0,74
19,12,5,4,4,9,14,7,19,93
19,12,5,4,6,21,12,0,0,79
19,12,5,4,7,5,0,0,0,52
19,12,5,4,7,5,4,0,0,56
19,12,5,4,7,5,18,0,0,70
19,12,5,4,7,5,19,0,0,71
19,12,5,4,7,9,14,7,0,77
19,12,5,4,12,9,11,5,0,77
19,12,5,4,19,0,0,0,0,59
19,12,5,5,0,0,0,0,0,41
19,12,5,5,3,8,0,0,0,52
19,12,5,5,3,8,25,0,0,77
19,12,5,5,11,0,0,0,0,52
19,12,5,5,11,5,4,0,0,61
19,12,5,5,11,5,14,0,0,71
19,12,5,5,11,5,14,5,4,80
19,12,5,5,11,5,14,19,0,90
19,12,5,5,11,5,18,0,0,75
19,12,5,5,11,5,19,20,0,96
19,12,5,5,11,25,0,0,0,77
19,12,5,5,11,9,5,18,0,84
19,12,5,5,11,9,5,19,20,105
19,12,5,5,11,9,14,7,0,82
19,12,5,5,11,9,20,0,0,81
19,12,5,5,11,12,25,0,0,89
19,12,5,5,11,14,5,19,19,109
19,12,5,5,11,19,0,0,0,71
19,12,5,5,16,3,15,1,20,96
19,12,5,5,16,5,18,0,0,80
19,12,5,5,16,5,18,5,4,89
19,12,5,5,16,6,21,12,0,96
19,12,5,5,16,25,0,0,0,82
19,12,5,5,16,9,5,18,0,89
19,12,5,5,16,9,5,19,20,110
19,12,5,5,16,9,6,25,0,97
19,12,5,5,16,9,12,25,0,103
19,12,5,5,16,9,14,7,0,87
19,12,5,5,16,9,14,7,19,106
19,12,5,5,16,9,19,8,0,93
19,12,5,5,16,12,1,14,4,88
19,12,5,5,16,12,5,19,19,112
19,12,5,5,16,12,9,11,5,94
19,12,5,5,16,18,25,0,0,100
19,12,5,5,16,19,0,0,0,76
19,12,5,5,16,23,1,12,11,104
19,12,5,5,16,23,1,18,4,103
19,12,5,5,16,23,5,1,18,104
19,12,5,5,16,23,15,18,20,133
19,12,5,5,18,0,0,0,0,59
19,12,5,5,20,0,0,0,0,61
19,12,5,5,20,5,4,0,0,70
19,12,5,5,20,25,0,0,0,86
19,12,5,5,20,9,5,18,0,93
19,12,5,5,20,9,5,19,20,114
19,12,5,5,20,9,14,7,0,91
19,12,5,5,20,19,0,0,0,80
19,12,5,5,22,5,0,0,0,68
19,12,5,5,22,5,4,0,0,72
19,12,5,5,22,5,5,14,0,87
19,12,5,5,22,5,6,21,12,107
19,12,5,5,22,5,12,5,20,105
19,12,5,5,22,5,18,0,0,86
19,12,5,5,22,5,19,0,0,87
19,12,5,5,22,9,14,7,0,93
19,12,5,5,26,25,0,0,0,92
19,12,5,25,0,0,0,0,0,61
19,12,5,9,4,5,4,0,0,58
19,12,5,25,5,4,0,0,0,70
19,12,5,25,5,18,0,0,0,84
19,12,5,9,7,8,0,0,0,60
19,12,5,9,7,8,5,4,0,69
19,12,5,9,7,8,5,18,0,83
19,12,5,9,7,8,5,18,19,102
19,12,5,9,7,8,9,14,7,90
19,12,5,9,7,8,19,0,0,79
19,12,5,9,7,8,20,0,0,80
19,12,5,9,7,8,20,25,0,105
19,12,5,9,7,8,20,19,0,99
19,12,5,25,9,14,7,0,0,91
19,12,5,25,19,0,0,0,0,80
19,12,5,14,4,1,14,7,0,76
19,12,5,14,4,5,18,0,0,77
19,12,5,14,4,5,18,5,18,100
19,12,5,14,4,5,18,12,25,114
19,12,5,14,20,0,0,0,0,70
19,12,5,16,5,26,0,0,0,83
19,12,5,16,20,0,0,0,0,72
19,12,5,20,5,0,0,0,0,61
19,12,5,21,20,8,0,0,0,85
19,12,5,21,20,8,4,15,7,111
19,12,5,21,20,8,5,4,0,94
19,12,5,21,20,8,6,21,12,124
19,12,5,21,20,8,9,14,7,115
19,12,5,21,20,8,19,0,0,104
19,12,5,23,0,0,0,0,0,59
19,12,5,23,5,4,0,0,0,68
19,12,5,23,5,18,0,0,0,82
19,12,5,23,9,14,7,0,0,89
19,12,5,23,19,0,0,0,0,78
19,12,5,23,20,8,0,0,0,87
19,12,25,2,15,15,20,19,0,127
19,12,9,3,5,0,0,0,0,48
19,12,9,3,5,1,2,12,5,68
19,12,9,3,5,4,0,0,0,52
19,12,9,3,5,18,0,0,0,66
19,12,9,3,5,18,19,0,0,85
19,12,9,3,5,19,0,0,0,67
19,12,9,3,8,0,0,0,0,51
19,12,9,3,8,20,0,0,0,71
19,12,9,3,9,14,7,0,0,73
19,12,9,3,9,14,7,12,25,110
19,12,9,3,11,0,0,0,0,54
19,12,9,3,11,5,4,0,0,63
19,12,9,3,11,5,14,0,0,73
19,12,9,3,11,5,14,19,0,92
19,12,9,3,11,5,18,0,0,77
19,12,9,3,11,5,18,5,4,86
19,12,9,3,11,5,18,25,0,102
19,12,9,3,11,5,18,19,0,96
19,12,9,3,11,5,19,20,0,98
19,12,9,3,11,9,14,7,0,84
19,12,9,3,11,12,25,0,0,91
19,12,9,3,11,14,5,19,19,111
19,12,9,3,11,19,0,0,0,73
19,12,9,4,0,0,0,0,0,44
19,12,9,4,1,2,12,5,0,64
19,12,9,4,1,2,12,25,0,84
19,12,9,4,1,7,5,0,0,57
19,12,9,4,4,5,14,0,0,67
19,12,9,4,4,5,18,0,0,71
19,12,9,4,4,5,18,25,0,96
19,12,9,4,4,18,25,0,0,91
19,12,9,4,5,0,0,0,0,49
19,12,9,4,5,1,2,12,5,69
19,12,9,4,5,1,2,12,25,89
19,12,9,4,5,4,0,0,0,53
19,12,9,4,5,6,9,12,13,89
19,12,9,4,5,8,5,1,4,67
19,12,9,4,5,11,14,15,20,109
19,12,9,4,5,13,1,14,0,77
19,12,9,4,5,18,0,0,0,67
19,12,9,4,5,18,19,0,0,86
19,12,9,4,5,19,0,0,0,68
19,12,9,4,5,23,1,25,0,98
19,12,9,4,5,23,1,25,19,117
19,12,9,4,9,14,7,0,0,74
19,12,9,4,9,14,7,12,25,111
19,12,9,5,18,0,0,0,0,63
19,12,25,5,18,0,0,0,0,79
19,12,9,5,19,20,0,0,0,84
19,12,25,5,19,20,0,0,0,100
19,12,9,6,20,5,18,0,0,89
19,12,9,7,7,5,5,14,0,78
19,12,9,7,8,20,0,0,0,75
19,12,9,7,8,20,5,4,0,84
19,12,9,7,8,20,5,14,0,94
19,12,9,7,8,20,5,18,0,98
19,12,9,7,8,20,5,19,20,119
19,12,9,7,8,20,25,0,0,100
19,12,9,7,8,20,9,5,18,107
19,12,9,7,8,20,9,12,25,121
19,12,9,7,8,20,9,14,7,105
19,12,9,7,8,20,9,19,8,111
19,12,9,7,8,20,12,25,0,112
19,12,9,7,8,20,19,0,0,94
19,12,25,9,19,8,0,0,0,92
19,12,9,11,0,0,0,0,0,51
19,12,9,12,25,0,0,0,0,77
19,12,25,12,25,0,0,0,0,93
19,12,9,13,5,0,0,0,0,58
19,12,9,13,5,4,0,0,0,62
19,12,9,13,5,13,1,14,0,86
19,12,9,13,5,13,5,14,0,90
19,12,9,13,5,16,9,20,0,103
19,12,9,13,5,18,0,0,0,76
19,12,9,13,5,19,0,0,0,77
19,12,9,13,25,0,0,0,0,78
19,12,9,13,9,5,18,0,0,85
19,12,9,13,9,5,19,20,0,106
19,12,9,13,9,12,25,0,0,99
19,12,9,13,9,14,5,19,19,119
19,12,9,13,9,14,7,0,0,83
19,12,9,13,9,19,8,0,0,89
19,12,9,13,12,25,0,0,0,90
19,12,9,13,12,9,14,5,0,93
19,12,9,13,13,5,4,0,0,75
19,12,9,13,13,5,18,0,0,89
19,12,9,13,13,5,19,20,0,110
19,12,9,13,13,9,14,7,0,96
19,12,9,13,13,9,19,8,0,102
19,12,9,13,14,5,19,19,0,110
19,12,9,13,16,19,25,0,0,113
19,12,9,13,16,19,9,5,18,120
19,12,9,13,19,0,0,0,0,72
19,12,9,13,19,25,0,0,0,97
19,12,9,13,19,9,5,18,0,104
19,12,9,13,19,9,5,19,20,125
19,12,9,14,5,0,0,0,0,59
19,12,25,14,5,19,19,0,0,113
19,12,25,14,5,19,19,5,19,137
19,12,9,14,7,0,0,0,0,61
19,12,9,14,7,2,1,3,11,78
19,12,9,14,7,2,1,12,12,88
19,12,9,14,7,5,0,0,0,66
19,12,9,14,7,5,18,19,0,103
19,12,9,14,7,9,14,7,0,91
19,12,9,14,7,13,1,14,0,89
19,12,9,14,7,19,0,0,0,80
19,12,9,14,7,19,8,15,20,123
19,12,9,14,7,19,13,1,14,108
19,12,9,14,7,19,13,5,14,112
19,12,9,14,11,0,0,0,0,65
19,12,9,14,11,5,4,0,0,74
19,12,9,14,11,5,18,0,0,88
19,12,9,14,11,25,0,0,0,90
19,12,9,14,11,9,5,18,0,97
19,12,9,14,11,9,5,19,20,118
19,12,9,14,11,9,12,25,0,111
19,12,9,14,11,9,14,7,0,95
19,12,9,14,11,19,0,0,0,84
19,12,9,14,11,19,11,9,14,118
19,12,9,14,11,23,5,5,4,102
19,12,9,14,20,5,0,0,0,79
19,12,9,16,2,1,3,11,0,73
19,12,9,16,2,1,14,4,0,77
19,12,9,16,2,15,1,18,4,96
19,12,9,16,2,15,4,25,0,102
19,12,9,16,3,1,19,5,0,84
19,12,9,16,3,1,19,5,19,103
19,12,9,16,3,15,1,3,8,86
19,12,9,16,3,15,1,20,0,95
19,12,9,16,3,15,22,5,18,119
19,12,9,16,5,0,0,0,0,61
19,12,25,16,5,0,0,0,0,77
19,12,9,16,5,4,0,0,0,65
19,12,9,16,5,19,0,0,0,80
19,12,25,16,5,19,0,0,0,96
19,12,9,16,6,15,18,13,0,108
19,12,9,16,6,15,18,13,19,127
19,12,9,16,8,15,18,14,0,111
19,12,9,16,8,15,21,19,5,124
19,12,9,16,9,14,7,0,0,86
19,12,9,16,11,14,15,20,0,116
19,12,9,16,11,14,15,20,19,135
19,12,9,16,12,5,19,19,0,111
19,12,9,16,13,1,14,0,0,84
19,12,9,16,14,15,15,19,5,124
19,12,9,16,15,21,20,0,0,112
19,12,9,16,15,21,20,19,0,131
19,12,9,16,15,22,5,18,0,116
19,12,9,16,15,22,5,18,19,135
19,12,9,16,16,1,7,5,0,85
19,12,9,16,16,1,7,5,19,104
19,12,9,16,16,5,4,0,0,81
19,12,9,16,16,5,18,0,0,95
19,12,9,16,16,5,18,5,4,104
19,12,9,16,16,5,18,25,0,120
19,12,9,16,16,5,18,19,0,114
19,12,9,16,16,25,0,0,0,97
19,12,9,16,16,9,5,18,0,104
19,12,9,16,16,9,5,19,20,125
19,12,9,16,16,9,14,7,0,102
19,12,9,16,16,18,15,15,6,126
19,12,9,16,18,1,9,12,0,96
19,12,9,16,19,0,0,0,0,75
19,12,9,16,19,8,5,5,20,113
19,12,9,16,19,8,15,4,0,102
19,12,9,16,19,8,15,5,0,103
19,12,9,16,19,11,9,14,0,109
19,12,9,16,19,12,1,16,0,104
19,12,9,16,19,12,15,16,0,118
19,12,9,16,19,12,15,16,19,137
19,12,9,16,19,15,12,5,0,107
19,12,9,16,19,15,12,5,19,126
19,12,9,16,19,20,5,16,0,116
19,12,9,16,19,20,9,3,11,118
19,12,9,16,19,20,15,14,5,129
19,12,9,16,20,0,0,0,0,76
19,12,9,16,21,16,0,0,0,93
19,12,9,16,21,16,19,0,0,112
19,12,9,16,23,1,25,0,0,105
19,12,9,16,23,1,25,19,0,124
19,12,9,16,23,1,18,5,0,103
19,12,9,16,23,1,18,5,19,122
19,12,9,18,20,0,0,0,0,78
19,12,9,19,8,0,0,0,0,67
19,12,9,20,0,0,0,0,0,60
19,12,9,20,3,8,0,0,0,71
19,12,9,20,5,0,0,0,0,65
19,12,9,20,8,5,18,0,0,91
19,12,9,20,8,5,18,5,4,100
19,12,9,20,8,5,18,25,0,116
19,12,9,20,8,5,18,15,15,121
19,12,9,20,8,5,18,19,0,110
19,12,9,20,8,25,0,0,0,93
19,12,9,20,9,14,7,0,0,90
19,12,9,20,12,5,19,19,0,115
19,12,9,20,12,9,11,5,0,97
19,12,9,20,19,0,0,0,0,79
19,12,9,20,19,8,5,12,12,116
19,12,9,20,20,5,4,0,0,89
19,12,9,20,20,5,18,0,0,103
19,12,9,20,20,5,18,19,0,122
19,12,9,20,20,25,0,0,0,105
19,12,9,20,20,9,14,7,0,110
19,12,9,20,23,9,14,7,0,113
19,12,9,20,23,9,19,5,0,116
19,12,9,20,23,15,18,11,0,127
19,12,9,22,5,0,0,0,0,67
19,12,9,22,5,18,0,0,0,85
19,12,9,22,5,18,5,4,0,94
19,12,9,22,5,18,5,18,0,108
19,12,9,22,5,18,5,18,19,127
19,12,9,22,5,18,25,0,0,110
19,12,9,22,5,18,9,14,7,115
19,12,9,22,5,18,19,0,0,104
19,12,9,22,9,14,7,0,0,92
19,12,9,22,15,22,9,3,0,111
19,12,9,22,15,22,9,3,19,130
19,12,9,22,15,22,9,20,26,154
19,12,9,23,5,18,0,0,0,86
19,12,15,1,20,0,0,0,0,67
19,12,15,2,0,0,0,0,0,48
19,12,15,2,2,5,18,0,0,73
19,12,15,2,2,5,18,5,4,82
19,12,15,2,2,5,18,5,18,96
19,12,15,2,2,5,18,25,0,98
19,12,15,2,2,5,18,19,0,92
19,12,15,2,2,25,0,0,0,75
19,12,15,2,2,9,19,8,0,86
19,12,15,2,19,0,0,0,0,67
19,12,15,3,11,0,0,0,0,60
19,12,15,3,11,5,14,0,0,79
19,12,15,3,11,5,18,0,0,83
19,12,15,3,11,19,20,5,18,122
19,12,15,4,0,0,0,0,0,50
19,12,15,4,4,5,18,0,0,77
19,12,15,4,7,5,0,0,0,62
19,12,15,4,7,5,18,0,0,80
19,12,15,5,0,0,0,0,0,51
19,12,15,5,2,5,18,18,25,119
19,12,15,5,2,21,19,8,0,101
19,12,15,5,19,0,0,0,0,70
19,12,15,5,20,18,5,5,0,99
19,12,15,7,0,0,0,0,0,53
19,12,15,7,1,14,0,0,0,68
19,12,15,7,1,14,5,5,18,96
19,12,15,7,1,14,9,26,5,108
19,12,15,7,1,14,19,0,0,87
19,12,15,7,7,5,4,0,0,69
19,12,15,7,7,5,18,0,0,83
19,12,15,7,7,5,18,19,0,102
19,12,15,7,7,9,14,7,0,90
19,12,15,7,19,0,0,0,0,72
19,12,15,7,23,15,15,4,0,110
19,12,15,9,4,0,0,0,0,59
19,12,15,25,4,0,0,0,0,75
19,12,15,9,4,19,0,0,0,78
19,12,15,25,4,19,0,0,0,94
19,12,15,10,4,0,0,0,0,60
19,12,15,10,4,19,0,0,0,79
19,12,15,11,1,0,0,0,0,58
19,12,15,11,5,0,0,0,0,62
19,12,15,11,5,4,0,0,0,66
19,12,15,11,5,14,0,0,0,76
19,12,15,11,9,14,7,0,0,87
19,12,15,13,13,1,3,11,0,87
19,12,15,13,13,1,3,11,25,112
19,12,15,13,13,15,3,11,0,101
19,12,15,14,0,0,0,0,0,60
19,12,15,14,5,0,0,0,0,65
19,12,15,14,11,0,0,0,0,71
19,12,15,15,0,0,0,0,0,61
19,12,15,15,13,0,0,0,0,74
19,12,15,15,13,25,0,0,0,99
19,12,15,15,16,0,0,0,0,77
19,12,15,15,16,13,1,14,0,105
19,12,15,15,16,13,5,14,0,109
19,12,15,15,16,19,0,0,0,96
19,12,15,15,19,8,0,0,0,88
19,12,15,15,20,0,0,0,0,81
19,12,15,16,0,0,0,0,0,62
19,12,15,16,4,1,19,8,0,94
19,12,15,16,5,0,0,0,0,67
19,12,15,16,5,4,0,0,0,71
19,12,15,16,5,12,25,0,0,104
19,12,15,16,5,14,5,19,19,124
19,12,15,16,5,18,0,0,0,85
19,12,15,16,5,18,19,0,0,104
19,12,15,16,5,19,0,0,0,86
19,12,15,16,5,23,1,25,19,135
19,12,15,16,5,23,9,19,5,123
19,12,15,16,25,0,0,0,0,87
19,12,15,16,9,14,7,0,0,92
19,12,15,16,9,14,7,12,25,129
19,12,15,16,13,1,11,5,18,110
19,12,15,16,16,1,7,5,0,91
19,12,15,16,16,5,4,0,0,87
19,12,15,16,16,5,18,25,0,126
19,12,15,16,16,25,0,0,0,103
19,12,15,16,16,9,5,18,0,110
19,12,15,16,16,9,5,19,20,131
19,12,15,16,16,9,12,25,0,124
19,12,15,16,16,9,14,7,0,108
19,12,15,16,19,0,0,0,0,81
19,12,15,16,19,8,15,16,0,120
19,12,15,16,19,20,15,14,5,135
19,12,15,16,23,15,18,11,0,129
19,12,15,16,23,15,18,11,19,148
19,12,15,18,16,0,0,0,0,80
19,12,15,19,8,0,0,0,0,73
19,12,15,19,8,5,4,0,0,82
19,12,15,19,8,5,18,0,0,96
19,12,15,19,8,5,19,0,0,97
19,12,15,19,8,25,0,0,0,98
19,12,15,19,8,9,5,18,0,105
19,12,15,19,8,9,5,19,20,126
19,12,15,19,8,9,12,25,0,119
19,12,15,19,8,9,14,7,0,103
19,12,15,20,0,0,0,0,0,66
19,12,15,20,2,1,3,11,0,83
19,12,15,20,2,1,3,11,19,102
19,12,15,20,5,0,0,0,0,71
19,12,15,20,5,4,0,0,0,75
19,12,15,20,8,0,0,0,0,74
19,12,15,20,8,6,21,12,0,113
19,12,15,20,8,6,21,12,19,132
19,12,15,20,8,15,21,14,4,128
19,12,15,20,8,19,0,0,0,93
19,12,15,20,13,1,14,0,0,94
19,12,15,20,19,0,0,0,0,85
19,12,15,20,20,5,4,0,0,95
19,12,15,20,20,5,14,0,0,105
19,12,15,20,20,5,18,0,0,109
19,12,15,20,20,5,18,25,0,134
19,12,15,20,20,9,14,7,0,116
19,12,15,20,23,9,19,5,0,122
19,12,15,21,2,2,9,5,0,85
19,12,15,21,3,8,0,0,0,78
19,12,15,21,3,8,5,4,0,87
19,12,15,21,3,8,5,18,0,101
19,12,15,21,3,8,5,18,19,120
19,12,15,21,3,8,5,19,0,102
19,12,15,21,3,8,25,0,0,103
19,12,15,21,3,8,9,5,18,110
19,12,15,21,3,8,9,12,25,124
19,12,15,21,3,8,9,14,7,108
19,12,15,21,7,8,5,4,0,91
19,12,15,21,7,8,25,0,0,107
19,12,15,21,7,8,9,5,18,114
19,12,15,21,7,8,9,14,7,112
19,12,15,21,7,8,19,0,0,101
19,12,15,21,14,7,5,0,0,93
19,12,15,21,14,7,5,18,0,111
19,12,15,21,18,0,0,0,0,85
19,12,15,21,19,8,0,0,0,94
19,12,15,22,1,11,19,0,0,99
19,12,15,22,5,14,0,0,0,87
19,12,15,22,5,14,12,25,0,124
19,12,15,22,5,14,18,25,0,130
19,12,15,22,5,14,19,0,0,106
19,12,15,23,0,0,0,0,0,69
19,12,15,23,2,1,3,11,0,86
19,12,15,23,2,5,12,12,25,125
19,12,15,23,3,15,1,3,8,99
19,12,15,23,4,15,23,14,0,125
19,12,15,23,4,15,23,14,19,144
19,12,15,23,5,4,0,0,0,78
19,12,15,23,5,18,0,0,0,92
19,12,15,23,5,19,20,0,0,113
19,12,15,23,6,21,12,0,0,108
19,12,15,23,7,15,9,14,7,121
19,12,15,23,8,15,21,14,4,131
19,12,15,23,9,14,7,0,0,99
19,12,15,23,9,19,8,0,0,105
19,12,15,23,12,25,0,0,0,106
19,12,15,23,14,5,19,19,0,126
19,12,15,23,16,15,11,5,0,116
19,12,15,23,16,15,11,5,19,135
19,12,15,23,18,9,5,0,0,101
19,12,15,23,19,0,0,0,0,88
19,12,15,23,21,16,0,0,0,106
19,12,15,23,23,15,18,13,0,138
19,12,15,23,23,15,18,13,19,157
19,12,20,0,0,0,0,0,0,51
19,12,21,2,0,0,0,0,0,54
19,12,21,2,2,5,4,0,0,65
19,12,21,2,2,5,18,0,0,79
19,12,21,2,2,5,18,5,4,88
19,12,21,2,2,5,18,5,18,102
19,12,21,2,2,5,18,25,0,104
19,12,21,2,2,5,18,12,25,116
19,12,21,2,2,5,18,19,0,98
19,12,21,2,2,25,0,0,0,81
19,12,21,2,2,9,14,7,0,86
19,12,21,2,2,9,14,7,19,105
19,12,21,2,19,0,0,0,0,73
19,12,21,4,0,0,0,0,0,56
19,12,21,4,4,5,18,0,0,83
19,12,21,4,4,5,18,25,0,108
19,12,21,4,7,5,0,0,0,68
19,12,21,4,7,5,4,0,0,72
19,12,21,4,7,5,18,0,0,86
19,12,21,4,7,5,19,0,0,87
19,12,21,4,7,25,0,0,0,88
19,12,21,4,7,9,5,18,0,95
19,12,21,4,7,9,5,19,20,116
19,12,21,4,7,9,14,7,0,93
19,12,21,5,0,0,0,0,0,57
19,12,21,5,4,0,0,0,0,61
19,12,21,5,18,0,0,0,0,75
19,12,21,5,19,0,0,0,0,76
19,12,21,6,6,0,0,0,0,64
19,12,21,6,6,5,4,0,0,73
19,12,21,6,6,9,14,7,0,94
19,12,21,6,6,19,0,0,0,83
19,12,21,7,0,0,0,0,0,59
19,12,21,7,1,2,5,4,0,71
19,12,21,7,1,2,5,4,19,90
19,12,21,7,6,5,19,20,0,109
19,12,21,7,6,5,19,20,19,128
19,12,21,7,7,1,18,4,0,89
19,12,21,7,7,1,18,4,25,114
19,12,21,7,7,1,18,4,19,108
19,12,21,7,7,5,4,0,0,75
19,12,21,7,7,5,18,0,0,89
19,12,21,7,7,5,18,19,0,108
19,12,21,7,7,25,0,0,0,91
19,12,21,7,7,9,14,7,0,96
19,12,21,7,7,9,19,8,0,102
19,12,21,7,8,15,18,14,0,114
19,12,21,7,12,9,11,5,0,96
19,12,21,7,19,0,0,0,0,78
19,12,21,7,23,15,15,4,0,116
19,12,21,9,3,5,0,0,0,69
19,12,21,9,3,5,4,0,0,73
19,12,21,9,3,5,18,0,0,87
19,12,21,9,3,5,19,0,0,88
19,12,21,9,3,5,23,1,25,118
19,12,21,9,3,25,0,0,0,89
19,12,21,9,3,9,14,7,0,94
19,12,21,9,7,0,0,0,0,68
19,12,21,9,14,7,0,0,0,82
19,12,21,9,20,0,0,0,0,81
19,12,21,13,0,0,0,0,0,65
19,12,21,13,2,5,18,0,0,90
19,12,21,13,2,5,18,5,4,99
19,12,21,13,2,5,18,5,18,113
19,12,21,13,2,5,18,25,0,115
19,12,21,13,2,5,18,19,0,109
19,12,21,13,2,18,15,21,19,140
19,12,21,13,4,15,13,0,0,97
19,12,21,13,7,21,13,0,0,106
19,12,21,13,7,21,13,19,0,125
19,12,21,13,9,19,13,0,0,106
19,12,21,13,9,19,13,19,0,125
19,12,21,13,12,1,14,4,0,96
19,12,21,13,12,9,11,5,0,102
19,12,21,13,12,15,18,4,0,114
19,12,21,13,12,15,18,4,19,133
19,12,21,13,13,1,7,5,0,91
19,12,21,13,13,5,4,0,0,87
19,12,21,13,13,5,18,0,0,101
19,12,21,13,13,5,18,19,0,120
19,12,21,13,13,25,0,0,0,103
19,12,21,13,13,9,5,18,0,110
19,12,21,13,13,9,5,19,20,131
19,12,21,13,13,9,14,7,0,108
19,12,21,13,13,15,3,11,0,107
19,12,21,13,13,15,3,11,25,132
19,12,21,13,16,5,4,0,0,90
19,12,21,13,16,25,0,0,0,106
19,12,21,13,16,9,14,7,0,111
19,12,21,13,16,18,15,15,6,135
19,12,21,13,16,19,0,0,0,100
19,12,21,13,16,23,15,18,11,148
19,12,21,13,19,0,0,0,0,84
19,12,21,13,23,1,18,4,0,111
19,12,21,13,23,9,19,5,0,121
19,12,21,14,7,0,0,0,0,73
19,12,21,14,7,2,15,4,25,119
19,12,21,14,7,5,0,0,0,78
19,12,21,14,7,19,8,15,20,135
19,12,21,14,11,0,0,0,0,77
19,12,21,14,11,5,14,0,0,96
19,12,21,16,0,0,0,0,0,68
19,12,21,18,0,0,0,0,0,70
19,12,21,18,2,0,0,0,0,72
19,12,21,18,2,1,14,0,0,87
19,12,21,18,2,15,23,0,0,110
19,12,21,18,2,19,0,0,0,91
19,12,21,18,16,0,0,0,0,86
19,12,21,18,16,5,4,0,0,95
19,12,21,18,16,9,14,7,0,116
19,12,21,18,16,19,0,0,0,105
19,12,21,18,18,5,4,0,0,97
19,12,21,18,18,25,0,0,0,113
19,12,21,18,18,9,5,4,0,106
19,12,21,18,18,9,5,19,0,121
19,12,21,18,18,25,9,14,7,143
19,12,21,18,18,9,14,7,0,118
19,12,21,18,19,0,0,0,0,89
19,12,21,18,22,9,1,14,0,116
19,12,21,19,8,0,0,0,0,79
19,12,21,19,8,5,4,0,0,88
19,12,21,19,8,5,18,0,0,102
19,12,21,19,8,5,19,0,0,103
19,12,21,19,8,25,0,0,0,104
19,12,21,19,8,9,5,18,0,111
19,12,21,19,8,9,5,19,20,132
19,12,21,19,8,9,12,25,0,125
19,12,21,19,8,9,14,7,0,109
19,12,21,19,8,16,9,20,0,124
19,12,21,20,0,0,0,0,0,72
19,12,21,20,3,8,0,0,0,83
19,12,21,20,3,8,25,0,0,108
19,12,21,20,8,5,18,0,0,103
19,12,21,20,8,15,15,4,0,114
19,12,21,20,19,0,0,0,0,91
19,12,21,20,20,5,4,0,0,101
19,12,21,20,20,5,18,0,0,115
19,12,21,20,20,5,18,5,4,124
19,12,21,20,20,5,18,25,0,140
19,12,21,20,20,25,0,0,0,117
19,12,21,20,20,9,11,9,14,135
19,12,21,20,20,9,14,7,0,122
19,12,21,20,20,9,19,8,0,128
19,13,5,1,18,0,0,0,0,56
19,13,5,1,18,3,1,19,5,84
19,13,5,1,18,5,4,0,0,65
19,13,5,1,18,5,18,0,0,79
19,13,5,1,18,5,18,19,0,98
19,13,5,1,18,25,0,0,0,81
19,13,5,1,18,9,5,18,0,88
19,13,5,1,18,9,5,19,20,109
19,13,5,1,18,9,14,7,0,86
19,13,5,1,18,12,5,19,19,111
19,13,5,1,18,19,0,0,0,75
19,13,5,1,20,8,0,0,0,66
19,13,5,3,20,9,3,0,0,72
19,13,5,3,20,9,19,0,0,88
19,13,5,3,20,9,20,5,0,94
19,13,5,4,4,21,13,0,0,79
19,13,5,4,4,21,13,19,0,98
19,13,5,5,0,0,0,0,0,42
19,13,5,5,3,8,0,0,0,53
19,13,5,5,11,0,0,0,0,53
19,13,5,5,11,5,4,0,0,62
19,13,5,5,11,25,0,0,0,78
19,13,5,5,11,9,14,7,0,83
19,13,5,5,11,19,0,0,0,72
19,13,5,5,18,0,0,0,0,60
19,13,5,5,20,8,0,0,0,70
19,13,5,7,13,1,0,0,0,58
19,13,5,7,13,1,19,0,0,77
19,13,5,7,13,1,20,9,3,90
19,13,5,12,12,0,0,0,0,61
19,13,5,12,12,1,2,12,5,81
19,13,5,12,12,1,7,5,0,74
19,13,5,12,12,5,4,0,0,70
19,13,5,12,12,5,18,0,0,84
19,13,5,12,12,5,18,19,0,103
19,13,5,12,12,6,21,12,0,100
19,13,5,12,12,25,0,0,0,86
19,13,5,12,12,9,5,0,0,75
19,13,5,12,12,9,5,18,0,93
19,13,5,12,12,9,5,19,20,114
19,13,5,12,12,9,14,7,0,91
19,13,5,12,12,19,0,0,0,80
19,13,5,12,12,19,15,13,5,113
19,13,5,12,20,0,0,0,0,69
19,13,5,12,20,5,4,0,0,78
19,13,5,12,20,5,18,0,0,92
19,13,5,12,20,5,18,25,0,117
19,13,5,12,20,5,18,19,0,111
19,13,5,12,20,9,14,7,0,99
19,13,5,12,20,13,1,14,0,97
19,13,5,12,20,19,0,0,0,88
19,13,5,18,11,0,0,0,0,66
19,13,5,18,11,5,4,0,0,75
19,13,5,18,11,9,14,7,0,96
19,13,5,18,11,19,0,0,0,85
19,13,5,18,22,25,0,0,0,102
19,13,5,20,8,0,0,0,0,65
19,13,5,20,8,5,0,0,0,70
19,13,5,21,19,5,0,0,0,82
19,13,5,21,20,8,0,0,0,86
19,13,5,23,0,0,0,0,0,60
19,13,5,23,19,0,0,0,0,79
19,13,9,3,8,0,0,0,0,52
19,13,9,3,11,5,18,0,0,78
19,13,9,3,11,5,20,0,0,80
19,13,9,3,11,12,25,0,0,92
19,13,9,4,4,25,0,0,0,74
19,13,9,4,4,9,5,0,0,63
19,13,9,4,4,21,13,0,0,83
19,13,9,4,7,5,0,0,0,57
19,13,9,4,7,5,14,0,0,71
19,13,9,4,7,5,14,19,0,90
19,13,9,4,7,5,15,14,0,86
19,13,9,4,7,5,15,14,19,105
19,13,9,4,7,9,14,0,0,75
19,13,9,4,7,9,14,19,0,94
19,13,9,5,18,3,1,19,5,92
19,13,9,6,20,0,0,0,0,67
19,13,9,7,7,9,14,19,0,97
19,13,9,12,1,3,9,14,0,80
19,13,9,12,1,24,5,19,0,102
19,13,9,12,5,0,0,0,0,58
19,13,9,12,5,1,2,12,5,78
19,13,9,12,5,1,7,5,0,71
19,13,9,12,5,4,0,0,0,62
19,13,9,12,5,6,21,12,0,97
19,13,9,12,5,12,5,19,19,113
19,13,9,12,5,18,0,0,0,76
19,13,9,12,5,18,19,0,0,95
19,13,9,12,5,19,0,0,0,77
19,13,9,12,5,20,0,0,0,78
19,13,9,12,25,0,0,0,0,78
19,13,9,12,9,14,7,0,0,83
19,13,9,12,9,14,7,12,25,120
19,13,9,18,3,8,0,0,0,70
19,13,9,18,3,8,5,4,0,79
19,13,9,18,3,8,5,18,0,93
19,13,9,18,3,8,5,19,0,94
19,13,9,18,3,8,25,0,0,95
19,13,9,18,3,8,9,14,7,100
19,13,9,18,9,19,0,0,0,87
19,13,9,18,11,0,0,0,0,70
19,13,9,18,11,5,4,0,0,79
19,13,9,18,11,5,18,0,0,93
19,13,9,18,11,5,18,19,0,112
19,13,9,18,11,25,0,0,0,95
19,13,9,18,11,9,5,18,0,102
19,13,9,18,11,9,5,19,20,123
19,13,9,18,11,9,14,7,0,100
19,13,9,18,11,9,19,8,0,106
19,13,9,18,11,12,5,0,0,87
19,13,9,18,11,12,25,0,0,107
19,13,9,18,11,19,0,0,0,89
19,13,9,18,20,12,5,0,0,96
19,13,9,20,1,2,12,5,0,81
19,13,9,20,3,8,0,0,0,72
19,13,9,20,5,0,0,0,0,66
19,13,9,20,5,18,0,0,0,84
19,13,9,20,5,18,19,0,0,103
19,13,9,20,5,19,0,0,0,85
19,13,25,20,8,0,0,0,0,85
19,13,9,20,8,1,13,0,0,83
19,13,9,20,8,5,18,0,0,92
19,13,9,20,8,5,18,25,0,117
19,13,9,20,8,25,0,0,0,94
19,13,9,20,8,9,5,4,0,87
19,13,9,20,8,9,5,18,0,101
19,13,9,20,8,9,5,19,0,102
19,13,9,20,8,25,9,14,7,124
19,13,9,20,8,9,14,7,0,99
19,13,9,20,8,9,20,5,0,103
19,13,9,20,8,21,13,0,0,103
19,13,9,20,8,23,15,18,11,136
19,13,9,20,9,14,7,0,0,91
19,13,25,20,18,9,5,0,0,109
19,13,9,20,20,5,14,0,0,100
19,13,9,20,20,5,18,0,0,104
19,13,9,20,20,9,14,7,0,111
19,13,9,20,20,12,5,0,0,98
19,13,9,20,20,12,9,19,8,129
19,13,12,0,0,0,0,0,0,44
19,13,15,3,11,5,4,0,0,70
19,13,15,3,11,5,18,0,0,84
19,13,15,3,11,6,1,3,5,76
19,13,15,3,11,9,14,7,0,91
19,13,15,3,11,9,14,7,19,110
19,13,15,3,11,12,5,19,19,116
19,13,15,3,11,12,9,11,5,98
19,13,15,3,11,19,0,0,0,80
19,13,15,7,0,0,0,0,0,54
19,13,15,7,7,25,0,0,0,86
19,13,15,7,7,9,5,18,0,93
19,13,15,7,7,9,5,19,20,114
19,13,15,7,12,5,19,19,0,109
19,13,15,7,19,0,0,0,0,73
19,13,15,11,1,2,12,5,0,78
19,13,15,11,1,2,12,5,19,97
19,13,15,11,5,1,2,12,5,83
19,13,15,11,5,2,15,24,0,104
19,13,15,11,5,2,21,19,8,113
19,13,15,11,5,4,0,0,0,67
19,13,15,11,5,8,15,0,0,86
19,13,15,11,5,8,15,12,5,103
19,13,15,11,5,25,0,0,0,88
19,13,15,11,5,10,1,3,11,88
19,13,15,11,5,12,5,19,19,118
19,13,15,11,5,12,9,11,5,100
19,13,15,11,5,16,15,20,0,114
19,13,15,11,5,16,15,20,19,133
19,13,15,11,5,18,0,0,0,81
19,13,15,11,5,18,25,0,0,106
19,13,15,11,5,18,19,0,0,100
19,13,15,11,5,19,0,0,0,82
19,13,15,11,5,23,15,15,4,120
19,13,15,11,25,0,0,0,0,83
19,13,15,11,9,5,18,0,0,90
19,13,15,11,9,5,19,0,0,91
19,13,15,11,9,5,19,20,0,111
19,13,15,11,9,12,25,0,0,104
19,13,15,11,9,14,5,19,19,124
19,13,15,11,9,14,7,0,0,88
19,13,15,11,9,14,7,19,0,107
19,13,15,11,9,19,8,0,0,94
19,13,15,11,15,0,0,0,0,73
19,13,15,11,15,19,0,0,0,92
19,13,15,12,4,5,18,0,0,86
19,13,15,12,4,5,18,5,4,95
19,13,15,12,4,5,18,19,0,105
19,13,15,12,20,0,0,0,0,79
19,13,15,12,20,19,0,0,0,98
19,13,15,15,3,8,0,0,0,73
19,13,15,15,3,8,5,4,0,82
19,13,15,15,3,8,5,19,0,97
19,13,15,15,3,8,25,0,0,98
19,13,15,15,3,8,9,14,7,103
19,13,15,15,3,8,19,0,0,92
19,13,15,15,4,7,5,0,0,78
19,13,15,15,4,7,5,4,0,82
19,13,15,15,4,7,5,18,0,96
19,13,15,15,4,7,9,14,7,103
19,13,15,15,7,5,0,0,0,74
19,13,15,15,11,0,0,0,0,73
19,13,15,15,18,9,3,8,0,100
19,13,15,15,20,8,0,0,0,90
19,13,15,15,20,8,5,4,0,99
19,13,15,15,20,8,5,14,0,109
19,13,15,15,20,8,5,14,19,128
19,13,15,15,20,8,5,18,0,113
19,13,15,15,20,8,5,18,19,132
19,13,15,15,20,8,5,19,0,114
19,13,15,15,20,8,5,19,20,134
19,13,15,15,20,8,25,0,0,115
19,13,15,15,20,8,9,5,0,104
19,13,15,15,20,8,9,5,19,123
19,13,15,15,20,8,9,6,25,130
19,13,15,15,20,8,9,14,7,120
19,13,15,15,20,8,9,19,8,126
19,13,15,15,20,8,12,25,0,127
19,13,15,15,20,8,19,0,0,109
19,13,15,16,16,12,5,0,0,96
19,13,15,18,5,0,0,0,0,70
19,13,15,18,5,2,18,15,0,105
19,13,15,18,26,1,14,4,15,125
19,13,15,18,26,1,20,15,0,127
19,13,15,20,5,0,0,0,0,72
19,13,15,20,8,5,18,0,0,98
19,13,15,20,8,5,18,5,4,107
19,13,15,20,8,5,18,5,18,121
19,13,15,20,8,5,18,25,0,123
19,13,15,20,8,5,18,19,0,117
19,13,15,20,20,5,18,0,0,110
19,13,15,21,3,8,0,0,0,79
19,13,15,21,3,8,5,18,0,102
19,13,15,21,12,4,5,18,0,107
19,13,15,21,12,4,5,18,19,126
19,13,15,21,19,0,0,0,0,87
19,13,15,21,19,5,0,0,0,92
19,13,15,21,19,5,18,0,0,110
19,13,15,21,20,0,0,0,0,88
19,13,18,7,19,0,0,0,0,76
19,13,18,18,5,2,18,4,0,97
19,13,21,4,4,5,18,0,0,84
19,13,21,4,7,5,0,0,0,69
19,13,21,4,7,5,4,0,0,73
19,13,21,4,7,5,4,12,25,110
19,13,21,4,7,5,18,0,0,87
19,13,21,4,7,5,19,0,0,88
19,13,21,4,7,25,0,0,0,89
19,13,21,4,7,9,5,18,0,96
19,13,21,4,7,9,5,19,20,117
19,13,21,4,7,9,12,25,0,110
19,13,21,4,7,9,14,7,0,94
19,13,21,7,0,0,0,0,0,60
19,13,21,7,7,5,18,0,0,90
19,13,21,7,7,5,18,25,0,115
19,13,21,7,7,5,19,20,0,111
19,13,21,7,7,9,19,8,0,103
19,13,21,7,7,12,5,0,0,84
19,13,21,7,7,12,5,4,0,88
19,13,21,7,7,12,5,18,0,102
19,13,21,7,7,12,5,18,25,127
19,13,21,7,7,12,5,18,19,121
19,13,21,7,7,12,5,19,0,103
19,13,21,7,7,12,9,14,7,109
19,13,21,7,9,19,13,0,0,101
19,13,21,7,12,25,0,0,0,97
19,13,21,7,14,5,19,19,0,117
19,13,21,9,19,20,25,0,0,126
19,13,21,18,0,0,0,0,0,71
19,13,21,18,11,19,0,0,0,101
19,13,21,18,18,0,0,0,0,89
19,13,21,18,18,25,0,0,0,114
19,13,21,18,20,12,5,0,0,108
19,13,21,19,5,0,0,0,0,77
19,13,21,19,8,0,0,0,0,80
19,13,21,20,0,0,0,0,0,73
19,13,21,20,3,8,0,0,0,84
19,13,21,20,3,8,5,4,0,93
19,13,21,20,3,8,5,19,0,108
19,13,21,20,3,8,25,0,0,109
19,13,21,20,3,8,9,5,18,116
19,13,21,20,3,8,9,14,0,107
19,13,21,20,3,8,9,14,7,114
19,13,21,20,12,5,19,19,0,128
19,13,21,20,16,18,15,15,6,143
19,13,21,20,20,5,4,0,0,102
19,13,21,20,20,5,18,0,0,116
19,13,21,20,20,25,0,0,0,118
19,13,21,20,20,9,5,18,0,125
19,13,21,20,20,9,5,19,20,146
19,13,21,20,20,9,12,25,0,139
19,13,21,20,20,9,14,7,0,123
19,14,5,1,4,0,0,0,0,43
19,14,5,1,11,0,0,0,0,50
19,14,5,1,11,2,15,24,0,91
19,14,5,1,11,5,4,0,0,59
19,14,5,1,11,5,18,0,0,73
19,14,5,1,11,5,18,5,4,82
19,14,5,1,11,5,18,19,0,92
19,14,5,1,11,25,0,0,0,75
19,14,5,1,11,9,5,18,0,82
19,14,5,1,11,9,5,19,20,103
19,14,5,1,11,9,12,25,0,96
19,14,5,1,11,9,14,7,0,80
19,14,5,1,11,9,19,8,0,86
19,14,5,1,11,19,0,0,0,69
19,14,5,1,11,19,2,25,0,96
19,14,5,1,11,19,13,1,14,97
19,14,5,1,16,0,0,0,0,55
19,14,5,1,16,5,4,0,0,64
19,14,5,1,16,9,14,7,0,85
19,14,5,1,16,19,0,0,0,74
19,14,5,1,20,8,0,0,0,67
19,14,5,1,20,8,5,0,0,72
19,14,5,2,0,0,0,0,0,40
19,14,5,3,11,0,0,0,0,52
19,14,5,3,11,4,18,1,23,98
19,14,5,3,11,5,4,0,0,61
19,14,5,3,11,5,18,0,0,75
19,14,5,3,11,5,20,0,0,77
19,14,5,3,11,9,14,7,0,82
19,14,5,3,11,19,0,0,0,71
19,14,5,4,0,0,0,0,0,42
19,14,5,4,4,5,4,0,0,55
19,14,5,4,4,9,14,7,0,76
19,14,5,4,19,0,0,0,0,61
19,14,5,5,0,0,0,0,0,43
19,14,5,5,18,0,0,0,0,61
19,14,5,5,18,5,4,0,0,70
19,14,5,5,18,5,18,0,0,84
19,14,5,5,18,5,18,19,0,103
19,14,5,5,18,6,21,12,0,100
19,14,5,5,18,25,0,0,0,86
19,14,5,5,18,9,14,7,0,91
19,14,5,5,18,12,5,19,19,116
19,14,5,5,18,19,0,0,0,80
19,14,5,5,19,8,0,0,0,70
19,14,5,5,19,8,5,19,0,94
19,14,5,5,19,8,9,14,7,100
19,14,5,5,19,20,0,0,0,82
19,14,5,5,19,20,25,0,0,107
19,14,5,5,26,5,0,0,0,74
19,14,5,5,26,5,4,0,0,78
19,14,5,5,26,5,18,0,0,92
19,14,5,5,26,5,18,19,0,111
19,14,5,5,26,5,19,0,0,93
19,14,5,5,26,25,0,0,0,94
19,14,5,5,26,9,5,18,0,101
19,14,5,5,26,9,5,19,20,122
19,14,5,5,26,9,14,7,0,99
19,14,5,12,12,5,4,0,0,71
19,14,5,12,12,5,18,0,0,85
19,14,5,12,12,5,19,20,0,106
19,14,5,12,12,25,0,0,0,87
19,14,5,12,12,19,0,0,0,81
19,14,5,18,16,0,0,0,0,72
19,14,5,23,0,0,0,0,0,61
19,14,25,0,0,0,0,0,0,58
19,14,25,1,16,20,9,3,0,107
19,14,9,2,0,0,0,0,0,44
19,14,9,2,2,5,4,0,0,55
19,14,9,2,2,9,14,7,0,76
19,14,9,2,2,12,5,0,0,63
19,14,9,2,2,12,5,4,0,67
19,14,9,2,2,12,5,18,0,81
19,14,9,2,5,12,0,0,0,61
19,14,9,2,19,0,0,0,0,63
19,14,9,3,8,5,18,0,0,76
19,14,9,3,11,0,0,0,0,56
19,14,9,3,11,4,18,1,23,102
19,14,9,3,11,5,4,0,0,65
19,14,9,3,11,5,25,0,0,86
19,14,9,3,11,5,18,0,0,79
19,14,9,3,11,5,18,5,4,88
19,14,9,3,11,5,18,5,18,102
19,14,9,3,11,5,18,25,0,104
19,14,9,3,11,5,18,19,0,98
19,14,9,3,11,5,20,0,0,81
19,14,9,3,11,9,14,7,0,86
19,14,9,3,11,12,5,0,0,73
19,14,9,3,11,19,0,0,0,75
19,14,9,4,4,12,5,0,0,67
19,14,9,4,5,0,0,0,0,51
19,14,9,4,5,12,25,0,0,88
19,14,9,4,5,14,5,19,19,108
19,14,9,4,5,18,25,0,0,94
19,14,9,4,5,19,20,0,0,90
19,14,25,5,0,0,0,0,0,63
19,14,25,5,4,0,0,0,0,67
19,14,9,5,19,0,0,0,0,66
19,14,25,5,19,0,0,0,0,82
19,14,9,6,6,0,0,0,0,54
19,14,9,6,6,1,2,12,5,74
19,14,9,6,6,5,4,0,0,63
19,14,9,6,6,5,18,0,0,77
19,14,9,6,6,5,18,19,0,96
19,14,9,6,6,25,0,0,0,79
19,14,9,6,6,9,5,18,0,86
19,14,9,6,6,9,5,19,20,107
19,14,9,6,6,9,12,25,0,100
19,14,9,6,6,9,14,7,0,84
19,14,9,6,6,9,19,8,0,90
19,14,9,6,6,12,5,0,0,71
19,14,9,6,6,12,5,4,0,75
19,14,9,6,6,12,5,18,0,89
19,14,9,6,6,12,5,18,19,108
19,14,9,6,6,12,5,19,0,90
19,14,9,6,6,12,25,0,0,91
19,14,9,6,6,12,9,14,7,96
19,14,9,6,6,19,0,0,0,73
19,14,9,6,20,0,0,0,0,68
19,14,9,6,20,5,4,0,0,77
19,14,9,6,20,5,18,0,0,91
19,14,9,6,20,5,18,19,0,110
19,14,9,6,20,25,0,0,0,93
19,14,9,6,20,9,14,7,0,98
19,14,9,7,0,0,0,0,0,49
19,14,9,7,7,5,4,0,0,65
19,14,9,7,7,5,18,0,0,79
19,14,9,7,7,5,18,5,4,88
19,14,9,7,7,5,18,5,18,102
19,14,9,7,7,5,18,19,0,98
19,14,9,7,7,9,14,7,0,86
19,14,9,7,7,12,5,0,0,73
19,14,9,7,7,12,5,4,0,77
19,14,9,7,7,12,5,18,0,91
19,14,9,7,7,12,5,18,19,110
19,14,9,7,7,12,5,19,0,92
19,14,9,7,7,12,9,14,7,98
19,14,9,7,8,20,0,0,0,77
19,14,9,7,19,0,0,0,0,68
19,14,25,9,14,7,0,0,0,88
19,14,9,16,0,0,0,0,0,58
19,14,9,16,5,0,0,0,0,63
19,14,9,16,5,2,9,12,12,98
19,14,9,16,5,4,0,0,0,67
19,14,9,16,5,6,9,19,8,105
19,14,9,16,5,12,9,11,5,100
19,14,9,16,5,18,0,0,0,81
19,14,9,16,5,18,19,0,0,100
19,14,9,16,5,19,0,0,0,82
19,14,9,16,25,0,0,0,0,83
19,14,9,16,9,14,7,0,0,88
19,14,9,16,9,19,8,0,0,94
19,14,9,16,10,1,3,11,0,83
19,14,9,16,14,15,19,5,0,111
19,14,9,16,16,5,4,0,0,83
19,14,9,16,16,5,18,0,0,97
19,14,9,16,16,5,18,19,0,116
19,14,9,16,16,5,18,20,25,142
19,14,9,16,16,5,20,0,0,99
19,14,9,16,16,5,20,25,0,124
19,14,9,16,16,5,20,19,0,118
19,14,9,16,16,25,0,0,0,99
19,14,9,16,16,9,5,18,0,106
19,14,9,16,16,9,5,19,20,127
19,14,9,16,16,9,12,25,0,120
19,14,9,16,16,9,14,7,0,104
19,14,9,16,16,9,19,8,0,110
19,14,9,16,19,0,0,0,0,77
19,14,9,16,20,9,15,21,19,142
19,14,9,18,12,0,0,0,0,72
19,14,9,18,20,0,0,0,0,80
19,14,9,18,20,12,5,0,0,97
19,14,9,20,0,0,0,0,0,62
19,14,9,20,3,8,0,0,0,73
19,14,9,20,3,8,5,4,0,82
19,14,9,20,3,8,5,18,0,96
19,14,9,20,3,8,5,18,19,115
19,14,9,20,3,8,5,19,0,97
19,14,9,20,3,8,25,0,0,98
19,14,9,20,3,8,9,5,18,105
19,14,9,20,3,8,9,14,7,103
19,14,9,20,5,0,0,0,0,67
19,14,9,20,8,5,0,0,0,75
19,14,9,20,8,25,0,0,0,95
19,14,9,20,19,0,0,0,0,81
19,14,9,20,20,12,5,0,0,99
19,14,9,20,26,0,0,0,0,88
19,14,9,22,5,25,0,0,0,94
19,14,9,22,5,12,0,0,0,81
19,14,9,22,5,12,5,4,0,90
19,14,9,22,5,12,5,18,0,104
19,14,9,22,5,12,5,18,19,123
19,14,9,22,5,12,25,0,0,106
19,14,9,22,5,12,9,14,7,111
19,14,9,22,5,12,12,5,4,102
19,14,9,22,5,12,12,5,18,116
19,14,9,22,5,12,12,25,0,118
19,14,9,22,5,12,19,0,0,100
19,14,9,22,25,0,0,0,0,89
19,14,15,2,0,0,0,0,0,50
19,14,15,2,2,5,18,0,0,75
19,14,15,2,2,5,18,25,0,100
19,14,15,2,2,5,18,19,0,94
19,14,15,2,2,5,19,19,0,95
19,14,15,2,2,25,0,0,0,77
19,14,15,2,2,9,5,18,0,84
19,14,15,2,2,9,5,19,20,105
19,14,15,2,2,9,12,25,0,98
19,14,15,2,2,9,14,7,0,82
19,14,15,2,2,9,19,8,0,88
19,14,15,2,2,9,19,13,0,93
19,14,15,2,2,9,19,13,19,112
19,14,15,2,4,15,13,0,0,82
19,14,15,2,9,19,13,0,0,91
19,14,15,2,12,9,14,7,0,92
19,14,15,2,15,3,18,1,20,107
19,14,15,2,19,0,0,0,0,69
19,14,15,2,19,3,1,20,0,93
19,14,15,3,1,20,0,0,0,72
19,14,15,3,8,5,18,0,0,82
19,14,15,3,11,0,0,0,0,62
19,14,15,3,11,5,18,0,0,85
19,14,15,4,0,0,0,0,0,52
19,14,15,4,12,25,0,0,0,89
19,14,15,5,11,0,0,0,0,64
19,14,15,5,11,9,14,7,0,94
19,14,15,7,0,0,0,0,0,55
19,14,15,7,1,0,0,0,0,56
19,14,15,7,7,5,4,0,0,71
19,14,15,7,7,9,14,7,0,92
19,14,15,7,19,0,0,0,0,74
19,14,15,11,5,0,0,0,0,64
19,14,15,15,4,0,0,0,0,67
19,14,15,15,4,5,4,0,0,76
19,14,15,15,4,9,14,7,0,97
19,14,15,15,4,19,0,0,0,86
19,14,15,15,11,5,4,0,0,83
19,14,15,15,11,5,18,0,0,97
19,14,15,15,11,5,18,5,4,106
19,14,15,15,11,5,18,19,0,116
19,14,15,15,11,9,14,7,0,104
19,14,15,15,11,19,0,0,0,93
19,14,15,15,11,21,13,19,0,127
19,14,15,15,12,0,0,0,0,75
19,14,15,15,12,5,4,0,0,84
19,14,15,15,12,9,14,7,0,105
19,14,15,15,12,19,0,0,0,94
19,14,15,15,16,0,0,0,0,79
19,14,15,15,16,5,4,0,0,88
19,14,15,15,16,5,18,0,0,102
19,14,15,15,16,5,18,19,0,121
19,14,15,15,16,25,0,0,0,104
19,14,15,15,16,9,5,18,0,111
19,14,15,15,16,9,5,19,20,132
19,14,15,15,16,9,12,25,0,125
19,14,15,15,16,9,14,7,0,109
19,14,15,15,16,19,0,0,0,98
19,14,15,15,19,5,0,0,0,87
19,14,15,15,20,0,0,0,0,83
19,14,15,15,20,5,4,0,0,92
19,14,15,15,20,6,21,12,0,122
19,14,15,15,20,6,21,12,19,141
19,14,15,15,20,25,0,0,0,108
19,14,15,15,20,9,5,18,0,115
19,14,15,15,20,9,5,19,20,136
19,14,15,15,20,9,12,25,0,129
19,14,15,15,20,9,14,7,0,113
19,14,15,15,20,19,0,0,0,102
19,14,15,15,22,5,0,0,0,90
19,14,15,15,26,5,0,0,0,94
19,14,15,15,26,5,4,0,0,98
19,14,15,15,26,5,18,0,0,112
19,14,15,15,26,5,18,19,0,131
19,14,15,15,26,5,19,0,0,113
19,14,15,15,26,25,0,0,0,114
19,14,15,15,26,9,5,18,0,121
19,14,15,15,26,9,5,19,20,142
19,14,15,15,26,9,14,7,0,119
19,14,15,15,26,12,5,0,0,106
19,14,15,15,26,12,5,4,0,110
19,14,15,15,26,12,5,19,0,125
19,14,15,15,26,12,9,14,7,131
19,14,15,16,0,0,0,0,0,64
19,14,15,18,5,0,0,0,0,71
19,14,15,18,5,4,0,0,0,75
19,14,15,18,5,12,5,19,19,126
19,14,15,18,5,18,0,0,0,89
19,14,15,18,5,18,19,0,0,108
19,14,15,18,5,19,0,0,0,90
19,14,15,18,9,14,7,0,0,96
19,14,15,18,9,14,7,12,25,133
19,14,15,18,11,0,0,0,0,77
19,14,15,18,11,5,12,0,0,94
19,14,15,18,11,5,12,5,4,103
19,14,15,18,11,5,12,5,18,117
19,14,15,18,11,5,12,19,0,113
19,14,15,18,11,5,18,0,0,100
19,14,15,18,20,0,0,0,0,86
19,14,15,18,20,5,4,0,0,95
19,14,15,18,20,5,18,0,0,109
19,14,15,18,20,5,18,19,0,128
19,14,15,18,20,25,0,0,0,111
19,14,15,18,20,9,14,7,0,116
19,14,15,18,20,12,5,0,0,103
19,14,15,18,20,19,0,0,0,105
19,14,15,20,0,0,0,0,0,68
19,14,15,20,19,0,0,0,0,87
19,14,15,20,20,5,18,0,0,111
19,14,15,20,20,5,18,25,0,136
19,14,15,20,20,25,0,0,0,113
19,14,15,20,20,9,5,0,0,102
19,14,15,20,20,9,5,18,0,120
19,14,15,20,20,9,5,19,20,141
19,14,15,20,20,9,12,25,0,134
19,14,15,21,3,8,0,0,0,80
19,14,15,21,20,0,0,0,0,89
19,14,15,21,20,5,4,0,0,98
19,14,15,21,20,5,18,0,0,112
19,14,15,21,20,6,1,9,18,123
19,14,15,21,20,25,0,0,0,114
19,14,15,21,20,9,5,18,0,121
19,14,15,21,20,9,5,19,20,142
19,14,15,21,20,9,14,7,0,119
19,14,15,21,20,9,19,8,0,125
19,14,15,21,20,12,5,19,19,144
19,14,15,21,20,12,9,11,5,126
19,14,15,21,20,19,0,0,0,108
19,14,15,23,2,1,12,12,19,117
19,14,15,23,2,1,14,11,0,99
19,14,15,23,2,1,14,11,19,118
19,14,15,23,2,5,12,12,0,102
19,14,15,23,2,5,12,12,19,121
19,14,15,23,2,5,12,20,0,110
19,14,15,23,2,5,18,7,0,103
19,14,15,23,2,5,18,18,25,139
19,14,15,23,2,9,18,4,0,104
19,14,15,23,2,9,18,4,19,123
19,14,15,23,2,12,9,14,11,119
19,14,15,23,2,15,21,14,4,127
19,14,15,23,2,18,5,1,11,108
19,14,15,23,2,18,15,20,8,134
19,14,15,23,2,18,21,19,8,139
19,14,15,23,2,21,19,8,0,121
19,14,15,23,3,1,16,0,0,91
19,14,15,23,3,1,16,19,0,110
19,14,15,23,3,18,1,6,20,119
19,14,15,23,3,18,5,5,16,118
19,14,15,23,4,18,9,6,20,128
19,14,15,23,4,18,15,16,0,124
19,14,15,23,4,18,15,16,19,143
19,14,15,23,5,4,0,0,0,80
19,14,15,23,6,1,12,12,0,102
19,14,15,23,6,1,12,12,19,121
19,14,15,23,6,9,5,12,4,107
19,14,15,23,6,12,1,11,5,106
19,14,15,23,6,15,23,12,0,127
19,14,15,23,8,15,21,19,5,139
19,14,15,23,25,0,0,0,0,96
19,14,15,23,9,5,0,0,0,85
19,14,15,23,9,5,18,0,0,103
19,14,15,23,9,5,19,20,0,124
19,14,15,23,9,12,25,0,0,117
19,14,15,23,9,14,5,19,19,137
19,14,15,23,9,14,7,0,0,101
19,14,15,23,9,19,8,0,0,107
19,14,15,23,11,0,0,0,0,82
19,14,15,23,12,0,0,0,0,83
19,14,15,23,12,1,14,4,0,102
19,14,15,23,12,1,14,4,19,121
19,14,15,23,12,5,19,19,0,126
19,14,15,23,12,9,11,5,0,108
19,14,15,23,13,1,11,5,18,119
19,14,15,23,13,1,19,20,0,124
19,14,15,23,13,5,12,20,0,121
19,14,15,23,13,5,12,20,19,140
19,14,15,23,13,5,14,0,0,103
19,14,15,23,13,15,12,4,0,115
19,14,15,23,16,1,3,11,0,102
19,14,15,23,16,1,3,11,19,121
19,14,15,23,16,12,15,23,0,137
19,14,15,23,16,12,15,23,19,156
19,14,15,23,16,18,15,15,6,141
19,14,15,23,19,0,0,0,0,90
19,14,15,23,19,3,1,16,5,115
19,14,15,23,19,8,1,4,5,108
19,14,15,23,19,8,5,4,0,107
19,14,15,23,19,8,5,4,19,126
19,14,15,23,19,8,9,14,5,126
19,14,15,23,19,8,15,5,0,118
19,14,15,23,19,8,15,5,4,122
19,14,15,23,19,8,15,5,18,136
19,14,15,23,19,8,15,5,19,137
19,14,15,23,19,12,9,4,5,120
19,14,15,23,19,12,9,16,0,127
19,14,15,23,19,20,15,18,13,156
19,14,15,23,19,21,9,20,0,140
19,14,15,23,19,21,9,20,19,159
19,14,15,23,23,15,18,13,0,140
19,14,15,26,26,12,5,0,0,117
19,14,21,2,0,0,0,0,0,56
19,14,21,2,2,1,2,12,5,78
19,14,21,2,2,5,4,0,0,67
19,14,21,2,2,5,5,0,0,68
19,14,21,2,2,5,18,0,0,81
19,14,21,2,2,5,18,19,0,100
19,14,21,2,2,25,0,0,0,83
19,14,21,2,2,9,5,18,0,90
19,14,21,2,2,9,5,19,20,111
19,14,21,2,2,9,14,7,0,88
19,14,21,2,2,9,19,8,0,94
19,14,21,2,14,5,19,19,0,113
19,14,21,2,14,15,19,5,0,109
19,14,21,2,16,18,15,15,6,126
19,14,21,2,19,0,0,0,0,75
19,14,21,3,11,0,0,0,0,68
19,14,21,4,7,5,0,0,0,70
19,14,21,4,7,5,18,25,0,113
19,14,21,6,6,0,0,0,0,66
19,14,21,6,6,2,15,24,0,107
19,14,21,6,6,5,4,0,0,75
19,14,21,6,6,5,18,0,0,89
19,14,21,6,6,5,18,19,0,108
19,14,21,6,6,25,0,0,0,91
19,14,21,6,6,9,5,18,0,98
19,14,21,6,6,9,5,19,20,119
19,14,21,6,6,9,12,25,0,112
19,14,21,6,6,9,14,7,0,96
19,14,21,6,6,9,19,8,0,102
19,14,21,6,6,11,9,14,0,100
19,14,21,6,6,12,5,0,0,83
19,14,21,6,6,12,5,4,0,87
19,14,21,6,6,12,5,18,0,101
19,14,21,6,6,12,5,18,19,120
19,14,21,6,6,12,5,19,0,102
19,14,21,6,6,12,5,19,19,121
19,14,21,6,6,12,25,0,0,103
19,14,21,6,6,12,9,5,18,110
19,14,21,6,6,12,9,14,7,108
19,14,21,6,6,13,1,14,0,94
19,14,21,6,6,19,0,0,0,85
19,14,21,7,0,0,0,0,0,61
19,14,21,7,7,5,4,0,0,77
19,14,21,7,7,5,18,0,0,91
19,14,21,7,7,5,18,25,0,116
19,14,21,7,7,5,18,9,5,105
19,14,21,7,7,5,19,20,0,112
19,14,21,7,7,9,5,19,0,101
19,14,21,7,7,9,14,7,0,98
19,14,21,7,7,9,19,8,0,104
19,14,21,7,7,12,5,0,0,85
19,14,21,7,7,12,5,4,0,89
19,14,21,7,7,12,5,19,0,104
19,14,21,7,7,12,25,0,0,105
19,14,21,7,7,12,9,14,7,110
19,14,21,7,9,6,25,0,0,101
19,14,21,7,12,25,0,0,0,98
19,14,21,7,14,5,19,19,0,118
19,14,21,7,19,0,0,0,0,80
19,14,21,13,0,0,0,0,0,67
19,14,21,16,0,0,0,0,0,70
19,14,21,16,16,5,18,0,0,109
19,14,21,18,0,0,0,0,0,72
19,14,21,18,12,0,0,0,0,84
19,14,21,18,12,25,0,0,0,109
19,14,21,18,16,0,0,0,0,88
19,14,21,18,20,0,0,0,0,92
19,14,21,26,26,12,5,0,0,123
19,15,2,2,5,4,0,0,0,47
19,15,2,2,5,18,0,0,0,61
19,15,2,2,5,18,19,0,0,80
19,15,2,2,25,0,0,0,0,63
19,15,2,2,9,14,7,0,0,68
19,15,2,2,9,14,7,12,25,105
19,15,2,5,9,20,0,0,0,70
19,15,2,5,18,0,0,0,0,59
19,15,2,5,18,5,4,0,0,68
19,15,2,5,18,5,18,0,0,82
19,15,2,5,18,5,19,20,0,103
19,15,2,5,18,9,14,7,0,89
19,15,2,5,18,9,26,5,0,99
19,15,2,5,18,9,26,5,4,103
19,15,2,5,18,9,26,5,19,118
19,15,2,5,18,12,25,0,0,96
19,15,2,5,18,12,9,11,5,96
19,15,2,5,18,14,5,19,19,116
19,15,2,5,18,23,9,19,5,115
19,15,2,6,21,12,0,0,0,75
19,15,2,15,12,5,0,0,0,68
19,15,2,15,12,5,19,0,0,87
19,15,2,16,18,15,15,6,0,106
19,15,2,18,1,12,9,20,5,101
19,15,2,18,5,22,5,19,20,125
19,15,2,18,9,5,20,25,0,113
19,15,2,18,9,17,21,5,20,126
19,15,2,19,0,0,0,0,0,55
19,15,3,1,7,5,0,0,0,50
19,15,3,1,7,5,18,0,0,68
19,15,3,1,7,5,18,19,0,87
19,15,3,1,7,5,19,0,0,69
19,15,3,3,1,7,5,0,0,53
19,15,3,3,1,7,5,19,0,72
19,15,3,3,5,18,0,0,0,63
19,15,3,3,5,18,9,19,20,111
19,15,3,3,5,18,9,20,5,97
19,15,3,3,5,18,19,0,0,82
19,15,3,5,0,0,0,0,0,42
19,15,3,8,20,0,0,0,0,65
19,15,3,9,1,2,12,5,0,66
19,15,3,9,1,2,12,5,19,85
19,15,3,9,1,2,12,25,0,86
19,15,3,9,1,12,0,0,0,59
19,15,3,9,1,12,9,19,5,92
19,15,3,9,1,12,9,19,13,100
19,15,3,9,1,12,9,19,20,107
19,15,3,9,1,12,9,20,5,93
19,15,3,9,1,12,9,20,25,113
19,15,3,9,1,12,9,26,5,99
19,15,3,9,1,12,12,25,0,96
19,15,3,9,1,12,19,0,0,78
19,15,3,9,1,20,5,0,0,72
19,15,3,9,1,20,9,15,14,105
19,15,3,9,1,20,9,22,5,103
19,15,3,9,5,19,0,0,0,70
19,15,3,9,5,20,1,12,0,84
19,15,3,9,5,20,1,18,25,115
19,15,3,9,5,20,1,19,0,91
19,15,3,9,5,20,5,9,20,105
19,15,3,9,5,20,25,0,0,96
19,15,3,9,5,20,9,5,19,104
19,15,3,9,5,20,9,19,13,112
19,15,3,9,5,20,9,19,20,119
19,15,3,9,9,0,0,0,0,55
19,15,3,9,15,3,18,1,20,103
19,15,3,9,15,7,5,14,25,112
19,15,3,9,15,7,18,1,13,100
19,15,3,9,15,12,0,0,0,73
19,15,3,9,15,12,15,7,25,120
19,15,3,9,15,14,15,13,25,128
19,15,3,9,15,16,1,20,8,106
19,15,3,9,21,19,0,0,0,86
19,15,3,11,0,0,0,0,0,48
19,15,3,11,5,4,0,0,0,57
19,15,3,11,5,25,5,0,0,83
19,15,3,11,5,25,5,19,0,102
19,15,3,11,5,18,0,0,0,71
19,15,3,11,5,18,15,15,0,101
19,15,3,11,5,18,15,15,19,120
19,15,3,11,5,20,0,0,0,73
19,15,3,11,5,20,5,4,0,82
19,15,3,11,5,20,6,21,12,112
19,15,3,11,5,20,9,14,7,103
19,15,3,11,5,20,19,0,0,92
19,15,3,11,8,5,1,4,0,66
19,15,3,11,25,0,0,0,0,73
19,15,3,11,9,14,7,0,0,78
19,15,3,11,12,5,19,19,0,103
19,15,3,11,13,1,11,5,18,96
19,15,3,11,13,1,14,0,0,76
19,15,3,11,13,5,14,0,0,80
19,15,3,11,15,0,0,0,0,63
19,15,3,11,19,0,0,0,0,67
19,15,3,12,5,0,0,0,0,54
19,15,3,12,5,19,0,0,0,73
19,15,3,13,1,14,0,0,0,65
19,15,3,13,1,14,18,25,0,108
19,15,3,13,5,14,0,0,0,69
19,15,3,15,0,0,0,0,0,52
19,15,3,15,18,18,9,20,15,132
19,15,4,0,0,0,0,0,0,38
19,15,4,1,0,0,0,0,0,39
19,15,4,1,3,12,1,19,5,79
19,15,4,1,9,3,0,0,0,51
19,15,4,1,12,5,19,19,0,94
19,15,4,1,12,9,19,20,0,99
19,15,4,1,12,9,19,20,19,118
19,15,4,1,12,9,20,5,0,85
19,15,4,1,12,9,20,5,19,104
19,15,4,1,12,9,20,25,0,105
19,15,4,1,13,9,4,0,0,65
19,15,4,1,13,9,4,5,0,70
19,15,4,1,13,9,4,5,19,89
19,15,4,1,19,0,0,0,0,58
19,15,4,1,23,1,20,5,18,106
19,15,4,2,21,19,20,5,18,123
19,15,4,4,5,4,0,0,0,51
19,15,4,4,5,14,0,0,0,61
19,15,4,4,5,14,5,4,0,70
19,15,4,4,5,14,9,14,7,91
19,15,4,4,5,14,12,25,0,98
19,15,4,4,5,14,19,0,0,80
19,15,4,4,9,5,18,0,0,74
19,15,4,4,9,5,19,0,0,75
19,15,4,4,9,5,19,20,0,95
19,15,4,4,9,14,7,0,0,72
19,15,4,4,9,20,5,0,0,76
19,15,4,25,0,0,0,0,0,63
19,15,4,9,3,0,0,0,0,50
19,15,4,9,15,0,0,0,0,62
19,15,4,9,21,13,0,0,0,81
19,15,4,9,21,13,19,0,0,100
19,15,4,12,5,19,19,0,0,93
19,15,4,15,11,21,0,0,0,85
19,15,4,15,13,25,0,0,0,91
19,15,4,15,13,9,3,0,0,78
19,15,4,15,13,9,5,19,0,99
19,15,4,15,13,9,20,5,19,119
19,15,4,15,13,9,20,9,3,107
19,15,4,15,13,9,26,5,0,106
19,15,4,15,13,19,0,0,0,85
19,15,4,19,0,0,0,0,0,57
19,15,4,23,15,18,11,0,0,105
19,15,5,0,0,0,0,0,0,39
19,15,5,11,15,5,0,0,0,70
19,15,5,22,5,18,0,0,0,84
19,15,6,1,0,0,0,0,0,41
19,15,6,1,14,5,0,0,0,60
19,15,6,1,18,0,0,0,0,59
19,15,6,1,18,19,0,0,0,78
19,15,6,1,19,0,0,0,0,60
19,15,6,6,1,18,9,4,0,78
19,15,6,6,9,15,14,5,0,89
19,15,6,6,9,15,14,9,0,93
19,15,6,6,9,20,0,0,0,75
19,15,6,6,9,20,19,0,0,94
19,15,6,6,18,9,20,20,15,128
19,15,6,11,5,5,0,0,0,61
19,15,6,15,11,12,9,19,0,106
19,15,6,20,0,0,0,0,0,60
19,15,6,20,1,0,0,0,0,61
19,15,6,20,1,19,0,0,0,80
19,15,6,20,2,1,3,11,0,77
19,15,6,20,2,1,3,11,19,96
19,15,6,20,2,1,12,12,0,87
19,15,6,20,2,1,12,12,19,106
19,15,6,20,2,15,1,18,4,100
19,15,6,20,2,15,21,14,4,116
19,15,6,20,3,15,1,12,0,91
19,15,6,20,5,14,0,0,0,79
19,15,6,20,5,14,5,4,0,88
19,15,6,20,5,14,5,18,0,102
19,15,6,20,5,14,5,18,19,121
19,15,6,20,5,14,9,14,7,109
19,15,6,20,5,14,19,0,0,98
19,15,6,20,5,18,0,0,0,83
19,15,6,20,5,19,20,0,0,104
19,15,6,20,8,5,1,4,0,78
19,15,6,20,8,5,1,4,19,97
19,15,6,20,8,15,18,14,0,115
19,15,6,20,25,0,0,0,0,85
19,15,6,20,9,5,0,0,0,74
19,15,6,20,9,5,19,0,0,93
19,15,6,20,9,19,8,0,0,96
19,15,6,20,12,25,0,0,0,97
19,15,6,20,12,9,14,7,0,102
19,15,6,20,14,5,18,0,0,97
19,15,6,20,14,5,19,19,0,117
19,15,6,20,19,0,0,0,0,79
19,15,6,20,19,8,9,16,0,112
19,15,6,20,19,15,1,16,0,111
19,15,6,20,20,1,3,11,0,95
19,15,6,20,23,1,18,5,0,107
19,15,6,20,23,1,18,5,19,126
19,15,6,20,23,15,15,4,0,117
19,15,6,20,23,15,15,4,19,136
19,15,7,0,0,0,0,0,0,41
19,15,7,5,18,0,0,0,0,64
19,15,7,5,20,0,0,0,0,66
19,15,7,7,1,18,20,8,0,95
19,15,7,7,5,4,0,0,0,57
19,15,7,7,25,0,0,0,0,73
19,15,7,7,9,5,18,0,0,80
19,15,7,7,9,5,19,20,0,101
19,15,7,7,9,12,25,0,0,94
19,15,7,7,9,14,5,19,19,114
19,15,7,7,9,14,7,0,0,78
19,15,25,0,0,0,0,0,0,59
19,15,25,1,0,0,0,0,0,60
19,15,25,1,19,0,0,0,0,79
19,15,25,1,20,5,0,0,0,85
19,15,25,2,5,1,14,0,0,81
19,15,25,2,5,1,14,19,0,100
19,15,9,7,14,0,0,0,0,64
19,15,9,7,14,5,0,0,0,69
19,15,9,7,14,5,5,0,0,74
19,15,9,12,0,0,0,0,0,55
19,15,9,12,1,7,5,0,0,68
19,15,9,12,1,7,5,19,0,87
19,15,9,12,2,15,18,14,5,109
19,15,9,12,5,4,0,0,0,64
19,15,25,12,5,4,0,0,0,80
19,15,9,12,25,0,0,0,0,80
19,15,9,12,9,5,18,0,0,87
19,15,9,12,9,5,19,20,0,108
19,15,9,12,9,14,7,0,0,85
19,15,9,12,12,5,19,19,0,110
19,15,9,12,16,18,15,15,6,125
19,15,9,12,19,0,0,0,0,74
19,15,9,12,21,18,5,0,0,99
19,15,9,12,21,18,5,19,0,118
19,15,25,13,9,12,11,0,0,104
19,15,25,13,9,12,11,19,0,123
19,15,9,18,0,0,0,0,0,61
19,15,9,18,5,5,0,0,0,71
19,15,9,18,5,5,19,0,0,90
19,15,25,19,0,0,0,0,0,78
19,15,25,21,26,5,19,0,0,130
19,15,10,1,19,0,0,0,0,64
19,15,10,15,21,18,14,0,0,112
19,15,10,15,21,18,14,5,4,121
19,15,10,15,21,18,14,5,25,142
19,15,10,15,21,18,14,5,18,135
19,15,10,15,21,18,14,19,0,131
19,15,11,0,0,0,0,0,0,45
19,15,11,1,0,0,0,0,0,46
19,15,11,5,0,0,0,0,0,50
19,15,11,5,13,1,14,0,0,78
19,15,11,5,13,1,14,18,25,121
19,15,11,5,13,5,14,0,0,82
19,15,11,5,14,0,0,0,0,64
19,15,11,5,19,0,0,0,0,69
19,15,11,15,0,0,0,0,0,60
19,15,11,15,12,0,0,0,0,72
19,15,11,15,12,19,0,0,0,91
19,15,12,1,3,5,0,0,0,55
19,15,12,1,3,5,4,0,0,59
19,15,12,1,3,5,6,21,12,94
19,15,12,1,3,5,18,0,0,73
19,15,12,1,3,5,18,19,0,92
19,15,12,1,3,5,19,0,0,74
19,15,12,1,3,8,0,0,0,58
19,15,12,1,3,9,14,7,0,80
19,15,12,1,3,9,15,21,19,114
19,15,12,1,25,0,0,0,0,72
19,15,12,1,14,0,0,0,0,61
19,15,12,1,14,1,12,0,0,74
19,15,12,1,14,4,0,0,0,65
19,15,12,1,14,4,5,18,0,88
19,15,12,1,14,4,5,18,19,107
19,15,12,1,14,4,18,1,0,84
19,15,12,1,14,4,19,0,0,84
19,15,12,1,14,5,9,14,0,89
19,15,12,1,14,5,9,14,5,94
19,15,12,1,14,5,15,21,19,121
19,15,12,1,14,9,1,0,0,71
19,15,12,1,14,9,4,9,14,97
19,15,12,1,14,9,14,0,0,84
19,15,12,1,14,9,14,5,0,89
19,15,12,1,14,9,14,5,19,108
19,15,12,1,14,9,14,19,0,103
19,15,12,1,14,15,9,4,0,89
19,15,12,1,14,15,19,0,0,95
19,15,12,1,14,19,0,0,0,80
19,15,12,1,14,21,13,19,0,114
19,15,12,1,18,0,0,0,0,65
19,15,12,1,18,25,0,0,0,90
19,15,12,1,18,9,1,0,0,75
19,15,12,1,18,9,5,7,15,101
19,15,12,1,18,9,9,1,0,84
19,15,12,1,18,9,19,5,0,98
19,15,12,1,18,9,19,5,4,102
19,15,12,1,18,9,19,5,19,117
19,15,12,1,18,9,19,13,0,106
19,15,12,1,18,9,19,13,19,125
19,15,12,1,18,9,19,20,0,113
19,15,12,1,18,9,21,13,19,127
19,15,12,1,18,9,26,5,0,105
19,15,12,1,18,9,26,5,4,109
19,15,12,1,18,9,26,5,19,124
19,15,12,1,20,5,0,0,0,72
19,15,12,1,20,5,4,0,0,76
19,15,12,1,20,5,19,0,0,91
19,15,12,1,20,9,1,0,0,77
19,15,12,1,20,9,14,7,0,97
19,15,12,1,20,9,15,14,0,105
19,15,12,1,20,9,15,14,19,124
19,15,12,1,20,9,21,13,0,110
19,15,12,1,20,20,9,1,0,97
19,15,12,1,26,26,9,0,0,108
19,15,12,4,0,0,0,0,0,50
19,15,12,4,1,4,15,0,0,70
19,15,12,4,1,4,15,5,19,94
19,15,12,4,1,4,15,19,0,89
19,15,12,4,1,14,5,12,0,82
19,15,12,4,1,14,18,9,5,97
19,15,12,4,1,14,19,0,0,84
19,15,12,4,1,20,0,0,0,71
19,15,12,4,5,18,0,0,0,73
19,15,12,4,5,18,5,4,0,82
19,15,12,4,5,18,5,18,0,96
19,15,12,4,5,18,5,18,19,115
19,15,12,4,5,18,9,14,7,103
19,15,12,4,5,18,19,0,0,92
19,15,12,4,9,0,0,0,0,59
19,15,12,4,9,5,18,0,0,82
19,15,12,4,9,5,18,5,4,91
19,15,12,4,9,5,18,25,0,107
19,15,12,4,9,5,18,12,25,119
19,15,12,4,9,5,18,19,0,101
19,15,12,4,15,0,0,0,0,65
19,15,12,5,0,0,0,0,0,51
19,15,12,5,1,19,0,0,0,71
19,15,12,5,3,9,19,5,0,87
19,15,12,5,3,9,19,5,4,91
19,15,12,5,3,9,19,5,19,106
19,15,12,5,3,9,19,13,0,95
19,15,12,5,3,9,19,13,19,114
19,15,12,5,3,9,19,20,0,102
19,15,12,5,3,9,19,20,19,121
19,15,12,5,3,9,26,5,0,94
19,15,12,5,3,9,26,5,4,98
19,15,12,5,3,9,26,5,18,112
19,15,12,5,3,9,26,5,19,113
19,15,12,5,4,0,0,0,0,55
19,15,12,5,9,0,0,0,0,60
19,15,12,5,9,6,15,18,13,112
19,15,12,5,9,12,0,0,0,72
19,15,12,5,9,14,0,0,0,74
19,15,12,5,25,14,0,0,0,90
19,15,12,5,25,14,5,0,0,95
19,15,12,5,12,5,19,19,0,106
19,15,12,5,12,25,0,0,0,88
19,15,12,5,13,14,0,0,0,78
19,15,12,5,13,14,5,18,0,101
19,15,12,5,13,14,5,19,19,121
19,15,12,5,13,14,5,19,20,122
19,15,12,5,13,14,9,6,25,118
19,15,12,5,13,14,9,19,5,111
19,15,12,5,13,14,9,20,25,132
19,15,12,5,13,14,9,26,5,118
19,15,12,5,13,14,12,25,0,115
19,15,12,5,14,5,19,19,0,108
19,15,12,5,14,5,20,20,5,115
19,15,12,5,14,9,1,12,0,87
19,15,12,5,14,9,20,5,0,99
19,15,12,5,14,9,20,9,19,122
19,15,12,5,14,9,21,13,0,108
19,15,12,5,14,15,9,4,0,93
19,15,12,5,14,15,9,4,19,112
19,15,12,5,14,20,9,14,5,113
19,15,12,5,16,9,5,3,5,89
19,15,12,5,16,12,1,20,5,105
19,15,12,5,16,18,9,14,20,128
19,15,12,5,18,0,0,0,0,69
19,15,12,5,18,5,20,0,0,94
19,15,12,5,18,5,20,19,0,113
19,15,12,5,18,20,0,0,0,89
19,15,12,5,19,0,0,0,0,70
19,15,12,5,21,19,0,0,0,91
19,15,12,6,1,0,0,0,0,53
19,15,12,6,1,20,1,18,1,93
19,15,12,6,5,7,5,0,0,69
19,15,12,6,5,7,5,19,0,88
19,15,12,6,5,7,7,9,0,80
19,15,12,6,5,7,7,9,15,95
19,15,12,6,7,5,0,0,0,64
19,15,12,7,5,12,0,0,0,70
19,15,12,9,0,0,0,0,0,55
19,15,12,9,1,20,9,22,5,112
19,15,12,9,3,9,20,0,0,87
19,15,12,9,3,9,20,5,4,96
19,15,12,9,3,9,20,5,5,97
19,15,12,9,3,9,20,5,18,110
19,15,12,9,3,9,20,15,18,120
19,15,12,9,3,9,20,19,0,106
19,15,12,9,4,0,0,0,0,59
19,15,12,9,4,1,7,15,19,101
19,15,12,9,4,1,18,5,0,83
19,15,12,9,4,1,18,25,0,103
19,15,12,9,4,1,18,9,3,90
19,15,12,9,4,1,20,5,0,85
19,15,12,9,4,1,20,5,4,89
19,15,12,9,4,5,15,0,0,79
19,15,12,9,4,5,18,0,0,82
19,15,12,9,4,5,19,20,0,103
19,15,12,9,4,9,0,0,0,68
19,15,12,9,4,9,6,25,0,99
19,15,12,9,4,9,12,12,21,113
19,15,12,9,4,9,19,8,0,95
19,15,12,9,4,9,19,13,0,100
19,15,12,9,4,9,19,20,0,107
19,15,12,9,4,9,20,25,0,113
19,15,12,9,4,12,25,0,0,96
19,15,12,9,4,14,5,19,19,116
19,15,12,9,4,15,0,0,0,74
19,15,12,9,4,19,0,0,0,78
19,15,12,9,4,21,4,9,0,93
19,15,12,9,4,21,13,0,0,93
19,15,12,9,4,21,19,0,0,99
19,15,12,9,6,15,18,13,0,107
19,15,12,9,6,21,7,5,0,94
19,15,12,9,6,21,7,9,4,102
19,15,12,9,12,15,17,21,25,145
19,15,12,9,12,21,14,1,18,121
19,15,12,9,14,7,0,0,0,76
19,15,12,9,15,14,0,0,0,84
19,15,12,9,15,14,19,0,0,103
19,15,12,9,16,5,4,0,0,80
19,15,12,9,16,5,4,1,12,93
19,15,12,9,16,19,9,19,13,131
19,15,12,9,16,19,9,19,20,138
19,15,12,9,17,21,9,4,0,106
19,15,12,9,17,21,9,4,19,125
19,15,12,9,19,20,0,0,0,94
19,15,12,9,19,20,5,0,0,99
19,15,12,9,20,1,9,18,5,108
19,15,12,9,20,1,18,25,0,119
19,15,12,9,20,9,4,1,12,101
19,15,12,9,20,15,14,0,0,104
19,15,12,9,20,15,14,19,0,123
19,15,12,9,20,21,4,5,0,105
19,15,12,9,20,21,4,5,19,124
19,15,12,12,1,18,0,0,0,77
19,15,12,12,1,18,9,1,0,87
19,15,12,12,5,18,0,0,0,81
19,15,12,12,5,18,5,20,0,106
19,15,12,12,5,18,5,20,19,125
19,15,12,12,9,3,11,5,18,104
19,15,12,13,9,26,1,20,5,120
19,15,12,14,0,0,0,0,0,60
19,15,12,15,4,0,0,0,0,65
19,15,12,15,4,9,0,0,0,74
19,15,12,15,4,9,26,5,0,105
19,15,12,15,5,4,0,0,0,70
19,15,12,15,9,14,7,0,0,91
19,15,12,15,9,19,20,0,0,109
19,15,12,15,9,19,20,9,3,121
19,15,12,15,9,19,20,19,0,128
19,15,12,15,14,3,8,1,11,98
19,15,12,15,14,5,20,19,0,119
19,15,12,15,14,5,20,26,0,126
19,15,12,15,14,9,19,20,0,123
19,15,12,15,14,19,0,0,0,94
19,15,12,15,19,0,0,0,0,80
19,15,12,15,20,8,0,0,0,89
19,15,12,15,20,9,14,11,0,115
19,15,12,15,20,14,9,11,0,115
19,15,12,16,21,7,1,0,0,91
19,15,12,16,21,7,9,4,0,103
19,15,12,19,0,0,0,0,0,65
19,15,12,19,20,9,3,5,0,102
19,15,12,19,20,9,3,5,19,121
19,15,12,19,20,9,20,9,1,124
19,15,12,21,2,12,5,0,0,86
19,15,12,21,2,12,5,19,0,105
19,15,12,21,2,12,25,0,0,106
19,15,12,21,13,0,0,0,0,80
19,15,12,21,13,19,0,0,0,99
19,15,12,21,14,1,18,0,0,100
19,15,12,21,19,0,0,0,0,86
19,15,12,21,20,5,0,0,0,92
19,15,12,21,20,5,19,0,0,111
19,15,12,21,20,9,15,0,0,111
19,15,12,21,20,9,15,14,0,125
19,15,12,21,20,9,15,14,19,144
19,15,12,21,20,9,22,5,0,123
19,15,12,21,20,9,26,5,0,127
19,15,12,21,20,9,26,5,18,145
19,15,12,21,20,15,18,25,0,145
19,15,12,21,20,21,19,0,0,127
19,15,12,22,0,0,0,0,0,68
19,15,12,22,1,1,20,5,4,99
19,15,12,22,1,2,12,5,0,88
19,15,12,22,1,2,12,5,4,92
19,15,12,22,1,20,5,0,0,94
19,15,12,22,1,20,5,4,0,98
19,15,12,22,1,20,5,19,0,113
19,15,12,22,1,20,9,14,7,119
19,15,12,22,1,20,9,15,14,127
19,15,12,22,5,0,0,0,0,73
19,15,12,22,5,4,0,0,0,77
19,15,12,22,5,13,5,14,20,125
19,15,12,22,5,14,3,25,0,115
19,15,12,22,5,14,4,0,0,91
19,15,12,22,5,14,20,0,0,107
19,15,12,22,5,14,20,12,25,144
19,15,12,22,5,14,20,19,0,126
19,15,12,22,5,18,0,0,0,91
19,15,12,22,5,18,19,0,0,110
19,15,12,22,5,19,0,0,0,92
19,15,12,22,9,14,7,0,0,98
19,15,12,22,15,12,25,26,5,151
19,15,12,22,21,19,0,0,0,108
19,15,13,1,3,21,12,5,0,89
19,15,13,1,12,15,0,0,0,75
19,15,13,1,16,12,1,19,13,109
19,15,13,1,19,0,0,0,0,67
19,15,13,1,20,1,0,0,0,69
19,15,13,1,20,5,14,0,0,87
19,15,13,1,20,5,14,5,19,111
19,15,13,1,20,9,3,0,0,80
19,15,13,1,20,9,3,1,12,93
19,15,13,1,20,9,3,19,0,99
19,15,13,1,20,9,19,13,0,109
19,15,13,1,20,9,19,20,0,116
19,15,13,1,20,15,13,5,0,101
19,15,13,1,20,15,13,9,3,108
19,15,13,1,20,15,21,19,0,123
19,15,13,2,5,18,0,0,0,72
19,15,13,2,5,18,9,19,8,108
19,15,13,2,5,18,12,25,0,109
19,15,13,2,18,5,0,0,0,72
19,15,13,2,18,5,9,19,8,108
19,15,13,2,18,5,9,20,5,106
19,15,13,2,18,5,12,25,0,109
19,15,13,2,18,5,18,15,0,105
19,15,13,2,18,5,18,15,19,124
19,15,13,2,18,15,21,19,0,122
19,15,13,4,5,12,0,0,0,68
19,15,13,4,9,5,12,0,0,77
19,15,13,5,0,0,0,0,0,52
19,15,13,5,2,15,4,25,0,98
19,15,13,5,4,1,25,0,0,82
19,15,13,5,4,1,25,19,0,101
19,15,13,5,4,5,1,12,0,74
19,15,13,5,7,1,20,5,0,85
19,15,13,5,8,15,23,0,0,98
19,15,13,5,15,14,5,0,0,86
19,15,13,5,15,14,5,12,12,110
19,15,13,5,15,14,5,19,0,105
19,15,13,5,16,1,18,20,0,107
19,15,13,5,16,12,1,3,5,89
19,15,13,5,18,19,5,20,19,133
19,15,13,5,20,0,0,0,0,72
19,15,13,5,20,8,9,14,7,110
19,15,13,5,20,9,13,5,0,99
19,15,13,5,20,9,13,5,19,118
19,15,13,5,22,5,18,0,0,97
19,15,13,5,23,1,25,0,0,101
19,15,13,5,23,1,25,19,0,120
19,15,13,5,23,8,1,20,0,104
19,15,13,5,23,8,1,20,19,123
19,15,13,5,23,8,5,14,0,102
19,15,13,5,23,8,5,18,5,111
19,15,13,5,23,8,25,0,0,108
19,15,13,5,23,8,9,12,5,109
19,15,13,5,23,9,19,5,0,108
19,15,13,9,3,0,0,0,0,59
19,15,13,9,20,1,12,0,0,89
19,15,13,9,20,5,0,0,0,81
19,15,13,9,20,5,19,0,0,100
19,15,13,9,20,9,3,0,0,88
19,15,13,12,5,18,0,0,0,82
19,15,13,13,1,0,0,0,0,61
19,15,13,13,1,9,20,5,0,95
19,15,13,13,5,12,9,5,18,109
19,15,13,13,9,20,5,0,0,94
19,15,13,14,5,0,0,0,0,66
19,15,13,14,5,18,0,0,0,84
19,15,13,14,9,1,12,0,0,83
19,15,13,14,9,1,20,5,0,96
19,15,13,14,9,6,25,0,0,101
19,15,13,14,9,6,9,3,0,88
19,15,13,14,9,6,21,7,5,109
19,15,13,14,15,12,5,14,20,127
19,15,13,14,15,12,9,19,13,129
19,15,13,14,15,12,9,26,5,128
19,15,13,16,1,25,0,0,0,89
19,15,13,16,14,5,0,0,0,82
19,15,13,16,14,5,18,0,0,100
19,15,13,16,14,15,21,18,0,131
19,15,14,1,2,12,5,0,0,68
19,15,14,1,7,18,1,13,0,88
19,15,14,1,14,3,5,0,0,71
19,15,14,1,14,3,5,19,0,90
19,15,14,1,14,3,25,0,0,91
19,15,14,1,14,20,0,0,0,83
19,15,14,1,14,20,1,12,0,96
19,15,14,1,14,20,9,3,0,95
19,15,14,1,14,20,9,14,1,107
19,15,14,1,14,20,19,0,0,102
19,15,14,1,18,13,1,14,0,95
19,15,14,1,18,13,5,14,0,99
19,15,14,1,18,19,0,0,0,86
19,15,14,1,20,1,0,0,0,70
19,15,14,1,20,1,19,0,0,89
19,15,14,1,20,9,14,1,0,93
19,15,14,1,20,9,14,1,19,112
19,15,14,1,20,9,14,5,0,97
19,15,14,1,20,9,15,14,0,107
19,15,14,3,25,0,0,0,0,76
19,15,14,4,0,0,0,0,0,52
19,15,14,4,1,7,5,0,0,65
19,15,14,4,1,20,9,15,14,111
19,15,14,4,5,0,0,0,0,57
19,15,14,4,5,12,9,0,0,78
19,15,14,4,5,18,0,0,0,75
19,15,14,4,5,18,19,0,0,94
19,15,14,4,5,19,0,0,0,76
19,15,14,5,0,0,0,0,0,53
19,15,14,5,18,9,0,0,0,80
19,15,14,5,19,0,0,0,0,72
19,15,14,7,2,1,7,0,0,65
19,15,14,7,2,9,18,4,0,88
19,15,14,7,2,9,18,4,19,107
19,15,14,7,2,15,15,11,0,98
19,15,14,7,2,15,15,11,19,117
19,15,14,7,3,18,1,6,20,103
19,15,14,7,5,18,0,0,0,78
19,15,14,7,6,5,19,20,0,105
19,15,14,7,6,5,19,20,19,124
19,15,14,7,6,21,12,0,0,94
19,15,14,7,6,21,12,12,25,131
19,15,14,7,25,0,0,0,0,80
19,15,14,7,11,15,11,0,0,92
19,15,14,7,12,1,14,4,0,86
19,15,14,7,12,5,0,0,0,72
19,15,14,7,12,5,19,19,0,110
19,15,14,7,12,5,20,0,0,92
19,15,14,7,12,9,11,5,0,92
19,15,14,7,13,1,14,0,0,83
19,15,14,7,19,0,0,0,0,74
19,15,14,7,19,13,9,20,8,124
19,15,14,7,19,20,5,18,0,117
19,15,14,7,19,20,5,18,19,136
19,15,14,8,15,15,4,0,0,90
19,15,14,8,15,15,4,19,0,109
19,15,14,9,3,0,0,0,0,60
19,15,14,9,3,1,0,0,0,61
19,15,14,9,3,1,12,12,25,110
19,15,14,9,3,1,20,5,0,86
19,15,14,9,3,1,20,5,4,90
19,15,14,9,3,1,20,5,19,105
19,15,14,9,3,1,20,15,18,114
19,15,14,9,3,19,0,0,0,79
19,15,14,9,14,7,0,0,0,78
19,15,14,9,15,21,0,0,0,93
19,15,14,11,0,0,0,0,0,59
19,15,14,12,5,19,19,0,0,103
19,15,14,12,25,0,0,0,0,85
19,15,14,12,9,11,5,0,0,85
19,15,14,14,5,20,0,0,0,87
19,15,14,14,5,20,1,18,25,131
19,15,14,14,5,20,5,4,0,96
19,15,14,14,5,20,5,5,18,115
19,15,14,14,5,20,9,3,0,99
19,15,14,14,5,20,9,14,7,117
19,15,14,14,5,20,9,19,5,120
19,15,14,14,5,20,9,19,8,123
19,15,14,14,5,20,9,19,20,135
19,15,14,14,5,20,9,26,5,127
19,15,14,14,5,20,18,25,0,130
19,15,14,14,5,20,19,0,0,106
19,15,14,14,5,20,20,5,4,116
19,15,14,14,9,5,19,0,0,95
19,15,14,14,9,11,9,14,19,124
19,15,14,14,15,2,21,15,25,140
19,15,14,15,2,21,15,25,0,126
19,15,14,15,7,18,1,13,0,102
19,15,14,15,13,5,20,5,18,124
19,15,14,15,18,1,14,20,0,116
19,15,14,15,18,1,14,20,19,135
19,15,14,15,18,5,19,0,0,105
19,15,14,15,18,9,3,0,0,93
19,15,14,15,18,9,6,9,3,108
19,15,14,15,18,9,20,25,0,135
19,15,14,15,18,9,26,5,0,121
19,15,14,15,18,15,21,19,0,136
19,15,14,15,22,15,24,0,0,124
19,15,14,15,22,15,24,5,19,148
19,15,14,19,0,0,0,0,0,67
19,15,14,19,8,9,16,0,0,100
19,15,14,19,8,9,16,19,0,119
19,15,14,19,25,0,0,0,0,92
19,15,14,19,9,5,0,0,0,81
19,15,14,19,9,5,18,0,0,99
19,15,14,19,9,5,19,20,0,120
19,15,14,20,5,14,14,1,0,102
19,15,15,3,8,15,14,7,0,96
19,15,15,3,8,15,14,7,19,115
19,15,15,4,12,5,0,0,0,70
19,15,15,4,12,5,4,0,0,74
19,15,15,4,12,25,0,0,0,90
19,15,15,4,12,9,14,7,0,95
19,15,15,5,25,0,0,0,0,79
19,15,15,7,1,14,0,0,0,71
19,15,15,7,5,5,0,0,0,66
19,15,15,7,5,5,4,0,0,70
19,15,15,7,5,5,9,14,7,96
19,15,15,7,5,9,14,7,0,91
19,15,15,8,15,14,7,0,0,93
19,15,15,10,5,5,0,0,0,69
19,15,15,11,0,0,0,0,0,60
19,15,15,11,25,0,0,0,0,85
19,15,15,11,9,5,0,0,0,74
19,15,15,11,19,0,0,0,0,79
19,15,15,12,0,0,0,0,0,61
19,15,15,12,15,15,19,0,0,110
19,15,15,13,0,0,0,0,0,62
19,15,15,14,0,0,0,0,0,63
19,15,15,14,5,18,19,0,0,105
19,15,15,14,5,19,20,0,0,107
19,15,15,14,25,0,0,0,0,88
19,15,15,14,9,19,8,0,0,99
19,15,15,14,12,25,0,0,0,100
19,15,15,16,5,18,0,0,0,88
19,15,15,18,1,23,14,0,0,105
19,15,15,18,4,0,0,0,0,71
19,15,15,18,5,25,14,0,0,111
19,15,15,18,11,5,5,0,0,88
19,15,15,18,11,9,0,0,0,87
19,15,15,18,11,25,0,0,0,103
19,15,15,18,13,1,0,0,0,81
19,15,15,19,15,15,0,0,0,98
19,15,15,20,5,4,0,0,0,78
19,15,15,20,5,18,0,0,0,92
19,15,15,20,5,18,11,9,14,126
19,15,15,20,8,0,0,0,0,77
19,15,15,20,8,5,0,0,0,82
19,15,15,20,8,5,4,0,0,86
19,15,15,20,8,5,18,0,0,100
19,15,15,20,8,5,18,5,18,123
19,15,15,20,8,5,18,19,0,119
19,15,15,20,8,5,19,0,0,101
19,15,15,20,8,5,19,20,0,121
19,15,15,20,8,6,1,19,20,123
19,15,15,20,8,6,21,12,0,116
19,15,15,20,8,9,14,7,0,107
19,15,15,20,8,12,5,19,19,132
19,15,15,20,8,12,25,0,0,114
19,15,15,20,8,19,0,0,0,96
19,15,15,20,8,19,1,25,0,122
19,15,15,20,8,19,1,9,4,110
19,15,15,20,8,19,1,25,19,141
19,15,15,20,8,19,1,23,0,120
19,15,15,20,25,0,0,0,0,94
19,15,15,20,9,5,4,0,0,87
19,15,15,20,9,5,18,0,0,101
19,15,15,20,9,5,19,20,0,122
19,15,15,20,25,9,14,7,0,124
19,15,15,20,9,12,25,0,0,115
19,15,15,20,25,12,9,11,5,131
19,15,15,20,9,14,5,19,19,135
19,15,15,20,9,14,7,0,0,99
19,15,15,20,9,19,8,0,0,105
19,15,15,20,12,5,19,19,0,124
19,15,15,20,12,9,11,5,0,106
19,15,15,20,16,18,15,15,6,139
19,15,15,20,19,0,0,0,0,88
19,15,16,5,0,0,0,0,0,55
19,15,16,8,5,13,5,0,0,81
19,15,16,8,5,14,5,0,0,82
19,15,16,8,25,0,0,0,0,83
19,15,16,8,9,3,0,0,0,70
19,15,16,8,9,3,1,12,0,83
19,15,16,8,9,19,13,19,0,118
19,15,16,8,9,19,20,5,18,129
19,15,16,8,9,19,20,9,3,118
19,15,16,8,9,19,20,19,0,125
19,15,16,8,15,13,15,18,5,124
19,15,16,8,15,18,9,1,0,101
19,15,16,8,19,0,0,0,0,77
19,15,16,8,20,1,0,0,0,79
19,15,16,9,20,5,0,0,0,84
19,15,16,9,20,5,4,0,0,88
19,15,16,9,20,5,19,0,0,103
19,15,16,9,20,9,14,7,0,109
19,15,16,9,20,9,15,14,0,117
19,15,16,15,18,0,0,0,0,83
19,15,16,15,18,1,20,5,0,109
19,15,16,15,18,9,6,9,3,110
19,15,16,15,18,15,19,5,0,122
19,15,16,15,18,15,21,19,0,138
19,15,16,15,18,19,0,0,0,102
19,15,16,16,5,4,0,0,0,75
19,15,16,16,5,18,0,0,0,89
19,15,16,16,25,0,0,0,0,91
19,15,16,16,9,5,18,0,0,98
19,15,16,16,9,5,19,20,0,119
19,15,16,16,9,14,5,19,19,132
19,15,16,16,9,14,7,0,0,96
19,15,16,18,1,14,9,0,0,92
19,15,16,18,1,14,9,14,15,121
19,15,16,18,1,14,9,19,20,131
19,15,16,18,1,14,15,0,0,98
19,15,16,18,1,14,15,19,0,117
19,15,16,19,0,0,0,0,0,69
19,15,18,1,0,0,0,0,0,53
19,15,18,1,7,5,0,0,0,65
19,15,18,1,12,0,0,0,0,65
19,15,18,1,12,9,21,13,0,108
19,15,18,1,14,3,5,0,0,75
19,15,18,1,19,0,0,0,0,72
19,15,18,2,1,2,12,5,0,74
19,15,18,2,1,20,5,0,0,80
19,15,18,2,1,20,5,19,0,99
19,15,18,2,5,4,0,0,0,63
19,15,18,2,5,14,20,0,0,93
19,15,18,2,5,14,20,19,0,112
19,15,18,2,5,20,0,0,0,79
19,15,18,2,5,20,19,0,0,98
19,15,18,2,9,3,0,0,0,66
19,15,18,2,9,12,5,0,0,80
19,15,18,2,9,14,0,0,0,77
19,15,18,2,9,14,7,0,0,84
19,15,18,2,9,14,15,19,5,116
19,15,18,2,9,20,1,14,0,98
19,15,18,2,9,20,5,0,0,88
19,15,18,2,9,20,9,3,0,95
19,15,18,2,9,20,9,26,5,123
19,15,18,2,9,20,15,12,0,110
19,15,18,2,9,20,15,12,19,129
19,15,18,2,15,12,0,0,0,81
19,15,18,2,15,19,5,0,0,93
19,15,18,2,15,19,5,19,0,112
19,15,18,2,15,19,9,4,0,101
19,15,18,2,15,19,9,4,5,106
19,15,18,2,19,0,0,0,0,73
19,15,18,3,5,18,0,0,0,78
19,15,18,3,5,18,5,18,0,101
19,15,18,3,5,18,5,18,19,120
19,15,18,3,5,18,5,19,19,121
19,15,18,3,5,18,25,0,0,103
19,15,18,3,5,18,9,5,19,111
19,15,18,3,5,18,9,14,7,108
19,15,18,3,5,18,9,26,5,118
19,15,18,3,5,18,15,21,19,133
19,15,18,3,8,9,14,0,0,86
19,15,18,4,0,0,0,0,0,56
19,15,18,4,1,0,0,0,0,57
19,15,18,4,5,19,0,0,0,80
19,15,18,4,9,4,0,0,0,69
19,15,18,4,9,4,9,20,25,123
19,15,18,4,9,4,12,25,0,106
19,15,18,4,9,14,5,0,0,84
19,15,18,4,9,14,5,19,0,103
19,15,18,4,9,14,9,0,0,88
19,15,18,4,9,14,15,0,0,94
19,15,18,4,15,0,0,0,0,71
19,15,18,4,15,18,0,0,0,89
19,15,18,4,15,18,19,0,0,108
19,15,18,4,19,0,0,0,0,75
19,15,18,5,0,0,0,0,0,57
19,15,18,5,4,4,9,1,0,75
19,15,18,5,4,9,1,0,0,71
19,15,18,5,4,9,1,12,0,83
19,15,18,5,4,9,1,20,5,96
19,15,18,5,4,9,15,9,4,98
19,15,18,5,4,9,21,13,0,104
19,15,18,5,5,0,0,0,0,62
19,15,18,5,6,15,15,20,0,113
19,15,18,5,8,1,23,11,0,100
19,15,18,5,8,5,1,4,0,75
19,15,18,5,8,5,1,4,19,94
19,15,18,5,8,15,14,0,0,94
19,15,18,5,12,25,0,0,0,94
19,15,18,5,12,19,0,0,0,88
19,15,18,5,13,1,0,0,0,71
19,15,18,5,14,5,19,19,0,114
19,15,18,5,18,0,0,0,0,75
19,15,18,5,19,0,0,0,0,76
19,15,18,5,19,20,0,0,0,96
19,15,18,7,8,5,0,0,0,72
19,15,18,7,8,15,0,0,0,82
19,15,18,7,8,15,19,0,0,101
19,15,18,7,8,21,13,19,0,120
19,15,18,7,15,0,0,0,0,74
19,15,18,7,15,19,0,0,0,93
19,15,18,9,0,0,0,0,0,61
19,15,18,25,0,0,0,0,0,77
19,15,18,9,3,9,4,0,0,77
19,15,18,9,3,9,14,5,0,92
19,15,18,9,3,15,9,4,0,92
19,15,18,9,14,7,0,0,0,82
19,15,18,9,14,7,19,0,0,101
19,15,18,9,20,5,0,0,0,86
19,15,18,9,20,5,19,0,0,105
19,15,18,9,20,9,3,0,0,93
19,15,18,9,20,9,3,1,12,106
19,15,18,14,0,0,0,0,0,66
19,15,18,14,1,18,5,0,0,90
19,15,18,14,1,18,9,0,0,94
19,15,18,14,5,4,0,0,0,75
19,15,18,14,5,18,0,0,0,89
19,15,18,14,5,18,19,0,0,108
19,15,18,14,9,14,7,0,0,96
19,15,18,14,19,0,0,0,0,85
19,15,18,15,2,1,14,0,0,84
19,15,18,15,3,8,5,0,0,83
19,15,18,15,3,8,5,19,0,102
19,15,18,15,18,1,12,0,0,98
19,15,18,15,18,1,20,5,0,111
19,15,18,15,18,1,20,5,19,130
19,15,18,15,18,9,1,12,0,107
19,15,18,15,18,9,20,25,0,139
19,15,18,15,18,9,26,5,0,125
19,15,18,15,19,5,0,0,0,91
19,15,18,15,19,5,19,0,0,110
19,15,18,15,19,9,12,0,0,107
19,15,18,15,19,9,19,0,0,114
19,15,18,15,19,9,19,5,19,138
19,15,18,16,20,9,15,14,0,126
19,15,18,16,20,9,15,14,19,145
19,15,18,16,20,9,22,5,0,124
19,15,18,18,1,0,0,0,0,71
19,15,18,18,1,14,3,5,0,93
19,15,18,18,5,12,0,0,0,87
19,15,18,18,5,12,19,0,0,106
19,15,18,18,5,14,0,0,0,89
19,15,18,18,25,0,0,0,0,95
19,15,18,18,9,5,18,0,0,102
19,15,18,18,9,5,19,20,0,123
19,15,18,18,25,9,19,8,0,131
19,15,18,18,9,12,25,0,0,116
19,15,18,18,9,14,5,19,19,136
19,15,18,18,15,1,0,0,0,86
19,15,18,18,15,23,0,0,0,108
19,15,18,18,15,23,5,4,0,117
19,15,18,18,15,23,5,18,0,131
19,15,18,18,15,23,5,18,19,150
19,15,18,18,15,23,6,21,12,147
19,15,18,18,15,23,25,0,0,133
19,15,18,18,15,23,9,14,7,138
19,15,18,20,0,0,0,0,0,72
19,15,18,20,1,2,12,5,0,92
19,15,18,20,1,2,12,25,0,112
19,15,18,20,1,12,0,0,0,85
19,15,18,20,1,14,3,5,0,95
19,15,18,20,1,20,9,15,14,131
19,15,18,20,5,4,0,0,0,81
19,15,18,20,5,18,0,0,0,95
19,15,18,20,5,18,19,0,0,114
19,15,18,20,5,19,0,0,0,96
19,15,18,20,25,0,0,0,0,97
19,15,18,20,9,1,18,25,0,125
19,15,18,20,9,5,0,0,0,86
19,15,18,20,9,5,4,0,0,90
19,15,18,20,9,5,9,14,7,116
19,15,18,20,9,5,19,0,0,105
19,15,18,20,9,12,5,7,5,110
19,15,18,20,9,12,5,7,9,114
19,15,18,20,9,12,5,7,25,130
19,15,18,20,9,13,5,14,20,133
19,15,18,20,9,14,7,0,0,102
19,15,18,20,9,20,1,0,0,102
19,15,18,20,9,20,9,15,14,139
19,15,18,20,12,25,0,0,0,109
19,15,18,20,12,9,7,5,0,105
19,15,18,20,13,5,14,20,0,124
19,15,18,20,19,0,0,0,0,91
19,15,18,20,23,9,20,8,0,132
19,15,18,21,19,0,0,0,0,92
19,15,18,22,1,0,0,0,0,75
19,15,19,8,0,0,0,0,0,61
19,15,19,8,5,4,0,0,0,70
19,15,19,9,5,0,0,0,0,67
19,15,19,15,9,19,8,0,0,104
19,15,19,16,9,18,15,0,0,111
19,15,19,17,21,9,12,0,0,112
19,15,19,19,0,0,0,0,0,72
19,15,19,19,9,5,7,15,0,108
19,15,19,19,12,5,0,0,0,89
19,15,19,20,5,14,21,20,9,142
19,15,19,20,5,14,21,20,15,148
19,15,20,0,0,0,0,0,0,54
19,15,20,5,18,9,1,12,0,99
19,15,20,8,0,0,0,0,0,62
19,15,20,8,19,0,0,0,0,81
19,15,20,9,5,0,0,0,0,68
19,15,20,14,9,1,0,0,0,78
19,15,20,14,9,11,0,0,0,88
19,15,20,15,12,0,0,0,0,81
19,15,20,15,12,19,0,0,0,100
19,15,20,19,0,0,0,0,0,73
19,15,20,20,1,7,5,0,0,87
19,15,20,20,5,4,0,0,0,83
19,15,20,20,5,18,0,0,0,97
19,15,20,20,5,18,25,0,0,122
19,15,20,20,9,5,0,0,0,88
19,15,20,20,9,14,7,0,0,104
19,15,20,20,9,19,5,0,0,107
19,15,20,20,9,19,8,0,0,110
19,15,20,20,9,19,8,12,25,147
19,15,20,23,5,5,4,0,0,91
19,15,21,1,7,7,1,0,0,71
19,15,21,1,13,15,19,1,0,104
19,15,21,1,13,21,12,1,0,103
19,15,21,1,18,9,0,0,0,83
19,15,21,1,18,9,19,0,0,102
19,15,21,2,9,19,5,19,0,109
19,15,21,2,18,5,20,20,5,125
19,15,21,3,1,18,0,0,0,77
19,15,21,3,1,18,19,0,0,96
19,15,21,3,8,5,20,0,0,91
19,15,21,3,8,25,0,0,0,91
19,15,21,3,8,9,5,0,0,80
19,15,21,3,8,15,14,7,19,121
19,15,21,4,0,0,0,0,0,59
19,15,21,4,1,7,21,18,0,106
19,15,21,4,1,14,19,0,0,93
19,15,21,4,7,5,0,0,0,71
19,15,21,4,7,25,0,0,0,91
19,15,21,5,1,11,0,0,0,72
19,15,21,5,5,6,0,0,0,71
19,15,21,5,5,7,5,0,0,77
19,15,21,6,6,12,0,0,0,79
19,15,21,6,6,12,5,0,0,84
19,15,21,6,6,12,5,4,0,88
19,15,21,6,6,12,5,5,4,93
19,15,21,6,6,12,5,19,0,103
19,15,21,6,6,12,5,21,18,123
19,15,21,6,15,21,19,19,5,140
19,15,21,7,1,14,0,0,0,77
19,15,21,7,8,0,0,0,0,70
19,15,21,7,8,5,4,0,0,79
19,15,21,7,8,5,18,0,0,93
19,15,21,7,8,9,14,7,0,100
19,15,21,7,8,12,5,19,19,125
19,15,21,7,8,19,0,0,0,89
19,15,21,7,8,20,0,0,0,90
19,15,21,11,0,0,0,0,0,66
19,15,21,11,19,0,0,0,0,85
19,15,21,12,1,3,11,0,0,82
19,15,21,12,2,5,12,12,0,98
19,15,21,12,3,1,11,5,0,87
19,15,21,12,4,9,5,0,0,85
19,15,21,12,5,4,0,0,0,76
19,15,21,12,6,21,12,0,0,106
19,15,21,12,6,21,12,12,25,143
19,15,21,12,8,5,1,12,0,93
19,15,21,12,25,0,0,0,0,92
19,15,21,12,9,3,1,12,0,92
19,15,21,12,9,19,8,0,0,103
19,15,21,12,12,5,19,19,0,122
19,15,21,12,12,9,11,5,0,104
19,15,21,12,16,5,14,3,5,110
19,15,21,12,16,5,14,14,25,141
19,15,21,12,19,0,0,0,0,86
19,15,21,12,20,5,18,0,0,110
19,15,21,12,20,18,5,0,0,110
19,15,21,12,23,1,18,4,0,113
19,15,21,12,24,0,0,0,0,91
19,15,21,12,26,0,0,0,0,93
19,15,21,13,0,0,0,0,0,68
19,15,21,13,1,11,0,0,0,80
19,15,21,13,1,18,17,21,5,130
19,15,21,14,4,1,2,12,5,93
19,15,21,14,4,1,7,5,0,86
19,15,21,14,4,2,15,24,0,114
19,15,21,14,4,5,4,0,0,82
19,15,21,14,4,5,18,0,0,96
19,15,21,14,4,5,18,19,0,115
19,15,21,14,4,5,19,20,0,117
19,15,21,14,4,6,21,12,0,112
19,15,21,14,4,9,14,7,0,103
19,15,21,14,4,9,14,7,19,122
19,15,21,14,4,12,5,19,19,128
19,15,21,14,4,12,25,0,0,110
19,15,21,14,4,14,5,19,19,130
19,15,21,14,4,16,15,19,20,143
19,15,21,14,4,19,0,0,0,92
19,15,21,16,0,0,0,0,0,71
19,15,21,16,2,15,14,5,0,107
19,15,21,16,3,15,14,0,0,103
19,15,21,16,3,15,14,19,0,122
19,15,21,16,5,4,0,0,0,80
19,15,21,16,5,18,0,0,0,94
19,15,21,16,6,9,14,0,0,100
19,15,21,16,25,0,0,0,0,96
19,15,21,16,9,5,18,0,0,103
19,15,21,16,9,5,18,5,0,108
19,15,21,16,9,5,18,5,19,127
19,15,21,16,9,5,19,20,0,124
19,15,21,16,9,14,7,0,0,101
19,15,21,16,12,5,0,0,0,88
19,15,21,16,12,5,4,0,0,92
19,15,21,16,12,5,19,19,0,126
19,15,21,16,12,9,11,5,0,108
19,15,21,16,12,9,14,7,0,113
19,15,21,16,13,5,1,20,0,110
19,15,21,16,15,14,0,0,0,100
19,15,21,16,19,0,0,0,0,90
19,15,21,16,19,16,15,15,14,150
19,15,21,18,2,1,12,12,0,100
19,15,21,18,2,1,12,12,19,119
19,15,21,18,2,5,12,12,25,129
19,15,21,18,2,5,18,18,25,141
19,15,21,18,2,18,5,1,4,103
19,15,21,18,2,21,19,8,0,123
19,15,21,18,3,1,11,5,0,93
19,15,21,18,3,5,0,0,0,81
19,15,21,18,3,5,6,21,12,120
19,15,21,18,3,5,19,0,0,100
19,15,21,18,3,18,15,21,20,150
19,15,21,18,4,0,0,0,0,77
19,15,21,18,4,9,14,5,0,105
19,15,21,18,4,9,14,5,19,124
19,15,21,18,4,15,3,11,0,106
19,15,21,18,4,15,15,11,0,118
19,15,21,18,4,15,21,7,8,128
19,15,21,18,4,18,5,0,0,100
19,15,21,18,5,4,0,0,0,82
19,15,21,18,5,14,0,0,0,92
19,15,21,18,5,18,0,0,0,96
19,15,21,18,5,19,20,0,0,117
19,15,21,18,25,0,0,0,0,98
19,15,21,18,9,14,7,0,0,103
19,15,21,18,9,19,8,0,0,109
19,15,21,18,9,19,8,12,25,146
19,15,21,18,10,1,3,11,0,98
19,15,21,18,12,25,0,0,0,110
19,15,21,18,12,9,14,7,0,115
19,15,21,18,14,5,19,19,0,130
19,15,21,18,15,3,11,0,0,102
19,15,21,18,16,21,19,19,0,148
19,15,21,18,19,0,0,0,0,92
19,15,21,18,19,15,16,0,0,123
19,15,21,18,19,15,16,19,0,142
19,15,21,18,20,15,16,0,0,124
19,15,21,18,22,5,12,4,0,116
19,15,21,18,23,5,5,4,0,110
19,15,21,18,23,15,15,4,0,130
19,15,21,18,23,15,15,4,19,149
19,15,21,19,0,0,0,0,0,74
19,15,21,19,5,0,0,0,0,79
19,15,21,19,5,4,0,0,0,83
19,15,21,19,5,18,0,0,0,97
19,15,21,19,5,19,0,0,0,98
19,15,21,19,5,23,9,6,5,122
19,15,21,19,8,25,0,0,0,107
19,15,21,19,9,14,7,0,0,104
19,15,21,19,12,9,11,0,0,106
19,15,21,20,1,3,8,5,0,92
19,15,21,20,1,3,8,5,19,111
19,15,21,20,1,7,5,0,0,88
19,15,21,20,1,14,5,0,0,95
19,15,21,20,1,14,5,19,0,114
19,15,21,20,1,18,0,0,0,94
19,15,21,20,5,14,5,21,18,138
19,15,21,20,5,14,21,0,0,115
19,15,21,20,5,18,0,0,0,98
19,15,21,20,5,18,12,25,0,135
19,15,21,20,5,18,19,0,0,117
19,15,21,20,8,5,4,0,0,92
19,15,21,20,8,5,18,0,0,106
19,15,21,20,8,5,18,12,25,143
19,15,21,20,8,5,18,14,19,139
19,15,21,20,8,5,18,19,0,125
19,15,21,20,8,9,14,7,0,113
19,15,21,20,8,9,14,7,19,132
19,15,21,20,8,12,1,14,4,114
19,15,21,20,8,12,25,0,0,120
19,15,21,20,8,13,15,19,20,150
19,15,21,20,8,14,5,19,19,140
19,15,21,20,8,16,1,23,0,123
19,15,21,20,8,16,1,23,19,142
19,15,21,20,8,18,15,14,19,149
19,15,21,20,8,19,0,0,0,102
19,15,21,20,8,23,1,18,4,129
19,15,21,20,8,23,15,15,4,140
19,15,21,20,20,5,18,0,0,118
19,15,21,21,19,8,0,0,0,103
19,15,21,21,19,8,25,0,0,128
19,15,21,22,5,14,9,18,0,123
19,15,21,22,5,14,9,18,19,142
19,15,21,22,5,18,1,9,14,124
19,15,21,22,12,1,11,9,0,110
19,15,21,23,5,19,20,5,18,145
19,15,22,0,0,0,0,0,0,56
19,15,22,5,14,1,14,3,5,98
19,15,22,5,14,5,26,0,0,106
19,15,22,5,18,5,9,7,14,114
19,15,22,5,18,20,25,0,0,124
19,15,22,9,5,20,4,15,13,122
19,15,22,9,5,20,9,3,0,102
19,15,22,9,5,20,9,19,20,138
19,15,22,9,5,20,9,26,5,130
19,15,22,9,20,5,0,0,0,90
19,15,22,11,8,15,19,0,0,109
19,15,22,11,8,15,19,5,0,114
19,15,22,11,8,15,26,0,0,116
19,15,22,11,8,15,26,5,19,140
19,15,22,11,8,15,26,25,0,141
19,15,22,16,18,5,14,5,0,114
19,15,22,18,1,14,0,0,0,89
19,15,22,18,1,14,12,25,0,126
19,15,22,18,1,14,19,0,0,108
19,15,22,18,1,14,20,25,0,134
19,15,23,1,2,12,5,0,0,77
19,15,23,1,14,0,0,0,0,72
19,15,23,1,14,19,0,0,0,91
19,15,23,1,18,0,0,0,0,76
19,15,23,1,18,18,5,5,0,104
19,15,23,1,18,18,25,0,0,119
19,15,23,1,18,19,0,0,0,95
19,15,23,2,1,3,11,0,0,74
19,15,23,2,1,3,11,5,4,83
19,15,23,2,1,14,5,0,0,79
19,15,23,2,5,12,12,25,0,113
19,15,23,2,18,5,1,4,0,87
19,15,23,2,18,5,1,4,19,106
19,15,23,3,1,18,0,0,0,79
19,15,23,3,1,18,19,0,0,98
19,15,23,4,5,18,0,0,0,84
19,15,23,4,15,14,5,19,0,114
19,15,23,5,4,0,0,0,0,66
19,15,23,5,12,0,0,0,0,74
19,15,23,5,14,19,0,0,0,95
19,15,23,5,18,19,0,0,0,99
19,15,23,6,0,0,0,0,0,63
19,15,23,6,15,15,20,0,0,113
19,15,23,9,14,7,0,0,0,87
19,15,23,9,14,19,0,0,0,99
19,15,23,9,19,8,0,0,0,93
19,15,23,12,0,0,0,0,0,69
19,15,23,12,5,0,0,0,0,74
19,15,23,12,9,11,5,0,0,94
19,15,23,12,20,8,0,0,0,97
19,15,23,14,0,0,0,0,0,71
19,15,23,19,0,0,0,0,0,76
19,15,23,19,5,0,0,0,0,81
19,15,23,20,0,0,0,0,0,77
19,15,23,20,5,0,0,0,0,82
19,15,24,0,0,0,0,0,0,58
19,15,26,9,14,0,0,0,0,83
19,15,26,9,14,5,0,0,0,88
19,15,26,9,14,5,19,0,0,107
19,15,26,9,14,19,0,0,0,102
19,15,26,12,25,0,0,0,0,97
19,15,26,15,12,9,3,0,0,99
19,15,26,26,12,5,0,0,0,103
19,15,26,26,12,5,4,0,0,107
19,15,26,26,12,25,0,0,0,123
19,16,5,1,11,0,0,0,0,52
19,16,5,1,11,1,2,12,5,72
19,16,5,1,11,1,2,12,25,92
19,16,5,1,11,5,1,19,25,102
19,16,5,1,11,5,18,19,0,94
19,16,5,1,11,9,5,0,0,66
19,16,5,1,11,9,5,19,0,85
19,16,5,1,11,9,14,7,0,82
19,16,5,1,11,9,14,7,19,101
19,16,5,1,11,12,5,19,19,107
19,16,5,1,12,0,0,0,0,53
19,16,5,1,12,2,15,14,5,89
19,16,5,1,14,0,0,0,0,55
19,16,5,1,14,5,4,0,0,64
19,16,5,1,14,9,14,7,0,85
19,16,5,1,14,19,0,0,0,74
19,16,5,1,18,3,1,19,20,102
19,16,5,1,18,5,4,0,0,68
19,16,5,1,18,5,25,5,0,94
19,16,5,1,18,5,18,0,0,82
19,16,5,1,18,5,18,19,0,101
19,16,5,1,18,8,5,1,4,77
19,16,5,1,18,25,0,0,0,84
19,16,5,1,18,12,9,11,5,96
19,16,5,1,18,13,5,14,0,91
19,16,5,1,18,13,9,14,20,115
19,16,5,1,18,19,13,1,14,106
19,16,5,1,18,19,13,5,14,110
19,16,5,1,18,23,15,15,4,116
19,16,5,1,18,23,15,18,20,135
19,16,5,1,22,5,0,0,0,68
19,16,5,3,3,5,4,0,0,55
19,16,5,3,3,8,9,5,0,68
19,16,5,3,3,9,14,7,0,76
19,16,5,3,5,0,0,0,0,48
19,16,5,3,9,1,12,0,0,65
19,16,5,3,9,1,12,5,18,88
19,16,5,3,9,1,12,12,25,102
19,16,5,3,9,1,12,19,0,84
19,16,5,3,9,1,12,20,25,110
19,16,5,3,9,1,20,5,0,78
19,16,5,3,9,1,20,5,4,82
19,16,5,3,9,1,20,5,19,97
19,16,5,3,9,5,0,0,0,57
19,16,5,3,9,5,19,0,0,76
19,16,5,3,9,6,0,0,0,58
19,16,5,3,9,6,25,0,0,83
19,16,5,3,9,6,9,3,0,70
19,16,5,3,9,6,9,3,19,89
19,16,5,3,9,6,9,5,4,76
19,16,5,3,9,6,9,5,18,90
19,16,5,3,9,6,9,5,19,91
19,16,5,3,9,6,9,19,20,106
19,16,5,3,9,12,12,21,13,110
19,16,5,3,9,13,5,14,0,84
19,16,5,3,9,13,5,14,19,103
19,16,5,3,9,15,21,19,0,107
19,16,5,3,11,0,0,0,0,54
19,16,5,3,11,5,4,0,0,63
19,16,5,3,11,6,1,12,12,85
19,16,5,3,11,25,0,0,0,79
19,16,5,3,11,9,5,18,0,86
19,16,5,3,11,9,5,19,20,107
19,16,5,3,11,9,14,7,0,84
19,16,5,3,11,12,5,0,0,71
19,16,5,3,11,12,5,4,0,75
19,16,5,3,11,12,5,4,25,100
19,16,5,3,11,12,5,19,0,90
19,16,5,3,11,12,5,19,19,109
19,16,5,3,11,12,25,0,0,91
19,16,5,3,11,12,9,14,7,96
19,16,5,3,11,19,0,0,0,73
19,16,5,3,19,0,0,0,0,62
19,16,5,3,20,0,0,0,0,63
19,16,5,3,20,1,3,12,5,84
19,16,5,3,20,1,14,20,0,98
19,16,5,3,20,1,20,5,0,89
19,16,5,3,20,1,20,5,4,93
19,16,5,3,20,1,20,5,19,108
19,16,5,3,20,5,18,0,0,86
19,16,5,3,20,5,18,5,4,95
19,16,5,3,20,5,18,19,0,105
19,16,5,3,20,9,14,7,0,93
19,16,5,3,20,18,1,0,0,82
19,16,5,3,20,18,1,12,0,94
19,16,5,3,20,18,5,0,0,86
19,16,5,3,20,18,5,4,0,90
19,16,5,3,20,18,5,19,0,105
19,16,5,3,20,18,25,0,0,106
19,16,5,3,20,18,15,21,19,136
19,16,5,3,20,18,21,13,0,115
19,16,5,3,20,18,21,13,19,134
19,16,5,3,20,20,18,1,0,102
19,16,5,3,21,12,1,0,0,77
19,16,5,3,21,12,1,18,0,95
19,16,5,3,21,12,1,20,5,102
19,16,5,3,21,12,9,19,20,124
19,16,5,3,21,12,21,13,0,110
19,16,5,3,21,12,21,13,19,129
19,16,5,3,21,19,0,0,0,83
19,16,5,5,3,5,0,0,0,53
19,16,5,5,3,8,0,0,0,56
19,16,5,5,3,8,5,18,0,79
19,16,5,5,3,8,5,19,0,80
19,16,5,5,3,8,6,21,12,95
19,16,5,5,3,8,9,6,25,96
19,16,5,5,3,8,9,14,7,86
19,16,5,5,3,8,23,1,25,105
19,16,5,5,4,0,0,0,0,49
19,16,5,5,4,1,23,1,25,99
19,16,5,5,4,2,1,12,12,76
19,16,5,5,4,2,15,1,20,87
19,16,5,5,4,5,4,0,0,58
19,16,5,5,4,5,18,0,0,72
19,16,5,5,4,5,18,19,0,91
19,16,5,5,4,6,21,12,0,88
19,16,5,5,4,7,21,14,0,91
19,16,5,5,4,25,0,0,0,74
19,16,5,5,4,9,5,18,0,81
19,16,5,5,4,9,5,19,20,102
19,16,5,5,4,9,12,25,0,95
19,16,5,5,4,9,14,7,0,79
19,16,5,5,4,9,14,7,19,98
19,16,5,5,4,12,5,19,19,104
19,16,5,5,4,12,25,0,0,86
19,16,5,5,4,15,0,0,0,64
19,16,5,5,4,15,19,0,0,83
19,16,5,5,4,19,0,0,0,68
19,16,5,5,4,19,20,5,18,111
19,16,5,5,4,21,16,0,0,86
19,16,5,5,4,21,16,19,0,105
19,16,5,5,4,23,1,25,19,117
19,16,5,5,4,23,1,12,11,96
19,16,5,5,4,23,5,12,12,101
19,16,5,5,12,0,0,0,0,57
19,16,5,5,12,5,4,0,0,66
19,16,5,5,12,9,14,7,0,87
19,16,5,5,12,11,5,14,0,87
19,16,5,5,12,12,5,19,19,112
19,16,5,5,12,19,0,0,0,76
19,16,5,5,14,0,0,0,0,59
19,16,5,5,18,5,4,0,0,72
19,16,5,5,18,9,14,7,0,93
19,16,5,5,18,9,14,7,19,112
19,16,5,5,18,9,20,25,0,117
19,16,5,5,18,19,0,0,0,82
19,16,5,25,5,18,9,1,0,98
19,16,5,9,12,0,0,0,0,61
19,16,5,9,12,5,4,0,0,70
19,16,5,9,12,9,14,7,0,91
19,16,5,9,12,19,0,0,0,80
19,16,5,9,18,0,0,0,0,67
19,16,5,9,18,5,4,0,0,76
19,16,5,9,18,9,14,7,0,97
19,16,5,9,18,19,0,0,0,86
19,16,5,9,19,5,0,0,0,73
19,16,5,9,19,5,19,0,0,92
19,16,5,9,19,19,0,0,0,87
19,16,5,9,19,19,5,19,0,111
19,16,5,11,2,15,15,13,0,96
19,16,5,11,20,0,0,0,0,71
19,16,5,12,1,5,1,14,0,73
19,16,5,12,2,15,21,14,4,108
19,16,5,12,4,5,18,0,0,79
19,16,5,12,4,9,14,7,0,86
19,16,5,12,4,18,9,14,7,104
19,16,5,12,4,18,15,14,0,103
19,16,5,12,5,1,14,0,0,72
19,16,5,12,11,0,0,0,0,63
19,16,5,12,12,0,0,0,0,64
19,16,5,12,12,1,2,12,5,84
19,16,5,12,12,2,9,14,4,93
19,16,5,12,12,4,15,23,14,120
19,16,5,12,12,5,4,0,0,73
19,16,5,12,12,5,18,0,0,87
19,16,5,12,12,5,18,19,0,106
19,16,5,12,12,6,21,12,0,103
19,16,5,12,12,9,3,1,14,91
19,16,5,12,12,9,14,7,0,94
19,16,5,12,12,9,14,7,19,113
19,16,5,12,12,11,5,14,0,94
19,16,5,12,12,19,0,0,0,83
19,16,5,12,12,23,15,18,4,124
19,16,5,12,12,23,15,18,11,131
19,16,5,12,13,1,14,0,0,80
19,16,5,12,20,0,0,0,0,72
19,16,5,12,20,5,18,19,0,114
19,16,5,12,20,15,9,4,0,100
19,16,5,12,20,19,0,0,0,91
19,16,5,12,20,26,0,0,0,98
19,16,5,12,20,26,5,19,0,122
19,16,5,12,21,14,3,1,18,109
19,16,5,12,21,14,11,0,0,98
19,16,5,12,21,14,11,5,4,107
19,16,5,12,21,14,11,5,18,121
19,16,5,12,21,14,11,19,0,117
19,16,5,14,3,5,18,19,0,99
19,16,5,14,3,5,19,0,0,81
19,16,5,14,3,25,0,0,0,82
19,16,5,14,3,9,5,0,0,71
19,16,5,14,4,0,0,0,0,58
19,16,5,14,4,1,2,12,5,78
19,16,5,14,4,5,18,19,0,100
19,16,5,14,4,6,21,12,0,97
19,16,5,14,4,9,2,12,5,86
19,16,5,14,4,9,14,7,0,88
19,16,5,14,4,9,14,7,19,107
19,16,5,14,4,12,5,19,19,113
19,16,5,14,4,19,0,0,0,77
19,16,5,14,19,5,19,0,0,97
19,16,5,14,20,0,0,0,0,74
19,16,5,15,19,0,0,0,0,74
19,16,5,18,1,2,12,5,0,78
19,16,5,18,1,7,5,0,0,71
19,16,5,18,1,20,5,0,0,84
19,16,5,18,5,0,0,0,0,63
19,16,5,18,9,20,25,0,0,112
19,16,5,18,11,5,20,0,0,94
19,16,5,18,13,0,0,0,0,71
19,16,5,18,13,1,0,0,0,72
19,16,5,18,13,1,14,9,1,96
19,16,5,18,13,1,18,25,0,115
19,16,5,18,13,1,20,1,0,93
19,16,5,18,13,1,20,9,1,102
19,16,5,18,13,1,20,9,3,104
19,16,5,18,13,1,20,9,4,105
19,16,5,18,13,1,20,9,14,115
19,16,5,18,13,25,0,0,0,96
19,16,5,18,13,9,3,0,0,83
19,16,5,18,13,9,4,9,14,107
19,16,5,18,13,9,14,0,0,94
19,16,5,18,13,9,14,5,0,99
19,16,5,18,13,9,14,5,19,118
19,16,5,18,13,9,19,13,0,112
19,16,5,18,13,9,19,20,0,119
19,16,5,18,13,15,21,19,0,126
19,16,5,18,13,19,0,0,0,90
19,16,5,18,13,21,12,5,0,109
19,16,5,18,15,14,0,0,0,87
19,16,5,18,15,14,1,18,1,107
19,16,5,18,15,14,1,18,15,121
19,16,5,18,15,14,5,0,0,92
19,16,5,18,16,12,5,0,0,91
19,16,5,18,19,5,0,0,0,82
19,16,5,20,0,0,0,0,0,60
19,16,5,20,3,8,0,0,0,71
19,16,5,20,3,8,5,19,0,95
19,16,5,20,5,0,0,0,0,65
19,16,5,20,20,12,5,0,0,97
19,16,5,21,3,8,1,14,0,87
19,16,5,23,0,0,0,0,0,63
19,16,5,23,5,4,0,0,0,72
19,16,5,23,5,18,0,0,0,86
19,16,5,23,5,18,19,0,0,105
19,16,5,23,25,0,0,0,0,88
19,16,5,23,9,5,18,0,0,95
19,16,5,23,9,5,19,20,0,116
19,16,5,23,9,14,5,19,19,129
19,16,5,23,9,14,7,0,0,93
19,16,5,23,19,0,0,0,0,82
19,16,5,24,0,0,0,0,0,64
19,16,8,1,3,5,12,0,0,64
19,16,8,1,3,5,12,9,1,74
19,16,8,1,3,5,12,21,19,104
19,16,8,1,5,18,9,20,5,101
19,16,8,1,7,9,1,0,0,61
19,16,8,1,7,9,15,14,0,89
19,16,8,1,7,14,15,21,19,120
19,16,8,1,7,14,21,13,19,118
19,16,8,1,12,13,0,0,0,69
19,16,8,1,12,13,1,0,0,70
19,16,8,5,3,9,4,0,0,64
19,16,8,5,3,9,21,19,0,100
19,16,8,5,3,15,9,4,0,79
19,16,8,5,7,5,19,0,0,79
19,16,8,5,7,9,4,0,0,68
19,16,8,5,14,4,15,14,5,100
19,16,8,5,14,5,0,0,0,67
19,16,8,5,14,5,19,0,0,86
19,16,8,5,14,9,3,0,0,74
19,16,8,5,14,9,15,14,0,100
19,16,8,5,14,15,9,4,0,90
19,16,8,5,14,15,9,4,19,109
19,16,8,5,14,15,20,9,3,109
19,16,8,5,18,1,2,12,5,86
19,16,8,5,18,1,12,0,0,79
19,16,8,5,18,5,0,0,0,71
19,16,8,5,18,5,4,0,0,75
19,16,8,5,18,5,19,0,0,90
19,16,8,5,18,25,0,0,0,91
19,16,8,5,18,9,3,0,0,78
19,16,8,5,18,9,3,1,12,91
19,16,8,5,18,9,3,12,5,95
19,16,8,5,18,9,3,19,0,97
19,16,8,5,18,9,5,18,0,98
19,16,8,5,18,9,5,19,20,119
19,16,8,5,18,9,6,25,0,106
19,16,8,5,18,9,14,7,0,96
19,16,8,5,18,15,9,4,0,94
19,16,8,5,18,15,9,4,19,113
19,16,8,5,18,15,13,5,0,99
19,16,8,5,18,21,12,1,0,100
19,16,8,5,18,21,12,1,18,118
19,16,8,5,18,21,12,5,0,104
19,16,8,5,18,21,12,5,19,123
19,16,8,5,24,9,4,5,0,90
19,16,8,25,7,13,9,1,0,98
19,16,8,25,7,13,9,3,0,100
19,16,8,25,7,13,15,9,4,116
19,16,8,25,7,13,21,19,0,128
19,16,8,9,14,3,20,5,18,112
19,16,8,9,14,4,9,4,0,83
19,16,8,9,14,7,1,12,0,86
19,16,8,9,14,7,5,19,0,97
19,16,8,9,14,7,9,4,0,86
19,16,8,9,14,7,9,4,19,105
19,16,8,9,14,7,9,14,5,101
19,16,8,9,14,7,15,9,4,101
19,16,8,9,14,24,5,19,0,114
19,16,8,9,14,24,9,1,14,114
19,16,8,9,14,24,9,14,5,118
19,16,8,18,1,7,9,4,5,87
19,16,25,0,0,0,0,0,0,60
19,16,9,1,12,0,0,0,0,57
19,16,25,2,15,1,20,0,0,98
19,16,9,3,0,0,0,0,0,47
19,16,9,3,1,5,0,0,0,53
19,16,9,3,1,12,0,0,0,60
19,16,9,3,1,14,20,0,0,82
19,16,9,3,1,19,0,0,0,67
19,16,9,3,1,20,5,0,0,73
19,16,9,3,1,20,5,4,0,77
19,16,9,3,3,1,20,15,0,86
19,16,9,3,3,1,20,15,19,105
19,16,9,3,5,0,0,0,0,52
19,16,9,3,5,1,2,12,5,72
19,16,9,3,5,2,21,19,8,102
19,16,9,3,5,3,1,11,5,72
19,16,9,3,5,4,0,0,0,56
19,16,9,3,5,6,21,12,0,91
19,16,9,3,5,25,0,0,0,77
19,16,9,3,5,12,5,19,19,107
19,16,9,3,5,12,9,11,5,89
19,16,9,3,5,18,25,0,0,95
19,16,9,3,5,18,9,5,19,103
19,16,9,3,5,18,19,0,0,89
19,16,9,3,5,19,0,0,0,71
19,16,9,3,25,0,0,0,0,72
19,16,9,3,9,5,18,0,0,79
19,16,9,3,9,5,19,20,0,100
19,16,9,3,9,6,15,18,13,108
19,16,9,3,9,12,5,7,5,85
19,16,9,3,9,12,25,0,0,93
19,16,9,3,9,14,5,19,19,113
19,16,9,3,9,14,7,0,0,77
19,16,9,3,11,0,0,0,0,58
19,16,9,3,11,5,20,0,0,83
19,16,9,3,11,12,5,0,0,75
19,16,9,3,11,14,5,12,0,89
19,16,9,3,11,19,0,0,0,77
19,16,9,3,15,19,5,0,0,86
19,16,9,3,15,19,9,20,25,135
19,16,9,3,15,21,19,0,0,102
19,16,9,3,19,0,0,0,0,66
19,16,9,3,21,12,1,0,0,81
19,16,9,3,21,12,1,5,0,86
19,16,9,3,21,12,1,18,0,99
19,16,9,3,21,12,1,20,5,106
19,16,9,3,21,12,5,0,0,85
19,16,9,3,21,12,5,19,0,104
19,16,9,3,21,12,15,19,5,119
19,16,9,3,21,12,15,21,19,135
19,16,9,3,21,12,21,13,0,114
19,16,9,4,5,18,0,0,0,71
19,16,9,4,5,18,5,4,0,80
19,16,9,4,5,18,25,0,0,96
19,16,9,4,5,18,9,5,18,103
19,16,9,4,5,18,9,19,8,107
19,16,9,4,5,18,12,5,20,108
19,16,9,4,5,18,12,25,0,108
19,16,9,4,5,18,13,1,14,99
19,16,9,4,5,18,19,0,0,90
19,16,9,4,5,18,23,5,2,101
19,16,9,4,7,5,18,0,0,78
19,16,25,4,15,13,0,0,0,92
19,16,9,5,4,0,0,0,0,53
19,16,9,5,7,5,12,19,0,92
19,16,9,5,12,0,0,0,0,61
19,16,9,5,12,5,4,0,0,70
19,16,9,5,12,5,18,19,0,103
19,16,9,5,12,9,14,7,0,91
19,16,9,5,12,19,0,0,0,80
19,16,9,5,18,0,0,0,0,67
19,16,25,5,18,0,0,0,0,83
19,16,9,5,18,5,4,0,0,76
19,16,9,5,18,9,14,7,0,97
19,16,9,5,19,0,0,0,0,68
19,16,9,6,0,0,0,0,0,50
19,16,25,6,1,21,12,20,0,120
19,16,9,6,6,0,0,0,0,56
19,16,9,6,6,5,4,0,0,65
19,16,9,6,6,25,0,0,0,81
19,16,9,6,6,9,5,18,0,88
19,16,9,6,6,9,5,19,20,109
19,16,9,6,6,9,12,25,0,102
19,16,9,6,6,9,14,7,0,86
19,16,9,6,6,19,0,0,0,75
19,16,9,7,0,0,0,0,0,51
19,16,9,7,7,15,20,25,0,118
19,16,25,7,12,1,19,19,0,118
19,16,9,7,14,5,12,0,0,82
19,16,9,7,14,5,20,0,0,90
19,16,9,7,14,21,20,0,0,106
19,16,9,7,15,20,0,0,0,86
19,16,9,7,15,20,19,0,0,105
19,16,25,8,15,12,5,0,0,100
19,16,25,9,14,7,0,0,0,90
19,16,25,9,19,13,0,0,0,101
19,16,9,11,0,0,0,0,0,55
19,16,9,11,5,2,9,12,12,95
19,16,9,11,5,4,0,0,0,64
19,16,9,11,5,4,1,3,5,73
19,16,9,11,5,6,9,19,8,102
19,16,9,11,5,8,15,12,5,100
19,16,9,11,5,8,15,18,14,115
19,16,9,11,5,12,5,20,0,97
19,16,9,11,5,12,5,20,19,116
19,16,9,11,5,12,9,11,5,97
19,16,9,11,5,14,1,18,4,97
19,16,9,11,5,18,0,0,0,78
19,16,9,11,5,18,19,0,0,97
19,16,9,11,5,19,0,0,0,79
19,16,9,11,5,20,1,9,12,102
19,16,9,11,5,20,15,16,0,111
19,16,9,11,5,23,5,5,4,97
19,16,9,11,5,23,9,19,5,116
19,16,9,11,25,0,0,0,0,80
19,16,9,11,9,5,18,0,0,87
19,16,9,11,9,5,19,20,0,108
19,16,9,11,9,12,25,0,0,101
19,16,9,11,9,14,5,19,19,121
19,16,9,11,9,14,7,0,0,85
19,16,9,11,19,0,0,0,0,74
19,16,9,12,5,0,0,0,0,61
19,16,9,12,5,4,0,0,0,65
19,16,9,12,5,8,15,12,5,101
19,16,9,12,5,18,0,0,0,79
19,16,9,12,5,19,0,0,0,80
19,16,9,12,5,23,15,18,13,130
19,16,9,12,9,11,9,14,0,99
19,16,9,12,9,11,9,14,19,118
19,16,9,12,9,14,7,0,0,86
19,16,9,12,9,14,7,19,0,105
19,16,9,12,9,20,5,0,0,90
19,16,9,12,9,20,9,3,0,97
19,16,9,12,12,0,0,0,0,68
19,16,9,12,12,1,2,12,5,88
19,16,9,12,12,1,7,5,0,81
19,16,9,12,12,1,7,5,19,100
19,16,9,12,12,2,15,24,0,109
19,16,9,12,12,5,4,0,0,77
19,16,9,12,12,5,18,0,0,91
19,16,9,12,12,5,18,19,0,110
19,16,9,12,12,5,20,0,0,93
19,16,9,12,12,25,0,0,0,93
19,16,9,12,12,9,11,9,14,111
19,16,9,12,12,9,14,7,0,98
19,16,9,12,12,15,22,5,18,128
19,16,9,12,12,16,9,16,5,114
19,16,9,12,12,19,0,0,0,87
19,16,9,12,12,23,1,25,0,117
19,16,9,12,12,23,1,25,19,136
19,16,9,12,15,13,1,0,0,85
19,16,9,12,15,13,1,19,0,104
19,16,9,12,15,19,9,20,5,124
19,16,9,12,20,0,0,0,0,76
19,16,9,12,20,8,0,0,0,84
19,16,9,12,20,8,19,0,0,103
19,16,9,12,21,19,0,0,0,96
19,16,9,14,0,0,0,0,0,58
19,16,9,14,1,0,0,0,0,59
19,16,9,14,1,3,5,14,5,86
19,16,9,14,1,3,8,0,0,70
19,16,9,14,1,3,8,5,19,94
19,16,9,14,1,5,0,0,0,64
19,16,9,14,1,7,5,0,0,71
19,16,9,14,1,7,5,19,0,90
19,16,9,14,1,12,0,0,0,71
19,16,9,14,1,12,5,19,0,95
19,16,9,14,1,12,9,19,0,99
19,16,9,14,1,12,12,25,0,108
19,16,9,14,1,12,19,0,0,90
19,16,9,14,1,20,5,0,0,84
19,16,9,14,4,5,18,0,0,85
19,16,9,14,4,12,1,7,5,87
19,16,9,14,4,12,5,0,0,79
19,16,9,14,4,12,5,4,0,83
19,16,9,14,4,12,5,18,0,97
19,16,9,14,4,12,5,18,19,116
19,16,9,14,4,12,5,19,0,98
19,16,9,14,4,12,25,0,0,99
19,16,9,14,4,12,9,5,18,106
19,16,9,14,4,12,9,14,7,104
19,16,9,14,4,18,9,6,20,115
19,16,9,14,5,0,0,0,0,63
19,16,9,14,5,2,9,12,12,98
19,16,9,14,5,2,15,14,5,99
19,16,9,14,5,4,0,0,0,67
19,16,9,14,5,12,0,0,0,75
19,16,9,14,5,12,5,19,19,118
19,16,9,14,5,12,5,20,0,100
19,16,9,14,5,12,9,11,5,100
19,16,9,14,5,12,12,5,0,92
19,16,9,14,5,12,12,5,19,111
19,16,9,14,5,12,19,0,0,94
19,16,9,14,5,19,0,0,0,82
19,16,9,14,5,20,0,0,0,83
19,16,9,14,5,20,1,9,12,105
19,16,9,14,5,20,19,0,0,102
19,16,9,14,7,5,12,0,0,82
19,16,9,14,25,0,0,0,0,83
19,16,9,14,9,5,18,0,0,90
19,16,9,14,9,5,19,20,0,111
19,16,9,14,9,6,15,18,13,119
19,16,9,14,9,14,5,19,19,124
19,16,9,14,9,20,9,19,0,115
19,16,9,14,11,0,0,0,0,69
19,16,9,14,12,5,19,19,0,113
19,16,9,14,14,1,2,12,5,92
19,16,9,14,14,1,11,5,18,107
19,16,9,14,14,5,25,0,0,102
19,16,9,14,14,5,25,19,0,121
19,16,9,14,14,5,12,0,0,89
19,16,9,14,14,5,18,0,0,95
19,16,9,14,14,5,18,5,20,120
19,16,9,14,14,5,18,25,0,120
19,16,9,14,14,5,18,19,0,114
19,16,9,14,14,25,0,0,0,97
19,16,9,14,14,9,5,19,0,105
19,16,9,14,14,9,14,7,0,102
19,16,9,14,14,9,14,7,19,121
19,16,9,14,15,4,1,12,0,90
19,16,9,14,15,4,5,0,0,82
19,16,9,14,15,6,6,0,0,85
19,16,9,14,15,6,6,19,0,104
19,16,9,14,15,9,4,0,0,86
19,16,9,14,15,18,0,0,0,91
19,16,9,14,15,18,19,0,0,110
19,16,9,14,15,19,5,0,0,97
19,16,9,14,15,19,5,12,25,134
19,16,9,14,15,19,9,20,25,146
19,16,9,14,15,21,19,0,0,113
19,16,9,14,15,21,20,0,0,114
19,16,9,14,15,21,20,19,0,133
19,16,9,14,16,18,15,15,6,128
19,16,9,14,19,0,0,0,0,77
19,16,9,14,19,20,5,18,0,120
19,16,9,14,19,20,5,18,19,139
19,16,9,14,19,20,18,25,0,140
19,16,9,14,20,5,24,20,0,127
19,16,9,14,20,15,0,0,0,93
19,16,9,14,20,15,19,0,0,112
19,16,9,14,20,18,25,0,0,121
19,16,9,14,21,12,1,0,0,92
19,16,9,14,21,12,1,5,0,97
19,16,9,14,21,12,1,20,5,117
19,16,9,14,21,12,5,0,0,96
19,16,9,14,21,12,5,19,0,115
19,16,9,14,21,12,15,19,5,130
19,16,9,14,21,12,15,21,19,146
19,16,9,15,14,9,4,0,0,86
19,16,25,16,18,15,15,6,0,130
19,16,9,18,1,0,0,0,0,63
19,16,9,18,1,2,12,5,0,82
19,16,9,18,1,3,12,5,0,83
19,16,9,18,1,3,12,5,19,102
19,16,9,18,1,3,21,12,1,100
19,16,9,18,1,5,0,0,0,68
19,16,9,18,1,5,1,19,0,88
19,16,9,18,1,12,0,0,0,75
19,16,9,18,1,12,5,0,0,80
19,16,9,18,1,12,5,4,0,84
19,16,9,18,1,12,9,14,7,105
19,16,9,18,1,12,9,19,13,116
19,16,9,18,1,12,9,20,25,129
19,16,9,18,1,12,9,26,5,115
19,16,9,18,1,12,12,5,4,96
19,16,9,18,1,12,12,25,0,112
19,16,9,18,1,12,15,9,4,103
19,16,9,18,1,12,19,0,0,94
19,16,9,18,1,14,0,0,0,77
19,16,9,18,1,14,5,0,0,82
19,16,9,18,1,14,20,0,0,97
19,16,9,18,1,14,20,1,12,110
19,16,9,18,1,14,20,8,25,130
19,16,9,18,1,14,20,9,3,109
19,16,9,18,1,14,20,19,0,116
19,16,9,18,1,19,20,5,18,125
19,16,9,18,1,20,5,0,0,88
19,16,9,18,1,20,5,4,0,92
19,16,9,18,1,20,9,15,14,121
19,16,9,18,5,0,0,0,0,67
19,16,9,18,5,1,0,0,0,68
19,16,9,18,5,1,19,0,0,87
19,16,9,18,5,4,0,0,0,71
19,16,9,18,5,12,5,19,19,122
19,16,9,18,5,12,5,20,0,104
19,16,9,18,5,13,0,0,0,80
19,16,9,18,5,13,5,0,0,85
19,16,9,18,5,13,5,19,0,104
19,16,9,18,5,13,19,0,0,99
19,16,9,18,5,16,15,12,5,115
19,16,9,18,5,23,1,18,4,113
19,16,9,18,5,23,9,19,5,123
19,16,9,18,25,0,0,0,0,87
19,16,9,18,9,3,12,5,0,91
19,16,9,18,9,5,18,0,0,94
19,16,9,18,9,5,19,20,0,115
19,16,9,18,9,6,15,18,13,123
19,16,9,18,9,12,12,1,0,96
19,16,9,18,9,12,12,1,18,114
19,16,9,18,9,12,12,21,13,129
19,16,9,18,9,14,7,0,0,92
19,16,9,18,9,20,1,12,0,104
19,16,9,18,9,20,4,15,13,123
19,16,9,18,9,20,5,4,0,100
19,16,9,18,9,20,5,18,0,114
19,16,9,18,9,20,6,21,12,130
19,16,9,18,9,20,25,0,0,116
19,16,9,18,9,20,9,14,7,121
19,16,9,18,9,20,9,19,13,132
19,16,9,18,9,20,9,19,20,139
19,16,9,18,9,20,9,26,5,131
19,16,9,18,9,20,15,19,15,140
19,16,9,18,9,20,15,21,19,146
19,16,9,18,9,20,19,0,0,110
19,16,9,18,9,20,21,1,12,125
19,16,9,18,9,20,21,5,12,129
19,16,9,18,9,20,21,19,0,131
19,16,9,18,11,5,20,0,0,98
19,16,9,18,12,9,5,0,0,88
19,16,9,18,12,9,14,7,0,104
19,16,9,18,15,7,18,1,13,116
19,16,9,18,15,9,4,0,0,90
19,16,9,18,15,9,4,1,12,103
19,16,9,18,15,9,12,9,3,110
19,16,9,18,15,12,0,0,0,89
19,16,9,18,15,12,5,0,0,94
19,16,25,18,15,19,0,0,0,112
19,16,9,18,15,21,19,0,0,117
19,16,9,18,20,0,0,0,0,82
19,16,9,18,20,5,4,0,0,91
19,16,9,18,20,9,14,7,0,112
19,16,9,18,20,12,5,0,0,99
19,16,9,18,20,19,0,0,0,101
19,16,9,18,21,12,1,5,0,101
19,16,9,18,21,12,1,19,0,115
19,16,9,18,21,12,1,20,5,121
19,16,9,19,5,0,0,0,0,68
19,16,25,19,8,9,16,0,0,112
19,16,9,19,19,0,0,0,0,82
19,16,9,19,19,1,20,5,4,112
19,16,9,19,19,1,20,21,19,143
19,16,9,19,19,25,0,0,0,107
19,16,9,19,19,21,19,0,0,122
19,16,9,20,0,0,0,0,0,64
19,16,9,20,1,12,0,0,0,77
19,16,9,20,1,12,19,0,0,96
19,16,9,20,2,1,12,12,0,91
19,16,9,20,2,1,12,12,19,110
19,16,9,20,2,15,24,0,0,105
19,16,9,20,5,0,0,0,0,69
19,16,9,20,5,4,0,0,0,73
19,16,9,20,5,6,21,12,0,108
19,16,9,20,5,12,5,19,19,124
19,16,9,20,5,19,0,0,0,88
19,16,9,20,6,9,18,5,0,102
19,16,9,20,6,9,18,5,19,121
19,16,9,20,6,18,15,7,0,110
19,16,9,20,6,21,12,0,0,103
19,16,9,20,8,1,13,1,9,96
19,16,9,20,8,1,13,5,0,91
19,16,9,20,9,14,7,0,0,94
19,16,9,20,9,19,8,0,0,100
19,16,9,20,11,9,4,0,0,88
19,16,9,20,11,9,20,0,0,104
19,16,9,20,15,21,19,0,0,119
19,16,25,20,15,23,5,18,0,141
19,16,9,20,19,0,0,0,0,83
19,16,9,20,19,20,9,3,11,126
19,16,9,20,20,5,4,0,0,93
19,16,9,20,20,5,14,0,0,103
19,16,9,20,20,5,18,0,0,107
19,16,9,20,20,5,18,19,0,126
19,16,9,20,20,9,14,7,0,114
19,16,9,20,20,12,5,0,0,101
19,16,9,20,20,12,5,19,0,120
19,16,9,20,20,15,15,14,0,128
19,16,9,20,20,15,15,14,19,147
19,16,9,20,26,5,19,0,0,114
19,16,9,20,26,11,15,16,0,132
19,16,9,22,0,0,0,0,0,66
19,16,9,22,5,18,25,0,0,114
19,16,9,22,19,0,0,0,0,85
19,16,9,22,22,25,0,0,0,113
19,16,9,22,22,9,14,7,0,118
19,16,12,1,4,0,0,0,0,52
19,16,12,1,25,0,0,0,0,73
19,16,12,1,25,5,4,0,0,82
19,16,12,1,25,5,18,0,0,96
19,16,12,1,25,6,5,5,20,109
19,16,12,1,25,6,15,15,20,129
19,16,12,1,25,9,14,7,0,103
19,16,12,1,9,18,7,5,0,87
19,16,12,1,25,19,0,0,0,92
19,16,12,1,11,5,0,0,0,64
19,16,12,1,11,5,19,0,0,83
19,16,12,1,19,8,0,0,0,75
19,16,12,1,19,8,5,4,0,84
19,16,12,1,19,8,5,18,0,98
19,16,12,1,19,8,5,18,19,117
19,16,12,1,19,8,5,19,0,99
19,16,12,1,19,8,25,0,0,100
19,16,12,1,19,8,9,5,18,107
19,16,12,1,19,8,9,12,25,121
19,16,12,1,19,8,9,14,7,105
19,16,12,1,19,8,19,0,0,94
19,16,12,1,20,0,0,0,0,68
19,16,12,1,20,3,8,0,0,79
19,16,12,1,20,3,8,5,18,102
19,16,12,1,20,3,8,25,0,104
19,16,12,1,20,8,5,18,0,99
19,16,12,1,20,19,0,0,0,87
19,16,12,1,20,20,5,4,0,97
19,16,12,1,20,20,5,18,0,111
19,16,12,1,20,20,5,18,19,130
19,16,12,5,5,14,0,0,0,71
19,16,12,5,5,14,5,4,0,80
19,16,12,5,5,14,6,21,12,110
19,16,12,5,5,14,25,0,0,96
19,16,12,5,5,14,9,5,18,103
19,16,12,5,5,14,9,14,7,101
19,16,12,5,5,14,9,19,8,107
19,16,12,5,5,14,19,0,0,90
19,16,12,5,5,20,0,0,0,77
19,16,12,5,5,20,14,5,23,119
19,16,12,5,14,1,12,7,25,111
19,16,12,5,14,1,21,24,5,117
19,16,12,5,14,3,21,12,9,111
19,16,12,5,14,4,5,14,20,109
19,16,12,5,14,4,5,18,0,93
19,16,12,5,14,4,9,4,0,83
19,16,12,5,14,4,15,18,0,103
19,16,12,5,14,4,15,18,19,122
19,16,12,5,14,4,15,21,18,124
19,16,12,5,14,5,13,9,1,94
19,16,12,5,14,5,20,9,3,103
19,16,12,5,14,9,1,0,0,76
19,16,12,5,14,9,1,12,0,88
19,16,12,5,14,9,3,0,0,78
19,16,12,5,14,9,3,1,12,91
19,16,12,5,14,9,9,0,0,84
19,16,12,5,14,9,14,9,9,107
19,16,12,5,14,9,20,9,0,104
19,16,12,5,14,9,20,9,19,123
19,16,12,5,14,9,21,13,0,109
19,16,12,5,14,9,21,19,0,115
19,16,12,5,14,15,9,4,0,94
19,16,12,5,14,15,13,1,0,95
19,16,12,5,14,20,0,0,0,86
19,16,12,5,14,20,19,0,0,105
19,16,12,5,14,21,12,21,19,139
19,16,12,5,20,0,0,0,0,72
19,16,12,5,21,3,8,1,14,99
19,16,12,5,21,7,8,1,14,103
19,16,12,9,3,5,0,0,0,64
19,16,12,9,3,5,4,0,0,68
19,16,12,9,3,5,18,0,0,82
19,16,12,9,3,5,18,19,0,101
19,16,12,9,3,5,19,0,0,83
19,16,12,9,3,9,14,7,0,89
19,16,12,9,3,9,14,7,19,108
19,16,12,9,6,6,0,0,0,68
19,16,12,9,6,6,19,0,0,87
19,16,12,9,14,4,5,18,0,97
19,16,12,9,14,5,0,0,0,75
19,16,12,9,14,5,4,0,0,79
19,16,12,9,14,5,19,0,0,94
19,16,12,9,14,5,23,1,25,124
19,16,12,9,14,9,14,7,0,100
19,16,12,9,14,20,0,0,0,90
19,16,12,9,14,20,1,7,5,103
19,16,12,9,14,20,5,4,0,99
19,16,12,9,14,20,5,18,0,113
19,16,12,9,14,20,5,18,4,117
19,16,12,9,14,20,5,18,25,138
19,16,12,9,14,20,5,18,19,132
19,16,12,9,14,20,25,0,0,115
19,16,12,9,14,20,9,14,7,120
19,16,12,9,14,20,19,0,0,109
19,16,12,9,20,2,5,1,11,95
19,16,12,9,20,5,0,0,0,81
19,16,12,9,20,14,5,23,0,118
19,16,12,9,20,14,21,20,0,131
19,16,12,9,20,19,0,0,0,95
19,16,12,9,20,19,1,23,0,119
19,16,12,9,20,20,1,9,12,118
19,16,12,9,20,20,5,4,0,105
19,16,12,9,20,20,5,14,0,115
19,16,12,9,20,20,5,18,0,119
19,16,12,9,20,20,5,18,19,138
19,16,12,9,20,20,9,14,7,126
19,16,12,9,20,23,15,18,13,145
19,16,12,15,4,7,5,0,0,78
19,16,12,15,4,7,5,4,0,82
19,16,12,15,4,7,5,19,0,97
19,16,12,15,4,7,25,0,0,98
19,16,12,15,9,20,0,0,0,91
19,16,12,15,18,5,0,0,0,85
19,16,12,15,18,5,19,0,0,104
19,16,12,15,19,8,0,0,0,89
19,16,12,15,19,8,5,4,0,98
19,16,12,15,19,8,5,19,0,113
19,16,12,15,19,8,25,0,0,114
19,16,12,15,19,8,9,14,7,119
19,16,12,15,20,3,8,0,0,93
19,16,12,15,20,3,8,5,4,102
19,16,12,15,20,3,8,5,19,117
19,16,12,15,20,3,8,25,0,118
19,16,12,15,20,8,5,18,0,113
19,16,12,21,14,7,5,0,0,94
19,16,12,21,14,20,0,0,0,102
19,16,12,21,18,7,5,0,0,98
19,16,12,21,18,7,5,4,0,102
19,16,12,21,18,7,5,18,0,116
19,16,12,21,18,7,5,19,0,117
19,16,12,21,18,7,25,0,0,118
19,16,12,21,18,7,9,5,18,125
19,16,12,21,18,7,9,12,25,139
19,16,12,21,18,7,9,14,7,123
19,16,12,21,18,20,0,0,0,106
19,16,12,21,20,8,5,18,0,119
19,16,12,21,20,20,5,18,0,131
19,16,12,21,20,20,5,18,25,156
19,16,12,21,20,20,5,18,19,150
19,16,14,9,14,24,0,0,0,96
19,16,14,9,14,24,5,19,0,120
19,16,15,1,3,8,0,0,0,62
19,16,15,4,5,19,0,0,0,78
19,16,15,4,9,21,13,0,0,97
19,16,15,4,21,13,5,14,5,112
19,16,15,6,6,25,0,0,0,87
19,16,15,6,6,9,19,8,0,98
19,16,15,6,6,12,5,0,0,79
19,16,15,7,5,12,0,0,0,74
19,16,15,9,12,0,0,0,0,71
19,16,15,9,12,1,2,12,5,91
19,16,15,9,12,1,7,5,0,84
19,16,15,9,12,1,7,5,19,103
19,16,15,9,12,1,20,5,0,97
19,16,15,9,12,1,20,5,4,101
19,16,15,9,12,2,1,14,11,99
19,16,15,9,12,5,4,0,0,80
19,16,15,9,12,5,18,0,0,94
19,16,15,9,12,5,18,19,0,113
19,16,15,9,12,6,9,22,5,113
19,16,15,9,12,6,21,12,0,110
19,16,15,9,12,9,14,7,0,101
19,16,15,9,12,12,5,19,19,126
19,16,15,9,12,13,5,14,20,123
19,16,15,9,12,19,0,0,0,90
19,16,15,9,12,19,13,1,14,118
19,16,15,9,12,19,13,5,14,122
19,16,15,9,12,20,0,0,0,91
19,16,15,11,5,0,0,0,0,66
19,16,15,11,5,4,0,0,0,70
19,16,15,11,5,12,5,19,19,121
19,16,15,11,5,14,0,0,0,80
19,16,15,11,5,19,0,0,0,85
19,16,15,11,5,19,13,1,14,113
19,16,15,11,5,19,13,5,14,117
19,16,15,11,5,19,20,5,18,128
19,16,15,11,5,23,9,19,5,122
19,16,15,11,25,0,0,0,0,86
19,16,15,11,9,14,7,0,0,91
19,16,15,12,5,0,0,0,0,67
19,16,15,12,9,1,0,0,0,72
19,16,15,12,9,1,18,25,0,115
19,16,15,12,9,1,18,9,1,100
19,16,15,12,9,1,20,5,0,97
19,16,15,12,9,1,20,5,4,101
19,16,15,12,9,1,20,5,19,116
19,16,15,12,9,1,20,15,18,125
19,16,15,12,9,21,13,0,0,105
19,16,15,14,4,1,9,3,0,81
19,16,15,14,4,1,9,3,19,100
19,16,15,14,4,1,9,26,5,109
19,16,15,14,4,5,1,14,0,88
19,16,15,14,4,5,5,0,0,78
19,16,15,14,4,5,5,19,0,97
19,16,15,14,4,9,1,3,0,81
19,16,15,14,4,9,12,0,0,89
19,16,15,14,4,25,12,0,0,105
19,16,15,14,4,25,12,5,0,110
19,16,15,14,4,25,12,9,3,117
19,16,15,14,4,25,12,9,4,118
19,16,15,14,4,21,12,9,24,134
19,16,15,14,7,0,0,0,0,71
19,16,15,14,7,5,0,0,0,76
19,16,15,14,7,5,4,0,0,80
19,16,15,14,7,5,6,12,25,119
19,16,15,14,7,5,6,21,12,115
19,16,15,14,7,5,12,5,20,113
19,16,15,14,7,5,15,21,19,131
19,16,15,14,7,5,18,0,0,94
19,16,15,14,7,5,18,19,0,113
19,16,15,14,7,5,19,0,0,95
19,16,15,14,7,25,0,0,0,96
19,16,15,14,7,9,1,14,0,95
19,16,15,14,7,9,5,18,0,103
19,16,15,14,7,9,5,19,20,124
19,16,15,14,7,9,12,25,0,117
19,16,15,14,7,9,14,0,0,94
19,16,15,14,7,9,14,7,0,101
19,16,15,14,7,9,14,19,0,113
19,16,15,14,7,9,15,12,5,112
19,16,15,14,7,9,15,19,5,119
19,16,15,14,7,9,15,21,19,135
19,16,15,14,7,15,9,4,0,99
19,16,15,14,19,1,12,0,0,96
19,16,15,14,19,1,12,9,1,106
19,16,15,14,19,9,2,12,5,111
19,16,15,14,19,9,14,7,0,113
19,16,15,14,19,9,15,14,0,121
19,16,15,14,19,9,15,14,19,140
19,16,15,14,19,15,14,0,0,112
19,16,15,14,19,15,14,19,0,131
19,16,15,14,19,15,18,0,0,116
19,16,15,14,19,15,18,5,4,125
19,16,15,14,19,15,18,19,0,135
19,16,15,14,19,16,5,3,11,118
19,16,15,14,20,15,14,0,0,113
19,16,15,14,20,15,15,14,0,128
19,16,15,14,20,15,15,14,19,147
19,16,15,15,6,0,0,0,0,71
19,16,15,15,6,5,4,0,0,80
19,16,15,15,6,5,18,0,0,94
19,16,15,15,6,5,18,25,0,119
19,16,15,15,6,5,18,19,0,113
19,16,15,15,6,25,0,0,0,96
19,16,15,15,6,9,14,7,0,101
19,16,15,15,6,9,19,8,0,107
19,16,15,15,6,19,0,0,0,90
19,16,15,15,11,0,0,0,0,76
19,16,15,15,11,4,15,13,0,108
19,16,15,15,11,5,4,0,0,85
19,16,15,15,11,5,18,25,0,124
19,16,15,15,11,25,0,0,0,101
19,16,15,15,11,9,5,18,0,108
19,16,15,15,11,9,5,19,0,109
19,16,15,15,11,9,5,19,20,129
19,16,15,15,11,9,12,25,0,122
19,16,15,15,11,9,14,7,0,106
19,16,15,15,11,9,19,8,0,112
19,16,15,15,11,9,19,13,0,117
19,16,15,15,11,9,19,20,0,124
19,16,15,15,11,19,0,0,0,95
19,16,15,15,12,0,0,0,0,77
19,16,15,15,12,5,4,0,0,86
19,16,15,15,12,5,18,0,0,100
19,16,15,15,12,5,18,19,0,119
19,16,15,15,12,6,21,12,0,116
19,16,15,15,12,9,14,7,0,107
19,16,15,15,12,12,9,11,5,114
19,16,15,15,12,19,0,0,0,96
19,16,15,15,12,23,15,15,4,134
19,16,15,15,13,0,0,0,0,78
19,16,15,15,14,0,0,0,0,79
19,16,15,15,14,2,1,3,11,96
19,16,15,15,14,2,1,9,20,111
19,16,15,15,14,2,9,12,12,114
19,16,15,15,14,5,4,0,0,88
19,16,15,15,14,5,25,0,0,109
19,16,15,15,14,5,25,12,25,146
19,16,15,15,14,5,25,19,0,128
19,16,15,15,14,6,21,12,0,118
19,16,15,15,14,6,21,12,19,137
19,16,15,15,14,25,0,0,0,104
19,16,15,15,14,9,5,18,0,111
19,16,15,15,14,9,5,19,0,112
19,16,15,15,14,9,5,19,20,132
19,16,15,15,14,25,9,19,13,145
19,16,15,15,14,9,12,25,0,125
19,16,15,15,14,9,14,7,0,109
19,16,15,15,14,9,19,13,0,120
19,16,15,15,14,12,5,19,19,134
19,16,15,15,14,12,9,11,5,116
19,16,15,15,14,19,0,0,0,98
19,16,15,15,14,19,6,21,12,137
19,16,15,15,14,23,1,25,19,147
19,16,15,15,14,23,9,19,5,135
19,16,15,15,14,23,15,15,4,136
19,16,15,15,14,23,15,18,20,155
19,16,15,15,18,5,4,0,0,92
19,16,15,15,18,5,18,0,0,106
19,16,15,15,18,9,14,7,0,113
19,16,15,15,18,14,0,0,0,97
19,16,15,15,18,19,0,0,0,102
19,16,15,15,20,0,0,0,0,85
19,16,15,18,0,0,0,0,0,68
19,16,15,18,1,2,15,12,1,99
19,16,15,18,1,4,9,1,12,95
19,16,15,18,1,4,9,3,0,85
19,16,15,18,1,4,9,14,0,96
19,16,15,18,1,4,9,19,13,114
19,16,15,18,1,12,0,0,0,81
19,16,15,18,1,14,7,5,0,95
19,16,15,18,1,14,7,9,1,100
19,16,15,18,1,20,9,15,14,127
19,16,15,18,5,0,0,0,0,73
19,16,15,18,5,4,0,0,0,77
19,16,15,18,5,12,9,14,7,115
19,16,15,18,5,19,0,0,0,92
19,16,15,18,25,0,0,0,0,93
19,16,15,18,9,3,9,4,5,98
19,16,15,18,9,4,0,0,0,81
19,16,15,18,9,4,5,19,13,118
19,16,15,18,9,4,9,1,0,91
19,16,15,18,9,4,9,1,12,103
19,16,15,18,9,4,9,21,13,124
19,16,15,18,9,14,7,0,0,98
19,16,15,18,15,3,1,18,16,121
19,16,15,18,15,3,25,19,20,150
19,16,15,18,15,3,25,20,5,136
19,16,15,18,15,4,5,18,13,123
19,16,15,18,15,4,21,3,20,131
19,16,15,18,15,7,5,14,0,109
19,16,15,18,15,7,5,14,25,134
19,16,15,18,15,7,15,14,5,124
19,16,15,18,15,7,15,14,25,144
19,16,15,18,15,9,4,0,0,96
19,16,15,18,15,14,9,1,0,107
19,16,15,18,15,14,20,0,0,117
19,16,15,18,15,16,8,25,12,144
19,16,15,18,15,19,1,3,0,106
19,16,15,18,15,21,19,0,0,123
19,16,15,18,15,26,15,1,12,137
19,16,15,18,15,26,15,1,14,139
19,16,15,18,15,26,15,9,3,136
19,16,15,18,15,26,15,9,4,137
19,16,15,18,15,26,15,15,14,153
19,16,15,18,18,1,14,0,0,101
19,16,15,18,18,1,14,19,0,120
19,16,15,18,20,0,0,0,0,88
19,16,15,18,20,1,2,12,5,108
19,16,15,18,20,1,14,3,5,111
19,16,15,18,20,5,4,0,0,97
19,16,15,18,20,5,18,0,0,111
19,16,15,18,20,5,18,19,0,130
19,16,15,18,20,6,21,12,0,127
19,16,15,18,20,25,0,0,0,113
19,16,15,18,20,9,5,18,0,120
19,16,15,18,20,9,5,19,20,141
19,16,15,18,20,9,12,25,0,134
19,16,15,18,20,9,14,7,0,118
19,16,15,18,20,9,22,5,0,124
19,16,15,18,20,12,5,19,19,143
19,16,15,18,20,12,25,0,0,125
19,16,15,18,20,12,9,14,7,130
19,16,15,18,20,19,0,0,0,107
19,16,15,18,20,19,13,1,14,135
19,16,15,18,20,19,13,5,14,139
19,16,15,18,20,19,15,13,5,140
19,16,15,18,20,21,12,1,0,122
19,16,15,18,20,21,12,1,5,127
19,16,15,18,21,12,1,18,0,120
19,16,15,18,21,12,1,20,5,127
19,16,15,18,21,12,5,0,0,106
19,16,15,18,21,12,5,19,0,125
19,16,15,18,21,12,15,9,4,129
19,16,15,19,8,0,0,0,0,77
19,16,15,19,8,25,0,0,0,102
19,16,15,20,12,5,19,19,0,125
19,16,15,20,12,9,7,8,20,126
19,16,15,20,12,9,11,5,0,107
19,16,15,20,12,9,20,0,0,111
19,16,15,20,18,21,13,16,0,138
19,16,15,20,19,0,0,0,0,89
19,16,15,20,19,13,1,14,0,117
19,16,15,20,19,13,5,14,0,121
19,16,15,20,20,1,2,12,5,110
19,16,15,20,20,1,9,12,0,112
19,16,15,20,20,5,4,0,0,99
19,16,15,20,20,5,4,12,25,136
19,16,15,20,20,5,12,4,25,136
19,16,15,20,20,5,18,0,0,113
19,16,15,20,20,5,18,19,0,132
19,16,15,20,20,25,0,0,0,115
19,16,15,20,20,9,5,18,0,122
19,16,15,20,20,9,5,19,20,143
19,16,15,20,20,9,12,25,0,136
19,16,15,20,20,9,14,7,0,120
19,16,15,20,20,12,5,0,0,107
19,16,15,21,3,8,5,18,0,105
19,16,15,21,19,1,7,5,0,103
19,16,15,21,19,1,12,0,0,103
19,16,15,21,19,1,12,12,25,140
19,16,15,21,19,1,12,19,0,122
19,16,15,21,19,5,0,0,0,95
19,16,15,21,19,5,4,0,0,99
19,16,15,21,19,5,19,0,0,114
19,16,15,21,19,25,0,0,0,115
19,16,15,21,19,9,14,7,0,120
19,16,15,21,20,0,0,0,0,91
19,16,15,21,20,5,4,0,0,100
19,16,15,21,20,5,18,0,0,114
19,16,15,21,20,5,18,19,0,133
19,16,15,21,20,25,0,0,0,116
19,16,15,21,20,9,14,7,0,121
19,16,15,21,20,12,5,19,19,146
19,16,15,21,20,12,9,11,5,128
19,16,15,21,20,13,1,14,0,119
19,16,15,21,20,19,0,0,0,110
19,16,16,0,0,0,0,0,0,51
19,16,18,1,3,8,12,5,0,82
19,16,18,1,3,11,0,0,0,68
19,16,18,1,3,11,9,19,8,104
19,16,18,1,3,11,12,5,0,85
19,16,18,1,3,11,12,25,0,105
19,16,18,1,4,0,0,0,0,58
19,16,18,1,4,4,12,5,0,79
19,16,18,1,4,4,12,5,4,83
19,16,18,1,4,4,12,5,19,98
19,16,18,1,7,0,0,0,0,61
19,16,18,1,7,7,5,4,0,77
19,16,18,1,7,7,5,18,0,91
19,16,18,1,7,7,9,14,7,98
19,16,18,1,7,7,12,25,0,105
19,16,18,1,7,13,1,14,0,89
19,16,18,1,7,19,0,0,0,80
19,16,18,1,25,0,0,0,0,79
19,16,18,1,9,3,8,0,0,74
19,16,18,1,25,5,4,0,0,88
19,16,18,1,25,5,25,0,0,109
19,16,18,1,25,5,18,0,0,102
19,16,18,1,25,5,18,19,0,121
19,16,18,1,25,6,21,12,0,118
19,16,18,1,25,9,14,7,0,109
19,16,18,1,25,12,5,19,19,134
19,16,18,1,25,12,9,11,5,116
19,16,18,1,9,14,0,0,0,77
19,16,18,1,9,14,5,4,0,86
19,16,18,1,9,14,7,0,0,84
19,16,18,1,9,14,9,14,7,107
19,16,18,1,9,14,19,0,0,96
19,16,18,1,9,14,20,0,0,97
19,16,18,1,9,14,20,19,0,116
19,16,18,1,25,19,0,0,0,98
19,16,18,1,9,20,8,0,0,91
19,16,18,1,14,7,0,0,0,75
19,16,18,1,14,7,12,5,0,92
19,16,18,1,14,7,12,5,4,96
19,16,18,1,14,7,12,25,0,112
19,16,18,1,14,7,19,0,0,94
19,16,18,1,14,11,0,0,0,79
19,16,18,1,20,0,0,0,0,74
19,16,18,1,20,19,0,0,0,93
19,16,18,1,20,20,5,4,0,103
19,16,18,1,20,20,5,18,0,117
19,16,18,1,20,20,25,0,0,119
19,16,18,1,20,20,9,14,7,124
19,16,18,1,20,20,12,5,0,111
19,16,18,1,20,20,12,5,4,115
19,16,18,1,20,20,12,5,19,130
19,16,18,1,21,3,8,12,5,103
19,16,18,1,23,12,0,0,0,89
19,16,18,1,23,12,5,4,0,98
19,16,18,1,23,12,5,18,0,112
19,16,18,1,23,12,5,18,19,131
19,16,18,1,23,12,25,0,0,114
19,16,18,1,23,12,9,5,18,121
19,16,18,1,23,12,9,14,7,119
19,16,18,1,23,12,19,0,0,108
19,16,18,5,1,4,0,0,0,63
19,16,18,5,1,4,5,4,0,72
19,16,18,5,1,4,5,18,0,86
19,16,18,5,1,4,5,18,19,105
19,16,18,5,1,4,25,0,0,88
19,16,18,5,1,4,9,14,7,93
19,16,18,5,1,4,19,0,0,82
19,16,18,5,1,7,8,0,0,74
19,16,18,5,1,20,8,0,0,87
19,16,18,5,1,20,8,5,4,96
19,16,18,5,3,11,12,5,0,89
19,16,18,5,5,4,0,0,0,67
19,16,18,5,5,9,14,7,0,93
19,16,18,5,5,19,0,0,0,82
19,16,18,5,5,21,23,0,0,107
19,16,18,5,14,7,0,0,0,79
19,16,18,5,14,7,5,0,0,84
19,16,18,5,14,7,9,14,7,109
19,16,18,5,14,20,0,0,0,92
19,16,18,5,20,0,0,0,0,78
19,16,18,5,20,20,25,0,0,123
19,16,18,5,23,0,0,0,0,81
19,16,18,5,23,12,0,0,0,93
19,16,18,25,0,0,0,0,0,78
19,16,18,9,5,4,0,0,0,71
19,16,18,9,5,18,0,0,0,85
19,16,18,25,5,18,0,0,0,101
19,16,18,9,5,19,20,0,0,106
19,16,18,25,5,19,20,0,0,122
19,16,18,9,7,0,0,0,0,69
19,16,18,9,7,7,5,4,0,85
19,16,18,9,7,7,5,18,0,99
19,16,18,9,7,7,5,18,19,118
19,16,18,9,7,7,25,0,0,101
19,16,18,9,7,7,9,5,18,108
19,16,18,9,7,7,9,14,7,106
19,16,18,9,7,8,20,0,0,97
19,16,18,9,7,8,20,5,4,106
19,16,18,9,7,8,20,25,0,122
19,16,18,9,7,8,20,12,25,134
19,16,18,9,7,8,20,19,0,116
19,16,18,9,7,12,5,20,0,106
19,16,18,9,7,19,0,0,0,88
19,16,18,9,7,20,1,9,12,111
19,16,18,25,12,25,0,0,0,115
19,16,18,9,14,4,7,5,0,92
19,16,18,25,14,5,19,19,0,135
19,16,18,9,14,7,1,12,0,96
19,16,18,9,14,7,1,12,4,100
19,16,18,9,14,7,1,12,19,115
19,16,18,9,14,7,5,0,0,88
19,16,18,9,14,7,5,4,0,92
19,16,18,9,14,7,5,18,19,125
19,16,18,9,14,7,5,19,0,107
19,16,18,9,14,7,6,21,12,122
19,16,18,9,14,7,7,21,14,125
19,16,18,9,14,7,9,5,18,115
19,16,18,9,14,7,9,12,25,129
19,16,18,9,14,7,9,14,7,113
19,16,18,9,14,7,12,5,0,100
19,16,18,9,14,7,12,5,4,104
19,16,18,9,14,7,12,5,20,120
19,16,18,9,14,7,12,25,0,120
19,16,18,9,14,11,0,0,0,87
19,16,18,9,14,11,12,5,0,104
19,16,18,9,14,11,12,5,4,108
19,16,18,9,14,11,12,5,18,122
19,16,18,9,14,11,12,5,19,123
19,16,18,9,14,20,0,0,0,96
19,16,18,9,14,20,5,4,0,105
19,16,18,9,14,20,5,18,0,119
19,16,18,9,14,20,5,18,19,138
19,16,18,9,14,20,9,14,7,126
19,16,18,9,14,20,19,0,0,115
19,16,18,9,20,0,0,0,0,82
19,16,18,9,20,5,0,0,0,87
19,16,18,9,20,5,12,25,0,124
19,16,18,9,20,5,19,0,0,106
19,16,18,9,20,9,19,8,0,118
19,16,18,9,20,19,0,0,0,101
19,16,18,9,20,19,1,9,12,123
19,16,18,9,20,20,1,9,12,124
19,16,18,9,20,20,5,4,0,111
19,16,18,9,20,20,25,0,0,127
19,16,18,9,20,20,9,5,0,116
19,16,18,9,20,20,9,14,7,132
19,16,18,9,20,26,0,0,0,108
19,16,18,9,20,26,5,4,0,117
19,16,18,9,20,26,5,18,0,131
19,16,18,9,20,26,5,19,0,132
19,16,18,15,1,20,0,0,0,89
19,16,18,15,3,11,5,20,0,107
19,16,18,15,3,11,5,20,19,126
19,16,18,15,4,0,0,0,0,72
19,16,18,15,7,21,5,0,0,101
19,16,18,15,9,12,0,0,0,89
19,16,18,15,14,7,0,0,0,89
19,16,18,15,19,5,0,0,0,92
19,16,18,15,20,0,0,0,0,88
19,16,18,15,20,25,0,0,0,113
19,16,18,15,20,20,12,5,0,125
19,16,18,15,21,20,0,0,0,109
19,16,18,15,21,20,1,7,5,122
19,16,18,15,21,20,5,4,0,118
19,16,18,15,21,20,5,18,0,132
19,16,18,15,21,20,6,21,12,148
19,16,18,15,21,20,9,14,7,139
19,16,18,15,21,20,19,0,0,128
19,16,18,15,23,19,25,0,0,135
19,16,18,21,3,5,0,0,0,82
19,16,18,21,3,5,4,0,0,86
19,16,18,21,3,5,12,25,0,119
19,16,18,21,3,5,18,0,0,100
19,16,18,21,3,5,18,25,0,125
19,16,18,21,3,5,19,0,0,101
19,16,18,21,3,5,19,20,0,121
19,16,18,21,3,25,0,0,0,102
19,16,18,21,3,9,5,18,0,109
19,16,18,21,3,9,5,19,20,130
19,16,18,21,3,9,6,25,0,117
19,16,18,21,3,9,14,7,0,107
19,16,18,21,5,0,0,0,0,79
19,16,18,21,5,18,0,0,0,97
19,16,18,21,5,19,0,0,0,98
19,16,18,21,7,0,0,0,0,81
19,16,18,21,7,19,0,0,0,100
19,16,18,21,9,11,0,0,0,94
19,16,18,21,9,11,5,18,0,117
19,16,18,21,9,20,0,0,0,103
19,16,18,21,14,11,0,0,0,99
19,16,18,21,14,14,25,0,0,127
19,16,18,21,14,20,0,0,0,108
19,16,18,21,14,20,12,25,0,145
19,16,18,21,19,1,4,15,0,113
19,16,18,21,19,8,0,0,0,101
19,16,20,0,0,0,0,0,0,55
19,16,21,4,2,15,25,0,0,102
19,16,21,4,4,5,4,0,0,73
19,16,21,4,4,5,18,0,0,87
19,16,21,4,4,5,18,19,0,106
19,16,21,4,4,25,0,0,0,89
19,16,21,4,4,9,14,7,0,94
19,16,21,4,4,12,5,0,0,81
19,16,21,4,19,0,0,0,0,79
19,16,21,5,0,0,0,0,0,61
19,16,21,5,4,0,0,0,0,65
19,16,21,5,19,0,0,0,0,80
19,16,21,6,6,12,5,0,0,85
19,16,21,7,0,0,0,0,0,63
19,16,21,7,7,25,0,0,0,95
19,16,21,9,12,25,9,5,0,116
19,16,21,9,12,26,9,5,0,117
19,16,21,9,14,7,0,0,0,86
19,16,21,11,5,0,0,0,0,72
19,16,21,12,25,9,5,0,0,107
19,16,21,12,26,9,5,0,0,108
19,16,21,13,1,14,20,5,0,109
19,16,21,13,5,0,0,0,0,74
19,16,21,13,5,4,0,0,0,78
19,16,21,13,5,19,0,0,0,93
19,16,21,13,25,0,0,0,0,94
19,16,21,13,9,5,18,0,0,101
19,16,21,13,9,5,19,20,0,122
19,16,21,13,9,6,15,18,13,130
19,16,21,13,9,14,7,0,0,99
19,16,21,13,15,9,4,0,0,97
19,16,21,13,15,14,5,0,0,103
19,16,21,13,15,14,5,19,0,122
19,16,21,13,15,14,9,0,0,107
19,16,21,13,15,14,9,19,0,126
19,16,21,13,15,19,5,0,0,108
19,16,21,13,15,21,19,0,0,124
19,16,21,14,0,0,0,0,0,70
19,16,21,14,3,8,0,0,0,81
19,16,21,14,7,0,0,0,0,77
19,16,21,14,7,5,0,0,0,82
19,16,21,14,25,1,18,14,0,128
19,16,21,14,11,0,0,0,0,81
19,16,21,14,11,5,4,0,0,90
19,16,21,14,11,25,0,0,0,106
19,16,21,14,11,9,5,0,0,95
19,16,21,14,11,9,5,18,0,113
19,16,21,14,11,9,5,19,0,114
19,16,21,14,11,9,5,19,20,134
19,16,21,14,11,9,12,25,0,127
19,16,21,14,11,9,14,7,0,111
19,16,21,14,11,12,5,19,19,136
19,16,21,14,11,19,0,0,0,100
19,16,21,14,14,25,0,0,0,109
19,16,21,14,14,9,5,19,0,117
19,16,21,14,23,1,18,5,0,117
19,16,21,18,4,9,5,0,0,92
19,16,21,18,4,15,7,0,0,100
19,16,21,18,7,1,12,12,0,106
19,16,21,18,7,1,12,12,19,125
19,16,21,18,7,5,0,0,0,86
19,16,21,18,7,5,19,0,0,105
19,16,21,18,9,1,0,0,0,84
19,16,21,18,9,1,5,0,0,89
19,16,21,18,9,5,19,0,0,107
19,16,21,18,9,15,21,19,0,138
19,16,21,18,12,0,0,0,0,86
19,16,21,18,12,5,19,19,0,129
19,16,21,18,12,5,20,0,0,111
19,16,21,18,12,9,11,5,0,111
19,16,21,18,12,9,14,7,0,116
19,16,21,18,12,21,15,21,19,162
19,16,21,18,13,1,11,5,18,122
19,16,21,18,13,15,14,5,25,146
19,16,21,18,14,0,0,0,0,88
19,16,21,18,14,5,4,0,0,97
19,16,21,18,14,5,18,0,0,111
19,16,21,18,14,5,18,19,0,130
19,16,21,18,14,9,14,7,0,118
19,16,21,18,14,19,0,0,0,107
19,16,21,18,16,18,15,15,6,144
19,16,21,18,18,5,4,0,0,101
19,16,21,18,18,5,25,0,0,122
19,16,21,18,18,5,9,5,19,130
19,16,21,18,18,5,25,19,0,141
19,16,21,18,18,5,18,0,0,115
19,16,21,18,18,5,18,19,0,134
19,16,21,18,18,25,0,0,0,117
19,16,21,18,18,9,1,12,0,114
19,16,21,18,18,9,5,18,0,124
19,16,21,18,18,9,5,18,19,143
19,16,21,18,18,9,5,19,0,125
19,16,21,18,18,9,14,7,0,122
19,16,21,18,18,9,14,7,19,141
19,16,21,18,18,9,20,5,0,126
19,16,21,18,19,0,0,0,0,93
19,16,21,18,20,0,0,0,0,94
19,16,21,18,20,5,4,0,0,103
19,16,21,18,20,5,18,0,0,117
19,16,21,18,20,9,14,7,0,124
19,16,21,18,20,9,22,5,0,130
19,16,21,18,20,12,5,0,0,111
19,16,21,18,20,12,5,19,0,130
19,16,21,18,20,19,0,0,0,113
19,16,21,18,23,1,25,0,0,123
19,16,21,18,23,9,14,7,0,127
19,16,21,18,23,15,18,20,0,150
19,16,21,20,0,0,0,0,0,76
19,16,21,20,1,0,0,0,0,77
19,16,21,20,1,20,9,22,5,133
19,16,21,20,5,0,0,0,0,81
19,16,21,20,14,9,11,19,0,129
19,16,21,20,20,1,0,0,0,97
19,16,21,20,20,5,18,0,0,119
19,16,21,20,20,5,18,5,4,128
19,16,21,20,20,5,18,5,18,142
19,16,21,20,20,5,18,25,0,144
19,16,21,20,20,5,18,19,0,138
19,16,21,20,21,13,0,0,0,110
19,16,21,20,21,13,1,18,25,154
19,16,21,20,21,13,15,19,5,149
19,16,21,20,21,13,15,21,19,165
19,17,4,0,0,0,0,0,0,40
19,17,17,0,0,0,0,0,0,53
19,17,18,20,0,0,0,0,0,74
19,17,21,1,2,0,0,0,0,60
19,17,21,1,2,1,19,8,0,88
19,17,21,1,2,2,5,4,0,71
19,17,21,1,2,2,5,18,0,85
19,17,21,1,2,2,25,0,0,87
19,17,21,1,2,2,9,5,18,94
19,17,21,1,2,2,9,14,7,92
19,17,21,1,2,2,9,19,8,98
19,17,21,1,2,2,12,5,0,79
19,17,21,1,2,2,12,5,4,83
19,17,21,1,2,2,12,5,18,97
19,17,21,1,2,2,12,5,19,98
19,17,21,1,2,2,12,25,0,99
19,17,21,1,2,19,0,0,0,79
19,17,21,1,3,3,15,0,0,79
19,17,21,1,3,3,15,19,0,98
19,17,21,1,4,0,0,0,0,62
19,17,21,1,4,4,5,4,0,75
19,17,21,1,4,4,5,18,0,89
19,17,21,1,4,4,25,0,0,91
19,17,21,1,4,4,9,14,7,96
19,17,21,1,4,5,18,0,0,85
19,17,21,1,4,18,1,20,5,106
19,17,21,1,4,18,9,19,13,121
19,17,21,1,4,18,15,12,0,107
19,17,21,1,4,18,15,14,0,109
19,17,21,1,4,18,15,14,5,114
19,17,21,1,4,18,15,14,19,128
19,17,21,1,4,19,0,0,0,81
19,17,21,1,9,12,0,0,0,79
19,17,21,1,9,12,5,18,0,102
19,17,21,1,9,12,19,0,0,98
19,17,21,1,12,5,14,5,0,94
19,17,21,1,12,5,14,5,19,113
19,17,21,1,12,9,4,0,0,83
19,17,21,1,12,9,4,5,18,106
19,17,21,1,12,9,4,12,25,120
19,17,21,1,12,12,0,0,0,82
19,17,21,1,12,12,5,4,0,91
19,17,21,1,12,12,5,18,0,105
19,17,21,1,12,12,5,18,25,130
19,17,21,1,12,12,5,18,19,124
19,17,21,1,12,12,25,0,0,107
19,17,21,1,12,12,9,5,18,114
19,17,21,1,12,12,9,14,7,112
19,17,21,1,12,12,9,19,8,118
19,17,21,1,12,12,19,0,0,101
19,17,21,1,12,13,0,0,0,83
19,17,21,1,12,15,9,4,0,98
19,17,21,1,12,15,18,0,0,103
19,17,21,1,12,15,18,19,0,122
19,17,21,1,13,0,0,0,0,71
19,17,21,1,13,1,0,0,0,72
19,17,21,1,13,1,5,0,0,77
19,17,21,1,13,1,20,5,0,97
19,17,21,1,13,1,20,5,4,101
19,17,21,1,13,5,0,0,0,76
19,17,21,1,13,5,12,12,1,101
19,17,21,1,13,5,15,21,19,131
19,17,21,1,13,25,0,0,0,96
19,17,21,1,13,9,6,25,0,111
19,17,21,1,13,9,19,8,0,107
19,17,21,1,13,15,9,4,0,99
19,17,21,1,13,15,19,1,0,106
19,17,21,1,13,15,19,1,12,118
19,17,21,1,13,15,19,5,0,110
19,17,21,1,13,15,19,9,19,133
19,17,21,1,13,15,21,19,0,126
19,17,21,1,13,21,12,1,0,105
19,17,21,1,13,21,12,1,5,110
19,17,21,1,13,21,12,5,0,109
19,17,21,1,14,4,5,18,0,99
19,17,21,1,14,4,5,18,19,118
19,17,21,1,14,20,21,13,0,126
19,17,21,1,18,1,2,12,5,96
19,17,21,1,18,5,0,0,0,81
19,17,21,1,18,5,1,7,5,94
19,17,21,1,18,5,3,1,16,101
19,17,21,1,18,5,4,0,0,85
19,17,21,1,18,5,4,12,25,122
19,17,21,1,18,5,12,25,0,118
19,17,21,1,18,5,13,1,14,109
19,17,21,1,18,5,13,5,14,113
19,17,21,1,18,5,18,0,0,99
19,17,21,1,18,5,18,19,0,118
19,17,21,1,18,5,19,0,0,100
19,17,21,1,18,5,19,20,0,120
19,17,21,1,18,25,0,0,0,101
19,17,21,1,18,9,5,18,0,108
19,17,21,1,18,9,14,7,0,106
19,17,21,1,18,9,19,8,0,112
19,17,21,1,18,11,0,0,0,87
19,17,21,1,18,18,15,19,5,133
19,17,21,1,18,18,15,21,19,149
19,17,21,1,18,19,15,14,0,124
19,17,21,1,19,8,0,0,0,85
19,17,21,1,19,8,5,4,0,94
19,17,21,1,19,8,5,18,0,108
19,17,21,1,19,8,5,18,19,127
19,17,21,1,19,8,5,19,0,109
19,17,21,1,19,8,25,0,0,110
19,17,21,1,19,8,9,5,18,117
19,17,21,1,19,8,9,12,25,131
19,17,21,1,19,8,9,14,7,115
19,17,21,1,19,8,19,0,0,104
19,17,21,1,20,0,0,0,0,78
19,17,21,1,20,9,14,9,4,114
19,17,21,1,20,12,25,0,0,115
19,17,21,1,20,13,5,14,20,130
19,17,21,1,20,13,15,18,5,129
19,17,21,1,20,14,5,19,19,135
19,17,21,1,20,19,0,0,0,97
19,17,21,1,20,20,1,7,5,111
19,17,21,1,20,20,5,4,0,107
19,17,21,1,20,20,5,18,0,121
19,17,21,1,20,20,5,18,19,140
19,17,21,1,20,20,5,19,20,142
19,17,21,1,20,20,25,0,0,123
19,17,21,1,20,20,9,5,18,130
19,17,21,1,20,20,9,12,25,144
19,17,21,1,20,20,9,14,7,128
19,17,21,1,20,20,9,19,8,134
19,17,21,1,20,20,12,5,0,115
19,17,21,1,20,23,9,19,5,134
19,17,21,1,23,0,0,0,0,81
19,17,21,1,23,2,21,19,8,131
19,17,21,1,23,4,15,13,0,113
19,17,21,1,23,6,9,19,8,123
19,17,21,1,23,11,0,0,0,92
19,17,21,1,23,11,5,4,0,101
19,17,21,1,23,11,5,18,0,115
19,17,21,1,23,11,5,18,19,134
19,17,21,1,23,11,25,0,0,117
19,17,21,1,23,11,9,5,0,106
19,17,21,1,23,11,9,5,18,124
19,17,21,1,23,11,9,14,7,122
19,17,21,1,23,11,19,0,0,111
19,17,21,1,23,12,0,0,0,93
19,17,21,1,23,12,5,18,0,116
19,17,21,1,23,18,15,15,20,149
19,17,21,1,23,19,0,0,0,100
19,17,21,1,23,23,5,5,4,118
19,17,21,4,7,5,0,0,0,73
19,17,21,4,7,25,0,0,0,93
19,17,21,5,1,11,0,0,0,74
19,17,21,5,1,11,5,4,0,83
19,17,21,5,1,11,5,18,0,97
19,17,21,5,1,11,5,18,25,122
19,17,21,5,1,11,5,18,19,116
19,17,21,5,1,11,25,0,0,99
19,17,21,5,1,11,9,5,18,106
19,17,21,5,1,11,9,12,25,120
19,17,21,5,1,11,9,14,7,104
19,17,21,5,1,11,12,5,20,111
19,17,21,5,1,11,19,0,0,93
19,17,21,5,1,12,0,0,0,75
19,17,21,5,1,12,4,0,0,79
19,17,21,5,1,12,5,4,0,84
19,17,21,5,1,12,5,18,0,98
19,17,21,5,1,12,5,18,19,117
19,17,21,5,1,12,9,14,7,105
19,17,21,5,1,12,19,0,0,94
19,17,21,5,1,13,0,0,0,76
19,17,21,5,1,13,25,0,0,101
19,17,21,5,1,13,9,19,8,112
19,17,21,5,1,13,15,21,19,131
19,17,21,5,1,19,25,0,0,107
19,17,21,5,5,7,5,0,0,79
19,17,21,5,5,7,5,5,0,84
19,17,21,5,5,7,5,5,4,88
19,17,21,5,5,7,5,5,19,103
19,17,21,5,5,12,0,0,0,79
19,17,21,5,5,26,5,0,0,98
19,17,21,5,5,26,5,4,0,102
19,17,21,5,5,26,5,18,0,116
19,17,21,5,5,26,5,18,19,135
19,17,21,5,5,26,5,19,0,117
19,17,21,5,5,26,25,0,0,118
19,17,21,5,5,26,9,14,7,123
19,17,21,5,7,0,0,0,0,69
19,17,21,5,7,7,5,4,0,85
19,17,21,5,7,7,9,14,7,106
19,17,21,5,7,19,0,0,0,88
19,17,21,5,12,3,8,0,0,85
19,17,21,5,12,3,8,5,4,94
19,17,21,5,12,3,8,5,18,108
19,17,21,5,12,3,8,5,19,109
19,17,21,5,12,3,8,25,0,110
19,17,21,5,12,5,20,20,5,124
19,17,21,5,14,3,8,0,0,87
19,17,21,5,14,3,8,5,18,110
19,17,21,5,20,0,0,0,0,82
19,17,21,5,20,5,5,0,0,92
19,17,21,9,2,0,0,0,0,68
19,17,21,9,2,2,5,4,0,79
19,17,21,9,2,2,5,18,0,93
19,17,21,9,2,2,5,18,25,118
19,17,21,9,2,2,9,14,7,100
19,17,21,9,2,2,9,19,8,106
19,17,21,9,2,12,5,20,0,105
19,17,21,9,2,12,9,14,7,110
19,17,21,9,2,19,0,0,0,87
19,17,21,9,2,19,20,5,18,130
19,17,21,9,4,4,5,4,0,83
19,17,21,9,4,4,5,18,0,97
19,17,21,9,4,4,9,14,7,104
19,17,21,9,4,4,12,5,0,91
19,17,21,9,4,7,5,0,0,82
19,17,21,9,4,7,25,0,0,102
19,17,21,9,4,7,9,5,18,109
19,17,21,9,4,19,0,0,0,89
19,17,21,9,6,6,5,4,0,87
19,17,21,9,6,6,5,18,0,101
19,17,21,9,6,6,25,0,0,103
19,17,21,9,6,6,9,5,18,110
19,17,21,9,7,7,12,5,0,97
19,17,21,9,7,7,12,5,4,101
19,17,21,9,7,7,12,5,19,116
19,17,21,9,7,7,12,25,0,117
19,17,21,9,12,7,5,5,0,95
19,17,21,9,12,7,5,5,4,99
19,17,21,9,12,7,5,5,18,113
19,17,21,9,12,7,5,5,19,114
19,17,21,9,12,12,1,5,0,96
19,17,21,9,12,12,1,19,0,110
19,17,21,9,12,12,5,18,25,138
19,17,21,9,12,12,7,5,5,107
19,17,21,9,12,12,9,1,14,114
19,17,21,9,12,12,9,4,0,103
19,17,21,9,12,12,15,9,4,118
19,17,21,9,12,12,19,0,0,109
19,17,21,9,14,0,0,0,0,80
19,17,21,9,14,1,3,25,0,109
19,17,21,9,14,1,14,3,5,103
19,17,21,9,14,1,14,3,25,123
19,17,21,9,14,1,14,20,0,115
19,17,21,9,14,3,8,0,0,91
19,17,21,9,14,3,8,5,4,100
19,17,21,9,14,3,8,5,19,115
19,17,21,9,14,14,25,0,0,119
19,17,21,9,14,14,9,5,4,112
19,17,21,9,14,14,9,5,18,126
19,17,21,9,14,14,9,5,19,127
19,17,21,9,14,19,25,0,0,124
19,17,21,9,14,20,0,0,0,100
19,17,21,9,14,20,5,4,0,109
19,17,21,9,14,20,5,18,0,123
19,17,21,9,14,20,5,18,19,142
19,17,21,9,14,20,5,19,20,144
19,17,21,9,14,20,25,0,0,125
19,17,21,9,14,20,9,5,18,132
19,17,21,9,14,20,9,14,7,130
19,17,21,9,14,20,12,25,0,137
19,17,21,9,14,20,19,0,0,119
19,17,21,9,18,1,7,5,0,97
19,17,21,9,18,1,12,20,25,142
19,17,21,9,18,1,18,3,8,114
19,17,21,9,18,5,4,0,0,93
19,17,21,9,18,5,4,15,13,121
19,17,21,9,18,5,5,14,0,108
19,17,21,9,18,5,5,14,19,127
19,17,21,9,18,5,12,5,20,126
19,17,21,9,18,5,12,25,0,126
19,17,21,9,18,5,19,19,0,127
19,17,21,9,18,5,20,0,0,109
19,17,21,9,18,9,14,7,0,114
19,17,21,9,18,9,19,8,0,120
19,17,21,9,18,9,19,13,0,125
19,17,21,9,18,11,0,0,0,95
19,17,21,9,18,12,0,0,0,96
19,17,21,9,18,13,0,0,0,97
19,17,21,9,18,13,5,4,0,106
19,17,21,9,18,13,5,18,0,120
19,17,21,9,18,13,5,18,19,139
19,17,21,9,18,13,25,0,0,122
19,17,21,9,18,13,9,5,18,129
19,17,21,9,18,13,9,14,7,127
19,17,21,9,18,13,19,0,0,116
19,17,21,9,18,18,0,0,0,102
19,17,21,9,18,18,5,12,0,119
19,17,21,9,18,18,5,12,25,144
19,17,21,9,18,18,5,12,19,138
19,17,21,9,18,20,0,0,0,104
19,17,21,9,18,20,5,4,0,113
19,17,21,9,18,20,5,18,0,127
19,17,21,9,18,20,5,18,19,146
19,17,21,9,18,20,25,0,0,129
19,17,21,9,18,20,9,14,7,134
19,17,21,9,18,20,9,19,8,140
19,17,21,9,18,20,19,0,0,123
19,17,21,9,19,8,0,0,0,93
19,17,21,9,19,8,5,4,0,102
19,17,21,9,19,8,5,19,0,117
19,17,21,9,19,8,25,0,0,118
19,17,21,9,19,8,9,5,18,125
19,17,21,9,19,8,9,14,7,123
19,17,21,9,19,19,0,0,0,104
19,17,21,9,20,0,0,0,0,86
19,17,21,9,20,3,8,0,0,97
19,17,21,9,20,3,8,25,0,122
19,17,21,9,20,20,5,18,0,129
19,17,21,9,26,0,0,0,0,92
19,17,21,15,15,19,8,0,0,114
19,17,21,15,15,19,8,5,4,123
19,17,21,15,15,19,8,5,19,138
19,17,21,15,15,19,8,25,0,139
19,17,21,15,26,5,0,0,0,103
19,17,21,19,8,25,0,0,0,109
19,17,21,19,8,9,5,18,0,116
19,17,21,19,8,9,5,19,20,137
19,17,21,21,19,8,0,0,0,105
19,17,21,21,19,8,5,4,0,114
19,17,21,21,19,8,5,19,0,129
19,17,21,21,19,8,25,0,0,130
19,17,21,21,19,8,9,14,7,135
19,18,9,4,8,1,18,0,0,77
19,18,9,4,8,1,18,1,14,92
19,18,9,11,1,14,20,8,0,100
19,18,9,14,9,22,1,19,0,111
19,18,9,18,1,13,0,0,0,78
19,18,9,19,0,0,0,0,0,65
19,18,9,22,1,20,19,1,14,123
19,18,21,20,9,0,0,0,0,87
19,19,5,4,0,0,0,0,0,47
19,19,9,14,7,0,0,0,0,68
19,19,15,18,20,0,0,0,0,91
19,19,20,15,18,0,0,0,0,91
19,19,21,0,0,0,0,0,0,59
19,20,2,4,0,0,0,0,0,45
19,20,3,8,9,0,0,0,0,59
19,20,4,4,13,16,0,0,0,76
19,20,5,1,4,1,2,12,5,69
19,20,5,1,4,5,4,0,0,58
19,20,5,1,4,6,1,19,20,95
19,20,5,1,4,9,5,4,0,67
19,20,5,1,4,9,5,18,0,81
19,20,5,1,4,9,5,18,19,100
19,20,5,1,4,9,5,19,0,82
19,20,5,1,4,9,5,19,20,102
19,20,5,1,4,25,9,14,7,104
19,20,5,1,4,25,9,19,8,110
19,20,5,1,4,9,12,25,0,95
19,20,5,1,4,9,14,7,0,79
19,20,5,1,4,9,14,7,19,98
19,20,5,1,4,9,20,5,0,83
19,20,5,1,4,13,1,14,0,77
19,20,5,1,4,19,0,0,0,68
19,20,5,1,11,0,0,0,0,56
19,20,5,1,11,19,0,0,0,75
19,20,5,1,12,0,0,0,0,57
19,20,5,1,12,1,2,12,5,77
19,20,5,1,12,1,7,5,0,70
19,20,5,1,12,1,7,5,19,89
19,20,5,1,12,5,4,0,0,66
19,20,5,1,12,5,18,0,0,80
19,20,5,1,12,5,18,19,0,99
19,20,5,1,12,25,0,0,0,82
19,20,5,1,12,9,14,7,0,87
19,20,5,1,12,9,14,7,19,106
19,20,5,1,12,19,0,0,0,76
19,20,5,1,12,20,8,0,0,85
19,20,5,1,12,20,8,25,0,110
19,20,5,1,12,20,8,19,0,104
19,20,5,1,13,0,0,0,0,58
19,20,5,1,13,2,15,1,20,96
19,20,5,1,13,3,1,18,0,80
19,20,5,1,13,5,4,0,0,67
19,20,5,1,13,5,18,0,0,81
19,20,5,1,13,5,18,5,4,90
19,20,5,1,13,5,18,19,0,100
19,20,5,1,13,25,0,0,0,83
19,20,5,1,13,9,5,0,0,72
19,20,5,1,13,9,5,18,0,90
19,20,5,1,13,9,5,19,20,111
19,20,5,1,13,9,12,25,0,104
19,20,5,1,13,9,14,7,0,88
19,20,5,1,13,12,5,19,19,113
19,20,5,1,13,12,9,11,5,95
19,20,5,1,13,16,9,16,5,104
19,20,5,1,13,18,15,12,12,115
19,20,5,1,13,19,0,0,0,77
19,20,5,1,13,19,8,9,16,110
19,20,5,1,14,0,0,0,0,59
19,20,5,1,14,9,14,7,0,89
19,20,5,1,16,19,9,14,0,103
19,20,5,1,16,19,9,14,19,122
19,20,5,1,18,1,20,5,0,89
19,20,5,1,18,1,20,5,19,108
19,20,5,1,18,9,3,0,0,75
19,20,5,1,18,25,12,0,0,100
19,20,5,1,18,9,14,0,0,86
19,20,5,1,18,9,14,5,0,91
19,20,5,1,18,9,14,5,19,110
19,20,5,1,18,9,14,19,0,105
19,20,5,1,18,15,14,5,0,97
19,20,5,1,18,18,8,5,1,95
19,20,5,1,20,9,14,0,0,88
19,20,5,1,20,9,20,5,0,99
19,20,5,1,20,9,20,5,19,118
19,20,5,1,20,9,20,9,3,106
19,20,5,1,20,15,13,1,0,94
19,20,5,1,20,15,13,1,19,113
19,20,5,1,20,15,19,5,19,123
19,20,5,1,20,15,19,9,19,127
19,20,5,2,2,9,14,19,0,90
19,20,5,3,8,0,0,0,0,55
19,20,5,3,8,1,4,15,19,94
19,20,5,3,8,12,9,14,7,97
19,20,5,3,11,12,9,14,7,100
19,20,5,4,4,12,5,0,0,69
19,20,5,4,6,1,19,20,0,94
19,20,5,5,4,0,0,0,0,53
19,20,5,5,4,12,5,19,19,108
19,20,5,5,4,12,9,11,5,90
19,20,5,5,4,19,0,0,0,72
19,20,5,5,11,0,0,0,0,60
19,20,5,5,11,5,4,0,0,69
19,20,5,5,11,9,14,7,0,90
19,20,5,5,11,11,1,14,0,86
19,20,5,5,11,19,0,0,0,79
19,20,5,5,12,2,15,23,0,101
19,20,5,5,12,5,4,0,0,70
19,20,5,5,12,5,14,0,0,80
19,20,5,5,12,5,18,0,0,84
19,20,5,5,12,5,18,19,0,103
19,20,5,5,12,8,5,1,4,79
19,20,5,5,12,25,0,0,0,86
19,20,5,5,12,25,1,18,4,109
19,20,5,5,12,9,5,0,0,75
19,20,5,5,12,9,5,18,0,93
19,20,5,5,12,9,5,19,0,94
19,20,5,5,12,9,5,19,20,114
19,20,5,5,12,9,6,25,0,101
19,20,5,5,12,9,14,7,0,91
19,20,5,5,12,12,5,19,19,116
19,20,5,5,12,12,9,11,5,98
19,20,5,5,12,13,1,11,5,91
19,20,5,5,12,13,1,14,0,89
19,20,5,5,12,13,5,14,0,93
19,20,5,5,12,19,0,0,0,80
19,20,5,5,12,23,1,18,5,108
19,20,5,5,12,23,15,18,11,128
19,20,5,5,13,0,0,0,0,62
19,20,5,5,14,2,15,3,0,83
19,20,5,5,14,2,15,3,11,94
19,20,5,5,14,2,15,11,0,91
19,20,5,5,14,2,15,11,19,110
19,20,5,5,14,2,18,1,19,103
19,20,5,5,14,9,14,7,0,93
19,20,5,5,14,11,9,18,11,112
19,20,5,5,14,20,8,0,0,91
19,20,5,5,16,4,15,23,14,121
19,20,5,5,16,5,4,0,0,74
19,20,5,5,16,5,14,0,0,84
19,20,5,5,16,5,14,5,4,93
19,20,5,5,16,5,14,19,0,103
19,20,5,5,16,5,18,0,0,88
19,20,5,5,16,5,18,19,0,107
19,20,5,5,16,5,19,20,0,109
19,20,5,5,16,25,0,0,0,90
19,20,5,5,16,9,14,7,0,95
19,20,5,5,16,9,19,8,0,101
19,20,5,5,16,12,5,0,0,82
19,20,5,5,16,12,5,4,0,86
19,20,5,5,16,12,5,19,0,101
19,20,5,5,16,12,25,0,0,102
19,20,5,5,16,14,5,19,19,122
19,20,5,5,16,19,0,0,0,84
19,20,5,5,16,23,5,5,4,102
19,20,5,5,16,23,15,18,20,141
19,20,5,5,18,0,0,0,0,67
19,20,5,5,18,1,2,12,5,87
19,20,5,5,18,1,7,5,0,80
19,20,5,5,18,1,7,5,19,99
19,20,5,5,18,5,4,0,0,76
19,20,5,5,18,5,18,0,0,90
19,20,5,5,18,5,18,19,0,109
19,20,5,5,18,25,0,0,0,92
19,20,5,5,18,9,14,7,0,97
19,20,5,5,18,12,5,19,19,122
19,20,5,5,18,12,9,14,7,109
19,20,5,5,18,13,1,14,0,95
19,20,5,5,18,19,0,0,0,86
19,20,5,5,18,19,13,1,14,114
19,20,5,5,18,19,13,5,14,118
19,20,5,5,22,5,0,0,0,76
19,20,5,5,22,5,4,0,0,80
19,20,5,5,22,5,12,25,0,113
19,20,5,5,22,5,18,0,0,94
19,20,5,5,22,5,19,0,0,95
19,20,5,5,22,9,14,7,0,101
19,20,5,5,22,9,14,7,19,120
19,20,5,7,0,0,0,0,0,51
19,20,5,7,8,0,0,0,0,59
19,20,5,7,14,15,19,9,19,127
19,20,5,7,14,15,20,9,3,112
19,20,5,7,15,4,15,14,19,118
19,20,5,7,15,4,15,14,20,119
19,20,5,7,15,19,1,21,18,125
19,20,5,25,0,0,0,0,0,69
19,20,5,9,4,0,0,0,0,57
19,20,5,9,7,8,0,0,0,68
19,20,5,9,14,2,15,3,11,98
19,20,5,9,14,2,15,11,0,95
19,20,5,9,14,2,15,11,19,114
19,20,5,9,14,2,21,3,11,104
19,20,5,9,14,6,21,12,0,106
19,20,5,25,14,9,14,7,0,113
19,20,5,9,14,11,9,18,11,116
19,20,5,9,14,19,0,0,0,86
19,20,5,11,1,14,0,0,0,70
19,20,5,12,1,0,0,0,0,57
19,20,5,12,1,5,0,0,0,62
19,20,5,12,1,9,0,0,0,66
19,20,5,12,1,18,0,0,0,75
19,20,5,12,5,0,0,0,0,61
19,20,5,12,5,14,5,0,0,80
19,20,5,12,5,19,0,0,0,80
19,20,5,12,9,3,0,0,0,68
19,20,5,12,12,0,0,0,0,68
19,20,5,12,12,1,18,0,0,87
19,20,5,12,12,1,18,25,0,112
19,20,5,12,12,1,19,0,0,88
19,20,5,12,12,1,20,5,0,94
19,20,5,12,12,1,20,5,4,98
19,20,5,12,12,5,4,0,0,77
19,20,5,12,12,5,18,9,4,104
19,20,5,12,12,9,6,25,0,108
19,20,5,12,12,9,14,7,0,98
19,20,5,12,12,9,15,0,0,92
19,20,5,12,12,9,15,14,0,106
19,20,5,12,12,21,12,1,18,120
19,20,5,13,0,0,0,0,0,57
19,20,5,13,1,0,0,0,0,58
19,20,5,13,2,15,11,0,0,85
19,20,5,13,6,15,18,13,0,109
19,20,5,13,8,5,1,4,0,75
19,20,5,13,12,5,19,19,0,112
19,20,5,13,12,5,20,0,0,94
19,20,5,13,12,9,11,5,0,94
19,20,5,13,13,1,0,0,0,71
19,20,5,13,13,1,19,0,0,90
19,20,5,13,13,1,20,1,0,92
19,20,5,13,13,5,4,0,0,79
19,20,5,13,13,5,18,0,0,93
19,20,5,13,13,5,18,25,0,118
19,20,5,13,13,5,18,19,0,112
19,20,5,13,13,25,0,0,0,95
19,20,5,13,13,9,5,18,0,102
19,20,5,13,13,9,5,19,20,123
19,20,5,13,13,9,14,7,0,100
19,20,5,13,16,5,12,0,0,90
19,20,5,13,16,12,5,0,0,90
19,20,5,13,16,15,19,20,0,127
19,20,5,13,19,0,0,0,0,76
19,20,5,13,19,15,14,0,0,105
19,20,5,13,19,15,14,19,0,124
19,20,5,13,23,1,18,4,19,122
19,20,5,13,23,1,18,5,0,104
19,20,5,13,23,1,18,5,19,123
19,20,5,14,1,18,0,0,0,77
19,20,5,14,3,8,0,0,0,69
19,20,5,14,3,8,5,12,0,86
19,20,5,14,3,8,5,19,0,93
19,20,5,14,3,8,6,21,12,108
19,20,5,14,3,8,25,0,0,94
19,20,5,14,3,8,9,5,18,101
19,20,5,14,3,8,9,14,7,99
19,20,5,14,3,8,9,15,14,107
19,20,5,14,3,9,12,0,0,82
19,20,5,14,3,9,12,5,4,91
19,20,5,14,3,9,12,5,18,105
19,20,5,14,3,9,12,19,0,101
19,20,5,14,4,0,0,0,0,62
19,20,5,14,7,0,0,0,0,65
19,20,5,14,7,1,8,0,0,74
19,20,5,14,7,1,8,19,0,93
19,20,5,14,9,1,0,0,0,68
19,20,5,14,9,15,14,0,0,96
19,20,5,14,15,0,0,0,0,73
19,20,5,14,15,7,0,0,0,80
19,20,5,14,15,11,25,0,0,109
19,20,5,14,15,16,1,9,3,102
19,20,5,14,15,16,5,9,3,106
19,20,5,14,15,19,0,0,0,92
19,20,5,14,15,19,5,4,0,101
19,20,5,14,15,19,5,19,0,116
19,20,5,14,15,19,9,19,0,120
19,20,5,14,15,20,9,3,0,105
19,20,5,14,15,20,25,16,25,159
19,20,5,14,20,5,18,0,0,101
19,20,5,14,20,5,18,5,18,124
19,20,5,14,20,9,14,7,0,108
19,20,5,14,20,15,14,0,0,107
19,20,5,14,20,15,18,19,0,130
19,20,5,14,20,18,5,12,0,113
19,20,5,16,0,0,0,0,0,60
19,20,5,16,1,21,14,20,0,116
19,20,5,16,2,1,9,18,14,104
19,20,5,16,3,8,9,12,4,96
19,20,5,16,4,1,13,5,0,83
19,20,5,16,4,1,13,5,19,102
19,20,5,16,4,1,14,3,5,87
19,20,5,16,4,15,23,14,0,116
19,20,5,16,4,15,23,14,19,135
19,20,5,16,8,1,14,5,0,88
19,20,5,16,8,1,14,9,3,95
19,20,5,16,8,1,14,15,19,117
19,20,5,16,8,5,0,0,0,73
19,20,5,16,8,5,1,4,0,78
19,20,5,16,12,5,19,19,0,115
19,20,5,16,12,9,11,5,0,97
19,20,5,16,14,5,25,0,0,104
19,20,5,16,14,9,5,3,5,96
19,20,5,16,15,14,25,0,0,114
19,20,5,16,16,5,4,0,0,85
19,20,5,16,16,5,18,0,0,99
19,20,5,16,16,5,18,19,0,118
19,20,5,16,16,9,14,7,0,106
19,20,5,16,19,0,0,0,0,79
19,20,5,16,19,9,18,5,0,111
19,20,5,16,19,15,14,0,0,108
19,20,5,16,19,15,14,19,0,127
19,20,5,16,19,20,15,14,5,133
19,20,5,16,19,20,15,15,12,141
19,20,5,16,20,0,0,0,0,80
19,20,5,16,21,14,3,12,5,115
19,20,5,16,21,16,0,0,0,97
19,20,5,16,21,16,19,0,0,116
19,20,5,16,23,1,25,0,0,109
19,20,5,16,23,9,19,5,0,116
19,20,5,18,0,0,0,0,0,62
19,20,5,18,1,3,12,5,0,83
19,20,5,18,1,4,0,0,0,67
19,20,5,18,1,4,9,1,14,91
19,20,5,18,3,15,12,9,14,115
19,20,5,18,3,15,18,1,12,111
19,20,5,18,3,15,18,9,14,121
19,20,5,18,3,15,18,15,12,125
19,20,5,18,5,0,0,0,0,67
19,20,5,18,5,9,4,0,0,80
19,20,5,18,5,15,0,0,0,82
19,20,5,18,5,15,5,4,0,91
19,20,5,18,5,15,9,14,7,112
19,20,5,18,5,15,13,0,0,95
19,20,5,18,5,15,13,5,0,100
19,20,5,18,5,15,13,5,18,118
19,20,5,18,5,15,19,0,0,101
19,20,5,18,5,19,0,0,0,86
19,20,5,18,9,0,0,0,0,71
19,20,5,18,9,3,0,0,0,74
19,20,5,18,9,3,1,12,0,87
19,20,5,18,9,3,19,0,0,93
19,20,5,18,9,4,0,0,0,75
19,20,5,18,9,4,5,0,0,80
19,20,5,18,9,7,13,1,0,92
19,20,5,18,9,7,13,1,19,111
19,20,5,18,9,12,1,14,20,118
19,20,5,18,9,12,5,0,0,88
19,20,5,18,9,12,5,12,25,125
19,20,5,18,9,12,9,19,5,116
19,20,5,18,9,12,9,20,25,137
19,20,5,18,9,12,9,26,5,123
19,20,5,18,9,14,0,0,0,85
19,20,5,18,11,0,0,0,0,73
19,20,5,18,12,5,20,0,0,99
19,20,5,18,12,5,20,19,0,118
19,20,5,18,12,9,14,7,19,123
19,20,5,18,14,1,4,0,0,81
19,20,5,18,14,1,7,5,0,89
19,20,5,18,14,1,12,0,0,89
19,20,5,18,14,1,12,9,19,117
19,20,5,18,14,5,2,5,18,106
19,20,5,18,14,5,2,18,1,102
19,20,5,18,14,5,4,0,0,85
19,20,5,18,14,5,19,20,0,120
19,20,5,18,14,6,21,12,0,115
19,20,5,18,14,9,20,5,0,110
19,20,5,18,14,9,20,5,19,129
19,20,5,18,14,9,20,9,3,117
19,20,5,18,14,11,14,5,5,111
19,20,5,18,14,12,25,0,0,113
19,20,5,18,14,13,1,14,0,104
19,20,5,18,14,13,5,14,0,108
19,20,5,18,14,13,15,19,20,143
19,20,5,18,14,14,1,0,0,91
19,20,5,18,14,14,5,19,19,133
19,20,5,18,14,16,15,19,20,146
19,20,5,18,14,19,0,0,0,95
19,20,5,18,14,19,15,14,0,124
19,20,5,18,14,19,15,14,19,143
19,20,5,18,14,21,13,0,0,110
19,20,5,18,14,21,13,19,0,129
19,20,5,18,14,23,1,25,0,125
19,20,5,18,14,23,1,25,19,144
19,20,5,18,14,23,1,18,4,122
19,20,5,18,15,0,0,0,0,77
19,20,5,18,15,9,4,0,0,90
19,20,5,18,15,9,4,1,12,103
19,20,5,18,15,9,4,19,0,109
19,20,5,18,15,12,0,0,0,89
19,20,5,18,15,12,19,0,0,108
19,20,5,18,18,9,14,3,11,117
19,20,5,18,20,0,0,0,0,82
19,20,5,18,20,15,18,0,0,115
19,20,5,18,20,15,18,19,0,134
19,20,5,18,22,5,0,0,0,89
19,20,5,20,0,0,0,0,0,64
19,20,5,20,3,8,0,0,0,75
19,20,5,20,8,1,12,0,0,85
19,20,5,20,8,25,0,0,0,97
19,20,5,20,19,15,14,19,0,131
19,20,5,20,20,5,4,0,0,93
19,20,5,20,20,9,14,7,0,114
19,20,5,22,1,14,0,0,0,81
19,20,5,22,5,4,15,18,5,113
19,20,5,22,5,12,0,0,0,83
19,20,5,23,1,2,12,5,0,87
19,20,5,23,1,18,4,5,4,99
19,20,5,23,1,18,4,12,25,127
19,20,5,23,1,18,4,18,25,133
19,20,5,23,1,18,4,19,0,109
19,20,5,23,1,18,20,25,0,131
19,20,5,23,1,18,20,18,25,149
19,20,5,23,2,21,13,0,0,103
19,20,5,23,2,21,13,19,0,122
19,20,5,23,5,4,0,0,0,76
19,20,5,23,8,15,21,19,5,135
19,20,5,23,25,0,0,0,0,92
19,20,5,23,9,14,7,0,0,97
19,20,5,23,9,19,8,0,0,103
19,20,5,23,16,1,14,0,0,98
19,20,5,23,16,1,14,19,0,117
19,20,5,23,16,15,14,4,0,116
19,20,5,23,16,15,20,0,0,118
19,20,5,23,19,0,0,0,0,86
19,20,7,0,0,0,0,0,0,46
19,20,7,5,0,0,0,0,0,51
19,20,8,5,14,5,0,0,0,71
19,20,8,5,14,9,1,0,0,76
19,20,8,5,14,9,3,0,0,78
19,20,25,0,0,0,0,0,0,64
19,20,25,1,14,0,0,0,0,79
19,20,25,1,14,25,0,0,0,104
19,20,9,2,0,0,0,0,0,50
19,20,9,2,2,12,5,0,0,69
19,20,9,2,2,12,5,18,0,87
19,20,9,2,5,20,8,25,12,120
19,20,9,2,9,1,12,0,0,72
19,20,9,2,9,1,20,5,0,85
19,20,9,2,9,1,20,5,4,89
19,20,9,2,9,3,0,0,0,62
19,20,9,2,9,14,5,0,0,78
19,20,9,2,9,14,5,19,0,97
19,20,9,2,9,15,21,19,0,114
19,20,9,2,9,21,13,0,0,93
19,20,9,2,9,21,13,19,0,112
19,20,9,2,14,9,20,5,0,98
19,20,9,2,14,9,20,5,19,117
19,20,9,2,15,14,9,21,13,122
19,20,9,2,15,16,8,5,14,108
19,20,25,3,1,0,0,0,0,68
19,20,9,3,3,1,4,15,0,74
19,20,25,3,5,18,9,3,0,102
19,20,25,3,5,18,9,14,0,113
19,20,9,3,8,1,4,15,0,79
19,20,9,3,8,1,18,9,1,88
19,20,9,3,8,5,12,0,0,76
19,20,9,3,8,5,18,15,14,111
19,20,9,3,8,9,3,0,0,71
19,20,9,3,8,9,4,0,0,72
19,20,9,3,8,9,4,9,1,82
19,20,9,3,8,15,9,0,0,83
19,20,9,3,8,15,19,0,0,93
19,20,9,3,8,15,21,19,0,114
19,20,9,3,8,19,0,0,0,78
19,20,9,3,8,23,15,18,20,135
19,20,9,3,11,0,0,0,0,62
19,20,9,3,11,1,2,12,5,82
19,20,9,3,11,1,7,5,0,75
19,20,9,3,11,2,1,12,12,89
19,20,9,3,11,2,15,1,20,100
19,20,9,3,11,5,4,0,0,71
19,20,9,3,11,5,12,0,0,79
19,20,9,3,11,5,14,0,0,81
19,20,9,3,11,5,18,0,0,85
19,20,9,3,11,5,18,25,0,110
19,20,9,3,11,5,18,19,0,104
19,20,9,3,11,5,20,0,0,87
19,20,9,3,11,6,1,19,20,108
19,20,9,3,11,6,21,12,0,101
19,20,9,3,11,6,21,12,19,120
19,20,9,3,11,25,0,0,0,87
19,20,9,3,11,9,5,18,0,94
19,20,9,3,11,9,5,19,20,115
19,20,9,3,11,9,12,25,0,108
19,20,9,3,11,9,14,7,0,92
19,20,9,3,11,9,20,0,0,91
19,20,9,3,11,10,1,23,0,96
19,20,9,3,11,12,1,3,0,78
19,20,9,3,11,12,5,0,0,79
19,20,9,3,11,12,5,1,6,86
19,20,9,3,11,12,5,4,0,83
19,20,9,3,11,12,5,18,0,97
19,20,9,3,11,12,5,18,19,116
19,20,9,3,11,12,5,19,0,98
19,20,9,3,11,12,5,19,19,117
19,20,9,3,11,12,25,0,0,99
19,20,9,3,11,12,9,11,5,99
19,20,9,3,11,12,9,14,7,104
19,20,9,3,11,13,1,14,0,90
19,20,9,3,11,13,5,14,0,94
19,20,9,3,11,15,21,20,0,118
19,20,9,3,11,15,21,20,19,137
19,20,9,3,11,16,9,14,0,101
19,20,9,3,11,16,9,14,19,120
19,20,9,3,11,19,0,0,0,81
19,20,9,3,11,19,5,5,4,95
19,20,9,3,11,20,1,9,12,104
19,20,9,3,11,21,13,0,0,96
19,20,9,3,11,21,13,19,0,115
19,20,9,3,11,21,16,0,0,99
19,20,9,3,11,21,16,19,0,118
19,20,9,3,11,23,5,5,4,99
19,20,9,3,11,23,15,18,11,129
19,20,9,3,20,9,15,14,0,109
19,20,9,4,0,0,0,0,0,52
19,20,9,4,4,25,0,0,0,81
19,20,25,5,0,0,0,0,0,69
19,20,9,5,4,0,0,0,0,57
19,20,25,5,4,0,0,0,0,73
19,20,9,5,19,0,0,0,0,72
19,20,25,5,19,0,0,0,0,88
19,20,9,6,5,0,0,0,0,59
19,20,9,6,6,0,0,0,0,60
19,20,9,6,6,5,4,0,0,69
19,20,9,6,6,5,14,0,0,79
19,20,9,6,6,5,14,5,4,88
19,20,9,6,6,5,14,5,18,102
19,20,9,6,6,5,14,19,0,98
19,20,9,6,6,5,18,0,0,83
19,20,9,6,6,5,19,20,0,104
19,20,9,6,6,9,14,7,0,90
19,20,9,6,6,9,19,8,0,96
19,20,9,6,6,12,5,7,0,84
19,20,9,6,6,12,5,18,0,95
19,20,9,6,6,12,25,0,0,97
19,20,9,6,6,12,9,11,5,97
19,20,9,6,6,14,5,3,11,93
19,20,9,6,6,14,5,19,19,117
19,20,9,6,6,18,21,13,16,128
19,20,9,6,6,19,0,0,0,79
19,20,9,6,6,20,1,9,12,102
19,20,9,6,12,5,0,0,0,71
19,20,9,6,12,5,4,0,0,75
19,20,9,6,12,5,4,12,25,112
19,20,9,6,12,5,18,0,0,89
19,20,9,6,12,5,18,19,0,108
19,20,9,6,12,5,19,0,0,90
19,20,9,6,12,9,14,7,0,96
19,20,25,6,21,12,0,0,0,103
19,20,9,7,13,1,0,0,0,69
19,20,9,7,13,1,9,0,0,78
19,20,9,7,13,1,12,0,0,81
19,20,9,7,13,1,19,0,0,88
19,20,9,7,13,1,20,0,0,89
19,20,9,7,13,1,20,1,0,90
19,20,9,7,13,1,20,1,12,102
19,20,9,7,13,1,20,9,3,101
19,20,9,7,13,5,0,0,0,73
19,20,9,7,13,5,19,0,0,92
19,20,25,9,14,7,0,0,0,94
19,20,25,12,1,18,0,0,0,95
19,20,25,12,1,20,5,0,0,102
19,20,9,12,2,0,0,0,0,62
19,20,9,12,2,5,14,5,0,86
19,20,9,12,2,5,14,5,19,105
19,20,9,12,2,9,20,5,0,96
19,20,9,12,2,9,20,5,19,115
19,20,25,12,4,9,1,0,0,90
19,20,9,12,5,0,0,0,0,65
19,20,25,12,5,0,0,0,0,81
19,20,25,12,5,2,15,15,11,124
19,20,25,12,5,4,0,0,0,85
19,20,25,12,5,4,15,13,0,113
19,20,25,12,5,12,5,19,19,136
19,20,25,12,5,12,9,11,5,118
19,20,9,12,5,13,1,14,0,93
19,20,9,12,5,13,5,14,0,97
19,20,25,12,5,18,0,0,0,99
19,20,25,12,5,18,19,0,0,118
19,20,9,12,5,20,0,0,0,85
19,20,25,12,5,20,0,0,0,101
19,20,25,12,5,20,19,0,0,120
19,20,9,12,5,20,20,5,0,110
19,20,9,12,5,20,20,5,4,114
19,20,9,12,5,20,20,15,0,120
19,20,9,12,5,20,20,15,19,139
19,20,25,12,5,23,15,18,20,157
19,20,25,12,9,0,0,0,0,85
19,20,9,12,25,1,7,1,0,94
19,20,9,12,25,1,7,9,0,102
19,20,25,12,9,6,15,18,13,137
19,20,25,12,9,14,5,0,0,104
19,20,25,12,9,14,7,0,0,106
19,20,25,12,9,14,7,19,0,125
19,20,25,12,9,15,14,0,0,114
19,20,25,12,9,19,5,0,0,109
19,20,25,12,9,19,5,4,0,113
19,20,25,12,9,19,5,18,0,127
19,20,25,12,9,19,5,18,19,146
19,20,25,12,9,19,5,19,0,128
19,20,25,12,9,19,8,0,0,112
19,20,25,12,9,19,8,12,25,149
19,20,25,12,9,19,9,14,7,134
19,20,25,12,9,19,20,0,0,124
19,20,25,12,9,19,20,9,3,136
19,20,25,12,9,19,20,19,0,143
19,20,25,12,9,20,5,0,0,110
19,20,25,12,9,20,5,19,0,129
19,20,25,12,9,20,9,3,0,117
19,20,25,12,9,20,9,19,13,146
19,20,25,12,9,26,5,0,0,116
19,20,25,12,9,26,5,4,0,120
19,20,25,12,9,26,5,18,0,134
19,20,25,12,9,26,5,18,19,153
19,20,25,12,9,26,5,19,0,135
19,20,25,12,9,26,9,14,7,141
19,20,9,12,12,1,7,5,0,85
19,20,9,12,12,2,15,18,14,121
19,20,9,12,12,5,4,0,0,81
19,20,9,12,12,5,18,0,0,95
19,20,9,12,12,5,18,25,0,120
19,20,9,12,12,5,19,20,0,116
19,20,9,12,12,25,0,0,0,97
19,20,25,12,12,9,0,0,0,97
19,20,9,12,12,9,5,18,0,104
19,20,9,12,12,9,5,19,20,125
19,20,9,12,12,9,14,7,0,102
19,20,9,12,12,9,15,14,0,110
19,20,9,12,12,9,19,8,0,108
19,20,9,12,12,13,5,14,0,104
19,20,9,12,12,14,5,19,19,129
19,20,9,12,12,18,15,15,13,133
19,20,9,12,12,19,0,0,0,91
19,20,25,12,15,0,0,0,0,91
19,20,25,12,15,2,1,20,1,115
19,20,25,12,15,2,1,20,5,119
19,20,25,12,15,8,25,1,12,137
19,20,25,12,15,9,4,0,0,104
19,20,25,12,15,12,9,20,5,137
19,20,25,12,15,16,9,4,0,120
19,20,25,12,15,16,9,26,5,147
19,20,25,12,15,16,15,4,0,126
19,20,25,12,15,21,19,0,0,131
19,20,9,12,20,0,0,0,0,80
19,20,9,12,20,2,9,18,4,113
19,20,9,12,20,5,4,0,0,89
19,20,9,12,20,5,4,12,25,126
19,20,9,12,20,5,18,0,0,103
19,20,9,12,20,25,0,0,0,105
19,20,9,12,20,9,5,18,0,112
19,20,9,12,20,9,5,19,20,133
19,20,9,12,20,9,6,25,0,120
19,20,9,12,20,9,14,7,0,110
19,20,9,12,20,9,19,8,0,116
19,20,9,12,20,12,9,11,5,117
19,20,9,12,20,19,0,0,0,99
19,20,25,12,21,19,0,0,0,116
19,20,25,12,21,19,5,19,0,140
19,20,9,13,0,0,0,0,0,61
19,20,9,13,5,0,0,0,0,66
19,20,9,13,5,19,0,0,0,85
19,20,9,13,25,0,0,0,0,86
19,20,25,13,25,0,0,0,0,102
19,20,25,13,9,5,0,0,0,91
19,20,9,13,9,5,4,0,0,79
19,20,25,13,9,5,4,0,0,95
19,20,25,13,9,5,9,14,7,121
19,20,9,13,9,5,19,0,0,94
19,20,25,13,9,5,19,0,0,110
19,20,9,13,25,9,14,7,0,116
19,20,25,13,25,9,14,7,0,132
19,20,9,13,16,1,18,20,0,116
19,20,9,13,16,5,18,20,0,120
19,20,9,13,21,12,1,14,20,129
19,20,9,13,21,12,1,20,5,120
19,20,9,13,21,12,9,0,0,103
19,20,9,13,21,12,15,19,5,133
19,20,9,13,21,12,21,19,0,134
19,20,9,14,7,0,0,0,0,69
19,20,9,14,7,1,18,5,5,98
19,20,9,14,7,2,21,12,12,116
19,20,9,14,7,5,0,0,0,74
19,20,9,14,7,5,18,0,0,92
19,20,9,14,7,5,18,19,0,111
19,20,9,14,7,6,9,19,8,111
19,20,9,14,7,25,0,0,0,94
19,20,9,14,7,9,5,18,0,101
19,20,9,14,7,9,5,19,20,122
19,20,9,14,7,9,12,25,0,115
19,20,9,14,7,9,14,7,0,99
19,20,9,14,7,12,5,19,19,124
19,20,9,14,7,15,0,0,0,84
19,20,9,14,7,15,19,0,0,103
19,20,9,14,7,18,1,25,0,113
19,20,9,14,7,18,1,25,19,132
19,20,9,14,7,19,0,0,0,88
19,20,9,14,7,20,1,9,12,111
19,20,9,14,11,0,0,0,0,73
19,20,9,14,11,1,18,4,0,96
19,20,9,14,11,1,18,4,19,115
19,20,9,14,11,1,18,15,15,122
19,20,9,14,11,2,1,12,12,100
19,20,9,14,11,2,9,18,4,106
19,20,9,14,11,2,21,7,0,103
19,20,9,14,11,2,21,7,19,122
19,20,9,14,11,2,21,19,8,123
19,20,9,14,11,4,1,13,16,107
19,20,9,14,11,5,18,0,0,96
19,20,9,14,11,5,18,15,15,126
19,20,9,14,11,5,18,19,0,115
19,20,9,14,11,8,15,18,14,128
19,20,9,14,11,9,2,21,19,124
19,20,9,14,11,9,5,18,0,105
19,20,9,14,11,9,5,19,20,126
19,20,9,14,11,9,14,7,0,103
19,20,9,14,11,15,0,0,0,88
19,20,9,14,11,16,15,20,0,124
19,20,9,14,11,16,15,20,19,143
19,20,9,14,11,19,0,0,0,92
19,20,9,14,11,23,5,5,4,110
19,20,9,14,11,23,15,15,4,130
19,20,9,14,11,23,15,18,20,149
19,20,9,14,20,0,0,0,0,82
19,20,9,14,20,5,4,0,0,91
19,20,9,14,20,5,4,12,25,128
19,20,9,14,20,5,18,0,0,105
19,20,9,14,20,5,18,19,0,124
19,20,9,14,20,25,0,0,0,107
19,20,9,14,20,9,14,7,0,112
19,20,9,14,20,12,5,19,19,137
19,20,9,14,20,19,0,0,0,101
19,20,9,15,14,0,0,0,0,77
19,20,9,15,14,9,3,0,0,89
19,20,9,15,14,9,14,7,0,107
19,20,9,16,1,20,5,0,0,90
19,20,9,16,5,0,0,0,0,69
19,20,9,16,5,4,0,0,0,73
19,20,9,16,5,12,0,0,0,81
19,20,9,16,5,12,19,0,0,100
19,20,9,16,5,14,4,0,0,87
19,20,9,16,5,14,4,9,1,97
19,20,9,16,5,14,4,19,0,106
19,20,9,16,5,19,0,0,0,88
19,20,25,16,8,14,1,20,5,128
19,20,25,16,8,14,9,3,0,114
19,20,9,16,9,6,15,18,13,125
19,20,9,16,9,20,1,20,5,119
19,20,9,16,9,20,5,19,0,117
19,20,9,16,9,20,21,18,5,137
19,20,9,16,15,0,0,0,0,79
19,20,9,16,15,19,0,0,0,98
19,20,9,16,16,5,14,0,0,99
19,20,9,16,16,12,5,0,0,97
19,20,9,16,16,12,5,4,0,101
19,20,9,16,16,12,5,18,0,115
19,20,9,16,16,12,5,18,19,134
19,20,9,16,16,12,5,19,0,116
19,20,9,16,16,12,25,0,0,117
19,20,9,16,16,12,9,14,7,122
19,20,25,16,19,9,19,0,0,127
19,20,25,16,19,9,19,5,19,151
19,20,25,16,20,9,3,0,0,112
19,20,25,16,20,9,3,1,12,125
19,20,25,16,20,9,3,9,14,135
19,20,25,16,20,9,3,19,0,131
19,20,9,16,21,12,1,0,0,98
19,20,9,16,21,12,1,5,0,103
19,20,9,16,21,12,1,14,20,132
19,20,9,16,21,12,1,18,0,116
19,20,9,16,21,12,1,18,25,141
19,20,9,16,21,12,1,20,5,123
19,20,9,16,21,12,5,0,0,102
19,20,9,16,21,12,5,4,0,106
19,20,9,16,21,12,5,19,0,121
19,20,9,18,1,2,15,21,20,125
19,20,25,18,1,3,9,14,0,109
19,20,25,18,1,24,5,19,0,131
19,20,9,18,5,0,0,0,0,71
19,20,25,18,5,14,5,0,0,106
19,20,25,18,5,14,5,19,0,125
19,20,25,18,25,12,0,0,0,119
19,20,25,18,25,12,9,3,0,131
19,20,9,18,11,0,0,0,0,77
19,20,9,18,11,19,0,0,0,96
19,20,9,18,12,5,19,19,0,121
19,20,25,18,15,12,0,0,0,109
19,20,25,18,15,12,5,14,5,133
19,20,25,18,15,14,5,0,0,116
19,20,9,18,16,0,0,0,0,82
19,20,9,18,16,5,19,0,0,106
19,20,9,18,16,19,0,0,0,101
19,20,9,18,18,1,0,0,0,85
19,20,9,18,18,1,2,12,5,104
19,20,9,18,18,1,7,5,0,97
19,20,9,18,18,5,4,0,0,93
19,20,9,18,18,5,18,0,0,107
19,20,9,18,18,5,18,19,0,126
19,20,9,18,18,9,14,7,0,114
19,20,9,18,18,9,14,7,19,133
19,20,9,18,18,21,16,0,0,121
19,20,9,18,18,21,16,19,0,140
19,20,9,18,19,0,0,0,0,85
19,20,9,20,3,8,0,0,0,79
19,20,9,20,3,8,5,4,0,88
19,20,9,20,3,8,5,18,0,102
19,20,9,20,3,8,5,18,25,127
19,20,9,20,3,8,5,18,19,121
19,20,9,20,3,8,5,19,0,103
19,20,9,20,3,8,9,14,7,109
19,20,9,20,5,0,0,0,0,73
19,20,9,20,8,0,0,0,0,76
19,20,9,20,8,5,0,0,0,81
19,20,25,20,8,5,0,0,0,97
19,20,9,20,8,25,0,0,0,101
19,20,9,20,8,9,5,4,0,94
19,20,9,20,8,9,5,19,0,109
19,20,9,20,8,25,9,14,7,131
19,20,9,20,8,12,25,0,0,113
19,20,9,20,21,20,5,4,0,118
19,20,9,22,5,0,0,0,0,75
19,20,9,22,5,18,0,0,0,93
19,20,9,22,5,18,19,0,0,112
19,20,9,22,25,0,0,0,0,95
19,20,25,23,1,18,4,0,0,110
19,20,11,0,0,0,0,0,0,50
19,20,12,7,0,0,0,0,0,58
19,20,15,1,0,0,0,0,0,55
19,20,15,1,3,8,0,0,0,66
19,20,15,1,5,0,0,0,0,60
19,20,15,1,9,0,0,0,0,64
19,20,15,1,19,0,0,0,0,74
19,20,15,1,20,5,18,0,0,98
19,20,15,1,20,9,14,7,0,105
19,20,15,1,20,19,0,0,0,94
19,20,15,2,0,0,0,0,0,56
19,20,15,2,2,1,12,12,0,83
19,20,15,2,2,5,4,0,0,67
19,20,15,2,2,9,14,7,0,88
19,20,15,2,19,0,0,0,0,75
19,20,15,3,1,8,0,0,0,66
19,20,15,3,3,1,4,15,0,80
19,20,15,3,3,1,4,15,19,99
19,20,15,3,3,1,20,1,0,82
19,20,15,3,3,1,20,1,19,101
19,20,15,3,11,1,4,5,0,78
19,20,15,3,11,1,4,5,4,82
19,20,15,3,11,1,4,5,19,97
19,20,15,3,11,1,4,15,0,88
19,20,15,3,11,1,7,5,0,81
19,20,15,3,11,2,15,23,0,108
19,20,15,3,11,3,1,18,0,90
19,20,15,3,11,3,1,18,19,109
19,20,15,3,11,5,4,0,0,77
19,20,15,3,11,5,18,0,0,91
19,20,15,3,11,5,18,19,0,110
19,20,15,3,11,6,9,19,8,110
19,20,15,3,11,8,15,18,14,123
19,20,15,3,11,25,0,0,0,93
19,20,15,3,11,25,1,18,4,116
19,20,15,3,11,9,5,18,0,100
19,20,15,3,11,9,5,19,20,121
19,20,15,3,11,9,12,25,0,114
19,20,15,3,11,9,14,5,20,116
19,20,15,3,11,9,14,7,0,98
19,20,15,3,11,9,14,7,19,117
19,20,15,3,11,9,19,8,0,104
19,20,15,3,11,9,19,20,0,116
19,20,15,3,11,9,19,20,19,135
19,20,15,3,11,12,5,19,19,123
19,20,15,3,11,12,9,11,5,105
19,20,15,3,11,13,1,14,0,96
19,20,15,3,11,13,5,14,0,100
19,20,15,3,11,16,9,12,5,110
19,20,15,3,11,16,15,20,0,119
19,20,15,3,11,16,15,20,19,138
19,20,15,3,11,18,15,15,13,129
19,20,15,3,11,19,0,0,0,87
19,20,15,3,11,23,15,18,11,135
19,20,15,4,0,0,0,0,0,58
19,20,15,4,7,5,0,0,0,70
19,20,15,4,7,5,4,0,0,74
19,20,15,4,7,5,18,0,0,88
19,20,15,4,7,5,18,25,0,113
19,20,15,4,7,5,19,0,0,89
19,20,15,4,7,25,0,0,0,90
19,20,15,4,7,9,5,18,0,97
19,20,15,4,7,9,5,19,20,118
19,20,15,4,7,9,12,25,0,111
19,20,15,4,7,9,14,7,0,95
19,20,15,4,20,15,14,5,0,112
19,20,15,5,3,8,1,19,0,90
19,20,15,5,16,0,0,0,0,75
19,20,15,6,0,0,0,0,0,60
19,20,15,6,6,0,0,0,0,66
19,20,15,7,0,0,0,0,0,61
19,20,15,7,1,0,0,0,0,62
19,20,15,7,5,25,0,0,0,91
19,20,15,7,5,9,5,19,0,99
19,20,15,7,5,25,19,0,0,110
19,20,15,7,25,0,0,0,0,86
19,20,15,7,9,5,0,0,0,75
19,20,15,7,9,5,19,0,0,94
19,20,15,9,3,1,12,0,0,79
19,20,15,9,3,1,12,12,25,116
19,20,15,9,3,9,19,13,19,126
19,20,15,9,3,19,0,0,0,85
19,20,15,9,20,0,0,0,0,83
19,20,15,9,20,5,18,0,0,106
19,20,15,11,5,0,0,0,0,70
19,20,15,11,5,4,0,0,0,74
19,20,15,11,5,8,15,12,4,109
19,20,15,11,5,8,15,12,5,110
19,20,15,11,5,18,0,0,0,88
19,20,15,11,5,18,19,0,0,107
19,20,15,11,5,19,9,1,19,118
19,20,15,11,5,19,9,20,5,123
19,20,15,11,9,14,7,0,0,95
19,20,15,11,18,15,15,19,0,132
19,20,15,11,22,9,19,0,0,115
19,20,15,12,1,0,0,0,0,67
19,20,15,12,1,5,0,0,0,72
19,20,15,12,1,19,0,0,0,86
19,20,15,12,4,0,0,0,0,70
19,20,15,12,5,0,0,0,0,71
19,20,15,12,5,4,0,0,0,75
19,20,15,12,5,12,9,11,5,108
19,20,15,12,5,14,0,0,0,85
19,20,15,12,5,14,12,25,0,122
19,20,15,12,5,19,0,0,0,90
19,20,15,12,5,23,9,19,5,127
19,20,15,12,9,4,0,0,0,79
19,20,15,12,9,4,5,18,0,102
19,20,15,12,9,4,5,19,20,123
19,20,15,12,9,4,9,20,25,133
19,20,15,12,9,4,12,25,0,116
19,20,15,12,9,19,20,0,0,114
19,20,15,12,12,5,14,0,0,97
19,20,15,12,12,5,14,19,0,116
19,20,15,12,15,14,0,0,0,95
19,20,15,12,15,14,1,20,5,121
19,20,15,12,15,14,9,3,0,107
19,20,15,12,15,14,19,0,0,114
19,20,15,12,16,15,18,20,0,135
19,20,15,12,26,9,20,5,0,126
19,20,15,13,1,0,0,0,0,68
19,20,15,13,1,3,1,3,5,80
19,20,15,13,1,3,8,0,0,79
19,20,15,13,1,3,8,1,12,92
19,20,15,13,1,3,8,5,4,88
19,20,15,13,1,3,8,5,18,102
19,20,15,13,1,3,8,5,19,103
19,20,15,13,1,3,8,25,0,104
19,20,15,13,1,3,8,9,3,91
19,20,15,13,1,3,8,19,0,98
19,20,15,13,1,3,11,0,0,82
19,20,15,13,1,12,0,0,0,80
19,20,15,13,1,16,15,4,0,103
19,20,15,13,1,19,0,0,0,87
19,20,15,13,1,20,1,0,0,89
19,20,15,13,1,20,1,12,0,101
19,20,15,13,1,20,5,0,0,93
19,20,15,13,1,20,5,19,0,112
19,20,15,13,1,20,9,3,0,100
19,20,15,13,1,20,15,4,5,112
19,20,15,13,1,20,15,13,25,141
19,20,15,13,1,20,15,19,5,127
19,20,15,13,1,20,15,21,19,143
19,20,15,13,5,0,0,0,0,72
19,20,15,13,25,0,0,0,0,92
19,20,15,13,9,15,14,0,0,105
19,20,15,13,9,21,13,0,0,110
19,20,15,13,15,4,1,5,1,93
19,20,15,13,15,4,5,0,0,91
19,20,15,13,15,4,5,1,0,92
19,20,15,13,15,4,5,1,12,104
19,20,15,13,15,4,5,21,13,125
19,20,15,13,15,21,19,0,0,122
19,20,15,13,15,24,25,19,0,150
19,20,15,13,16,0,0,0,0,83
19,20,15,13,16,5,4,0,0,92
19,20,15,13,16,5,18,0,0,106
19,20,15,13,16,5,18,19,0,125
19,20,15,13,16,9,14,7,0,113
19,20,15,13,16,19,0,0,0,102
19,20,15,14,1,2,12,5,0,88
19,20,15,14,1,7,5,0,0,81
19,20,15,14,4,0,0,0,0,72
19,20,15,14,5,1,2,12,5,93
19,20,15,14,5,2,1,19,19,114
19,20,15,14,5,2,9,18,4,106
19,20,15,14,5,2,15,1,20,111
19,20,15,14,5,2,15,23,0,113
19,20,15,14,5,3,1,19,20,116
19,20,15,14,5,3,1,20,0,97
19,20,15,14,5,3,8,1,20,105
19,20,15,14,5,3,18,15,16,125
19,20,15,14,5,4,0,0,0,77
19,20,15,14,5,4,1,13,16,107
19,20,15,14,5,6,9,19,8,115
19,20,15,14,5,6,12,25,0,116
19,20,15,14,5,7,1,12,5,98
19,20,15,14,5,7,1,12,12,105
19,20,15,14,5,8,1,14,4,100
19,20,15,14,5,8,5,1,4,91
19,20,15,14,5,25,0,0,0,98
19,20,15,14,5,25,1,18,4,121
19,20,15,14,5,9,20,5,0,107
19,20,15,14,5,12,5,19,19,128
19,20,15,14,5,12,9,11,5,110
19,20,15,14,5,13,5,14,0,105
19,20,15,14,5,13,9,14,20,129
19,20,15,14,5,14,0,0,0,87
19,20,15,14,5,16,21,20,0,130
19,20,15,14,5,18,0,0,0,91
19,20,15,14,5,18,15,15,20,141
19,20,15,14,5,18,19,0,0,110
19,20,15,14,5,19,5,5,4,106
19,20,15,14,5,19,8,15,20,135
19,20,15,14,5,23,1,12,12,121
19,20,15,14,5,23,1,18,5,120
19,20,15,14,5,23,5,5,4,110
19,20,15,14,5,23,9,19,5,129
19,20,15,14,5,23,15,15,4,130
19,20,15,14,5,23,15,18,11,140
19,20,15,14,5,23,15,18,20,149
19,20,15,14,7,0,0,0,0,75
19,20,15,14,25,0,0,0,0,93
19,20,15,14,9,5,4,0,0,86
19,20,15,14,9,5,18,0,0,100
19,20,15,14,9,5,19,20,0,121
19,20,15,14,9,6,25,0,0,108
19,20,15,14,9,12,25,0,0,114
19,20,15,14,9,14,5,19,19,134
19,20,15,14,9,14,7,0,0,98
19,20,15,14,9,19,8,0,0,104
19,20,15,14,9,19,8,5,4,113
19,20,15,14,9,19,8,5,19,128
19,20,15,14,11,0,0,0,0,79
19,20,15,14,11,5,18,0,0,102
19,20,15,14,11,5,18,5,4,111
19,20,15,15,4,0,0,0,0,73
19,20,15,15,4,5,4,0,0,82
19,20,15,15,4,5,14,0,0,92
19,20,15,15,6,0,0,0,0,75
19,20,15,15,7,5,0,0,0,81
19,20,15,15,7,5,4,0,0,85
19,20,15,15,7,5,19,0,0,100
19,20,15,15,7,9,14,7,0,106
19,20,15,15,11,0,0,0,0,80
19,20,15,15,11,5,4,0,0,89
19,20,15,15,11,5,18,0,0,103
19,20,15,15,11,5,18,19,0,122
19,20,15,15,11,9,5,0,0,94
19,20,15,15,11,9,14,7,0,110
19,20,15,15,11,19,0,0,0,99
19,20,15,15,12,0,0,0,0,81
19,20,15,15,12,2,1,12,12,108
19,20,15,15,12,5,4,0,0,90
19,20,15,15,12,9,5,0,0,95
19,20,15,15,12,9,5,19,0,114
19,20,15,15,12,9,14,7,0,111
19,20,15,15,12,12,9,11,5,118
19,20,15,15,12,19,0,0,0,100
19,20,15,15,14,0,0,0,0,83
19,20,15,15,14,4,0,0,0,87
19,20,15,15,16,0,0,0,0,85
19,20,15,15,16,2,1,12,12,112
19,20,15,15,16,5,4,0,0,94
19,20,15,15,16,5,18,0,0,108
19,20,15,15,16,5,18,19,0,127
19,20,15,15,16,9,14,7,0,115
19,20,15,15,18,5,25,0,0,117
19,20,15,15,18,25,0,0,0,112
19,20,15,15,20,0,0,0,0,89
19,20,15,15,20,5,18,0,0,112
19,20,15,15,20,8,0,0,0,97
19,20,15,15,20,8,9,14,7,127
19,20,15,16,0,0,0,0,0,70
19,20,15,16,1,0,0,0,0,71
19,20,15,16,2,1,3,11,0,87
19,20,15,16,2,1,14,4,0,91
19,20,15,16,2,1,14,11,0,98
19,20,15,16,2,12,15,3,11,113
19,20,15,16,2,15,1,18,4,110
19,20,15,16,3,15,3,11,0,102
19,20,15,16,3,15,3,11,19,121
19,20,15,16,4,9,3,5,0,91
19,20,15,16,5,0,0,0,0,75
19,20,15,16,5,4,0,0,0,79
19,20,15,16,5,14,0,0,0,89
19,20,15,16,5,18,0,0,0,93
19,20,15,16,5,18,19,0,0,112
19,20,15,16,7,1,16,0,0,94
19,20,15,16,7,1,16,19,0,113
19,20,15,16,8,15,21,14,4,132
19,20,15,16,9,14,7,0,0,100
19,20,15,16,12,5,19,19,0,125
19,20,15,16,12,9,7,8,20,126
19,20,15,16,15,22,5,18,0,130
19,20,15,16,15,22,5,18,19,149
19,20,15,16,16,1,2,12,5,106
19,20,15,16,16,1,2,12,25,126
19,20,15,16,16,1,7,5,0,99
19,20,15,16,16,1,7,5,19,118
19,20,15,16,16,5,4,0,0,95
19,20,15,16,16,5,12,0,0,103
19,20,15,16,16,5,18,0,0,109
19,20,15,16,16,5,18,5,4,118
19,20,15,16,16,5,18,19,0,128
19,20,15,16,16,5,21,18,0,130
19,20,15,16,16,9,14,7,0,116
19,20,15,16,16,9,20,0,0,115
19,20,15,16,16,12,5,0,0,103
19,20,15,16,16,12,5,4,0,107
19,20,15,16,16,12,5,19,0,122
19,20,15,16,16,12,9,14,7,128
19,20,15,16,19,0,0,0,0,89
19,20,15,16,19,8,9,16,0,122
19,20,15,16,20,0,0,0,0,90
19,20,15,16,23,1,25,0,0,119
19,20,15,16,23,1,20,3,8,125
19,20,15,16,23,1,20,5,18,137
19,20,15,16,23,15,18,11,0,137
19,20,15,18,0,0,0,0,0,72
19,20,15,18,1,2,12,5,0,92
19,20,15,18,1,2,12,5,19,111
19,20,15,18,1,7,5,0,0,85
19,20,15,18,1,7,5,19,0,104
19,20,15,18,1,25,0,0,0,98
19,20,15,18,1,24,0,0,0,97
19,20,15,18,1,24,5,19,0,121
19,20,15,18,5,0,0,0,0,77
19,20,15,18,5,4,0,0,0,81
19,20,15,18,5,5,14,0,0,96
19,20,15,18,5,25,5,4,0,111
19,20,15,18,5,25,19,0,0,121
19,20,15,18,5,11,5,5,16,114
19,20,15,18,5,13,1,14,0,105
19,20,15,18,5,13,5,14,0,109
19,20,15,18,5,18,15,15,13,138
19,20,15,18,5,19,0,0,0,96
19,20,15,18,5,19,8,9,16,129
19,20,15,18,5,19,13,1,14,124
19,20,15,18,5,23,9,4,5,118
19,20,15,18,7,5,0,0,0,84
19,20,15,18,9,1,12,0,0,94
19,20,15,18,9,1,20,5,0,107
19,20,15,18,9,1,20,5,4,111
19,20,15,18,25,2,15,15,11,140
19,20,15,18,9,5,4,0,0,90
19,20,15,18,9,5,18,0,0,104
19,20,15,18,9,5,19,0,0,105
19,20,15,18,9,5,20,20,5,131
19,20,15,18,9,6,25,0,0,112
19,20,15,18,9,6,9,5,4,105
19,20,15,18,25,9,14,7,0,127
19,20,15,18,25,12,5,19,19,152
19,20,15,18,25,12,9,14,5,137
19,20,15,18,9,14,7,0,0,102
19,20,15,18,25,23,9,19,5,153
19,20,15,18,25,23,15,18,11,164
19,20,15,18,11,0,0,0,0,83
19,20,15,18,11,5,14,0,0,102
19,20,15,18,11,9,19,8,0,119
19,20,15,18,11,12,9,11,5,120
19,20,15,18,11,12,9,14,7,125
19,20,15,18,11,19,0,0,0,102
19,20,15,18,11,23,9,19,5,139
19,20,15,18,13,1,2,12,5,105
19,20,15,18,13,2,5,12,20,124
19,20,15,18,13,2,9,18,4,118
19,20,15,18,13,3,15,3,11,117
19,20,15,18,13,5,4,0,0,94
19,20,15,18,13,5,18,0,0,108
19,20,15,18,13,6,21,12,0,124
19,20,15,18,13,9,5,18,0,117
19,20,15,18,13,9,5,19,20,138
19,20,15,18,13,9,12,25,0,131
19,20,15,18,13,9,14,7,0,115
19,20,15,18,13,9,19,8,0,121
19,20,15,18,13,12,5,19,19,140
19,20,15,18,13,12,9,11,5,122
19,20,15,18,13,19,0,0,0,104
19,20,15,18,13,20,9,4,5,123
19,20,15,18,13,23,1,18,4,131
19,20,15,18,13,23,9,14,4,135
19,20,15,18,13,23,9,19,5,141
19,20,15,18,14,5,12,12,9,124
19,20,15,18,14,5,12,12,15,130
19,20,15,19,8,0,0,0,0,81
19,20,15,19,19,20,15,14,0,141
19,20,15,20,0,0,0,0,0,74
19,20,15,20,5,18,0,0,0,97
19,20,15,20,9,14,7,0,0,104
19,20,15,20,9,14,11,1,0,109
19,20,15,20,9,14,11,9,0,117
19,20,15,20,9,15,21,19,0,138
19,20,15,20,20,0,0,0,0,94
19,20,15,20,20,5,18,0,0,117
19,20,15,20,20,5,18,5,12,134
19,20,15,21,14,0,0,0,0,89
19,20,15,21,14,4,0,0,0,93
19,20,15,21,14,4,5,4,0,102
19,20,15,21,14,4,9,14,7,123
19,20,15,21,14,4,19,0,0,112
19,20,15,21,16,0,0,0,0,91
19,20,15,21,16,6,21,12,0,130
19,20,15,21,16,19,0,0,0,110
19,20,15,21,18,0,0,0,0,93
19,20,15,21,18,5,0,0,0,98
19,20,15,21,18,5,19,0,0,117
19,20,15,21,18,25,0,0,0,118
19,20,15,21,18,9,5,0,0,107
19,20,15,21,18,9,14,7,0,123
19,20,15,21,18,12,25,0,0,130
19,20,15,21,18,14,5,19,19,150
19,20,15,21,18,19,0,0,0,112
19,20,15,21,19,8,0,0,0,102
19,20,15,21,20,5,14,0,0,114
19,20,15,21,20,5,14,5,4,123
19,20,15,21,20,5,14,19,0,133
19,20,15,21,20,5,18,0,0,118
19,20,15,21,20,5,19,20,0,139
19,20,15,21,20,8,0,0,0,103
19,20,15,21,20,25,0,0,0,120
19,20,15,21,20,9,19,8,0,131
19,20,15,21,20,12,25,0,0,132
19,20,15,21,20,14,5,19,19,152
19,20,15,21,20,19,0,0,0,114
19,20,15,21,20,23,15,15,4,152
19,20,15,22,1,9,14,5,0,105
19,20,15,22,5,0,0,0,0,81
19,20,15,22,5,4,0,0,0,85
19,20,15,22,5,6,21,12,0,120
19,20,15,22,5,12,5,19,19,136
19,20,15,22,5,13,1,14,0,109
19,20,15,22,5,13,5,14,0,113
19,20,15,22,5,14,0,0,0,95
19,20,15,22,5,16,9,16,5,127
19,20,15,22,5,18,19,0,0,118
19,20,15,22,5,19,0,0,0,100
19,20,15,22,5,23,15,15,4,138
19,20,15,22,9,5,19,0,0,109
19,20,15,22,9,14,7,0,0,106
19,20,15,23,1,2,12,5,0,97
19,20,15,23,1,7,5,0,0,90
19,20,15,23,1,7,5,19,0,109
19,20,15,23,1,23,1,25,0,127
19,20,15,23,1,23,1,25,19,146
19,20,15,23,2,1,12,12,0,104
19,20,15,23,2,15,1,18,4,117
19,20,15,23,2,15,18,4,0,116
19,20,15,23,3,5,0,0,0,85
19,20,15,23,4,15,23,14,0,133
19,20,15,23,5,4,0,0,0,86
19,20,15,23,5,18,0,0,0,100
19,20,15,23,9,14,7,0,0,107
19,20,15,23,12,9,14,19,0,131
19,20,15,23,14,5,20,0,0,116
19,20,15,23,14,12,9,14,19,145
19,20,15,23,16,0,0,0,0,93
19,20,15,23,16,19,0,0,0,112
19,20,15,23,19,0,0,0,0,96
19,20,15,23,19,5,0,0,0,101
19,20,15,23,20,8,0,0,0,105
19,20,15,23,23,15,15,4,0,134
19,20,18,0,0,0,0,0,0,57
19,20,18,1,0,0,0,0,0,58
19,20,18,1,2,9,19,13,0,101
19,20,18,1,3,11,0,0,0,72
19,20,18,1,3,20,0,0,0,81
19,20,18,1,4,4,12,5,0,83
19,20,18,1,4,4,12,5,4,87
19,20,18,1,4,4,12,5,18,101
19,20,18,1,4,4,12,5,19,102
19,20,18,1,4,9,3,15,0,89
19,20,18,1,4,9,14,5,0,90
19,20,18,1,4,9,15,20,0,106
19,20,18,1,4,12,0,0,0,74
19,20,18,1,4,12,4,0,0,78
19,20,18,1,5,0,0,0,0,63
19,20,18,1,6,5,0,0,0,69
19,20,18,1,6,5,4,0,0,73
19,20,18,1,6,5,18,0,0,87
19,20,18,1,6,5,18,19,0,106
19,20,18,1,6,5,19,0,0,88
19,20,18,1,6,9,14,7,0,94
19,20,18,1,7,0,0,0,0,65
19,20,18,1,7,7,12,5,0,89
19,20,18,1,7,7,12,5,4,93
19,20,18,1,7,7,12,5,18,107
19,20,18,1,7,7,12,5,19,108
19,20,18,1,7,7,12,25,0,109
19,20,18,1,7,21,12,1,18,117
19,20,18,1,7,21,12,21,13,132
19,20,18,1,25,0,0,0,0,83
19,20,18,1,25,1,23,1,25,133
19,20,18,1,25,5,4,0,0,92
19,20,18,1,25,5,18,0,0,106
19,20,18,1,25,5,18,19,0,125
19,20,18,1,9,7,8,20,0,102
19,20,18,1,9,7,8,20,19,121
19,20,18,1,25,9,14,7,0,113
19,20,18,1,9,11,0,0,0,78
19,20,18,1,9,11,5,0,0,83
19,20,18,1,9,12,0,0,0,79
19,20,18,1,25,12,9,14,7,125
19,20,18,1,9,14,5,4,0,90
19,20,18,1,9,14,5,18,0,104
19,20,18,1,9,14,5,18,19,123
19,20,18,1,9,14,9,14,7,111
19,20,18,1,9,14,19,0,0,100
19,20,18,1,9,14,20,0,0,101
19,20,18,1,25,19,0,0,0,102
19,20,18,1,9,20,5,14,0,106
19,20,18,1,9,20,5,14,19,125
19,20,18,1,9,20,5,18,0,110
19,20,18,1,9,20,5,19,20,131
19,20,18,1,9,20,12,25,0,124
19,20,18,1,9,20,19,0,0,106
19,20,18,1,11,1,0,0,0,70
19,20,18,1,11,5,0,0,0,74
19,20,18,1,11,5,4,0,0,78
19,20,18,1,11,5,19,0,0,93
19,20,18,1,11,25,0,0,0,94
19,20,18,1,12,5,20,0,0,95
19,20,18,1,13,0,0,0,0,71
19,20,18,1,13,1,19,8,0,99
19,20,18,1,13,1,26,15,14,127
19,20,18,1,13,13,5,12,0,101
19,20,18,1,13,13,5,18,0,107
19,20,18,1,13,15,14,25,0,125
19,20,18,1,13,16,0,0,0,87
19,20,18,1,14,4,1,7,5,89
19,20,18,1,14,4,5,4,0,85
19,20,18,1,14,4,5,18,19,118
19,20,18,1,14,4,9,14,7,106
19,20,18,1,14,4,19,0,0,95
19,20,18,1,14,7,5,0,0,84
19,20,18,1,14,7,5,12,25,121
19,20,18,1,14,7,5,18,19,121
19,20,18,1,14,7,5,19,20,123
19,20,18,1,14,7,12,5,0,96
19,20,18,1,14,7,12,5,4,100
19,20,18,1,14,7,12,5,18,114
19,20,18,1,14,7,12,5,19,115
19,20,18,1,14,7,21,18,25,143
19,20,18,1,14,25,0,0,0,97
19,20,18,1,14,14,5,18,0,109
19,20,18,1,16,0,0,0,0,74
19,20,18,1,16,8,1,14,7,104
19,20,18,1,16,8,5,1,4,92
19,20,18,1,16,12,5,19,19,129
19,20,18,1,16,12,9,11,5,111
19,20,18,1,16,14,5,19,19,131
19,20,18,1,16,16,1,4,15,110
19,20,18,1,16,16,1,14,0,105
19,20,18,1,16,16,5,4,0,99
19,20,18,1,16,16,5,18,0,113
19,20,18,1,16,16,5,18,19,132
19,20,18,1,16,16,9,14,7,120
19,20,18,1,16,16,12,5,0,107
19,20,18,1,16,19,0,0,0,93
19,20,18,1,16,23,15,18,11,141
19,20,18,1,16,23,15,18,20,150
19,20,18,1,19,19,0,0,0,96
19,20,18,1,19,19,5,19,0,120
19,20,18,1,20,1,0,0,0,79
19,20,18,1,20,1,7,5,13,104
19,20,18,1,20,1,12,0,0,91
19,20,18,1,20,1,19,0,0,98
19,20,18,1,20,5,0,0,0,83
19,20,18,1,20,5,7,5,0,95
19,20,18,1,20,5,7,9,0,99
19,20,18,1,20,5,7,25,0,115
19,20,18,1,20,5,7,9,3,102
19,20,18,1,20,5,7,15,9,114
19,20,18,1,20,5,7,15,19,124
19,20,18,1,20,5,7,21,19,130
19,20,18,1,20,8,0,0,0,86
19,20,18,1,20,8,19,0,0,105
19,20,18,1,20,9,0,0,0,87
19,20,18,1,20,9,3,0,0,90
19,20,18,1,20,9,6,25,0,118
19,20,18,1,20,9,7,0,0,94
19,20,18,1,20,9,15,20,5,127
19,20,18,1,20,12,9,14,0,113
19,20,18,1,20,15,10,5,20,128
19,20,18,1,20,15,14,9,3,119
19,20,18,1,20,15,19,5,0,117
19,20,18,1,20,15,21,19,0,133
19,20,18,1,20,21,13,0,0,112
19,20,18,1,20,21,13,19,0,131
19,20,18,1,20,21,19,0,0,118
19,20,18,1,21,3,8,20,0,110
19,20,18,1,21,7,8,20,0,114
19,20,18,1,22,1,7,5,0,93
19,20,18,1,22,1,7,5,4,97
19,20,18,1,22,1,7,5,19,112
19,20,18,1,22,1,7,21,5,114
19,20,18,1,22,1,9,7,0,97
19,20,18,1,22,1,9,7,19,116
19,20,18,1,22,5,0,0,0,85
19,20,18,1,23,0,0,0,0,81
19,20,18,1,23,2,9,12,12,116
19,20,18,1,23,5,4,0,0,90
19,20,18,1,23,5,14,0,0,100
19,20,18,1,23,5,18,0,0,104
19,20,18,1,23,6,15,18,11,131
19,20,18,1,23,8,1,20,0,110
19,20,18,1,23,25,0,0,0,106
19,20,18,1,23,25,1,18,4,129
19,20,18,1,23,9,5,18,0,113
19,20,18,1,23,9,5,19,20,134
19,20,18,1,23,9,14,7,0,111
19,20,18,1,23,9,19,8,0,117
19,20,18,1,23,12,5,19,19,136
19,20,18,1,23,12,9,11,5,118
19,20,18,1,23,13,1,14,0,109
19,20,18,1,23,13,15,20,5,134
19,20,18,1,23,19,0,0,0,100
19,20,18,1,23,23,15,18,11,148
19,20,18,1,23,23,15,18,13,150
19,20,18,5,0,0,0,0,0,62
19,20,18,5,1,8,20,5,0,96
19,20,18,5,1,11,0,0,0,74
19,20,18,5,1,11,5,4,0,83
19,20,18,5,1,11,5,18,0,97
19,20,18,5,1,11,5,18,19,116
19,20,18,5,1,11,25,0,0,99
19,20,18,5,1,11,9,5,18,106
19,20,18,5,1,11,9,12,25,120
19,20,18,5,1,11,9,14,7,104
19,20,18,5,1,11,19,0,0,93
19,20,18,5,1,13,0,0,0,76
19,20,18,5,1,13,2,5,4,87
19,20,18,5,1,13,5,4,0,85
19,20,18,5,1,13,5,18,0,99
19,20,18,5,1,13,5,18,19,118
19,20,18,5,1,13,6,21,12,115
19,20,18,5,1,13,25,0,0,101
19,20,18,5,1,13,9,5,18,108
19,20,18,5,1,13,9,14,7,106
19,20,18,5,1,13,12,5,20,113
19,20,18,5,1,13,19,0,0,95
19,20,18,5,1,13,23,1,25,125
19,20,18,5,3,11,0,0,0,76
19,20,18,5,3,11,12,25,0,113
19,20,18,5,5,0,0,0,0,67
19,20,18,5,5,11,0,0,0,78
19,20,18,5,5,11,5,4,0,87
19,20,18,5,5,11,5,18,0,101
19,20,18,5,5,11,5,18,19,120
19,20,18,5,5,11,9,14,7,108
19,20,18,5,5,11,19,0,0,97
19,20,18,5,5,12,0,0,0,79
19,20,18,5,5,12,5,18,0,102
19,20,18,5,5,14,0,0,0,81
19,20,18,5,5,16,0,0,0,83
19,20,18,5,5,20,1,7,5,100
19,20,18,5,5,20,3,1,18,109
19,20,18,5,5,20,5,18,19,129
19,20,18,5,5,20,6,21,12,126
19,20,18,5,5,20,12,5,20,124
19,20,18,5,5,20,19,0,0,106
19,20,18,5,5,20,23,1,25,136
19,20,18,5,25,0,0,0,0,87
19,20,18,5,25,14,5,0,0,106
19,20,18,5,9,20,0,0,0,91
19,20,18,5,9,20,5,0,0,96
19,20,18,5,11,5,0,0,0,78
19,20,18,5,13,13,1,0,0,89
19,20,18,5,13,13,1,19,0,108
19,20,18,5,14,7,0,0,0,83
19,20,18,5,14,7,9,20,5,117
19,20,18,5,14,7,20,8,0,111
19,20,18,5,14,7,20,8,25,136
19,20,18,5,14,7,20,8,19,130
19,20,18,5,14,20,0,0,0,96
19,20,18,5,14,20,8,0,0,104
19,20,18,5,14,21,9,20,25,151
19,20,18,5,14,21,15,21,19,152
19,20,18,5,16,5,14,0,0,97
19,20,18,5,16,5,14,20,0,117
19,20,18,5,16,5,18,1,0,102
19,20,18,5,16,15,18,0,0,111
19,20,18,5,16,19,0,0,0,97
19,20,18,5,16,19,9,19,0,125
19,20,18,5,19,19,0,0,0,100
19,20,18,5,19,19,5,4,0,109
19,20,18,5,19,19,5,18,0,123
19,20,18,5,19,19,5,19,0,124
19,20,18,5,19,19,6,21,12,139
19,20,18,5,19,19,9,14,7,130
19,20,18,5,19,19,15,18,0,133
19,20,18,5,19,19,15,18,19,152
19,20,18,5,20,0,0,0,0,82
19,20,18,5,20,3,8,5,4,102
19,20,18,5,20,3,8,5,18,116
19,20,18,5,20,3,8,5,19,117
19,20,18,5,20,3,8,25,0,118
19,20,18,5,20,13,1,14,0,110
19,20,18,5,20,13,5,14,0,114
19,20,18,5,20,20,1,0,0,103
19,20,18,5,20,20,1,19,0,122
19,20,18,5,20,20,5,0,0,107
19,20,18,5,20,20,9,0,0,111
19,20,18,5,20,20,15,0,0,117
19,20,18,5,20,20,15,19,0,136
19,20,18,5,21,19,5,12,0,119
19,20,18,5,21,19,5,12,19,138
19,20,18,5,23,0,0,0,0,85
19,20,18,5,23,1,7,5,0,98
19,20,18,5,23,5,4,0,0,94
19,20,18,5,23,5,18,0,0,108
19,20,18,5,23,5,18,19,0,127
19,20,18,5,23,9,14,7,0,115
19,20,18,5,23,13,5,14,20,137
19,20,18,5,23,14,0,0,0,99
19,20,18,5,23,19,0,0,0,104
19,20,18,5,23,20,8,0,0,113
19,20,18,9,1,0,0,0,0,67
19,20,18,9,1,5,0,0,0,72
19,20,18,9,1,12,0,0,0,79
19,20,18,9,1,20,1,12,0,100
19,20,18,9,1,20,5,0,0,92
19,20,18,9,1,20,5,4,0,96
19,20,18,9,1,20,5,19,0,111
19,20,18,9,1,20,9,14,7,117
19,20,18,9,1,20,9,15,14,125
19,20,18,9,1,20,21,13,0,121
19,20,18,9,1,20,21,18,5,131
19,20,18,9,3,8,0,0,0,77
19,20,18,25,3,8,0,0,0,93
19,20,18,9,3,8,5,0,0,82
19,20,18,25,3,8,14,9,1,117
19,20,18,25,3,8,14,9,3,119
19,20,18,25,3,8,14,9,14,130
19,20,18,25,3,8,14,15,12,134
19,20,18,9,3,11,0,0,0,80
19,20,18,9,3,11,5,14,0,99
19,20,18,9,3,11,5,18,0,103
19,20,18,9,3,11,12,5,0,97
19,20,18,9,3,11,12,5,4,101
19,20,18,9,3,11,12,5,19,116
19,20,18,9,3,11,19,0,0,99
19,20,18,9,3,20,0,0,0,89
19,20,18,9,3,20,5,18,0,112
19,20,18,9,3,20,5,19,20,133
19,20,18,9,3,20,9,15,14,127
19,20,18,9,3,20,9,19,8,125
19,20,18,9,3,20,12,25,0,126
19,20,18,9,3,20,21,13,0,123
19,20,18,9,3,20,21,18,5,133
19,20,18,9,4,0,0,0,0,70
19,20,18,9,4,4,5,14,0,93
19,20,18,9,4,4,12,5,0,91
19,20,18,9,4,5,0,0,0,75
19,20,18,9,4,5,12,5,7,99
19,20,18,9,4,5,14,3,5,97
19,20,18,9,4,5,14,3,25,117
19,20,18,9,4,5,14,20,0,109
19,20,18,9,4,5,18,0,0,93
19,20,18,9,4,5,18,19,0,112
19,20,18,9,4,5,19,0,0,94
19,20,18,9,4,8,1,14,0,93
19,20,18,9,4,8,1,14,1,94
19,20,18,9,4,9,14,7,0,100
19,20,18,9,4,12,9,14,7,112
19,20,18,9,4,12,9,14,19,124
19,20,18,9,4,15,18,0,0,103
19,20,18,9,4,15,18,19,0,122
19,20,18,9,6,5,0,0,0,77
19,20,18,9,6,5,6,21,12,116
19,20,18,9,6,5,19,0,0,96
19,20,18,9,6,6,5,14,0,97
19,20,18,9,6,20,0,0,0,92
19,20,18,9,7,0,0,0,0,73
19,20,18,9,7,1,5,0,0,79
19,20,18,9,7,1,12,0,0,86
19,20,18,9,7,1,20,5,0,99
19,20,18,9,7,7,12,5,0,97
19,20,18,9,7,8,20,0,0,101
19,20,18,9,7,9,12,0,0,94
19,20,18,9,7,9,12,5,19,118
19,20,18,9,7,9,12,9,19,122
19,20,18,9,7,9,12,19,0,113
19,20,18,9,7,9,14,5,0,101
19,20,18,9,7,15,19,5,0,112
19,20,18,9,7,15,21,19,0,128
19,20,18,9,11,5,0,0,0,82
19,20,18,9,11,5,4,0,0,86
19,20,18,9,11,5,14,0,0,96
19,20,18,9,11,5,15,21,20,138
19,20,18,9,11,5,18,0,0,100
19,20,18,9,11,5,18,19,0,119
19,20,18,9,11,5,19,0,0,101
19,20,18,9,11,9,14,7,0,107
19,20,18,9,14,4,0,0,0,84
19,20,18,9,14,7,0,0,0,87
19,20,18,9,14,7,5,4,0,96
19,20,18,9,14,7,5,14,5,111
19,20,18,9,14,7,5,14,20,126
19,20,18,9,14,7,5,18,19,129
19,20,18,9,14,7,6,21,12,126
19,20,18,9,14,7,25,0,0,112
19,20,18,9,14,7,9,5,18,119
19,20,18,9,14,7,9,12,25,133
19,20,18,9,14,7,9,14,7,117
19,20,18,9,14,7,13,1,14,115
19,20,18,9,14,7,13,5,14,119
19,20,18,9,14,7,19,0,0,106
19,20,18,9,14,11,12,5,0,108
19,20,18,9,15,12,1,0,0,94
19,20,18,9,15,12,1,5,0,99
19,20,18,9,15,12,1,20,5,119
19,20,18,9,15,12,5,20,0,118
19,20,18,9,16,0,0,0,0,82
19,20,18,9,16,5,0,0,0,87
19,20,18,25,16,5,0,0,0,103
19,20,18,9,16,5,4,0,0,91
19,20,18,9,16,5,18,0,0,105
19,20,18,9,16,5,18,19,0,124
19,20,18,9,16,5,19,0,0,106
19,20,18,9,16,6,9,12,13,122
19,20,18,9,16,25,0,0,0,107
19,20,18,9,16,9,5,18,0,114
19,20,18,9,16,9,5,19,20,135
19,20,18,9,16,9,14,7,0,112
19,20,18,9,16,9,14,7,19,131
19,20,18,9,16,12,5,20,0,119
19,20,18,9,16,12,9,14,7,124
19,20,18,9,16,16,1,7,5,111
19,20,18,9,16,16,5,4,0,107
19,20,18,9,16,16,5,18,0,121
19,20,18,9,16,16,5,18,19,140
19,20,18,9,16,16,9,14,7,128
19,20,18,9,16,16,9,20,0,127
19,20,18,9,16,16,12,5,18,133
19,20,18,9,16,19,0,0,0,101
19,20,18,9,16,20,0,0,0,102
19,20,18,9,20,0,0,0,0,86
19,20,18,9,22,5,0,0,0,93
19,20,18,9,22,5,4,0,0,97
19,20,18,9,22,5,14,0,0,107
19,20,18,9,22,5,18,0,0,111
19,20,18,9,22,5,18,19,0,130
19,20,18,9,22,5,19,0,0,112
19,20,18,9,22,25,0,0,0,113
19,20,18,9,22,9,14,7,0,118
19,20,18,9,22,9,14,7,19,137
19,20,18,15,1,13,0,0,0,86
19,20,18,15,2,5,0,0,0,79
19,20,18,15,2,5,4,0,0,83
19,20,18,15,2,5,19,0,0,98
19,20,18,15,2,9,3,0,0,86
19,20,18,15,2,9,12,0,0,95
19,20,18,15,2,9,12,1,0,96
19,20,18,15,2,9,12,1,5,101
19,20,18,15,2,9,12,1,18,114
19,20,18,15,2,9,12,5,0,100
19,20,18,15,2,9,12,5,19,119
19,20,18,15,2,9,12,9,0,104
19,20,18,15,2,9,12,19,0,114
19,20,18,15,2,9,12,21,19,135
19,20,18,15,3,11,12,5,0,103
19,20,18,15,4,4,12,5,0,97
19,20,18,15,4,5,0,0,0,81
19,20,18,15,25,0,0,0,0,97
19,20,18,15,25,5,4,0,0,106
19,20,18,15,25,5,18,0,0,120
19,20,18,15,25,5,18,19,0,139
19,20,18,15,25,7,15,15,4,138
19,20,18,15,25,9,14,7,0,127
19,20,18,15,9,12,0,0,0,93
19,20,18,15,25,19,0,0,0,116
19,20,18,15,11,5,0,0,0,88
19,20,18,15,11,5,4,0,0,92
19,20,18,15,11,5,18,0,0,106
19,20,18,15,11,5,18,19,0,125
19,20,18,15,11,5,19,0,0,107
19,20,18,15,11,25,0,0,0,108
19,20,18,15,11,9,14,7,0,113
19,20,18,15,11,9,14,7,19,132
19,20,18,15,12,4,0,0,0,88
19,20,18,15,12,12,0,0,0,96
19,20,18,15,12,12,4,0,0,100
19,20,18,15,12,12,5,4,0,105
19,20,18,15,12,12,5,18,0,119
19,20,18,15,12,12,5,18,19,138
19,20,18,15,12,12,9,14,7,126
19,20,18,15,12,12,19,0,0,115
19,20,18,15,13,1,0,0,0,86
19,20,18,15,13,1,12,0,0,98
19,20,18,15,13,1,20,1,0,107
19,20,18,15,13,1,20,1,12,119
19,20,18,15,13,1,20,9,3,118
19,20,18,15,13,2,0,0,0,87
19,20,18,15,13,2,9,20,5,121
19,20,18,15,13,2,15,9,4,115
19,20,18,15,13,5,0,0,0,90
19,20,18,15,13,5,4,0,0,94
19,20,18,15,13,9,14,7,0,115
19,20,18,15,13,13,9,14,7,128
19,20,18,15,13,21,8,18,0,132
19,20,18,15,14,4,0,0,0,90
19,20,18,15,14,5,0,0,0,91
19,20,18,15,14,7,2,15,24,134
19,20,18,15,14,7,5,18,0,116
19,20,18,15,14,7,5,19,20,137
19,20,18,15,14,7,25,12,0,130
19,20,18,15,14,7,25,12,5,135
19,20,18,15,14,7,25,12,19,149
19,20,18,15,14,7,9,19,8,129
19,20,18,15,14,7,12,25,0,130
19,20,18,15,14,7,13,1,14,121
19,20,18,15,14,7,13,5,14,125
19,20,18,15,14,20,9,1,0,116
19,20,18,15,14,20,9,1,14,130
19,20,18,15,14,20,9,1,19,135
19,20,18,15,14,20,9,3,0,118
19,20,18,15,14,20,9,15,14,144
19,20,18,15,14,20,9,21,13,149
19,20,18,15,15,11,0,0,0,98
19,20,18,15,15,11,5,14,0,117
19,20,18,15,15,20,0,0,0,107
19,20,18,15,16,0,0,0,0,88
19,20,18,15,16,8,1,9,3,109
19,20,18,15,16,8,5,0,0,101
19,20,18,15,16,8,5,19,0,120
19,20,18,15,16,8,9,3,0,108
19,20,18,15,16,8,15,9,4,124
19,20,18,15,16,16,5,4,0,113
19,20,18,15,16,16,5,18,0,127
19,20,18,15,16,16,25,0,0,129
19,20,18,15,16,16,9,14,7,134
19,20,18,15,16,19,0,0,0,107
19,20,18,15,19,19,5,18,0,133
19,20,18,15,20,8,0,0,0,100
19,20,18,15,21,4,9,14,7,127
19,20,18,15,21,4,19,0,0,116
19,20,18,15,21,14,7,5,0,119
19,20,18,15,21,20,0,0,0,113
19,20,18,15,22,5,0,0,0,99
19,20,18,15,23,0,0,0,0,95
19,20,18,15,23,4,0,0,0,99
19,20,18,15,23,5,4,0,0,104
19,20,18,15,23,9,14,7,0,125
19,20,18,15,23,14,0,0,0,109
19,20,18,15,23,19,0,0,0,114
19,20,18,21,2,0,0,0,0,80
19,20,18,21,2,2,12,25,0,119
19,20,18,21,3,9,15,14,0,119
19,20,18,21,3,11,0,0,0,92
19,20,18,21,3,11,5,14,0,111
19,20,18,21,3,20,0,0,0,101
19,20,18,21,3,20,5,4,0,110
19,20,18,21,3,20,9,15,14,139
19,20,18,21,3,20,9,22,5,137
19,20,18,21,3,20,21,18,5,145
19,20,18,21,4,5,0,0,0,87
19,20,18,21,4,5,12,0,0,99
19,20,18,21,4,5,12,19,0,118
19,20,18,21,5,0,0,0,0,83
19,20,18,21,7,7,12,5,0,109
19,20,18,21,7,7,12,5,4,113
19,20,18,21,7,7,12,5,18,127
19,20,18,21,7,7,12,5,19,128
19,20,18,21,9,19,0,0,0,106
19,20,18,21,9,19,19,12,5,142
19,20,18,21,13,0,0,0,0,91
19,20,18,21,13,1,5,0,0,97
19,20,18,21,13,1,19,0,0,111
19,20,18,21,13,1,20,9,3,124
19,20,18,21,13,9,20,9,19,148
19,20,18,21,13,13,5,4,0,113
19,20,18,21,13,13,5,18,0,127
19,20,18,21,13,13,5,18,19,146
19,20,18,21,13,13,9,14,7,134
19,20,18,21,13,15,19,5,0,130
19,20,18,21,13,15,21,19,0,146
19,20,18,21,13,16,5,20,0,132
19,20,18,21,13,16,5,20,19,151
19,20,18,21,13,19,0,0,0,110
19,20,18,21,14,7,0,0,0,99
19,20,18,21,14,20,0,0,0,112
19,20,18,21,14,20,5,4,0,121
19,20,18,21,14,20,9,14,7,142
19,20,18,21,14,20,19,0,0,131
19,20,18,21,19,5,0,0,0,102
19,20,18,21,20,0,0,0,0,98
19,20,18,21,20,8,0,0,0,106
19,20,18,21,20,8,9,1,14,130
19,20,18,21,20,8,9,9,14,138
19,20,18,21,20,8,9,14,0,129
19,20,18,21,20,19,0,0,0,117
19,20,18,21,20,20,5,4,0,127
19,20,18,21,20,20,5,18,0,141
19,20,18,21,20,20,5,18,19,160
19,20,18,21,20,20,9,14,7,148
19,20,18,21,22,0,0,0,0,100
19,20,18,21,22,9,20,5,0,134
19,20,21,2,0,0,0,0,0,62
19,20,21,2,2,0,0,0,0,64
19,20,21,2,2,5,4,0,0,73
19,20,21,2,2,5,18,0,0,87
19,20,21,2,2,25,0,0,0,89
19,20,21,2,2,9,5,18,0,96
19,20,21,2,2,9,5,19,20,117
19,20,21,2,2,9,12,25,0,110
19,20,21,2,2,9,14,7,0,94
19,20,21,2,2,12,5,0,0,81
19,20,21,2,2,12,5,4,0,85
19,20,21,2,2,12,5,19,0,100
19,20,21,2,2,12,25,0,0,101
19,20,21,2,2,12,9,5,18,108
19,20,21,2,2,12,9,14,7,106
19,20,21,2,2,15,25,0,0,104
19,20,21,2,2,15,18,14,0,111
19,20,21,2,3,8,5,14,0,92
19,20,21,2,5,0,0,0,0,67
19,20,21,2,5,18,0,0,0,85
19,20,21,2,9,5,19,20,0,115
19,20,21,2,15,25,0,0,0,102
19,20,21,2,15,18,14,12,25,146
19,20,21,2,19,0,0,0,0,81
19,20,21,2,23,15,18,20,0,138
19,20,21,3,3,15,0,0,0,81
19,20,21,3,3,15,5,4,0,90
19,20,21,3,3,15,5,18,0,104
19,20,21,3,3,15,5,18,19,123
19,20,21,3,3,15,5,19,0,105
19,20,21,3,3,15,25,5,18,129
19,20,21,3,3,15,9,14,7,111
19,20,21,3,3,15,19,0,0,100
19,20,21,3,11,0,0,0,0,74
19,20,21,3,11,5,14,0,0,93
19,20,21,3,11,9,14,7,0,104
19,20,21,3,11,12,9,14,7,116
19,20,21,4,0,0,0,0,0,64
19,20,21,4,2,15,15,11,0,107
19,20,21,4,2,15,15,11,19,126
19,20,21,4,4,5,4,0,0,77
19,20,21,4,4,5,18,0,0,91
19,20,21,4,4,5,18,25,0,116
19,20,21,4,4,25,0,0,0,93
19,20,21,4,4,9,5,0,0,82
19,20,21,4,4,9,5,19,0,101
19,20,21,4,4,9,14,7,0,98
19,20,21,4,4,9,14,7,19,117
19,20,21,4,4,12,5,0,0,85
19,20,21,4,5,0,0,0,0,69
19,20,21,4,5,14,20,0,0,103
19,20,21,4,5,14,20,18,25,146
19,20,21,4,5,14,20,19,0,122
19,20,21,4,5,18,9,20,5,121
19,20,21,4,6,9,19,8,0,106
19,20,21,4,8,15,18,19,5,129
19,20,21,4,25,0,0,0,0,89
19,20,21,4,9,1,0,0,0,74
19,20,21,4,9,1,2,12,5,93
19,20,21,4,9,5,4,0,0,82
19,20,21,4,9,5,4,12,25,119
19,20,21,4,9,5,18,0,0,96
19,20,21,4,9,5,18,19,0,115
19,20,21,4,9,5,19,0,0,97
19,20,21,4,25,9,14,7,0,119
19,20,21,4,9,15,0,0,0,88
19,20,21,4,9,15,19,0,0,107
19,20,21,4,9,15,21,19,0,128
19,20,21,4,25,19,0,0,0,108
19,20,21,4,19,0,0,0,0,83
19,20,21,4,23,15,18,11,0,131
19,20,21,4,23,15,18,11,19,150
19,20,21,5,0,0,0,0,0,65
19,20,21,6,6,0,0,0,0,72
19,20,21,6,6,1,7,5,0,85
19,20,21,6,6,1,20,1,0,94
19,20,21,6,6,5,4,0,0,81
19,20,21,6,6,5,18,0,0,95
19,20,21,6,6,5,18,19,0,114
19,20,21,6,6,25,0,0,0,97
19,20,21,6,6,9,5,18,0,104
19,20,21,6,6,9,5,19,20,125
19,20,21,6,6,9,12,25,0,118
19,20,21,6,6,9,14,7,0,102
19,20,21,6,6,9,14,7,19,121
19,20,21,6,6,12,5,19,19,127
19,20,21,6,6,19,0,0,0,91
19,20,21,7,0,0,0,0,0,67
19,20,21,7,7,25,0,0,0,99
19,20,21,9,22,5,18,0,0,114
19,20,21,9,22,5,18,19,0,133
19,20,21,12,12,0,0,0,0,84
19,20,21,12,12,5,18,0,0,107
19,20,21,12,12,19,0,0,0,103
19,20,21,12,13,0,0,0,0,85
19,20,21,12,20,25,0,0,0,117
19,20,21,12,20,9,6,25,0,132
19,20,21,13,0,0,0,0,0,73
19,20,21,13,2,12,5,0,0,92
19,20,21,13,2,12,5,4,0,96
19,20,21,13,2,12,5,18,0,110
19,20,21,13,2,12,5,18,19,129
19,20,21,13,2,12,5,19,0,111
19,20,21,13,2,12,25,0,0,112
19,20,21,13,2,12,9,14,7,117
19,20,21,13,5,18,0,0,0,96
19,20,21,13,13,5,4,0,0,95
19,20,21,13,13,5,12,0,0,103
19,20,21,13,13,5,18,0,0,109
19,20,21,13,13,25,0,0,0,111
19,20,21,13,13,9,14,7,0,116
19,20,21,13,15,18,0,0,0,106
19,20,21,13,15,21,18,0,0,127
19,20,21,13,16,0,0,0,0,89
19,20,21,13,16,1,7,5,0,102
19,20,21,13,16,1,7,5,19,121
19,20,21,13,16,5,4,0,0,98
19,20,21,13,16,5,18,0,0,112
19,20,21,13,16,5,18,19,0,131
19,20,21,13,16,25,0,0,0,114
19,20,21,13,16,9,5,18,0,121
19,20,21,13,16,9,5,19,20,142
19,20,21,13,16,9,12,25,0,135
19,20,21,13,16,9,14,7,0,119
19,20,21,13,16,9,19,8,0,125
19,20,21,13,16,12,5,19,19,144
19,20,21,13,16,12,9,11,5,126
19,20,21,13,16,12,9,14,7,131
19,20,21,13,16,14,15,19,5,142
19,20,21,13,16,19,0,0,0,108
19,20,21,13,16,23,9,19,5,145
19,20,21,13,19,0,0,0,0,92
19,20,21,14,0,0,0,0,0,74
19,20,21,14,7,0,0,0,0,81
19,20,21,14,11,0,0,0,0,85
19,20,21,14,11,1,18,4,0,108
19,20,21,14,14,5,4,0,0,97
19,20,21,14,14,5,18,0,0,111
19,20,21,14,14,5,18,19,0,130
19,20,21,14,14,9,14,7,0,118
19,20,21,14,16,15,12,12,0,129
19,20,21,14,19,0,0,0,0,93
19,20,21,14,19,1,9,12,0,115
19,20,21,14,19,1,9,12,19,134
19,20,21,14,19,12,5,0,0,110
19,20,21,14,20,0,0,0,0,94
19,20,21,14,20,5,4,0,0,103
19,20,21,14,20,5,4,12,25,140
19,20,21,14,20,5,18,0,0,117
19,20,21,14,20,25,0,0,0,119
19,20,21,14,20,9,14,7,0,124
19,20,21,14,20,9,19,20,0,142
19,20,21,14,20,13,1,14,0,122
19,20,21,14,20,13,5,14,0,126
19,20,21,14,20,14,5,19,19,151
19,20,21,14,20,19,0,0,0,113
19,20,21,16,1,0,0,0,0,77
19,20,21,16,1,19,0,0,0,96
19,20,21,16,5,0,0,0,0,81
19,20,21,16,5,4,0,0,0,85
19,20,21,16,5,6,25,0,0,112
19,20,21,16,5,6,9,5,4,105
19,20,21,16,5,6,9,5,18,119
19,20,21,16,5,6,9,5,19,120
19,20,21,16,5,14,4,0,0,99
19,20,21,16,5,14,4,12,25,136
19,20,21,16,5,14,20,0,0,115
19,20,21,16,5,15,21,19,0,136
19,20,21,16,5,19,0,0,0,100
19,20,21,16,5,24,0,0,0,105
19,20,21,16,8,5,0,0,0,89
19,20,21,16,9,4,0,0,0,89
19,20,21,16,9,4,5,18,0,112
19,20,21,16,9,4,5,19,20,133
19,20,21,16,9,4,9,19,8,125
19,20,21,16,9,4,9,20,25,143
19,20,21,16,9,4,12,25,0,126
19,20,21,16,9,4,19,0,0,108
19,20,21,16,9,14,7,0,0,106
19,20,21,16,15,18,0,0,0,109
19,20,21,16,15,18,15,19,5,148
19,20,21,16,15,18,15,21,19,164
19,20,21,16,15,18,19,0,0,128
19,20,21,16,15,19,5,0,0,115
19,20,21,16,16,0,0,0,0,92
19,20,21,16,18,1,20,5,0,120
19,20,21,16,18,1,20,5,4,124
19,20,21,16,18,21,13,0,0,128
19,20,21,16,21,12,15,19,5,148
19,20,21,18,2,12,5,0,0,97
19,20,21,18,4,25,0,0,0,107
19,20,21,18,4,9,5,4,0,100
19,20,21,18,4,9,5,18,0,114
19,20,21,18,4,9,5,19,0,115
19,20,21,18,4,9,5,19,20,135
19,20,21,18,4,9,12,25,0,128
19,20,21,18,7,5,15,14,0,119
19,20,21,18,7,5,15,14,19,138
19,20,21,18,9,14,0,0,0,101
19,20,21,18,9,14,5,0,0,106
19,20,21,18,11,0,0,0,0,89
19,20,21,18,14,9,14,5,0,120
19,20,21,18,14,15,9,4,0,120
19,20,21,18,15,3,8,0,0,104
19,20,21,18,19,8,21,13,0,139
19,20,21,18,20,1,14,0,0,113
19,20,21,18,20,5,0,0,0,103
19,20,21,18,20,25,0,0,0,123
19,20,21,18,20,9,14,0,0,121
19,20,21,18,20,9,15,14,0,136
19,20,21,18,20,9,20,5,0,132
19,20,21,18,20,19,0,0,0,117
19,20,21,19,19,0,0,0,0,98
19,20,21,20,0,0,0,0,0,80
19,20,21,20,20,5,18,0,0,123
19,20,21,20,20,5,18,5,4,132
19,20,21,20,20,5,18,5,18,146
19,20,21,20,20,5,18,19,0,142
19,21,2,0,0,0,0,0,0,42
19,21,2,1,0,0,0,0,0,43
19,21,2,1,2,2,15,20,0,82
19,21,2,1,2,2,15,20,19,101
19,21,2,1,3,9,4,0,0,59
19,21,2,1,3,9,4,12,25,96
19,21,2,1,3,18,9,4,0,77
19,21,2,1,3,20,0,0,0,66
19,21,2,1,3,20,9,15,14,104
19,21,2,1,3,21,20,5,0,92
19,21,2,1,4,1,18,0,0,66
19,21,2,1,4,1,18,19,0,85
19,21,2,1,4,21,12,20,0,100
19,21,2,1,4,21,12,20,19,119
19,21,2,1,5,18,1,20,5,92
19,21,2,1,5,18,9,1,12,88
19,21,2,1,7,5,0,0,0,55
19,21,2,1,7,5,14,3,25,97
19,21,2,1,7,5,14,20,0,89
19,21,2,1,7,5,14,20,19,108
19,21,2,1,8,0,0,0,0,51
19,21,2,1,8,4,1,18,0,74
19,21,2,1,8,4,1,18,25,99
19,21,2,1,8,4,1,18,19,93
19,21,2,1,8,19,0,0,0,70
19,21,2,1,8,19,8,9,16,103
19,21,2,1,9,4,0,0,0,56
19,21,2,1,12,1,18,0,0,74
19,21,2,1,12,1,18,25,0,99
19,21,2,1,12,1,20,5,0,81
19,21,2,1,12,1,20,5,4,85
19,21,2,1,12,2,9,4,0,70
19,21,2,1,12,16,9,14,5,99
19,21,2,1,12,20,5,18,14,112
19,21,2,1,13,1,18,5,0,80
19,21,2,1,14,1,12,0,0,70
19,21,2,1,14,4,5,1,14,81
19,21,2,1,14,7,12,5,4,85
19,21,2,1,16,9,3,1,12,84
19,21,2,1,17,21,1,0,0,82
19,21,2,1,17,21,1,12,0,94
19,21,2,1,17,21,5,1,14,101
19,21,2,1,18,3,8,0,0,72
19,21,2,1,18,3,20,9,3,96
19,21,2,1,18,5,1,0,0,67
19,21,2,1,18,5,1,12,0,79
19,21,2,1,18,5,1,19,0,86
19,21,2,1,18,9,4,0,0,74
19,21,2,1,18,13,1,12,5,92
19,21,2,1,18,13,15,18,0,107
19,21,2,1,18,15,21,19,5,121
19,21,2,1,19,0,0,0,0,62
19,21,2,1,19,8,9,0,0,79
19,21,2,1,19,20,18,1,12,113
19,21,2,1,20,15,13,0,0,91
19,21,2,1,20,15,13,9,3,103
19,21,2,1,20,15,13,19,0,110
19,21,2,1,21,4,0,0,0,68
19,21,2,1,21,18,1,12,0,95
19,21,2,1,24,9,1,12,0,89
19,21,2,1,24,9,12,5,0,93
19,21,2,2,1,9,12,9,5,80
19,21,2,2,1,14,4,0,0,63
19,21,2,2,1,14,11,0,0,70
19,21,2,2,1,19,1,12,0,77
19,21,2,2,1,19,5,0,0,69
19,21,2,2,1,19,5,19,0,88
19,21,2,2,1,19,9,14,0,87
19,21,2,2,1,19,19,0,0,83
19,21,2,2,1,19,19,1,0,84
19,21,2,2,1,19,19,5,19,107
19,21,2,2,5,1,4,12,5,71
19,21,2,2,5,1,21,0,0,71
19,21,2,2,5,4,0,0,0,53
19,21,2,2,9,1,19,0,0,73
19,21,2,2,9,6,9,4,0,72
19,21,2,2,9,14,7,0,0,74
19,21,2,2,9,14,7,19,0,93
19,21,2,2,12,15,3,11,0,85
19,21,2,2,15,18,5,1,12,95
19,21,2,2,18,1,14,3,8,88
19,21,2,2,18,5,5,4,0,76
19,21,2,2,18,5,5,4,19,95
19,21,2,2,18,15,11,5,18,111
19,21,2,2,18,15,13,9,4,103
19,21,2,2,21,18,5,1,21,110
19,21,2,3,1,5,3,1,12,67
19,21,2,3,1,14,4,9,4,77
19,21,2,3,1,14,20,15,18,113
19,21,2,3,1,19,5,0,0,70
19,21,2,3,1,19,8,0,0,73
19,21,2,3,1,19,9,14,7,95
19,21,2,3,1,19,9,14,15,103
19,21,2,3,1,19,20,0,0,85
19,21,2,3,1,19,20,5,0,90
19,21,2,3,1,21,4,1,12,84
19,21,2,3,1,21,19,5,0,91
19,21,2,3,1,21,19,5,19,110
19,21,2,3,1,22,1,20,5,94
19,21,2,3,1,22,9,20,25,122
19,21,2,3,5,12,12,0,0,74
19,21,2,3,5,12,12,1,18,93
19,21,2,3,5,12,12,19,0,93
19,21,2,3,5,14,20,5,18,107
19,21,2,3,5,14,20,18,5,107
19,21,2,3,8,0,0,0,0,53
19,21,2,3,8,1,19,5,18,96
19,21,2,3,8,5,12,1,0,71
19,21,2,3,8,5,12,1,5,76
19,21,2,3,8,9,5,6,0,73
19,21,2,3,8,9,5,6,19,92
19,21,2,3,25,1,14,9,4,98
19,21,2,3,25,3,12,5,0,90
19,21,2,3,25,3,12,5,19,109
19,21,2,3,9,19,9,15,14,111
19,21,2,3,9,20,25,0,0,99
19,21,2,3,9,20,9,5,19,107
19,21,2,3,12,1,9,13,0,80
19,21,2,3,12,1,14,0,0,72
19,21,2,3,12,1,14,19,0,91
19,21,2,3,12,1,19,19,0,96
19,21,2,3,12,1,21,19,5,103
19,21,2,3,12,1,22,9,1,90
19,21,2,3,12,1,22,9,9,98
19,21,2,3,12,5,9,0,0,71
19,21,2,3,12,5,18,11,0,91
19,21,2,3,12,5,18,11,19,110
19,21,2,3,12,9,13,1,24,104
19,21,2,3,12,9,17,21,5,109
19,21,2,3,12,15,14,5,0,91
19,21,2,3,12,15,22,5,18,117
19,21,2,3,15,1,20,0,0,81
19,21,2,3,15,4,5,0,0,69
19,21,2,3,15,4,5,19,0,88
19,21,2,3,15,13,13,9,20,115
19,21,2,3,15,14,9,3,0,86
19,21,2,3,15,14,19,21,12,126
19,21,2,3,15,14,22,5,24,125
19,21,2,3,15,15,12,0,0,87
19,21,2,3,15,15,12,5,4,96
19,21,2,3,15,15,12,19,0,106
19,21,2,3,15,18,20,5,24,127
19,21,2,3,15,19,20,1,0,100
19,21,2,3,15,19,20,1,5,105
19,21,2,3,15,19,20,1,12,112
19,21,2,3,15,22,5,18,0,105
19,21,2,3,18,5,5,11,0,84
19,21,2,3,18,5,19,20,0,107
19,21,2,3,18,9,16,20,0,108
19,21,2,3,18,21,19,20,0,123
19,21,2,3,21,2,9,3,0,80
19,21,2,3,21,2,15,9,4,96
19,21,2,3,21,14,5,21,19,125
19,21,2,3,21,18,1,20,5,110
19,21,2,3,21,20,5,19,0,110
19,21,2,3,21,20,9,19,0,114
19,21,2,4,1,20,1,18,25,111
19,21,2,4,1,20,5,0,0,72
19,21,2,4,1,20,5,4,0,76
19,21,2,4,1,20,9,14,7,97
19,21,2,4,5,1,3,15,14,84
19,21,2,4,5,1,12,5,18,87
19,21,2,4,5,1,14,0,0,66
19,21,2,4,5,1,14,19,0,85
19,21,2,4,5,2,0,0,0,53
19,21,2,4,5,2,19,0,0,72
19,21,2,4,5,14,20,5,4,94
19,21,2,4,5,16,15,20,0,102
19,21,2,4,5,16,15,20,19,121
19,21,2,4,5,16,21,20,25,133
19,21,2,4,5,18,13,1,12,95
19,21,2,4,5,18,13,9,3,94
19,21,2,4,5,22,9,12,0,94
19,21,2,4,9,1,12,0,0,68
19,21,2,4,9,5,0,0,0,60
19,21,2,4,9,20,0,0,0,75
19,21,2,4,9,22,9,4,5,95
19,21,2,4,9,22,9,14,5,105
19,21,2,4,15,3,20,15,18,117
19,21,2,4,15,12,5,14,20,112
19,21,2,4,15,12,15,21,19,128
19,21,2,4,15,18,19,1,12,111
19,21,2,4,15,21,2,12,5,101
19,21,2,4,18,1,9,14,0,88
19,21,2,4,18,9,12,12,0,97
19,21,2,4,18,21,9,4,0,98
19,21,2,4,21,1,2,12,5,87
19,21,2,4,21,1,2,12,25,107
19,21,2,4,21,1,12,0,0,80
19,21,2,4,21,1,12,19,0,99
19,21,2,4,21,3,5,0,0,75
19,21,2,4,21,3,5,4,0,79
19,21,2,4,21,3,5,19,0,94
19,21,2,4,21,3,9,14,7,100
19,21,2,4,21,3,20,0,0,90
19,21,2,4,21,3,20,5,4,99
19,21,2,4,21,3,20,19,0,109
19,21,2,4,21,5,0,0,0,72
19,21,2,4,21,5,4,0,0,76
19,21,2,4,21,5,4,12,25,113
19,21,2,4,21,5,18,0,0,90
19,21,2,4,21,5,18,19,0,109
19,21,2,4,21,5,19,0,0,91
19,21,2,4,21,9,14,7,0,97
19,21,2,4,21,16,12,5,0,100
19,21,2,4,21,18,1,12,0,98
19,21,2,4,21,18,5,0,0,90
19,21,2,4,23,1,18,6,0,94
19,21,2,5,3,8,15,0,0,73
19,21,2,5,3,8,15,5,19,97
19,21,2,5,4,9,20,0,0,80
19,21,2,5,4,9,20,5,4,89
19,21,2,5,4,9,20,15,18,113
19,21,2,5,4,9,20,19,0,99
19,21,2,5,14,20,9,18,5,113
19,21,2,5,14,20,18,25,0,124
19,21,2,5,16,15,3,8,0,89
19,21,2,5,16,15,3,8,19,108
19,21,2,5,17,21,1,12,0,98
19,21,2,5,18,0,0,0,0,65
19,21,2,5,18,1,14,5,0,85
19,21,2,5,18,1,20,5,0,91
19,21,2,5,18,5,3,20,0,93
19,21,2,5,18,5,15,21,19,125
19,21,2,5,18,9,3,0,0,77
19,21,2,5,18,9,14,0,0,88
19,21,2,5,18,9,14,5,0,93
19,21,2,5,18,9,14,19,0,107
19,21,2,5,18,9,19,5,0,98
19,21,2,5,18,9,19,5,4,102
19,21,2,5,18,9,19,5,19,117
19,21,2,5,18,9,20,5,0,99
19,21,2,5,18,9,26,5,0,105
19,21,2,5,18,9,26,5,4,109
19,21,2,5,18,9,26,5,19,124
19,21,2,5,18,15,14,5,0,99
19,21,2,5,18,15,19,5,0,104
19,21,2,5,18,15,21,19,0,120
19,21,2,5,18,19,0,0,0,84
19,21,2,5,20,0,0,0,0,67
19,21,2,5,20,8,0,0,0,75
19,21,2,5,24,3,9,20,5,108
19,21,2,6,1,3,5,0,0,57
19,21,2,6,1,3,9,5,19,85
19,21,2,6,1,3,20,15,18,105
19,21,2,6,1,13,9,12,25,108
19,21,2,6,5,21,0,0,0,74
19,21,2,6,9,5,6,0,0,68
19,21,2,6,9,5,12,4,0,78
19,21,2,6,9,5,12,4,19,97
19,21,2,6,9,7,21,18,5,108
19,21,2,6,9,12,5,0,0,74
19,21,2,6,9,12,5,19,0,93
19,21,2,6,9,24,0,0,0,81
19,21,2,6,9,24,5,19,0,105
19,21,2,6,12,1,22,15,18,116
19,21,2,6,12,15,15,18,0,108
19,21,2,6,12,15,15,18,19,127
19,21,2,6,12,15,18,1,0,94
19,21,2,6,12,21,9,4,0,94
19,21,2,6,12,21,19,8,0,108
19,21,2,6,15,3,1,12,0,79
19,21,2,6,15,12,9,1,18,103
19,21,2,6,15,18,13,0,0,94
19,21,2,6,15,19,19,9,12,122
19,21,2,6,18,1,13,5,0,85
19,21,2,6,21,13,15,19,5,121
19,21,2,6,21,19,3,0,0,91
19,21,2,6,21,19,11,0,0,99
19,21,2,7,0,0,0,0,0,49
19,21,2,7,1,12,5,1,0,68
19,21,2,7,1,14,7,5,18,94
19,21,2,7,1,14,15,9,4,92
19,21,2,7,1,16,5,0,0,71
19,21,2,7,1,16,5,4,0,75
19,21,2,7,1,16,9,14,7,96
19,21,2,7,5,14,5,18,1,92
19,21,2,7,5,14,18,5,0,91
19,21,2,7,5,14,19,0,0,87
19,21,2,7,5,14,20,5,19,112
19,21,2,7,5,14,21,1,12,102
19,21,2,7,5,14,21,19,0,108
19,21,2,7,5,20,0,0,0,74
19,21,2,7,9,1,14,20,0,93
19,21,2,7,25,18,5,0,0,97
19,21,2,7,25,18,9,0,0,101
19,21,2,7,25,18,21,19,0,132
19,21,2,7,9,20,0,0,0,78
19,21,2,7,15,1,12,0,0,77
19,21,2,7,15,1,12,19,0,96
19,21,2,7,15,4,0,0,0,68
19,21,2,7,18,1,4,5,0,77
19,21,2,7,18,1,4,5,19,96
19,21,2,7,18,1,16,8,0,92
19,21,2,7,18,1,16,8,19,111
19,21,2,7,18,9,14,0,0,90
19,21,2,7,18,15,21,16,0,119
19,21,2,7,18,15,21,16,19,138
19,21,2,7,21,12,1,18,0,101
19,21,2,7,21,13,0,0,0,83
19,21,2,7,21,13,19,0,0,102
19,21,2,7,23,5,12,25,0,114
19,21,2,8,1,12,9,4,0,76
19,21,2,8,1,12,9,4,5,81
19,21,2,8,1,12,12,0,0,75
19,21,2,8,5,1,4,0,0,60
19,21,2,8,5,1,4,19,0,79
19,21,2,8,5,1,12,20,8,96
19,21,2,8,5,4,18,1,12,90
19,21,2,8,5,18,4,0,0,77
19,21,2,8,5,18,15,0,0,88
19,21,2,8,5,18,15,5,19,112
19,21,2,8,25,1,12,9,14,111
19,21,2,8,25,15,9,4,0,103
19,21,2,8,15,15,11,5,4,100
19,21,2,8,15,21,19,5,0,110
19,21,2,8,21,13,1,14,0,99
19,21,2,8,21,13,1,14,19,118
19,21,2,8,21,13,9,4,0,97
19,21,2,9,3,12,5,0,0,71
19,21,2,9,3,21,12,1,18,106
19,21,2,9,3,21,12,21,13,121
19,21,2,9,4,1,18,0,0,74
19,21,2,9,4,5,1,0,0,61
19,21,2,9,4,5,1,12,0,73
19,21,2,9,4,5,1,19,0,80
19,21,2,9,12,9,1,0,0,73
19,21,2,9,12,9,12,9,1,94
19,21,2,9,12,9,21,13,0,106
19,21,2,9,13,1,7,15,0,87
19,21,2,9,14,3,9,19,5,101
19,21,2,9,14,4,5,24,0,98
19,21,2,9,14,4,21,3,5,98
19,21,2,9,14,6,5,18,0,94
19,21,2,9,14,6,5,21,4,101
19,21,2,9,14,6,15,18,13,117
19,21,2,9,14,19,5,18,20,127
19,21,2,9,14,20,5,14,20,124
19,21,2,9,15,4,9,4,5,88
19,21,2,9,20,1,14,5,0,91
19,21,2,9,20,1,14,25,0,111
19,21,2,9,20,5,13,0,0,89
19,21,2,9,20,5,13,19,0,108
19,21,2,9,20,15,0,0,0,86
19,21,2,9,20,15,21,19,0,126
19,21,2,10,0,0,0,0,0,52
19,21,2,10,1,3,5,14,20,95
19,21,2,10,1,3,11,0,0,67
19,21,2,10,5,3,20,0,0,80
19,21,2,10,5,3,20,5,4,89
19,21,2,10,5,3,20,19,0,99
19,21,2,10,5,5,0,0,0,62
19,21,2,10,15,9,14,0,0,90
19,21,2,10,15,9,14,5,4,99
19,21,2,10,15,9,14,19,0,109
19,21,2,10,15,9,14,20,0,110
19,21,2,10,21,4,7,5,0,89
19,21,2,10,21,7,1,12,0,93
19,21,2,10,21,7,1,20,5,106
19,21,2,10,21,14,3,20,0,110
19,21,2,10,21,14,9,15,18,129
19,21,2,11,9,14,7,0,0,83
19,21,2,12,1,2,9,1,12,79
19,21,2,12,1,25,5,18,0,103
19,21,2,12,1,25,5,18,19,122
19,21,2,12,1,14,1,20,5,95
19,21,2,12,1,16,19,1,18,109
19,21,2,12,1,20,5,0,0,80
19,21,2,12,1,20,5,4,0,84
19,21,2,12,1,20,5,19,0,99
19,21,2,12,1,20,9,14,7,105
19,21,2,12,1,20,9,15,14,113
19,21,2,12,1,20,9,22,5,111
19,21,2,12,1,22,9,21,19,126
19,21,2,12,5,1,4,5,18,87
19,21,2,12,5,1,19,5,0,84
19,21,2,12,5,1,19,5,4,88
19,21,2,12,5,1,19,5,19,103
19,21,2,12,5,19,19,5,5,107
19,21,2,12,5,19,19,15,18,130
19,21,2,12,5,20,0,0,0,79
19,21,2,12,5,20,8,1,12,100
19,21,2,12,5,20,19,0,0,98
19,21,2,12,5,20,20,5,18,122
19,21,2,12,5,22,1,20,5,107
19,21,2,12,5,22,5,12,0,98
19,21,2,12,5,22,5,12,19,117
19,21,2,12,9,4,0,0,0,67
19,21,2,12,9,13,1,14,20,111
19,21,2,12,9,13,1,20,5,102
19,21,2,12,9,13,5,4,0,85
19,21,2,12,9,13,5,12,25,118
19,21,2,12,9,13,5,18,0,99
19,21,2,12,9,13,5,18,19,118
19,21,2,12,9,13,5,19,0,100
19,21,2,12,9,13,5,19,20,120
19,21,2,12,9,13,9,14,7,106
19,21,2,12,9,13,9,19,8,112
19,21,2,12,9,13,9,26,5,116
19,21,2,12,9,14,5,0,0,82
19,21,2,12,9,14,5,1,18,101
19,21,2,12,9,14,5,19,0,101
19,21,2,12,9,14,7,21,1,106
19,21,2,12,9,19,20,0,0,102
19,21,2,12,9,19,20,19,0,121
19,21,2,12,15,14,7,0,0,90
19,21,2,12,15,18,1,12,0,100
19,21,2,12,15,18,5,1,12,105
19,21,2,12,15,20,0,0,0,89
19,21,2,12,15,20,19,0,0,108
19,21,2,12,21,13,2,1,18,109
19,21,2,12,21,14,1,18,0,108
19,21,2,12,21,14,1,18,25,133
19,21,2,12,21,14,1,20,5,115
19,21,2,12,21,24,1,20,5,125
19,21,2,13,1,9,4,0,0,69
19,21,2,13,1,9,14,0,0,79
19,21,2,13,1,14,0,0,0,70
19,21,2,13,1,14,9,1,0,80
19,21,2,13,1,14,9,3,0,82
19,21,2,13,1,14,15,18,0,103
19,21,2,13,1,18,9,14,5,102
19,21,2,13,1,19,20,5,18,118
19,21,2,13,1,20,18,9,24,127
19,21,2,13,5,4,9,1,12,86
19,21,2,13,5,4,9,1,14,88
19,21,2,13,5,13,2,5,18,98
19,21,2,13,5,14,0,0,0,74
19,21,2,13,5,14,20,1,0,95
19,21,2,13,5,14,20,1,12,107
19,21,2,13,5,14,20,21,13,128
19,21,2,13,5,18,7,5,0,90
19,21,2,13,5,18,7,5,4,94
19,21,2,13,5,18,7,5,19,109
19,21,2,13,5,18,19,5,0,102
19,21,2,13,5,18,19,5,4,106
19,21,2,13,5,18,19,5,19,121
19,21,2,13,5,20,5,18,0,103
19,21,2,13,9,3,18,15,14,114
19,21,2,13,9,14,4,0,0,82
19,21,2,13,9,19,19,0,0,102
19,21,2,13,9,19,19,9,20,131
19,21,2,13,9,19,19,12,25,139
19,21,2,13,9,20,0,0,0,84
19,21,2,13,9,20,19,0,0,103
19,21,2,13,9,20,20,1,12,117
19,21,2,13,9,20,20,5,4,113
19,21,2,13,9,20,20,5,18,127
19,21,2,13,15,4,5,0,0,79
19,21,2,13,15,4,5,19,0,98
19,21,2,13,15,4,21,12,5,112
19,21,2,13,15,20,9,22,5,126
19,21,2,13,21,3,15,19,1,114
19,21,2,13,21,3,15,21,19,134
19,21,2,14,1,19,1,12,0,89
19,21,2,14,5,3,20,0,0,84
19,21,2,14,5,19,19,0,0,99
19,21,2,14,5,20,0,0,0,81
19,21,2,14,5,20,19,0,0,100
19,21,2,14,5,21,18,1,12,113
19,21,2,14,5,24,0,0,0,85
19,21,2,14,9,3,8,5,0,81
19,21,2,14,9,22,5,1,12,105
19,21,2,14,9,22,5,1,14,107
19,21,2,14,15,4,1,12,0,88
19,21,2,14,15,4,5,0,0,80
19,21,2,14,15,4,5,19,0,99
19,21,2,14,15,18,13,1,12,115
19,21,2,14,15,20,5,0,0,96
19,21,2,14,21,3,12,5,9,106
19,21,2,14,21,4,5,0,0,86
19,21,2,14,21,13,2,5,18,115
19,21,2,15,2,20,21,19,5,124
19,21,2,15,3,5,1,14,0,80
19,21,2,15,3,20,1,22,5,108
19,21,2,15,3,20,9,12,5,106
19,21,2,15,3,21,12,1,18,112
19,21,2,15,6,6,9,3,5,86
19,21,2,15,12,9,22,5,0,105
19,21,2,15,16,1,17,21,5,117
19,21,2,15,16,20,9,3,0,105
19,21,2,15,16,20,9,13,1,116
19,21,2,15,18,1,12,0,0,88
19,21,2,15,18,4,1,9,14,103
19,21,2,15,18,4,5,18,0,102
19,21,2,15,18,4,5,18,19,121
19,21,2,15,18,14,0,0,0,89
19,21,2,15,18,14,5,4,0,98
19,21,2,15,18,14,5,18,0,112
19,21,2,15,18,14,5,18,19,131
19,21,2,15,18,14,9,14,7,119
19,21,2,15,18,14,19,0,0,108
19,21,2,15,22,1,12,0,0,92
19,21,2,15,22,1,20,5,0,105
19,21,2,15,22,1,20,5,4,109
19,21,2,15,22,15,9,4,0,107
19,21,2,15,24,9,4,0,0,94
19,21,2,15,24,9,4,5,0,99
19,21,2,15,24,9,4,5,19,118
19,21,2,16,1,7,15,4,1,86
19,21,2,16,1,14,5,12,0,90
19,21,2,16,1,18,0,0,0,77
19,21,2,16,1,18,20,0,0,97
19,21,2,16,1,18,20,25,0,122
19,21,2,16,1,18,20,19,0,116
19,21,2,16,1,19,19,0,0,97
19,21,2,16,1,19,20,15,18,131
19,21,2,16,1,20,18,15,14,126
19,21,2,16,5,14,1,0,0,78
19,21,2,16,5,14,1,5,4,87
19,21,2,16,5,14,1,19,0,97
19,21,2,16,5,18,9,15,4,109
19,21,2,16,8,1,19,5,0,91
19,21,2,16,8,1,19,5,19,110
19,21,2,16,8,25,12,1,0,104
19,21,2,16,8,25,12,1,18,122
19,21,2,16,8,25,12,12,1,116
19,21,2,16,8,25,12,21,13,137
19,21,2,16,9,1,12,0,0,80
19,21,2,16,9,12,15,19,5,118
19,21,2,16,9,13,16,0,0,96
19,21,2,16,9,19,20,15,14,135
19,21,2,16,12,1,14,20,0,105
19,21,2,16,12,1,20,0,0,91
19,21,2,16,12,1,20,5,0,96
19,21,2,16,12,5,24,1,12,112
19,21,2,16,12,9,14,20,8,121
19,21,2,16,12,15,20,0,0,105
19,21,2,16,12,15,20,19,0,124
19,21,2,16,12,15,23,0,0,108
19,21,2,16,15,5,14,1,0,93
19,21,2,16,15,5,14,1,12,105
19,21,2,16,15,5,14,1,19,112
19,21,2,16,15,12,1,18,0,104
19,21,2,16,15,15,12,0,0,100
19,21,2,16,15,15,12,19,0,119
19,21,2,16,15,18,20,0,0,111
19,21,2,16,15,19,20,0,0,112
19,21,2,16,15,20,5,14,20,132
19,21,2,16,18,5,19,19,0,119
19,21,2,16,18,9,15,18,0,118
19,21,2,16,18,15,15,6,0,112
19,21,2,16,18,15,15,6,19,131
19,21,2,16,21,2,9,3,0,93
19,21,2,16,21,14,3,8,0,104
19,21,2,16,21,18,12,9,14,132
19,21,2,17,21,5,21,5,19,130
19,21,2,18,1,0,0,0,0,61
19,21,2,18,1,3,5,0,0,69
19,21,2,18,1,3,5,19,0,88
19,21,2,18,1,4,9,1,12,87
19,21,2,18,1,4,9,21,19,114
19,21,2,18,1,9,12,0,0,82
19,21,2,18,1,13,5,1,12,92
19,21,2,18,1,13,15,19,5,113
19,21,2,18,1,13,15,21,19,129
19,21,2,18,1,14,7,5,0,87
19,21,2,18,1,14,7,5,19,106
19,21,2,18,5,1,4,5,18,93
19,21,2,18,5,1,19,15,14,114
19,21,2,18,5,3,20,1,12,101
19,21,2,18,5,3,20,15,18,121
19,21,2,18,5,7,5,14,20,111
19,21,2,18,5,7,9,15,14,110
19,21,2,18,5,7,21,12,9,114
19,21,2,18,5,14,20,0,0,99
19,21,2,18,5,14,20,19,0,118
19,21,2,18,5,16,1,14,4,100
19,21,2,18,5,16,5,14,20,120
19,21,2,18,5,16,15,18,20,134
19,21,2,18,5,19,9,14,0,107
19,21,2,18,9,3,20,1,12,105
19,21,2,18,9,4,5,14,20,112
19,21,2,18,9,7,9,4,0,89
19,21,2,18,9,14,7,0,0,90
19,21,2,18,9,14,7,19,0,109
19,21,2,18,9,19,9,15,14,126
19,21,2,18,9,19,9,22,5,124
19,21,2,18,9,19,15,18,25,146
19,21,2,18,15,7,1,20,5,108
19,21,2,18,15,7,5,5,0,92
19,21,2,18,15,7,15,18,0,115
19,21,2,18,15,15,20,0,0,110
19,21,2,18,15,20,21,14,4,134
19,21,2,18,15,21,14,4,0,114
19,21,2,18,21,12,5,0,0,98
19,21,2,18,21,12,5,18,0,116
19,21,2,18,21,12,5,19,0,117
19,21,2,19,0,0,0,0,0,61
19,21,2,19,1,3,18,1,12,96
19,21,2,19,1,12,5,0,0,79
19,21,2,19,1,12,5,19,0,98
19,21,2,19,1,12,9,14,5,102
19,21,2,19,1,12,20,0,0,94
19,21,2,19,1,13,16,12,5,108
19,21,2,19,3,1,12,5,0,82
19,21,2,19,3,8,5,13,1,91
19,21,2,19,3,8,5,13,5,95
19,21,2,19,3,8,15,15,12,114
19,21,2,19,3,18,9,2,5,98
19,21,2,19,3,18,9,16,20,127
19,21,2,19,3,18,9,22,5,118
19,21,2,19,5,1,0,0,0,67
19,21,2,19,5,3,9,22,5,105
19,21,2,19,5,3,20,0,0,89
19,21,2,19,5,3,20,19,0,108
19,21,2,19,5,3,21,20,5,115
19,21,2,19,5,12,12,1,0,91
19,21,2,19,5,12,12,9,1,100
19,21,2,19,5,14,19,5,0,104
19,21,2,19,5,16,20,0,0,102
19,21,2,19,5,18,5,0,0,89
19,21,2,19,5,18,5,19,0,108
19,21,2,19,5,18,9,5,19,117
19,21,2,19,5,18,15,19,1,119
19,21,2,19,5,18,15,21,19,139
19,21,2,19,5,18,22,5,0,111
19,21,2,19,5,18,22,5,4,115
19,21,2,19,5,18,22,5,19,130
19,21,2,19,5,19,17,21,9,132
19,21,2,19,5,20,0,0,0,86
19,21,2,19,5,20,19,0,0,105
19,21,2,19,5,23,5,18,0,112
19,21,2,19,8,1,6,20,0,96
19,21,2,19,8,1,6,20,19,115
19,21,2,19,8,5,12,12,0,98
19,21,2,19,8,9,18,5,0,101
19,21,2,19,8,18,21,2,0,110
19,21,2,19,8,18,21,2,19,129
19,21,2,19,9,3,9,22,5,109
19,21,2,19,9,4,5,0,0,79
19,21,2,19,9,4,5,4,0,83
19,21,2,19,9,4,5,14,20,113
19,21,2,19,9,4,5,18,0,97
19,21,2,19,9,4,5,18,19,116
19,21,2,19,9,4,5,19,0,98
19,21,2,19,9,4,25,0,0,99
19,21,2,19,9,4,9,5,19,107
19,21,2,19,9,4,9,14,7,104
19,21,2,19,9,4,9,19,5,107
19,21,2,19,9,4,9,19,20,122
19,21,2,19,9,4,9,21,13,117
19,21,2,19,9,4,9,26,5,114
19,21,2,19,9,7,14,0,0,91
19,21,2,19,9,12,12,0,0,94
19,21,2,19,9,13,9,1,14,107
19,21,2,19,9,13,16,12,5,116
19,21,2,19,25,14,15,4,0,119
19,21,2,19,9,19,20,0,0,109
19,21,2,19,9,19,20,5,4,118
19,21,2,19,25,19,20,5,13,143
19,21,2,19,9,19,20,5,18,132
19,21,2,19,9,19,20,19,0,128
19,21,2,19,9,20,5,0,0,95
19,21,2,19,9,20,5,19,0,114
19,21,2,19,9,26,1,18,0,115
19,21,2,19,12,15,20,0,0,108
19,21,2,19,12,15,20,19,0,127
19,21,2,19,13,9,12,5,0,100
19,21,2,19,14,5,5,18,0,103
19,21,2,19,15,3,9,1,12,101
19,21,2,19,15,9,12,0,0,97
19,21,2,19,15,9,12,5,4,106
19,21,2,19,15,9,12,5,18,120
19,21,2,19,15,9,12,19,0,116
19,21,2,19,15,12,1,18,0,107
19,21,2,19,15,12,9,4,0,101
19,21,2,19,15,14,9,3,0,102
19,21,2,19,15,14,9,3,19,121
19,21,2,19,15,18,20,0,0,114
19,21,2,19,15,18,20,5,18,137
19,21,2,19,16,1,3,5,0,86
19,21,2,19,16,1,3,5,19,105
19,21,2,19,16,8,5,18,5,113
19,21,2,19,16,9,18,1,12,117
19,21,2,19,20,0,0,0,0,81
19,21,2,19,20,1,7,5,0,94
19,21,2,19,20,1,7,5,19,113
19,21,2,19,20,1,14,3,5,104
19,21,2,19,20,1,14,3,8,107
19,21,2,19,20,1,14,20,0,116
19,21,2,19,20,1,20,5,0,107
19,21,2,19,20,25,12,1,18,137
19,21,2,19,20,9,12,5,0,107
19,21,2,19,20,25,12,5,0,123
19,21,2,19,20,15,3,11,0,110
19,21,2,19,20,15,18,5,0,119
19,21,2,19,20,15,18,25,0,139
19,21,2,19,20,18,1,3,20,123
19,21,2,19,20,18,1,20,0,120
19,21,2,19,20,18,1,20,1,121
19,21,2,19,20,18,1,20,5,125
19,21,2,19,20,18,1,20,9,129
19,21,2,19,20,18,5,1,13,118
19,21,2,19,20,18,9,14,7,129
19,21,2,19,20,18,21,3,20,143
19,21,2,19,21,12,3,9,0,106
19,21,2,19,21,12,3,21,19,137
19,21,2,19,21,12,6,9,4,113
19,21,2,19,21,12,20,0,0,114
19,21,2,19,21,12,20,21,19,154
19,21,2,19,21,13,5,0,0,100
19,21,2,19,21,13,5,4,0,104
19,21,2,19,21,13,5,19,0,119
19,21,2,19,21,13,9,14,7,125
19,21,2,19,21,18,5,20,25,150
19,21,2,20,1,3,11,0,0,77
19,21,2,20,1,18,7,5,20,113
19,21,2,20,1,18,19,1,12,113
19,21,2,20,1,19,11,0,0,93
19,21,2,20,1,19,11,19,0,112
19,21,2,20,1,24,1,0,0,88
19,21,2,20,1,24,5,18,0,110
19,21,2,20,1,24,15,14,0,116
19,21,2,20,5,3,20,1,12,103
19,21,2,20,5,5,14,0,0,86
19,21,2,20,5,5,14,5,18,109
19,21,2,20,5,5,14,19,0,105
19,21,2,20,5,14,1,14,20,116
19,21,2,20,5,14,4,0,0,85
19,21,2,20,5,14,4,5,4,94
19,21,2,20,5,14,4,19,0,104
19,21,2,20,5,14,19,5,0,105
19,21,2,20,5,14,21,18,5,125
19,21,2,20,5,16,9,4,0,96
19,21,2,20,5,18,5,20,5,115
19,21,2,20,5,19,20,0,0,106
19,21,2,20,5,19,20,19,0,125
19,21,2,20,5,24,20,0,0,111
19,21,2,20,5,24,20,19,0,130
19,21,2,20,8,5,13,5,0,93
19,21,2,20,8,18,9,12,12,121
19,21,2,20,9,12,5,0,0,88
19,21,2,20,9,12,5,12,25,125
19,21,2,20,9,12,5,18,0,106
19,21,2,20,9,12,5,19,20,127
19,21,2,20,9,12,9,14,0,106
19,21,2,20,9,12,9,19,0,111
19,21,2,20,9,12,9,19,5,116
19,21,2,20,9,12,9,19,13,124
19,21,2,20,9,12,9,19,20,131
19,21,2,20,9,12,9,20,25,137
19,21,2,20,9,12,9,26,5,123
19,21,2,20,9,12,12,0,0,95
19,21,2,20,9,12,12,25,0,120
19,21,2,20,9,12,20,25,0,128
19,21,2,20,25,16,5,0,0,108
19,21,2,20,25,16,5,19,0,127
19,21,2,20,9,20,12,5,0,108
19,21,2,20,9,20,12,5,4,112
19,21,2,20,9,20,12,5,19,127
19,21,2,20,12,5,0,0,0,79
19,21,2,20,12,5,12,25,0,116
19,21,2,20,12,5,18,0,0,97
19,21,2,20,12,5,19,20,0,118
19,21,2,20,12,5,20,25,0,124
19,21,2,20,12,25,0,0,0,99
19,21,2,20,12,9,19,20,0,122
19,21,2,20,15,14,5,0,0,96
19,21,2,20,15,14,5,19,0,115
19,21,2,20,15,14,9,3,0,103
19,21,2,20,15,14,9,3,19,122
19,21,2,20,15,16,9,1,0,103
19,21,2,20,15,16,9,3,0,105
19,21,2,20,15,16,9,3,19,124
19,21,2,20,15,18,18,9,4,126
19,21,2,20,15,20,1,12,0,110
19,21,2,20,15,20,1,12,19,129
19,21,2,20,15,20,5,13,0,115
19,21,2,20,15,23,5,18,0,123
19,21,2,20,18,1,3,20,0,104
19,21,2,20,18,1,3,20,19,123
19,21,2,20,18,1,25,0,0,106
19,21,2,20,18,5,1,4,0,90
19,21,2,20,18,5,5,0,0,90
19,21,2,20,18,5,5,19,0,109
19,21,2,20,18,5,14,3,8,110
19,21,2,20,18,5,14,4,0,103
19,21,2,20,18,9,2,1,12,104
19,21,2,20,18,9,2,5,0,96
19,21,2,20,18,9,2,5,19,115
19,21,2,20,18,9,6,9,4,108
19,21,2,20,18,9,19,20,0,128
19,21,2,20,18,15,16,9,3,123
19,21,2,20,18,21,4,5,0,110
19,21,2,20,18,21,14,11,0,126
19,21,2,20,21,14,9,3,0,109
19,21,2,20,21,14,9,3,19,128
19,21,2,20,21,14,14,5,12,128
19,21,2,20,21,20,15,18,0,136
19,21,2,20,23,9,14,5,4,117
19,21,2,21,3,21,12,1,0,100
19,21,2,21,12,1,20,5,0,101
19,21,2,21,12,1,20,5,4,105
19,21,2,21,13,2,18,1,12,109
19,21,2,21,14,7,21,1,12,118
19,21,2,21,14,9,20,0,0,106
19,21,2,21,14,9,20,19,0,125
19,21,2,21,18,2,0,0,0,83
19,21,2,21,18,2,1,14,0,98
19,21,2,21,18,2,1,14,19,117
19,21,2,21,18,2,5,4,0,92
19,21,2,21,18,2,9,1,0,93
19,21,2,21,18,2,9,1,14,107
19,21,2,21,18,2,9,1,19,112
19,21,2,21,18,2,19,0,0,102
19,21,2,21,18,19,9,14,5,128
19,21,2,22,1,19,19,1,12,116
19,21,2,22,5,9,14,0,0,92
19,21,2,22,5,14,4,5,5,97
19,21,2,22,5,14,5,0,0,88
19,21,2,22,5,14,5,4,0,92
19,21,2,22,5,14,5,19,0,107
19,21,2,22,5,14,9,14,7,113
19,21,2,22,5,14,9,26,5,123
19,21,2,22,5,18,19,1,12,119
19,21,2,22,5,18,19,5,0,111
19,21,2,22,5,18,19,5,4,115
19,21,2,22,5,18,20,0,0,107
19,21,2,22,5,18,20,5,4,116
19,21,2,22,5,18,20,5,18,130
19,21,2,22,5,18,20,19,0,126
19,21,2,22,9,3,1,18,0,95
19,21,2,22,9,3,1,18,19,114
19,21,2,22,9,9,0,0,0,82
19,21,2,22,9,18,1,12,0,104
19,21,2,22,9,18,1,20,5,117
19,21,2,22,9,18,9,12,5,117
19,21,2,22,15,3,1,12,0,95
19,21,2,22,15,12,1,0,0,92
19,21,2,23,1,25,0,0,0,91
19,21,2,23,1,25,5,4,0,100
19,21,2,23,1,25,19,0,0,110
19,21,2,23,1,18,0,0,0,84
19,21,2,23,1,18,4,5,14,107
19,21,2,23,1,20,5,18,0,109
19,21,2,23,5,9,7,8,20,114
19,21,2,23,9,14,11,0,0,99
19,21,2,23,15,18,11,5,18,132
19,21,2,26,5,18,15,0,0,106
19,21,2,26,15,14,1,12,0,110
19,21,2,26,15,14,1,18,25,141
19,21,2,26,15,14,5,0,0,102
19,21,2,26,15,14,5,19,0,121
19,21,3,3,1,4,5,0,0,56
19,21,3,3,1,8,0,0,0,55
19,21,3,3,1,8,19,0,0,74
19,21,3,3,5,4,5,14,20,94
19,21,3,3,5,5,4,0,0,60
19,21,3,3,5,5,4,5,4,69
19,21,3,3,5,5,4,5,18,83
19,21,3,3,5,5,4,19,0,79
19,21,3,3,5,14,20,0,0,85
19,21,3,3,5,14,20,15,18,118
19,21,3,3,5,19,0,0,0,70
19,21,3,3,5,19,6,21,12,109
19,21,3,3,5,19,9,22,5,106
19,21,3,3,5,19,19,0,0,89
19,21,3,3,5,19,19,5,19,113
19,21,3,3,5,19,19,15,18,122
19,21,3,3,9,0,0,0,0,55
19,21,3,3,9,14,0,0,0,69
19,21,3,3,9,14,1,20,5,95
19,21,3,3,9,14,3,20,0,92
19,21,3,3,9,14,5,1,0,75
19,21,3,3,9,14,9,3,0,81
19,21,3,3,9,14,25,12,0,106
19,21,3,3,9,14,25,12,19,125
19,21,3,3,9,14,9,20,5,103
19,21,3,3,9,14,15,12,0,96
19,21,3,3,9,14,15,21,19,124
19,21,3,3,9,14,21,13,0,103
19,21,3,3,9,19,5,0,0,79
19,21,3,3,15,18,0,0,0,79
19,21,3,3,15,18,5,4,0,88
19,21,3,3,15,18,5,18,0,102
19,21,3,3,15,18,5,18,19,121
19,21,3,3,15,18,6,21,12,118
19,21,3,3,15,18,25,0,0,104
19,21,3,3,15,18,9,5,19,112
19,21,3,3,15,18,9,14,7,109
19,21,3,3,15,18,19,0,0,98
19,21,3,3,15,19,5,0,0,85
19,21,3,3,15,20,1,19,8,109
19,21,3,3,15,21,18,0,0,100
19,21,3,3,15,21,18,5,4,109
19,21,3,3,15,21,18,5,18,123
19,21,3,3,15,21,18,19,0,119
19,21,3,3,15,21,19,0,0,101
19,21,3,3,21,2,0,0,0,69
19,21,3,3,21,2,1,0,0,70
19,21,3,3,21,2,1,5,0,75
19,21,3,3,21,2,5,0,0,74
19,21,3,3,21,2,9,0,0,78
19,21,3,3,21,2,9,14,5,97
19,21,3,3,21,2,15,21,19,124
19,21,3,3,21,4,18,25,0,114
19,21,3,3,21,12,1,0,0,80
19,21,3,3,21,12,5,14,20,118
19,21,3,3,21,12,15,21,19,134
19,21,3,3,21,13,2,0,0,82
19,21,3,3,21,13,2,5,4,91
19,21,3,3,21,13,2,5,18,105
19,21,3,3,21,13,2,19,0,101
19,21,3,3,21,18,19,1,12,117
19,21,3,3,21,19,0,0,0,86
19,21,3,3,21,19,19,0,0,105
19,21,3,3,21,19,19,5,4,114
19,21,3,3,21,19,19,5,19,129
19,21,3,8,0,0,0,0,0,51
19,21,3,8,12,9,11,5,0,88
19,21,3,8,14,5,19,19,0,108
19,21,3,8,23,9,19,5,0,107
19,21,3,9,0,0,0,0,0,52
19,21,3,11,0,0,0,0,0,54
19,21,3,11,1,2,12,5,0,74
19,21,3,11,1,2,15,2,0,74
19,21,3,11,1,7,5,0,0,67
19,21,3,11,5,4,0,0,0,63
19,21,3,11,5,14,0,0,0,73
19,21,3,11,5,14,5,18,0,96
19,21,3,11,5,14,25,0,0,98
19,21,3,11,5,18,0,0,0,77
19,21,3,11,5,18,5,4,0,86
19,21,3,11,5,18,5,12,0,94
19,21,3,11,5,18,9,14,7,107
19,21,3,11,5,18,19,0,0,96
19,21,3,11,5,20,0,0,0,79
19,21,3,11,6,9,19,8,0,96
19,21,3,11,8,15,12,5,0,94
19,21,3,11,9,14,7,0,0,84
19,21,3,11,12,5,0,0,0,71
19,21,3,11,12,5,4,0,0,75
19,21,3,11,12,5,18,0,0,89
19,21,3,11,12,5,18,19,0,108
19,21,3,11,12,5,19,0,0,90
19,21,3,11,12,5,19,19,0,109
19,21,3,11,12,9,14,7,19,115
19,21,3,11,19,0,0,0,0,73
19,21,3,11,19,20,15,14,5,127
19,21,3,12,1,20,0,0,0,76
19,21,3,18,1,13,9,14,0,98
19,21,3,18,1,13,9,14,5,103
19,21,3,18,1,19,5,0,0,86
19,21,3,18,1,19,5,19,0,105
19,21,3,18,1,20,5,0,0,87
19,21,3,18,5,19,0,0,0,85
19,21,3,18,9,5,18,0,0,93
19,21,3,18,9,5,18,19,0,112
19,21,3,18,15,1,3,9,4,93
19,21,3,18,15,19,5,0,0,100
19,21,3,18,15,19,5,19,0,119
19,21,3,20,9,15,14,0,0,101
19,21,3,20,9,15,14,1,12,114
19,21,3,20,9,15,14,19,0,120
19,21,3,20,15,18,9,1,12,118
19,21,3,20,15,18,9,1,14,120
19,21,3,21,16,9,18,1,0,108
19,21,3,21,18,9,0,0,0,91
19,21,3,21,18,25,0,0,0,107
19,21,3,21,18,9,21,0,0,112
19,21,3,21,18,21,10,21,0,134
19,21,4,0,0,0,0,0,0,44
19,21,4,1,4,5,18,15,0,87
19,21,4,1,13,5,14,0,0,77
19,21,4,1,13,9,14,1,0,82
19,21,4,1,13,9,14,1,12,94
19,21,4,1,18,25,0,0,0,88
19,21,4,1,18,9,1,0,0,73
19,21,4,1,18,9,5,19,0,96
19,21,4,1,18,9,21,13,0,106
19,21,4,1,20,5,0,0,0,70
19,21,4,1,20,9,15,14,0,103
19,21,4,1,20,9,15,14,19,122
19,21,4,1,20,15,18,25,0,123
19,21,4,1,20,15,18,9,1,108
19,21,4,2,21,18,9,20,5,119
19,21,4,4,0,0,0,0,0,48
19,21,4,4,5,14,0,0,0,67
19,21,4,4,5,14,12,25,0,104
19,21,4,4,5,14,19,0,0,86
19,21,4,4,5,14,20,25,0,112
19,21,4,4,25,0,0,0,0,73
19,21,4,4,12,5,0,0,0,65
19,21,4,4,19,0,0,0,0,67
19,21,4,5,0,0,0,0,0,49
19,21,4,5,19,0,0,0,0,68
19,21,4,9,6,15,18,13,0,105
19,21,4,15,18,0,0,0,0,77
19,21,4,15,18,1,12,0,0,90
19,21,4,15,18,5,19,9,19,129
19,21,4,15,18,9,3,0,0,89
19,21,4,15,18,9,6,9,3,104
19,21,4,15,18,15,21,19,0,132
19,21,4,15,18,19,0,0,0,96
19,21,4,19,0,0,0,0,0,63
19,21,4,19,5,4,0,0,0,72
19,21,4,19,5,18,0,0,0,86
19,21,4,19,5,18,19,0,0,105
19,21,4,19,5,19,0,0,0,87
19,21,4,19,25,0,0,0,0,88
19,21,4,19,9,5,18,0,0,95
19,21,4,19,9,5,19,20,0,116
19,21,4,19,9,14,7,0,0,93
19,21,4,19,12,5,19,19,0,118
19,21,4,19,13,1,14,0,0,91
19,21,4,19,13,5,14,0,0,95
19,21,5,4,0,0,0,0,0,49
19,21,5,4,5,0,0,0,0,54
19,21,5,4,5,4,0,0,0,58
19,21,5,4,5,19,0,0,0,73
19,21,5,4,9,14,5,0,0,77
19,21,5,4,9,14,7,0,0,79
19,21,5,7,5,5,0,0,0,62
19,21,5,25,0,0,0,0,0,70
19,21,5,14,20,0,0,0,0,79
19,21,5,18,0,0,0,0,0,63
19,21,5,18,19,0,0,0,0,82
19,21,5,18,20,5,0,0,0,88
19,21,5,19,0,0,0,0,0,64
19,21,5,20,0,0,0,0,0,65
19,21,5,20,25,0,0,0,0,90
19,21,5,20,19,0,0,0,0,84
19,21,6,0,0,0,0,0,0,46
19,21,6,6,1,18,9,0,0,80
19,21,6,6,1,18,9,19,0,99
19,21,6,6,5,3,20,0,0,80
19,21,6,6,5,18,0,0,0,75
19,21,6,6,5,18,1,14,20,110
19,21,6,6,5,18,5,4,0,84
19,21,6,6,5,18,5,18,0,98
19,21,6,6,5,18,5,18,19,117
19,21,6,6,5,18,9,14,7,105
19,21,6,6,5,18,19,0,0,94
19,21,6,6,5,20,5,0,0,82
19,21,6,6,5,20,5,19,0,101
19,21,6,6,9,3,5,0,0,69
19,21,6,6,9,3,5,4,0,73
19,21,6,6,9,3,5,18,0,87
19,21,6,6,9,3,5,18,19,106
19,21,6,6,9,3,5,19,0,88
19,21,6,6,9,3,9,14,7,94
19,21,6,6,9,19,1,14,20,115
19,21,6,6,9,24,0,0,0,85
19,21,6,6,9,24,1,12,0,98
19,21,6,6,9,24,5,4,0,94
19,21,6,6,9,24,5,18,0,108
19,21,6,6,9,24,5,19,0,109
19,21,6,6,9,24,9,14,7,115
19,21,6,6,9,24,9,15,14,123
19,21,6,6,12,1,20,5,0,90
19,21,6,6,12,1,20,5,4,94
19,21,6,6,12,1,20,5,19,109
19,21,6,6,12,21,5,0,0,90
19,21,6,6,15,3,1,20,5,96
19,21,6,6,18,1,7,1,14,93
19,21,6,6,18,1,7,5,0,83
19,21,6,6,18,1,7,5,19,102
19,21,6,6,18,1,7,15,0,93
19,21,6,6,18,1,9,14,0,94
19,21,6,6,18,15,14,20,0,119
19,21,6,6,18,21,20,5,24,140
19,21,6,6,21,19,5,0,0,97
19,21,6,6,21,19,5,4,0,101
19,21,6,6,21,19,5,19,0,116
19,21,6,6,21,19,9,14,7,122
19,21,6,6,21,19,9,15,14,130
19,21,6,6,21,19,9,22,5,128
19,21,7,1,13,15,0,0,0,76
19,21,7,1,14,0,0,0,0,62
19,21,7,1,14,14,0,0,0,76
19,21,7,1,18,2,9,18,4,99
19,21,7,1,18,2,21,19,8,116
19,21,7,1,18,3,1,14,5,89
19,21,7,1,18,3,15,1,20,105
19,21,7,1,18,5,4,0,0,75
19,21,7,1,18,5,12,12,25,120
19,21,7,1,18,5,18,0,0,89
19,21,7,1,18,25,0,0,0,91
19,21,7,1,18,9,5,18,0,98
19,21,7,1,18,9,5,19,0,99
19,21,7,1,18,9,5,19,20,119
19,21,7,1,18,9,14,7,0,96
19,21,7,1,18,9,14,7,19,115
19,21,7,1,18,12,5,19,19,121
19,21,7,1,18,12,9,11,5,103
19,21,7,1,18,16,12,21,13,128
19,21,7,1,18,19,0,0,0,85
19,21,7,1,18,19,15,16,0,116
19,21,7,1,20,0,0,0,0,68
19,21,7,5,14,20,0,0,0,86
19,21,7,5,19,3,5,14,20,113
19,21,7,7,0,0,0,0,0,54
19,21,7,7,1,14,0,0,0,69
19,21,7,7,5,19,20,0,0,98
19,21,7,7,5,19,20,1,0,99
19,21,7,7,5,19,20,5,4,107
19,21,7,7,5,19,20,5,18,121
19,21,7,7,5,19,20,15,18,131
19,21,7,7,5,19,20,19,0,117
19,21,7,7,5,19,20,21,13,132
19,21,7,7,9,12,0,0,0,75
19,21,7,8,0,0,0,0,0,55
19,21,7,8,5,4,0,0,0,64
19,21,7,8,9,14,7,0,0,85
19,21,7,8,19,0,0,0,0,74
19,21,7,9,0,0,0,0,0,56
19,21,7,9,8,0,0,0,0,64
19,21,7,9,12,12,1,20,5,106
19,21,7,9,19,0,0,0,0,75
19,21,7,19,12,15,15,20,0,128
19,21,7,21,1,18,15,0,0,102
19,21,8,21,1,18,15,0,0,103
19,21,9,3,9,4,1,12,0,78
19,21,9,3,9,4,5,0,0,70
19,21,9,3,9,4,5,4,0,74
19,21,9,3,9,4,5,19,0,89
19,21,9,3,9,4,9,14,7,95
19,21,9,3,9,4,9,19,13,106
19,21,9,3,9,4,9,19,20,113
19,21,9,3,9,19,13,0,0,93
19,21,9,4,9,1,14,0,0,77
19,21,9,6,15,18,13,0,0,101
19,21,9,12,9,14,5,0,0,89
19,21,9,12,12,9,14,5,0,101
19,21,9,13,1,20,5,0,0,88
19,21,9,14,5,0,0,0,0,68
19,21,9,14,7,0,0,0,0,70
19,21,9,14,7,12,25,0,0,107
19,21,9,14,20,0,0,0,0,83
19,21,9,14,20,19,0,0,0,102
19,21,25,15,7,0,0,0,0,87
19,21,9,19,20,0,0,0,0,88
19,21,9,20,0,0,0,0,0,69
19,21,9,20,1,2,12,5,0,89
19,21,9,20,1,2,12,25,0,109
19,21,9,20,3,1,19,5,0,97
19,21,9,20,3,1,19,5,19,116
19,21,9,20,5,0,0,0,0,74
19,21,9,20,5,4,0,0,0,78
19,21,9,20,5,18,0,0,0,92
19,21,9,20,5,18,19,0,0,111
19,21,9,20,5,19,0,0,0,93
19,21,9,20,8,15,12,4,0,108
19,21,9,20,25,0,0,0,0,94
19,21,9,20,9,14,7,0,0,99
19,21,9,20,9,14,7,19,0,118
19,21,9,20,12,25,0,0,0,106
19,21,9,20,12,9,11,5,0,106
19,21,9,20,15,18,0,0,0,102
19,21,9,20,15,18,5,19,19,145
19,21,9,20,15,18,19,0,0,121
19,21,9,20,18,5,19,19,0,130
19,21,9,20,19,0,0,0,0,88
19,21,9,22,1,14,20,5,0,111
19,21,9,22,5,26,0,0,0,102
19,21,10,9,0,0,0,0,0,59
19,21,11,9,25,1,11,9,0,106
19,21,11,9,25,1,11,9,19,125
19,21,11,11,1,8,0,0,0,71
19,21,11,11,1,8,19,0,0,90
19,21,11,11,5,14,25,5,0,111
19,21,11,11,15,20,0,0,0,97
19,21,12,3,1,12,0,0,0,68
19,21,12,3,1,12,9,26,5,108
19,21,12,3,1,18,0,0,0,74
19,21,12,3,1,20,5,0,0,81
19,21,12,3,1,20,5,4,0,85
19,21,12,3,1,20,9,15,14,114
19,21,12,3,9,0,0,0,0,64
19,21,12,3,9,6,15,18,13,116
19,21,12,3,21,12,1,18,0,107
19,21,12,3,21,12,1,20,5,114
19,21,12,3,21,12,21,19,0,128
19,21,12,3,21,19,0,0,0,95
19,21,12,4,0,0,0,0,0,56
19,21,12,4,1,14,0,0,0,71
19,21,12,4,1,14,19,0,0,90
19,21,12,5,1,0,0,0,0,58
19,21,12,6,1,0,0,0,0,59
19,21,12,6,1,3,9,4,0,75
19,21,12,6,1,13,1,20,5,98
19,21,12,6,1,13,9,3,0,84
19,21,12,6,1,13,9,4,5,90
19,21,12,6,1,13,25,12,0,109
19,21,12,6,1,13,9,14,5,100
19,21,12,6,1,19,0,0,0,78
19,21,12,6,1,20,1,19,5,104
19,21,12,6,1,20,5,0,0,84
19,21,12,6,1,20,5,4,0,88
19,21,12,6,1,20,5,19,0,103
19,21,12,6,1,20,9,3,0,91
19,21,12,6,1,20,9,14,7,109
19,21,12,6,1,20,9,15,14,117
19,21,12,6,1,20,9,26,5,119
19,21,12,6,1,20,15,0,0,94
19,21,12,6,1,26,9,4,5,103
19,21,12,6,9,4,0,0,0,71
19,21,12,6,9,4,5,0,0,76
19,21,12,6,9,4,5,19,0,95
19,21,12,6,9,4,19,0,0,90
19,21,12,6,9,14,1,20,5,107
19,21,12,6,9,14,5,0,0,86
19,21,12,6,9,14,9,3,0,93
19,21,12,6,9,14,9,4,5,99
19,21,12,6,9,14,25,12,0,118
19,21,12,6,9,14,25,12,19,137
19,21,12,6,9,15,14,0,0,96
19,21,12,6,9,20,5,0,0,92
19,21,12,6,9,20,5,19,0,111
19,21,12,6,9,20,9,3,0,99
19,21,12,6,9,20,15,0,0,102
19,21,12,6,15,0,0,0,0,73
19,21,12,6,15,1,3,9,4,90
19,21,12,6,15,3,25,1,14,116
19,21,12,6,15,12,5,9,3,102
19,21,12,6,15,14,1,12,19,119
19,21,12,6,15,14,1,20,5,113
19,21,12,6,15,14,5,0,0,92
19,21,12,6,15,14,5,19,0,111
19,21,12,6,15,14,9,3,0,99
19,21,12,6,15,14,25,12,0,124
19,21,12,6,15,14,25,12,19,143
19,21,12,6,15,14,9,21,13,130
19,21,12,6,15,21,18,5,1,118
19,21,12,6,15,24,9,4,5,115
19,21,12,6,15,24,9,19,13,138
19,21,12,6,21,18,0,0,0,97
19,21,12,6,21,18,1,7,5,110
19,21,12,6,21,18,1,14,0,112
19,21,12,6,21,18,1,20,5,123
19,21,12,6,21,18,5,1,0,103
19,21,12,6,21,18,5,4,0,106
19,21,12,6,21,18,5,20,0,122
19,21,12,6,21,18,5,20,19,141
19,21,12,6,21,18,25,0,0,122
19,21,12,6,21,18,9,3,0,109
19,21,12,6,21,18,25,12,0,134
19,21,12,6,21,18,25,12,19,153
19,21,12,6,21,18,9,14,7,127
19,21,12,6,21,18,9,26,5,137
19,21,12,6,21,18,15,21,19,152
19,21,12,6,21,18,19,0,0,116
19,21,12,9,14,7,0,0,0,82
19,21,12,11,0,0,0,0,0,63
19,21,12,11,1,0,0,0,0,64
19,21,12,11,5,4,0,0,0,72
19,21,12,11,5,18,0,0,0,86
19,21,12,11,5,18,19,0,0,105
19,21,12,11,25,0,0,0,0,88
19,21,12,11,9,5,18,0,0,95
19,21,12,11,9,5,19,0,0,96
19,21,12,11,9,5,19,20,0,116
19,21,12,11,9,12,25,0,0,109
19,21,12,11,25,12,9,11,5,125
19,21,12,11,9,14,5,19,19,129
19,21,12,11,9,14,7,0,0,93
19,21,12,11,19,0,0,0,0,82
19,21,12,12,0,0,0,0,0,64
19,21,12,12,1,7,5,0,0,77
19,21,12,12,1,7,5,19,0,96
19,21,12,12,5,14,0,0,0,83
19,21,12,12,5,14,5,18,0,106
19,21,12,12,5,14,5,19,20,127
19,21,12,12,5,14,12,25,0,120
19,21,12,12,5,14,19,0,0,102
19,21,12,12,9,1,2,12,5,93
19,21,12,12,9,1,7,5,0,86
19,21,12,12,9,5,4,0,0,82
19,21,12,12,9,5,19,0,0,97
19,21,12,12,25,9,14,7,0,119
19,21,12,12,15,23,0,0,0,102
19,21,12,16,8,1,0,0,0,77
19,21,12,16,8,1,3,9,4,93
19,21,12,16,8,1,13,9,3,102
19,21,12,16,8,1,13,9,4,103
19,21,12,16,8,1,13,25,12,127
19,21,12,16,8,1,13,9,14,113
19,21,12,16,8,1,19,0,0,96
19,21,12,16,8,1,20,5,0,102
19,21,12,16,8,1,20,5,4,106
19,21,12,16,8,1,20,5,19,121
19,21,12,16,8,1,20,9,3,109
19,21,12,16,8,1,20,15,0,112
19,21,12,16,8,1,26,9,4,116
19,21,12,16,8,9,4,0,0,89
19,21,12,16,8,9,4,5,0,94
19,21,12,16,8,9,4,5,19,113
19,21,12,16,8,9,4,9,3,101
19,21,12,16,8,9,4,19,0,108
19,21,12,16,8,9,14,0,0,99
19,21,12,16,8,9,14,5,0,104
19,21,12,16,8,9,14,9,3,111
19,21,12,16,8,9,14,25,12,136
19,21,12,16,8,9,15,14,0,114
19,21,12,16,8,9,20,5,0,110
19,21,12,16,8,9,20,5,19,129
19,21,12,16,8,9,20,9,3,117
19,21,12,16,8,9,20,15,0,120
19,21,12,16,8,15,0,0,0,91
19,21,12,16,8,15,6,25,0,122
19,21,12,16,8,15,7,5,12,115
19,21,12,16,8,15,14,1,12,118
19,21,12,16,8,15,14,5,0,110
19,21,12,16,8,15,14,5,19,129
19,21,12,16,8,15,14,9,3,117
19,21,12,16,8,15,14,25,12,142
19,21,12,16,8,15,19,15,12,137
19,21,12,16,8,15,24,9,4,128
19,21,12,16,8,21,18,1,14,130
19,21,12,16,8,21,18,5,1,121
19,21,12,16,8,21,18,5,4,124
19,21,12,16,8,21,18,5,20,140
19,21,12,16,8,21,18,25,0,140
19,21,12,16,8,21,18,9,3,127
19,21,12,16,8,21,18,25,12,152
19,21,12,16,8,21,18,15,21,151
19,21,12,16,8,21,18,19,0,134
19,21,12,20,1,13,0,0,0,86
19,21,12,20,1,14,0,0,0,87
19,21,12,20,1,14,1,19,0,107
19,21,12,20,1,14,1,20,5,113
19,21,12,20,1,14,5,0,0,92
19,21,12,20,1,14,5,19,19,130
19,21,12,20,1,14,25,0,0,112
19,21,12,20,1,14,9,1,14,111
19,21,12,20,1,14,9,3,0,99
19,21,12,20,1,14,9,14,0,110
19,21,12,20,1,14,9,19,13,128
19,21,12,20,1,14,9,19,20,135
19,21,12,20,1,14,9,26,5,127
19,21,12,20,1,14,18,25,0,130
19,21,12,20,1,14,19,0,0,106
19,21,12,20,15,14,5,0,0,106
19,21,12,20,18,25,0,0,0,115
19,21,12,20,18,9,5,18,0,122
19,21,12,20,18,9,5,19,20,143
19,21,12,20,18,9,12,25,0,136
19,21,12,21,14,7,0,0,0,94
19,21,12,22,1,14,9,20,5,123
19,21,13,1,3,8,0,0,0,65
19,21,13,1,3,8,19,0,0,84
19,21,13,1,3,19,0,0,0,76
19,21,13,1,7,5,0,0,0,66
19,21,13,1,20,18,1,14,19,126
19,21,13,2,1,12,0,0,0,68
19,21,13,2,21,12,0,0,0,88
19,21,13,2,21,12,9,3,0,100
19,21,13,5,14,0,0,0,0,72
19,21,13,9,0,0,0,0,0,62
19,21,13,9,20,18,15,0,0,115
19,21,13,12,5,19,19,0,0,108
19,21,13,13,1,0,0,0,0,67
19,21,13,13,1,2,12,5,0,86
19,21,13,13,1,5,0,0,0,72
19,21,13,13,1,7,5,0,0,79
19,21,13,13,1,14,4,0,0,85
19,21,13,13,1,14,4,19,0,104
19,21,13,13,1,18,0,0,0,85
19,21,13,13,1,18,25,0,0,110
19,21,13,13,1,18,9,5,19,118
19,21,13,13,1,18,9,12,25,131
19,21,13,13,1,18,9,19,5,118
19,21,13,13,1,18,9,19,20,133
19,21,13,13,1,18,9,26,5,125
19,21,13,13,1,19,0,0,0,86
19,21,13,13,1,20,0,0,0,87
19,21,13,13,1,20,5,0,0,92
19,21,13,13,1,20,5,4,0,96
19,21,13,13,1,20,5,19,0,111
19,21,13,13,1,20,9,14,7,117
19,21,13,13,1,20,9,15,14,125
19,21,13,13,1,20,9,22,5,123
19,21,13,13,1,20,15,18,25,145
19,21,13,13,5,4,0,0,0,75
19,21,13,13,5,18,5,4,0,98
19,21,13,13,5,18,5,18,0,112
19,21,13,13,5,18,25,0,0,114
19,21,13,13,5,18,9,5,18,121
19,21,13,13,5,18,9,14,7,119
19,21,13,13,5,18,9,19,8,125
19,21,13,13,5,18,9,20,5,123
19,21,13,13,5,18,9,26,5,129
19,21,13,13,5,18,12,1,25,127
19,21,13,13,5,18,12,25,0,126
19,21,13,13,5,18,19,5,20,133
19,21,13,13,9,14,7,0,0,96
19,21,13,13,9,14,7,19,0,115
19,21,13,13,9,19,20,0,0,114
19,21,13,13,9,20,1,12,0,108
19,21,13,13,9,20,25,0,0,120
19,21,13,13,9,20,18,25,0,138
19,21,13,13,9,20,19,0,0,114
19,21,13,13,15,14,0,0,0,95
19,21,13,13,15,14,5,4,0,104
19,21,13,13,15,14,5,18,0,118
19,21,13,13,15,14,5,18,19,137
19,21,13,13,15,14,9,14,7,125
19,21,13,13,15,14,19,5,4,123
19,21,13,13,15,14,19,5,19,138
19,21,13,13,21,12,1,0,0,100
19,21,13,13,21,12,1,5,0,105
19,21,13,13,21,12,9,19,20,147
19,21,13,13,21,20,0,0,0,107
19,21,13,15,9,19,20,0,0,116
19,21,13,15,19,0,0,0,0,87
19,21,13,16,0,0,0,0,0,69
19,21,13,16,1,7,5,0,0,82
19,21,13,16,5,18,0,0,0,92
19,21,13,16,8,0,0,0,0,77
19,21,13,16,8,25,0,0,0,102
19,21,13,16,8,9,19,8,0,113
19,21,13,16,9,20,0,0,0,98
19,21,13,16,9,20,1,14,0,113
19,21,13,16,12,5,0,0,0,86
19,21,13,16,13,1,14,0,0,97
19,21,13,16,19,0,0,0,0,88
19,21,13,16,19,9,13,21,19,150
19,21,13,16,20,0,0,0,0,89
19,21,13,16,20,5,18,19,0,131
19,21,13,16,20,9,15,14,0,127
19,21,13,16,20,9,15,21,19,153
19,21,13,16,20,21,1,18,25,154
19,21,13,16,20,21,15,21,19,165
19,21,13,16,20,21,18,5,0,133
19,21,13,16,23,5,5,4,0,106
19,21,13,16,23,5,5,4,19,125
19,21,13,19,0,0,0,0,0,72
19,21,14,2,1,3,11,0,0,71
19,21,14,2,1,11,5,0,0,73
19,21,14,2,1,11,5,4,0,77
19,21,14,2,1,20,8,0,0,85
19,21,14,2,1,20,8,5,0,90
19,21,14,2,1,20,8,5,4,94
19,21,14,2,1,20,8,5,18,108
19,21,14,2,1,20,8,5,19,109
19,21,14,2,1,20,8,19,0,104
19,21,14,2,5,1,13,0,0,75
19,21,14,2,5,1,13,5,4,84
19,21,14,2,5,1,13,25,0,100
19,21,14,2,5,1,13,19,0,94
19,21,14,2,5,12,20,19,0,112
19,21,14,2,5,18,18,25,0,122
19,21,14,2,9,18,4,0,0,87
19,21,14,2,9,18,4,19,0,106
19,21,14,2,12,9,14,4,0,95
19,21,14,2,12,9,14,11,0,102
19,21,14,2,15,14,14,5,20,124
19,21,14,2,15,23,0,0,0,94
19,21,14,2,15,23,19,0,0,113
19,21,14,2,18,5,1,11,0,91
19,21,14,2,21,18,14,0,0,109
19,21,14,2,21,18,14,5,4,118
19,21,14,2,21,18,14,19,0,128
19,21,14,2,21,18,14,20,0,129
19,21,14,2,21,18,19,20,19,153
19,21,14,3,11,5,0,0,0,73
19,21,14,3,21,16,0,0,0,94
19,21,14,4,1,5,0,0,0,64
19,21,14,4,1,5,19,0,0,83
19,21,14,4,1,14,7,0,0,80
19,21,14,4,1,18,0,0,0,77
19,21,14,4,1,18,9,0,0,86
19,21,14,4,5,11,0,0,0,74
19,21,14,4,5,18,0,0,0,81
19,21,14,4,5,18,5,4,0,90
19,21,14,4,5,18,5,18,0,104
19,21,14,4,5,18,5,18,19,123
19,21,14,4,5,18,9,14,7,111
19,21,14,4,5,18,12,25,0,118
19,21,14,4,5,18,19,0,0,100
19,21,14,4,5,23,0,0,0,86
19,21,14,4,5,23,19,0,0,105
19,21,14,4,9,1,12,0,0,80
19,21,14,4,9,1,12,19,0,99
19,21,14,4,9,11,0,0,0,78
19,21,14,4,15,7,0,0,0,80
19,21,14,4,15,7,19,0,0,99
19,21,14,4,15,23,14,0,0,110
19,21,14,4,15,23,14,5,18,133
19,21,14,4,15,23,14,19,0,129
19,21,14,4,18,1,0,0,0,77
19,21,14,4,18,5,19,19,0,119
19,21,14,4,18,9,0,0,0,85
19,21,14,4,18,25,0,0,0,101
19,21,14,4,18,9,5,19,0,109
19,21,14,4,18,9,12,25,0,122
19,21,14,4,18,25,13,1,14,129
19,21,14,4,18,25,13,5,14,133
19,21,14,4,18,15,16,19,0,126
19,21,14,5,0,0,0,0,0,59
19,21,14,6,1,12,12,0,0,85
19,21,14,6,1,19,20,0,0,100
19,21,14,6,9,19,8,0,0,96
19,21,14,6,9,19,8,5,18,119
19,21,14,6,9,19,8,5,19,120
19,21,14,6,12,15,23,5,18,133
19,21,14,6,15,9,12,0,0,96
19,21,14,7,1,18,0,0,0,80
19,21,14,7,8,1,0,0,0,70
19,21,14,7,12,1,4,5,0,83
19,21,14,7,12,1,19,19,0,112
19,21,14,7,12,15,0,0,0,88
19,21,14,7,12,15,23,0,0,111
19,21,14,7,12,15,23,19,0,130
19,21,14,7,18,5,2,5,0,91
19,21,14,8,1,20,0,0,0,83
19,21,14,25,9,5,0,0,0,93
19,21,14,11,0,0,0,0,0,65
19,21,14,11,5,14,0,0,0,84
19,21,14,11,5,20,0,0,0,90
19,21,14,11,5,20,19,0,0,109
19,21,14,11,9,5,0,0,0,79
19,21,14,11,12,1,14,4,0,96
19,21,14,12,1,13,16,0,0,96
19,21,14,12,1,13,16,19,0,115
19,21,14,12,1,14,4,19,0,104
19,21,14,12,5,19,19,0,0,109
19,21,14,12,5,19,19,12,25,146
19,21,14,12,5,20,0,0,0,91
19,21,14,12,9,7,8,20,0,110
19,21,14,12,9,7,8,20,19,129
19,21,14,12,9,11,5,0,0,91
19,21,14,12,9,20,0,0,0,95
19,21,14,14,0,0,0,0,0,68
19,21,14,14,1,19,0,0,0,88
19,21,14,14,5,4,0,0,0,77
19,21,14,14,25,1,19,5,5,123
19,21,14,14,25,1,19,19,5,137
19,21,14,14,9,5,18,0,0,100
19,21,14,14,9,5,19,20,0,121
19,21,14,14,9,12,25,0,0,114
19,21,14,14,9,14,5,19,19,134
19,21,14,14,9,14,7,0,0,98
19,21,14,14,19,0,0,0,0,87
19,21,14,14,21,4,0,0,0,93
19,21,14,16,18,15,15,6,0,124
19,21,14,17,21,1,11,5,0,109
19,21,14,18,9,19,5,0,0,105
19,21,14,18,9,19,5,19,0,124
19,21,14,18,9,19,9,14,7,130
19,21,14,18,15,15,6,0,0,108
19,21,14,18,15,15,6,19,0,127
19,21,14,18,15,15,13,0,0,115
19,21,14,18,15,15,13,19,0,134
19,21,14,18,15,19,5,0,0,111
19,21,14,19,0,0,0,0,0,73
19,21,14,19,3,1,12,4,0,93
19,21,14,19,3,1,12,4,19,112
19,21,14,19,3,15,18,3,8,120
19,21,14,19,3,18,5,5,14,118
19,21,14,19,5,5,11,5,18,117
19,21,14,19,5,20,0,0,0,98
19,21,14,19,5,20,19,0,0,117
19,21,14,19,5,20,20,25,0,143
19,21,14,19,8,1,4,5,0,91
19,21,14,19,8,1,4,5,19,110
19,21,14,19,8,9,14,5,19,128
19,21,14,19,8,9,14,25,0,129
19,21,14,19,13,9,20,0,0,115
19,21,14,19,16,15,20,0,0,124
19,21,14,19,16,15,20,19,0,143
19,21,14,19,16,15,20,20,25,169
19,21,14,19,17,21,1,12,12,136
19,21,14,19,20,1,25,0,0,119
19,21,14,19,20,1,18,0,0,112
19,21,14,19,20,5,1,4,0,103
19,21,14,19,20,15,14,5,0,127
19,21,14,19,20,15,14,5,19,146
19,21,14,19,20,18,15,11,5,142
19,21,14,19,20,18,21,3,11,146
19,21,14,19,21,9,20,0,0,123
19,21,14,19,21,9,20,19,0,142
19,21,14,20,0,0,0,0,0,74
19,21,14,20,1,14,0,0,0,89
19,21,14,20,1,14,14,5,4,112
19,21,14,20,1,14,19,0,0,108
19,21,14,20,18,1,16,0,0,109
19,21,14,21,16,0,0,0,0,91
19,21,14,21,16,19,0,0,0,110
19,21,14,23,1,25,0,0,0,103
19,21,14,23,1,25,19,0,0,122
19,21,14,23,1,18,4,0,0,100
19,21,14,23,1,18,4,19,0,119
19,21,14,23,5,5,4,0,0,91
19,21,14,23,9,19,5,0,0,110
19,21,16,1,0,0,0,0,0,57
19,21,16,1,18,9,0,0,0,84
19,21,16,1,23,14,0,0,0,94
19,21,16,5,0,0,0,0,0,61
19,21,16,5,12,12,5,24,0,114
19,21,16,5,18,0,0,0,0,79
19,21,16,5,18,1,2,12,5,99
19,21,16,5,18,1,2,12,25,119
19,21,16,5,18,1,3,9,4,96
19,21,16,5,18,1,4,4,0,88
19,21,16,5,18,1,4,4,19,107
19,21,16,5,18,1,14,1,12,107
19,21,16,5,18,1,20,5,0,105
19,21,16,5,18,1,22,9,20,131
19,21,16,5,18,2,0,0,0,81
19,21,16,5,18,2,1,4,0,86
19,21,16,5,18,2,5,18,0,104
19,21,16,5,18,2,5,19,20,125
19,21,16,5,18,2,9,1,0,91
19,21,16,5,18,2,9,1,19,110
19,21,16,5,18,2,9,20,25,135
19,21,16,5,18,2,12,25,0,118
19,21,16,5,18,2,15,12,4,112
19,21,16,5,18,2,15,13,2,111
19,21,16,5,18,2,21,19,25,146
19,21,16,5,18,3,1,18,0,101
19,21,16,5,18,3,5,4,5,96
19,21,16,5,18,3,9,20,25,136
19,21,16,5,18,3,15,12,4,113
19,21,16,5,18,3,15,15,12,124
19,21,16,5,18,3,15,16,0,113
19,21,16,5,18,3,15,23,0,120
19,21,16,5,18,3,21,2,5,110
19,21,16,5,18,4,5,2,20,110
19,21,16,5,18,4,15,19,5,122
19,21,16,5,18,5,4,0,0,88
19,21,16,5,18,5,7,15,0,106
19,21,16,5,18,5,7,15,19,125
19,21,16,5,18,5,16,9,3,112
19,21,16,5,18,5,20,20,5,129
19,21,16,5,18,6,1,14,0,100
19,21,16,5,18,6,1,18,13,117
19,21,16,5,18,6,1,19,20,125
19,21,16,5,18,6,1,20,0,106
19,21,16,5,18,6,5,5,0,95
19,21,16,5,18,6,5,20,5,115
19,21,16,5,18,6,9,3,5,102
19,21,16,5,18,6,9,14,5,113
19,21,16,5,18,6,9,20,0,114
19,21,16,5,18,6,9,24,0,118
19,21,16,5,18,6,12,21,24,142
19,21,16,5,18,6,21,19,5,130
19,21,16,5,18,7,5,14,5,110
19,21,16,5,18,7,25,18,5,134
19,21,16,5,18,7,15,15,4,120
19,21,16,5,18,7,21,14,0,121
19,21,16,5,18,8,1,18,4,110
19,21,16,5,18,8,5,1,20,113
19,21,16,5,18,8,5,18,15,125
19,21,16,5,18,8,5,20,0,112
19,21,16,5,18,8,9,7,8,111
19,21,16,5,18,8,9,20,0,116
19,21,16,5,18,8,9,22,5,123
19,21,16,5,18,9,1,12,0,101
19,21,16,5,18,9,14,7,0,109
19,21,16,5,18,9,15,18,19,140
19,21,16,5,18,9,21,19,0,128
19,21,16,5,18,10,5,20,0,114
19,21,16,5,18,10,5,20,19,133
19,21,16,5,18,12,0,0,0,91
19,21,16,5,18,12,1,25,0,117
19,21,16,5,18,12,1,9,14,115
19,21,16,5,18,12,9,5,0,105
19,21,16,5,18,12,9,5,4,109
19,21,16,5,18,12,9,5,19,124
19,21,16,5,18,12,9,14,5,119
19,21,16,5,18,12,15,1,4,111
19,21,16,5,18,13,1,12,5,110
19,21,16,5,18,13,5,14,0,111
19,21,16,5,18,13,9,14,9,124
19,21,16,5,18,13,15,13,0,120
19,21,16,5,18,14,1,12,0,106
19,21,16,5,18,14,15,22,1,131
19,21,16,5,18,16,12,21,19,147
19,21,16,5,18,16,15,18,20,148
19,21,16,5,18,16,15,19,5,134
19,21,16,5,18,16,18,15,0,128
19,21,16,5,18,16,21,18,5,139
19,21,16,5,18,18,1,3,5,106
19,21,16,5,18,18,9,3,8,117
19,21,16,5,18,19,0,0,0,98
19,21,16,5,18,19,1,6,5,110
19,21,16,5,18,19,1,12,20,131
19,21,16,5,18,19,5,4,5,112
19,21,16,5,18,19,5,20,0,123
19,21,16,5,18,19,5,20,19,142
19,21,16,5,18,19,5,24,0,127
19,21,16,5,18,19,8,9,16,131
19,21,16,5,18,19,9,26,5,138
19,21,16,5,18,19,15,6,20,139
19,21,16,5,18,19,15,9,12,134
19,21,16,5,18,19,16,25,0,139
19,21,16,5,18,19,20,1,18,137
19,21,16,5,18,20,1,18,5,123
19,21,16,5,18,20,1,24,0,124
19,21,16,5,18,20,8,9,14,130
19,21,16,5,18,21,7,12,25,144
19,21,16,5,18,21,14,9,20,143
19,21,16,5,18,21,19,5,18,142
19,21,16,5,18,22,1,19,20,141
19,21,16,5,18,22,5,14,5,125
19,21,16,5,18,22,9,19,5,134
19,21,16,5,18,22,9,22,5,137
19,21,16,5,18,23,5,1,11,119
19,21,16,5,18,23,9,19,5,135
19,21,16,5,19,0,0,0,0,80
19,21,16,9,14,1,20,5,0,105
19,21,16,9,14,1,20,5,4,109
19,21,16,9,14,1,20,5,19,124
19,21,16,9,14,1,20,15,18,133
19,21,16,9,14,5,0,0,0,84
19,21,16,9,14,5,12,25,0,121
19,21,16,9,14,5,19,0,0,103
19,21,16,9,14,9,20,25,0,133
19,21,16,12,5,24,0,0,0,97
19,21,16,16,0,0,0,0,0,72
19,21,16,16,1,2,12,5,0,92
19,21,16,16,1,7,5,0,0,85
19,21,16,16,5,4,0,0,0,81
19,21,16,16,5,4,9,20,0,110
19,21,16,16,5,18,0,0,0,95
19,21,16,16,5,18,9,14,7,125
19,21,16,16,5,18,19,0,0,114
19,21,16,16,9,14,7,0,0,102
19,21,16,16,12,0,0,0,0,84
19,21,16,16,12,1,3,5,0,93
19,21,16,16,12,1,14,20,0,119
19,21,16,16,12,1,14,20,19,138
19,21,16,16,12,5,4,0,0,93
19,21,16,16,12,5,12,25,0,126
19,21,16,16,12,5,18,0,0,107
19,21,16,16,12,5,19,0,0,108
19,21,16,16,12,5,19,20,0,128
19,21,16,16,12,25,0,0,0,109
19,21,16,16,12,9,1,12,0,106
19,21,16,16,12,9,1,14,20,128
19,21,16,16,12,9,3,1,20,117
19,21,16,16,12,9,3,5,0,101
19,21,16,16,12,9,5,4,0,102
19,21,16,16,12,9,5,18,0,116
19,21,16,16,12,9,5,18,19,135
19,21,16,16,12,9,5,19,0,117
19,21,16,16,12,25,9,14,7,139
19,21,16,16,12,9,14,7,0,114
19,21,16,16,14,5,1,0,0,92
19,21,16,16,15,14,5,0,0,106
19,21,16,16,15,18,20,0,0,125
19,21,16,16,15,18,20,5,4,134
19,21,16,16,15,18,20,5,18,148
19,21,16,16,15,18,20,19,0,144
19,21,16,16,15,19,0,0,0,106
19,21,16,16,15,19,1,12,0,119
19,21,16,16,15,19,1,12,19,138
19,21,16,16,15,19,5,0,0,111
19,21,16,16,15,19,5,4,0,115
19,21,16,16,15,19,5,18,0,129
19,21,16,16,15,19,5,18,19,148
19,21,16,16,15,19,5,19,0,130
19,21,16,16,15,19,9,14,7,136
19,21,16,16,15,19,20,0,0,126
19,21,16,16,18,5,19,19,0,133
19,21,16,16,18,9,13,5,0,117
19,21,16,16,18,9,19,5,0,123
19,21,16,16,21,18,1,14,20,146
19,21,16,16,21,18,1,20,5,137
19,21,16,16,21,20,5,0,0,118
19,21,16,18,0,0,0,0,0,74
19,21,16,18,1,0,0,0,0,75
19,21,16,18,1,6,9,14,5,109
19,21,16,18,1,15,18,1,12,121
19,21,16,18,1,22,9,19,5,130
19,21,16,18,5,13,1,3,25,121
19,21,16,18,5,13,5,0,0,97
19,21,16,18,5,13,5,12,25,134
19,21,16,18,5,13,5,18,0,115
19,21,16,18,5,13,5,19,20,136
19,21,16,18,5,13,9,20,25,146
19,21,16,18,5,13,15,0,0,107
19,21,16,18,5,13,15,19,0,126
19,21,16,18,5,13,21,13,0,126
19,21,16,18,5,19,19,5,4,126
19,21,16,18,9,19,9,14,7,132
19,21,16,19,0,0,0,0,0,75
19,21,16,20,9,15,14,0,0,114
19,21,16,21,12,3,8,18,5,123
19,21,16,22,18,0,0,0,0,96
19,21,17,0,0,0,0,0,0,57
19,21,18,1,8,0,0,0,0,67
19,21,18,1,8,5,5,0,0,77
19,21,18,1,8,9,0,0,0,76
19,21,18,1,8,19,0,0,0,86
19,21,18,1,12,0,0,0,0,71
19,21,18,1,13,9,14,0,0,95
19,21,18,1,14,1,12,0,0,86
19,21,18,1,14,3,5,0,0,81
19,21,18,1,19,0,0,0,0,78
19,21,18,2,1,19,5,0,0,85
19,21,18,2,1,19,5,4,0,89
19,21,18,2,1,19,5,19,0,104
19,21,18,2,1,20,5,0,0,86
19,21,18,2,1,20,5,18,0,104
19,21,18,2,5,4,0,0,0,69
19,21,18,2,5,4,4,5,4,82
19,21,18,3,5,1,19,5,0,91
19,21,18,3,5,1,19,5,4,95
19,21,18,3,5,1,19,5,19,110
19,21,18,3,8,1,18,7,5,100
19,21,18,3,9,14,7,12,5,108
19,21,18,3,12,5,0,0,0,78
19,21,18,3,12,15,25,0,0,113
19,21,18,3,15,1,20,0,0,97
19,21,18,3,15,1,20,19,0,116
19,21,18,3,18,21,5,0,0,105
19,21,18,3,21,12,9,0,0,103
19,21,18,3,21,12,15,19,5,133
19,21,18,3,21,12,15,21,19,149
19,21,18,3,21,12,21,19,0,134
19,21,18,4,0,0,0,0,0,62
19,21,18,4,1,20,9,15,14,121
19,21,18,4,5,12,9,14,5,107
19,21,18,4,5,14,20,0,0,101
19,21,18,4,9,20,25,0,0,116
19,21,18,4,15,13,21,20,5,136
19,21,18,4,19,0,0,0,0,81
19,21,18,5,0,0,0,0,0,63
19,21,18,5,4,0,0,0,0,67
19,21,18,5,6,9,18,5,0,101
19,21,18,5,12,25,0,0,0,100
19,21,18,5,13,5,14,20,0,115
19,21,18,5,14,5,19,19,0,120
19,21,18,5,18,0,0,0,0,81
19,21,18,5,19,0,0,0,0,82
19,21,18,5,19,2,25,0,0,109
19,21,18,5,19,8,0,0,0,90
19,21,18,5,19,20,0,0,0,102
19,21,18,5,20,25,0,0,0,108
19,21,18,5,20,9,5,19,0,116
19,21,18,5,20,20,5,0,0,108
19,21,18,6,1,2,12,5,0,84
19,21,18,6,1,3,5,0,0,73
19,21,18,6,1,3,5,4,0,77
19,21,18,6,1,3,5,12,25,110
19,21,18,6,1,3,5,18,0,91
19,21,18,6,1,3,5,18,19,110
19,21,18,6,1,3,5,19,0,92
19,21,18,6,1,3,25,0,0,93
19,21,18,6,1,3,9,14,7,98
19,21,18,6,2,9,18,4,0,97
19,21,18,6,2,9,18,4,19,116
19,21,18,6,2,15,1,18,4,104
19,21,18,6,2,15,1,20,0,102
19,21,18,6,2,15,1,20,19,121
19,21,18,6,5,4,0,0,0,73
19,21,18,6,5,9,20,0,0,98
19,21,18,6,5,9,20,5,4,107
19,21,18,6,5,9,20,5,18,121
19,21,18,6,5,9,20,19,0,117
19,21,18,6,5,18,0,0,0,87
19,21,18,6,5,18,19,0,0,106
19,21,18,6,6,9,19,8,0,106
19,21,18,6,25,0,0,0,0,89
19,21,18,6,9,3,9,1,12,98
19,21,18,6,9,5,0,0,0,78
19,21,18,6,9,5,18,0,0,96
19,21,18,6,9,5,19,20,0,117
19,21,18,6,9,14,7,0,0,94
19,21,18,6,9,14,7,19,0,113
19,21,18,6,12,5,0,0,0,81
19,21,18,6,12,9,11,5,0,101
19,21,18,6,13,1,14,0,0,92
19,21,18,6,13,5,14,0,0,96
19,21,18,6,16,5,18,3,8,114
19,21,18,6,18,1,16,16,5,120
19,21,18,6,18,9,4,5,18,118
19,21,18,6,19,0,0,0,0,83
19,21,18,6,21,19,5,0,0,109
19,21,18,6,21,19,9,15,14,142
19,21,18,7,0,0,0,0,0,65
19,21,18,7,5,0,0,0,0,70
19,21,18,7,5,4,0,0,0,74
19,21,18,7,5,6,21,12,0,109
19,21,18,7,5,12,5,19,19,125
19,21,18,7,5,14,3,25,0,112
19,21,18,7,5,14,20,0,0,104
19,21,18,7,5,15,14,0,0,99
19,21,18,7,5,15,14,3,25,127
19,21,18,7,5,15,14,19,0,118
19,21,18,7,5,18,0,0,0,88
19,21,18,7,5,18,25,0,0,113
19,21,18,7,5,18,9,5,19,121
19,21,18,7,5,18,9,26,5,128
19,21,18,7,5,18,19,0,0,107
19,21,18,7,5,19,0,0,0,89
19,21,18,7,25,0,0,0,0,90
19,21,18,7,9,3,1,12,0,90
19,21,18,7,9,5,18,0,0,97
19,21,18,7,9,5,19,20,0,118
19,21,18,7,9,14,5,19,19,131
19,21,18,7,9,14,7,0,0,95
19,21,18,8,1,9,0,0,0,76
19,21,18,9,3,1,20,0,0,91
19,21,18,9,3,1,20,5,0,96
19,21,18,9,3,1,20,5,19,115
19,21,18,9,7,1,0,0,0,75
19,21,18,9,17,21,5,0,0,110
19,21,18,12,25,0,0,0,0,95
19,21,18,12,9,5,18,0,0,102
19,21,18,12,9,5,19,20,0,123
19,21,18,12,9,12,25,0,0,116
19,21,18,12,9,14,5,19,19,136
19,21,18,13,1,0,0,0,0,72
19,21,18,13,1,18,11,0,0,101
19,21,18,13,1,19,20,5,18,134
19,21,18,13,5,14,1,7,5,103
19,21,18,13,9,19,1,12,0,112
19,21,18,13,9,19,1,14,20,134
19,21,18,13,9,19,5,0,0,104
19,21,18,13,9,19,5,4,0,108
19,21,18,13,9,19,5,18,0,122
19,21,18,13,9,19,5,18,19,141
19,21,18,13,9,19,5,19,0,123
19,21,18,13,9,19,9,14,7,129
19,21,18,13,9,20,0,0,0,100
19,21,18,13,15,21,14,20,0,141
19,21,18,13,15,21,14,20,19,160
19,21,18,13,21,12,12,5,20,141
19,21,18,14,1,9,0,0,0,82
19,21,18,14,1,25,0,0,0,98
19,21,18,14,1,13,5,0,0,91
19,21,18,14,1,13,5,4,0,95
19,21,18,14,1,13,5,18,0,109
19,21,18,14,1,13,5,18,19,128
19,21,18,14,1,13,5,19,0,110
19,21,18,14,1,13,9,14,7,116
19,21,18,14,1,16,0,0,0,89
19,21,18,14,1,16,5,0,0,94
19,21,18,14,15,21,14,0,0,122
19,21,18,16,1,19,19,0,0,113
19,21,18,16,1,19,19,5,4,122
19,21,18,16,1,19,19,5,18,136
19,21,18,16,1,19,19,5,19,137
19,21,18,16,8,21,12,0,0,115
19,21,18,16,12,9,3,5,0,103
19,21,18,16,12,9,3,5,4,107
19,21,18,16,12,9,3,5,19,122
19,21,18,16,12,21,19,0,0,126
19,21,18,16,12,21,19,5,19,150
19,21,18,16,15,15,19,5,0,128
19,21,18,16,18,9,14,20,0,135
19,21,18,16,18,9,14,20,19,154
19,21,18,16,18,9,19,1,12,133
19,21,18,16,18,9,19,5,0,125
19,21,18,16,18,9,19,5,4,129
19,21,18,16,18,9,19,5,18,143
19,21,18,16,18,9,19,5,19,144
19,21,18,16,18,9,26,1,12,140
19,21,18,16,18,9,26,5,0,132
19,21,18,16,18,9,26,5,4,136
19,21,18,16,18,9,26,5,19,151
19,21,18,17,21,5,4,18,25,148
19,21,18,17,21,9,4,25,0,134
19,21,18,17,21,9,4,18,25,152
19,21,18,18,1,0,0,0,0,77
19,21,18,18,1,8,0,0,0,85
19,21,18,18,1,19,0,0,0,96
19,21,18,18,5,1,12,0,0,94
19,21,18,18,5,2,21,20,0,124
19,21,18,18,5,9,14,0,0,104
19,21,18,18,5,25,19,0,0,125
19,21,18,18,5,10,15,9,14,129
19,21,18,18,5,14,1,12,0,108
19,21,18,18,5,14,4,5,18,122
19,21,18,18,5,14,4,18,25,142
19,21,18,18,5,16,20,0,0,117
19,21,18,18,15,7,1,3,25,127
19,21,18,18,15,7,1,20,5,124
19,21,18,18,15,25,1,12,0,129
19,21,18,18,15,25,1,12,19,148
19,21,18,18,15,19,9,15,14,148
19,21,18,18,15,21,14,4,0,130
19,21,18,18,15,21,14,4,19,149
19,21,18,19,9,19,5,0,0,110
19,21,18,19,9,26,5,0,0,117
19,21,18,19,15,12,9,4,0,117
19,21,18,19,20,25,12,5,0,139
19,21,18,20,1,24,0,0,0,103
19,21,18,20,1,24,5,4,0,112
19,21,18,20,1,24,5,19,0,127
19,21,18,20,1,24,9,14,7,133
19,21,18,20,15,21,20,0,0,134
19,21,18,20,15,21,20,19,0,153
19,21,18,21,3,21,3,21,0,127
19,21,18,22,0,0,0,0,0,80
19,21,18,22,5,25,0,0,0,110
19,21,18,22,5,25,1,7,5,123
19,21,18,22,5,25,1,12,0,123
19,21,18,22,5,25,5,4,0,119
19,21,18,22,5,25,9,14,7,140
19,21,18,22,5,9,12,0,0,106
19,21,18,22,5,9,12,5,4,115
19,21,18,22,5,9,12,19,0,125
19,21,18,22,5,25,15,18,19,162
19,21,18,22,5,25,19,0,0,129
19,21,18,22,9,5,23,0,0,117
19,21,18,22,9,19,5,0,0,113
19,21,18,22,9,22,1,12,0,124
19,21,18,22,9,22,1,12,19,143
19,21,18,22,9,22,1,14,20,146
19,21,18,22,9,22,5,0,0,116
19,21,18,22,9,22,5,4,0,120
19,21,18,22,9,22,5,18,0,134
19,21,18,22,9,22,5,18,19,153
19,21,18,22,9,22,5,19,0,135
19,21,18,22,9,22,9,14,7,141
19,21,18,22,9,22,15,18,0,144
19,21,18,22,9,22,15,18,19,163
19,21,18,23,1,14,0,0,0,96
19,21,19,1,14,5,5,0,0,84
19,21,19,1,14,14,9,20,5,122
19,21,19,1,14,19,0,0,0,93
19,21,19,3,5,16,20,0,0,103
19,21,19,3,5,16,20,15,18,136
19,21,19,3,9,20,1,20,5,117
19,21,19,3,9,20,5,0,0,96
19,21,19,8,9,0,0,0,0,76
19,21,19,8,9,19,0,0,0,95
19,21,19,12,9,11,0,0,0,91
19,21,19,12,9,11,19,0,0,110
19,21,19,15,20,15,24,9,14,156
19,21,19,16,5,3,20,0,0,103
19,21,19,16,5,3,20,5,4,112
19,21,19,16,5,3,20,5,18,126
19,21,19,16,5,3,20,15,18,136
19,21,19,16,5,3,20,19,0,122
19,21,19,16,5,14,4,0,0,98
19,21,19,16,5,14,4,5,4,107
19,21,19,16,5,14,4,5,18,121
19,21,19,16,5,14,4,19,0,117
19,21,19,16,5,14,19,5,0,118
19,21,19,16,5,14,19,5,19,137
19,21,19,16,5,14,19,15,18,146
19,21,19,16,9,3,9,15,14,125
19,21,19,16,9,18,1,12,0,115
19,21,19,16,9,18,5,0,0,107
19,21,19,16,9,18,5,4,0,111
19,21,19,16,9,18,5,19,0,126
19,21,19,16,9,18,9,14,7,132
19,21,19,19,0,0,0,0,0,78
19,21,19,19,5,4,0,0,0,87
19,21,19,19,5,19,0,0,0,102
19,21,19,19,5,24,9,20,5,141
19,21,19,19,25,0,0,0,0,103
19,21,19,19,9,14,7,0,0,108
19,21,19,19,15,0,0,0,0,93
19,21,19,20,1,9,14,0,0,103
19,21,19,20,1,9,14,5,4,112
19,21,19,20,1,9,14,5,18,126
19,21,19,20,1,9,14,19,0,122
19,21,19,20,5,14,1,14,20,133
19,21,19,20,5,14,20,15,18,151
19,21,19,20,9,14,5,14,20,141
19,21,19,21,18,18,0,0,0,116
19,21,19,21,18,18,1,14,20,151
19,21,19,21,18,18,1,20,5,142
19,21,19,21,18,18,15,21,19,171
19,21,19,21,18,18,21,19,0,156
19,21,20,5,18,2,5,18,25,133
19,21,20,8,5,18,0,0,0,91
19,21,20,9,12,5,0,0,0,86
19,21,20,12,5,18,0,0,0,95
19,21,20,12,5,18,1,7,5,108
19,21,20,12,5,18,5,19,19,138
19,21,20,12,5,18,25,0,0,120
19,21,20,12,5,18,19,0,0,114
19,21,20,15,18,0,0,0,0,93
19,21,20,15,18,9,1,0,0,103
19,21,20,15,18,9,1,12,0,115
19,21,20,15,18,9,1,14,0,117
19,21,20,15,18,9,15,21,19,157
19,21,20,18,1,0,0,0,0,79
19,21,20,18,1,19,0,0,0,98
19,21,20,20,1,0,0,0,0,81
19,21,20,20,1,19,0,0,0,100
19,21,20,20,5,5,0,0,0,90
19,21,20,20,5,5,9,19,13,131
19,21,20,20,5,5,19,0,0,109
19,21,20,20,5,14,0,0,0,99
19,21,20,20,9,14,0,0,0,103
19,21,20,20,12,5,0,0,0,97
19,21,20,21,18,1,12,0,0,112
19,21,20,21,18,1,12,12,25,149
19,21,20,21,18,5,0,0,0,104
19,21,20,21,18,5,4,0,0,108
19,21,20,21,18,5,19,0,0,123
19,21,20,21,18,9,14,7,0,129
19,21,21,13,0,0,0,0,0,74
19,21,23,1,14,4,9,0,0,91
19,21,23,1,18,18,15,0,0,115
19,21,23,5,0,0,0,0,0,68
19,21,26,0,0,0,0,0,0,66
19,21,26,5,18,1,9,14,0,113
19,21,26,5,18,1,9,14,5,118
19,21,26,5,18,1,9,14,19,132
19,21,26,5,20,20,5,19,0,135
19,22,3,5,0,0,0,0,0,49
19,22,5,4,2,5,18,7,19,101
19,22,5,12,20,0,0,0,0,78
19,22,5,12,20,5,0,0,0,83
19,22,5,12,20,5,12,25,0,120
19,22,5,12,20,5,18,0,0,101
19,22,5,12,20,5,19,20,0,122
19,22,7,19,0,0,0,0,0,67
19,23,5,1,12,0,0,0,0,60
19,23,5,1,13,9,19,8,0,97
19,23,5,1,18,0,0,0,0,66
19,23,5,1,18,5,18,0,0,89
19,23,5,1,18,5,18,19,0,108
19,23,5,1,18,9,14,7,0,96
19,23,5,1,18,19,0,0,0,85
19,23,5,1,18,23,15,18,4,126
19,23,5,1,20,0,0,0,0,68
19,23,5,1,20,2,1,14,4,89
19,23,5,1,20,2,15,24,0,109
19,23,5,1,20,5,4,0,0,77
19,23,5,1,20,5,18,0,0,91
19,23,5,1,20,5,18,19,0,110
19,23,5,1,20,6,21,12,0,107
19,23,5,1,20,8,0,0,0,76
19,23,5,1,20,25,0,0,0,93
19,23,5,1,20,9,5,18,0,100
19,23,5,1,20,9,5,19,20,121
19,23,5,1,20,9,12,25,0,114
19,23,5,1,20,9,14,7,0,98
19,23,5,1,20,12,5,19,19,123
19,23,5,1,20,19,0,0,0,87
19,23,5,1,20,19,8,15,16,126
19,23,5,1,20,23,5,5,4,105
19,23,5,4,5,19,0,0,0,75
19,23,5,4,7,5,0,0,0,63
19,23,5,4,7,5,18,0,0,81
19,23,5,4,18,21,0,0,0,90
19,23,5,5,14,9,5,19,0,99
19,23,5,5,14,19,0,0,0,85
19,23,5,5,16,0,0,0,0,68
19,23,5,5,16,1,2,12,5,88
19,23,5,5,16,1,7,5,0,81
19,23,5,5,16,2,1,3,11,85
19,23,5,5,16,4,15,13,0,100
19,23,5,5,16,5,18,0,0,91
19,23,5,5,16,5,18,19,0,110
19,23,5,5,16,25,0,0,0,93
19,23,5,5,16,9,5,18,0,100
19,23,5,5,16,9,5,19,20,121
19,23,5,5,16,9,14,7,0,98
19,23,5,5,16,9,14,7,19,117
19,23,5,5,16,19,0,0,0,87
19,23,5,5,16,21,16,0,0,105
19,23,5,5,18,0,0,0,0,70
19,23,5,5,18,5,4,0,0,79
19,23,5,5,18,20,0,0,0,90
19,23,5,5,19,5,0,0,0,76
19,23,5,5,19,23,5,5,0,104
19,23,5,5,20,5,14,0,0,91
19,23,5,5,20,5,14,5,4,100
19,23,5,5,20,5,14,5,18,114
19,23,5,5,20,5,14,19,0,110
19,23,5,5,20,5,18,0,0,95
19,23,5,5,20,5,19,20,0,116
19,23,5,5,20,6,9,19,8,114
19,23,5,5,20,6,21,12,0,111
19,23,5,5,20,25,0,0,0,97
19,23,5,5,20,9,5,0,0,86
19,23,5,5,20,9,5,19,0,105
19,23,5,5,20,9,14,7,0,102
19,23,5,5,20,9,14,7,19,121
19,23,5,5,20,9,19,8,0,108
19,23,5,5,20,11,9,14,19,125
19,23,5,5,20,12,5,1,6,96
19,23,5,5,20,12,5,19,19,127
19,23,5,5,20,12,25,0,0,109
19,23,5,5,20,12,9,11,5,109
19,23,5,5,20,12,9,14,7,114
19,23,5,5,20,13,1,14,0,100
19,23,5,5,20,13,5,1,12,103
19,23,5,5,20,13,5,1,20,111
19,23,5,5,20,14,5,19,19,129
19,23,5,5,20,18,15,15,20,140
19,23,5,5,20,19,0,0,0,91
19,23,5,5,20,19,8,15,16,130
19,23,5,5,20,19,15,13,5,124
19,23,5,5,20,19,15,16,0,122
19,23,5,5,20,19,15,16,19,141
19,23,5,5,20,23,5,5,4,109
19,23,5,5,20,23,15,15,4,129
19,23,5,5,20,23,15,18,20,148
19,23,5,7,15,0,0,0,0,69
19,23,5,12,3,8,9,5,0,84
19,23,5,12,12,0,0,0,0,71
19,23,5,12,12,1,7,5,0,84
19,23,5,12,12,4,15,13,0,103
19,23,5,12,12,5,4,0,0,80
19,23,5,12,12,5,18,0,0,94
19,23,5,12,12,5,19,20,0,115
19,23,5,12,12,6,9,19,8,113
19,23,5,12,12,8,5,1,4,89
19,23,5,12,12,25,0,0,0,96
19,23,5,12,12,9,14,7,0,101
19,23,5,12,12,9,14,7,19,120
19,23,5,12,12,9,19,8,0,107
19,23,5,12,12,14,5,19,19,128
19,23,5,12,12,19,0,0,0,90
19,23,5,12,12,20,15,1,4,111
19,23,5,12,16,0,0,0,0,75
19,23,5,12,20,0,0,0,0,79
19,23,5,12,20,5,18,0,0,102
19,23,5,12,20,5,18,5,4,111
19,23,5,12,20,5,18,5,18,125
19,23,5,12,20,5,18,19,0,121
19,23,5,12,20,8,0,0,0,87
19,23,5,12,20,25,0,0,0,104
19,23,5,12,20,18,25,0,0,122
19,23,5,12,20,18,9,5,18,129
19,23,5,16,0,0,0,0,0,63
19,23,5,16,20,0,0,0,0,83
19,23,5,16,20,2,1,3,11,100
19,23,5,16,20,23,9,14,7,136
19,23,5,18,4,0,0,0,0,69
19,23,5,18,22,1,2,12,5,107
19,23,5,18,22,5,0,0,0,92
19,23,5,18,22,5,4,0,0,96
19,23,5,18,22,5,18,0,0,110
19,23,5,18,22,5,18,19,0,129
19,23,5,18,22,5,19,0,0,111
19,23,5,18,22,9,12,25,0,133
19,23,5,18,22,9,14,7,0,117
19,23,5,22,5,14,0,0,0,88
19,23,5,22,5,14,19,0,0,107
19,23,25,0,0,0,0,0,0,67
19,23,9,3,11,0,0,0,0,65
19,23,9,4,4,5,14,0,0,78
19,23,9,4,4,5,14,19,0,97
19,23,9,4,7,5,0,0,0,67
19,23,9,6,20,5,14,0,0,96
19,23,9,6,20,5,18,0,0,100
19,23,9,6,20,5,18,19,0,119
19,23,9,6,20,5,19,20,0,121
19,23,9,6,20,6,15,15,20,133
19,23,9,6,20,25,0,0,0,102
19,23,9,6,20,9,1,14,0,101
19,23,9,6,20,9,5,0,0,91
19,23,9,6,20,12,5,20,0,114
19,23,9,6,20,12,25,0,0,114
19,23,9,6,20,12,9,5,18,121
19,23,9,6,20,12,9,11,5,114
19,23,9,6,20,14,5,19,19,134
19,23,9,6,20,19,0,0,0,96
19,23,9,7,0,0,0,0,0,58
19,23,9,7,7,5,4,0,0,74
19,23,9,7,7,5,18,0,0,88
19,23,9,7,7,5,18,19,0,107
19,23,9,7,7,9,14,7,0,95
19,23,9,7,7,12,5,0,0,82
19,23,9,7,19,0,0,0,0,77
19,23,9,12,5,0,0,0,0,68
19,23,9,12,11,9,5,0,0,88
19,23,9,12,12,0,0,0,0,75
19,23,9,12,12,2,15,23,12,127
19,23,9,12,12,5,4,0,0,84
19,23,9,12,12,5,18,0,0,98
19,23,9,12,12,5,18,19,0,117
19,23,9,12,12,9,14,7,0,105
19,23,9,12,12,16,15,20,0,126
19,23,9,12,12,19,0,0,0,94
19,23,9,12,12,20,21,2,0,118
19,23,9,13,0,0,0,0,0,64
19,23,9,13,2,5,12,0,0,83
19,23,9,13,25,0,0,0,0,89
19,23,9,13,13,1,2,12,5,97
19,23,9,13,13,5,18,0,0,100
19,23,9,13,13,5,18,5,20,125
19,23,9,13,13,5,18,19,0,119
19,23,9,13,13,25,0,0,0,102
19,23,9,13,13,9,5,18,0,109
19,23,9,13,13,9,5,19,20,130
19,23,9,13,13,9,12,25,0,123
19,23,9,13,13,9,14,7,0,107
19,23,9,13,13,9,14,7,19,126
19,23,9,13,13,9,19,20,0,125
19,23,9,13,19,0,0,0,0,83
19,23,9,13,19,21,9,20,0,133
19,23,9,13,19,21,9,20,19,152
19,23,9,13,23,5,1,18,0,111
19,23,9,14,4,12,5,0,0,86
19,23,9,14,4,12,5,4,0,90
19,23,9,14,4,12,5,18,0,104
19,23,9,14,4,12,5,18,25,129
19,23,9,14,4,12,5,18,19,123
19,23,9,14,4,12,5,19,0,105
19,23,9,14,4,12,9,14,7,111
19,23,9,14,5,0,0,0,0,70
19,23,9,14,5,3,15,20,5,113
19,23,9,14,5,8,5,1,4,88
19,23,9,14,5,8,5,18,4,105
19,23,9,14,5,8,15,15,4,112
19,23,9,14,5,8,21,12,12,123
19,23,9,14,5,25,0,0,0,95
19,23,9,14,5,12,25,0,0,107
19,23,9,14,5,12,9,11,5,107
19,23,9,14,5,16,9,16,5,116
19,23,9,14,5,16,15,24,0,125
19,23,9,14,5,18,25,0,0,113
19,23,9,14,5,19,20,25,0,134
19,23,9,14,7,0,0,0,0,72
19,23,9,14,7,1,2,12,5,92
19,23,9,14,7,1,2,12,25,112
19,23,9,14,7,2,1,3,11,89
19,23,9,14,7,2,25,0,0,99
19,23,9,14,7,2,25,19,0,118
19,23,9,14,7,2,15,1,20,110
19,23,9,14,7,5,0,0,0,77
19,23,9,14,7,5,4,0,0,81
19,23,9,14,7,5,9,14,7,107
19,23,9,14,7,5,12,0,0,89
19,23,9,14,7,5,15,21,18,131
19,23,9,14,7,5,18,0,0,95
19,23,9,14,7,5,18,19,0,114
19,23,9,14,7,5,19,0,0,96
19,23,9,14,7,25,0,0,0,97
19,23,9,14,7,9,5,18,0,104
19,23,9,14,7,9,5,19,20,125
19,23,9,14,7,9,14,7,0,102
19,23,9,14,7,12,5,0,0,89
19,23,9,14,7,12,5,4,0,93
19,23,9,14,7,12,5,19,0,108
19,23,9,14,7,12,9,14,7,114
19,23,9,14,7,13,1,14,0,100
19,23,9,14,7,13,5,14,0,104
19,23,9,14,7,19,0,0,0,91
19,23,9,14,7,20,18,5,5,120
19,23,9,14,9,19,8,0,0,101
19,23,9,14,9,19,8,12,25,138
19,23,9,14,11,5,4,0,0,85
19,23,9,14,11,5,18,0,0,99
19,23,9,14,11,9,14,7,0,106
19,23,9,14,11,19,0,0,0,95
19,23,9,14,14,5,25,0,0,109
19,23,9,14,14,5,25,19,0,128
19,23,9,16,5,0,0,0,0,72
19,23,9,16,5,4,0,0,0,76
19,23,9,16,5,18,0,0,0,90
19,23,9,16,5,19,0,0,0,91
19,23,9,16,25,0,0,0,0,92
19,23,9,16,9,14,7,0,0,97
19,23,9,16,12,5,0,0,0,84
19,23,9,16,12,5,19,0,0,103
19,23,9,16,16,5,18,0,0,106
19,23,9,16,16,12,5,0,0,100
19,23,9,16,16,12,5,19,0,119
19,23,9,18,4,0,0,0,0,73
19,23,9,18,5,0,0,0,0,74
19,23,9,18,12,0,0,0,0,81
19,23,9,18,12,5,4,0,0,90
19,23,9,18,12,25,0,0,0,106
19,23,9,18,12,9,5,18,0,113
19,23,9,18,12,9,5,19,20,134
19,23,9,18,12,9,14,7,0,111
19,23,9,18,12,19,0,0,0,100
19,23,9,18,18,5,18,0,0,110
19,23,9,18,18,9,14,7,0,117
19,23,9,19,8,0,0,0,0,78
19,23,9,19,8,5,4,0,0,87
19,23,9,19,8,5,18,19,0,120
19,23,9,19,8,5,19,0,0,102
19,23,9,19,8,25,0,0,0,103
19,23,9,19,8,9,5,18,0,110
19,23,9,19,8,9,5,19,20,131
19,23,9,19,8,9,14,7,0,108
19,23,9,19,19,5,19,0,0,113
19,23,9,19,19,9,14,7,0,119
19,23,9,20,3,8,0,0,0,82
19,23,9,20,3,8,5,4,0,91
19,23,9,20,3,8,5,12,0,99
19,23,9,20,3,8,5,18,0,105
19,23,9,20,3,8,5,18,19,124
19,23,9,20,3,8,5,19,0,106
19,23,9,20,3,8,25,0,0,107
19,23,9,20,3,8,9,14,7,112
19,23,9,20,3,8,13,1,14,110
19,23,9,20,3,8,13,5,14,114
19,23,9,20,8,0,0,0,0,79
19,23,9,20,8,5,0,0,0,84
19,23,25,20,8,5,0,0,0,100
19,23,9,20,8,5,14,0,0,98
19,23,9,20,8,5,18,0,0,102
19,23,9,20,8,5,18,5,4,111
19,23,9,20,8,5,18,19,0,121
19,23,9,20,8,12,25,0,0,116
19,23,9,22,5,0,0,0,0,78
19,23,9,22,5,4,0,0,0,82
19,23,9,22,5,12,0,0,0,90
19,23,9,22,5,12,5,4,0,99
19,23,9,22,5,12,5,25,5,125
19,23,9,22,5,12,9,14,7,120
19,23,9,22,5,12,12,5,4,111
19,23,9,22,5,12,19,0,0,109
19,23,9,22,5,18,0,0,0,96
19,23,9,22,5,19,0,0,0,97
19,23,9,22,5,20,0,0,0,98
19,23,9,22,5,20,19,0,0,117
19,23,9,22,5,20,20,25,0,143
19,23,9,22,9,14,7,0,0,103
19,23,9,23,5,20,0,0,0,99
19,23,9,26,0,0,0,0,0,77
19,23,9,26,26,0,0,0,0,103
19,23,9,26,26,12,5,0,0,120
19,23,9,26,26,12,5,4,0,124
19,23,9,26,26,12,5,18,0,138
19,23,9,26,26,12,5,18,19,157
19,23,9,26,26,12,5,19,0,139
19,23,9,26,26,12,9,14,7,145
19,23,12,5,1,22,5,19,0,106
19,23,15,2,0,0,0,0,0,59
19,23,15,2,2,5,4,0,0,70
19,23,15,2,2,5,18,0,0,84
19,23,15,2,2,5,18,19,0,103
19,23,15,2,2,9,14,7,0,91
19,23,15,2,19,0,0,0,0,78
19,23,15,12,12,5,14,0,0,100
19,23,15,12,12,5,14,12,25,137
19,23,15,12,14,0,0,0,0,83
19,23,15,13,0,0,0,0,0,70
19,23,15,14,11,0,0,0,0,82
19,23,15,14,11,5,14,0,0,101
19,23,15,15,14,5,4,0,0,95
19,23,15,15,14,5,18,0,0,109
19,23,15,15,14,5,18,19,0,128
19,23,15,15,14,25,0,0,0,111
19,23,15,15,14,9,14,7,0,116
19,23,15,15,14,19,0,0,0,105
19,23,15,15,16,0,0,0,0,88
19,23,15,15,16,5,4,0,0,97
19,23,15,15,16,5,18,0,0,111
19,23,15,15,16,5,18,19,0,130
19,23,15,15,16,9,14,7,0,118
19,23,15,15,16,19,0,0,0,107
19,23,15,15,19,5,0,0,0,96
19,23,15,15,19,5,19,0,0,115
19,23,15,15,19,8,0,0,0,99
19,23,15,15,19,8,5,4,0,108
19,23,15,15,19,8,5,19,0,123
19,23,15,15,19,8,9,14,7,129
19,23,15,16,0,0,0,0,0,73
19,23,15,16,16,5,4,0,0,98
19,23,15,16,16,9,14,7,0,119
19,23,15,16,19,0,0,0,0,92
19,23,15,18,4,0,0,0,0,79
19,23,15,18,4,2,9,12,12,114
19,23,15,18,4,5,4,0,0,88
19,23,15,18,4,5,18,0,0,102
19,23,15,18,4,6,9,19,8,121
19,23,15,18,4,9,3,11,0,102
19,23,15,18,4,9,14,7,0,109
19,23,15,18,4,11,14,15,20,139
19,23,15,18,4,12,5,19,19,134
19,23,15,18,4,12,5,20,0,116
19,23,15,18,4,12,9,11,5,116
19,23,15,18,4,13,1,14,0,107
19,23,15,18,4,13,5,14,0,111
19,23,15,18,4,16,12,1,25,133
19,23,15,18,4,19,13,1,14,126
19,23,15,18,4,19,13,5,14,130
19,23,15,18,4,19,20,5,18,141
19,23,15,18,4,20,1,9,12,121
19,23,15,18,4,23,5,5,4,116
19,23,15,18,5,0,0,0,0,80
19,23,15,18,14,0,0,0,0,89
19,23,15,19,8,0,0,0,0,84
19,23,15,20,0,0,0,0,0,77
19,23,15,20,19,0,0,0,0,96
19,23,15,20,20,5,4,0,0,106
19,23,15,20,20,5,18,0,0,120
19,23,15,20,20,5,18,19,0,139
19,23,15,20,20,9,14,7,0,127
19,23,15,21,7,8,0,0,0,93
19,23,15,21,14,0,0,0,0,92
19,23,15,21,14,4,0,0,0,96
19,23,15,21,14,4,5,4,0,105
19,23,15,21,14,4,9,14,7,126
19,23,15,21,14,4,19,0,0,115
19,23,15,21,14,5,4,0,0,101
19,23,15,21,14,9,14,7,0,122
19,23,15,21,14,19,0,0,0,111
19,23,15,23,0,0,0,0,0,80
19,23,21,13,0,0,0,0,0,76
19,23,21,14,7,0,0,0,0,84
19,23,21,14,7,5,14,0,0,103
19,23,21,18,5,0,0,0,0,86
19,26,12,1,3,8,20,1,0,90
19,26,15,16,5,12,11,1,0,105
20,2,19,16,0,0,0,0,0,57
20,3,8,0,0,0,0,0,0,31
20,3,8,1,9,0,0,0,0,41
20,3,8,1,16,1,14,0,0,63
20,3,8,1,18,9,11,0,0,70
20,3,8,1,19,20,0,0,0,71
20,3,8,5,0,0,0,0,0,36
20,3,8,5,3,11,21,16,0,87
20,3,8,5,9,18,5,11,0,79
20,3,8,5,20,22,5,18,20,121
20,3,8,9,3,11,0,0,0,54
20,3,8,9,14,3,15,21,0,93
20,3,8,18,0,0,0,0,0,49
20,3,8,21,0,0,0,0,0,52
20,3,11,0,0,0,0,0,0,34
20,5,2,2,1,4,0,0,0,34
20,5,2,2,5,20,0,0,0,54
20,5,2,5,12,4,9,0,0,57
20,5,3,1,12,9,0,0,0,50
20,5,3,1,19,19,9,18,0,94
20,5,3,8,5,4,0,0,0,45
20,5,3,8,25,0,0,0,0,61
20,5,3,8,9,5,0,0,0,50
20,5,3,8,9,5,18,0,0,68
20,5,3,8,9,5,19,0,0,69
20,5,3,8,9,5,19,20,0,89
20,5,3,8,9,12,25,0,0,82
20,5,3,8,9,14,5,19,19,102
20,5,3,8,14,5,0,0,0,55
20,5,3,8,14,9,3,0,0,62
20,5,3,8,14,9,3,1,0,63
20,5,3,8,14,9,3,1,12,75
20,5,3,8,14,9,3,15,14,91
20,5,3,8,14,9,3,19,0,81
20,5,3,8,14,9,17,21,5,102
20,5,3,8,14,9,19,13,0,91
20,5,3,8,14,9,19,20,0,98
20,5,3,8,14,15,12,0,0,77
20,5,3,8,15,21,19,0,0,91
20,5,3,11,0,0,0,0,0,39
20,5,3,14,15,12,15,7,25,116
20,5,3,15,13,9,14,0,0,79
20,5,3,15,14,0,0,0,0,57
20,5,3,20,1,0,0,0,0,49
20,5,3,20,1,12,0,0,0,61
20,5,3,20,9,6,15,18,13,109
20,5,3,20,9,20,5,0,0,82
20,5,3,20,9,20,5,19,0,101
20,5,3,20,15,12,15,7,25,122
20,5,3,20,15,14,9,3,0,89
20,5,3,20,15,14,9,3,19,108
20,5,3,20,15,14,9,19,13,118
20,5,3,20,15,18,9,1,12,103
20,5,3,20,15,18,9,21,13,124
20,5,3,20,18,9,3,5,19,102
20,5,3,20,18,9,24,0,0,99
20,5,3,20,21,13,0,0,0,82
20,5,3,20,21,18,5,0,0,92
20,5,3,21,13,0,0,0,0,62
20,5,3,21,13,1,0,0,0,63
20,5,4,4,5,4,0,0,0,42
20,5,4,4,5,18,19,0,0,75
20,5,4,4,9,5,19,0,0,66
20,5,4,4,9,14,7,0,0,63
20,5,4,5,19,3,1,0,0,57
20,5,4,5,19,3,1,14,0,71
20,5,4,5,19,3,8,5,0,69
20,5,4,5,19,3,8,9,0,73
20,5,4,5,19,3,15,0,0,71
20,5,4,7,5,0,0,0,0,41
20,5,4,9,15,19,9,20,25,126
20,5,4,9,15,21,19,0,0,93
20,5,4,9,15,21,19,12,25,130
20,5,4,9,19,15,13,5,0,90
20,5,4,9,21,13,0,0,0,72
20,5,4,9,21,13,19,0,0,91
20,5,4,19,0,0,0,0,0,48
20,5,5,0,0,0,0,0,0,30
20,5,5,3,1,12,12,0,0,58
20,5,5,4,0,0,0,0,0,34
20,5,5,4,12,5,0,0,0,51
20,5,5,9,14,7,0,0,0,60
20,5,5,12,0,0,0,0,0,42
20,5,5,12,19,0,0,0,0,61
20,5,5,13,0,0,0,0,0,43
20,5,5,13,5,4,0,0,0,52
20,5,5,13,5,18,0,0,0,66
20,5,5,13,5,18,19,0,0,85
20,5,5,13,6,21,12,0,0,82
20,5,5,13,9,14,7,0,0,73
20,5,5,13,9,14,7,12,25,110
20,5,5,13,12,5,19,19,0,98
20,5,5,13,19,0,0,0,0,62
20,5,5,14,0,0,0,0,0,44
20,5,5,14,1,7,5,0,0,57
20,5,5,14,1,7,5,4,0,61
20,5,5,14,1,7,5,18,0,75
20,5,5,14,1,7,5,18,19,94
20,5,5,14,5,18,0,0,0,67
20,5,5,14,5,18,19,0,0,86
20,5,5,14,5,20,0,0,0,69
20,5,5,14,6,21,12,0,0,83
20,5,5,14,6,21,12,12,25,120
20,5,5,14,6,21,12,19,0,102
20,5,5,14,25,0,0,0,0,69
20,5,5,14,25,2,15,16,0,102
20,5,5,14,9,5,0,0,0,58
20,5,5,14,9,5,18,0,0,76
20,5,5,14,9,5,19,20,0,97
20,5,5,14,9,19,8,0,0,80
20,5,5,14,19,0,0,0,0,63
20,5,5,14,19,25,0,0,0,88
20,5,5,14,19,9,5,18,0,95
20,5,5,14,19,9,5,19,20,116
20,5,5,14,20,25,0,0,0,89
20,5,5,14,20,19,25,0,0,108
20,5,5,14,20,19,9,5,18,115
20,5,5,16,5,5,0,0,0,56
20,5,5,16,5,5,19,0,0,75
20,5,5,18,0,0,0,0,0,48
20,5,5,18,5,18,0,0,0,71
20,5,5,19,20,0,0,0,0,69
20,5,5,20,0,0,0,0,0,50
20,5,5,20,1,12,12,5,18,98
20,5,5,20,1,14,0,0,0,65
20,5,5,20,5,5,0,0,0,60
20,5,5,20,5,18,5,4,0,82
20,5,5,20,5,18,5,18,0,96
20,5,5,20,5,18,25,0,0,98
20,5,5,20,5,18,9,14,7,103
20,5,5,20,5,18,19,0,0,92
20,5,5,20,8,0,0,0,0,58
20,5,5,20,8,1,3,8,5,75
20,5,5,20,8,5,0,0,0,63
20,5,5,20,8,5,4,0,0,67
20,5,5,20,8,5,18,0,0,81
20,5,5,20,8,5,18,19,0,100
20,5,5,20,8,5,19,0,0,82
20,5,5,20,8,6,21,12,0,97
20,5,5,20,8,25,0,0,0,83
20,5,5,20,8,9,5,18,0,90
20,5,5,20,8,9,5,19,20,111
20,5,5,20,8,9,12,25,0,104
20,5,5,20,8,9,14,7,0,88
20,5,5,20,8,9,14,7,19,107
20,5,5,20,8,12,5,19,19,113
20,5,5,20,8,12,9,11,5,95
20,5,5,20,25,0,0,0,0,75
20,5,5,20,9,14,7,0,0,80
20,5,5,20,15,20,1,12,0,98
20,5,5,20,15,20,1,12,19,117
20,5,5,20,15,20,21,13,0,119
20,5,5,20,15,20,21,13,19,138
20,5,5,20,19,15,15,11,0,110
20,5,5,22,5,5,0,0,0,62
20,5,5,23,8,1,1,16,0,79
20,5,6,0,0,0,0,0,0,31
20,5,6,6,0,0,0,0,0,37
20,5,6,6,19,0,0,0,0,56
20,5,6,9,12,12,9,14,0,87
20,5,7,0,0,0,0,0,0,32
20,5,7,7,0,0,0,0,0,39
20,5,7,13,5,14,0,0,0,64
20,5,7,13,5,14,20,0,0,84
20,5,7,13,5,14,20,1,0,85
20,5,7,13,5,14,20,1,12,97
20,5,7,13,5,14,20,21,13,118
20,5,7,13,9,14,1,0,0,69
20,5,7,13,9,14,1,12,0,81
20,5,7,19,0,0,0,0,0,51
20,5,7,21,1,0,0,0,0,54
20,5,7,21,1,19,0,0,0,73
20,5,7,21,5,24,9,14,0,105
20,5,7,21,7,21,18,9,1,109
20,5,7,21,12,1,0,0,0,66
20,5,7,21,12,1,5,0,0,71
20,5,7,21,12,1,18,0,0,84
20,5,7,21,12,1,18,12,25,121
20,5,7,21,12,1,20,5,4,95
20,5,7,21,13,5,14,0,0,85
20,5,7,21,13,5,14,20,0,105
20,5,7,21,13,5,14,20,1,106
20,5,7,21,13,5,14,20,19,124
20,5,7,21,13,9,14,1,0,90
20,5,7,21,18,9,1,0,0,81
20,5,7,21,18,9,21,13,0,114
20,5,8,5,5,0,0,0,0,43
20,5,8,19,5,5,12,0,0,74
20,5,8,19,9,12,0,0,0,73
20,5,8,19,9,12,4,1,18,96
20,5,9,3,8,5,18,0,0,68
20,5,9,7,12,1,3,8,0,65
20,5,9,7,12,5,3,8,0,69
20,5,9,8,20,5,0,0,0,67
20,5,9,9,4,0,0,0,0,47
20,5,9,9,4,19,0,0,0,66
20,5,9,12,0,0,0,0,0,46
20,5,9,14,4,0,0,0,0,52
20,5,9,14,4,1,2,12,5,72
20,5,9,14,4,5,18,0,0,75
20,5,9,14,4,19,0,0,0,71
20,5,9,14,12,1,14,4,0,79
20,5,9,15,9,4,0,0,0,62
20,5,9,19,5,0,0,0,0,58
20,5,10,1,14,15,0,0,0,65
20,5,10,21,0,0,0,0,0,56
20,5,11,5,4,25,5,0,0,75
20,5,11,25,1,0,0,0,0,62
20,5,11,9,1,8,0,0,0,54
20,5,11,11,5,14,0,0,0,66
20,5,11,14,15,14,25,13,25,142
20,5,11,20,9,20,5,0,0,90
20,5,11,20,9,20,5,19,0,109
20,5,11,20,9,20,9,3,0,97
20,5,11,20,15,19,0,0,0,90
20,5,11,20,15,19,9,0,0,99
20,5,11,20,15,19,9,12,0,111
20,5,12,1,0,0,0,0,0,38
20,5,12,1,5,0,0,0,0,43
20,5,12,1,11,21,3,8,1,82
20,5,12,1,13,15,14,5,19,104
20,5,12,1,14,7,0,0,0,59
20,5,12,1,18,0,0,0,0,56
20,5,12,1,18,25,0,0,0,81
20,5,12,1,18,9,1,14,0,80
20,5,12,1,18,12,25,0,0,93
20,5,12,5,0,0,0,0,0,42
20,5,12,5,2,12,5,13,0,74
20,5,12,5,3,1,19,20,0,85
20,5,12,5,3,1,19,20,19,104
20,5,12,5,3,15,4,5,0,69
20,5,12,5,3,15,13,13,0,86
20,5,12,5,3,15,14,0,0,74
20,5,12,5,4,21,0,0,0,67
20,5,12,5,4,21,19,0,0,86
20,5,12,5,6,9,12,13,0,82
20,5,12,5,6,9,12,13,19,101
20,5,12,5,7,0,0,0,0,49
20,5,12,5,7,1,0,0,0,50
20,5,12,5,7,1,19,0,0,69
20,5,12,5,7,5,14,9,3,80
20,5,12,5,7,15,14,25,0,103
20,5,12,5,7,15,14,9,3,90
20,5,12,5,7,18,1,6,0,74
20,5,12,5,7,18,1,13,0,81
20,5,12,5,7,18,1,13,19,100
20,5,12,5,7,18,1,16,8,92
20,5,12,5,9,15,19,9,19,113
20,5,12,5,12,5,14,19,0,92
20,5,12,5,13,1,14,0,0,70
20,5,12,5,13,1,18,11,19,104
20,5,12,5,13,5,14,0,0,74
20,5,12,5,13,5,20,5,18,103
20,5,12,5,13,5,20,18,25,123
20,5,12,5,13,15,20,15,18,123
20,5,12,5,14,5,18,7,25,111
20,5,12,5,15,4,15,14,20,110
20,5,12,5,15,12,15,7,25,116
20,5,12,5,15,19,1,21,18,116
20,5,12,5,15,19,20,0,0,96
20,5,12,5,15,19,20,19,0,115
20,5,12,5,15,26,15,9,3,110
20,5,12,5,15,26,15,15,14,127
20,5,12,5,16,1,20,8,0,87
20,5,12,5,16,1,20,8,25,112
20,5,12,5,16,8,0,0,0,66
20,5,12,5,16,8,5,13,5,89
20,5,12,5,16,8,15,14,5,100
20,5,12,5,16,8,15,14,25,120
20,5,12,5,16,8,15,20,5,106
20,5,12,5,16,8,15,20,25,126
20,5,12,5,16,12,1,25,0,96
20,5,12,5,16,12,1,25,19,115
20,5,12,5,16,12,1,19,13,103
20,5,12,5,16,15,18,20,0,111
20,5,12,5,16,15,18,20,19,130
20,5,12,5,16,15,19,20,0,112
20,5,12,5,18,1,14,19,0,94
20,5,12,5,18,7,25,0,0,92
20,5,12,5,18,7,9,3,0,79
20,5,12,5,19,0,0,0,0,61
20,5,12,5,19,3,15,16,5,100
20,5,12,5,19,3,15,16,25,120
20,5,12,5,19,5,9,19,13,107
20,5,12,5,19,5,13,5,0,84
20,5,12,5,19,5,19,0,0,85
20,5,12,5,19,9,1,0,0,71
20,5,12,5,19,9,19,0,0,89
20,5,12,5,19,13,0,0,0,74
20,5,12,5,19,20,9,1,12,103
20,5,12,5,19,20,9,3,0,93
20,5,12,5,19,20,9,3,8,101
20,5,12,5,20,1,16,5,0,84
20,5,12,5,20,5,24,0,0,91
20,5,12,5,20,5,24,20,0,111
20,5,12,5,20,8,15,14,0,99
20,5,12,5,20,8,15,14,19,118
20,5,12,5,20,25,16,5,4,112
20,5,12,5,20,25,16,5,18,126
20,5,12,5,20,25,16,5,19,127
20,5,12,5,20,21,2,5,0,90
20,5,12,5,21,20,15,0,0,98
20,5,12,5,22,9,5,23,0,101
20,5,12,5,22,9,5,23,19,120
20,5,12,5,22,9,19,5,0,97
20,5,12,5,22,9,19,5,4,101
20,5,12,5,22,9,19,5,19,116
20,5,12,5,22,9,19,15,18,125
20,5,12,5,22,15,3,1,12,95
20,5,12,5,22,15,24,0,0,103
20,5,12,5,24,5,4,0,0,75
20,5,12,5,24,5,19,0,0,90
20,5,12,5,24,9,14,7,0,96
20,5,12,6,1,9,18,9,3,83
20,5,12,6,5,18,1,7,5,79
20,5,12,6,5,18,5,4,0,75
20,5,12,6,5,18,9,14,7,96
20,5,12,6,5,18,19,0,0,85
20,5,12,6,15,18,4,19,0,99
20,5,12,9,0,0,0,0,0,46
20,5,12,9,1,0,0,0,0,47
20,5,12,9,1,12,0,0,0,59
20,5,12,9,3,0,0,0,0,49
20,5,12,9,3,1,12,0,0,62
20,5,12,9,3,1,12,12,25,99
20,5,12,25,14,0,0,0,0,76
20,5,12,9,21,13,0,0,0,80
20,5,12,12,1,2,12,5,0,69
20,5,12,12,1,3,8,0,0,61
20,5,12,12,5,5,0,0,0,59
20,5,12,12,5,14,0,0,0,68
20,5,12,12,5,18,19,0,0,91
20,5,12,12,25,0,0,0,0,74
20,5,12,12,9,5,19,0,0,82
20,5,12,12,9,5,19,5,19,106
20,5,12,12,9,14,0,0,0,72
20,5,12,12,9,14,7,0,0,79
20,5,12,12,9,14,7,12,25,116
20,5,12,12,9,14,15,9,4,100
20,5,12,12,25,19,0,0,0,93
20,5,12,12,19,0,0,0,0,68
20,5,12,12,19,15,13,5,0,101
20,5,12,12,20,0,0,0,0,69
20,5,12,12,20,1,12,5,0,87
20,5,12,12,20,1,12,5,19,106
20,5,12,12,20,18,21,20,8,136
20,5,12,12,21,18,1,12,0,101
20,5,12,12,21,18,1,20,5,114
20,5,12,12,21,18,5,20,0,113
20,5,12,12,21,18,9,1,14,112
20,5,12,12,21,18,9,3,0,100
20,5,12,12,21,18,9,15,14,126
20,5,12,12,21,18,9,19,13,129
20,5,12,12,21,18,9,19,20,136
20,5,12,12,21,18,9,20,5,122
20,5,12,12,21,18,9,21,13,131
20,5,12,12,21,18,9,26,5,128
20,5,12,12,21,18,15,21,19,143
20,5,12,15,2,12,1,19,20,106
20,5,12,15,9,0,0,0,0,61
20,5,12,15,12,5,13,13,1,96
20,5,12,15,13,5,0,0,0,70
20,5,12,15,13,5,18,5,0,93
20,5,12,15,13,5,19,0,0,89
20,5,12,15,13,9,3,0,0,77
20,5,12,15,13,9,20,9,3,106
20,5,12,15,14,9,19,13,0,107
20,5,12,15,16,8,1,19,5,101
20,5,12,15,16,19,9,19,0,115
20,5,12,15,16,20,9,3,0,100
20,5,12,15,19,0,0,0,0,71
20,5,12,15,20,1,24,9,19,125
20,5,12,15,20,25,16,5,0,118
20,5,12,15,20,18,15,3,8,116
20,5,12,16,1,20,8,0,0,82
20,5,12,16,8,5,18,0,0,84
20,5,12,16,8,5,18,5,4,93
20,5,12,16,8,5,18,9,3,96
20,5,12,16,8,5,18,19,0,103
20,5,12,19,0,0,0,0,0,56
20,5,12,19,15,14,0,0,0,85
20,5,12,19,15,14,9,3,0,97
20,5,12,19,15,14,19,0,0,104
20,5,12,20,0,0,0,0,0,57
20,5,12,21,18,7,25,0,0,108
20,5,13,1,3,8,1,0,0,51
20,5,13,1,4,1,21,0,0,65
20,5,13,2,5,0,0,0,0,45
20,5,13,2,5,20,1,0,0,66
20,5,13,2,5,20,1,18,1,85
20,5,13,2,12,15,18,0,0,85
20,5,13,2,12,15,18,5,19,109
20,5,13,2,12,15,18,19,0,104
20,5,13,5,14,5,0,0,0,62
20,5,13,5,14,15,19,0,0,91
20,5,13,5,18,1,20,5,0,87
20,5,13,5,18,9,20,25,0,115
20,5,13,5,18,15,21,19,0,116
20,5,13,5,19,3,1,12,0,78
20,5,13,9,1,11,0,0,0,59
20,5,13,9,14,0,0,0,0,61
20,5,13,16,5,8,0,0,0,67
20,5,13,16,5,8,19,0,0,86
20,5,13,16,5,18,0,0,0,77
20,5,13,16,5,18,1,0,0,78
20,5,13,16,5,18,1,19,0,97
20,5,13,16,5,18,1,20,5,103
20,5,13,16,5,18,5,4,0,86
20,5,13,16,5,18,5,18,0,100
20,5,13,16,5,18,5,18,19,119
20,5,13,16,5,18,25,0,0,102
20,5,13,16,5,18,9,14,7,107
20,5,13,16,5,18,9,19,8,113
20,5,13,16,5,18,19,0,0,96
20,5,13,16,5,19,20,5,4,107
20,5,13,16,5,19,20,25,0,123
20,5,13,16,5,19,20,19,0,117
20,5,13,16,5,20,5,0,0,84
20,5,13,16,9,0,0,0,0,63
20,5,13,16,12,1,18,25,0,110
20,5,13,16,12,1,18,19,0,104
20,5,13,16,12,1,20,5,0,92
20,5,13,16,12,1,20,5,18,110
20,5,13,16,12,1,20,5,19,111
20,5,13,16,12,5,4,0,0,75
20,5,13,16,12,5,6,21,12,110
20,5,13,16,12,5,19,0,0,90
20,5,13,16,12,5,20,0,0,91
20,5,13,16,12,5,20,19,0,110
20,5,13,16,12,9,26,5,0,106
20,5,13,16,12,15,14,0,0,95
20,5,13,16,12,21,13,0,0,100
20,5,13,16,15,18,1,0,0,88
20,5,13,16,15,18,1,12,0,100
20,5,13,16,15,18,1,12,5,105
20,5,13,16,15,18,1,12,19,119
20,5,13,16,15,18,1,18,25,131
20,5,13,16,15,18,5,0,0,92
20,5,13,16,15,18,9,19,5,120
20,5,13,16,15,18,9,19,20,135
20,5,13,16,15,18,9,26,5,127
20,5,13,16,15,19,0,0,0,88
20,5,13,16,18,5,0,0,0,77
20,5,13,16,18,5,12,25,0,114
20,5,13,16,19,0,0,0,0,73
20,5,13,16,20,0,0,0,0,74
20,5,13,16,20,1,2,12,5,94
20,5,13,16,20,5,4,0,0,83
20,5,13,16,20,5,18,19,0,116
20,5,13,16,20,9,14,7,0,104
20,5,13,16,20,18,5,19,19,135
20,5,13,16,20,19,0,0,0,93
20,5,13,16,20,19,15,13,5,126
20,5,13,16,21,18,1,0,0,94
20,5,13,16,21,18,1,19,0,113
20,5,13,16,21,19,0,0,0,94
20,5,13,19,5,0,0,0,0,62
20,5,13,19,5,12,15,1,6,96
20,5,13,19,5,18,0,0,0,80
20,5,13,21,12,5,14,3,5,98
20,5,13,21,12,5,14,3,25,118
20,5,13,21,12,5,14,20,0,110
20,5,14,1,2,12,5,0,0,59
20,5,14,1,2,12,25,0,0,79
20,5,14,1,3,5,0,0,0,48
20,5,14,1,3,5,19,0,0,67
20,5,14,1,3,25,0,0,0,68
20,5,14,1,3,9,15,21,19,107
20,5,14,1,3,9,20,25,0,97
20,5,14,1,3,12,5,0,0,60
20,5,14,1,3,21,12,1,0,77
20,5,14,1,3,21,12,21,13,110
20,5,14,1,9,0,0,0,0,49
20,5,14,1,9,12,0,0,0,61
20,5,14,1,9,12,12,5,0,78
20,5,14,1,9,12,12,5,19,97
20,5,14,1,9,12,12,15,14,102
20,5,14,1,9,12,19,0,0,80
20,5,14,1,9,13,0,0,0,62
20,5,14,1,12,7,9,1,0,69
20,5,14,1,14,3,25,0,0,82
20,5,14,1,14,3,9,5,19,90
20,5,14,1,14,20,0,0,0,74
20,5,14,1,14,20,5,4,0,83
20,5,14,1,14,20,5,18,0,97
20,5,14,1,14,20,9,14,7,104
20,5,14,1,14,20,9,19,13,115
20,5,14,1,14,20,18,25,0,117
20,5,14,1,14,20,19,0,0,93
20,5,14,3,8,5,19,0,0,74
20,5,14,3,8,23,5,5,4,87
20,5,14,4,0,0,0,0,0,43
20,5,14,4,1,2,12,5,0,63
20,5,14,4,1,14,3,5,0,66
20,5,14,4,1,14,3,5,19,85
20,5,14,4,1,14,20,0,0,78
20,5,14,4,5,4,0,0,0,52
20,5,14,4,5,10,15,14,0,87
20,5,14,4,5,14,3,5,0,70
20,5,14,4,5,14,3,5,19,89
20,5,14,4,5,14,3,25,0,90
20,5,14,4,5,14,20,0,0,82
20,5,14,4,5,18,0,0,0,66
20,5,14,4,5,18,5,4,0,75
20,5,14,4,5,18,5,5,0,76
20,5,14,4,5,18,5,18,0,89
20,5,14,4,5,18,5,18,19,108
20,5,14,4,5,18,5,19,20,110
20,5,14,4,5,18,6,21,12,105
20,5,14,4,5,18,9,14,7,96
20,5,14,4,5,18,9,19,5,99
20,5,14,4,5,18,9,19,8,102
20,5,14,4,5,18,9,26,5,106
20,5,14,4,5,18,12,25,0,103
20,5,14,4,5,18,19,0,0,85
20,5,14,4,9,3,12,5,0,72
20,5,14,4,9,4,15,0,0,71
20,5,14,4,9,14,1,12,0,79
20,5,14,4,9,14,5,1,12,84
20,5,14,4,9,14,7,0,0,73
20,5,14,4,9,14,7,12,25,110
20,5,14,4,9,14,15,21,19,121
20,5,14,4,13,5,14,20,0,95
20,5,14,4,15,0,0,0,0,58
20,5,14,4,15,14,0,0,0,72
20,5,14,4,15,14,15,21,19,127
20,5,14,4,15,14,19,0,0,91
20,5,14,4,15,15,18,0,0,91
20,5,14,4,15,20,15,13,5,111
20,5,14,4,15,20,15,13,25,131
20,5,14,4,15,21,18,0,0,97
20,5,14,4,18,1,3,0,0,65
20,5,14,4,18,5,0,0,0,66
20,5,14,4,18,5,12,0,0,78
20,5,14,4,18,5,19,19,5,109
20,5,14,4,18,25,0,0,0,86
20,5,14,4,18,9,12,0,0,82
20,5,14,4,18,9,12,5,4,91
20,5,14,4,18,9,12,12,25,119
20,5,14,4,18,9,12,19,0,101
20,5,14,4,18,15,14,0,0,90
20,5,14,4,19,0,0,0,0,62
20,5,14,5,2,18,1,0,0,65
20,5,14,5,2,18,5,19,0,88
20,5,14,5,2,18,9,15,14,102
20,5,14,5,2,18,9,19,13,105
20,5,14,5,2,18,9,20,25,118
20,5,14,5,2,18,15,19,5,103
20,5,14,5,2,18,15,19,9,107
20,5,14,5,2,18,15,21,19,119
20,5,14,5,3,20,15,13,25,120
20,5,14,5,13,5,14,20,0,96
20,5,14,5,13,5,14,20,19,115
20,5,14,5,14,4,1,0,0,63
20,5,14,5,14,4,1,19,0,82
20,5,14,5,14,4,21,13,0,96
20,5,14,5,14,20,0,0,0,78
20,5,14,5,18,1,12,0,0,75
20,5,14,5,18,9,20,25,0,116
20,5,14,5,19,13,9,3,0,88
20,5,14,5,19,13,21,19,0,116
20,5,14,5,20,0,0,0,0,64
20,5,14,5,20,19,0,0,0,83
20,5,14,5,26,0,0,0,0,70
20,5,14,6,15,12,4,0,0,76
20,5,14,6,15,12,4,19,0,95
20,5,14,7,0,0,0,0,0,46
20,5,14,7,5,18,5,0,0,74
20,5,14,7,5,18,9,20,5,103
20,5,14,7,21,0,0,0,0,67
20,5,14,9,1,0,0,0,0,49
20,5,14,9,1,3,9,4,5,70
20,5,14,9,1,5,0,0,0,54
20,5,14,9,1,6,21,7,5,88
20,5,14,9,1,19,0,0,0,68
20,5,14,9,1,19,9,19,0,96
20,5,14,9,2,12,5,0,0,67
20,5,14,9,5,14,20,5,0,92
20,5,14,9,15,0,0,0,0,63
20,5,14,12,1,0,0,0,0,52
20,5,14,12,9,14,5,0,0,79
20,5,14,14,5,0,0,0,0,58
20,5,14,14,5,18,19,0,0,95
20,5,14,14,9,19,0,0,0,81
20,5,14,14,9,19,4,15,13,113
20,5,14,14,9,19,5,19,0,105
20,5,14,14,9,19,25,0,0,106
20,5,14,14,9,19,20,0,0,101
20,5,14,14,9,19,20,19,0,120
20,5,14,14,15,0,0,0,0,68
20,5,14,14,21,0,0,0,0,74
20,5,14,15,4,5,19,9,19,110
20,5,14,15,4,25,14,9,1,107
20,5,14,15,12,15,7,25,0,113
20,5,14,15,14,0,0,0,0,68
20,5,14,15,14,5,4,0,0,77
20,5,14,15,14,5,18,0,0,91
20,5,14,15,14,5,18,19,0,110
20,5,14,15,14,9,14,7,0,98
20,5,14,15,14,9,20,9,19,125
20,5,14,15,14,19,0,0,0,87
20,5,14,15,16,8,25,20,5,128
20,5,14,15,16,8,15,14,25,132
20,5,14,15,18,0,0,0,0,72
20,5,14,15,18,5,0,0,0,77
20,5,14,15,18,9,14,15,0,110
20,5,14,15,18,9,19,20,0,120
20,5,14,15,18,9,20,5,0,106
20,5,14,15,18,9,20,5,19,125
20,5,14,15,18,12,5,19,19,127
20,5,14,15,18,15,15,14,0,116
20,5,14,15,18,19,0,0,0,91
20,5,14,15,19,9,20,9,19,130
20,5,14,15,20,15,13,5,0,107
20,5,14,15,20,15,13,25,0,127
20,5,14,15,21,18,0,0,0,93
20,5,14,15,21,18,19,0,0,112
20,5,14,16,5,14,3,5,0,82
20,5,14,16,5,14,3,5,19,101
20,5,14,16,5,14,14,25,0,113
20,5,14,16,9,14,0,0,0,78
20,5,14,16,9,14,19,0,0,97
20,5,14,18,5,3,0,0,0,65
20,5,14,18,5,3,19,0,0,84
20,5,14,19,0,0,0,0,0,58
20,5,14,19,1,19,0,0,0,78
20,5,14,19,1,23,0,0,0,82
20,5,14,19,5,0,0,0,0,63
20,5,14,19,5,12,5,19,19,118
20,5,14,19,5,12,25,0,0,100
20,5,14,19,5,14,5,19,19,120
20,5,14,19,5,18,0,0,0,81
20,5,14,19,5,19,0,0,0,82
20,5,14,19,5,19,20,0,0,102
20,5,14,19,9,2,12,5,0,86
20,5,14,19,9,2,12,25,0,106
20,5,14,19,9,6,25,0,0,98
20,5,14,19,9,12,5,0,0,84
20,5,14,19,9,12,5,12,25,121
20,5,14,19,9,12,9,20,25,133
20,5,14,19,9,14,7,0,0,88
20,5,14,19,9,15,14,0,0,96
20,5,14,19,9,15,14,1,12,109
20,5,14,19,9,15,14,5,4,105
20,5,14,19,9,15,14,5,18,119
20,5,14,19,9,15,14,19,0,115
20,5,14,19,9,20,25,0,0,112
20,5,14,19,9,20,9,5,19,120
20,5,14,19,9,22,5,0,0,94
20,5,14,19,15,0,0,0,0,73
20,5,14,19,15,13,5,0,0,91
20,5,14,19,15,14,0,0,0,87
20,5,14,19,15,18,0,0,0,91
20,5,14,19,15,18,9,1,12,113
20,5,14,19,15,18,19,0,0,110
20,5,14,19,16,15,20,0,0,109
20,5,14,19,21,18,5,0,0,102
20,5,14,20,0,0,0,0,0,59
20,5,14,20,1,2,12,5,0,79
20,5,14,20,1,3,12,5,0,80
20,5,14,20,1,3,12,5,4,84
20,5,14,20,1,3,12,5,19,99
20,5,14,20,1,3,21,12,1,97
20,5,14,20,1,7,5,0,0,72
20,5,14,20,1,7,5,19,0,91
20,5,14,20,1,13,5,14,0,92
20,5,14,20,1,20,9,15,14,118
20,5,14,20,1,20,9,22,5,116
20,5,14,20,5,4,0,0,0,68
20,5,14,20,5,18,0,0,0,82
20,5,14,20,5,18,5,4,0,91
20,5,14,20,5,18,5,18,0,105
20,5,14,20,5,18,9,14,7,112
20,5,14,20,5,18,19,0,0,101
20,5,14,20,6,21,12,0,0,98
20,5,14,20,8,0,0,0,0,67
20,5,14,20,8,12,25,0,0,104
20,5,14,20,8,19,0,0,0,86
20,5,14,20,25,0,0,0,0,84
20,5,14,20,9,3,12,5,0,88
20,5,14,20,9,5,0,0,0,73
20,5,14,20,9,5,18,0,0,91
20,5,14,20,9,5,19,20,0,112
20,5,14,20,9,6,15,18,13,120
20,5,14,20,9,7,15,0,0,90
20,5,14,20,9,12,25,0,0,105
20,5,14,20,9,12,12,1,0,93
20,5,14,20,9,12,12,21,13,126
20,5,14,20,9,14,7,0,0,89
20,5,14,20,9,15,14,0,0,97
20,5,14,20,12,5,19,19,0,114
20,5,14,20,12,5,20,0,0,96
20,5,14,20,12,9,11,5,0,96
20,5,14,20,13,1,11,5,18,107
20,5,14,20,13,1,20,5,0,98
20,5,14,20,15,18,0,0,0,92
20,5,14,20,15,18,25,0,0,117
20,5,14,20,15,18,9,1,0,102
20,5,14,20,15,18,9,1,12,114
20,5,14,20,15,18,9,21,13,135
20,5,14,20,19,0,0,0,0,78
20,5,14,20,21,18,5,0,0,103
20,5,14,20,23,1,18,4,19,124
20,5,14,20,23,9,19,5,0,115
20,5,14,20,23,15,18,11,0,126
20,5,14,20,23,15,18,20,0,135
20,5,14,21,1,20,5,0,0,86
20,5,14,21,5,0,0,0,0,65
20,5,14,21,5,19,0,0,0,84
20,5,14,21,9,15,21,19,0,124
20,5,14,21,9,19,0,0,0,88
20,5,14,21,9,20,0,0,0,89
20,5,14,21,9,20,25,0,0,114
20,5,14,21,9,20,9,5,19,122
20,5,14,21,15,21,19,0,0,115
20,5,14,21,15,21,19,12,25,152
20,5,14,21,18,5,0,0,0,83
20,5,14,21,18,5,4,0,0,87
20,5,14,21,18,5,19,0,0,102
20,5,14,21,18,25,0,0,0,103
20,5,14,21,18,9,1,12,0,100
20,5,14,21,20,9,0,0,0,89
20,5,14,21,20,15,0,0,0,95
20,5,14,21,20,15,19,0,0,114
20,5,14,26,15,14,0,0,0,94
20,5,14,26,15,14,5,0,0,99
20,5,15,3,1,12,12,9,0,77
20,5,15,3,1,12,12,9,19,96
20,5,15,16,1,14,0,0,0,71
20,5,15,16,1,14,19,0,0,90
20,5,15,19,9,14,20,5,0,107
20,5,15,19,9,14,20,5,19,126
20,5,16,1,0,0,0,0,0,42
20,5,16,1,3,8,5,0,0,58
20,5,16,1,12,0,0,0,0,54
20,5,16,1,12,19,0,0,0,73
20,5,16,1,18,25,0,0,0,85
20,5,16,1,18,9,5,19,0,93
20,5,16,1,19,0,0,0,0,61
20,5,16,5,0,0,0,0,0,46
20,5,16,5,5,0,0,0,0,51
20,5,16,5,5,19,0,0,0,70
20,5,16,5,6,25,0,0,0,77
20,5,16,5,6,9,5,4,0,70
20,5,16,5,6,9,5,19,0,85
20,5,16,5,6,25,9,14,7,107
20,5,16,5,20,1,20,5,0,92
20,5,16,8,9,12,12,9,13,104
20,5,16,8,9,12,12,9,14,105
20,5,16,8,18,1,0,0,0,68
20,5,16,8,18,1,19,0,0,87
20,5,16,8,18,9,20,5,0,101
20,5,16,8,18,9,20,5,19,120
20,5,16,8,18,9,20,9,3,108
20,5,16,8,18,15,9,20,5,116
20,5,16,8,18,15,19,9,19,129
20,5,16,9,4,0,0,0,0,54
20,5,16,9,4,1,18,9,1,83
20,5,16,9,4,9,20,25,0,108
20,5,16,9,4,12,25,0,0,91
20,5,16,9,4,14,5,19,19,111
20,5,16,15,25,0,0,0,0,81
20,5,16,15,25,19,0,0,0,100
20,5,16,15,18,0,0,0,0,74
20,5,17,21,9,12,1,0,0,85
20,5,17,21,9,12,1,19,0,104
20,5,17,21,9,12,12,1,0,97
20,5,18,1,7,12,9,14,0,86
20,5,18,1,8,5,18,20,26,121
20,5,18,1,9,19,0,0,0,72
20,5,18,1,11,9,8,9,0,81
20,5,18,1,15,8,13,0,0,80
20,5,18,1,15,8,13,19,0,99
20,5,18,1,16,0,0,0,0,60
20,5,18,1,16,8,0,0,0,68
20,5,18,1,16,8,9,13,0,90
20,5,18,1,19,0,0,0,0,63
20,5,18,1,19,19,0,0,0,82
20,5,18,1,20,1,0,0,0,65
20,5,18,1,20,9,3,0,0,76
20,5,18,1,20,9,3,1,12,89
20,5,18,1,20,9,19,13,0,105
20,5,18,1,20,9,19,13,19,124
20,5,18,1,20,15,7,5,14,105
20,5,18,1,20,15,9,4,0,92
20,5,18,1,20,15,13,1,0,93
20,5,18,1,20,15,13,1,19,112
20,5,18,1,20,15,19,9,19,126
20,5,18,2,9,1,0,0,0,55
20,5,18,2,9,1,19,0,0,74
20,5,18,2,9,3,0,0,0,57
20,5,18,2,9,21,13,0,0,88
20,5,18,2,9,21,13,19,0,107
20,5,18,3,5,0,0,0,0,51
20,5,18,3,5,12,0,0,0,63
20,5,18,3,5,12,5,20,0,88
20,5,18,3,5,12,5,20,19,107
20,5,18,3,5,12,19,0,0,82
20,5,18,3,5,18,0,0,0,69
20,5,18,3,5,18,15,14,0,98
20,5,18,3,5,18,15,15,14,113
20,5,18,3,5,19,0,0,0,70
20,5,18,3,5,20,0,0,0,71
20,5,18,3,5,20,19,0,0,90
20,5,18,3,9,1,0,0,0,56
20,5,18,3,9,14,5,0,0,74
20,5,18,3,9,15,0,0,0,70
20,5,18,5,2,1,20,5,0,76
20,5,18,5,2,5,12,12,1,80
20,5,18,5,2,5,14,5,0,74
20,5,18,5,2,5,14,5,19,93
20,5,18,5,2,5,14,9,3,81
20,5,18,5,2,9,3,0,0,62
20,5,18,5,2,9,12,9,3,83
20,5,18,5,2,9,14,9,3,85
20,5,18,5,2,9,14,20,8,101
20,5,18,5,2,18,1,0,0,69
20,5,18,5,2,18,1,5,0,74
20,5,18,5,2,18,1,12,0,81
20,5,18,5,2,18,1,14,20,103
20,5,18,5,2,18,1,19,0,88
20,5,18,5,2,18,1,20,5,94
20,5,18,5,4,9,14,5,19,99
20,5,18,5,4,15,0,0,0,67
20,5,18,5,4,15,19,0,0,86
20,5,18,5,6,1,8,0,0,63
20,5,18,5,11,0,0,0,0,59
20,5,18,5,16,8,1,8,0,81
20,5,18,5,19,0,0,0,0,67
20,5,18,5,20,5,0,0,0,73
20,5,18,5,20,9,1,12,0,90
20,5,18,5,20,9,19,8,0,104
20,5,18,5,20,9,19,13,0,109
20,5,18,5,21,0,0,0,0,69
20,5,18,6,5,26,0,0,0,80
20,5,18,7,1,0,0,0,0,51
20,5,18,7,1,12,0,0,0,63
20,5,18,7,1,14,20,0,0,85
20,5,18,7,9,20,5,0,0,84
20,5,18,7,9,20,5,19,0,103
20,5,18,7,9,20,9,3,0,91
20,5,18,7,21,13,0,0,0,84
20,5,18,9,25,1,11,9,0,98
20,5,18,9,25,1,11,9,19,117
20,5,18,13,1,0,0,0,0,57
20,5,18,13,1,7,5,0,0,69
20,5,18,13,1,12,0,0,0,69
20,5,18,13,1,14,0,0,0,71
20,5,18,13,1,20,9,3,0,89
20,5,18,13,5,4,0,0,0,65
20,5,18,13,5,14,0,0,0,75
20,5,18,13,5,18,0,0,0,79
20,5,18,13,5,18,19,0,0,98
20,5,18,13,9,14,0,0,0,79
20,5,18,13,9,14,1,12,0,92
20,5,18,13,9,14,1,12,19,111
20,5,18,13,9,14,1,14,20,114
20,5,18,13,9,14,1,20,5,105
20,5,18,13,9,14,5,0,0,84
20,5,18,13,9,14,5,18,0,102
20,5,18,13,9,14,7,0,0,86
20,5,18,13,9,14,9,0,0,88
20,5,18,13,9,14,9,14,5,107
20,5,18,13,9,14,9,19,13,120
20,5,18,13,9,14,9,19,20,127
20,5,18,13,9,14,9,26,5,119
20,5,18,13,9,14,15,0,0,94
20,5,18,13,9,20,1,12,0,98
20,5,18,13,9,20,1,18,25,129
20,5,18,13,9,20,5,0,0,90
20,5,18,13,9,20,5,19,0,109
20,5,18,13,9,20,9,3,0,97
20,5,18,13,9,20,9,4,0,98
20,5,18,13,12,5,19,19,0,111
20,5,18,13,12,25,0,0,0,93
20,5,18,13,15,14,0,0,0,85
20,5,18,13,15,18,0,0,0,89
20,5,18,13,15,18,19,0,0,108
20,5,18,13,19,0,0,0,0,75
20,5,18,13,20,9,13,5,0,103
20,5,18,13,20,9,13,5,19,122
20,5,18,13,23,9,19,5,0,112
20,5,18,14,0,0,0,0,0,57
20,5,18,14,1,0,0,0,0,58
20,5,18,14,1,12,0,0,0,70
20,5,18,14,1,18,0,0,0,76
20,5,18,14,1,18,25,0,0,101
20,5,18,14,1,18,9,5,19,109
20,5,18,14,1,20,5,12,25,120
20,5,18,14,5,0,0,0,0,62
20,5,18,14,5,4,0,0,0,66
20,5,18,14,5,18,0,0,0,80
20,5,18,14,5,18,25,0,0,105
20,5,18,14,5,19,0,0,0,81
20,5,18,14,9,14,7,0,0,87
20,5,18,14,9,15,14,0,0,95
20,5,18,14,9,15,14,19,0,114
20,5,18,14,9,26,5,0,0,97
20,5,18,14,12,5,20,0,0,94
20,5,18,14,19,0,0,0,0,76
20,5,18,15,24,9,4,5,0,100
20,5,18,16,0,0,0,0,0,59
20,5,18,16,1,14,5,0,0,79
20,5,18,16,5,14,0,0,0,78
20,5,18,16,5,14,5,0,0,83
20,5,18,16,5,14,5,19,0,102
20,5,18,16,5,14,9,3,0,90
20,5,18,16,5,14,15,9,4,106
20,5,18,16,8,5,14,25,12,123
20,5,18,16,9,12,5,14,5,104
20,5,18,16,9,14,0,0,0,82
20,5,18,16,9,14,5,0,0,87
20,5,18,16,9,14,5,14,5,106
20,5,18,16,9,14,5,15,12,114
20,5,18,16,9,14,15,12,0,109
20,5,18,16,9,14,15,12,19,128
20,5,18,16,15,4,9,15,14,116
20,5,18,18,1,3,5,0,0,70
20,5,18,18,1,3,5,4,0,74
20,5,18,18,1,3,5,18,0,88
20,5,18,18,1,3,5,19,0,89
20,5,18,18,1,3,9,14,7,95
20,5,18,18,1,5,0,0,0,67
20,5,18,18,1,7,5,0,0,74
20,5,18,18,1,9,14,0,0,85
20,5,18,18,1,9,14,19,0,104
20,5,18,18,1,13,1,18,1,95
20,5,18,18,1,13,1,18,5,99
20,5,18,18,1,14,0,0,0,76
20,5,18,18,1,14,5,0,0,81
20,5,18,18,1,14,5,1,14,96
20,5,18,18,1,14,5,19,0,100
20,5,18,18,1,16,9,14,0,101
20,5,18,18,1,16,9,14,19,120
20,5,18,18,1,18,0,0,0,80
20,5,18,18,1,18,9,1,0,90
20,5,18,18,1,18,9,9,1,99
20,5,18,18,1,18,9,21,13,123
20,5,18,18,1,19,0,0,0,81
20,5,18,18,1,19,5,19,0,105
20,5,18,18,1,19,19,5,0,105
20,5,18,18,1,26,26,15,0,129
20,5,18,18,1,26,26,15,19,148
20,5,18,18,5,5,14,0,0,85
20,5,18,18,5,5,14,19,0,104
20,5,18,18,5,9,20,25,0,120
20,5,18,18,5,12,12,1,0,91
20,5,18,18,5,12,12,1,19,110
20,5,18,18,5,14,5,12,25,122
20,5,18,18,5,14,5,19,0,104
20,5,18,18,5,14,15,0,0,95
20,5,18,18,5,15,21,19,0,121
20,5,18,18,5,20,0,0,0,86
20,5,18,18,5,20,5,4,0,95
20,5,18,18,5,20,19,0,0,105
20,5,18,18,9,2,12,5,0,89
20,5,18,18,9,2,12,5,19,108
20,5,18,18,9,2,12,25,0,109
20,5,18,18,9,3,15,12,5,105
20,5,18,18,9,5,18,19,0,112
20,5,18,18,9,5,19,0,0,94
20,5,18,18,9,6,25,0,0,101
20,5,18,18,9,6,9,3,0,88
20,5,18,18,9,6,9,5,4,94
20,5,18,18,9,6,9,5,18,108
20,5,18,18,9,6,9,5,19,109
20,5,18,18,9,7,5,14,5,101
20,5,18,18,9,14,5,0,0,89
20,5,18,18,9,14,5,19,0,108
20,5,18,18,9,20,0,0,0,90
20,5,18,18,9,20,19,0,0,109
20,5,18,18,15,14,0,0,0,90
20,5,18,18,15,18,0,0,0,94
20,5,18,18,15,18,6,21,12,133
20,5,18,18,15,18,9,19,5,127
20,5,18,18,15,18,9,19,13,135
20,5,18,18,15,18,9,19,20,142
20,5,18,18,15,18,9,26,5,134
20,5,18,18,15,18,19,0,0,113
20,5,18,19,5,0,0,0,0,67
20,5,18,19,5,12,25,0,0,104
20,5,18,19,5,14,5,19,19,124
20,5,18,19,5,18,0,0,0,85
20,5,18,19,5,19,20,0,0,106
20,5,18,19,9,15,14,0,0,100
20,5,18,19,21,12,6,9,4,114
20,5,18,20,5,14,1,14,20,117
20,5,18,20,9,1,12,0,0,85
20,5,18,20,9,1,12,19,0,104
20,5,18,20,9,1,14,0,0,87
20,5,18,20,9,1,14,1,0,88
20,5,18,20,9,1,14,19,0,106
20,5,18,20,9,1,20,5,0,98
20,5,18,20,9,9,0,0,0,81
20,5,18,20,9,15,0,0,0,87
20,5,18,20,9,21,13,0,0,106
20,5,18,20,15,14,0,0,0,92
20,5,18,20,18,9,14,1,12,117
20,5,18,20,21,12,9,1,0,106
20,5,18,21,1,8,0,0,0,73
20,5,18,21,25,21,11,9,0,130
20,5,18,21,14,3,9,21,19,130
20,5,18,21,20,5,18,15,0,122
20,5,18,21,20,5,18,21,0,128
20,5,18,22,1,12,5,14,20,117
20,5,18,22,5,5,0,0,0,75
20,5,18,26,5,20,0,0,0,94
20,5,18,26,5,20,20,15,0,129
20,5,18,26,5,20,20,15,19,148
20,5,18,26,9,14,1,0,0,93
20,5,18,26,9,15,0,0,0,93
20,5,18,26,15,0,0,0,0,84
20,5,19,1,3,11,0,0,0,59
20,5,19,3,1,18,9,1,0,76
20,5,19,11,5,18,5,0,0,83
20,5,19,11,5,18,9,1,0,88
20,5,19,12,1,19,0,0,0,76
20,5,19,19,1,18,1,0,0,83
20,5,19,19,1,18,1,3,5,91
20,5,19,19,5,12,0,0,0,80
20,5,19,19,5,12,1,20,5,106
20,5,19,19,5,12,12,1,0,93
20,5,19,19,5,12,12,1,5,98
20,5,19,19,5,12,12,1,18,111
20,5,19,19,5,18,1,0,0,87
20,5,19,19,5,18,1,3,20,110
20,5,19,19,5,18,1,5,0,92
20,5,19,19,5,18,1,9,3,99
20,5,19,19,5,18,1,12,0,99
20,5,19,19,5,18,1,20,5,112
20,5,19,19,9,20,21,18,1,132
20,5,19,19,9,20,21,18,5,136
20,5,19,19,21,12,1,18,0,115
20,5,19,20,1,0,0,0,0,65
20,5,19,20,1,2,12,5,0,84
20,5,19,20,1,3,5,1,14,88
20,5,19,20,1,3,25,0,0,93
20,5,19,20,1,3,9,5,19,101
20,5,19,20,1,5,0,0,0,70
20,5,19,20,1,13,21,18,0,117
20,5,19,20,1,14,4,9,0,92
20,5,19,20,1,15,0,0,0,80
20,5,19,20,1,18,0,0,0,83
20,5,19,20,1,20,1,0,0,86
20,5,19,20,1,20,5,0,0,90
20,5,19,20,1,20,5,19,0,109
20,5,19,20,1,20,9,15,14,123
20,5,19,20,1,20,15,18,0,118
20,5,19,20,1,20,15,18,25,143
20,5,19,20,1,20,15,18,19,137
20,5,19,20,1,20,18,9,24,136
20,5,19,20,1,20,21,13,0,119
20,5,19,20,2,5,4,0,0,75
20,5,19,20,3,18,15,19,19,138
20,5,19,20,5,0,0,0,0,69
20,5,19,20,5,4,0,0,0,73
20,5,19,20,5,5,0,0,0,74
20,5,19,20,5,5,19,0,0,93
20,5,19,20,5,18,0,0,0,87
20,5,19,20,5,18,19,0,0,106
20,5,19,20,5,19,0,0,0,88
20,5,19,20,25,0,0,0,0,89
20,5,19,20,9,3,12,5,0,93
20,5,19,20,9,3,12,5,19,112
20,5,19,20,9,3,15,14,4,109
20,5,19,20,9,5,18,0,0,96
20,5,19,20,9,5,18,5,0,101
20,5,19,20,9,5,19,20,0,117
20,5,19,20,9,6,25,0,0,104
20,5,19,20,9,6,9,5,4,97
20,5,19,20,9,6,9,5,18,111
20,5,19,20,9,6,9,5,19,112
20,5,19,20,9,12,25,0,0,110
20,5,19,20,9,13,15,14,25,140
20,5,19,20,9,14,5,19,19,130
20,5,19,20,9,14,7,0,0,94
20,5,19,20,9,14,7,12,25,131
20,5,19,20,9,14,7,19,0,113
20,5,19,20,9,19,0,0,0,92
20,5,19,20,9,20,9,19,0,121
20,5,19,20,13,1,20,3,8,109
20,5,19,20,15,14,0,0,0,93
20,5,19,20,15,14,5,0,0,98
20,5,19,20,15,14,19,0,0,112
20,5,19,20,15,15,14,0,0,108
20,5,19,20,15,15,14,19,0,127
20,5,19,20,15,18,0,0,0,97
20,5,19,20,18,9,12,0,0,103
20,5,19,20,19,0,0,0,0,83
20,5,19,20,21,4,15,0,0,104
20,5,19,20,21,4,15,19,0,123
20,5,19,20,21,12,5,0,0,102
20,5,19,22,9,14,15,0,0,104
20,5,20,0,0,0,0,0,0,45
20,5,20,1,14,1,12,0,0,73
20,5,20,1,14,25,0,0,0,85
20,5,20,1,14,9,1,0,0,70
20,5,20,1,14,9,3,0,0,72
20,5,20,1,14,9,3,1,12,85
20,5,20,1,14,9,3,19,0,91
20,5,20,1,14,9,5,19,0,93
20,5,20,1,14,9,12,12,1,94
20,5,20,1,14,9,14,5,0,88
20,5,20,1,14,9,19,5,0,93
20,5,20,1,14,9,19,5,4,97
20,5,20,1,14,9,19,5,19,112
20,5,20,1,14,9,19,13,0,101
20,5,20,1,14,9,26,5,0,100
20,5,20,1,14,9,26,5,4,104
20,5,20,1,14,9,26,5,19,119
20,5,20,1,14,15,9,4,0,88
20,5,20,1,14,21,19,0,0,100
20,5,20,1,14,21,19,5,19,124
20,5,20,1,18,3,15,14,5,101
20,5,20,1,18,4,0,0,0,68
20,5,20,1,18,20,15,9,4,112
20,5,20,3,8,0,0,0,0,56
20,5,20,3,8,5,4,0,0,65
20,5,20,3,8,25,0,0,0,81
20,5,20,3,8,9,5,18,0,88
20,5,20,3,8,9,5,19,20,109
20,5,20,3,8,9,12,25,0,102
20,5,20,5,0,0,0,0,0,50
20,5,20,5,12,0,0,0,0,62
20,5,20,8,0,0,0,0,0,53
20,5,20,8,5,12,9,14,0,93
20,5,20,8,5,18,0,0,0,76
20,5,20,8,5,18,5,4,0,85
20,5,20,8,5,18,25,0,0,101
20,5,20,8,5,18,9,14,7,106
20,5,20,8,5,18,19,0,0,95
20,5,20,8,25,4,1,14,0,97
20,5,20,8,19,0,0,0,0,72
20,5,20,15,20,21,13,0,0,114
20,5,20,15,20,21,13,19,0,133
20,5,20,18,1,0,0,0,0,64
20,5,20,18,1,3,5,14,5,91
20,5,20,18,1,3,9,4,0,80
20,5,20,18,1,3,9,4,19,99
20,5,20,18,1,3,20,0,0,87
20,5,20,18,1,3,20,25,19,131
20,5,20,18,1,4,0,0,0,68
20,5,20,18,1,4,9,3,0,80
20,5,20,18,1,4,19,0,0,87
20,5,20,18,1,7,1,13,25,110
20,5,20,18,1,7,25,14,0,110
20,5,20,18,1,7,12,15,20,118
20,5,20,18,1,7,15,14,0,100
20,5,20,18,1,7,15,14,19,119
20,5,20,18,1,7,18,1,13,103
20,5,20,18,1,7,18,9,4,102
20,5,20,18,1,9,15,4,15,107
20,5,20,18,1,11,9,19,0,103
20,5,20,18,1,12,9,20,5,110
20,5,20,18,1,12,15,7,25,123
20,5,20,18,1,13,5,18,0,100
20,5,20,18,1,13,5,18,19,119
20,5,20,18,1,13,9,14,0,100
20,5,20,18,1,13,9,14,5,105
20,5,20,18,1,14,4,5,18,105
20,5,20,18,1,14,5,0,0,83
20,5,20,18,1,14,20,0,0,98
20,5,20,18,1,15,14,9,4,106
20,5,20,18,1,16,25,12,1,118
20,5,20,18,1,16,12,1,0,93
20,5,20,18,1,16,15,4,0,99
20,5,20,18,1,16,15,4,25,124
20,5,20,18,1,16,15,4,19,118
20,5,20,18,1,16,15,21,19,135
20,5,20,18,1,18,3,8,0,93
20,5,20,18,1,18,3,8,25,118
20,5,20,18,1,18,3,8,19,112
20,5,20,18,1,19,0,0,0,83
20,5,20,18,1,19,5,13,5,106
20,5,20,18,1,19,15,13,5,116
20,5,20,18,1,19,15,13,25,136
20,5,20,18,1,19,20,5,18,126
20,5,20,18,1,20,15,14,5,118
20,5,20,18,1,24,9,1,12,110
20,5,20,18,1,24,9,12,5,114
20,5,20,18,1,24,15,14,0,117
20,5,20,18,1,26,1,14,5,110
20,5,20,18,1,26,5,14,5,114
20,5,20,18,1,26,25,12,0,127
20,5,20,18,1,26,9,14,0,113
20,5,20,18,1,26,9,14,5,118
20,5,20,18,1,26,15,0,0,105
20,5,20,18,1,26,15,12,5,122
20,5,20,18,1,26,15,14,5,124
20,5,20,18,4,18,1,0,0,86
20,5,20,18,9,3,0,0,0,75
20,5,20,18,9,3,1,12,0,88
20,5,20,18,9,3,9,20,25,129
20,5,20,18,9,3,15,21,19,130
20,5,20,18,9,6,15,12,0,105
20,5,20,18,9,7,9,4,0,92
20,5,20,18,25,12,0,0,0,100
20,5,20,18,25,12,5,14,5,124
20,5,20,18,25,12,19,0,0,119
20,5,20,18,15,2,15,12,0,107
20,5,20,18,15,4,5,0,0,87
20,5,20,18,15,4,5,19,0,106
20,5,20,18,15,4,15,14,20,131
20,5,20,18,15,12,0,0,0,90
20,5,20,18,15,12,5,0,0,95
20,5,20,18,15,12,9,3,0,102
20,5,20,18,15,14,9,3,0,104
20,5,20,18,15,19,5,0,0,102
20,5,20,18,15,21,19,0,0,118
20,5,20,18,15,24,9,4,0,115
20,5,20,18,15,24,9,4,5,120
20,5,20,18,15,24,9,4,19,134
20,5,20,19,0,0,0,0,0,64
20,5,20,20,5,18,0,0,0,88
20,5,20,20,5,18,5,4,0,97
20,5,20,20,5,18,25,0,0,113
20,5,20,20,5,18,9,14,7,118
20,5,20,20,5,18,9,19,8,124
20,5,20,20,5,18,15,21,19,143
20,5,20,20,5,18,19,0,0,107
20,5,20,20,25,0,0,0,0,90
20,5,20,20,9,19,8,0,0,101
20,5,20,20,9,24,0,0,0,98
20,5,21,3,8,0,0,0,0,57
20,5,21,3,8,9,20,0,0,86
20,5,21,3,18,9,14,0,0,90
20,5,21,6,9,20,0,0,0,81
20,5,21,7,8,0,0,0,0,61
20,5,21,7,8,12,25,0,0,98
20,5,21,7,8,14,5,19,19,118
20,5,21,11,0,0,0,0,0,57
20,5,21,20,15,14,19,0,0,114
20,5,22,9,19,19,0,0,0,94
20,5,23,0,0,0,0,0,0,48
20,5,23,1,18,20,0,0,0,87
20,5,23,5,4,0,0,0,0,57
20,5,23,5,12,0,0,0,0,65
20,5,23,5,18,0,0,0,0,71
20,5,23,8,9,20,0,0,0,85
20,5,23,9,14,7,0,0,0,78
20,5,23,9,20,0,0,0,0,77
20,5,23,12,25,0,0,0,0,85
20,5,23,19,15,13,5,0,0,100
20,5,23,20,1,23,0,0,0,92
20,5,23,20,5,18,0,0,0,91
20,5,24,1,14,19,0,0,0,83
20,5,24,1,19,5,19,0,0,93
20,5,24,7,21,9,14,15,0,115
20,5,24,20,0,0,0,0,0,69
20,5,24,20,1,18,9,1,14,112
20,5,24,20,2,15,15,11,0,112
20,5,24,20,2,15,15,11,19,131
20,5,24,20,9,12,5,0,0,95
20,5,24,20,9,12,5,19,0,114
20,5,24,20,9,12,9,19,20,138
20,5,24,20,12,5,19,19,0,124
20,5,24,20,12,5,20,0,0,106
20,5,24,20,13,1,14,0,0,97
20,5,24,20,15,18,9,1,12,124
20,5,24,20,18,9,14,5,0,115
20,5,24,20,19,0,0,0,0,88
20,5,24,20,21,1,12,0,0,103
20,5,24,20,21,1,12,12,25,140
20,5,24,20,21,1,18,25,0,134
20,5,24,20,21,9,19,20,0,138
20,5,24,20,21,18,1,12,0,121
20,5,24,20,21,18,5,0,0,113
20,5,24,20,21,18,5,4,0,117
20,5,24,20,21,18,5,19,0,132
20,5,24,20,21,18,9,14,7,138
20,5,24,20,21,19,0,0,0,109
20,5,26,0,0,0,0,0,0,51
20,5,26,11,5,18,5,0,0,90
20,5,26,11,9,18,1,8,0,98
20,6,18,0,0,0,0,0,0,44
20,7,20,0,0,0,0,0,0,47
20,8,5,1,3,5,15,21,19,97
20,8,5,1,8,0,0,0,0,42
20,8,5,1,14,4,18,9,3,82
20,8,5,1,18,3,8,25,0,88
20,8,5,1,18,3,8,9,3,75
20,8,5,1,19,21,13,0,0,87
20,8,5,1,20,0,0,0,0,54
20,8,5,1,20,5,18,0,0,77
20,8,5,1,20,5,18,19,0,96
20,8,5,1,20,18,1,12,0,85
20,8,5,1,20,18,5,0,0,77
20,8,5,1,20,18,5,19,0,96
20,8,5,1,20,18,25,0,0,97
20,8,5,1,20,18,9,3,0,84
20,8,5,1,20,18,9,3,19,103
20,8,5,1,20,18,9,26,5,112
20,8,5,1,20,18,15,14,0,101
20,8,5,1,22,5,0,0,0,61
20,8,5,2,0,0,0,0,0,35
20,8,5,2,1,9,14,0,0,59
20,8,5,2,1,9,14,5,0,64
20,8,5,2,1,9,14,5,19,83
20,8,5,2,1,9,19,13,0,77
20,8,5,2,5,18,7,5,0,70
20,8,5,3,1,0,0,0,0,37
20,8,5,3,1,5,0,0,0,42
20,8,5,3,1,12,0,0,0,49
20,8,5,3,1,20,5,0,0,62
20,8,5,3,9,1,0,0,0,46
20,8,5,3,9,1,12,0,0,58
20,8,5,3,9,20,9,19,0,93
20,8,5,3,9,21,13,0,0,79
20,8,5,3,12,1,14,0,0,63
20,8,5,3,15,4,15,14,20,104
20,8,5,3,15,9,4,0,0,64
20,8,5,4,0,0,0,0,0,37
20,8,5,5,0,0,0,0,0,38
20,8,5,5,4,15,13,0,0,70
20,8,5,5,11,0,0,0,0,49
20,8,5,5,11,5,4,0,0,58
20,8,5,5,11,5,18,0,0,72
20,8,5,5,11,9,14,7,0,79
20,8,5,5,12,9,14,0,0,73
20,8,5,5,12,9,14,19,0,92
20,8,5,5,12,15,12,0,0,77
20,8,5,5,12,15,12,19,0,96
20,8,5,5,18,0,0,0,0,56
20,8,5,5,20,0,0,0,0,58
20,8,5,5,20,19,5,5,0,87
20,8,5,5,26,1,14,0,0,79
20,8,5,6,20,0,0,0,0,59
20,8,5,6,20,2,15,20,5,101
20,8,5,6,20,4,15,13,0,91
20,8,5,6,20,12,5,19,19,114
20,8,5,6,20,19,0,0,0,78
20,8,5,6,20,21,15,21,19,135
20,8,5,7,5,20,8,5,18,96
20,8,5,7,9,4,4,5,18,80
20,8,5,7,9,20,8,5,18,100
20,8,5,7,14,0,0,0,0,54
20,8,5,7,14,4,15,13,0,86
20,8,5,7,14,8,15,15,4,96
20,8,5,7,14,12,1,14,4,85
20,8,5,7,14,12,25,0,0,91
20,8,5,7,14,12,9,11,5,91
20,8,5,7,14,19,0,0,0,73
20,8,5,7,14,19,8,9,16,106
20,8,5,25,0,0,0,0,0,58
20,8,5,25,1,15,21,0,0,95
20,8,5,25,4,0,0,0,0,62
20,8,5,9,6,15,18,13,0,94
20,8,5,25,12,12,0,0,0,82
20,8,5,9,14,0,0,0,0,56
20,8,5,9,14,5,0,0,0,61
20,8,5,9,14,5,19,0,0,80
20,8,5,9,14,9,19,13,0,97
20,8,5,9,14,19,0,0,0,75
20,8,5,9,18,0,0,0,0,60
20,8,5,25,18,5,0,0,0,81
20,8,5,9,18,14,0,0,0,74
20,8,5,9,18,19,0,0,0,79
20,8,5,9,18,19,5,14,19,117
20,8,5,9,19,13,0,0,0,74
20,8,5,9,19,13,19,0,0,93
20,8,5,9,19,20,0,0,0,81
20,8,5,9,19,20,9,3,0,93
20,8,5,9,19,20,19,0,0,100
20,8,5,25,22,5,0,0,0,85
20,8,5,12,1,12,7,9,1,75
20,8,5,12,9,15,14,0,0,83
20,8,5,12,9,20,9,19,0,102
20,8,5,12,25,20,15,11,25,141
20,8,5,12,9,21,13,0,0,88
20,8,5,12,15,14,3,21,19,117
20,8,5,13,0,0,0,0,0,46
20,8,5,13,1,20,1,0,0,68
20,8,5,13,1,20,9,3,0,79
20,8,5,13,1,20,9,19,20,115
20,8,5,13,5,0,0,0,0,51
20,8,5,13,5,4,0,0,0,55
20,8,5,13,5,12,5,19,19,106
20,8,5,13,5,12,5,20,0,88
20,8,5,13,5,18,0,0,0,69
20,8,5,13,5,19,0,0,0,70
20,8,5,13,9,14,7,0,0,76
20,8,5,13,19,5,12,0,0,82
20,8,5,14,0,0,0,0,0,47
20,8,5,14,1,4,0,0,0,52
20,8,5,14,1,4,1,25,19,97
20,8,5,14,1,7,5,0,0,60
20,8,5,14,1,7,5,19,0,79
20,8,5,14,1,12,0,0,0,60
20,8,5,14,1,18,0,0,0,66
20,8,5,14,1,18,19,0,0,85
20,8,5,14,3,5,0,0,0,55
20,8,5,14,14,5,0,0,0,66
20,8,5,14,14,5,19,19,0,104
20,8,5,14,19,0,0,0,0,66
20,8,5,15,3,18,1,3,25,98
20,8,5,15,3,18,1,19,25,114
20,8,5,15,3,18,1,20,0,90
20,8,5,15,3,18,1,20,19,109
20,8,5,15,4,25,0,0,0,77
20,8,5,15,4,9,3,25,0,89
20,8,5,15,4,18,1,13,1,85
20,8,5,15,7,1,13,25,0,94
20,8,5,15,7,15,14,1,12,97
20,8,5,15,7,15,14,25,0,109
20,8,5,15,7,15,14,9,3,96
20,8,5,15,8,21,13,1,14,105
20,8,5,15,11,20,15,14,25,133
20,8,5,15,12,0,0,0,0,60
20,8,5,15,12,1,20,18,25,124
20,8,5,15,12,5,16,19,25,125
20,8,5,15,12,15,7,0,0,82
20,8,5,15,12,15,7,1,12,95
20,8,5,15,12,15,7,5,18,105
20,8,5,15,12,15,7,9,0,91
20,8,5,15,12,15,7,25,0,107
20,8,5,15,12,15,7,9,3,94
20,8,5,15,12,15,7,19,0,101
20,8,5,15,12,15,7,21,5,108
20,8,5,15,12,15,7,21,19,122
20,8,5,15,13,1,3,8,25,98
20,8,5,15,13,1,7,25,0,94
20,8,5,15,13,1,7,9,3,81
20,8,5,15,13,1,14,3,25,104
20,8,5,15,13,1,14,9,1,86
20,8,5,15,14,15,13,25,0,115
20,8,5,15,16,1,20,8,25,118
20,8,5,15,16,8,1,7,25,105
20,8,5,15,16,8,1,14,25,112
20,8,5,15,16,8,9,12,5,98
20,8,5,15,18,0,0,0,0,66
20,8,5,15,18,2,9,19,20,116
20,8,5,15,18,2,15,0,0,83
20,8,5,15,18,2,15,19,0,102
20,8,5,15,18,5,13,0,0,84
20,8,5,15,18,5,13,9,3,96
20,8,5,15,18,5,13,19,0,103
20,8,5,15,18,5,20,9,3,103
20,8,5,15,18,25,0,0,0,91
20,8,5,15,18,9,1,0,0,76
20,8,5,15,18,9,1,9,0,85
20,8,5,15,18,9,3,0,0,78
20,8,5,15,18,9,3,1,0,79
20,8,5,15,18,9,3,1,12,91
20,8,5,15,18,9,3,15,14,107
20,8,5,15,18,9,3,19,0,97
20,8,5,15,18,9,5,19,0,99
20,8,5,15,18,9,19,5,0,99
20,8,5,15,18,9,19,5,4,103
20,8,5,15,18,9,19,5,18,117
20,8,5,15,18,9,19,5,19,118
20,8,5,15,18,9,19,13,0,107
20,8,5,15,18,9,19,20,0,114
20,8,5,15,18,9,19,20,19,133
20,8,5,15,18,9,26,5,0,106
20,8,5,15,18,9,26,5,4,110
20,8,5,15,18,9,26,5,18,124
20,8,5,15,18,9,26,5,19,125
20,8,5,15,18,21,13,0,0,100
20,8,5,15,19,15,16,8,0,106
20,8,5,15,23,0,0,0,0,71
20,8,5,15,23,4,15,13,0,103
20,8,5,15,23,13,1,14,0,99
20,8,5,15,23,13,5,14,0,103
20,8,5,18,0,0,0,0,0,51
20,8,5,18,1,12,9,20,5,98
20,8,5,18,1,16,0,0,0,68
20,8,5,18,1,16,25,0,0,93
20,8,5,18,1,16,9,1,0,78
20,8,5,18,1,16,9,5,19,101
20,8,5,18,1,16,9,19,20,116
20,8,5,18,1,16,19,9,4,100
20,8,5,18,2,12,9,7,0,81
20,8,5,18,5,0,0,0,0,56
20,8,5,18,5,1,19,0,0,76
20,8,5,18,5,1,20,0,0,77
20,8,5,18,5,1,23,1,25,106
20,8,5,18,5,2,5,14,0,77
20,8,5,18,5,2,25,0,0,83
20,8,5,18,5,3,11,12,25,107
20,8,5,18,5,4,0,0,0,60
20,8,5,18,5,6,15,18,0,95
20,8,5,18,5,6,15,18,5,100
20,8,5,18,5,6,18,15,13,108
20,8,5,18,5,9,14,0,0,79
20,8,5,18,5,9,14,20,15,114
20,8,5,18,5,12,12,0,0,80
20,8,5,18,5,13,9,14,0,92
20,8,5,18,5,13,9,14,19,111
20,8,5,18,5,14,3,5,0,78
20,8,5,18,5,14,5,19,19,113
20,8,5,18,5,15,6,0,0,77
20,8,5,18,5,15,9,4,0,84
20,8,5,18,5,15,14,0,0,85
20,8,5,18,5,15,14,20,15,120
20,8,5,18,5,15,21,20,0,112
20,8,5,18,5,15,22,5,18,116
20,8,5,18,5,19,0,0,0,75
20,8,5,18,5,20,9,12,0,97
20,8,5,18,5,20,9,12,12,109
20,8,5,18,5,20,15,0,0,91
20,8,5,18,5,21,14,20,15,126
20,8,5,18,5,21,16,0,0,93
20,8,5,18,5,21,16,15,14,122
20,8,5,18,5,22,9,4,0,91
20,8,5,18,5,23,9,20,8,116
20,8,5,18,9,1,3,0,0,64
20,8,5,18,9,1,3,1,0,65
20,8,5,18,9,1,3,1,12,77
20,8,5,18,9,1,3,1,19,84
20,8,5,18,9,1,3,19,0,83
20,8,5,18,9,1,12,0,0,73
20,8,5,18,9,1,14,0,0,75
20,8,5,18,9,4,9,9,4,86
20,8,5,18,9,15,4,9,3,91
20,8,5,18,9,21,13,0,0,94
20,8,5,18,13,0,0,0,0,64
20,8,5,18,13,1,5,0,0,70
20,8,5,18,13,1,9,3,0,77
20,8,5,18,13,1,12,0,0,77
20,8,5,18,13,1,12,12,25,114
20,8,5,18,13,1,12,19,0,96
20,8,5,18,13,5,0,0,0,69
20,8,5,18,13,5,12,0,0,81
20,8,5,18,13,5,12,19,0,100
20,8,5,18,13,5,19,0,0,88
20,8,5,18,13,25,0,0,0,89
20,8,5,18,13,9,3,0,0,76
20,8,5,18,13,9,3,1,12,89
20,8,5,18,13,9,15,14,0,102
20,8,5,18,13,9,15,14,19,121
20,8,5,18,13,9,20,5,0,98
20,8,5,18,13,9,20,5,19,117
20,8,5,18,13,9,20,19,0,112
20,8,5,18,13,15,0,0,0,79
20,8,5,18,13,15,7,5,14,105
20,8,5,18,13,15,19,5,19,122
20,8,5,18,13,15,19,5,20,123
20,8,5,18,13,15,20,9,3,111
20,8,5,18,13,19,0,0,0,83
20,8,5,18,15,4,15,14,20,119
20,8,5,18,15,9,4,0,0,79
20,8,5,18,15,12,15,7,25,125
20,8,5,18,15,16,15,4,0,101
20,8,5,18,15,16,15,4,19,120
20,8,5,19,1,21,18,0,0,92
20,8,5,19,1,21,18,1,12,105
20,8,5,19,1,21,18,9,0,101
20,8,5,19,1,21,18,25,0,117
20,8,5,19,1,21,18,9,19,120
20,8,5,19,1,21,18,21,19,132
20,8,5,19,5,0,0,0,0,57
20,8,5,19,5,19,0,0,0,76
20,8,5,19,9,1,12,0,0,74
20,8,5,19,9,3,12,5,0,81
20,8,5,19,9,19,0,0,0,80
20,8,5,19,15,3,25,20,5,120
20,8,5,19,16,9,1,14,19,111
20,8,5,19,20,5,18,0,0,95
20,8,5,19,20,18,5,5,14,114
20,8,5,20,1,19,0,0,0,73
20,8,5,20,3,8,0,0,0,64
20,8,5,20,5,0,0,0,0,58
20,8,5,20,9,3,0,0,0,65
20,8,5,20,9,3,1,12,0,78
20,8,5,20,9,3,19,0,0,84
20,8,5,20,9,14,0,0,0,76
20,8,5,20,9,14,5,0,0,81
20,8,5,21,18,7,25,0,0,104
20,8,5,21,18,7,9,3,0,91
20,8,5,21,18,7,9,5,19,112
20,8,5,21,18,7,9,19,20,127
20,8,5,22,5,20,9,14,0,103
20,8,5,23,0,0,0,0,0,56
20,8,5,23,5,4,0,0,0,65
20,8,5,23,25,0,0,0,0,81
20,8,5,23,9,5,18,0,0,88
20,8,5,23,9,5,19,20,0,109
20,8,5,23,9,14,5,19,19,122
20,8,5,23,12,5,19,19,0,111
20,8,5,23,12,9,11,5,0,93
20,8,5,23,14,5,19,19,0,113
20,8,5,23,19,0,0,0,0,75
20,8,25,0,0,0,0,0,0,53
20,8,9,1,3,5,20,9,3,78
20,8,9,1,12,4,9,14,0,77
20,8,9,1,12,4,9,14,5,82
20,8,9,1,13,9,4,0,0,64
20,8,9,1,13,9,4,5,0,69
20,8,9,1,13,9,14,0,0,74
20,8,9,1,13,9,14,5,0,79
20,8,9,1,13,9,14,5,19,98
20,8,9,1,13,9,14,19,0,93
20,8,9,1,19,9,0,0,0,66
20,8,9,1,19,9,14,5,0,85
20,8,9,1,19,9,20,5,0,91
20,8,9,1,19,15,9,0,0,81
20,8,9,1,19,15,19,0,0,91
20,8,9,1,19,15,20,5,0,97
20,8,9,1,19,21,19,0,0,97
20,8,9,1,19,21,19,9,0,106
20,8,9,1,26,9,4,5,0,82
20,8,9,1,26,9,4,5,19,101
20,8,9,1,26,9,14,0,0,87
20,8,9,1,26,9,14,5,0,92
20,8,9,1,26,9,14,5,19,111
20,8,9,1,26,9,14,19,0,106
20,8,9,1,26,15,12,0,0,91
20,8,9,1,26,15,12,5,0,96
20,8,9,1,26,15,12,5,19,115
20,8,9,1,26,15,12,19,0,110
20,8,9,2,5,20,0,0,0,64
20,8,9,2,12,5,0,0,0,56
20,8,9,3,11,0,0,0,0,51
20,8,9,3,11,5,0,0,0,56
20,8,9,3,11,5,14,0,0,70
20,8,9,3,11,5,14,5,4,79
20,8,9,3,11,5,14,5,18,93
20,8,9,3,11,5,14,19,0,89
20,8,9,3,11,5,18,0,0,74
20,8,9,3,11,5,19,20,0,95
20,8,9,3,11,5,20,0,0,76
20,8,9,3,11,5,20,5,4,85
20,8,9,3,11,5,20,25,0,101
20,8,9,3,11,5,20,19,0,95
20,8,9,3,11,8,5,1,4,69
20,8,9,3,11,25,0,0,0,76
20,8,9,3,11,9,19,8,0,87
20,8,9,3,11,12,5,1,6,75
20,8,9,3,11,12,25,0,0,88
20,8,9,3,11,12,9,16,19,107
20,8,9,3,11,14,5,3,11,84
20,8,9,3,11,14,5,19,19,108
20,8,9,3,11,19,0,0,0,70
20,8,9,3,11,19,5,20,0,95
20,8,9,3,11,19,5,20,19,114
20,8,9,3,11,19,11,9,14,104
20,8,9,3,11,23,9,14,4,101
20,8,9,3,11,23,9,20,0,103
20,8,9,5,6,4,15,13,0,80
20,8,9,5,6,12,1,14,4,79
20,8,9,5,6,12,25,0,0,85
20,8,9,5,6,23,9,19,5,104
20,8,9,5,14,25,12,0,0,93
20,8,9,5,14,15,14,5,0,90
20,8,9,5,22,1,2,12,5,84
20,8,9,5,22,5,0,0,0,69
20,8,9,5,22,5,4,0,0,73
20,8,9,5,22,5,18,0,0,87
20,8,9,5,22,5,18,25,0,112
20,8,9,5,22,5,19,0,0,88
20,8,9,5,22,9,14,7,0,94
20,8,9,5,22,9,19,8,0,100
20,8,9,7,0,0,0,0,0,44
20,8,9,7,7,5,4,0,0,60
20,8,9,7,7,5,18,0,0,74
20,8,9,7,7,9,14,7,0,81
20,8,9,7,8,0,0,0,0,52
20,8,9,7,8,2,15,14,5,88
20,8,9,7,8,5,4,0,0,61
20,8,9,7,8,19,0,0,0,71
20,8,9,7,8,20,0,0,0,72
20,8,25,9,14,5,0,0,0,81
20,8,25,12,1,3,9,14,5,97
20,8,25,12,1,11,15,9,4,105
20,8,9,12,11,0,0,0,0,60
20,8,9,12,12,5,18,0,0,84
20,8,9,12,12,25,0,0,0,86
20,8,9,12,12,19,0,0,0,80
20,8,25,13,1,20,5,0,0,92
20,8,9,13,2,5,18,0,0,75
20,8,9,13,2,12,5,0,0,69
20,8,9,13,2,12,5,4,0,73
20,8,9,13,2,12,5,19,0,88
20,8,25,13,5,0,0,0,0,71
20,8,25,13,5,7,15,12,0,105
20,8,25,13,5,25,0,0,0,96
20,8,25,13,5,12,5,0,0,88
20,8,25,13,5,12,9,3,0,95
20,8,25,13,5,12,9,3,9,104
20,8,25,13,5,14,5,0,0,90
20,8,25,13,5,19,0,0,0,90
20,8,25,13,5,20,9,3,0,103
20,8,25,13,9,0,0,0,0,75
20,8,25,13,25,0,0,0,0,91
20,8,25,13,9,1,0,0,0,76
20,8,25,13,9,1,13,1,0,90
20,8,25,13,9,3,0,0,0,78
20,8,25,13,9,4,9,14,5,107
20,8,25,13,9,5,18,0,0,98
20,8,25,13,9,5,19,20,0,119
20,8,25,13,25,12,0,0,0,103
20,8,25,13,25,12,9,3,0,115
20,8,25,13,9,14,0,0,0,89
20,8,25,13,9,14,5,0,0,94
20,8,25,13,9,14,5,19,0,113
20,8,25,13,9,15,19,9,19,137
20,8,25,13,9,20,9,19,0,123
20,8,25,13,15,3,25,20,5,134
20,8,25,13,15,12,0,0,0,93
20,8,25,13,15,12,1,20,5,119
20,8,25,13,15,12,9,26,5,133
20,8,25,13,15,12,19,0,0,112
20,8,25,13,15,13,1,0,0,95
20,8,25,13,15,13,1,20,1,116
20,8,25,13,15,19,9,14,0,123
20,8,25,13,15,20,9,3,0,113
20,8,25,13,19,0,0,0,0,85
20,8,25,13,21,19,5,19,0,130
20,8,9,14,3,12,1,4,0,71
20,8,9,14,3,12,1,4,19,90
20,8,9,14,4,15,23,14,0,107
20,8,9,14,4,15,23,14,19,126
20,8,9,14,5,0,0,0,0,56
20,8,9,14,7,0,0,0,0,58
20,8,9,14,7,1,12,0,0,71
20,8,9,14,7,8,15,15,4,100
20,8,9,14,7,25,0,0,0,83
20,8,9,14,7,9,19,8,0,94
20,8,9,14,7,12,5,19,19,113
20,8,9,14,7,12,5,20,0,95
20,8,9,14,7,12,25,0,0,95
20,8,9,14,7,12,9,11,5,95
20,8,9,14,7,13,1,14,0,86
20,8,9,14,7,14,5,19,19,115
20,8,9,14,7,19,0,0,0,77
20,8,9,14,7,21,13,0,0,92
20,8,9,14,7,21,13,13,25,130
20,8,9,14,7,21,20,0,0,99
20,8,9,14,11,0,0,0,0,62
20,8,9,14,11,1,2,12,5,82
20,8,9,14,11,1,2,12,25,102
20,8,9,14,11,5,18,0,0,85
20,8,9,14,11,5,18,19,0,104
20,8,9,14,11,6,21,12,0,101
20,8,9,14,11,9,14,7,0,92
20,8,9,14,11,9,14,7,19,111
20,8,9,14,11,12,9,14,7,104
20,8,9,14,11,19,0,0,0,81
20,8,9,14,12,25,0,0,0,88
20,8,9,14,14,5,4,0,0,74
20,8,9,14,14,5,18,0,0,88
20,8,9,14,14,5,18,19,0,107
20,8,9,14,14,5,19,19,0,108
20,8,9,14,14,5,19,20,0,109
20,8,25,14,14,9,4,0,0,94
20,8,9,14,14,9,14,7,0,95
20,8,9,14,14,9,19,8,0,101
20,8,9,14,15,12,9,20,5,112
20,8,9,14,19,0,0,0,0,70
20,8,9,15,0,0,0,0,0,52
20,8,9,15,1,3,5,20,0,81
20,8,9,15,1,13,9,4,0,79
20,8,9,15,1,13,9,4,5,84
20,8,9,15,3,25,1,14,15,110
20,8,9,15,5,19,20,5,18,119
20,8,9,15,6,21,18,1,14,112
20,8,9,15,12,0,0,0,0,64
20,8,9,15,12,9,3,0,0,76
20,8,9,15,12,9,3,19,0,95
20,8,9,15,12,19,0,0,0,83
20,8,9,15,14,1,13,9,3,92
20,8,9,15,14,1,20,5,0,92
20,8,9,15,14,1,20,5,19,111
20,8,9,15,14,5,9,14,5,99
20,8,9,15,14,9,3,0,0,78
20,8,9,15,14,25,12,0,0,103
20,8,9,15,14,25,12,19,0,122
20,8,9,15,14,9,14,0,0,89
20,8,9,15,14,9,14,5,0,94
20,8,9,15,14,9,14,5,19,113
20,8,9,15,14,9,14,19,0,108
20,8,9,15,14,9,21,13,0,109
20,8,9,15,16,8,5,14,0,95
20,8,9,15,16,8,5,14,5,100
20,8,9,15,16,8,5,14,19,114
20,8,9,15,16,25,18,1,14,126
20,8,9,15,20,5,16,1,0,94
20,8,9,15,20,5,16,1,19,113
20,8,9,15,21,18,5,1,0,97
20,8,9,15,21,18,5,1,19,116
20,8,9,15,24,5,14,5,0,100
20,8,9,15,26,15,14,5,0,112
20,8,9,15,26,15,14,9,4,120
20,8,9,18,0,0,0,0,0,55
20,8,9,18,1,13,0,0,0,69
20,8,9,18,1,13,19,0,0,88
20,8,9,18,4,0,0,0,0,59
20,8,9,18,4,8,1,14,4,86
20,8,9,18,4,9,14,7,19,108
20,8,9,18,4,12,25,0,0,96
20,8,9,18,4,12,9,14,7,101
20,8,9,18,4,14,5,19,19,116
20,8,9,18,4,19,0,0,0,78
20,8,9,18,4,19,13,1,14,106
20,8,25,18,5,15,9,4,0,104
20,8,25,18,5,15,19,9,19,138
20,8,25,18,9,4,9,1,0,94
20,8,25,18,9,4,9,1,12,106
20,8,25,18,9,4,9,21,13,127
20,8,25,18,9,19,20,15,18,152
20,8,9,18,12,0,0,0,0,67
20,8,9,18,12,1,7,5,0,80
20,8,9,18,12,1,7,5,19,99
20,8,9,18,12,5,4,0,0,76
20,8,9,18,12,9,14,7,0,97
20,8,9,18,12,19,0,0,0,86
20,8,25,18,15,3,5,12,5,111
20,8,25,18,15,8,25,1,12,132
20,8,25,18,15,9,4,0,0,99
20,8,25,18,15,9,4,1,12,112
20,8,25,18,15,9,4,5,1,105
20,8,25,18,15,9,4,19,0,118
20,8,25,18,15,12,4,0,0,102
20,8,25,18,15,14,9,14,0,123
20,8,25,18,15,14,9,14,5,128
20,8,25,18,15,18,9,1,0,114
20,8,25,18,15,18,9,15,14,142
20,8,25,18,15,19,9,19,0,133
20,8,25,18,15,20,15,13,5,139
20,8,25,18,15,20,15,13,25,159
20,8,25,18,15,24,9,14,0,133
20,8,25,18,15,24,9,14,5,138
20,8,25,18,15,24,9,14,19,152
20,8,25,18,19,5,0,0,0,95
20,8,25,18,19,5,19,0,0,114
20,8,25,18,19,9,0,0,0,99
20,8,25,18,19,15,9,4,0,118
20,8,9,18,19,20,0,0,0,94
20,8,9,18,19,20,5,4,0,103
20,8,9,18,19,20,5,18,0,117
20,8,9,18,19,20,5,18,19,136
20,8,9,18,19,20,6,21,12,133
20,8,9,18,19,20,25,0,0,119
20,8,9,18,19,20,9,5,18,126
20,8,9,18,19,20,9,12,25,140
20,8,9,18,19,20,9,14,7,124
20,8,9,18,19,20,12,5,0,111
20,8,9,18,19,20,19,0,0,113
20,8,25,18,19,21,19,0,0,130
20,8,25,18,19,21,19,9,0,139
20,8,9,18,20,0,0,0,0,75
20,8,9,18,20,5,5,14,0,99
20,8,9,18,20,5,5,14,19,118
20,8,9,18,20,25,0,0,0,100
20,8,9,18,20,9,5,19,0,108
20,8,9,18,20,9,5,20,8,117
20,8,9,18,20,25,9,19,8,136
20,8,9,19,0,0,0,0,0,56
20,8,25,19,5,12,0,0,0,89
20,8,25,19,5,12,6,0,0,95
20,8,25,19,5,14,0,0,0,91
20,8,9,19,8,15,23,0,0,102
20,8,9,19,12,9,11,5,0,93
20,8,9,19,12,12,0,0,0,80
20,8,9,19,14,0,0,0,0,70
20,8,9,19,14,5,19,19,0,113
20,8,9,19,19,5,14,0,0,94
20,8,9,19,20,12,5,4,0,97
20,8,9,19,20,12,5,18,25,136
20,8,9,19,20,12,5,19,0,112
20,8,9,19,20,12,25,0,0,113
20,8,9,19,20,12,9,19,8,124
20,8,9,19,23,9,19,5,0,112
20,8,9,20,8,5,18,0,0,88
20,8,9,20,8,5,18,20,15,123
20,8,9,20,11,1,0,0,0,69
20,8,9,20,19,9,0,0,0,85
20,8,9,20,19,9,15,12,0,112
20,8,9,21,18,1,13,0,0,90
20,8,9,22,5,12,0,0,0,76
20,8,9,24,12,5,0,0,0,78
20,8,12,9,16,19,9,19,0,112
20,8,15,2,0,0,0,0,0,45
20,8,15,3,8,20,0,0,0,74
20,8,15,6,0,0,0,0,0,49
20,8,15,6,20,0,0,0,0,69
20,8,15,7,8,20,0,0,0,78
20,8,15,11,5,0,0,0,0,59
20,8,15,11,9,19,8,0,0,90
20,8,15,12,1,14,3,5,0,78
20,8,15,12,5,0,0,0,0,60
20,8,15,12,5,4,0,0,0,64
20,8,15,12,5,9,9,20,5,103
20,8,15,12,5,9,20,5,0,94
20,8,15,12,5,13,15,4,0,92
20,8,15,12,5,16,9,14,0,99
20,8,15,12,5,16,9,14,19,118
20,8,15,12,5,19,0,0,0,79
20,8,15,12,9,0,0,0,0,64
20,8,15,12,9,14,7,0,0,85
20,8,15,12,12,9,0,0,0,76
20,8,15,12,15,9,0,0,0,79
20,8,15,12,15,19,0,0,0,89
20,8,15,12,21,19,0,0,0,95
20,8,15,13,1,14,0,0,0,71
20,8,15,13,1,19,9,14,7,106
20,8,15,13,9,19,9,4,0,97
20,8,15,14,0,0,0,0,0,57
20,8,15,14,4,5,18,0,0,84
20,8,15,14,5,0,0,0,0,62
20,8,15,14,7,0,0,0,0,64
20,8,15,14,7,5,4,0,0,73
20,8,15,14,7,25,0,0,0,89
20,8,15,14,7,13,1,14,0,92
20,8,15,14,7,19,0,0,0,83
20,8,15,15,0,0,0,0,0,58
20,8,15,15,9,4,0,0,0,71
20,8,15,15,13,0,0,0,0,71
20,8,15,18,1,3,1,12,0,78
20,8,15,18,1,3,5,19,0,89
20,8,15,18,1,3,9,3,0,77
20,8,15,18,1,12,0,0,0,74
20,8,15,18,1,24,0,0,0,86
20,8,15,18,1,24,5,19,0,110
20,8,15,18,5,0,0,0,0,66
20,8,15,18,9,1,0,0,0,71
20,8,15,18,9,1,19,0,0,90
20,8,15,18,9,1,20,5,0,96
20,8,15,18,9,3,0,0,0,73
20,8,15,18,9,14,1,0,0,85
20,8,15,18,9,20,5,0,0,95
20,8,15,18,9,20,5,19,0,114
20,8,15,18,9,21,13,0,0,104
20,8,15,18,9,21,13,19,0,123
20,8,15,18,14,2,1,3,11,92
20,8,15,18,14,2,9,12,12,110
20,8,15,18,14,2,21,19,8,125
20,8,15,18,14,5,4,0,0,84
20,8,15,18,14,5,14,0,0,94
20,8,15,18,14,8,5,1,4,93
20,8,15,18,14,9,5,18,0,107
20,8,15,18,14,9,5,19,20,128
20,8,15,18,14,9,12,25,0,121
20,8,15,18,14,9,14,7,0,105
20,8,15,18,14,12,5,19,19,130
20,8,15,18,14,12,5,20,0,112
20,8,15,18,14,12,9,11,5,112
20,8,15,18,14,19,0,0,0,94
20,8,15,18,14,20,1,9,12,117
20,8,15,18,15,0,0,0,0,76
20,8,15,18,15,14,0,0,0,90
20,8,15,18,15,14,19,0,0,109
20,8,15,18,16,5,19,0,0,101
20,8,15,18,16,19,0,0,0,96
20,8,15,18,20,0,0,0,0,81
20,8,15,18,20,5,18,0,0,104
20,8,15,19,5,0,0,0,0,67
20,8,15,21,0,0,0,0,0,64
20,8,15,21,5,4,0,0,0,73
20,8,15,21,7,8,0,0,0,79
20,8,15,21,7,8,20,0,0,99
20,8,15,21,7,8,20,5,4,108
20,8,15,21,7,8,20,5,14,118
20,8,15,21,7,8,20,25,0,124
20,8,15,21,7,8,20,19,0,118
20,8,15,21,9,14,7,0,0,94
20,8,15,21,19,0,0,0,0,83
20,8,15,21,19,1,14,4,0,102
20,8,15,21,19,1,14,4,19,121
20,8,15,21,19,5,0,0,0,88
20,8,15,23,0,0,0,0,0,66
20,8,15,23,5,12,0,0,0,83
20,8,15,23,12,5,19,19,0,121
20,8,15,23,20,0,0,0,0,86
20,8,18,1,3,11,0,0,0,61
20,8,18,1,5,16,0,0,0,68
20,8,18,1,9,12,0,0,0,68
20,8,18,1,9,14,0,0,0,70
20,8,18,1,12,4,15,13,0,91
20,8,18,1,12,4,15,13,19,110
20,8,18,1,12,12,0,0,0,71
20,8,18,1,12,12,4,15,13,103
20,8,18,1,12,12,5,4,0,80
20,8,18,1,12,12,9,14,7,101
20,8,18,1,12,12,19,0,0,90
20,8,18,1,13,0,0,0,0,60
20,8,18,1,13,13,12,5,0,90
20,8,18,1,14,7,0,0,0,68
20,8,18,1,14,7,9,20,25,122
20,8,18,1,14,9,20,5,0,95
20,8,18,1,14,9,20,9,3,102
20,8,18,1,16,0,0,0,0,63
20,8,18,1,16,16,12,5,0,96
20,8,18,1,19,8,0,0,0,74
20,8,18,1,19,8,5,4,0,83
20,8,18,1,19,8,5,12,0,91
20,8,18,1,19,8,5,18,19,116
20,8,18,1,19,8,5,19,0,98
20,8,18,1,19,8,9,14,7,104
20,8,18,1,19,15,0,0,0,81
20,8,18,1,19,15,14,9,3,107
20,8,18,1,19,20,0,0,0,86
20,8,18,1,20,3,8,0,0,78
20,8,18,1,22,5,0,0,0,74
20,8,18,1,22,5,18,0,0,92
20,8,18,1,22,5,19,0,0,93
20,8,18,1,23,0,0,0,0,70
20,8,18,1,23,1,18,20,0,109
20,8,18,1,23,5,4,0,0,79
20,8,18,1,23,9,14,7,0,100
20,8,18,1,23,14,0,0,0,84
20,8,18,1,23,14,5,5,14,108
20,8,18,1,23,14,12,25,0,121
20,8,18,1,23,19,0,0,0,89
20,8,18,5,1,4,0,0,0,56
20,8,18,5,1,4,5,4,0,65
20,8,18,5,1,4,5,14,0,75
20,8,18,5,1,4,5,18,0,79
20,8,18,5,1,4,5,18,19,98
20,8,18,5,1,4,6,9,14,85
20,8,18,5,1,4,25,0,0,81
20,8,18,5,1,4,9,5,18,88
20,8,18,5,1,4,9,14,7,86
20,8,18,5,1,4,12,5,0,73
20,8,18,5,1,4,12,5,20,93
20,8,18,5,1,4,19,0,0,75
20,8,18,5,1,4,23,1,25,105
20,8,18,5,1,16,0,0,0,68
20,8,18,5,1,16,5,4,0,77
20,8,18,5,1,16,5,14,0,87
20,8,18,5,1,16,5,18,0,91
20,8,18,5,1,16,5,18,19,110
20,8,18,5,1,16,9,14,7,98
20,8,18,5,1,16,19,0,0,87
20,8,18,5,1,20,0,0,0,72
20,8,18,5,1,20,5,4,0,81
20,8,18,5,1,20,5,14,0,91
20,8,18,5,1,20,5,14,19,110
20,8,18,5,1,20,6,21,12,111
20,8,18,5,1,20,9,14,7,102
20,8,18,5,1,20,19,0,0,91
20,8,18,5,1,22,5,0,0,79
20,8,18,5,5,6,15,12,4,93
20,8,18,5,5,12,9,14,7,98
20,8,18,5,5,14,5,19,19,113
20,8,18,5,5,16,0,0,0,72
20,8,18,5,5,16,5,4,0,81
20,8,18,5,5,16,9,14,7,102
20,8,18,5,5,16,19,0,0,91
20,8,18,5,5,19,0,0,0,75
20,8,18,5,5,19,15,13,5,108
20,8,18,5,9,16,0,0,0,76
20,8,18,5,14,5,0,0,0,70
20,8,18,5,14,5,20,9,3,102
20,8,18,5,14,15,4,5,0,89
20,8,18,5,14,15,4,5,19,108
20,8,18,5,14,15,4,25,0,109
20,8,18,5,14,15,4,9,3,96
20,8,18,5,14,15,19,0,0,99
20,8,18,5,15,14,9,14,0,103
20,8,18,5,15,14,9,14,5,108
20,8,18,5,15,19,5,0,0,90
20,8,18,5,16,5,0,0,0,72
20,8,18,5,16,20,9,3,0,99
20,8,18,5,19,8,0,0,0,78
20,8,18,5,19,8,1,12,0,91
20,8,18,5,19,8,5,4,0,87
20,8,18,5,19,8,5,12,0,95
20,8,18,5,19,8,5,18,0,101
20,8,18,5,19,8,5,18,19,120
20,8,18,5,19,8,5,19,0,102
20,8,18,5,19,8,9,14,7,108
20,8,18,5,19,8,15,12,4,109
20,8,18,5,19,20,12,5,0,107
20,8,18,5,23,0,0,0,0,74
20,8,18,9,2,2,12,5,0,76
20,8,18,9,3,5,0,0,0,63
20,8,18,9,4,1,3,5,0,68
20,8,18,9,6,20,2,15,24,122
20,8,18,9,6,20,25,0,0,106
20,8,18,9,6,20,9,5,18,113
20,8,18,9,6,20,9,12,25,127
20,8,18,9,6,20,19,0,0,100
20,8,18,9,12,12,0,0,0,79
20,8,18,9,12,12,1,14,20,114
20,8,18,9,12,12,5,4,0,88
20,8,18,9,12,12,5,18,0,102
20,8,18,9,12,12,5,18,19,121
20,8,18,9,12,12,6,21,12,118
20,8,18,9,12,12,25,0,0,104
20,8,18,9,12,12,9,5,18,111
20,8,18,9,12,12,9,14,7,109
20,8,18,9,12,12,19,0,0,98
20,8,18,9,13,2,12,5,0,87
20,8,18,9,13,16,0,0,0,84
20,8,18,9,13,19,1,0,0,88
20,8,18,25,13,19,1,0,0,104
20,8,18,9,14,7,0,0,0,76
20,8,18,9,14,7,9,14,7,106
20,8,18,9,14,20,5,18,0,112
20,8,18,9,15,2,15,12,25,124
20,8,18,9,16,0,0,0,0,71
20,8,18,9,16,5,12,0,0,88
20,8,18,9,16,9,4,0,0,84
20,8,18,9,16,16,12,5,0,104
20,8,18,9,16,19,0,0,0,90
20,8,18,9,19,20,0,0,0,94
20,8,18,9,22,5,0,0,0,82
20,8,18,9,22,5,4,0,0,86
20,8,18,9,22,5,14,0,0,96
20,8,18,9,22,5,18,0,0,100
20,8,18,9,22,5,18,19,0,119
20,8,18,9,22,5,19,0,0,101
20,8,18,9,22,9,14,7,0,107
20,8,18,15,0,0,0,0,0,61
20,8,18,15,1,20,0,0,0,82
20,8,18,15,1,20,1,12,0,95
20,8,18,15,1,20,5,4,0,91
20,8,18,15,1,20,6,21,12,121
20,8,18,15,1,20,25,0,0,107
20,8,18,15,1,20,9,5,18,114
20,8,18,15,1,20,9,12,25,128
20,8,18,15,1,20,9,14,7,112
20,8,18,15,1,20,12,5,20,119
20,8,18,15,1,20,19,0,0,101
20,8,18,15,2,0,0,0,0,63
20,8,18,15,2,2,5,4,0,74
20,8,18,15,2,2,5,18,0,88
20,8,18,15,2,2,5,18,19,107
20,8,18,15,2,2,9,14,7,95
20,8,18,15,2,12,5,19,19,118
20,8,18,15,2,19,0,0,0,82
20,8,18,15,3,11,0,0,0,75
20,8,18,15,4,4,5,14,0,88
20,8,18,15,4,4,25,0,0,94
20,8,18,15,5,0,0,0,0,66
20,8,18,15,5,4,0,0,0,70
20,8,18,15,5,9,14,7,0,96
20,8,18,15,5,19,0,0,0,85
20,8,18,15,13,2,1,19,5,101
20,8,18,15,13,2,9,0,0,85
20,8,18,15,13,2,9,14,0,99
20,8,18,15,13,2,9,14,19,118
20,8,18,15,13,2,15,9,4,104
20,8,18,15,13,2,15,19,5,115
20,8,18,15,13,2,21,19,0,116
20,8,18,15,14,1,12,0,0,88
20,8,18,15,14,5,0,0,0,80
20,8,18,15,14,5,4,0,0,84
20,8,18,15,14,5,4,15,13,112
20,8,18,15,14,5,12,5,20,117
20,8,18,15,14,5,19,0,0,99
20,8,18,15,14,7,0,0,0,82
20,8,18,15,14,7,5,4,0,91
20,8,18,15,14,7,5,18,0,105
20,8,18,15,14,7,6,21,12,121
20,8,18,15,14,7,9,14,7,112
20,8,18,15,14,7,19,0,0,101
20,8,18,15,14,9,14,7,0,105
20,8,18,15,14,9,26,5,0,115
20,8,18,15,14,15,9,0,0,99
20,8,18,15,14,15,19,0,0,109
20,8,18,15,16,5,0,0,0,82
20,8,18,15,16,16,12,5,0,110
20,8,18,15,19,20,12,5,0,117
20,8,18,15,19,20,12,5,19,136
20,8,18,15,20,20,12,5,0,118
20,8,18,15,20,20,12,5,4,122
20,8,18,15,20,20,12,5,18,136
20,8,18,15,20,20,12,5,19,137
20,8,18,15,21,0,0,0,0,82
20,8,18,15,21,3,8,0,0,93
20,8,18,15,21,3,8,20,0,113
20,8,18,15,21,7,8,0,0,97
20,8,18,15,21,7,8,12,25,134
20,8,18,15,22,5,0,0,0,88
20,8,18,15,23,0,0,0,0,84
20,8,18,15,23,1,23,1,25,134
20,8,18,15,23,2,1,3,11,101
20,8,18,15,23,4,15,23,14,140
20,8,18,15,23,5,18,0,0,107
20,8,18,15,23,5,18,19,0,126
20,8,18,15,23,9,14,7,0,114
20,8,18,15,23,14,0,0,0,98
20,8,18,15,23,15,6,6,0,111
20,8,18,15,23,15,21,20,0,140
20,8,18,15,23,19,0,0,0,103
20,8,18,15,23,19,20,0,0,123
20,8,18,15,23,19,20,5,18,146
20,8,18,15,23,23,15,18,20,160
20,8,18,21,0,0,0,0,0,67
20,8,18,21,13,0,0,0,0,80
20,8,18,21,13,2,12,5,0,99
20,8,18,21,13,13,5,4,0,102
20,8,18,21,13,13,5,18,0,116
20,8,18,21,13,13,5,18,19,135
20,8,18,21,13,13,25,0,0,118
20,8,18,21,13,13,9,5,18,125
20,8,18,21,13,13,9,14,7,123
20,8,18,21,13,19,0,0,0,99
20,8,18,21,13,23,15,18,20,156
20,8,18,21,15,21,20,0,0,123
20,8,18,21,16,21,20,0,0,124
20,8,18,21,16,21,20,19,0,143
20,8,18,21,19,8,0,0,0,94
20,8,18,21,19,8,5,12,0,111
20,8,18,21,19,8,5,18,0,117
20,8,18,21,19,8,5,19,0,118
20,8,18,21,19,8,25,0,0,119
20,8,18,21,19,20,0,0,0,106
20,8,18,21,19,20,5,4,0,115
20,8,18,21,19,20,5,18,0,129
20,8,18,21,19,20,5,18,19,148
20,8,18,21,19,20,6,21,12,145
20,8,18,21,19,20,9,14,7,136
20,8,18,21,19,20,12,5,0,123
20,8,18,21,19,20,15,18,0,139
20,8,18,21,19,20,15,18,19,158
20,8,18,21,19,20,19,0,0,125
20,8,18,21,20,3,8,0,0,98
20,8,18,21,22,0,0,0,0,89
20,8,18,21,23,1,25,19,0,135
20,8,19,1,14,20,0,0,0,82
20,8,21,1,14,0,0,0,0,64
20,8,21,4,0,0,0,0,0,53
20,8,21,4,4,5,4,0,0,66
20,8,21,4,4,9,14,7,0,87
20,8,21,4,19,0,0,0,0,72
20,8,21,7,0,0,0,0,0,56
20,8,21,7,4,15,13,0,0,88
20,8,21,7,7,5,4,0,0,72
20,8,21,7,7,5,5,0,0,73
20,8,21,7,7,5,5,19,0,92
20,8,21,7,7,5,18,25,0,111
20,8,21,7,7,5,19,19,0,106
20,8,21,7,7,9,14,7,0,93
20,8,21,7,7,9,19,8,0,99
20,8,21,7,7,9,19,13,0,104
20,8,21,7,19,0,0,0,0,75
20,8,21,25,1,0,0,0,0,75
20,8,21,25,1,19,0,0,0,94
20,8,21,10,1,19,0,0,0,79
20,8,21,10,5,14,5,0,0,83
20,8,21,10,25,12,0,0,0,96
20,8,21,10,9,14,0,0,0,82
20,8,21,10,15,14,5,0,0,93
20,8,21,12,9,1,0,0,0,71
20,8,21,12,9,1,19,0,0,90
20,8,21,12,9,18,0,0,0,88
20,8,21,12,9,20,5,0,0,95
20,8,21,12,9,21,13,0,0,104
20,8,21,12,9,21,13,19,0,123
20,8,21,12,18,0,0,0,0,79
20,8,21,12,21,20,8,0,0,110
20,8,21,13,2,0,0,0,0,64
20,8,21,13,2,2,9,18,4,97
20,8,21,13,2,5,4,0,0,73
20,8,21,13,2,5,18,0,0,87
20,8,21,13,2,8,15,12,5,104
20,8,21,13,2,25,0,0,0,89
20,8,21,13,2,9,11,9,14,107
20,8,21,13,2,9,14,7,0,94
20,8,21,13,2,11,9,14,0,98
20,8,21,13,2,11,9,14,19,117
20,8,21,13,2,12,5,0,0,81
20,8,21,13,2,12,5,19,19,119
20,8,21,13,2,12,9,11,5,101
20,8,21,13,2,12,9,14,7,106
20,8,21,13,2,13,1,18,11,107
20,8,21,13,2,14,1,9,12,100
20,8,21,13,2,14,21,20,0,119
20,8,21,13,2,14,21,20,19,138
20,8,21,13,2,18,15,16,5,118
20,8,21,13,2,19,0,0,0,83
20,8,21,13,2,20,1,3,11,99
20,8,21,13,13,9,14,0,0,98
20,8,21,13,16,0,0,0,0,78
20,8,21,13,16,5,4,0,0,87
20,8,21,13,16,5,18,0,0,101
20,8,21,13,16,5,18,19,0,120
20,8,21,13,16,9,14,7,0,108
20,8,21,13,16,19,0,0,0,97
20,8,21,14,4,0,0,0,0,67
20,8,21,14,4,5,18,0,0,90
20,8,21,14,4,5,18,5,4,99
20,8,21,14,4,5,18,5,18,113
20,8,21,14,4,5,18,25,0,115
20,8,21,14,4,5,18,19,0,109
20,8,21,14,4,18,15,21,19,140
20,8,21,14,7,0,0,0,0,70
20,8,21,14,7,5,0,0,0,75
20,8,21,14,11,0,0,0,0,74
20,8,21,14,11,5,4,0,0,83
20,8,21,14,11,9,14,7,0,104
20,8,21,14,11,19,0,0,0,93
20,8,21,15,3,0,0,0,0,67
20,8,21,18,7,9,0,0,0,83
20,8,21,18,9,2,12,5,0,95
20,8,21,18,9,2,12,5,19,114
20,8,21,18,9,6,5,18,0,105
20,8,21,18,9,6,5,18,19,124
20,8,21,18,9,6,25,0,0,107
20,8,21,18,12,0,0,0,0,79
20,8,21,18,12,5,0,0,0,84
20,8,21,18,12,19,0,0,0,98
20,8,21,18,13,0,0,0,0,80
20,8,21,18,13,21,19,0,0,120
20,8,21,18,18,15,3,11,0,114
20,8,21,18,19,5,0,0,0,91
20,8,21,18,19,20,0,0,0,106
20,8,21,18,20,0,0,0,0,87
20,8,21,19,0,0,0,0,0,68
20,8,21,19,7,1,20,5,0,101
20,8,21,19,12,25,0,0,0,105
20,8,21,19,14,5,19,19,0,125
20,8,21,19,23,9,19,5,0,124
20,8,21,20,20,5,18,0,0,112
20,8,23,1,3,11,0,0,0,66
20,8,23,1,3,11,5,4,0,75
20,8,23,1,3,11,5,18,0,89
20,8,23,1,3,11,5,18,19,108
20,8,23,1,3,11,9,14,7,96
20,8,23,1,3,11,19,0,0,85
20,8,23,1,9,20,0,0,0,81
20,8,23,1,9,20,5,0,0,86
20,8,23,1,18,20,0,0,0,90
20,8,23,1,18,20,5,4,0,99
20,8,23,1,18,20,5,18,0,113
20,8,23,1,18,20,5,18,19,132
20,8,23,1,18,20,9,14,7,120
20,8,23,1,18,20,12,25,0,127
20,8,23,1,18,20,13,1,14,118
20,8,23,1,18,20,13,5,14,122
20,8,23,1,18,20,19,0,0,109
20,8,23,1,18,20,19,1,23,133
20,8,23,9,20,5,0,0,0,85
20,8,23,9,20,20,12,5,0,117
20,8,23,15,18,12,0,0,0,96
20,9,2,0,0,0,0,0,0,31
20,9,2,2,25,0,0,0,0,58
20,9,2,2,9,20,0,0,0,62
20,9,2,5,25,0,0,0,0,61
20,9,2,5,18,20,0,0,0,74
20,9,2,5,20,1,14,19,0,90
20,9,2,9,1,0,0,0,0,41
20,9,2,9,1,4,0,0,0,45
20,9,2,9,1,5,0,0,0,46
20,9,2,9,1,12,0,0,0,53
20,9,2,9,1,12,5,0,0,58
20,9,2,9,1,12,9,1,0,63
20,9,2,9,1,12,9,19,0,81
20,9,2,9,1,19,0,0,0,60
20,9,2,9,3,5,14,0,0,62
20,9,2,15,21,18,2,15,21,123
20,9,3,1,12,0,0,0,0,45
20,9,3,1,12,19,0,0,0,64
20,9,3,3,1,0,0,0,0,36
20,9,3,3,8,5,14,0,0,62
20,9,3,5,13,5,14,20,0,89
20,9,3,5,18,0,0,0,0,55
20,9,3,8,5,12,0,0,0,57
20,25,3,8,9,19,13,0,0,97
20,25,3,8,9,19,20,9,3,116
20,25,3,8,9,20,5,0,0,90
20,9,3,11,0,0,0,0,0,43
20,9,3,11,2,5,1,14,0,65
20,9,3,11,2,9,18,4,0,76
20,9,3,11,5,1,20,5,18,92
20,9,3,11,5,4,0,0,0,52
20,9,3,11,5,25,0,0,0,73
20,9,3,11,5,14,0,0,0,62
20,9,3,11,5,18,0,0,0,66
20,9,3,11,5,18,19,0,0,85
20,9,3,11,5,20,0,0,0,68
20,9,3,11,5,20,5,4,0,77
20,9,3,11,5,20,5,18,0,91
20,9,3,11,5,20,9,14,7,98
20,9,3,11,5,20,19,0,0,87
20,9,3,11,25,0,0,0,0,68
20,9,3,11,9,3,9,4,5,73
20,9,3,11,9,5,0,0,0,57
20,9,3,11,9,14,7,0,0,73
20,9,3,11,9,14,7,19,0,92
20,9,3,11,12,5,0,0,0,60
20,9,3,11,12,5,4,0,0,64
20,9,3,11,12,5,12,25,0,97
20,9,3,11,12,5,18,0,0,78
20,9,3,11,12,5,18,19,0,97
20,9,3,11,12,5,19,0,0,79
20,9,3,11,12,5,19,19,0,98
20,9,3,11,12,25,0,0,0,80
20,9,3,11,12,9,14,7,0,85
20,9,3,11,12,9,19,8,0,91
20,9,3,11,14,5,25,0,0,87
20,9,3,11,16,18,15,15,6,113
20,9,3,11,19,0,0,0,0,62
20,9,3,11,19,5,5,4,0,76
20,9,3,11,19,5,5,4,19,95
20,9,3,11,20,1,3,11,0,78
20,9,3,11,20,1,3,11,19,97
20,9,3,11,20,9,3,11,0,86
20,9,3,11,20,15,3,11,0,92
20,9,3,11,20,15,3,11,19,111
20,9,3,11,23,5,5,4,0,80
20,25,3,15,15,14,0,0,0,92
20,25,3,15,15,14,1,20,5,118
20,25,3,15,15,14,19,0,0,111
20,9,3,19,0,0,0,0,0,51
20,9,3,20,1,3,0,0,0,56
20,9,3,20,1,3,11,5,4,76
20,9,3,20,1,3,19,0,0,75
20,9,3,20,1,3,20,15,5,96
20,9,3,20,9,3,0,0,0,64
20,9,3,20,15,3,0,0,0,70
20,9,3,20,15,3,11,5,4,90
20,9,3,20,15,3,19,0,0,89
20,9,3,21,12,0,0,0,0,65
20,9,4,1,12,0,0,0,0,46
20,9,4,1,12,12,25,0,0,83
20,9,4,2,9,20,0,0,0,64
20,9,4,2,9,20,19,0,0,83
20,25,4,4,5,14,0,0,0,72
20,9,4,4,5,18,0,0,0,60
20,9,4,4,25,0,0,0,0,62
20,25,4,4,25,14,0,0,0,92
20,9,4,4,12,5,0,0,0,54
20,9,4,4,12,5,25,0,0,79
20,9,4,4,12,5,18,0,0,72
20,9,4,4,12,25,0,0,0,74
20,9,4,4,12,9,14,7,0,79
20,9,4,5,0,0,0,0,0,38
20,9,4,5,3,15,1,3,8,68
20,9,4,5,4,0,0,0,0,42
20,9,4,5,6,21,12,0,0,77
20,9,4,5,8,5,1,4,0,56
20,9,4,5,12,1,14,4,0,69
20,9,4,5,12,1,14,4,19,88
20,9,4,5,12,5,19,19,0,93
20,9,4,5,12,25,0,0,0,75
20,9,4,5,12,9,11,5,0,75
20,9,4,5,12,9,14,7,0,80
20,9,4,5,13,1,11,5,18,86
20,9,4,5,13,1,18,11,0,81
20,9,4,5,13,1,18,11,19,100
20,9,4,5,18,1,3,5,0,65
20,9,4,5,18,9,16,0,0,81
20,9,4,5,18,9,16,19,0,100
20,9,4,5,18,15,4,5,0,80
20,9,4,5,19,0,0,0,0,57
20,9,4,5,19,13,1,14,0,85
20,9,4,5,23,1,25,0,0,87
20,9,4,5,23,1,25,19,0,106
20,9,4,5,23,1,18,4,0,84
20,9,4,5,23,1,20,5,18,105
20,9,4,9,0,0,0,0,0,42
20,9,4,25,0,0,0,0,0,58
20,9,4,9,1,2,12,5,0,62
20,25,4,9,5,0,0,0,0,63
20,9,4,9,5,4,0,0,0,51
20,9,4,9,5,18,0,0,0,65
20,9,4,9,5,18,19,0,0,84
20,9,4,9,5,19,0,0,0,66
20,9,4,9,5,19,20,0,0,86
20,9,4,9,6,5,0,0,0,53
20,9,4,25,9,14,7,0,0,88
20,9,4,25,9,19,13,0,0,99
20,9,4,9,12,25,0,0,0,79
20,9,4,9,14,5,19,19,0,99
20,9,4,9,14,7,0,0,0,63
20,9,4,9,14,7,19,0,0,82
20,9,4,9,15,19,5,0,0,81
20,9,4,25,20,9,16,19,0,122
20,9,4,12,5,25,0,0,0,75
20,9,4,12,9,14,7,0,0,75
20,9,4,15,12,15,7,25,0,107
20,9,5,0,0,0,0,0,0,34
20,9,5,2,1,3,11,0,0,51
20,9,5,2,1,3,11,19,0,70
20,9,5,2,15,25,0,0,0,76
20,9,5,3,12,1,19,16,0,85
20,9,5,3,12,1,19,16,19,104
20,9,5,4,0,0,0,0,0,38
20,9,5,4,15,7,0,0,0,60
20,25,5,5,0,0,0,0,0,55
20,25,5,5,19,0,0,0,0,74
20,9,5,9,14,7,0,0,0,64
20,9,5,12,5,19,19,0,0,89
20,9,5,13,1,11,5,18,0,82
20,9,5,13,1,11,9,14,7,89
20,9,5,14,4,1,0,0,0,53
20,9,5,14,19,0,0,0,0,67
20,9,5,14,20,1,0,0,0,69
20,9,5,14,20,15,0,0,0,83
20,9,5,16,9,14,0,0,0,73
20,9,5,16,9,14,19,0,0,92
20,9,5,18,0,0,0,0,0,52
20,9,5,18,3,5,0,0,0,60
20,9,5,18,3,5,4,0,0,64
20,9,5,18,3,5,12,0,0,72
20,9,5,18,3,5,12,19,0,91
20,9,5,18,3,5,18,15,14,107
20,9,5,18,3,5,19,0,0,79
20,9,5,18,5,4,0,0,0,61
20,9,5,18,5,18,0,0,0,75
20,9,5,18,9,14,7,0,0,82
20,9,5,18,12,9,11,5,0,89
20,9,5,18,18,1,19,0,0,90
20,9,5,18,19,0,0,0,0,71
20,9,5,18,19,13,1,14,0,99
20,9,5,19,0,0,0,0,0,53
20,25,5,19,0,0,0,0,0,69
20,9,5,20,9,3,11,0,0,77
20,9,5,22,9,14,5,0,0,84
20,9,5,23,9,7,0,0,0,73
20,9,5,23,9,7,7,5,4,89
20,9,6,6,1,14,9,5,19,89
20,9,6,6,5,4,0,0,0,50
20,9,6,6,9,14,5,4,0,73
20,9,6,6,9,14,7,0,0,71
20,9,6,6,9,14,9,14,7,94
20,9,6,6,9,14,19,0,0,83
20,9,6,6,9,19,8,0,0,77
20,9,6,6,12,5,0,0,0,58
20,9,6,6,19,0,0,0,0,60
20,9,6,9,14,1,7,8,0,74
20,9,6,20,0,0,0,0,0,55
20,9,6,20,5,18,0,0,0,78
20,9,7,0,0,0,0,0,0,36
20,25,7,0,0,0,0,0,0,52
20,9,7,5,0,0,0,0,0,41
20,9,7,5,12,12,1,0,0,66
20,9,7,5,12,12,1,20,5,91
20,9,7,5,12,12,5,0,0,70
20,9,7,5,12,12,21,13,0,99
20,9,7,5,12,12,21,19,0,105
20,9,7,5,18,0,0,0,0,59
20,9,7,5,18,2,9,18,4,92
20,9,7,5,18,5,25,5,0,94
20,9,7,5,18,5,25,5,19,113
20,9,7,5,18,6,9,19,8,101
20,9,7,5,18,6,15,15,20,115
20,9,7,5,18,8,15,15,4,101
20,9,7,5,18,25,0,0,0,84
20,9,7,5,18,9,19,8,0,95
20,9,7,5,18,9,19,13,0,100
20,9,7,5,18,11,9,14,0,93
20,9,7,5,18,12,25,0,0,96
20,9,7,5,18,12,9,11,5,96
20,9,7,5,18,12,9,14,7,101
20,9,7,5,18,14,21,20,0,114
20,9,7,5,18,19,0,0,0,78
20,9,7,5,18,23,15,15,4,116
20,9,7,7,5,18,0,0,0,66
20,9,7,8,20,0,0,0,0,64
20,9,7,8,20,5,14,0,0,83
20,9,7,8,20,5,14,5,4,92
20,9,7,8,20,5,14,5,18,106
20,9,7,8,20,5,14,19,0,102
20,9,7,8,20,5,18,0,0,87
20,9,7,8,20,5,19,20,0,108
20,9,7,8,20,9,19,8,0,100
20,9,7,8,20,11,14,9,20,118
20,9,7,8,20,12,25,0,0,101
20,9,7,8,20,12,9,5,18,108
20,9,7,8,20,14,5,19,19,121
20,9,7,8,20,18,15,16,5,118
20,9,7,8,20,19,0,0,0,83
20,9,7,8,20,23,1,4,0,92
20,9,7,8,20,23,1,4,19,111
20,9,7,8,20,23,9,18,5,119
20,9,7,12,9,3,0,0,0,60
20,9,7,12,9,14,9,3,0,83
20,9,7,12,15,14,0,0,0,77
20,9,7,12,15,14,19,0,0,96
20,9,7,14,15,14,0,0,0,79
20,9,7,14,21,13,0,0,0,84
20,9,7,15,14,0,0,0,0,65
20,9,7,15,14,19,0,0,0,84
20,9,7,18,5,19,19,0,0,97
20,9,7,18,5,19,19,5,19,121
20,9,7,18,9,14,5,0,0,82
20,9,7,18,9,19,8,0,0,90
20,9,7,18,15,9,4,0,0,82
20,9,7,18,15,14,5,0,0,88
20,9,7,20,1,7,0,0,0,64
20,25,9,14,7,0,0,0,0,75
20,9,11,5,0,0,0,0,0,45
20,25,11,5,0,0,0,0,0,61
20,25,11,5,14,0,0,0,0,75
20,9,11,5,19,0,0,0,0,64
20,25,11,5,19,0,0,0,0,80
20,25,11,8,1,14,1,0,0,80
20,25,11,9,14,7,0,0,0,86
20,9,11,9,19,0,0,0,0,68
20,9,11,9,20,9,11,9,0,98
20,9,11,11,1,0,0,0,0,52
20,9,11,11,5,18,0,0,0,74
20,9,11,11,21,14,0,0,0,86
20,9,11,12,9,14,0,0,0,75
20,9,11,15,12,15,19,8,0,109
20,9,11,15,12,15,19,8,5,114
20,9,11,15,15,18,0,0,0,88
20,9,11,15,18,0,0,0,0,73
20,9,11,21,18,0,0,0,0,79
20,9,12,0,0,0,0,0,0,41
20,9,12,1,9,20,5,0,0,76
20,9,12,1,11,0,0,0,0,53
20,9,12,1,11,1,0,0,0,54
20,9,12,1,11,19,0,0,0,72
20,9,12,1,16,9,1,0,0,68
20,9,12,1,16,9,1,19,0,87
20,25,12,1,18,9,0,0,0,85
20,25,12,1,18,21,19,0,0,116
20,9,12,1,19,9,20,5,0,95
20,25,12,1,19,20,5,18,0,120
20,9,12,2,21,18,9,5,19,115
20,9,12,4,5,0,0,0,0,50
20,9,12,4,5,19,0,0,0,69
20,9,12,5,0,0,0,0,0,46
20,25,12,5,2,5,18,18,25,130
20,9,12,5,4,0,0,0,0,50
20,9,12,5,6,9,19,8,0,88
20,9,12,5,25,1,18,4,0,94
20,9,12,5,12,9,11,5,0,83
20,9,12,5,13,1,11,5,18,94
20,9,12,5,18,25,0,0,0,89
20,9,12,5,18,9,5,19,0,97
20,9,12,5,18,15,15,20,0,114
20,9,12,5,18,19,0,0,0,83
20,9,12,5,19,0,0,0,0,65
20,9,12,5,19,5,5,4,0,79
20,9,12,5,19,8,5,18,4,100
20,9,12,5,19,20,15,14,5,119
20,9,12,5,20,20,5,0,0,91
20,9,12,5,23,1,25,19,0,114
20,9,12,5,23,15,18,11,0,113
20,9,12,5,23,15,18,11,19,132
20,9,12,9,3,5,20,21,13,112
20,9,12,25,5,18,0,0,0,89
20,9,12,9,11,21,13,0,0,95
20,9,12,9,14,7,0,0,0,71
20,9,12,9,14,7,19,0,0,90
20,25,12,9,15,14,0,0,0,95
20,9,12,12,1,2,12,5,0,73
20,9,12,12,1,7,5,0,0,66
20,9,12,12,1,7,5,19,0,85
20,9,12,12,5,4,0,0,0,62
20,9,12,12,5,25,0,0,0,83
20,9,12,12,5,18,5,4,0,85
20,9,12,12,5,18,9,14,7,106
20,9,12,12,5,18,13,1,14,104
20,9,12,12,5,18,13,5,14,108
20,9,12,12,5,18,19,0,0,95
20,9,12,12,5,20,0,0,0,78
20,9,12,12,9,3,21,13,0,99
20,9,12,12,9,14,7,0,0,83
20,9,12,12,9,20,5,0,0,87
20,9,12,12,9,20,5,19,0,106
20,9,12,12,15,4,15,14,20,121
20,9,12,12,15,20,0,0,0,88
20,9,12,12,15,20,20,5,18,131
20,9,12,12,19,0,0,0,0,72
20,9,12,13,21,19,0,0,0,94
20,25,12,15,3,9,14,0,0,98
20,25,12,15,13,1,0,0,0,86
20,25,12,15,16,15,4,0,0,107
20,25,12,15,19,5,0,0,0,96
20,25,12,15,19,5,19,0,0,115
20,25,12,15,19,9,14,0,0,114
20,25,12,15,19,9,14,19,0,133
20,25,12,15,19,9,19,0,0,119
20,25,12,15,19,15,9,4,0,119
20,25,12,15,19,20,25,12,5,153
20,25,12,15,20,1,20,5,0,118
20,25,12,15,20,5,0,0,0,97
20,25,12,15,20,9,3,0,0,104
20,25,12,15,20,15,24,5,1,137
20,25,12,15,20,21,19,0,0,132
20,9,12,16,1,8,0,0,0,66
20,9,12,19,0,0,0,0,0,60
20,9,12,20,0,0,0,0,0,61
20,9,12,20,1,2,12,5,0,81
20,9,12,20,2,15,1,18,4,101
20,9,12,20,5,4,0,0,0,70
20,9,12,20,5,18,0,0,0,84
20,9,12,20,5,18,19,0,0,103
20,9,12,20,8,0,0,0,0,69
20,9,12,20,8,5,1,4,0,79
20,9,12,20,8,19,0,0,0,88
20,9,12,20,25,0,0,0,0,86
20,9,12,20,25,1,18,4,0,109
20,9,12,20,25,1,18,4,19,128
20,9,12,20,9,14,7,0,0,91
20,9,12,20,12,9,11,5,0,98
20,9,12,20,13,1,11,5,18,109
20,9,12,20,13,5,20,5,18,122
20,9,12,20,19,0,0,0,0,80
20,9,12,20,21,16,0,0,0,98
20,9,12,20,21,18,5,0,0,105
20,25,12,21,19,0,0,0,0,97
20,9,13,1,2,12,5,0,0,62
20,9,13,1,12,9,9,14,5,92
20,9,13,1,12,9,14,5,0,83
20,9,13,1,18,0,0,0,0,61
20,9,13,1,18,1,21,0,0,83
20,9,13,1,18,1,21,19,0,102
20,9,13,1,18,9,15,20,0,105
20,9,13,1,18,18,9,0,0,88
20,9,13,1,21,1,0,0,0,65
20,9,13,1,23,1,0,0,0,67
20,9,13,1,26,9,20,5,0,103
20,9,13,2,1,12,0,0,0,57
20,25,13,2,1,12,0,0,0,73
20,9,13,2,1,12,5,0,0,62
20,9,13,2,1,12,5,19,0,81
20,25,13,2,1,12,15,14,0,102
20,9,13,2,1,12,19,0,0,76
20,25,13,2,1,12,19,0,0,92
20,9,13,2,1,14,7,0,0,66
20,9,13,2,5,0,0,0,0,49
20,9,13,2,5,18,0,0,0,67
20,9,13,2,5,18,5,4,0,76
20,9,13,2,5,18,5,18,0,90
20,9,13,2,5,18,25,0,0,92
20,9,13,2,5,18,9,14,7,97
20,9,13,2,5,18,13,1,14,95
20,9,13,2,5,18,13,5,14,99
20,9,13,2,5,18,14,0,0,81
20,9,13,2,5,18,19,0,0,86
20,9,13,2,18,1,12,0,0,75
20,9,13,2,18,5,0,0,0,67
20,9,13,2,18,5,12,0,0,79
20,9,13,2,18,5,12,5,4,88
20,9,13,2,18,5,12,5,18,102
20,9,13,2,18,5,12,19,0,98
20,9,13,2,18,5,19,0,0,86
20,9,13,5,1,2,12,5,0,67
20,9,13,5,3,1,18,4,0,73
20,9,13,5,3,1,18,4,19,92
20,9,13,5,4,0,0,0,0,51
20,9,13,5,6,21,12,0,0,86
20,9,13,5,6,21,12,12,25,123
20,9,13,5,11,5,5,16,0,84
20,9,13,5,12,5,19,19,0,102
20,9,13,5,12,25,0,0,0,84
20,9,13,5,12,9,5,18,0,91
20,9,13,5,12,9,5,19,20,112
20,9,13,5,12,9,9,14,5,96
20,9,13,5,12,9,12,25,0,105
20,9,13,5,12,9,14,7,0,89
20,9,13,5,14,15,7,21,25,129
20,9,13,5,15,21,19,0,0,102
20,9,13,5,15,21,19,12,25,139
20,9,13,5,15,21,20,0,0,103
20,9,13,5,15,21,20,19,0,122
20,9,13,5,16,9,5,3,5,85
20,9,13,5,16,18,15,15,6,117
20,9,13,5,18,0,0,0,0,65
20,9,13,5,18,1,21,0,0,87
20,9,13,5,18,9,20,25,0,119
20,9,13,5,18,19,0,0,0,84
20,9,13,5,19,0,0,0,0,66
20,9,13,5,19,1,22,5,18,112
20,9,13,5,19,3,1,12,5,87
20,9,13,5,19,8,1,18,5,98
20,9,13,5,19,20,1,13,16,116
20,9,13,5,20,0,0,0,0,67
20,9,13,5,20,1,2,12,5,87
20,9,13,5,20,1,11,5,18,102
20,9,13,5,20,18,16,0,0,101
20,9,13,5,23,1,18,4,0,93
20,9,13,5,23,15,18,11,0,114
20,9,13,5,23,15,18,11,19,133
20,9,13,5,23,15,18,14,0,117
20,9,13,9,4,0,0,0,0,55
20,9,13,9,4,5,18,0,0,78
20,9,13,9,4,5,19,20,0,99
20,9,13,9,4,9,20,25,0,109
20,9,13,9,4,12,25,0,0,92
20,9,13,9,4,14,5,19,19,112
20,9,13,9,4,15,21,19,0,110
20,9,13,9,14,7,0,0,0,72
20,9,13,9,14,7,19,0,0,91
20,9,13,9,19,8,0,0,0,78
20,9,13,9,19,20,0,0,0,90
20,9,13,13,5,18,0,0,0,78
20,9,13,15,0,0,0,0,0,57
20,9,13,15,3,18,1,3,25,107
20,9,13,15,14,5,5,18,0,99
20,9,13,15,18,15,19,15,0,124
20,9,13,15,18,15,21,19,0,130
20,9,13,15,18,19,15,13,5,127
20,9,13,15,20,8,9,5,19,118
20,25,13,16,0,0,0,0,0,74
20,25,13,16,1,14,0,0,0,89
20,9,13,16,1,14,1,0,0,74
20,25,13,16,1,14,1,0,0,90
20,25,13,16,1,14,1,12,0,102
20,25,13,16,1,14,1,13,0,103
20,9,13,16,1,14,9,0,0,82
20,25,13,16,1,14,9,0,0,98
20,25,13,16,1,14,25,0,0,114
20,25,13,16,1,14,9,3,0,101
20,25,13,16,1,14,9,5,19,122
20,25,13,16,1,14,9,14,7,119
20,25,13,16,1,14,9,19,13,130
20,9,13,16,1,14,9,19,20,121
20,25,13,16,1,14,9,19,20,137
20,25,13,16,1,14,9,26,5,129
20,9,13,16,1,14,15,0,0,88
20,25,13,16,1,14,15,0,0,104
20,25,13,16,1,14,15,14,0,118
20,25,13,16,1,14,19,0,0,108
20,9,13,16,1,14,21,13,0,107
20,25,13,16,1,14,21,13,0,123
20,9,13,16,1,14,21,13,19,126
20,25,13,16,1,14,21,13,19,142
20,9,13,23,8,9,19,11,25,137
20,9,14,0,0,0,0,0,0,43
20,9,14,1,7,5,0,0,0,56
20,9,14,1,10,1,0,0,0,55
20,9,14,1,13,9,14,5,0,85
20,9,14,1,13,15,21,0,0,93
20,9,14,1,13,15,21,19,0,112
20,9,14,1,13,16,9,16,9,107
20,9,14,2,5,18,7,5,14,94
20,9,14,3,0,0,0,0,0,46
20,9,14,3,1,12,0,0,0,59
20,9,14,3,1,12,19,0,0,78
20,9,14,3,8,5,12,0,0,71
20,9,14,3,8,9,12,12,0,87
20,9,14,3,12,1,4,0,0,63
20,9,14,3,20,0,0,0,0,66
20,9,14,3,20,5,4,0,0,75
20,9,14,3,20,9,14,7,0,96
20,9,14,3,20,9,15,14,0,104
20,9,14,3,20,19,0,0,0,85
20,9,14,3,20,21,18,5,0,110
20,9,14,3,20,21,18,5,4,114
20,9,14,3,20,21,18,5,19,129
20,9,14,4,0,0,0,0,0,47
20,25,14,4,0,0,0,0,0,63
20,9,14,4,1,12,15,0,0,75
20,9,14,4,5,18,0,0,0,70
20,9,14,4,5,18,2,15,24,111
20,9,14,4,5,18,5,4,0,79
20,9,14,4,5,18,25,0,0,95
20,9,14,4,5,18,9,19,8,106
20,9,14,4,5,18,15,21,19,125
20,9,14,4,5,18,19,0,0,89
20,9,14,5,1,0,0,0,0,49
20,9,14,5,1,12,0,0,0,61
20,9,14,5,1,14,0,0,0,63
20,9,14,5,1,19,0,0,0,68
20,9,14,5,4,0,0,0,0,52
20,25,14,5,4,0,0,0,0,68
20,9,14,5,7,18,1,19,19,112
20,9,14,5,9,4,0,0,0,61
20,9,14,5,9,4,19,0,0,80
20,9,14,5,9,14,5,0,0,76
20,9,14,5,13,1,14,0,0,76
20,9,14,5,13,5,14,0,0,80
20,9,14,5,15,9,4,0,0,76
20,9,14,5,15,12,1,0,0,76
20,9,14,5,18,5,18,0,0,89
20,9,14,5,19,0,0,0,0,67
20,25,14,5,19,0,0,0,0,83
20,9,14,5,20,1,18,5,0,92
20,9,14,5,20,25,0,0,0,93
20,9,14,5,23,5,5,4,0,85
20,9,14,6,15,9,12,0,0,85
20,9,14,6,15,9,12,19,0,104
20,9,14,6,21,12,0,0,0,82
20,9,14,6,21,12,19,0,0,101
20,9,14,7,5,0,0,0,0,55
20,9,14,7,5,4,0,0,0,59
20,9,14,7,5,9,14,7,0,85
20,9,14,7,5,14,20,0,0,89
20,9,14,7,5,18,0,0,0,73
20,9,14,7,5,19,0,0,0,74
20,9,14,7,9,0,0,0,0,59
20,9,14,7,9,2,12,5,0,78
20,9,14,7,9,4,0,0,0,63
20,9,14,7,9,14,7,0,0,80
20,9,14,7,9,20,9,4,0,92
20,9,14,7,12,1,19,19,0,101
20,9,14,7,12,5,0,0,0,67
20,9,14,7,12,5,4,0,0,71
20,9,14,7,12,5,18,0,0,85
20,9,14,7,12,5,18,19,0,104
20,9,14,7,12,5,19,0,0,86
20,9,14,7,12,25,0,0,0,87
20,9,14,7,12,9,5,18,0,94
20,9,14,7,12,9,5,19,20,115
20,9,14,7,12,9,14,7,0,92
20,9,14,7,12,9,19,8,0,98
20,9,14,7,19,0,0,0,0,69
20,9,14,7,20,1,14,7,0,92
20,9,14,7,21,1,9,20,5,106
20,9,14,7,21,25,0,0,0,96
20,9,14,8,15,18,14,0,0,98
20,9,14,8,15,18,14,19,0,117
20,9,14,8,15,21,19,5,0,111
20,9,14,9,5,18,0,0,0,75
20,9,14,9,5,19,20,0,0,96
20,9,14,9,12,25,0,0,0,89
20,9,14,9,14,5,19,19,0,109
20,9,14,9,14,7,0,0,0,73
20,25,14,9,14,7,0,0,0,89
20,9,14,11,0,0,0,0,0,54
20,9,14,11,5,18,0,0,0,77
20,9,14,11,5,18,4,15,13,109
20,9,14,11,5,18,5,4,0,86
20,9,14,11,5,18,5,18,0,100
20,9,14,11,5,18,5,18,19,119
20,9,14,11,5,18,9,14,7,107
20,9,14,11,5,18,12,25,0,114
20,9,14,11,5,18,19,0,0,96
20,9,14,11,12,5,0,0,0,71
20,9,14,11,12,5,4,0,0,75
20,9,14,11,12,5,18,0,0,89
20,9,14,11,12,5,18,19,0,108
20,9,14,11,12,5,19,0,0,90
20,9,14,11,12,25,0,0,0,91
20,9,14,11,12,9,5,18,0,98
20,9,14,11,12,9,5,19,20,119
20,9,14,11,12,9,14,7,0,96
20,9,14,11,12,9,14,7,19,115
20,9,14,12,5,20,0,0,0,80
20,9,14,12,9,11,5,0,0,80
20,9,14,13,1,14,0,0,0,71
20,9,14,13,5,14,0,0,0,75
20,9,14,14,5,4,0,0,0,66
20,9,14,14,5,14,0,0,0,76
20,9,14,14,5,18,0,0,0,80
20,9,14,14,5,18,25,0,0,105
20,9,14,14,5,18,19,0,0,99
20,9,14,14,5,20,0,0,0,82
20,9,14,14,25,0,0,0,0,82
20,9,14,14,9,5,14,20,0,105
20,9,14,14,9,5,18,0,0,89
20,9,14,14,9,5,19,20,0,110
20,9,14,14,9,6,9,5,4,90
20,9,14,14,9,12,25,0,0,103
20,9,14,14,9,14,5,19,19,123
20,9,14,14,9,14,7,0,0,87
20,9,14,14,9,20,21,19,0,126
20,9,14,14,15,3,11,0,0,86
20,9,14,15,19,1,0,0,0,78
20,9,14,16,12,1,20,5,0,97
20,9,14,16,12,1,20,5,19,116
20,9,14,16,15,20,0,0,0,94
20,9,14,19,0,0,0,0,0,62
20,9,14,19,5,12,0,0,0,79
20,9,14,19,5,12,5,4,0,88
20,9,14,19,5,12,9,14,7,109
20,9,14,19,5,12,12,5,4,100
20,9,14,19,5,12,12,25,0,116
20,9,14,19,5,12,18,25,0,122
20,9,14,19,5,12,19,0,0,98
20,9,14,19,25,0,0,0,0,87
20,9,14,19,13,1,14,0,0,90
20,9,14,19,13,5,14,0,0,94
20,9,14,19,13,9,20,8,0,112
20,9,14,19,13,9,20,8,25,137
20,9,14,19,13,9,20,8,19,131
20,9,14,19,20,15,14,5,0,116
20,9,14,19,20,15,14,5,19,135
20,9,14,19,20,21,6,6,0,115
20,9,14,20,0,0,0,0,0,63
20,9,14,20,1,0,0,0,0,64
20,9,14,20,1,3,11,0,0,78
20,9,14,20,1,7,5,0,0,76
20,9,14,20,1,13,1,18,0,96
20,9,14,20,1,18,18,15,14,129
20,9,14,20,5,4,0,0,0,72
20,9,14,20,5,18,0,0,0,86
20,9,14,20,5,18,19,0,0,105
20,9,14,20,25,0,0,0,0,88
20,9,14,20,9,5,0,0,0,77
20,9,14,20,9,14,5,19,19,129
20,9,14,20,9,14,7,0,0,93
20,9,14,20,9,14,7,12,25,130
20,9,14,20,9,14,7,19,0,112
20,9,14,20,25,16,5,0,0,109
20,9,14,20,25,16,5,18,0,127
20,9,14,20,25,16,5,19,0,128
20,9,14,20,9,19,20,0,0,111
20,9,14,20,12,5,19,19,0,118
20,9,14,20,19,0,0,0,0,82
20,9,14,23,1,12,4,0,0,83
20,9,14,23,1,18,5,0,0,90
20,9,14,23,1,18,5,19,0,109
20,9,14,23,15,13,1,14,0,109
20,9,14,23,15,18,11,0,0,110
20,9,14,23,15,18,11,5,18,133
20,9,14,23,15,18,11,19,0,129
20,9,14,26,5,14,9,20,5,122
20,9,15,14,0,0,0,0,0,58
20,9,15,21,19,0,0,0,0,84
20,25,16,0,0,0,0,0,0,61
20,25,16,1,2,12,5,0,0,81
20,25,16,1,12,0,0,0,0,74
20,9,16,2,21,18,14,0,0,100
20,9,16,3,1,18,20,0,0,87
20,9,16,3,1,18,20,19,0,106
20,9,16,3,1,20,0,0,0,69
20,9,16,3,1,20,19,0,0,88
20,9,16,5,0,0,0,0,0,50
20,25,16,5,0,0,0,0,0,66
20,25,16,5,1,2,12,5,0,86
20,25,16,5,2,1,18,0,0,87
20,25,16,5,2,1,18,19,0,106
20,25,16,5,3,1,19,5,0,94
20,25,16,5,3,1,19,5,19,113
20,25,16,5,3,1,19,20,0,109
20,25,16,5,3,1,19,20,19,128
20,25,16,5,4,0,0,0,0,70
20,25,16,5,6,1,3,5,0,81
20,25,16,5,6,1,3,5,19,100
20,25,16,5,6,15,18,13,0,118
20,25,16,5,8,5,1,4,0,84
20,25,16,5,25,0,0,0,0,91
20,25,16,5,12,5,19,19,0,121
20,25,16,5,15,21,20,0,0,122
20,25,16,5,18,0,0,0,0,84
20,25,16,5,19,0,0,0,0,85
20,25,16,5,19,5,20,0,0,110
20,25,16,5,19,5,20,19,0,129
20,25,16,5,19,15,6,0,0,106
20,25,16,5,23,18,9,20,5,141
20,25,16,5,23,18,15,20,5,147
20,9,16,6,21,12,0,0,0,84
20,25,16,8,1,5,13,9,1,98
20,9,16,8,5,1,4,0,0,63
20,25,16,8,5,13,9,1,0,97
20,25,16,8,9,1,0,0,0,79
20,25,16,8,9,3,0,0,0,81
20,25,16,8,9,14,9,1,0,102
20,25,16,8,12,9,20,9,3,122
20,25,16,8,12,9,20,9,19,138
20,25,16,8,12,15,14,0,0,110
20,25,16,8,12,15,16,9,4,125
20,25,16,8,12,15,19,9,19,143
20,25,16,8,15,5,13,9,1,112
20,25,16,8,15,9,4,0,0,97
20,25,16,8,15,9,4,1,12,110
20,25,16,8,15,9,4,9,14,120
20,25,16,8,15,9,4,19,0,116
20,25,16,8,15,14,9,1,0,108
20,25,16,8,15,14,19,0,0,117
20,25,16,8,15,15,14,0,0,113
20,25,16,8,15,15,14,19,0,132
20,25,16,8,15,19,5,0,0,108
20,25,16,8,15,19,9,19,0,131
20,25,16,8,15,21,19,0,0,124
20,25,16,8,21,19,0,0,0,109
20,25,16,8,21,19,5,19,0,133
20,9,16,9,0,0,0,0,0,54
20,25,16,25,0,0,0,0,0,86
20,25,16,9,3,0,0,0,0,73
20,25,16,9,3,1,0,0,0,74
20,25,16,9,3,1,12,0,0,86
20,25,16,9,3,1,12,12,25,123
20,25,16,9,3,15,14,0,0,102
20,25,16,9,3,21,13,0,0,107
20,25,16,9,5,18,0,0,0,93
20,25,16,9,5,19,20,0,0,114
20,25,16,9,6,25,0,0,0,101
20,25,16,9,6,9,5,4,0,94
20,25,16,9,6,9,5,18,0,108
20,25,16,9,6,9,5,18,19,127
20,25,16,9,6,9,5,19,0,109
20,25,16,9,6,25,9,14,7,131
20,25,16,9,11,1,0,0,0,82
20,25,16,9,11,15,14,0,0,110
20,25,16,9,11,15,14,19,0,129
20,25,16,9,14,7,0,0,0,91
20,9,16,9,19,0,0,0,0,73
20,25,16,9,19,20,0,0,0,109
20,25,16,9,19,20,19,0,0,128
20,9,16,9,20,0,0,0,0,74
20,9,16,9,20,9,0,0,0,83
20,9,16,12,5,0,0,0,0,62
20,9,16,12,5,19,19,0,0,100
20,9,16,12,5,20,0,0,0,82
20,9,16,13,1,14,0,0,0,73
20,9,16,13,5,14,0,0,0,77
20,9,16,13,15,19,20,0,0,112
20,25,16,15,0,0,0,0,0,76
20,25,16,15,2,1,18,0,0,97
20,25,16,15,3,15,19,13,25,151
20,9,16,15,6,6,0,0,0,72
20,9,16,15,6,6,19,0,0,91
20,25,16,15,7,18,1,16,8,126
20,25,16,15,12,15,7,25,0,135
20,25,16,15,12,15,7,9,3,122
20,25,16,15,13,1,14,9,1,114
20,25,16,15,13,5,20,18,25,157
20,9,16,15,14,9,0,0,0,83
20,25,16,15,14,25,13,0,0,128
20,25,16,15,14,25,13,1,12,141
20,25,16,15,14,25,13,9,3,140
20,25,16,15,16,8,9,12,5,126
20,25,16,15,18,1,13,1,0,109
20,25,16,15,19,0,0,0,0,95
20,25,16,15,20,8,5,18,5,132
20,25,16,16,0,0,0,0,0,77
20,9,16,16,1,2,12,5,0,81
20,9,16,16,5,4,0,0,0,70
20,9,16,16,5,5,0,0,0,71
20,9,16,16,5,18,0,0,0,84
20,9,16,16,5,18,19,0,0,103
20,9,16,16,5,20,0,0,0,86
20,9,16,16,25,0,0,0,0,86
20,9,16,16,9,5,18,0,0,93
20,9,16,16,9,5,19,20,0,114
20,9,16,16,9,14,7,0,0,91
20,9,16,16,25,20,15,5,0,126
20,9,16,16,12,5,0,0,0,78
20,9,16,16,12,5,4,0,0,82
20,9,16,16,12,5,13,1,14,106
20,9,16,16,12,5,18,0,0,96
20,9,16,16,12,5,18,19,0,115
20,9,16,16,12,5,19,0,0,97
20,9,16,16,12,25,0,0,0,98
20,9,16,16,12,9,14,7,0,103
20,9,16,16,18,15,15,6,0,115
20,25,16,16,19,0,0,0,0,96
20,9,16,18,5,5,0,0,0,73
20,9,16,19,25,0,0,0,0,89
20,9,16,19,9,5,18,0,0,96
20,9,16,19,9,5,19,20,0,117
20,9,16,19,9,6,25,0,0,104
20,9,16,19,9,6,9,5,18,111
20,9,16,19,9,12,25,0,0,110
20,9,16,19,9,14,5,19,19,130
20,9,16,19,20,1,6,6,0,97
20,9,16,19,20,1,6,6,19,116
20,9,16,19,20,1,22,5,19,131
20,9,16,19,20,5,18,0,0,107
20,9,16,19,20,5,18,19,0,126
20,9,16,19,20,15,3,11,0,113
20,9,16,19,20,15,3,11,19,132
20,9,16,20,1,9,12,0,0,87
20,9,16,20,5,5,18,5,18,116
20,9,16,20,9,12,20,0,0,106
20,9,16,20,15,5,0,0,0,85
20,9,16,20,15,5,4,0,0,89
20,9,16,20,15,5,9,14,7,115
20,9,16,20,15,5,19,0,0,104
20,9,16,20,15,9,14,7,0,110
20,25,16,20,15,12,15,7,25,155
20,9,16,20,15,16,0,0,0,96
20,9,16,20,15,16,16,5,18,135
20,9,16,20,15,16,19,0,0,115
20,9,16,21,12,9,4,0,0,91
20,9,16,21,12,15,9,4,0,106
20,9,16,21,16,0,0,0,0,82
20,25,16,23,0,0,0,0,0,84
20,9,17,21,5,21,18,0,0,111
20,9,18,1,4,5,0,0,0,57
20,9,18,1,4,5,19,0,0,76
20,9,18,1,7,5,0,0,0,60
20,9,18,1,12,5,5,0,0,70
20,25,18,1,13,9,14,0,0,100
20,25,18,1,13,9,14,5,0,105
20,25,18,1,13,9,14,5,19,124
20,25,18,1,14,14,5,19,19,135
20,25,18,1,14,14,25,0,0,117
20,25,18,1,14,14,9,1,12,114
20,25,18,1,14,14,9,3,0,104
20,25,18,1,14,14,9,5,19,125
20,25,18,1,14,14,9,14,5,120
20,25,18,1,14,14,9,19,0,120
20,25,18,1,14,14,9,19,5,125
20,25,18,1,14,14,9,19,13,133
20,25,18,1,14,14,9,26,5,132
20,25,18,1,14,14,15,9,4,120
20,25,18,1,14,14,15,21,19,147
20,25,18,1,14,20,0,0,0,98
20,25,18,1,14,20,19,0,0,117
20,25,18,1,19,15,12,5,0,115
20,9,18,1,19,19,5,0,0,91
20,9,18,1,26,0,0,0,0,74
20,9,18,5,0,0,0,0,0,52
20,9,18,5,4,0,0,0,0,56
20,25,18,5,4,0,0,0,0,72
20,9,18,5,4,5,18,0,0,79
20,9,18,5,4,5,19,20,0,100
20,9,18,5,4,12,25,0,0,93
20,9,18,5,4,14,5,19,19,113
20,9,18,5,4,15,13,0,0,84
20,9,18,5,8,15,21,19,5,120
20,9,18,5,12,5,19,19,0,107
20,9,18,5,12,9,14,7,0,94
20,9,18,5,13,1,9,4,0,79
20,9,18,5,13,1,11,5,18,100
20,9,18,5,13,1,14,0,0,80
20,9,18,5,13,5,14,0,0,84
20,9,18,5,13,5,14,20,0,104
20,25,18,5,13,5,19,9,19,133
20,9,18,5,18,0,0,0,0,70
20,9,18,5,18,15,15,13,0,113
20,9,18,5,19,0,0,0,0,71
20,25,18,5,19,0,0,0,0,87
20,9,18,5,19,13,9,20,8,121
20,9,18,5,19,15,12,0,0,98
20,9,18,5,19,15,13,5,0,104
20,9,18,5,23,15,13,1,14,118
20,9,18,5,23,15,13,5,14,122
20,25,18,9,1,19,9,19,0,120
20,9,18,9,2,1,0,0,0,59
20,9,18,9,14,7,0,0,0,77
20,25,18,9,14,7,0,0,0,93
20,9,18,9,14,7,12,25,0,114
20,9,18,12,0,0,0,0,0,59
20,9,18,12,5,4,0,0,0,68
20,9,18,12,9,14,7,0,0,89
20,9,18,12,19,0,0,0,0,78
20,9,18,13,1,0,0,0,0,61
20,25,18,15,3,9,4,9,14,117
20,9,18,15,3,9,14,9,1,98
20,25,18,15,9,4,0,0,0,91
20,25,18,15,12,9,20,5,0,124
20,25,18,15,12,15,7,25,0,137
20,25,18,15,13,1,0,0,0,92
20,25,18,15,13,1,14,3,25,134
20,25,18,15,13,1,19,0,0,111
20,25,18,15,13,1,20,1,0,113
20,25,18,15,14,9,3,0,0,104
20,25,18,15,14,9,19,13,0,133
20,25,18,15,19,0,0,0,0,97
20,25,18,15,19,25,12,0,0,134
20,25,18,15,19,9,14,5,0,125
20,25,18,15,19,9,14,5,19,144
20,9,18,18,0,0,0,0,0,65
20,9,18,18,1,3,11,5,0,85
20,9,18,18,5,20,0,0,0,90
20,9,18,18,9,20,0,0,0,94
20,9,18,18,9,22,5,5,0,106
20,9,18,18,9,22,5,5,19,125
20,9,18,18,9,22,9,5,0,110
20,9,18,18,12,9,5,0,0,91
20,9,18,18,23,9,18,18,0,133
20,9,18,19,8,1,20,8,1,104
20,9,18,22,5,0,0,0,0,74
20,9,18,23,9,20,0,0,0,99
20,9,19,0,0,0,0,0,0,48
20,9,19,1,14,5,0,0,0,68
20,9,19,1,14,5,19,0,0,87
20,9,19,1,18,0,0,0,0,67
20,9,19,9,3,0,0,0,0,60
20,25,19,15,14,9,20,5,0,127
20,9,19,19,21,0,0,0,0,88
20,9,19,19,21,1,12,0,0,101
20,9,19,19,21,5,0,0,0,93
20,9,19,19,21,5,4,0,0,97
20,9,19,19,21,5,25,0,0,118
20,9,19,19,21,5,19,0,0,112
20,9,19,19,21,9,14,7,0,118
20,9,19,19,21,12,1,18,0,119
20,9,19,19,23,15,15,4,0,124
20,25,19,20,5,0,0,0,0,89
20,25,19,20,9,5,0,0,0,98
20,9,19,23,9,14,0,0,0,94
20,25,20,0,0,0,0,0,0,65
20,9,20,1,14,1,20,5,0,90
20,9,20,1,14,1,20,5,19,109
20,9,20,1,14,9,1,19,0,93
20,9,20,1,14,25,12,0,0,101
20,9,20,1,14,9,19,13,19,124
20,9,20,1,14,9,20,5,0,98
20,9,20,1,14,9,20,5,19,117
20,9,20,1,14,9,20,9,3,105
20,9,20,1,14,9,21,13,0,107
20,9,20,1,14,9,21,13,19,126
20,9,20,1,14,15,0,0,0,79
20,9,20,1,14,15,21,19,0,119
20,9,20,1,14,19,0,0,0,83
20,9,20,1,18,0,0,0,0,68
20,9,20,2,9,20,0,0,0,80
20,9,20,2,9,20,19,0,0,99
20,9,20,2,9,20,20,25,0,125
20,9,20,5,0,0,0,0,0,54
20,9,20,5,18,0,0,0,0,72
20,9,20,5,18,19,0,0,0,91
20,9,20,6,5,18,0,0,0,78
20,9,20,6,5,18,19,0,0,97
20,9,20,6,9,19,8,0,0,91
20,9,20,8,1,2,12,5,0,77
20,9,20,8,1,12,0,0,0,70
20,9,20,8,5,0,0,0,0,62
20,25,20,8,5,0,0,0,0,78
20,9,20,8,5,2,15,15,11,105
20,9,20,8,5,4,0,0,0,66
20,25,20,8,5,4,0,0,0,82
20,9,20,8,5,12,5,19,19,117
20,9,20,8,5,18,0,0,0,80
20,9,20,8,5,18,19,0,0,99
20,9,20,8,5,19,0,0,0,81
20,25,20,8,5,19,0,0,0,97
20,9,20,8,25,13,1,12,0,108
20,9,20,8,9,14,7,0,0,87
20,25,20,8,9,14,7,0,0,103
20,9,20,8,9,14,7,19,0,106
20,9,20,8,15,14,9,1,0,96
20,9,20,8,15,14,9,1,19,115
20,9,20,8,15,14,9,3,0,98
20,9,20,9,0,0,0,0,0,58
20,9,20,9,1,14,19,0,0,92
20,9,20,9,5,14,0,0,0,77
20,9,20,9,12,1,20,5,0,96
20,9,20,9,12,12,1,14,20,117
20,9,20,9,12,12,1,20,5,108
20,9,20,9,19,0,0,0,0,77
20,9,20,9,22,1,20,5,0,106
20,9,20,9,22,1,20,5,4,110
20,9,20,9,22,1,20,5,19,125
20,9,20,9,22,1,20,15,18,134
20,9,20,9,22,9,12,0,0,101
20,9,20,12,1,18,11,0,0,91
20,9,20,12,1,18,11,19,0,110
20,9,20,12,5,0,0,0,0,66
20,9,20,12,5,4,0,0,0,70
20,9,20,12,5,4,15,13,0,98
20,9,20,12,5,12,5,19,19,121
20,9,20,12,5,14,5,0,0,85
20,9,20,12,5,18,0,0,0,84
20,9,20,12,5,19,0,0,0,85
20,9,20,12,5,19,8,9,16,118
20,9,20,12,9,11,5,0,0,86
20,9,20,12,9,14,7,0,0,91
20,9,20,12,9,19,20,0,0,109
20,9,20,12,9,19,20,19,0,128
20,9,20,13,1,12,0,0,0,75
20,9,20,13,1,12,12,0,0,87
20,9,20,13,1,14,0,0,0,77
20,9,20,13,5,14,0,0,0,81
20,9,20,13,9,3,5,0,0,79
20,9,20,13,13,9,3,5,0,92
20,9,20,13,15,21,19,5,0,122
20,9,20,15,11,9,0,0,0,84
20,9,20,18,1,2,12,5,0,87
20,9,20,18,1,14,20,0,0,102
20,9,20,18,1,14,20,19,0,121
20,9,20,18,1,20,5,0,0,93
20,9,20,18,1,20,5,4,0,97
20,9,20,18,1,20,5,19,0,112
20,9,20,18,1,20,9,14,7,118
20,9,20,18,1,20,9,15,14,126
20,9,20,18,1,20,15,18,0,121
20,9,20,18,1,20,15,18,19,140
20,9,20,18,5,0,0,0,0,72
20,9,20,18,5,19,0,0,0,91
20,9,20,19,0,0,0,0,0,68
20,9,20,20,5,18,0,0,0,92
20,9,20,20,5,18,5,4,0,101
20,9,20,20,5,18,5,12,0,109
20,9,20,20,5,18,5,18,0,115
20,9,20,20,5,18,5,18,19,134
20,9,20,20,5,18,25,0,0,117
20,9,20,20,5,18,9,14,7,122
20,9,20,20,5,18,19,0,0,111
20,9,20,20,25,0,0,0,0,94
20,9,20,20,9,5,0,0,0,83
20,9,20,20,9,5,19,0,0,102
20,9,20,20,9,22,1,20,5,126
20,9,20,20,12,5,0,0,0,86
20,9,20,20,12,5,2,1,20,109
20,9,20,20,12,5,18,0,0,104
20,9,20,20,12,5,19,0,0,105
20,9,20,20,12,9,14,0,0,104
20,9,20,20,21,16,0,0,0,106
20,9,20,20,21,16,5,4,0,115
20,9,20,20,21,16,25,0,0,131
20,9,20,20,21,16,9,14,7,136
20,9,20,20,21,16,16,5,4,131
20,9,20,20,21,16,16,25,0,147
20,9,20,20,21,16,19,0,0,125
20,9,20,21,2,1,14,3,25,115
20,9,20,21,2,1,14,20,0,107
20,9,20,21,2,1,20,5,0,98
20,9,20,21,12,1,4,15,0,102
20,9,20,21,12,1,18,0,0,101
20,9,20,21,12,1,18,25,0,126
20,9,20,21,12,1,18,12,25,138
20,9,20,21,12,1,18,19,0,120
20,9,20,21,12,5,0,0,0,87
20,9,20,21,12,9,0,0,0,91
20,9,20,21,12,21,19,0,0,122
20,25,21,13,0,0,0,0,0,79
20,9,22,5,18,0,0,0,0,74
20,9,22,25,0,0,0,0,0,76
20,9,26,1,0,0,0,0,0,56
20,9,26,5,21,18,0,0,0,99
20,9,26,23,9,14,0,0,0,101
20,9,26,26,25,0,0,0,0,106
20,9,26,26,9,5,19,0,0,114
20,10,5,14,11,1,12,0,0,73
20,10,9,0,0,0,0,0,0,39
20,10,15,19,9,20,5,0,0,98
20,10,21,18,21,14,7,1,0,112
20,11,20,0,0,0,0,0,0,51
20,12,15,0,0,0,0,0,0,47
20,12,18,0,0,0,0,0,0,50
20,13,5,13,1,0,0,0,0,52
20,13,5,13,1,20,1,0,0,73
20,13,5,19,5,19,0,0,0,81
20,13,5,19,9,19,0,0,0,85
20,13,8,0,0,0,0,0,0,41
20,14,16,11,0,0,0,0,0,61
20,15,2,1,3,3,15,0,0,59
20,15,2,1,3,3,15,5,19,83
20,15,2,1,3,3,15,25,0,84
20,15,2,1,3,3,15,19,0,78
20,15,2,25,13,1,14,0,0,90
20,15,2,25,13,5,14,0,0,94
20,15,2,9,14,5,0,0,0,65
20,15,2,9,18,1,0,0,0,65
20,15,2,25,19,0,0,0,0,81
20,15,2,15,7,7,1,14,0,81
20,15,2,15,7,7,1,14,19,100
20,15,3,1,12,15,20,5,0,91
20,15,3,3,1,20,1,0,0,63
20,15,3,3,1,20,1,19,0,82
20,15,3,3,1,20,5,0,0,67
20,15,3,3,1,20,9,14,1,86
20,15,3,8,0,0,0,0,0,46
20,15,3,8,5,18,0,0,0,69
20,15,3,8,5,18,5,4,0,78
20,15,3,8,5,18,9,14,7,99
20,15,3,8,5,18,19,0,0,88
20,15,3,11,0,0,0,0,0,49
20,15,3,15,0,0,0,0,0,53
20,15,3,15,7,15,14,25,0,114
20,15,3,15,11,9,14,9,14,110
20,15,3,15,12,15,7,25,0,112
20,15,3,15,13,5,0,0,0,71
20,15,3,15,13,5,20,5,18,114
20,15,3,15,18,15,18,15,0,119
20,15,3,19,9,14,19,0,0,99
20,15,3,21,19,19,15,0,0,112
20,15,4,1,25,0,0,0,0,65
20,15,4,1,25,9,19,8,0,101
20,15,4,1,25,12,12,0,0,89
20,15,4,1,25,19,0,0,0,84
20,15,4,4,5,18,0,0,0,66
20,15,4,4,9,3,11,0,0,66
20,15,4,4,9,5,19,0,0,76
20,15,4,4,25,9,26,5,0,108
20,15,4,4,25,13,1,14,0,96
20,15,4,4,25,13,5,14,0,100
20,15,4,4,9,20,5,0,0,77
20,15,4,4,12,5,0,0,0,60
20,15,4,4,12,5,4,0,0,64
20,15,4,4,12,5,18,0,0,78
20,15,4,4,12,5,18,19,0,97
20,15,4,4,12,5,19,0,0,79
20,15,4,4,12,9,14,7,0,85
20,15,4,5,0,0,0,0,0,44
20,15,4,5,12,9,11,5,0,81
20,15,4,25,0,0,0,0,0,64
20,15,4,9,5,19,0,0,0,72
20,15,4,12,15,23,18,9,5,121
20,15,5,0,0,0,0,0,0,40
20,15,5,1,0,0,0,0,0,41
20,15,5,2,15,1,18,4,0,80
20,15,5,3,1,16,0,0,0,60
20,15,5,3,1,16,16,5,4,85
20,15,5,3,1,16,19,0,0,79
20,15,5,4,0,0,0,0,0,44
20,15,5,8,15,12,4,0,0,79
20,15,5,8,15,12,4,19,0,98
20,15,5,25,0,0,0,0,0,65
20,15,5,9,14,7,0,0,0,70
20,15,5,12,5,19,19,0,0,95
20,15,5,12,9,11,5,0,0,77
20,15,5,12,12,9,20,5,0,98
20,15,5,14,1,9,12,0,0,76
20,15,5,14,1,9,12,5,4,85
20,15,5,14,1,9,12,19,0,95
20,15,5,16,9,5,3,5,0,78
20,15,5,16,9,5,3,5,19,97
20,15,5,16,12,1,20,5,0,94
20,15,5,16,12,1,20,5,19,113
20,15,5,18,12,5,19,19,0,113
20,15,5,19,0,0,0,0,0,59
20,15,5,19,8,15,5,0,0,87
20,15,5,19,8,15,5,19,0,106
20,15,5,20,15,5,0,0,0,80
20,15,6,6,0,0,0,0,0,47
20,15,6,6,5,5,0,0,0,57
20,15,6,6,5,5,13,1,14,85
20,15,6,6,5,5,19,0,0,76
20,15,6,6,25,0,0,0,0,72
20,15,6,6,9,5,19,0,0,80
20,15,6,6,25,13,1,14,0,100
20,15,6,6,25,13,5,14,0,104
20,15,6,6,9,14,7,0,0,77
20,15,6,6,9,19,8,0,0,83
20,15,6,6,19,0,0,0,0,66
20,15,6,9,12,5,0,0,0,67
20,15,6,15,18,5,0,0,0,79
20,15,6,15,18,14,0,0,0,88
20,15,6,20,5,18,0,0,0,84
20,15,6,20,13,1,14,0,0,89
20,15,6,20,13,5,14,0,0,93
20,15,6,20,19,0,0,0,0,80
20,15,6,20,19,20,5,1,4,110
20,15,6,21,0,0,0,0,0,62
20,15,6,21,19,0,0,0,0,81
20,15,7,0,0,0,0,0,0,42
20,15,7,1,0,0,0,0,0,43
20,15,7,1,5,0,0,0,0,48
20,15,7,1,5,4,0,0,0,52
20,15,7,1,12,9,11,5,0,80
20,15,7,1,19,0,0,0,0,62
20,15,7,1,20,1,0,0,0,64
20,15,7,1,20,5,0,0,0,68
20,15,7,1,20,5,4,0,0,72
20,15,7,1,23,9,19,5,0,99
20,15,7,5,4,0,0,0,0,51
20,15,7,5,13,1,14,0,0,75
20,15,7,5,20,8,5,18,0,98
20,15,7,5,20,8,5,18,19,117
20,15,7,7,5,4,0,0,0,58
20,15,7,7,5,12,0,0,0,66
20,15,7,7,5,18,0,0,0,72
20,15,7,7,5,18,25,0,0,97
20,15,7,7,5,18,9,5,19,105
20,15,7,7,9,14,7,0,0,79
20,15,7,7,12,5,0,0,0,66
20,15,7,7,12,5,4,0,0,70
20,15,7,7,12,5,18,0,0,84
20,15,7,7,12,5,18,19,0,103
20,15,7,7,12,5,19,0,0,85
20,15,7,7,12,9,14,7,0,91
20,15,7,12,5,19,19,0,0,97
20,15,7,19,0,0,0,0,0,61
20,15,7,20,0,0,0,0,0,62
20,15,7,21,5,0,0,0,0,68
20,15,7,21,5,19,0,0,0,87
20,15,8,5,18,0,0,0,0,66
20,15,8,5,18,15,1,0,0,82
20,15,8,15,0,0,0,0,0,58
20,15,8,21,2,15,8,21,0,110
20,15,8,21,14,7,1,0,0,86
20,15,9,0,0,0,0,0,0,44
20,15,25,4,15,13,0,0,0,92
20,15,25,5,4,0,0,0,0,69
20,15,25,5,18,0,0,0,0,83
20,15,25,5,18,19,0,0,0,102
20,15,25,6,21,12,0,0,0,99
20,15,25,8,15,21,19,5,0,128
20,15,25,9,14,7,0,0,0,90
20,15,25,9,14,7,12,25,0,127
20,15,25,9,19,8,0,0,0,96
20,15,25,9,19,8,12,25,0,133
20,15,9,12,0,0,0,0,0,56
20,15,25,12,1,14,4,0,0,91
20,15,9,12,5,0,0,0,0,61
20,15,9,12,5,4,0,0,0,65
20,15,9,12,5,18,0,0,0,79
20,15,9,12,5,18,19,0,0,98
20,15,9,12,5,19,0,0,0,80
20,15,25,12,5,19,19,0,0,115
20,15,9,12,5,20,0,0,0,81
20,15,9,12,5,20,5,4,0,90
20,15,9,12,5,20,9,14,7,111
20,15,9,12,5,20,18,25,0,124
20,15,9,12,5,20,19,0,0,100
20,15,9,12,5,20,20,5,0,106
20,15,9,12,5,20,20,5,4,110
20,15,9,12,5,20,20,5,19,125
20,15,9,12,6,21,12,0,0,95
20,15,9,12,6,21,12,12,25,132
20,15,25,12,9,11,5,0,0,97
20,15,9,12,9,14,5,20,0,104
20,15,9,12,9,14,7,0,0,86
20,15,9,12,9,14,7,12,25,123
20,15,9,12,12,5,19,19,0,111
20,15,9,12,19,0,0,0,0,75
20,15,9,12,19,15,13,5,0,108
20,15,9,12,23,15,18,14,0,126
20,15,25,13,1,11,5,18,0,108
20,15,25,13,1,11,9,14,7,115
20,15,25,13,1,14,0,0,0,88
20,15,25,13,5,14,0,0,0,92
20,15,25,15,0,0,0,0,0,75
20,15,25,15,14,0,0,0,0,89
20,15,25,15,14,19,0,0,0,108
20,15,25,15,19,0,0,0,0,94
20,15,25,15,20,1,19,0,0,115
20,15,25,19,0,0,0,0,0,79
20,15,9,19,5,0,0,0,0,68
20,15,9,19,5,3,8,0,0,79
20,15,9,19,5,4,0,0,0,72
20,15,25,19,8,15,16,0,0,118
20,15,25,19,8,15,16,19,0,137
20,15,9,19,9,14,7,0,0,93
20,15,25,19,15,13,5,0,0,112
20,15,9,19,15,14,0,0,0,92
20,15,9,19,20,0,0,0,0,83
20,15,9,20,0,0,0,0,0,64
20,15,9,20,5,4,0,0,0,73
20,15,9,20,25,0,0,0,0,89
20,15,9,20,9,14,7,0,0,94
20,15,9,20,9,19,8,0,0,100
20,15,9,20,15,9,0,0,0,88
20,15,25,20,15,23,14,0,0,132
20,15,9,20,19,0,0,0,0,83
20,15,9,22,5,12,0,0,0,83
20,15,25,23,15,13,1,14,0,126
20,15,25,23,15,18,20,0,0,136
20,15,11,1,25,19,0,0,0,91
20,15,11,1,13,1,11,0,0,72
20,15,11,1,13,1,11,19,0,91
20,15,11,5,0,0,0,0,0,51
20,15,11,5,4,0,0,0,0,55
20,15,11,5,14,0,0,0,0,65
20,15,11,5,14,5,4,0,0,74
20,15,11,5,14,9,14,7,0,95
20,15,11,5,14,9,19,13,0,106
20,15,11,5,14,9,19,13,19,125
20,15,11,5,14,9,26,5,0,105
20,15,11,5,14,12,5,19,19,120
20,15,11,5,14,19,0,0,0,84
20,15,11,5,18,0,0,0,0,69
20,15,11,5,18,19,0,0,0,88
20,15,11,5,19,0,0,0,0,70
20,15,11,9,14,7,0,0,0,76
20,15,11,25,15,9,20,5,19,139
20,15,11,15,0,0,0,0,0,61
20,15,11,15,12,15,7,25,0,120
20,15,11,15,12,15,19,8,5,120
20,15,11,15,13,1,11,0,0,86
20,15,11,15,13,1,11,19,0,105
20,15,11,15,14,15,13,1,0,104
20,15,11,15,14,15,13,1,19,123
20,15,11,15,16,1,20,0,0,98
20,15,11,20,15,11,10,5,0,107
20,15,12,1,0,0,0,0,0,48
20,15,12,1,13,9,14,5,0,89
20,15,12,1,14,0,0,0,0,62
20,15,12,1,14,5,0,0,0,67
20,15,12,1,14,5,19,0,0,86
20,15,12,1,14,19,0,0,0,81
20,15,12,1,19,0,0,0,0,67
20,15,12,2,15,15,20,8,0,107
20,15,12,2,15,15,20,8,19,126
20,15,12,4,0,0,0,0,0,51
20,15,12,4,5,18,9,1,0,84
20,15,12,4,15,0,0,0,0,66
20,15,12,5,0,0,0,0,0,52
20,15,12,5,4,0,0,0,0,56
20,15,12,5,4,15,19,0,0,90
20,15,12,5,18,1,2,12,5,90
20,15,12,5,18,1,2,12,25,110
20,15,12,5,18,1,14,3,5,93
20,15,12,5,18,1,14,3,25,113
20,15,12,5,18,1,14,20,0,105
20,15,12,5,18,1,20,5,0,96
20,15,12,5,18,1,20,5,4,100
20,15,12,5,18,1,20,5,19,115
20,15,12,5,18,1,20,15,18,124
20,15,12,5,18,9,19,13,0,111
20,15,12,5,19,0,0,0,0,71
20,15,12,5,23,1,18,5,0,99
20,15,12,7,21,1,3,8,1,88
20,15,12,9,4,9,14,0,0,83
20,15,12,9,4,9,14,5,0,88
20,15,12,9,4,9,14,5,19,107
20,15,12,9,4,9,14,19,0,102
20,15,12,25,12,0,0,0,0,84
20,15,12,25,12,5,14,5,0,108
20,15,12,25,12,19,0,0,0,103
20,15,12,9,14,7,0,0,0,77
20,15,12,9,16,1,14,5,0,92
20,15,12,9,20,5,0,0,0,81
20,15,12,12,1,2,12,5,0,79
20,15,12,12,1,7,5,0,0,72
20,15,12,12,1,7,5,19,0,91
20,15,12,12,2,1,18,0,0,80
20,15,12,12,2,1,18,19,0,99
20,15,12,12,2,15,15,11,0,102
20,15,12,12,2,15,15,20,8,119
20,15,12,12,5,4,0,0,0,68
20,15,12,12,5,6,19,5,14,108
20,15,12,12,5,14,20,0,0,98
20,15,12,12,5,18,25,0,0,107
20,15,12,12,5,18,19,0,0,101
20,15,12,12,7,1,20,5,0,92
20,15,12,12,7,1,20,5,19,111
20,15,12,12,8,1,12,12,0,92
20,15,12,12,8,15,21,19,5,127
20,15,12,12,25,0,0,0,0,84
20,15,12,12,9,5,19,0,0,92
20,15,12,12,9,11,5,18,0,102
20,15,12,12,9,14,7,0,0,89
20,15,12,12,13,5,14,0,0,91
20,15,12,12,15,14,0,0,0,88
20,15,12,12,16,5,14,14,25,133
20,15,12,12,19,0,0,0,0,78
20,15,12,12,20,1,11,5,18,114
20,15,12,12,23,1,25,0,0,108
20,15,12,12,23,1,25,19,0,127
20,15,12,13,5,14,0,0,0,79
20,15,12,16,1,20,3,8,0,95
20,15,12,19,5,25,0,0,0,96
20,15,12,19,5,12,0,0,0,83
20,15,12,19,5,19,20,5,18,133
20,15,12,20,0,0,0,0,0,67
20,15,12,20,5,18,0,0,0,90
20,15,12,21,1,20,5,0,0,94
20,15,12,21,1,20,5,19,0,113
20,15,12,21,5,14,5,0,0,92
20,15,12,21,5,14,5,19,0,111
20,15,12,21,9,3,0,0,0,80
20,15,12,21,9,4,0,0,0,81
20,15,12,21,9,4,5,0,0,86
20,15,12,21,9,4,5,19,0,105
20,15,12,21,9,4,9,4,5,99
20,15,12,21,9,4,9,14,0,104
20,15,12,21,9,4,9,14,5,109
20,15,12,21,9,4,9,14,15,119
20,15,12,21,9,4,9,14,19,123
20,15,12,21,9,4,15,0,0,96
20,15,12,21,9,4,19,0,0,100
20,15,12,21,25,12,0,0,0,105
20,15,12,21,25,12,5,14,5,129
20,15,12,21,25,12,9,3,0,117
20,15,12,21,25,12,19,0,0,124
20,15,12,21,15,12,0,0,0,95
20,15,12,21,15,12,5,0,0,100
20,15,12,21,15,12,5,19,0,119
20,15,12,21,15,12,19,0,0,114
20,15,12,21,19,0,0,0,0,87
20,15,12,26,5,25,0,0,0,103
20,15,13,1,8,1,23,11,19,111
20,15,13,1,12,12,5,25,0,103
20,15,13,1,12,12,5,25,19,122
20,15,13,1,14,0,0,0,0,63
20,15,13,1,14,4,0,0,0,67
20,15,13,1,14,19,0,0,0,82
20,15,13,1,20,9,12,12,15,117
20,15,13,1,20,15,0,0,0,84
20,15,13,1,20,15,5,25,0,114
20,15,13,1,20,15,5,19,0,108
20,15,13,2,0,0,0,0,0,50
20,15,13,2,1,3,0,0,0,54
20,15,13,2,1,3,11,0,0,65
20,15,13,2,1,3,11,19,0,84
20,15,13,2,1,3,19,0,0,73
20,15,13,2,1,11,0,0,0,62
20,15,13,2,1,11,19,0,0,81
20,15,13,2,1,12,0,0,0,63
20,15,13,2,5,0,0,0,0,55
20,15,13,2,5,4,0,0,0,59
20,15,13,2,9,3,0,0,0,62
20,15,13,2,9,14,7,0,0,80
20,15,13,2,12,5,19,19,0,105
20,15,13,2,12,5,20,0,0,87
20,15,13,2,12,9,11,5,0,87
20,15,13,2,15,25,0,0,0,90
20,15,13,2,15,25,6,21,12,129
20,15,13,2,15,25,9,19,8,126
20,15,13,2,15,25,9,19,13,131
20,15,13,2,15,25,19,0,0,109
20,15,13,2,15,12,1,0,0,78
20,15,13,2,15,12,1,19,0,97
20,15,13,2,15,12,15,0,0,92
20,15,13,2,15,12,15,19,0,111
20,15,13,2,19,0,0,0,0,69
20,15,13,2,19,20,15,14,5,123
20,15,13,3,1,20,0,0,0,72
20,15,13,3,1,20,19,0,0,91
20,15,13,3,1,20,20,5,4,101
20,15,13,3,15,4,0,0,0,70
20,15,13,3,15,4,19,0,0,89
20,15,13,5,0,0,0,0,0,53
20,15,13,5,6,21,12,0,0,92
20,15,13,5,12,5,20,0,0,90
20,15,13,5,14,20,0,0,0,87
20,15,13,5,14,20,1,0,0,88
20,15,13,5,14,20,15,19,5,126
20,15,13,5,14,20,15,21,19,142
20,15,13,5,14,20,21,13,0,121
20,15,13,5,19,0,0,0,0,72
20,15,13,6,15,15,12,0,0,96
20,15,13,6,15,15,12,19,0,115
20,15,13,25,0,0,0,0,0,73
20,15,13,9,1,0,0,0,0,58
20,15,13,9,1,12,0,0,0,70
20,15,13,9,14,0,0,0,0,71
20,15,13,9,14,5,19,0,0,95
20,15,13,9,19,8,0,0,0,84
20,15,13,9,21,13,0,0,0,91
20,15,13,9,21,13,9,1,0,101
20,15,13,10,15,8,14,0,0,95
20,15,13,10,15,14,0,0,0,87
20,15,13,13,5,4,0,0,0,70
20,15,13,13,25,2,1,7,0,96
20,15,13,13,25,3,15,4,0,108
20,15,13,13,9,5,19,0,0,94
20,15,13,13,25,18,15,20,0,139
20,15,13,13,25,18,15,20,19,158
20,15,13,14,15,4,4,25,0,110
20,15,13,14,15,18,18,25,0,138
20,15,13,14,15,21,16,0,0,114
20,15,13,15,7,18,1,13,0,102
20,15,13,15,7,18,1,13,19,121
20,15,13,15,7,18,1,16,8,113
20,15,13,15,12,15,0,0,0,90
20,15,13,15,13,1,14,9,1,101
20,15,13,15,18,14,0,0,0,95
20,15,13,15,18,18,15,23,0,137
20,15,13,15,18,18,15,23,19,156
20,15,13,15,19,9,19,0,0,110
20,15,13,16,9,15,14,19,0,121
20,15,13,16,9,16,5,18,0,112
20,15,13,16,15,14,0,0,0,93
20,15,13,18,9,7,0,0,0,82
20,15,13,20,1,20,5,0,0,94
20,15,13,20,9,20,0,0,0,97
20,15,13,20,9,20,19,0,0,116
20,15,14,0,0,0,0,0,0,49
20,15,14,1,4,1,0,0,0,55
20,15,14,1,12,0,0,0,0,62
20,15,14,1,12,9,19,20,0,110
20,15,14,1,12,9,20,5,0,96
20,15,14,1,12,9,20,25,0,116
20,15,14,1,12,12,25,0,0,99
20,15,14,1,12,13,1,20,12,108
20,15,14,1,14,20,0,0,0,84
20,15,14,1,20,9,15,14,0,108
20,15,14,4,9,0,0,0,0,62
20,15,14,4,9,14,15,0,0,91
20,15,14,4,15,0,0,0,0,68
20,15,14,4,15,19,0,0,0,87
20,15,14,5,0,0,0,0,0,54
20,15,14,5,1,18,13,0,0,86
20,15,14,5,1,18,13,19,0,105
20,15,14,5,4,0,0,0,0,58
20,15,14,5,12,1,4,1,0,72
20,15,14,5,12,1,4,1,19,91
20,15,14,5,12,5,19,19,0,109
20,15,14,5,13,5,0,0,0,72
20,15,14,5,13,5,19,0,0,91
20,15,14,5,13,9,3,0,0,79
20,15,14,5,16,18,15,15,6,124
20,15,14,5,18,0,0,0,0,72
20,15,14,5,18,19,0,0,0,91
20,15,14,5,19,0,0,0,0,73
20,15,14,5,20,9,3,0,0,86
20,15,14,5,20,9,3,19,0,105
20,15,14,5,20,20,5,0,0,99
20,15,14,5,20,20,5,19,0,118
20,15,14,7,0,0,0,0,0,56
20,15,14,7,5,4,0,0,0,65
20,15,14,7,5,18,0,0,0,79
20,15,14,7,5,18,19,0,0,98
20,15,14,7,9,14,7,0,0,86
20,15,14,7,11,1,14,7,0,89
20,15,14,7,13,1,14,0,0,84
20,15,14,7,13,5,14,0,0,88
20,15,14,7,19,0,0,0,0,75
20,15,14,7,19,13,1,14,0,103
20,15,14,7,19,13,5,14,0,107
20,15,14,7,21,5,4,0,0,86
20,15,14,7,21,5,6,21,12,121
20,15,14,7,21,5,25,0,0,107
20,15,14,7,21,5,12,5,20,119
20,15,14,7,21,5,13,1,14,110
20,15,14,7,21,5,13,5,14,114
20,15,14,7,21,5,18,0,0,100
20,15,14,7,21,5,19,0,0,101
20,15,14,7,21,5,20,9,16,127
20,15,14,7,21,25,0,0,0,102
20,15,14,7,21,9,14,7,0,107
20,15,14,7,21,9,14,7,19,126
20,15,14,9,1,0,0,0,0,59
20,15,14,9,3,0,0,0,0,61
20,15,14,9,3,1,12,0,0,74
20,15,14,9,3,1,12,12,25,111
20,15,14,9,3,9,20,25,0,115
20,15,14,9,3,9,26,5,0,101
20,15,14,9,3,11,5,4,0,81
20,15,14,9,3,11,9,14,7,102
20,15,14,9,3,19,0,0,0,80
20,15,14,9,5,18,0,0,0,81
20,15,14,9,5,19,20,0,0,102
20,15,14,9,6,25,0,0,0,89
20,15,14,9,7,8,20,0,0,93
20,15,14,9,7,8,20,19,0,112
20,15,14,25,8,15,15,16,0,128
20,15,14,9,14,7,0,0,0,79
20,15,14,9,19,8,0,0,0,85
20,15,14,9,19,8,12,25,0,122
20,15,14,9,20,5,0,0,0,83
20,15,14,9,20,18,21,1,12,130
20,15,14,10,15,14,0,0,0,88
20,15,14,11,0,0,0,0,0,60
20,15,14,11,1,0,0,0,0,61
20,15,14,12,5,20,0,0,0,86
20,15,14,12,5,20,19,0,0,105
20,15,14,14,0,0,0,0,0,63
20,15,14,14,1,7,5,0,0,76
20,15,14,14,1,7,5,19,0,95
20,15,14,14,5,0,0,0,0,68
20,15,14,14,5,1,21,0,0,90
20,15,14,14,5,1,21,5,4,99
20,15,14,14,5,1,21,19,0,109
20,15,14,14,5,1,21,24,0,114
20,15,14,14,5,12,12,5,0,97
20,15,14,14,5,18,0,0,0,86
20,15,14,14,5,18,19,0,0,105
20,15,14,14,5,19,0,0,0,87
20,15,14,14,9,19,8,0,0,99
20,15,14,14,9,19,8,12,25,136
20,15,14,14,12,1,14,4,0,94
20,15,14,15,7,18,1,13,0,103
20,15,14,15,7,18,1,16,8,114
20,15,14,15,12,15,7,25,0,123
20,15,14,15,13,5,20,5,18,125
20,15,14,15,13,5,20,18,25,145
20,15,14,15,16,8,1,14,20,123
20,15,14,15,16,12,1,19,20,132
20,15,14,15,19,3,15,16,5,122
20,15,14,15,20,1,24,9,19,137
20,15,14,15,21,19,0,0,0,104
20,15,14,19,0,0,0,0,0,68
20,15,14,19,9,12,0,0,0,89
20,15,14,19,9,12,1,18,0,108
20,15,14,19,9,12,5,0,0,94
20,15,14,19,9,12,12,1,18,120
20,15,14,19,9,12,19,0,0,108
20,15,14,19,15,18,0,0,0,101
20,15,14,19,15,18,9,1,12,123
20,15,14,19,21,18,1,20,5,133
20,15,14,19,21,18,5,0,0,112
20,15,14,19,21,18,5,4,0,116
20,15,14,19,21,18,5,19,0,131
20,15,14,19,21,18,9,14,7,137
20,15,14,20,9,14,5,0,0,97
20,15,14,20,9,14,5,18,0,115
20,15,14,20,9,14,5,19,0,116
20,15,14,21,19,0,0,0,0,89
20,15,14,21,19,5,19,0,0,113
20,15,15,0,0,0,0,0,0,50
20,15,15,1,18,20,0,0,0,89
20,15,15,4,12,5,0,0,0,71
20,15,15,11,0,0,0,0,0,61
20,15,15,11,5,14,0,0,0,80
20,15,15,12,0,0,0,0,0,62
20,15,15,12,1,3,8,0,0,74
20,15,15,12,2,15,24,0,0,103
20,15,15,12,2,15,24,5,19,127
20,15,15,12,5,4,0,0,0,71
20,15,15,12,5,18,0,0,0,85
20,15,15,12,5,18,19,0,0,104
20,15,15,12,8,5,1,4,0,80
20,15,15,12,8,5,1,4,19,99
20,15,15,12,8,15,21,19,5,130
20,15,15,12,9,14,7,0,0,92
20,15,15,12,9,14,7,19,0,111
20,15,15,12,11,9,20,0,0,102
20,15,15,12,12,5,19,19,0,117
20,15,15,12,13,1,11,5,0,92
20,15,15,12,13,1,11,5,18,110
20,15,15,12,13,1,14,0,0,90
20,15,15,12,13,1,18,11,0,105
20,15,15,12,13,5,14,0,0,94
20,15,15,12,16,12,1,20,5,116
20,15,15,12,18,15,15,13,0,123
20,15,15,12,18,15,15,13,19,142
20,15,15,12,19,0,0,0,0,81
20,15,15,12,19,8,5,4,0,98
20,15,15,12,19,8,5,4,19,117
20,15,15,12,19,9,0,0,0,90
20,15,15,12,19,25,0,0,0,106
20,15,15,12,19,12,9,4,5,111
20,15,15,12,19,13,9,20,8,131
20,15,15,12,19,20,15,3,11,130
20,15,15,12,19,20,15,14,5,135
20,15,15,13,0,0,0,0,0,63
20,15,15,13,12,25,0,0,0,100
20,15,15,14,0,0,0,0,0,64
20,15,15,14,19,0,0,0,0,83
20,15,15,14,23,15,15,4,0,121
20,15,15,16,0,0,0,0,0,66
20,15,15,18,9,5,0,0,0,82
20,15,15,18,15,3,11,0,0,97
20,15,15,18,15,15,0,0,0,98
20,15,15,19,8,0,0,0,0,77
20,15,15,19,9,5,0,0,0,83
20,15,15,20,0,0,0,0,0,70
20,15,15,20,5,4,0,0,0,79
20,15,15,20,5,18,0,0,0,93
20,15,15,20,5,18,19,0,0,112
20,15,15,20,8,0,0,0,0,78
20,15,15,20,8,1,3,8,5,95
20,15,15,20,8,1,3,8,25,115
20,15,15,20,8,2,9,12,12,113
20,15,15,20,8,3,15,13,2,111
20,15,15,20,8,3,21,16,0,118
20,15,15,20,8,5,4,0,0,87
20,15,15,20,8,5,18,0,0,101
20,15,15,20,8,6,21,12,0,117
20,15,15,20,8,25,0,0,0,103
20,15,15,20,8,9,5,18,0,110
20,15,15,20,8,9,5,19,20,131
20,15,15,20,8,9,12,25,0,124
20,15,15,20,8,9,12,12,0,111
20,15,15,20,8,9,14,7,0,108
20,15,15,20,8,12,5,19,19,133
20,15,15,20,8,12,5,20,0,115
20,15,15,20,8,12,9,11,5,115
20,15,15,20,8,16,9,3,11,117
20,15,15,20,8,19,0,0,0,97
20,15,15,20,8,19,15,13,5,130
20,15,15,20,8,23,1,19,8,129
20,15,15,20,8,23,15,18,11,145
20,15,15,20,8,23,15,18,20,154
20,15,15,20,9,14,7,0,0,100
20,15,15,20,12,5,0,0,0,87
20,15,15,20,12,5,4,0,0,91
20,15,15,20,12,5,18,0,0,105
20,15,15,20,12,5,18,19,0,124
20,15,15,20,12,5,19,0,0,106
20,15,15,20,12,9,14,7,0,112
20,15,15,20,12,9,19,8,0,118
20,15,15,20,13,15,15,20,0,133
20,15,15,20,19,0,0,0,0,89
20,15,15,20,19,5,19,0,0,113
20,15,15,20,19,25,0,0,0,114
20,15,15,20,19,9,5,19,0,122
20,15,15,26,12,5,0,0,0,93
20,15,15,26,15,15,0,0,0,106
20,15,16,1,12,7,9,1,0,81
20,15,16,1,18,3,8,0,0,81
20,15,16,1,18,3,8,25,0,106
20,15,16,1,18,3,8,9,1,91
20,15,16,1,19,0,0,0,0,71
20,15,16,1,19,19,0,0,0,90
20,15,16,1,20,15,0,0,0,87
20,15,16,1,21,0,0,0,0,73
20,15,16,1,26,0,0,0,0,78
20,15,16,1,26,5,19,0,0,102
20,15,16,1,26,6,5,12,19,120
20,15,16,1,26,25,0,0,0,103
20,15,16,1,26,9,14,5,0,106
20,15,16,1,26,9,20,5,0,112
20,15,16,3,1,16,0,0,0,71
20,15,16,3,1,19,20,0,0,94
20,15,16,3,1,19,20,12,5,111
20,15,16,3,8,18,15,13,5,113
20,15,16,3,15,1,20,0,0,90
20,15,16,3,15,1,20,19,0,109
20,15,16,3,18,15,19,19,0,125
20,15,16,4,18,5,19,19,0,116
20,15,16,5,0,0,0,0,0,56
20,15,16,5,3,8,5,5,0,77
20,15,16,5,3,20,15,13,25,132
20,15,16,5,4,0,0,0,0,60
20,15,16,5,5,0,0,0,0,61
20,15,16,5,5,19,0,0,0,80
20,15,16,5,14,7,0,0,0,77
20,15,16,5,16,15,0,0,0,87
20,15,16,5,18,0,0,0,0,74
20,15,16,5,18,4,15,13,0,106
20,15,16,5,18,19,0,0,0,93
20,15,16,5,19,0,0,0,0,75
20,15,16,6,9,12,12,5,4,99
20,15,16,6,12,9,7,8,20,113
20,15,16,6,21,12,0,0,0,90
20,15,16,6,21,12,12,0,0,102
20,15,16,8,0,0,0,0,0,59
20,15,16,8,1,9,11,5,0,85
20,15,16,8,1,13,16,5,18,112
20,15,16,8,5,0,0,0,0,64
20,15,16,8,5,19,0,0,0,83
20,15,16,8,5,20,9,3,0,96
20,15,16,8,5,20,9,26,5,124
20,15,16,8,9,0,0,0,0,68
20,15,16,8,15,21,19,0,0,114
20,15,16,8,16,8,9,0,0,92
20,15,16,8,19,0,0,0,0,78
20,15,16,8,21,19,0,0,0,99
20,15,16,9,0,0,0,0,0,60
20,15,16,9,1,0,0,0,0,61
20,15,16,9,1,18,25,0,0,104
20,15,16,9,1,18,9,1,0,89
20,15,16,9,1,18,9,1,14,103
20,15,16,9,1,18,9,5,19,112
20,15,16,9,1,18,9,19,20,127
20,15,16,9,1,18,9,21,19,128
20,15,16,9,3,0,0,0,0,63
20,15,16,9,3,1,12,0,0,76
20,15,16,9,3,1,12,12,25,113
20,15,16,9,14,7,0,0,0,81
20,15,16,9,19,0,0,0,0,79
20,15,16,9,23,1,12,1,0,97
20,15,16,11,9,3,11,0,0,85
20,15,16,11,9,3,11,19,0,104
20,15,16,11,14,15,20,0,0,111
20,15,16,11,14,15,20,19,0,130
20,15,16,12,5,19,19,0,0,106
20,15,16,12,9,11,5,0,0,88
20,15,16,12,9,14,5,0,0,91
20,15,16,12,9,14,5,18,0,109
20,15,16,12,15,6,20,25,0,129
20,15,16,13,1,11,5,18,0,99
20,15,16,13,1,11,9,14,7,106
20,15,16,13,1,14,0,0,0,79
20,15,16,13,1,19,20,0,0,104
20,15,16,13,1,19,20,19,0,123
20,15,16,13,1,21,12,0,0,98
20,15,16,13,5,14,0,0,0,83
20,15,16,13,9,14,14,15,23,139
20,15,16,13,15,19,20,0,0,118
20,15,16,13,15,19,20,12,25,155
20,15,16,14,5,20,0,0,0,90
20,15,16,14,15,20,3,8,0,111
20,15,16,15,0,0,0,0,0,66
20,15,16,15,1,12,7,9,1,96
20,15,16,15,4,5,13,5,0,93
20,15,16,15,7,0,0,0,0,73
20,15,16,15,7,18,1,16,8,116
20,15,16,15,9,0,0,0,0,75
20,15,16,15,12,1,20,18,25,142
20,15,16,15,12,15,7,25,0,125
20,15,16,15,12,15,7,9,3,112
20,15,16,15,14,25,13,0,0,118
20,15,16,15,14,25,13,1,12,131
20,15,16,15,14,25,13,25,0,143
20,15,16,15,14,25,13,9,3,130
20,15,16,15,14,25,13,19,0,137
20,15,16,15,16,8,15,14,5,124
20,15,16,15,19,0,0,0,0,85
20,15,16,15,20,1,24,9,19,139
20,15,16,15,20,25,16,5,0,132
20,15,16,15,20,25,16,5,19,151
20,15,16,15,20,25,16,9,3,139
20,15,16,16,5,4,0,0,0,76
20,15,16,16,5,18,19,0,0,109
20,15,16,16,25,0,0,0,0,92
20,15,16,16,9,5,3,5,0,89
20,15,16,16,9,14,7,12,25,134
20,15,16,16,9,14,7,19,0,116
20,15,16,16,12,5,0,0,0,84
20,15,16,16,12,5,4,0,0,88
20,15,16,16,12,5,18,0,0,102
20,15,16,16,12,5,19,0,0,103
20,15,16,16,12,25,0,0,0,104
20,15,16,16,12,9,14,7,0,109
20,15,16,18,1,9,12,0,0,91
20,15,16,18,15,16,5,0,0,105
20,15,16,19,1,9,12,0,0,92
20,15,16,19,1,9,12,19,0,111
20,15,16,19,9,4,5,0,0,88
20,15,16,19,9,4,5,18,0,106
20,15,16,19,9,4,5,18,19,125
20,15,16,19,9,4,5,19,0,107
20,15,16,19,25,20,21,18,14,168
20,15,16,19,12,0,0,0,0,82
20,15,16,19,13,1,14,0,0,98
20,15,16,19,13,5,12,20,0,120
20,15,16,19,13,5,12,20,19,139
20,15,16,19,13,5,14,0,0,102
20,15,16,19,15,9,12,0,0,106
20,15,16,19,15,9,12,5,4,115
20,15,16,19,15,9,12,19,0,125
20,15,16,19,16,9,14,0,0,109
20,15,16,19,16,9,14,19,0,128
20,15,16,19,19,13,5,12,20,139
20,15,16,19,20,9,20,3,8,130
20,15,16,19,20,15,14,5,0,124
20,15,16,19,20,15,14,5,19,143
20,15,16,19,23,1,18,13,0,125
20,15,16,20,1,9,12,0,0,93
20,15,16,23,9,19,5,0,0,107
20,15,16,23,15,18,11,0,0,118
20,15,16,23,15,18,11,5,4,127
20,15,16,23,15,18,11,19,0,137
20,15,17,21,5,0,0,0,0,78
20,15,17,21,5,19,0,0,0,97
20,15,17,21,5,20,0,0,0,98
20,15,17,21,5,20,19,0,0,117
20,15,17,21,9,12,12,1,0,107
20,15,18,1,8,19,0,0,0,81
20,15,18,1,12,0,0,0,0,66
20,15,18,1,14,0,0,0,0,68
20,15,18,1,14,1,0,0,0,69
20,15,18,1,19,0,0,0,0,73
20,15,18,2,1,14,9,20,5,104
20,15,18,3,0,0,0,0,0,56
20,15,18,3,5,12,0,0,0,73
20,15,18,3,8,0,0,0,0,64
20,15,18,3,8,5,4,0,0,73
20,15,18,3,8,5,18,0,0,87
20,15,18,3,8,5,18,5,0,92
20,15,18,3,8,5,18,5,19,111
20,15,18,3,8,5,19,0,0,88
20,15,18,3,8,5,20,0,0,89
20,15,18,3,8,25,0,0,0,89
20,15,18,3,8,9,5,18,0,96
20,15,18,3,8,9,5,18,19,115
20,15,18,3,8,9,5,19,20,117
20,15,18,3,8,9,14,7,0,94
20,15,18,3,8,12,5,19,19,119
20,15,18,3,8,12,9,11,5,101
20,15,18,3,8,12,9,20,0,105
20,15,18,3,8,13,1,14,0,92
20,15,18,3,8,15,14,0,0,93
20,15,18,3,8,15,14,19,0,112
20,15,18,3,8,23,5,5,4,101
20,15,18,3,8,23,15,15,4,121
20,15,18,3,8,23,15,18,20,140
20,15,18,3,19,0,0,0,0,75
20,15,18,3,21,12,1,18,0,108
20,15,18,3,21,12,21,19,0,129
20,15,18,4,9,15,14,0,0,95
20,15,18,5,1,4,15,18,0,96
20,15,18,5,1,4,15,18,19,115
20,15,18,5,4,0,0,0,0,62
20,15,18,5,18,15,0,0,0,91
20,15,18,5,18,15,19,0,0,110
20,15,18,5,20,0,0,0,0,78
20,15,18,5,21,20,9,3,0,111
20,15,18,5,21,20,9,3,19,130
20,15,18,6,5,12,0,0,0,76
20,15,18,6,12,5,0,0,0,76
20,15,18,7,15,3,8,0,0,86
20,15,18,9,3,0,0,0,0,65
20,15,18,9,9,0,0,0,0,71
20,15,18,25,23,5,5,4,0,115
20,15,18,13,1,0,0,0,0,67
20,15,18,13,1,5,0,0,0,72
20,15,18,13,5,14,0,0,0,85
20,15,18,13,5,14,20,0,0,105
20,15,18,13,5,14,20,1,0,106
20,15,18,13,5,14,20,5,4,114
20,15,18,13,5,14,20,5,18,128
20,15,18,13,5,14,20,9,12,126
20,15,18,13,5,14,20,15,18,138
20,15,18,13,5,14,20,18,25,148
20,15,18,13,5,14,20,19,0,124
20,15,18,13,5,14,20,21,13,139
20,15,18,13,9,14,1,0,0,90
20,15,18,13,9,14,1,12,0,102
20,15,18,13,9,14,15,21,19,144
20,15,18,13,15,4,15,14,20,134
20,15,18,14,0,0,0,0,0,67
20,15,18,14,1,4,1,0,0,73
20,15,18,14,1,4,5,0,0,77
20,15,18,14,1,4,9,3,0,84
20,15,18,14,1,4,15,0,0,87
20,15,18,14,1,4,15,5,19,111
20,15,18,14,1,4,15,19,0,106
20,15,18,14,1,12,0,0,0,80
20,15,18,14,1,18,9,1,0,96
20,15,18,14,1,18,9,1,5,101
20,15,18,14,1,18,9,1,14,110
20,15,18,14,1,18,9,1,19,115
20,15,18,14,5,25,0,0,0,97
20,15,18,14,5,19,5,0,0,96
20,15,18,14,5,19,9,0,0,100
20,15,18,14,9,12,12,1,0,101
20,15,18,14,9,12,12,15,19,134
20,15,18,14,15,20,5,0,0,107
20,15,18,14,21,19,0,0,0,107
20,15,18,15,0,0,0,0,0,68
20,15,18,15,9,4,0,0,0,81
20,15,18,15,9,4,1,12,0,94
20,15,18,15,9,4,19,0,0,100
20,15,18,15,12,9,12,12,15,128
20,15,18,15,14,10,1,0,0,93
20,15,18,15,19,0,0,0,0,87
20,15,18,15,19,5,0,0,0,92
20,15,18,15,19,9,20,25,0,141
20,15,18,15,20,0,0,0,0,88
20,15,18,15,20,8,0,0,0,96
20,15,18,15,20,15,18,15,0,136
20,15,18,15,21,19,0,0,0,108
20,15,18,16,5,4,15,0,0,93
20,15,18,16,5,4,15,5,4,102
20,15,18,16,5,4,15,5,18,116
20,15,18,16,5,4,15,5,19,117
20,15,18,16,5,4,15,19,0,112
20,15,18,16,5,14,20,0,0,108
20,15,18,16,5,24,0,0,0,98
20,15,18,16,9,4,0,0,0,82
20,15,18,16,9,4,9,20,25,136
20,15,18,16,9,4,12,25,0,119
20,15,18,16,9,4,19,0,0,101
20,15,18,16,9,6,25,0,0,109
20,15,18,16,9,6,9,5,4,102
20,15,18,16,9,20,21,4,5,128
20,15,18,16,15,18,0,0,0,102
20,15,18,16,15,18,9,26,5,142
20,15,18,16,15,18,19,0,0,121
20,15,18,17,21,1,20,5,0,117
20,15,18,17,21,1,20,5,4,121
20,15,18,17,21,5,0,0,0,96
20,15,18,17,21,5,4,0,0,100
20,15,18,17,21,5,18,0,0,114
20,15,18,17,21,5,18,19,0,133
20,15,18,17,21,5,19,0,0,115
20,15,18,17,21,5,19,5,19,139
20,15,18,17,21,9,14,7,0,121
20,15,18,18,5,6,25,0,0,107
20,15,18,18,5,6,9,5,4,100
20,15,18,18,5,6,9,5,19,115
20,15,18,18,5,14,20,0,0,110
20,15,18,18,5,14,20,19,0,129
20,15,18,18,5,20,0,0,0,96
20,15,18,18,9,4,0,0,0,84
20,15,18,18,9,4,5,18,0,107
20,15,18,18,9,4,5,19,20,128
20,15,18,18,9,4,9,20,25,138
20,15,18,18,9,4,12,25,0,121
20,15,18,18,9,6,25,0,0,111
20,15,18,18,9,6,9,5,4,104
20,15,18,18,9,6,9,5,19,119
20,15,18,18,15,14,5,0,0,105
20,15,18,19,0,0,0,0,0,72
20,15,18,19,1,4,5,0,0,82
20,15,18,19,1,4,5,19,0,101
20,15,18,19,1,12,15,0,0,100
20,15,18,19,5,0,0,0,0,77
20,15,18,19,5,12,0,0,0,89
20,15,18,19,5,19,0,0,0,96
20,15,18,19,9,0,0,0,0,81
20,15,18,19,9,12,5,0,0,98
20,15,18,19,9,15,14,0,0,110
20,15,18,19,9,15,14,1,12,123
20,15,18,19,9,15,14,19,0,129
20,15,18,19,9,22,5,0,0,108
20,15,18,19,11,0,0,0,0,83
20,15,18,19,11,19,0,0,0,102
20,15,18,19,15,0,0,0,0,87
20,15,18,19,15,5,19,0,0,111
20,15,18,19,15,19,0,0,0,106
20,15,18,19,20,5,14,0,0,111
20,15,18,20,0,0,0,0,0,73
20,15,18,20,1,0,0,0,0,74
20,15,18,20,1,25,19,0,0,118
20,15,18,20,5,1,21,0,0,100
20,15,18,20,5,1,21,19,0,119
20,15,18,20,5,1,21,24,0,124
20,15,18,20,5,14,0,0,0,92
20,15,18,20,5,19,0,0,0,97
20,15,18,20,9,3,15,14,5,119
20,15,18,20,9,5,0,0,0,87
20,15,18,20,9,12,0,0,0,94
20,15,18,20,9,12,5,0,0,99
20,15,18,20,9,12,9,20,25,148
20,15,18,20,9,12,12,1,0,107
20,15,18,20,9,12,12,1,19,126
20,15,18,20,9,12,12,5,0,111
20,15,18,20,9,12,12,15,14,135
20,15,18,20,9,15,21,19,0,137
20,15,18,20,9,19,0,0,0,101
20,15,18,20,9,22,5,0,0,109
20,15,18,20,15,9,19,5,0,121
20,15,18,20,15,9,19,5,19,140
20,15,18,20,15,14,9,0,0,111
20,15,18,20,15,14,9,19,0,130
20,15,18,20,15,18,0,0,0,106
20,15,18,20,18,9,3,5,19,127
20,15,18,20,18,9,3,9,4,116
20,15,18,20,18,9,24,5,19,148
20,15,18,20,19,0,0,0,0,92
20,15,18,20,21,5,0,0,0,99
20,15,18,20,21,12,1,0,0,107
20,15,18,20,21,12,15,21,19,161
20,15,18,20,21,15,19,5,0,133
20,15,18,20,21,15,21,19,0,149
20,15,18,20,21,18,5,0,0,117
20,15,18,20,21,18,5,4,0,121
20,15,18,20,21,18,5,18,0,135
20,15,18,20,21,18,5,18,19,154
20,15,18,20,21,18,5,19,0,136
20,15,18,20,21,18,9,14,7,142
20,15,18,20,21,18,15,21,19,167
20,15,18,21,12,1,0,0,0,87
20,15,18,21,12,1,5,0,0,92
20,15,18,21,12,1,19,0,0,106
20,15,18,21,12,9,0,0,0,95
20,15,18,21,12,9,14,0,0,109
20,15,18,21,12,15,9,4,0,114
20,15,18,21,12,15,19,5,0,125
20,15,18,21,12,15,19,9,19,148
20,15,18,21,12,15,21,19,0,141
20,15,18,21,12,21,19,0,0,126
20,15,18,21,19,0,0,0,0,93
20,15,18,21,19,5,19,0,0,117
20,15,18,22,5,0,0,0,0,80
20,15,18,22,9,4,0,0,0,88
20,15,18,22,9,20,25,0,0,129
20,15,18,22,15,21,19,0,0,130
20,15,19,1,16,8,9,19,20,127
20,15,19,1,16,8,15,20,8,122
20,15,19,3,1,14,9,20,5,106
20,15,19,8,0,0,0,0,0,62
20,15,19,8,5,18,0,0,0,85
20,15,19,8,5,18,25,0,0,110
20,15,19,8,5,19,0,0,0,86
20,15,19,8,25,0,0,0,0,87
20,15,19,8,12,25,0,0,0,99
20,15,19,8,14,1,9,12,0,98
20,15,19,25,0,0,0,0,0,79
20,15,19,9,12,25,0,0,0,100
20,15,19,19,0,0,0,0,0,73
20,15,19,19,5,4,0,0,0,82
20,15,19,19,5,18,0,0,0,96
20,15,19,19,5,18,19,0,0,115
20,15,19,19,5,19,0,0,0,97
20,15,19,19,25,0,0,0,0,98
20,15,19,19,9,12,25,0,0,119
20,15,19,19,9,14,7,0,0,103
20,15,19,19,9,14,7,12,25,140
20,15,19,19,13,5,14,20,0,125
20,15,19,19,16,15,20,0,0,124
20,15,19,19,16,15,20,19,0,143
20,15,19,19,21,16,0,0,0,110
20,15,19,19,21,16,19,0,0,129
20,15,19,19,21,20,0,0,0,114
20,15,19,20,0,0,0,0,0,74
20,15,19,20,1,4,1,0,0,80
20,15,19,20,1,4,1,19,0,99
20,15,19,20,1,4,15,0,0,94
20,15,19,20,1,4,15,19,0,113
20,15,19,20,1,15,0,0,0,90
20,15,19,20,9,3,1,20,5,112
20,15,20,0,0,0,0,0,0,55
20,15,20,1,2,12,5,0,0,75
20,15,20,1,12,0,0,0,0,68
20,15,20,1,12,5,4,0,0,77
20,15,20,1,12,9,14,7,0,98
20,15,20,1,12,9,19,5,0,101
20,15,20,1,12,9,19,5,4,105
20,15,20,1,12,9,19,5,19,120
20,15,20,1,12,9,19,13,0,109
20,15,20,1,12,9,19,13,19,128
20,15,20,1,12,9,19,20,0,116
20,15,20,1,12,9,20,25,0,122
20,15,20,1,12,9,26,5,0,108
20,15,20,1,12,9,26,5,4,112
20,15,20,1,12,9,26,5,18,126
20,15,20,1,12,9,26,5,19,127
20,15,20,1,12,12,5,4,0,89
20,15,20,1,12,12,5,18,0,103
20,15,20,1,12,12,5,18,19,122
20,15,20,1,12,12,25,0,0,105
20,15,20,1,12,12,9,14,7,110
20,15,20,1,12,14,5,19,19,125
20,15,20,1,12,19,0,0,0,87
20,15,20,1,14,9,14,5,0,98
20,15,20,1,17,21,9,14,0,117
20,15,20,1,17,21,9,14,1,118
20,15,20,1,17,21,9,14,5,122
20,15,20,1,18,1,0,0,0,75
20,15,20,3,8,11,1,0,0,78
20,15,20,5,0,0,0,0,0,60
20,15,20,5,4,0,0,0,0,64
20,15,20,5,12,15,1,4,0,92
20,15,20,5,13,0,0,0,0,73
20,15,20,5,13,25,0,0,0,98
20,15,20,5,13,9,3,0,0,85
20,15,20,5,13,9,19,13,0,114
20,15,20,5,13,9,19,13,19,133
20,15,20,5,13,9,19,20,0,121
20,15,20,5,13,9,19,20,19,140
20,15,20,5,13,9,20,5,0,107
20,15,20,5,13,9,20,5,19,126
20,15,20,5,13,19,0,0,0,92
20,15,20,5,18,0,0,0,0,78
20,15,20,5,18,25,0,0,0,103
20,15,20,5,18,19,0,0,0,97
20,15,20,5,19,0,0,0,0,79
20,15,20,8,5,18,0,0,0,86
20,15,20,25,0,0,0,0,0,80
20,15,20,9,5,14,20,0,0,103
20,15,20,25,13,1,14,0,0,108
20,15,20,9,14,7,0,0,0,85
20,15,20,9,20,9,22,5,0,120
20,15,20,15,0,0,0,0,0,70
20,15,20,15,1,2,1,0,0,74
20,15,20,15,18,1,0,0,0,89
20,15,20,17,21,15,20,0,0,128
20,15,20,19,0,0,0,0,0,74
20,15,20,20,5,4,0,0,0,84
20,15,20,20,5,14,0,0,0,94
20,15,20,20,5,18,0,0,0,98
20,15,20,20,5,18,5,4,0,107
20,15,20,20,5,18,5,18,0,121
20,15,20,20,5,18,5,18,19,140
20,15,20,20,5,18,25,0,0,123
20,15,20,20,5,18,9,14,7,128
20,15,20,20,5,18,9,19,8,134
20,15,20,20,5,18,19,0,0,117
20,15,20,20,25,0,0,0,0,100
20,15,20,20,25,8,5,1,4,118
20,15,20,20,9,14,7,0,0,105
20,15,20,20,12,5,0,0,0,92
20,15,20,20,12,9,19,8,0,123
20,15,20,20,21,13,0,0,0,109
20,15,20,21,1,22,1,0,0,100
20,15,20,21,13,0,0,0,0,89
20,15,21,0,0,0,0,0,0,56
20,15,21,1,18,5,7,0,0,87
20,15,21,1,18,20,0,0,0,95
20,15,21,3,1,14,0,0,0,74
20,15,21,3,1,14,5,20,0,99
20,15,21,3,1,14,19,0,0,93
20,15,21,3,8,0,0,0,0,67
20,15,21,3,8,1,2,12,5,87
20,15,21,3,8,2,1,3,11,84
20,15,21,3,8,2,5,12,12,98
20,15,21,3,8,2,15,24,0,108
20,15,21,3,8,4,15,23,14,123
20,15,21,3,8,5,0,0,0,72
20,15,21,3,8,5,4,0,0,76
20,15,21,3,8,5,18,0,0,90
20,15,21,3,8,5,18,19,0,109
20,15,21,3,8,5,19,0,0,91
20,15,21,3,8,8,15,12,5,107
20,15,21,3,8,25,0,0,0,92
20,15,21,3,8,9,5,18,0,99
20,15,21,3,8,9,5,19,20,120
20,15,21,3,8,9,12,25,0,113
20,15,21,3,8,9,14,7,0,97
20,15,21,3,8,12,5,19,19,122
20,15,21,3,8,12,9,14,5,107
20,15,21,3,8,13,1,18,11,110
20,15,21,3,8,15,21,19,0,122
20,15,21,3,8,16,1,14,0,98
20,15,21,3,8,21,16,0,0,104
20,15,21,3,8,21,16,19,0,123
20,15,21,3,8,23,15,15,4,124
20,15,21,6,9,3,0,0,0,74
20,15,21,7,0,0,0,0,0,63
20,15,21,7,8,0,0,0,0,71
20,15,21,7,8,5,4,0,0,80
20,15,21,7,8,5,14,0,0,90
20,15,21,7,8,5,14,5,4,99
20,15,21,7,8,5,14,5,18,113
20,15,21,7,8,5,14,19,0,109
20,15,21,7,8,5,18,0,0,94
20,15,21,7,8,5,19,20,0,115
20,15,21,7,8,8,5,1,4,89
20,15,21,7,8,25,0,0,0,96
20,15,21,7,8,9,5,0,0,85
20,15,21,7,8,9,5,19,0,104
20,15,21,7,8,9,14,7,0,101
20,15,21,7,8,9,19,8,0,107
20,15,21,7,8,12,25,0,0,108
20,15,21,7,8,14,5,19,19,128
20,15,21,7,8,18,1,0,0,90
20,15,21,7,8,19,0,0,0,90
20,15,21,7,8,20,0,0,0,91
20,15,21,12,4,0,0,0,0,72
20,15,21,13,14,1,8,0,0,92
20,15,21,16,0,0,0,0,0,72
20,15,21,16,5,5,0,0,0,82
20,15,21,16,5,5,4,0,0,86
20,15,21,16,5,5,19,0,0,101
20,15,21,16,5,20,0,0,0,97
20,15,21,18,1,3,15,0,0,93
20,15,21,18,1,3,15,19,0,112
20,15,21,18,2,5,0,0,0,81
20,15,21,18,5,4,0,0,0,83
20,15,21,18,5,12,12,5,0,108
20,15,21,18,5,12,12,5,19,127
20,15,21,18,5,18,0,0,0,97
20,15,21,18,5,18,19,0,0,116
20,15,21,18,5,20,0,0,0,99
20,15,21,18,5,20,20,5,0,124
20,15,21,18,9,14,7,0,0,104
20,15,21,18,9,14,7,19,0,123
20,15,21,18,9,19,13,0,0,115
20,15,21,18,9,19,13,19,0,134
20,15,21,18,9,19,20,0,0,122
20,15,21,18,9,19,20,25,0,147
20,15,21,18,9,19,20,9,3,134
20,15,21,18,9,19,20,18,25,165
20,15,21,18,9,19,20,19,0,141
20,15,21,18,9,26,5,0,0,114
20,15,21,18,13,1,12,9,14,123
20,15,21,18,13,5,14,20,5,131
20,15,21,18,14,0,0,0,0,88
20,15,21,18,14,1,14,20,0,123
20,15,21,18,14,1,19,9,14,131
20,15,21,18,14,5,0,0,0,93
20,15,21,18,14,5,4,15,19,131
20,15,21,18,14,5,5,0,0,98
20,15,21,18,14,5,25,0,0,118
20,15,21,18,14,5,25,5,4,127
20,15,21,18,14,5,25,5,18,141
20,15,21,18,14,5,25,19,0,137
20,15,21,18,14,5,12,0,0,105
20,15,21,18,14,5,20,20,5,138
20,15,21,18,14,15,9,19,0,131
20,15,21,18,14,21,18,5,0,132
20,15,21,18,20,0,0,0,0,94
20,15,21,18,20,5,0,0,0,99
20,15,21,19,3,8,5,0,0,91
20,15,21,19,5,0,0,0,0,80
20,15,21,19,5,4,0,0,0,84
20,15,21,19,5,12,0,0,0,92
20,15,21,19,5,18,0,0,0,98
20,15,21,19,5,19,0,0,0,99
20,15,21,19,25,0,0,0,0,100
20,15,21,19,9,14,7,0,0,105
20,15,21,19,12,5,0,0,0,92
20,15,21,19,12,5,4,0,0,96
20,15,21,19,12,5,19,0,0,111
20,15,21,19,12,25,0,0,0,112
20,15,21,19,12,9,14,7,0,117
20,15,21,19,20,0,0,0,0,95
20,15,21,19,20,9,5,0,0,109
20,15,21,20,0,0,0,0,0,76
20,15,21,20,5,4,0,0,0,85
20,15,21,20,5,18,0,0,0,99
20,15,21,20,5,18,19,0,0,118
20,15,21,20,9,14,7,0,0,106
20,15,21,20,19,0,0,0,0,95
20,15,21,26,12,5,0,0,0,99
20,15,21,26,12,5,4,0,0,103
20,15,21,26,12,5,19,0,0,118
20,15,21,26,12,9,14,7,0,124
20,15,22,0,0,0,0,0,0,57
20,15,22,1,8,0,0,0,0,66
20,15,22,1,18,0,0,0,0,76
20,15,22,1,18,9,3,8,0,96
20,15,22,1,18,9,19,3,8,115
20,15,22,1,18,9,19,8,0,112
20,15,22,5,20,0,0,0,0,82
20,15,23,1,2,12,5,0,0,78
20,15,23,1,7,5,0,0,0,71
20,15,23,1,7,5,19,0,0,90
20,15,23,1,9,0,0,0,0,68
20,15,23,1,14,0,0,0,0,73
20,15,23,1,18,4,0,0,0,81
20,15,23,1,18,4,12,25,0,118
20,15,23,1,18,4,19,0,0,100
20,15,23,1,23,1,25,0,0,108
20,15,23,1,23,1,25,19,0,127
20,15,23,2,1,18,0,0,0,79
20,15,23,2,15,1,20,0,0,96
20,15,23,2,15,1,20,19,0,115
20,15,23,3,15,3,11,0,0,90
20,15,23,4,0,0,0,0,0,62
20,15,23,4,9,5,0,0,0,76
20,15,23,5,4,0,0,0,0,67
20,15,23,5,12,0,0,0,0,75
20,15,23,5,12,5,4,0,0,84
20,15,23,5,12,5,20,20,5,125
20,15,23,5,12,9,14,7,0,105
20,15,23,5,12,9,14,7,19,124
20,15,23,5,12,12,5,4,0,96
20,15,23,5,12,12,9,14,7,117
20,15,23,5,12,18,25,0,0,118
20,15,23,5,12,19,0,0,0,94
20,15,23,5,18,5,4,0,0,90
20,15,23,5,18,25,0,0,0,106
20,15,23,5,18,9,5,18,0,113
20,15,23,5,18,9,5,19,20,134
20,15,23,5,18,9,14,7,0,111
20,15,23,5,18,12,5,19,19,136
20,15,23,5,18,12,5,20,0,118
20,15,23,5,18,12,9,11,5,118
20,15,23,5,18,13,1,14,0,109
20,15,23,5,18,13,5,14,0,113
20,15,23,5,18,23,9,19,5,137
20,15,23,5,18,23,15,18,11,148
20,15,23,5,18,23,15,18,20,157
20,15,23,7,8,20,0,0,0,93
20,15,23,8,5,1,4,0,0,76
20,15,23,8,5,1,4,5,4,85
20,15,23,8,5,1,4,19,0,95
20,15,23,8,5,5,0,0,0,76
20,15,23,8,5,5,19,0,0,95
20,15,23,25,0,0,0,0,0,83
20,15,23,9,5,0,0,0,0,72
20,15,23,9,5,19,0,0,0,91
20,15,23,9,14,7,0,0,0,88
20,15,23,11,1,25,0,0,0,95
20,15,23,12,9,11,5,0,0,95
20,15,23,12,9,14,5,0,0,98
20,15,23,12,9,14,5,19,0,117
20,15,23,13,1,19,20,0,0,111
20,15,23,13,15,14,4,0,0,104
20,15,23,13,15,14,4,19,0,123
20,15,23,13,15,14,20,0,0,120
20,15,23,13,15,14,20,19,0,139
20,15,23,14,5,4,0,0,0,81
20,15,23,14,5,5,0,0,0,82
20,15,23,14,5,5,19,0,0,101
20,15,23,14,5,20,0,0,0,97
20,15,23,14,6,15,12,11,0,116
20,15,23,14,6,15,12,11,19,135
20,15,23,14,6,21,12,0,0,111
20,15,23,14,7,1,20,5,0,105
20,15,23,14,8,15,13,5,0,113
20,15,23,14,8,15,15,4,0,114
20,15,23,14,8,15,21,19,5,140
20,15,23,14,9,5,19,0,0,105
20,15,23,14,9,6,25,0,0,112
20,15,23,14,9,6,9,5,4,105
20,15,23,14,9,14,5,19,19,138
20,15,23,14,9,19,8,0,0,108
20,15,23,14,9,19,8,12,25,145
20,15,23,14,9,19,20,0,0,120
20,15,23,14,12,1,14,4,0,103
20,15,23,14,12,5,19,19,0,127
20,15,23,14,12,5,20,0,0,109
20,15,23,14,12,5,20,19,0,128
20,15,23,14,12,25,0,0,0,109
20,15,23,14,12,9,11,5,0,109
20,15,23,14,12,9,14,7,0,114
20,15,23,14,13,1,14,0,0,100
20,15,23,14,13,5,14,0,0,104
20,15,23,14,19,0,0,0,0,91
20,15,23,14,19,2,15,25,0,133
20,15,23,14,19,3,1,16,5,116
20,15,23,14,19,5,14,4,9,123
20,15,23,14,19,6,15,12,11,135
20,15,23,14,19,8,9,16,0,124
20,15,23,14,19,8,9,16,19,143
20,15,23,14,19,9,4,5,0,109
20,15,23,14,19,9,20,5,0,125
20,15,23,14,19,13,1,14,0,119
20,15,23,14,19,13,5,14,0,123
20,15,23,14,23,1,18,4,0,118
20,15,23,14,23,1,18,4,19,137
20,15,23,14,23,5,1,18,0,119
20,15,23,14,23,5,1,18,19,138
20,15,23,16,1,20,8,0,0,103
20,15,23,16,1,20,8,19,0,122
20,15,23,18,15,16,5,0,0,112
20,15,23,18,15,16,5,19,0,131
20,15,23,19,0,0,0,0,0,77
20,15,23,19,5,18,0,0,0,100
20,15,23,19,25,0,0,0,0,102
20,15,23,26,9,5,0,0,0,98
20,15,24,0,0,0,0,0,0,59
20,15,24,1,0,0,0,0,0,60
20,15,24,1,5,13,9,1,0,88
20,15,24,1,5,13,9,1,19,107
20,15,24,1,5,13,9,3,0,90
20,15,24,1,13,9,14,0,0,96
20,15,24,1,14,5,13,9,1,102
20,15,24,1,16,8,5,14,5,108
20,15,24,3,1,20,12,0,0,95
20,15,24,5,13,9,1,0,0,87
20,15,24,5,13,9,1,19,0,106
20,15,24,5,13,9,3,0,0,89
20,15,24,9,3,0,0,0,0,71
20,15,24,9,3,1,12,0,0,84
20,15,24,9,3,1,12,12,25,121
20,15,24,9,3,1,14,20,0,106
20,15,24,9,3,1,14,20,19,125
20,15,24,9,3,1,18,15,12,117
20,15,24,9,3,1,20,5,0,97
20,15,24,9,3,5,13,9,1,99
20,15,24,9,3,9,20,25,0,125
20,15,24,9,3,15,9,4,0,99
20,15,24,9,3,15,12,0,0,98
20,15,24,9,3,15,14,0,0,100
20,15,24,9,3,15,19,5,19,129
20,15,24,9,3,15,19,9,19,133
20,15,24,9,3,21,13,0,0,105
20,15,24,9,6,5,18,0,0,97
20,15,24,9,6,25,0,0,0,99
20,15,24,9,6,9,5,4,0,92
20,15,24,9,6,25,9,14,7,129
20,15,24,9,7,5,14,9,3,106
20,15,24,9,8,5,13,9,1,104
20,15,24,9,14,0,0,0,0,82
20,15,24,9,14,5,0,0,0,87
20,15,24,9,14,5,13,9,1,110
20,15,24,9,14,5,19,0,0,106
20,15,24,9,14,15,19,9,19,144
20,15,24,9,14,19,0,0,0,101
20,15,24,9,16,8,1,7,9,109
20,15,24,9,20,25,0,0,0,113
20,15,24,15,4,15,14,20,0,127
20,15,24,15,9,4,0,0,0,87
20,15,24,15,9,4,19,0,0,106
20,15,24,15,12,25,19,9,19,158
20,15,24,15,12,15,7,25,0,133
20,15,24,15,14,0,0,0,0,88
20,15,24,15,14,5,0,0,0,93
20,15,24,15,14,15,19,9,19,150
20,15,24,15,16,8,9,12,0,119
20,15,24,15,16,8,9,12,5,124
20,15,24,15,16,8,9,12,25,144
20,15,24,15,19,9,19,0,0,121
20,15,24,15,19,15,26,9,14,157
20,15,24,15,20,1,5,0,0,100
20,15,26,5,0,0,0,0,0,66
20,15,26,5,5,0,0,0,0,71
20,15,26,5,18,0,0,0,0,84
20,16,4,0,0,0,0,0,0,40
20,16,8,0,0,0,0,0,0,44
20,16,11,0,0,0,0,0,0,47
20,16,11,5,0,0,0,0,0,52
20,18,5,1,3,8,5,18,0,78
20,18,5,1,3,8,5,18,25,103
20,18,5,1,3,12,5,0,0,64
20,18,5,1,3,12,5,19,0,83
20,18,5,1,3,12,25,0,0,84
20,18,5,1,4,0,0,0,0,48
20,18,5,1,4,5,4,0,0,57
20,18,5,1,4,5,18,0,0,71
20,18,5,1,4,5,18,19,0,90
20,18,5,1,4,9,14,7,0,78
20,18,5,1,4,12,5,0,0,65
20,18,5,1,4,12,5,4,0,69
20,18,5,1,4,12,5,18,0,83
20,18,5,1,4,12,5,18,19,102
20,18,5,1,4,12,5,19,0,84
20,18,5,1,4,12,5,19,19,103
20,18,5,1,4,12,9,14,7,90
20,18,5,1,4,13,9,12,12,94
20,18,5,1,4,19,0,0,0,67
20,18,5,1,7,21,5,0,0,77
20,18,5,1,19,0,0,0,0,63
20,18,5,1,19,15,14,0,0,92
20,18,5,1,19,15,14,19,0,111
20,18,5,1,19,18,0,0,0,81
20,18,5,1,19,21,18,5,0,107
20,18,5,1,19,21,18,5,4,111
20,18,5,1,19,21,18,5,19,126
20,18,5,1,20,1,2,12,5,84
20,18,5,1,20,1,2,12,25,104
20,18,5,1,20,5,4,0,0,73
20,18,5,1,20,5,5,0,0,74
20,18,5,1,20,5,18,0,0,87
20,18,5,1,20,5,18,19,0,106
20,18,5,1,20,25,0,0,0,89
20,18,5,1,20,9,5,19,0,97
20,18,5,1,20,25,9,19,20,137
20,18,5,1,20,25,9,20,5,123
20,18,5,1,20,9,14,7,0,94
20,18,5,1,20,9,19,5,0,97
20,18,5,1,20,9,19,5,18,115
20,18,5,1,20,9,19,5,19,116
20,18,5,1,20,13,5,14,20,116
20,18,5,1,20,15,18,0,0,97
20,18,5,1,20,19,0,0,0,83
20,18,5,2,12,5,0,0,0,62
20,18,5,2,12,5,4,0,0,66
20,18,5,2,12,5,19,0,0,81
20,18,5,2,12,5,20,0,0,82
20,18,5,2,12,25,0,0,0,82
20,18,5,2,12,9,14,7,0,87
20,18,5,2,21,3,8,5,20,102
20,18,5,2,21,3,11,5,20,105
20,18,5,3,5,14,20,15,0,100
20,18,5,3,5,14,20,15,19,119
20,18,5,3,11,16,15,20,0,108
20,18,5,4,4,12,5,0,0,68
20,18,5,4,4,12,5,4,0,72
20,18,5,4,4,12,5,19,0,87
20,18,5,4,4,12,9,14,7,93
20,18,5,4,5,3,9,12,5,81
20,18,5,4,9,12,12,5,0,85
20,18,5,4,18,9,12,12,5,103
20,18,5,5,2,5,1,18,4,78
20,18,5,5,2,9,14,5,0,78
20,18,5,5,4,0,0,0,0,52
20,18,5,5,6,9,19,8,0,90
20,18,5,5,6,21,12,0,0,87
20,18,5,5,8,1,9,18,0,84
20,18,5,5,8,15,15,4,0,90
20,18,5,5,25,0,0,0,0,73
20,18,5,5,9,6,25,0,0,88
20,18,5,5,9,14,5,19,19,114
20,18,5,5,9,14,7,0,0,78
20,18,5,5,12,1,23,14,0,98
20,18,5,5,12,5,19,19,0,103
20,18,5,5,12,5,20,0,0,85
20,18,5,5,12,9,11,5,0,85
20,18,5,5,12,9,14,5,4,92
20,18,5,5,12,9,14,7,0,90
20,18,5,5,13,1,11,5,18,96
20,18,5,5,13,1,14,0,0,76
20,18,5,5,14,0,0,0,0,62
20,18,5,5,14,1,9,12,0,84
20,18,5,5,14,1,9,12,19,103
20,18,5,5,14,19,0,0,0,81
20,18,5,5,14,23,1,18,5,109
20,18,5,5,19,0,0,0,0,67
20,18,5,5,19,3,1,16,5,92
20,18,5,5,19,8,9,16,0,100
20,18,5,5,20,9,19,5,0,101
20,18,5,5,20,15,16,0,0,99
20,18,5,5,20,15,16,19,0,118
20,18,5,5,23,1,18,4,0,94
20,18,5,5,23,1,18,4,19,113
20,18,5,6,0,0,0,0,0,49
20,18,5,6,1,0,0,0,0,50
20,18,5,6,1,8,0,0,0,58
20,18,5,6,7,15,18,4,4,97
20,18,5,6,12,5,0,0,0,66
20,18,5,6,12,5,5,0,0,71
20,18,5,6,15,9,12,0,0,85
20,18,5,6,15,9,12,5,4,94
20,18,5,6,15,9,12,19,0,104
20,18,5,7,1,4,25,14,5,99
20,18,5,7,5,18,7,0,0,80
20,18,5,7,5,20,0,0,0,75
20,18,5,7,5,20,15,21,18,129
20,18,5,7,15,8,13,0,0,86
20,18,5,8,1,12,1,0,0,65
20,18,5,8,1,12,1,19,0,84
20,18,5,8,1,12,1,19,5,89
20,18,5,8,1,12,15,19,5,103
20,18,5,9,12,12,1,7,5,89
20,18,5,9,12,12,5,0,0,81
20,18,5,25,19,0,0,0,0,87
20,18,5,9,20,15,21,18,0,126
20,18,5,9,20,18,5,0,0,95
20,18,5,11,0,0,0,0,0,54
20,18,5,11,2,15,5,18,0,94
20,18,5,11,11,5,4,0,0,74
20,18,5,11,11,5,18,0,0,88
20,18,5,11,11,5,18,19,0,107
20,18,5,11,11,9,14,7,0,95
20,18,5,11,16,1,20,8,0,99
20,18,5,11,19,0,0,0,0,73
20,18,5,12,12,9,19,0,0,95
20,18,5,12,12,9,19,5,4,104
20,18,5,12,12,9,19,5,19,119
20,18,5,13,1,20,15,4,5,101
20,18,5,13,1,20,15,9,4,105
20,18,5,13,2,12,5,0,0,75
20,18,5,13,2,12,5,4,0,79
20,18,5,13,2,12,5,18,0,93
20,18,5,13,2,12,5,18,19,112
20,18,5,13,2,12,5,19,0,94
20,18,5,13,2,12,9,5,18,102
20,18,5,13,2,12,9,14,7,100
20,18,5,13,2,12,15,18,0,103
20,18,5,13,5,12,9,14,5,101
20,18,5,13,5,14,19,0,0,94
20,18,5,13,5,20,15,12,0,108
20,18,5,13,5,24,0,0,0,85
20,18,5,13,9,5,0,0,0,70
20,18,5,13,15,7,18,1,13,110
20,18,5,13,15,12,1,14,20,118
20,18,5,13,15,12,9,19,20,131
20,18,5,13,15,12,9,20,5,117
20,18,5,13,15,12,15,0,0,98
20,18,5,13,15,12,15,19,0,117
20,18,5,13,15,12,15,19,15,132
20,18,5,13,15,18,0,0,0,89
20,18,5,13,15,18,19,0,0,108
20,18,5,13,16,12,9,14,0,107
20,18,5,13,21,12,1,14,20,124
20,18,5,13,21,12,1,20,5,115
20,18,5,13,21,12,5,14,20,128
20,18,5,13,21,12,15,21,19,144
20,18,5,14,1,9,12,0,0,79
20,18,5,14,1,9,12,19,0,98
20,18,5,14,3,8,0,0,0,68
20,18,5,14,3,8,1,14,20,103
20,18,5,14,3,8,5,4,0,77
20,18,5,14,3,8,5,18,0,91
20,18,5,14,3,8,5,18,19,110
20,18,5,14,3,8,5,19,0,92
20,18,5,14,3,8,6,21,12,107
20,18,5,14,3,8,9,14,7,98
20,18,5,14,3,8,12,5,20,105
20,18,5,14,4,0,0,0,0,61
20,18,5,14,4,5,4,0,0,70
20,18,5,14,4,5,12,0,0,78
20,18,5,14,4,25,0,0,0,86
20,18,5,14,4,9,5,18,0,93
20,18,5,14,4,9,5,19,0,94
20,18,5,14,4,9,5,19,20,114
20,18,5,14,4,9,12,25,0,107
20,18,5,14,4,9,14,7,0,91
20,18,5,14,4,12,5,0,0,78
20,18,5,14,4,19,0,0,0,80
20,18,5,14,20,1,12,0,0,90
20,18,5,16,1,11,0,0,0,71
20,18,5,16,1,14,0,0,0,74
20,18,5,16,1,14,7,0,0,81
20,18,5,16,1,14,7,19,0,100
20,18,5,16,1,14,9,26,5,114
20,18,5,16,1,14,14,5,4,97
20,18,5,16,1,14,14,5,18,111
20,18,5,16,1,14,19,0,0,93
20,18,5,16,8,9,14,5,0,95
20,18,5,16,8,9,14,5,4,99
20,18,5,16,8,9,14,5,18,113
20,18,5,16,8,9,14,5,19,114
20,18,5,16,8,15,14,5,0,101
20,18,5,16,9,4,0,0,0,72
20,18,5,16,9,4,1,14,20,107
20,18,5,16,9,4,1,20,5,98
20,18,5,16,9,4,9,20,25,126
20,18,5,16,9,4,12,25,0,109
20,18,5,16,15,14,5,13,5,111
20,18,5,16,16,5,0,0,0,80
20,18,5,19,0,0,0,0,0,62
20,18,5,19,1,9,5,12,0,89
20,18,5,19,1,14,3,5,0,85
20,18,5,19,3,8,5,0,0,78
20,18,5,19,9,12,12,15,0,110
20,18,5,19,9,19,0,0,0,90
20,18,5,19,16,1,19,19,0,117
20,18,5,19,19,0,0,0,0,81
20,18,5,19,19,5,4,0,0,90
20,18,5,19,19,5,12,0,0,98
20,18,5,19,19,5,12,19,0,117
20,18,5,19,19,5,19,0,0,105
20,18,5,19,19,6,21,12,0,120
20,18,5,19,19,25,0,0,0,106
20,18,5,19,19,9,5,18,0,113
20,18,5,19,19,9,5,19,20,134
20,18,5,19,19,12,5,19,19,136
20,18,5,19,19,12,5,20,0,118
20,18,5,19,19,12,9,11,5,118
20,18,5,19,19,15,14,0,0,110
20,18,5,19,19,15,21,18,0,135
20,18,5,19,19,15,21,18,19,154
20,18,5,19,19,21,18,5,0,125
20,18,5,19,19,21,18,5,4,129
20,18,5,19,19,21,18,5,19,144
20,18,5,19,20,0,0,0,0,82
20,18,5,19,20,12,5,0,0,99
20,18,5,19,20,12,5,19,0,118
20,18,5,19,20,12,9,14,7,124
20,18,5,20,0,0,0,0,0,63
20,18,5,20,9,19,0,0,0,91
20,18,5,20,19,0,0,0,0,82
20,18,5,22,1,12,12,25,0,115
20,18,5,22,5,20,0,0,0,90
20,18,5,22,5,20,19,0,0,109
20,18,5,22,5,20,20,5,0,115
20,18,5,22,9,19,0,0,0,93
20,18,5,23,1,7,5,0,0,79
20,18,5,23,5,12,0,0,0,83
20,18,5,23,19,0,0,0,0,85
20,18,5,23,19,13,1,14,0,113
20,18,5,23,19,13,5,14,0,117
20,18,6,0,0,0,0,0,0,44
20,18,25,0,0,0,0,0,0,63
20,18,9,1,2,12,5,0,0,67
20,18,9,1,3,0,0,0,0,51
20,18,9,1,3,5,0,0,0,56
20,18,9,1,3,9,4,0,0,64
20,18,9,1,3,9,4,19,0,83
20,18,9,1,3,19,0,0,0,70
20,18,9,1,3,20,0,0,0,71
20,18,9,1,3,20,9,14,5,99
20,18,9,1,4,9,3,0,0,64
20,18,9,1,4,9,3,1,12,77
20,18,9,1,4,9,3,19,0,83
20,18,9,1,4,9,19,13,0,93
20,18,9,1,4,9,19,13,19,112
20,18,9,1,4,9,19,20,0,100
20,18,9,1,4,19,0,0,0,71
20,18,9,1,5,14,5,0,0,72
20,18,9,1,5,14,15,19,5,106
20,18,9,1,7,5,0,0,0,60
20,18,9,1,7,5,19,0,0,79
20,18,9,1,7,15,14,1,12,97
20,18,9,1,11,9,4,0,0,72
20,18,9,1,12,0,0,0,0,60
20,18,9,1,12,1,20,5,0,86
20,18,9,1,12,9,19,13,0,101
20,18,9,1,12,9,19,20,0,108
20,18,9,1,12,9,20,25,0,114
20,18,9,1,12,15,7,21,5,108
20,18,9,1,12,19,0,0,0,79
20,18,9,1,13,9,4,0,0,74
20,18,9,1,13,9,4,5,0,79
20,18,9,1,13,9,14,0,0,84
20,18,9,1,13,9,14,5,0,89
20,18,9,1,13,9,14,15,0,99
20,18,9,1,13,15,18,16,8,118
20,18,9,1,14,4,5,18,0,89
20,18,9,1,14,7,12,5,4,90
20,18,9,1,14,7,12,5,18,104
20,18,9,1,14,7,12,5,19,105
20,18,9,1,14,14,21,1,12,110
20,18,9,1,16,19,1,12,0,96
20,18,9,1,18,3,8,0,0,77
20,18,9,1,18,3,8,25,0,102
20,18,9,1,18,3,20,9,3,101
20,18,9,1,18,5,1,12,0,84
20,18,9,1,18,25,0,0,0,91
20,18,9,1,18,9,1,14,0,90
20,18,9,1,18,9,9,0,0,84
20,18,9,1,18,25,12,0,0,103
20,18,9,1,19,20,5,18,0,110
20,18,9,1,20,9,3,0,0,80
20,18,9,1,20,15,13,9,3,108
20,18,9,1,24,1,12,0,0,85
20,18,9,1,24,9,1,12,0,94
20,18,9,1,24,15,14,0,0,101
20,18,9,1,26,1,14,5,0,94
20,18,9,1,26,9,14,0,0,97
20,18,9,1,26,9,14,5,0,102
20,18,9,1,26,9,14,5,19,121
20,18,9,1,26,9,14,19,0,116
20,18,9,1,26,15,0,0,0,89
20,18,9,1,26,15,9,3,0,101
20,18,9,1,26,15,12,5,0,106
20,18,9,1,26,15,12,5,19,125
20,18,9,1,26,15,12,9,3,113
20,18,9,2,1,4,5,0,0,59
20,18,9,2,1,4,5,19,0,78
20,18,9,2,1,4,25,0,0,79
20,18,9,2,1,4,9,3,0,66
20,18,9,2,1,4,9,19,13,95
20,18,9,2,1,12,0,0,0,62
20,18,9,2,1,12,9,19,13,103
20,18,9,2,1,12,9,19,20,110
20,18,9,2,1,12,12,25,0,99
20,18,9,2,1,18,18,5,4,95
20,18,9,2,1,19,5,0,0,74
20,18,9,2,1,19,9,3,0,81
20,18,9,2,2,12,5,0,0,68
20,18,9,2,5,0,0,0,0,54
20,18,9,2,5,12,5,19,19,109
20,18,9,2,5,12,5,20,0,91
20,18,9,2,5,12,9,11,5,91
20,18,9,2,5,19,0,0,0,73
20,18,9,2,5,19,8,9,16,106
20,18,9,2,5,19,13,1,14,101
20,18,9,2,5,19,13,5,14,105
20,18,9,2,12,5,20,0,0,86
20,18,9,2,15,12,15,7,25,123
20,18,9,2,18,1,3,0,0,71
20,18,9,2,18,1,3,8,0,79
20,18,9,2,18,1,3,8,19,98
20,18,9,2,18,15,13,9,4,108
20,18,9,2,21,1,12,0,0,83
20,18,9,2,21,1,12,12,25,120
20,18,9,2,21,12,1,18,0,101
20,18,9,2,21,12,1,20,5,108
20,18,9,2,21,12,15,9,4,110
20,18,9,2,21,14,1,0,0,85
20,18,9,2,21,14,1,12,0,97
20,18,9,2,21,14,1,12,19,116
20,18,9,2,21,14,1,18,25,128
20,18,9,2,21,14,1,20,5,110
20,18,9,2,21,14,5,0,0,89
20,18,9,2,21,14,5,19,0,108
20,18,9,2,21,20,1,18,25,134
20,18,9,2,21,20,5,0,0,95
20,18,9,2,21,20,5,4,0,99
20,18,9,2,21,20,5,18,0,113
20,18,9,2,21,20,5,19,0,114
20,18,9,2,21,20,9,14,7,120
20,18,9,2,21,20,9,19,20,138
20,18,9,3,1,0,0,0,0,51
20,18,9,3,1,5,0,0,0,56
20,18,9,3,1,12,3,9,3,78
20,18,9,3,1,18,0,0,0,69
20,18,9,3,1,18,2,15,14,100
20,18,9,3,1,21,4,1,12,89
20,18,9,3,5,0,0,0,0,55
20,18,9,3,5,4,0,0,0,59
20,18,9,3,5,14,1,18,25,113
20,18,9,3,5,16,8,1,12,92
20,18,9,3,5,16,19,0,0,90
20,18,9,3,5,16,19,5,19,114
20,18,9,3,5,18,9,1,0,83
20,18,9,3,5,18,9,15,14,111
20,18,9,3,5,18,9,21,13,116
20,18,9,3,5,19,0,0,0,74
20,18,9,3,8,9,0,0,0,67
20,18,9,3,8,25,0,0,0,83
20,18,9,3,8,9,1,0,0,68
20,18,9,3,8,9,14,1,5,87
20,18,9,3,8,9,14,1,12,94
20,18,9,3,8,9,14,1,19,101
20,18,9,3,8,9,15,14,0,96
20,18,9,3,8,9,15,14,19,115
20,18,9,3,8,9,20,5,0,92
20,18,9,3,8,9,20,5,19,111
20,18,9,3,8,9,20,9,3,99
20,18,9,3,8,9,20,9,19,115
20,18,9,3,8,12,15,18,15,118
20,18,9,3,8,15,4,5,0,82
20,18,9,3,8,15,7,5,14,99
20,18,9,3,8,15,9,4,0,86
20,18,9,3,8,15,13,1,0,87
20,18,9,3,8,15,13,5,0,91
20,18,9,3,8,15,13,5,19,110
20,18,9,3,8,15,13,9,3,98
20,18,9,3,8,15,18,4,0,95
20,18,9,3,8,15,19,9,19,120
20,18,9,3,8,15,21,19,0,113
20,18,9,3,8,18,15,9,3,103
20,18,9,3,8,18,15,13,5,109
20,18,9,3,25,3,12,5,0,95
20,18,9,3,25,3,12,5,4,99
20,18,9,3,25,3,12,5,18,113
20,18,9,3,25,3,12,5,19,114
20,18,9,3,25,3,12,9,3,102
20,18,9,3,9,14,7,0,0,80
20,18,9,3,9,14,9,21,13,116
20,18,9,3,11,0,0,0,0,61
20,18,9,3,11,5,4,0,0,70
20,18,9,3,11,5,18,0,0,84
20,18,9,3,11,5,18,25,0,109
20,18,9,3,11,5,18,19,0,103
20,18,9,3,11,6,21,12,0,100
20,18,9,3,11,25,0,0,0,86
20,18,9,3,11,9,5,0,0,75
20,18,9,3,11,9,5,18,0,93
20,18,9,3,11,9,5,19,20,114
20,18,9,3,11,9,12,25,0,107
20,18,9,3,11,9,14,7,0,91
20,18,9,3,11,9,19,8,0,97
20,18,9,3,11,12,5,0,0,78
20,18,9,3,11,12,5,4,0,82
20,18,9,3,11,12,5,19,0,97
20,18,9,3,11,12,5,19,19,116
20,18,9,3,11,12,5,20,0,98
20,18,9,3,11,12,25,0,0,98
20,18,9,3,11,12,9,5,18,105
20,18,9,3,11,12,9,11,5,98
20,18,9,3,11,12,9,14,7,103
20,18,9,3,11,13,5,14,20,113
20,18,9,3,11,19,0,0,0,80
20,18,9,3,11,19,25,0,0,105
20,18,9,3,11,19,9,5,18,112
20,18,9,3,11,19,9,12,25,126
20,18,9,3,11,19,15,13,5,113
20,18,9,3,11,19,20,5,18,123
20,18,9,3,12,1,4,0,0,67
20,18,9,3,12,1,4,19,0,86
20,18,9,3,12,9,14,9,1,95
20,18,9,3,12,9,14,9,3,97
20,18,9,3,15,12,9,3,0,89
20,18,9,3,15,12,15,14,0,106
20,18,9,3,15,12,15,18,0,110
20,18,9,3,15,12,15,18,19,129
20,18,9,3,15,12,15,21,18,131
20,18,9,3,15,14,0,0,0,79
20,18,9,3,15,14,3,8,0,90
20,18,9,3,15,18,14,0,0,97
20,18,9,3,15,18,14,5,0,102
20,18,9,3,15,18,14,5,19,121
20,18,9,3,15,18,14,19,0,116
20,18,9,3,15,19,1,14,5,104
20,18,9,3,15,19,25,12,0,121
20,18,9,3,15,20,0,0,0,85
20,18,9,3,15,20,5,5,0,95
20,18,9,3,15,20,9,14,5,113
20,18,9,3,15,20,19,0,0,104
20,18,9,3,15,21,14,9,0,109
20,18,9,3,18,5,19,15,12,119
20,18,9,3,18,15,20,9,3,115
20,18,9,3,18,21,18,1,12,120
20,18,9,3,20,18,1,3,0,92
20,18,9,3,20,18,1,3,19,111
20,18,9,3,21,19,16,1,12,119
20,18,9,3,21,19,16,9,4,119
20,18,9,4,0,0,0,0,0,51
20,18,9,4,1,3,20,25,12,112
20,18,9,4,1,9,12,25,0,98
20,18,9,4,4,12,5,18,0,90
20,18,9,4,5,3,1,14,5,79
20,18,9,4,5,3,5,14,5,83
20,18,9,4,5,3,25,12,0,96
20,18,9,4,5,3,15,9,3,86
20,18,9,4,5,14,20,0,0,90
20,18,9,4,5,14,20,1,12,103
20,18,9,4,5,14,20,19,0,109
20,18,9,4,5,18,13,9,3,99
20,18,9,4,9,9,0,0,0,69
20,18,9,4,25,13,9,20,5,123
20,18,9,4,18,1,0,0,0,70
20,18,9,4,18,1,3,8,13,94
20,18,9,4,21,1,13,0,0,86
20,18,9,4,21,1,14,0,0,87
20,18,9,4,21,15,0,0,0,87
20,18,9,4,21,21,13,0,0,106
20,18,9,4,21,21,13,19,0,125
20,18,9,5,3,9,15,21,19,119
20,18,9,5,4,0,0,0,0,56
20,18,9,5,4,12,25,0,0,93
20,18,9,5,4,14,5,19,19,113
20,18,9,5,5,14,14,9,1,95
20,18,9,5,14,5,0,0,0,71
20,18,9,5,14,5,19,0,0,90
20,18,9,5,14,14,9,1,0,90
20,18,9,5,14,14,9,1,12,102
20,18,9,5,14,14,9,1,19,109
20,18,9,5,14,14,9,21,13,123
20,18,9,5,14,19,0,0,0,85
20,18,9,5,14,20,1,12,0,99
20,18,9,5,14,20,5,19,0,110
20,18,9,5,17,21,1,12,0,103
20,18,9,5,18,1,18,3,8,100
20,18,9,5,18,19,0,0,0,89
20,18,9,5,18,21,3,9,14,117
20,18,9,5,19,0,0,0,0,71
20,18,9,5,20,5,18,9,3,107
20,18,9,5,20,8,25,12,0,117
20,18,9,6,1,0,0,0,0,54
20,18,9,6,1,3,9,1,12,79
20,18,9,6,5,3,20,1,0,82
20,18,9,6,5,18,15,21,19,131
20,18,9,6,9,4,0,0,0,66
20,18,9,6,9,12,1,18,0,93
20,18,9,6,12,5,0,0,0,70
20,18,9,6,12,5,4,0,0,74
20,18,9,6,12,5,4,15,13,102
20,18,9,6,12,5,18,0,0,88
20,18,9,6,12,5,18,19,0,107
20,18,9,6,12,5,19,0,0,89
20,18,9,6,12,5,20,0,0,90
20,18,9,6,12,25,0,0,0,90
20,18,9,6,12,9,14,7,0,95
20,18,9,6,12,9,14,7,19,114
20,18,9,6,12,15,18,1,12,111
20,18,9,6,15,3,1,12,0,84
20,18,9,6,15,3,1,12,19,103
20,18,9,6,15,9,12,0,0,89
20,18,9,6,15,12,4,0,0,84
20,18,9,6,15,12,25,0,0,105
20,18,9,6,15,18,9,1,0,96
20,18,9,6,15,18,9,1,12,108
20,18,9,6,15,18,9,21,13,129
20,18,9,6,15,18,13,0,0,99
20,18,9,6,15,18,13,5,4,108
20,18,9,6,15,18,13,9,14,122
20,18,9,6,15,18,14,9,1,110
20,18,9,6,21,18,1,14,0,107
20,18,9,6,21,18,3,1,12,108
20,18,9,7,0,0,0,0,0,54
20,18,9,7,1,0,0,0,0,55
20,18,9,7,1,5,0,0,0,60
20,18,9,7,1,13,25,0,0,93
20,18,9,7,1,13,9,19,20,116
20,18,9,7,1,13,15,21,19,123
20,18,9,7,1,20,18,15,14,122
20,18,9,7,5,13,9,14,9,104
20,18,9,7,7,5,4,0,0,70
20,18,9,7,7,5,18,0,0,84
20,18,9,7,7,5,18,5,4,93
20,18,9,7,7,5,18,19,0,103
20,18,9,7,7,5,19,20,0,105
20,18,9,7,7,9,14,7,0,91
20,18,9,7,25,14,0,0,0,93
20,18,9,7,25,14,9,1,14,117
20,18,9,7,25,14,15,21,19,148
20,18,9,7,9,14,20,1,12,110
20,18,9,7,12,25,0,0,0,91
20,18,9,7,12,9,4,0,0,79
20,18,9,7,12,25,16,8,0,115
20,18,9,7,12,25,16,8,19,134
20,18,9,7,12,15,20,0,0,101
20,18,9,7,14,5,19,19,0,111
20,18,9,7,15,0,0,0,0,69
20,18,9,7,15,14,0,0,0,83
20,18,9,7,15,14,1,12,0,96
20,18,9,7,15,14,5,0,0,88
20,18,9,7,15,14,9,3,0,95
20,18,9,7,15,14,9,4,0,96
20,18,9,7,15,14,9,20,5,117
20,18,9,7,15,14,15,9,4,111
20,18,9,7,15,14,15,14,0,112
20,18,9,7,15,14,15,21,19,138
20,18,9,7,15,14,19,0,0,102
20,18,9,7,15,14,21,13,0,117
20,18,9,7,15,19,0,0,0,88
20,18,9,7,18,1,13,0,0,86
20,18,9,7,18,1,13,19,0,105
20,18,9,7,18,1,16,8,0,97
20,18,9,7,18,1,16,8,19,116
20,18,9,7,19,0,0,0,0,73
20,18,9,8,1,12,9,4,0,81
20,18,9,8,1,12,9,4,5,86
20,18,9,8,5,4,18,1,0,83
20,18,9,8,5,4,18,1,12,95
20,18,9,8,5,4,18,15,14,111
20,18,9,8,25,2,18,9,4,113
20,18,9,8,25,4,18,9,3,114
20,18,9,8,25,4,18,15,12,129
20,18,9,8,15,18,1,12,0,101
20,18,9,8,15,21,18,12,25,146
20,18,25,8,15,21,19,5,0,131
20,18,25,9,14,7,0,0,0,93
20,18,25,9,14,7,12,25,0,130
20,18,9,10,5,20,0,0,0,82
20,18,9,10,5,20,19,0,0,101
20,18,9,10,21,7,1,20,5,111
20,18,9,10,21,7,15,21,19,140
20,18,9,11,1,25,1,0,0,85
20,18,9,11,5,0,0,0,0,63
20,18,9,11,5,18,0,0,0,81
20,18,9,11,5,18,9,1,0,91
20,18,9,11,5,18,9,15,14,119
20,18,9,11,5,19,0,0,0,82
20,18,9,11,5,20,15,0,0,98
20,18,9,11,5,20,15,14,5,117
20,18,9,11,9,18,0,0,0,85
20,18,9,12,1,2,5,0,0,67
20,18,9,12,1,21,18,9,14,122
20,18,9,12,2,9,5,19,0,94
20,18,9,12,5,13,13,1,0,91
20,18,9,12,9,14,5,1,18,106
20,18,9,12,9,20,0,0,0,88
20,18,9,12,9,20,5,0,0,93
20,18,9,12,9,20,8,0,0,96
20,18,9,12,9,20,8,9,3,108
20,18,9,12,9,20,8,15,14,125
20,18,9,12,9,21,13,0,0,102
20,18,9,12,12,1,4,15,0,91
20,18,9,12,12,1,14,4,15,105
20,18,9,12,12,5,4,0,0,80
20,18,9,12,12,5,18,0,0,94
20,18,9,12,12,5,18,19,0,113
20,18,9,12,12,5,20,0,0,96
20,18,9,12,12,5,20,15,0,111
20,18,9,12,12,5,20,20,15,131
20,18,9,12,12,9,0,0,0,80
20,18,9,12,12,9,2,21,2,105
20,18,9,12,12,9,9,14,0,103
20,18,9,12,12,9,12,0,0,92
20,18,9,12,12,9,14,7,0,101
20,18,9,12,12,9,15,14,0,109
20,18,9,12,12,9,15,14,19,128
20,18,9,12,12,9,21,13,19,133
20,18,9,12,12,15,0,0,0,86
20,18,9,12,12,15,5,19,0,110
20,18,9,12,12,19,0,0,0,90
20,18,9,12,15,2,1,12,0,89
20,18,9,12,15,2,1,20,5,102
20,18,9,12,15,2,5,0,0,81
20,18,9,12,15,2,5,4,0,85
20,18,9,12,15,2,9,20,5,110
20,18,9,12,15,7,25,0,0,106
20,18,9,12,15,7,9,3,0,93
20,18,9,12,15,7,9,5,19,114
20,18,9,12,15,7,9,19,20,129
20,18,9,13,0,0,0,0,0,60
20,18,25,13,1,0,0,0,0,77
20,18,9,13,1,3,5,18,0,87
20,18,9,13,1,18,1,14,0,94
20,18,9,13,1,18,1,14,19,113
20,18,25,13,1,20,1,0,0,98
20,18,9,13,5,12,12,9,3,101
20,18,9,13,5,18,0,0,0,83
20,18,9,13,5,18,9,3,0,95
20,18,9,13,5,18,9,4,5,101
20,18,9,13,5,18,9,20,5,117
20,18,9,13,5,18,15,21,19,138
20,18,9,13,5,18,19,0,0,102
20,18,9,13,5,19,9,3,0,96
20,18,9,13,5,19,25,12,0,121
20,18,9,13,5,19,20,5,18,127
20,18,9,13,5,20,5,18,0,108
20,18,9,13,5,20,5,18,19,127
20,18,9,13,5,20,8,25,12,130
20,18,9,13,5,20,18,9,3,115
20,18,9,13,12,25,0,0,0,97
20,18,9,13,13,5,4,0,0,82
20,18,9,13,13,5,18,19,0,115
20,18,9,13,13,5,19,20,0,117
20,18,9,13,13,9,14,7,0,103
20,18,9,13,13,9,14,7,19,122
20,18,9,13,14,5,19,19,0,117
20,18,9,13,15,4,1,12,0,92
20,18,9,13,15,18,9,3,0,105
20,18,9,13,15,18,16,8,0,117
20,18,9,13,15,18,16,8,19,136
20,18,9,13,15,20,15,18,0,128
20,18,9,13,15,20,15,18,19,147
20,18,9,13,19,0,0,0,0,79
20,18,25,13,19,0,0,0,0,95
20,18,9,13,19,20,15,14,5,133
20,18,9,13,20,18,1,13,0,112
20,18,9,14,1,12,0,0,0,74
20,18,9,14,1,12,9,20,25,128
20,18,9,14,1,12,9,26,5,114
20,18,9,14,1,18,25,0,0,105
20,18,9,14,1,20,9,15,14,120
20,18,9,14,4,12,5,0,0,82
20,18,9,14,4,12,5,4,0,86
20,18,9,14,4,12,5,19,0,101
20,18,9,14,4,12,9,14,7,107
20,18,9,14,5,0,0,0,0,66
20,18,9,14,5,4,0,0,0,70
20,18,9,14,5,12,25,0,0,103
20,18,9,14,5,18,22,5,0,111
20,18,9,14,5,18,22,5,4,115
20,18,9,14,5,19,0,0,0,85
20,18,9,14,5,21,18,1,12,118
20,18,9,14,7,9,14,5,0,96
20,18,9,14,7,12,5,0,0,85
20,18,9,14,7,15,9,4,0,96
20,18,9,14,9,4,1,4,15,94
20,18,9,14,9,14,7,0,0,91
20,18,9,14,9,20,9,5,19,123
20,18,9,14,9,20,18,9,4,121
20,18,9,14,9,20,18,9,14,131
20,18,9,14,9,20,18,15,0,123
20,18,9,14,11,0,0,0,0,72
20,18,9,14,11,5,20,0,0,97
20,18,9,14,11,5,20,5,4,106
20,18,9,14,11,5,20,5,18,120
20,18,9,14,11,5,20,25,0,122
20,18,9,14,11,5,20,18,25,140
20,18,9,14,11,5,20,19,0,116
20,18,9,14,11,12,5,0,0,89
20,18,9,14,11,12,5,20,0,109
20,18,9,14,11,21,13,0,0,106
20,18,9,14,11,21,13,19,0,125
20,18,9,14,15,4,1,12,0,93
20,18,9,14,15,4,5,0,0,85
20,18,9,14,15,4,9,14,5,108
20,18,9,14,15,12,0,0,0,88
20,18,9,14,15,13,5,14,0,108
20,18,9,14,15,13,9,1,12,111
20,18,9,14,20,12,5,0,0,98
20,18,9,14,21,14,9,20,25,150
20,18,9,15,2,15,12,0,0,91
20,18,9,15,2,15,12,15,14,120
20,18,9,15,3,20,9,12,5,111
20,18,9,15,3,21,12,1,18,117
20,18,9,15,4,5,0,0,0,71
20,18,9,15,4,5,19,0,0,90
20,18,9,15,4,9,1,0,0,76
20,18,9,15,4,9,15,14,0,104
20,18,9,15,5,3,9,19,13,111
20,18,9,15,5,3,19,0,0,89
20,18,9,15,9,3,15,21,19,129
20,18,9,15,12,0,0,0,0,74
20,18,9,15,12,3,15,21,19,132
20,18,9,15,12,5,0,0,0,79
20,18,9,15,12,5,1,20,5,105
20,18,9,15,12,5,6,9,14,108
20,18,9,15,12,5,9,3,0,91
20,18,9,15,12,5,9,14,0,102
20,18,9,15,12,5,20,0,0,99
20,18,9,15,12,5,20,19,0,118
20,18,9,15,12,15,7,25,0,121
20,18,9,15,12,19,0,0,0,93
20,18,9,15,14,5,19,0,0,100
20,18,9,15,14,6,9,0,0,91
20,18,9,15,14,6,15,0,0,97
20,18,9,15,14,25,13,0,0,114
20,18,9,15,14,25,13,1,12,127
20,18,9,15,18,0,0,0,0,80
20,18,9,15,18,3,8,9,19,119
20,18,9,15,19,0,0,0,0,81
20,18,9,15,19,5,0,0,0,86
20,18,9,15,19,5,19,0,0,105
20,18,25,15,21,20,0,0,0,119
20,18,25,15,21,20,19,0,0,138
20,18,9,15,24,9,4,0,0,99
20,18,9,15,24,9,4,5,0,104
20,18,9,15,24,9,4,5,19,123
20,18,9,15,24,9,4,19,0,118
20,18,9,15,26,15,14,9,4,130
20,18,25,16,0,0,0,0,0,79
20,18,25,16,1,0,0,0,0,80
20,18,9,16,1,3,11,0,0,78
20,18,9,16,1,3,11,19,0,97
20,18,9,16,1,12,0,0,0,76
20,18,25,16,1,14,0,0,0,94
20,18,25,16,1,14,5,9,4,112
20,18,9,16,1,18,1,0,0,83
20,18,9,16,1,18,20,0,0,102
20,18,9,16,1,18,20,5,4,111
20,18,9,16,5,0,0,0,0,68
20,18,9,16,5,4,1,12,0,85
20,18,9,16,5,12,0,0,0,80
20,18,9,16,5,12,9,11,5,105
20,18,9,16,5,13,1,14,0,96
20,18,9,16,5,14,14,25,0,121
20,18,9,16,5,18,25,0,0,111
20,18,9,16,5,18,9,5,19,119
20,18,9,16,5,19,0,0,0,87
20,18,9,16,5,19,8,15,16,126
20,18,25,16,5,20,9,4,0,117
20,18,9,16,5,23,9,6,5,111
20,18,9,16,8,1,14,5,0,91
20,18,9,16,8,1,19,5,0,96
20,18,9,16,8,1,19,5,18,114
20,18,9,16,8,1,19,9,3,103
20,18,9,16,8,5,14,25,12,127
20,18,9,16,8,15,14,25,0,125
20,18,9,16,25,0,0,0,0,88
20,18,25,16,9,1,20,5,0,114
20,18,9,16,25,12,5,1,14,120
20,18,9,16,12,0,0,0,0,75
20,18,9,16,12,1,0,0,0,76
20,18,9,16,12,1,14,5,0,95
20,18,9,16,12,1,14,5,19,114
20,18,9,16,12,1,19,9,3,107
20,18,9,16,12,5,0,0,0,80
20,18,9,16,12,5,4,0,0,84
20,18,9,16,12,5,7,9,1,97
20,18,9,16,12,5,18,0,0,98
20,18,9,16,12,5,19,0,0,99
20,18,9,16,12,5,20,0,0,100
20,18,9,16,12,5,20,19,0,119
20,18,9,16,12,5,24,5,19,128
20,18,9,16,12,25,0,0,0,100
20,18,9,16,12,9,14,7,0,105
20,18,9,16,12,9,20,5,0,109
20,18,9,16,12,9,20,5,19,128
20,18,9,16,12,15,9,4,0,103
20,18,9,16,12,15,9,4,25,128
20,18,9,16,12,15,9,4,19,122
20,18,9,16,12,15,16,25,0,131
20,18,9,16,12,15,16,9,1,116
20,18,9,16,12,21,13,0,0,109
20,18,9,16,13,1,4,1,13,95
20,18,9,16,15,4,0,0,0,82
20,18,9,16,15,4,1,12,0,95
20,18,9,16,15,4,25,0,0,107
20,18,9,16,15,4,9,1,12,104
20,18,9,16,15,4,9,1,14,106
20,18,9,16,15,4,9,3,0,94
20,18,9,16,15,4,9,5,19,115
20,18,9,16,15,4,19,0,0,101
20,18,9,16,15,12,1,18,0,109
20,18,9,16,15,12,9,19,0,118
20,18,9,16,15,12,9,20,5,124
20,18,9,16,15,19,0,0,0,97
20,18,9,16,15,19,5,19,0,121
20,18,9,16,15,20,0,0,0,98
20,18,9,16,15,20,1,7,5,111
20,18,9,16,15,20,5,18,0,121
20,18,9,16,16,1,14,20,0,114
20,18,9,16,16,5,4,0,0,88
20,18,9,16,16,5,18,0,0,102
20,18,9,16,16,5,18,19,0,121
20,18,9,16,16,5,20,0,0,104
20,18,9,16,16,5,20,19,0,123
20,18,9,16,16,9,14,7,0,109
20,18,9,16,16,9,14,7,19,128
20,18,9,16,16,9,19,20,0,127
20,18,9,16,16,12,5,0,0,96
20,18,9,16,16,12,5,18,0,114
20,18,9,16,19,0,0,0,0,82
20,18,9,16,19,9,12,12,0,115
20,18,25,16,19,9,14,0,0,121
20,18,25,16,19,9,14,19,0,140
20,18,9,16,19,9,19,0,0,110
20,18,9,16,19,15,13,5,0,115
20,18,9,16,20,0,0,0,0,83
20,18,9,16,20,1,14,5,0,103
20,18,9,16,20,1,14,5,19,122
20,18,25,16,20,1,19,5,0,124
20,18,25,16,20,9,3,0,0,111
20,18,9,16,20,25,3,1,0,112
20,18,9,16,20,25,3,1,19,131
20,18,9,16,20,25,3,8,0,119
20,18,9,16,20,25,3,8,19,138
20,18,9,16,20,25,17,21,5,151
20,18,25,16,20,15,7,5,14,140
20,18,25,16,20,15,14,5,0,133
20,18,9,16,20,15,20,5,0,123
20,18,9,16,21,4,9,1,0,98
20,18,9,16,21,4,9,1,12,110
20,18,9,16,21,4,9,19,20,136
20,18,9,16,21,4,9,21,13,131
20,18,9,16,23,9,18,5,0,118
20,18,9,17,21,5,20,0,0,110
20,18,9,17,21,5,20,18,1,129
20,18,9,18,1,4,9,1,12,92
20,18,9,18,1,4,9,9,0,88
20,18,9,18,1,4,9,21,19,119
20,18,9,18,5,7,14,21,13,125
20,18,9,18,5,13,5,0,0,88
20,18,9,18,5,13,5,19,0,107
20,18,25,19,1,9,12,0,0,104
20,18,25,19,1,9,12,19,0,123
20,18,9,19,1,12,20,0,0,99
20,18,9,19,1,26,15,0,0,108
20,18,9,19,3,5,12,5,0,91
20,18,9,19,3,5,12,5,19,110
20,18,9,19,5,3,20,0,0,94
20,18,9,19,5,3,20,5,4,103
20,18,9,19,5,3,20,15,18,127
20,18,9,19,5,3,20,19,0,113
20,18,9,19,5,13,5,0,0,89
20,18,9,19,5,13,5,19,0,108
20,18,9,19,5,13,9,3,0,96
20,18,9,19,5,18,9,1,12,111
20,18,9,19,5,20,15,19,5,130
20,18,9,19,8,1,23,0,0,98
20,18,9,19,8,14,1,0,0,89
20,18,9,19,9,12,1,14,5,107
20,18,9,19,11,5,12,5,0,99
20,18,9,19,11,5,12,5,19,118
20,18,9,19,11,5,12,9,1,104
20,18,9,19,13,9,3,0,0,91
20,18,9,19,13,21,19,0,0,119
20,18,9,19,13,21,19,5,19,143
20,18,9,19,15,4,9,21,13,128
20,18,9,19,15,13,5,0,0,99
20,18,9,19,15,13,5,19,0,118
20,18,9,19,15,13,25,0,0,119
20,18,9,19,15,13,9,3,0,106
20,18,9,19,15,13,9,3,19,125
20,18,9,19,15,13,9,5,19,127
20,18,9,19,15,14,1,14,20,130
20,18,9,19,16,1,19,20,0,122
20,18,9,19,16,15,18,9,3,127
20,18,9,19,17,21,1,18,5,128
20,18,9,19,20,0,0,0,0,86
20,18,25,19,20,0,0,0,0,102
20,18,9,19,20,1,20,5,0,112
20,18,9,19,20,5,0,0,0,91
20,18,25,19,20,5,0,0,0,107
20,18,25,19,20,5,4,0,0,111
20,18,25,19,20,5,18,0,0,125
20,18,25,19,20,5,18,19,0,144
20,18,25,19,20,5,19,0,0,126
20,18,9,19,20,5,19,19,5,134
20,18,9,19,20,5,26,1,0,118
20,18,9,19,20,5,26,1,19,137
20,18,9,19,20,6,21,12,0,125
20,18,9,19,20,9,3,8,0,106
20,18,9,19,20,9,3,8,19,125
20,18,9,19,20,25,12,25,0,148
20,18,25,19,20,9,14,7,0,132
20,18,9,19,20,9,22,5,0,122
20,18,25,19,20,19,0,0,0,121
20,18,9,19,21,12,0,0,0,99
20,18,9,19,21,12,1,0,0,100
20,18,9,19,21,12,3,0,0,102
20,18,9,19,21,12,6,9,4,118
20,18,9,20,0,0,0,0,0,67
20,18,25,20,0,0,0,0,0,83
20,18,9,20,1,3,20,9,3,103
20,18,9,20,1,14,15,16,5,118
20,18,9,20,1,16,8,0,0,92
20,18,9,20,5,0,0,0,0,72
20,18,9,20,5,12,25,0,0,109
20,18,9,20,5,14,5,19,19,129
20,18,9,20,5,18,0,0,0,90
20,18,9,20,5,19,20,0,0,111
20,18,9,20,8,5,9,19,13,121
20,18,9,20,8,5,9,19,20,128
20,18,9,20,8,5,9,20,5,114
20,18,9,20,8,9,14,7,0,105
20,18,9,20,8,9,14,7,19,124
20,18,9,20,9,1,20,5,0,102
20,18,9,20,9,1,20,5,4,106
20,18,9,20,9,3,1,12,0,92
20,18,9,20,9,3,1,12,5,97
20,18,9,20,9,3,5,21,13,118
20,18,9,20,9,3,9,14,0,102
20,18,9,20,9,3,9,19,13,120
20,18,9,20,9,3,15,9,4,107
20,18,9,20,9,3,21,13,19,132
20,18,9,20,25,12,0,0,0,104
20,18,9,20,9,19,8,0,0,103
20,18,9,20,9,21,13,0,0,110
20,18,9,20,9,21,13,19,0,129
20,18,9,20,15,3,15,14,5,119
20,18,9,20,15,12,15,0,0,109
20,18,9,20,15,13,1,19,0,115
20,18,9,20,15,13,9,20,5,129
20,18,9,20,15,14,1,12,0,109
20,18,9,20,15,14,5,0,0,101
20,18,9,20,15,14,5,19,0,120
20,18,9,20,15,14,15,9,4,124
20,18,9,20,15,14,15,21,19,151
20,18,9,20,15,14,19,0,0,115
20,18,25,20,15,16,8,1,14,137
20,18,9,20,15,16,9,14,5,126
20,18,9,20,15,18,0,0,0,100
20,18,9,20,15,18,1,12,0,113
20,18,9,20,15,18,9,21,13,143
20,18,9,20,15,24,9,4,5,124
20,18,9,20,21,18,1,12,0,119
20,18,9,20,21,18,1,20,5,132
20,18,9,20,21,18,5,0,0,111
20,18,9,20,21,18,9,21,13,149
20,18,9,21,13,6,0,0,0,87
20,18,9,21,13,16,8,1,12,118
20,18,9,21,13,16,8,5,4,114
20,18,9,21,13,16,8,5,18,128
20,18,9,21,13,16,8,19,0,124
20,18,9,21,13,22,9,18,0,130
20,18,9,21,13,22,9,18,9,139
20,18,9,21,13,22,9,18,25,155
20,18,9,21,13,22,9,18,19,149
20,18,9,21,14,1,12,0,0,95
20,18,9,21,14,5,19,0,0,106
20,18,9,21,14,9,15,14,0,120
20,18,9,21,18,9,4,0,0,99
20,18,9,22,1,12,5,14,20,121
20,18,9,22,1,12,22,5,0,109
20,18,9,22,1,12,22,5,19,128
20,18,9,22,1,14,20,0,0,104
20,18,9,22,1,14,20,12,25,141
20,18,9,22,1,20,0,0,0,90
20,18,9,22,5,18,2,1,12,107
20,18,9,22,5,20,0,0,0,94
20,18,9,22,5,20,19,0,0,113
20,18,9,22,5,20,20,5,0,119
20,18,9,22,9,1,0,0,0,79
20,18,9,22,9,1,12,0,0,91
20,18,9,22,9,1,12,12,25,128
20,18,9,22,9,18,7,1,0,104
20,18,9,22,9,21,13,0,0,112
20,18,9,22,22,5,20,0,0,116
20,18,9,23,5,5,11,12,25,128
20,18,9,23,5,20,0,0,0,95
20,18,25,23,15,18,11,19,0,149
20,18,9,24,0,0,0,0,0,71
20,18,9,26,15,9,3,0,0,100
20,18,9,26,15,13,1,12,0,114
20,18,9,26,15,14,1,12,0,115
20,18,9,26,15,14,5,0,0,107
20,18,15,1,11,0,0,0,0,65
20,18,15,1,11,5,4,0,0,74
20,18,15,1,11,9,14,7,0,95
20,18,15,1,11,19,0,0,0,84
20,18,15,1,20,0,0,0,0,74
20,18,15,2,1,4,15,18,0,93
20,18,15,3,1,0,0,0,0,57
20,18,15,3,1,9,3,1,12,82
20,18,15,3,1,18,0,0,0,75
20,18,15,3,1,18,19,0,0,94
20,18,15,3,8,0,0,0,0,64
20,18,15,3,8,1,0,0,0,65
20,18,15,3,8,1,9,3,19,96
20,18,15,3,8,1,12,0,0,77
20,18,15,3,8,1,18,0,0,83
20,18,15,3,8,1,18,19,0,102
20,18,15,3,8,1,18,20,0,103
20,18,15,3,8,1,20,5,0,90
20,18,15,3,8,5,0,0,0,69
20,18,15,3,8,5,4,0,0,73
20,18,15,3,8,5,5,0,0,74
20,18,15,3,8,5,5,19,0,93
20,18,15,3,8,5,19,0,0,88
20,18,15,3,8,5,21,19,0,109
20,18,15,3,8,9,0,0,0,73
20,18,15,3,8,9,4,0,0,77
20,18,15,3,8,9,12,0,0,85
20,18,15,3,8,9,12,9,3,97
20,18,15,3,8,9,12,15,19,119
20,18,15,3,8,9,12,19,0,104
20,18,15,3,8,9,14,7,0,94
20,18,15,3,8,9,19,3,9,104
20,18,15,3,8,9,19,11,0,103
20,18,15,3,8,9,20,5,0,98
20,18,15,3,8,9,20,9,3,105
20,18,15,3,8,12,5,1,0,82
20,18,15,3,8,12,5,1,5,87
20,18,15,3,8,12,5,1,18,100
20,18,15,3,8,12,5,1,19,101
20,18,15,3,8,15,9,4,0,92
20,18,15,3,8,15,9,4,19,111
20,18,15,3,11,0,0,0,0,67
20,18,15,3,11,5,4,0,0,76
20,18,15,3,11,5,18,25,0,115
20,18,15,3,11,9,14,7,0,97
20,18,15,3,11,19,0,0,0,86
20,18,15,3,15,0,0,0,0,71
20,18,15,4,0,0,0,0,0,57
20,18,15,4,4,5,14,0,0,80
20,18,15,4,5,0,0,0,0,62
20,18,15,6,6,5,18,0,0,88
20,18,15,6,6,5,18,19,0,107
20,18,15,6,20,0,0,0,0,79
20,18,15,7,0,0,0,0,0,60
20,18,15,7,5,18,9,20,5,117
20,18,15,7,7,5,18,0,0,90
20,18,15,7,7,9,14,0,0,90
20,18,15,7,7,19,0,0,0,86
20,18,15,7,15,14,0,0,0,89
20,18,15,7,15,14,15,9,4,117
20,18,15,7,15,14,19,0,0,108
20,18,15,7,19,0,0,0,0,79
20,18,15,7,21,5,0,0,0,86
20,18,15,9,11,1,0,0,0,74
20,18,15,9,11,1,19,0,0,93
20,18,15,9,12,9,19,13,0,115
20,18,15,9,12,9,20,5,0,108
20,18,15,9,12,9,20,5,19,127
20,18,15,9,12,21,19,5,19,138
20,18,15,9,19,0,0,0,0,81
20,18,15,25,19,0,0,0,0,97
20,18,15,10,1,14,19,0,0,97
20,18,15,11,5,0,0,0,0,69
20,18,15,11,5,4,0,0,0,73
20,18,15,11,5,18,0,0,0,87
20,18,15,11,5,19,0,0,0,88
20,18,15,11,9,14,7,0,0,94
20,18,15,12,1,14,4,0,0,84
20,18,15,12,1,14,4,19,0,103
20,18,15,12,12,0,0,0,0,77
20,18,15,12,12,4,15,13,0,109
20,18,15,12,12,5,4,0,0,86
20,18,15,12,12,5,25,0,0,107
20,18,15,12,12,5,25,5,4,116
20,18,15,12,12,5,25,5,18,130
20,18,15,12,12,5,25,19,0,126
20,18,15,12,12,5,9,20,5,116
20,18,15,12,12,5,18,0,0,100
20,18,15,12,12,5,18,19,0,119
20,18,15,12,12,25,0,0,0,102
20,18,15,12,12,9,5,4,0,95
20,18,15,12,12,9,5,19,0,110
20,18,15,12,12,25,9,14,7,132
20,18,15,12,12,25,13,1,14,130
20,18,15,12,12,25,13,5,14,134
20,18,15,12,12,9,13,15,7,121
20,18,15,12,12,9,14,7,0,107
20,18,15,12,12,9,14,7,19,126
20,18,15,12,12,13,1,14,0,105
20,18,15,12,12,13,5,14,0,109
20,18,15,12,12,15,12,0,0,104
20,18,15,12,12,15,16,0,0,108
20,18,15,12,12,15,16,25,0,133
20,18,15,12,12,15,16,19,0,127
20,18,15,12,12,19,0,0,0,96
20,18,15,13,2,1,0,0,0,69
20,18,15,13,2,1,19,8,0,96
20,18,15,13,2,5,0,0,0,73
20,18,15,13,2,15,14,5,0,102
20,18,15,13,2,15,14,5,19,121
20,18,15,13,2,15,14,25,0,122
20,18,15,13,13,5,12,0,0,96
20,18,15,13,13,5,12,19,0,115
20,18,15,13,16,5,0,0,0,87
20,18,15,13,16,5,4,0,0,91
20,18,15,13,16,5,19,0,0,106
20,18,15,13,16,9,12,0,0,103
20,18,15,13,16,9,12,12,15,130
20,18,15,13,16,9,14,7,0,112
20,18,15,13,16,12,5,0,0,99
20,18,15,13,16,19,0,0,0,101
20,18,15,14,0,0,0,0,0,67
20,18,15,14,1,4,15,18,0,105
20,18,15,14,1,7,5,0,0,80
20,18,15,14,1,19,0,0,0,87
20,18,15,14,3,0,0,0,0,70
20,18,15,14,5,0,0,0,0,72
20,18,15,14,5,18,0,0,0,90
20,18,15,14,5,19,0,0,0,91
20,18,15,14,11,0,0,0,0,78
20,18,15,15,4,15,14,20,0,121
20,18,15,15,12,25,0,0,0,105
20,18,15,15,12,9,5,0,0,94
20,18,15,15,16,0,0,0,0,84
20,18,15,15,16,5,4,0,0,93
20,18,15,15,16,5,18,0,0,107
20,18,15,15,16,5,18,19,0,126
20,18,15,15,16,6,15,23,12,140
20,18,15,15,16,9,1,12,0,106
20,18,15,15,16,9,1,12,19,125
20,18,15,15,16,9,14,7,0,114
20,18,15,15,16,19,0,0,0,103
20,18,15,15,16,19,8,9,16,136
20,18,15,15,16,23,9,19,5,140
20,18,15,15,19,20,9,20,5,141
20,18,15,15,20,0,0,0,0,88
20,18,15,15,26,0,0,0,0,94
20,18,15,16,0,0,0,0,0,69
20,18,15,16,1,5,15,12,1,103
20,18,15,16,1,5,15,12,9,111
20,18,15,16,1,9,1,0,0,80
20,18,15,16,1,9,15,14,0,108
20,18,15,16,1,12,0,0,0,82
20,18,15,16,1,18,25,0,0,113
20,18,15,16,1,18,9,1,0,98
20,18,15,16,1,18,9,15,14,126
20,18,15,16,1,20,5,0,0,95
20,18,15,16,5,0,0,0,0,74
20,18,15,16,5,9,3,0,0,86
20,18,15,16,5,9,14,0,0,97
20,18,15,16,5,9,14,5,0,102
20,18,15,16,5,18,0,0,0,92
20,18,15,16,5,19,0,0,0,93
20,18,15,16,5,19,9,19,0,121
20,18,15,16,8,1,5,1,0,84
20,18,15,16,8,1,5,21,13,117
20,18,15,16,8,1,12,0,0,90
20,18,15,16,8,5,13,1,0,96
20,18,15,16,8,5,19,25,0,126
20,18,15,16,8,9,0,0,0,86
20,18,15,16,8,25,0,0,0,102
20,18,15,16,8,9,3,0,0,89
20,18,15,16,8,9,3,1,12,102
20,18,15,16,8,9,5,4,0,95
20,18,15,16,8,9,5,19,0,110
20,18,15,16,8,25,9,14,7,132
20,18,15,16,8,9,19,13,0,118
20,18,15,16,8,15,14,0,0,106
20,18,15,16,25,0,0,0,0,94
20,18,15,16,9,1,0,0,0,79
20,18,15,16,9,3,0,0,0,81
20,18,15,16,9,3,1,12,0,94
20,18,15,16,9,3,19,0,0,100
20,18,15,16,9,4,9,14,5,110
20,18,15,16,25,12,0,0,0,106
20,18,15,16,9,14,0,0,0,92
20,18,15,16,9,14,5,0,0,97
20,18,15,16,9,14,5,19,0,116
20,18,15,16,9,14,19,0,0,111
20,18,15,16,9,19,13,0,0,110
20,18,15,16,9,19,13,19,0,129
20,18,15,16,9,19,20,0,0,117
20,18,15,16,9,19,20,9,3,129
20,18,15,16,15,25,12,0,0,121
20,18,15,16,15,12,15,7,25,143
20,18,15,16,15,14,9,14,0,121
20,18,15,16,15,16,8,9,12,129
20,18,15,16,15,21,19,0,0,124
20,18,15,16,16,1,9,1,0,96
20,18,15,16,16,15,0,0,0,100
20,18,15,19,20,5,18,1,0,116
20,18,15,20,3,15,26,25,0,142
20,18,15,20,8,5,4,0,0,90
20,18,15,20,8,6,21,12,0,120
20,18,15,20,8,9,14,7,0,111
20,18,15,20,8,12,5,19,19,136
20,18,15,20,8,12,9,11,5,118
20,18,15,20,8,19,0,0,0,100
20,18,15,20,25,12,0,0,0,110
20,18,15,20,25,12,19,0,0,129
20,18,15,20,12,5,20,0,0,110
20,18,15,20,12,9,14,5,0,113
20,18,15,20,12,9,14,5,19,132
20,18,15,20,15,12,0,0,0,100
20,18,15,20,19,0,0,0,0,92
20,18,15,20,20,5,4,0,0,102
20,18,15,20,20,5,21,18,0,137
20,18,15,20,20,25,0,0,0,118
20,18,15,20,20,9,5,0,0,107
20,18,15,20,20,9,14,7,0,123
20,18,15,20,20,12,5,19,0,129
20,18,15,20,20,15,9,18,0,135
20,18,15,21,2,1,4,15,18,114
20,18,15,21,2,12,5,0,0,93
20,18,15,21,2,12,5,4,0,97
20,18,15,21,2,12,5,18,0,111
20,18,15,21,2,12,5,18,19,130
20,18,15,21,2,12,5,19,0,112
20,18,15,21,2,12,25,0,0,113
20,18,15,21,2,12,9,14,7,118
20,18,15,21,2,12,15,21,19,143
20,18,15,21,5,0,0,0,0,79
20,18,15,21,7,8,0,0,0,89
20,18,15,21,7,8,5,4,0,98
20,18,15,21,7,8,6,21,12,128
20,18,15,21,7,8,25,0,0,114
20,18,15,21,7,8,9,14,7,119
20,18,15,21,7,8,19,0,0,108
20,18,15,21,7,8,23,1,25,138
20,18,15,21,14,3,5,0,0,96
20,18,15,21,14,3,5,4,0,100
20,18,15,21,14,3,5,18,0,114
20,18,15,21,14,3,5,18,19,133
20,18,15,21,14,3,5,19,0,115
20,18,15,21,14,3,9,14,7,121
20,18,15,21,16,1,14,4,0,109
20,18,15,21,16,5,0,0,0,95
20,18,15,21,16,5,4,0,0,99
20,18,15,21,16,5,18,0,0,113
20,18,15,21,16,5,18,19,0,132
20,18,15,21,16,5,19,0,0,114
20,18,15,21,16,9,1,12,0,112
20,18,15,21,16,9,1,12,19,131
20,18,15,21,16,9,14,7,0,120
20,18,15,21,19,5,0,0,0,98
20,18,15,21,19,5,18,0,0,116
20,18,15,21,19,5,18,5,4,125
20,18,15,21,19,5,18,19,0,135
20,18,15,21,19,19,0,0,0,112
20,18,15,21,19,19,5,0,0,117
20,18,15,21,19,19,5,1,21,139
20,18,15,21,20,2,9,18,4,127
20,18,15,21,20,5,18,0,0,117
20,18,15,21,20,6,21,12,0,133
20,18,15,21,20,25,0,0,0,119
20,18,15,21,20,9,5,18,0,126
20,18,15,21,20,9,5,19,20,147
20,18,15,21,20,12,5,19,19,149
20,18,15,21,20,12,5,20,0,131
20,18,15,21,20,12,9,11,5,131
20,18,15,21,20,12,9,14,7,136
20,18,15,21,20,19,0,0,0,113
20,18,15,21,22,0,0,0,0,96
20,18,15,21,22,5,18,5,0,124
20,18,15,21,22,5,18,5,19,143
20,18,15,21,22,5,21,18,0,140
20,18,15,21,22,5,21,18,19,159
20,18,15,21,22,18,5,0,0,119
20,18,15,22,1,20,15,18,5,134
20,18,15,22,5,0,0,0,0,80
20,18,15,22,5,12,5,19,19,135
20,18,15,22,5,18,0,0,0,98
20,18,15,22,5,18,19,0,0,117
20,18,15,22,5,19,0,0,0,99
20,18,15,23,1,2,12,5,0,96
20,18,15,23,1,14,5,0,0,96
20,18,15,23,5,4,0,0,0,85
20,18,15,23,5,12,0,0,0,93
20,18,15,23,5,12,5,4,0,102
20,18,15,23,5,12,5,18,0,116
20,18,15,23,5,12,5,18,19,135
20,18,15,23,5,12,6,21,12,132
20,18,15,23,5,12,9,14,7,123
20,18,15,23,5,12,12,5,4,114
20,18,15,23,5,12,12,5,18,128
20,18,15,23,5,12,13,1,14,121
20,18,15,23,5,12,19,0,0,112
20,18,15,23,9,5,0,0,0,90
20,18,15,23,9,14,7,0,0,106
20,18,15,23,13,1,14,0,0,104
20,18,15,23,19,0,0,0,0,95
20,18,15,23,19,5,18,19,0,137
20,18,15,23,20,8,0,0,0,104
20,18,15,23,20,8,19,0,0,123
20,18,16,0,0,0,0,0,0,54
20,18,16,19,5,20,0,0,0,98
20,18,19,0,0,0,0,0,0,57
20,18,20,0,0,0,0,0,0,58
20,18,21,1,14,3,25,0,0,102
20,18,21,1,14,3,9,5,19,110
20,18,21,1,14,4,9,19,5,111
20,18,21,1,14,20,0,0,0,94
20,18,21,1,14,20,3,25,0,122
20,18,21,1,14,20,5,4,0,103
20,18,21,1,14,20,9,14,7,124
20,18,21,1,14,20,9,19,13,135
20,18,21,1,14,20,12,25,0,131
20,18,21,1,14,20,18,25,0,137
20,18,21,1,14,20,19,0,0,113
20,18,21,2,0,0,0,0,0,61
20,18,21,2,21,0,0,0,0,82
20,18,21,3,5,0,0,0,0,67
20,18,21,3,5,4,0,0,0,71
20,18,21,3,5,12,5,19,19,122
20,18,21,3,5,19,0,0,0,86
20,18,21,3,8,1,0,0,0,71
20,18,21,3,8,13,1,14,0,98
20,18,21,3,9,1,12,0,0,84
20,18,21,3,9,14,7,0,0,92
20,18,21,3,11,0,0,0,0,73
20,18,21,3,11,1,7,5,0,86
20,18,21,3,11,1,7,5,19,105
20,18,21,3,11,5,4,0,0,82
20,18,21,3,11,5,18,0,0,96
20,18,21,3,11,5,18,19,0,115
20,18,21,3,11,6,21,12,0,112
20,18,21,3,11,9,5,0,0,87
20,18,21,3,11,9,14,7,0,103
20,18,21,3,11,9,14,7,19,122
20,18,21,3,11,12,5,0,0,90
20,18,21,3,11,12,5,4,0,94
20,18,21,3,11,12,5,18,0,108
20,18,21,3,11,12,5,18,19,127
20,18,21,3,11,12,9,11,5,110
20,18,21,3,11,12,9,14,5,113
20,18,21,3,11,12,9,14,7,115
20,18,21,3,11,12,15,1,4,105
20,18,21,3,11,13,1,14,0,101
20,18,21,3,11,13,5,14,0,105
20,18,21,3,11,19,0,0,0,92
20,18,21,3,11,19,20,5,18,135
20,18,21,3,11,23,1,25,0,122
20,18,21,3,21,12,5,14,20,134
20,18,21,4,4,15,0,0,0,82
20,18,21,4,7,5,0,0,0,75
20,18,21,4,7,5,4,0,0,79
20,18,21,4,7,5,14,0,0,89
20,18,21,4,7,5,14,19,0,108
20,18,21,4,7,5,15,14,0,104
20,18,21,4,7,5,15,14,19,123
20,18,21,4,7,5,18,0,0,93
20,18,21,4,7,5,18,19,0,112
20,18,21,4,7,5,19,0,0,94
20,18,21,4,7,9,14,7,0,100
20,18,21,5,2,12,21,5,0,104
20,18,21,5,2,12,21,5,19,123
20,18,21,5,2,15,18,14,0,113
20,18,21,5,2,18,5,4,0,93
20,18,21,5,4,0,0,0,0,68
20,18,21,5,9,14,7,0,0,94
20,18,21,5,12,9,11,5,0,101
20,18,21,5,12,15,22,5,19,137
20,18,21,5,14,5,19,19,0,121
20,18,21,5,16,5,14,14,25,138
20,18,21,5,18,0,0,0,0,82
20,18,21,5,19,0,0,0,0,83
20,18,21,5,19,20,0,0,0,103
20,18,21,5,23,15,15,4,0,121
20,18,21,6,6,0,0,0,0,71
20,18,21,6,6,5,0,0,0,76
20,18,21,6,6,5,19,0,0,95
20,18,21,6,6,12,5,0,0,88
20,18,21,6,6,12,5,4,0,92
20,18,21,6,6,12,5,18,0,106
20,18,21,6,6,12,5,19,0,107
20,18,21,7,0,0,0,0,0,66
20,18,21,7,19,0,0,0,0,85
20,18,21,9,14,7,0,0,0,89
20,18,21,9,19,8,0,0,0,95
20,18,21,9,19,13,0,0,0,100
20,18,21,9,19,13,19,0,0,119
20,18,21,9,19,20,9,3,0,119
20,18,21,12,25,0,0,0,0,96
20,18,21,12,12,0,0,0,0,83
20,18,21,12,12,5,18,0,0,106
20,18,21,12,12,9,0,0,0,92
20,18,21,12,12,15,0,0,0,98
20,18,21,12,12,19,0,0,0,102
20,18,21,13,2,1,19,8,0,102
20,18,21,13,5,1,21,0,0,99
20,18,21,13,5,1,21,24,0,123
20,18,21,13,13,5,12,0,0,102
20,18,21,13,16,0,0,0,0,88
20,18,21,13,16,5,4,0,0,97
20,18,21,13,16,5,18,0,0,111
20,18,21,13,16,5,18,25,0,136
20,18,21,13,16,5,20,0,0,113
20,18,21,13,16,5,20,5,4,122
20,18,21,13,16,5,20,5,18,136
20,18,21,13,16,5,20,25,0,138
20,18,21,13,16,5,20,18,25,156
20,18,21,13,16,5,20,19,0,132
20,18,21,13,16,8,0,0,0,96
20,18,21,13,16,9,5,0,0,102
20,18,21,13,16,9,14,7,0,118
20,18,21,13,16,12,5,19,19,143
20,18,21,13,16,12,9,11,5,125
20,18,21,13,16,19,0,0,0,107
20,18,21,14,0,0,0,0,0,73
20,18,21,14,3,1,7,5,0,89
20,18,21,14,3,1,12,0,0,89
20,18,21,14,3,1,20,5,0,102
20,18,21,14,3,1,20,5,4,106
20,18,21,14,3,1,20,5,19,121
20,18,21,14,3,1,20,15,18,130
20,18,21,14,3,8,0,0,0,84
20,18,21,14,3,8,5,4,0,93
20,18,21,14,3,8,5,15,14,118
20,18,21,14,3,8,5,18,0,107
20,18,21,14,3,8,13,1,14,112
20,18,21,14,3,21,19,0,0,116
20,18,21,14,4,12,5,0,0,94
20,18,21,14,4,12,5,4,0,98
20,18,21,14,4,12,5,18,0,112
20,18,21,14,4,12,5,18,19,131
20,18,21,14,4,12,5,19,0,113
20,18,21,14,4,12,9,14,7,119
20,18,21,14,11,0,0,0,0,84
20,18,21,14,11,2,1,3,11,101
20,18,21,14,11,5,4,0,0,93
20,18,21,14,11,6,9,19,8,126
20,18,21,14,11,6,21,12,0,123
20,18,21,14,11,6,21,12,19,142
20,18,21,14,11,9,14,7,0,114
20,18,21,14,11,12,5,19,19,139
20,18,21,14,11,14,15,19,5,137
20,18,21,14,11,19,0,0,0,103
20,18,21,14,11,23,1,25,0,133
20,18,21,14,11,23,15,18,11,151
20,18,21,14,14,5,12,0,0,104
20,18,21,14,14,5,12,19,0,123
20,18,21,14,14,9,15,14,0,125
20,18,21,14,14,9,15,14,19,144
20,18,21,15,14,7,0,0,0,95
20,18,21,19,8,0,0,0,0,86
20,18,21,19,9,15,14,0,0,116
20,18,21,19,19,0,0,0,0,97
20,18,21,19,19,5,4,0,0,106
20,18,21,19,19,5,12,12,0,126
20,18,21,19,19,5,18,0,0,120
20,18,21,19,19,5,18,25,0,145
20,18,21,19,19,5,18,19,0,139
20,18,21,19,19,5,19,0,0,121
20,18,21,19,19,9,14,7,0,127
20,18,21,19,19,9,14,7,19,146
20,18,21,19,19,23,15,18,11,164
20,18,21,19,20,1,2,12,5,118
20,18,21,19,20,1,2,12,25,138
20,18,21,19,20,5,4,0,0,107
20,18,21,19,20,5,5,0,0,108
20,18,21,19,20,5,5,4,0,112
20,18,21,19,20,5,5,19,0,127
20,18,21,19,20,5,9,14,7,133
20,18,21,19,20,5,14,0,0,117
20,18,21,19,20,5,18,0,0,121
20,18,21,19,20,5,18,19,0,140
20,18,21,19,20,6,21,12,0,137
20,18,21,19,20,25,0,0,0,123
20,18,21,19,20,9,5,18,0,130
20,18,21,19,20,9,5,19,0,131
20,18,21,19,20,9,5,19,20,151
20,18,21,19,20,9,6,25,0,138
20,18,21,19,20,9,12,25,0,144
20,18,21,19,20,9,14,7,0,128
20,18,21,19,20,12,5,0,0,115
20,18,21,19,20,12,5,19,19,153
20,18,21,19,20,13,1,14,0,126
20,18,21,19,20,13,5,14,0,130
20,18,21,19,20,15,18,0,0,131
20,18,21,19,20,15,18,19,0,150
20,18,21,19,20,19,0,0,0,117
20,18,21,20,8,1,2,12,5,107
20,18,21,20,8,6,21,12,0,126
20,18,21,20,8,25,0,0,0,112
20,18,21,20,8,9,6,25,0,127
20,18,21,20,8,12,5,19,19,142
20,18,21,20,8,12,9,11,5,124
20,18,21,20,8,19,0,0,0,106
20,18,21,20,8,19,13,1,14,134
20,18,21,20,9,14,1,20,5,128
20,18,21,20,9,14,5,0,0,107
20,18,21,22,1,20,0,0,0,102
20,18,21,24,9,12,12,9,3,128
20,18,21,24,9,12,12,9,14,139
20,19,3,8,1,18,9,11,0,89
20,19,5,18,5,0,0,0,0,67
20,19,5,19,19,5,2,5,0,94
20,19,5,20,19,5,0,0,0,88
20,19,5,20,19,5,19,0,0,107
20,19,9,1,0,0,0,0,0,49
20,19,9,13,13,5,19,0,0,98
20,19,9,14,5,0,0,0,0,67
20,19,9,15,12,15,7,25,0,122
20,19,9,20,19,9,20,8,0,124
20,19,11,0,0,0,0,0,0,50
20,19,11,5,4,0,0,0,0,59
20,19,11,9,14,7,0,0,0,80
20,19,11,19,0,0,0,0,0,69
20,19,11,20,19,11,0,0,0,100
20,19,11,20,19,11,5,4,0,109
20,19,11,20,19,11,9,14,7,130
20,19,11,20,19,11,19,0,0,119
20,19,15,15,18,9,19,0,0,115
20,19,15,18,5,19,0,0,0,96
20,19,15,18,9,19,0,0,0,100
20,19,15,18,18,9,19,19,0,137
20,19,15,20,19,9,0,0,0,102
20,19,21,2,1,0,0,0,0,63
20,19,21,2,15,0,0,0,0,77
20,19,21,11,21,16,9,14,0,131
20,19,21,13,5,2,9,20,5,114
20,19,21,14,0,0,0,0,0,74
20,19,21,14,1,13,9,0,0,97
20,19,21,14,1,13,9,3,0,100
20,19,21,14,1,13,9,19,0,116
20,19,21,14,7,20,21,0,0,122
20,19,21,18,5,19,0,0,0,102
20,19,21,18,9,19,0,0,0,106
20,19,21,18,21,7,9,0,0,115
20,21,2,0,0,0,0,0,0,43
20,21,2,1,5,0,0,0,0,49
20,21,2,1,7,5,0,0,0,56
20,21,2,1,9,19,20,0,0,92
20,21,2,1,9,19,20,19,0,111
20,21,2,1,12,0,0,0,0,56
20,21,2,1,16,8,15,14,5,102
20,21,2,1,18,0,0,0,0,62
20,21,2,1,18,15,14,0,0,91
20,21,2,1,19,0,0,0,0,63
20,21,2,1,20,5,0,0,0,69
20,21,2,1,20,15,24,9,14,126
20,21,2,2,1,0,0,0,0,46
20,21,2,2,1,2,12,5,0,65
20,21,2,2,1,12,0,0,0,58
20,21,2,2,5,3,11,0,0,64
20,21,2,2,5,4,0,0,0,54
20,21,2,2,5,18,0,0,0,68
20,21,2,2,5,18,19,0,0,87
20,21,2,2,25,0,0,0,0,70
20,21,2,2,9,5,0,0,0,59
20,21,2,2,9,5,18,0,0,77
20,21,2,2,9,5,19,20,0,98
20,21,2,2,9,14,5,19,19,111
20,21,2,2,9,14,7,0,0,75
20,21,2,2,9,19,8,0,0,81
20,21,2,2,9,19,20,0,0,93
20,21,2,2,15,5,0,0,0,65
20,21,2,5,0,0,0,0,0,48
20,21,2,5,3,20,15,13,25,124
20,21,2,5,4,0,0,0,0,52
20,21,2,5,6,15,18,13,0,100
20,21,2,5,6,21,12,0,0,87
20,21,2,5,8,5,1,4,0,66
20,21,2,5,12,5,19,19,0,103
20,21,2,5,12,5,20,0,0,85
20,21,2,5,12,9,11,5,0,85
20,21,2,5,13,1,11,5,18,96
20,21,2,5,13,1,14,0,0,76
20,21,2,5,13,5,14,0,0,80
20,21,2,5,14,15,19,5,0,101
20,21,2,5,18,0,0,0,0,66
20,21,2,5,18,3,12,5,0,86
20,21,2,5,18,3,12,5,4,90
20,21,2,5,18,3,12,5,19,105
20,21,2,5,18,3,21,12,1,103
20,21,2,5,18,3,21,12,5,107
20,21,2,5,18,9,14,0,0,89
20,21,2,5,18,9,26,5,0,106
20,21,2,5,18,12,5,19,19,121
20,21,2,5,18,15,9,4,0,94
20,21,2,5,18,15,19,5,0,105
20,21,2,5,18,15,19,5,19,124
20,21,2,5,18,15,21,19,0,121
20,21,2,5,18,19,0,0,0,85
20,21,2,5,19,0,0,0,0,67
20,21,2,5,19,13,9,20,8,117
20,21,2,5,19,14,15,21,20,137
20,21,2,5,23,15,18,11,0,115
20,21,2,5,23,15,18,11,19,134
20,21,2,6,9,19,8,0,0,85
20,21,2,6,9,19,8,5,19,109
20,21,2,6,21,12,0,0,0,82
20,21,2,6,21,12,19,0,0,101
20,21,2,8,21,14,20,5,18,129
20,21,2,9,3,5,14,0,0,74
20,21,2,9,3,15,12,1,18,101
20,21,2,9,3,15,18,14,0,102
20,21,2,9,6,5,18,0,0,81
20,21,2,9,6,5,24,5,19,111
20,21,2,9,6,9,3,9,4,83
20,21,2,9,6,15,18,13,0,104
20,21,2,9,7,0,0,0,0,59
20,21,2,9,11,0,0,0,0,63
20,21,2,9,14,7,0,0,0,73
20,21,2,9,14,7,19,0,0,92
20,21,2,9,16,15,18,5,0,106
20,21,2,9,16,15,18,9,4,114
20,21,2,9,19,20,0,0,0,91
20,21,2,9,19,20,19,0,0,110
20,21,2,12,5,20,0,0,0,80
20,21,2,12,9,11,5,0,0,80
20,21,2,13,1,11,5,18,0,91
20,21,2,13,1,11,9,14,7,98
20,21,2,13,5,14,0,0,0,75
20,21,2,15,9,4,0,0,0,71
20,21,2,15,18,18,8,5,1,108
20,21,2,19,0,0,0,0,0,62
20,21,2,19,20,5,18,0,0,105
20,21,2,20,1,9,12,0,0,85
20,21,2,21,12,1,18,0,0,95
20,21,2,21,12,1,18,12,25,132
20,21,2,21,12,1,20,5,0,102
20,21,2,21,12,1,20,5,4,106
20,21,2,21,12,1,20,5,19,121
20,21,2,21,12,1,20,15,18,130
20,21,2,21,12,5,0,0,0,81
20,21,2,21,12,5,19,0,0,100
20,21,2,21,12,5,20,0,0,101
20,21,2,21,12,9,0,0,0,85
20,21,2,21,12,9,14,0,0,99
20,21,2,21,12,9,14,19,0,118
20,21,2,21,12,15,19,5,0,115
20,21,2,21,12,15,21,19,0,131
20,21,2,21,12,21,18,5,0,120
20,21,2,21,12,21,18,5,19,139
20,21,2,21,12,21,19,0,0,116
20,21,2,21,16,8,15,14,5,122
20,21,2,23,15,13,1,14,0,109
20,21,3,1,14,4,5,18,1,87
20,21,3,8,9,19,0,0,0,80
20,21,3,8,9,20,0,0,0,81
20,21,3,8,21,14,0,0,0,87
20,21,3,8,21,14,1,20,5,113
20,21,3,8,21,14,9,19,13,128
20,21,3,8,21,14,9,26,5,127
20,21,3,8,21,14,19,0,0,106
20,21,3,11,1,8,15,5,19,103
20,21,3,11,5,4,0,0,0,64
20,21,3,11,5,18,5,4,0,87
20,21,3,11,5,18,9,14,7,108
20,21,3,11,5,18,19,0,0,97
20,21,3,11,5,20,0,0,0,80
20,21,3,11,5,20,19,0,0,99
20,21,3,11,9,14,7,0,0,85
20,21,3,11,14,5,18,0,0,92
20,21,3,11,19,0,0,0,0,74
20,21,3,11,19,8,15,16,0,113
20,21,3,11,20,15,15,0,0,105
20,21,3,15,20,21,3,15,0,118
20,21,3,21,13,1,0,0,0,79
20,21,3,21,20,21,3,21,0,130
20,21,4,5,0,0,0,0,0,50
20,21,4,5,12,0,0,0,0,62
20,21,5,0,0,0,0,0,0,46
20,21,5,2,15,18,0,0,0,81
20,21,5,4,9,1,14,0,0,74
20,21,5,9,18,15,14,0,0,102
20,21,6,1,0,0,0,0,0,48
20,21,6,1,3,5,15,21,19,111
20,21,6,1,12,9,11,5,0,85
20,21,6,1,14,0,0,0,0,62
20,21,6,1,19,0,0,0,0,67
20,21,6,6,0,0,0,0,0,53
20,21,6,6,5,20,0,0,0,78
20,21,6,6,5,20,19,0,0,97
20,21,6,6,9,14,7,0,0,83
20,21,6,6,15,15,14,0,0,97
20,21,6,6,19,0,0,0,0,72
20,21,6,15,12,9,0,0,0,83
20,21,6,20,0,0,0,0,0,67
20,21,6,20,5,4,0,0,0,76
20,21,6,20,5,18,0,0,0,90
20,21,6,20,5,18,19,0,0,109
20,21,6,20,25,0,0,0,0,92
20,21,6,20,9,5,18,0,0,99
20,21,6,20,9,5,19,20,0,120
20,21,6,20,9,12,25,0,0,113
20,21,6,20,9,14,7,0,0,97
20,21,6,20,12,5,20,0,0,104
20,21,7,0,0,0,0,0,0,48
20,21,7,2,15,1,20,0,0,86
20,21,7,2,15,1,20,19,0,105
20,21,7,7,5,4,0,0,0,64
20,21,7,7,5,18,0,0,0,78
20,21,7,7,5,18,25,0,0,103
20,21,7,7,5,18,19,0,0,97
20,21,7,7,9,14,7,0,0,85
20,21,7,7,9,14,7,12,25,122
20,21,7,8,18,1,0,0,0,75
20,21,7,8,18,9,11,0,0,94
20,21,7,8,18,9,11,19,0,113
20,21,7,12,5,19,19,0,0,103
20,21,7,12,9,11,5,0,0,85
20,21,7,18,9,11,0,0,0,86
20,21,7,18,9,11,19,0,0,105
20,21,7,19,0,0,0,0,0,67
20,21,7,21,9,0,0,0,0,78
20,21,7,21,18,9,1,0,0,97
20,21,7,21,18,9,21,13,0,130
20,21,9,0,0,0,0,0,0,50
20,21,25,0,0,0,0,0,0,66
20,21,25,5,18,0,0,0,0,89
20,21,25,5,18,5,0,0,0,94
20,21,25,5,18,5,19,0,0,113
20,21,25,5,18,19,0,0,0,108
20,21,9,11,0,0,0,0,0,61
20,21,9,12,25,9,5,0,0,101
20,21,9,12,12,5,0,0,0,79
20,21,9,12,12,5,19,0,0,98
20,21,9,12,12,5,20,20,5,124
20,21,9,12,26,9,5,0,0,102
20,21,9,14,7,1,0,0,0,72
20,21,9,19,0,0,0,0,0,69
20,21,9,19,13,0,0,0,0,82
20,21,9,20,9,15,14,0,0,108
20,21,9,20,9,15,14,1,12,121
20,21,9,20,9,15,14,19,0,127
20,21,9,20,9,22,5,0,0,106
20,21,11,5,0,0,0,0,0,57
20,21,11,18,1,0,0,0,0,71
20,21,11,21,20,21,11,21,0,146
20,21,12,1,4,9,0,0,0,67
20,21,12,1,4,9,19,0,0,86
20,21,12,1,18,5,13,9,1,100
20,21,12,1,18,5,13,9,3,102
20,21,12,1,19,9,0,0,0,82
20,21,12,3,1,14,0,0,0,71
20,21,12,3,8,1,14,0,0,79
20,21,12,3,8,9,14,0,0,87
20,21,12,5,0,0,0,0,0,58
20,21,12,5,19,0,0,0,0,77
20,21,12,9,1,3,0,0,0,66
20,21,12,9,16,0,0,0,0,78
20,21,12,9,16,1,14,20,0,113
20,21,12,9,16,9,0,0,0,87
20,21,12,9,16,25,0,0,0,103
20,21,12,9,16,9,19,20,0,126
20,21,12,9,16,12,9,11,5,115
20,21,12,9,16,19,0,0,0,97
20,21,12,9,16,23,15,15,4,135
20,21,12,9,19,1,14,0,0,96
20,21,12,9,19,1,14,5,19,120
20,21,12,12,5,19,0,0,0,89
20,21,12,12,9,2,5,5,0,86
20,21,12,12,9,2,5,5,19,105
20,21,12,14,9,3,0,0,0,79
20,21,12,19,9,0,0,0,0,81
20,21,12,23,1,18,0,0,0,95
20,21,12,23,1,21,18,0,0,116
20,21,13,0,0,0,0,0,0,54
20,21,13,1,9,14,0,0,0,78
20,21,13,1,19,8,1,0,0,83
20,21,13,2,1,11,0,0,0,68
20,21,13,2,1,11,9,0,0,77
20,21,13,2,5,11,0,0,0,72
20,21,13,2,5,11,9,0,0,81
20,21,13,2,5,19,20,5,18,123
20,21,13,2,12,5,0,0,0,73
20,21,13,2,12,5,2,21,7,103
20,21,13,2,12,5,4,0,0,77
20,21,13,2,12,5,18,0,0,91
20,21,13,2,12,5,18,19,0,110
20,21,13,2,12,5,19,0,0,92
20,21,13,2,12,25,0,0,0,93
20,21,13,2,12,9,14,7,0,98
20,21,13,2,12,9,14,7,19,117
20,21,13,2,18,5,12,0,0,91
20,21,13,2,18,5,12,19,0,110
20,21,13,2,18,9,12,0,0,95
20,21,13,2,18,9,12,19,0,114
20,21,13,5,0,0,0,0,0,59
20,21,13,5,6,25,0,0,0,90
20,21,13,5,6,9,5,4,0,83
20,21,13,5,6,9,5,19,0,98
20,21,13,5,6,25,9,14,7,120
20,21,13,5,18,9,3,0,0,89
20,21,13,5,19,3,5,14,20,120
20,21,13,6,9,5,0,0,0,74
20,21,13,9,4,0,0,0,0,67
20,21,13,9,4,9,12,25,0,113
20,21,13,9,4,9,20,25,0,121
20,21,13,9,4,12,25,0,0,104
20,21,13,9,4,14,5,19,19,124
20,21,13,12,9,0,0,0,0,75
20,21,13,13,1,12,19,0,0,99
20,21,13,13,5,4,0,0,0,76
20,21,13,13,5,12,0,0,0,84
20,21,13,13,5,12,5,18,0,107
20,21,13,13,5,12,19,0,0,103
20,21,13,13,5,18,0,0,0,90
20,21,13,13,25,0,0,0,0,92
20,21,13,13,9,5,19,0,0,100
20,21,13,13,9,14,7,0,0,97
20,21,13,13,12,5,18,0,0,102
20,21,13,13,12,5,18,19,0,121
20,21,13,13,15,3,11,0,0,96
20,21,13,13,21,12,5,18,0,123
20,21,13,15,18,0,0,0,0,87
20,21,13,15,18,1,12,0,0,100
20,21,13,15,18,5,4,0,0,96
20,21,13,15,18,12,9,11,5,124
20,21,13,15,18,15,21,19,0,142
20,21,13,15,18,19,0,0,0,106
20,21,13,15,21,18,0,0,0,108
20,21,13,15,21,18,5,4,0,117
20,21,13,15,21,18,19,0,0,127
20,21,13,16,0,0,0,0,0,70
20,21,13,16,8,25,0,0,0,103
20,21,13,16,12,9,14,5,0,110
20,21,13,16,12,9,14,5,19,129
20,21,13,16,19,0,0,0,0,89
20,21,13,20,21,13,0,0,0,108
20,21,13,21,12,1,18,0,0,106
20,21,13,21,12,1,18,25,0,131
20,21,13,21,12,1,20,5,0,113
20,21,13,21,12,9,0,0,0,96
20,21,13,21,12,15,19,5,0,126
20,21,13,21,12,15,21,19,0,142
20,21,13,21,12,20,0,0,0,107
20,21,13,21,12,20,5,18,0,130
20,21,13,21,12,20,19,0,0,126
20,21,13,21,12,20,21,19,0,147
20,21,13,21,12,21,19,0,0,127
20,21,13,21,12,21,19,5,19,151
20,21,14,0,0,0,0,0,0,55
20,21,14,1,0,0,0,0,0,56
20,21,14,1,2,12,5,0,0,75
20,21,14,1,2,12,25,0,0,95
20,21,14,1,12,0,0,0,0,68
20,21,14,2,5,12,12,25,0,111
20,21,14,3,1,0,0,0,0,59
20,21,14,4,0,0,0,0,0,59
20,21,14,4,1,20,9,15,14,118
20,21,14,4,5,18,0,0,0,82
20,21,14,4,9,19,8,0,0,95
20,21,14,4,9,19,8,5,19,119
20,21,14,4,18,1,0,0,0,78
20,21,14,4,18,1,19,0,0,97
20,21,14,4,21,14,0,0,0,94
20,21,14,5,0,0,0,0,0,60
20,21,14,5,1,2,12,5,0,80
20,21,14,5,1,2,12,25,0,100
20,21,14,5,4,0,0,0,0,64
20,21,14,5,6,21,12,0,0,99
20,21,14,5,6,21,12,12,25,136
20,21,14,5,12,5,19,19,0,115
20,21,14,5,13,1,11,5,18,108
20,21,14,5,18,0,0,0,0,78
20,21,14,5,18,19,0,0,0,97
20,21,14,5,19,0,0,0,0,79
20,21,14,5,19,13,9,20,8,129
20,21,14,5,19,15,13,5,0,112
20,21,14,5,19,20,5,18,0,122
20,21,14,5,21,16,0,0,0,97
20,21,14,5,21,16,19,0,0,116
20,21,14,6,21,12,0,0,0,94
20,21,14,7,1,8,0,0,0,71
20,21,14,7,1,20,5,0,0,88
20,21,14,7,15,0,0,0,0,77
20,21,14,7,15,19,0,0,0,96
20,21,14,7,19,0,0,0,0,81
20,21,14,7,19,20,1,20,5,127
20,21,14,7,19,20,5,14,0,120
20,21,14,7,19,20,5,14,19,139
20,21,14,7,19,20,9,3,0,113
20,21,14,7,19,20,9,20,5,135
20,21,14,7,19,20,15,21,19,156
20,21,14,8,15,15,6,0,0,99
20,21,14,25,0,0,0,0,0,80
20,21,14,9,3,0,0,0,0,67
20,21,14,9,3,1,5,0,0,73
20,21,14,9,3,1,18,25,0,111
20,21,14,9,3,1,20,5,0,93
20,21,14,9,3,1,20,5,4,97
20,21,14,9,3,1,20,5,19,112
20,21,14,9,3,9,14,0,0,90
20,21,14,9,3,11,5,4,0,87
20,21,14,9,3,12,5,0,0,84
20,21,14,9,3,12,5,19,0,103
20,21,14,9,3,12,5,19,19,122
20,21,14,9,3,19,0,0,0,86
20,21,14,9,14,5,19,19,0,121
20,21,14,9,14,7,0,0,0,85
20,21,14,9,14,7,19,0,0,104
20,21,14,9,19,8,0,0,0,91
20,21,14,9,19,9,1,14,19,126
20,21,14,9,19,20,0,0,0,103
20,21,14,11,0,0,0,0,0,66
20,21,14,11,1,0,0,0,0,67
20,21,14,11,5,20,0,0,0,91
20,21,14,12,1,14,4,0,0,86
20,21,14,12,9,11,5,0,0,92
20,21,14,13,15,15,20,0,0,118
20,21,14,14,1,0,0,0,0,70
20,21,14,14,1,7,5,0,0,82
20,21,14,14,1,7,5,19,0,101
20,21,14,14,5,4,0,0,0,78
20,21,14,14,5,12,0,0,0,86
20,21,14,14,5,12,5,4,0,95
20,21,14,14,5,12,5,18,0,109
20,21,14,14,5,12,5,18,19,128
20,21,14,14,5,12,9,14,7,116
20,21,14,14,5,12,9,19,20,134
20,21,14,14,5,12,9,20,5,120
20,21,14,14,5,12,12,5,4,107
20,21,14,14,5,12,12,5,18,121
20,21,14,14,5,12,12,25,0,123
20,21,14,14,5,12,13,1,14,114
20,21,14,14,5,12,13,5,14,118
20,21,14,14,5,12,19,0,0,105
20,21,14,14,5,12,23,1,25,135
20,21,14,14,5,18,0,0,0,92
20,21,14,14,5,18,25,0,0,117
20,21,14,14,5,18,9,5,19,125
20,21,14,14,25,0,0,0,0,94
20,21,14,14,9,5,19,0,0,102
20,21,14,14,9,14,7,0,0,99
20,21,14,14,12,1,14,4,0,100
20,21,14,14,15,18,0,0,0,102
20,21,14,15,0,0,0,0,0,70
20,21,14,19,0,0,0,0,0,74
20,21,14,21,0,0,0,0,0,76
20,21,16,0,0,0,0,0,0,57
20,21,16,1,9,9,4,0,0,80
20,21,16,1,11,9,8,9,0,95
20,21,16,1,14,19,8,9,16,124
20,21,16,1,18,1,0,0,0,77
20,21,16,5,11,0,0,0,0,73
20,21,16,5,12,15,19,0,0,108
20,21,16,9,11,0,0,0,0,77
20,21,16,9,11,19,0,0,0,96
20,21,16,12,5,0,0,0,0,74
20,21,16,12,5,19,0,0,0,93
20,21,16,13,5,14,0,0,0,89
20,21,16,16,5,4,0,0,0,82
20,21,16,16,5,14,3,5,0,100
20,21,16,16,5,14,3,5,19,119
20,21,16,16,5,14,14,25,0,131
20,21,16,16,9,14,7,0,0,103
20,21,16,19,0,0,0,0,0,76
20,21,16,21,14,1,0,0,0,93
20,21,17,21,5,0,0,0,0,84
20,21,17,21,5,19,0,0,0,103
20,21,17,21,15,17,21,5,0,137
20,21,18,1,3,9,14,0,0,86
20,21,18,1,3,15,0,0,0,78
20,21,18,1,3,15,19,0,0,97
20,21,18,1,3,15,21,0,0,99
20,21,18,1,3,15,21,19,0,118
20,21,18,1,11,15,15,0,0,101
20,21,18,1,14,9,20,5,0,108
20,21,18,1,14,15,19,5,0,113
20,21,18,2,0,0,0,0,0,61
20,21,18,2,1,14,0,0,0,76
20,21,18,2,1,14,5,4,0,85
20,21,18,2,1,14,14,5,4,99
20,21,18,2,1,14,19,0,0,95
20,21,18,2,1,14,20,15,0,111
20,21,18,2,1,14,20,15,16,127
20,21,18,2,1,18,25,0,0,105
20,21,18,2,1,18,9,5,19,113
20,21,18,2,5,8,0,0,0,74
20,21,18,2,5,20,8,0,0,94
20,21,18,2,5,20,8,19,0,113
20,21,18,2,9,4,0,0,0,74
20,21,18,2,9,4,9,20,5,108
20,21,18,2,9,4,9,20,25,128
20,21,18,2,9,4,12,25,0,111
20,21,18,2,9,14,1,7,5,97
20,21,18,2,9,14,1,12,0,97
20,21,18,2,9,14,1,12,19,116
20,21,18,2,9,14,1,20,5,110
20,21,18,2,9,14,5,0,0,89
20,21,18,2,9,14,5,4,0,93
20,21,18,2,9,14,5,18,0,107
20,21,18,2,9,14,5,19,0,108
20,21,18,2,9,14,9,20,5,118
20,21,18,2,9,14,15,9,4,112
20,21,18,2,9,20,0,0,0,90
20,21,18,2,9,20,8,0,0,98
20,21,18,2,9,20,8,19,0,117
20,21,18,2,9,20,19,0,0,109
20,21,18,2,12,5,0,0,0,78
20,21,18,2,15,3,1,18,0,98
20,21,18,2,15,3,1,18,19,117
20,21,18,2,15,6,1,14,0,97
20,21,18,2,15,6,1,14,19,116
20,21,18,2,15,10,5,20,0,111
20,21,18,2,15,10,5,20,19,130
20,21,18,2,15,16,18,15,16,141
20,21,18,2,15,16,21,13,16,142
20,21,18,2,15,19,0,0,0,95
20,21,18,2,15,20,0,0,0,96
20,21,18,2,15,20,19,0,0,115
20,21,18,2,21,12,5,14,20,133
20,21,18,3,15,9,19,0,0,105
20,21,18,3,15,16,15,12,5,125
20,21,18,4,0,0,0,0,0,63
20,21,18,4,9,6,15,18,13,124
20,21,18,4,9,14,5,0,0,91
20,21,18,4,15,9,4,0,0,91
20,21,18,4,19,0,0,0,0,82
20,21,18,5,5,14,0,0,0,83
20,21,18,5,5,14,6,21,12,122
20,21,18,5,5,14,19,0,0,102
20,21,18,6,0,0,0,0,0,65
20,21,18,6,1,7,5,0,0,78
20,21,18,6,4,15,13,0,0,97
20,21,18,6,5,4,0,0,0,74
20,21,18,6,5,14,0,0,0,84
20,21,18,6,25,0,0,0,0,90
20,21,18,6,9,5,18,0,0,97
20,21,18,6,9,5,19,20,0,118
20,21,18,6,9,14,5,19,19,131
20,21,18,6,9,14,7,0,0,95
20,21,18,6,9,20,5,0,0,99
20,21,18,6,12,5,19,19,0,120
20,21,18,6,12,9,11,5,0,102
20,21,18,6,13,1,14,0,0,93
20,21,18,6,13,5,14,0,0,97
20,21,18,6,19,0,0,0,0,84
20,21,18,6,19,11,9,0,0,104
20,21,18,6,19,11,9,19,0,123
20,21,18,6,23,9,19,5,0,121
20,21,18,7,5,14,3,25,0,113
20,21,18,7,5,14,20,0,0,105
20,21,18,7,5,14,20,12,25,142
20,21,18,7,5,19,3,5,0,98
20,21,18,7,5,19,3,5,4,102
20,21,18,7,25,0,0,0,0,91
20,21,18,7,9,4,0,0,0,79
20,21,18,7,9,4,9,20,25,133
20,21,18,7,9,4,12,25,0,116
20,21,18,7,9,20,5,0,0,100
20,21,18,7,9,20,5,19,0,119
20,21,18,7,15,9,4,0,0,94
20,21,18,7,15,18,0,0,0,99
20,21,18,7,15,18,19,0,0,118
20,21,18,9,3,1,20,1,0,93
20,21,18,9,15,0,0,0,0,83
20,21,18,9,15,14,0,0,0,97
20,21,18,9,19,20,1,0,0,108
20,21,18,9,19,20,1,19,0,127
20,21,18,10,1,9,20,5,0,104
20,21,18,10,9,20,5,0,0,103
20,21,18,11,5,5,18,0,0,98
20,21,18,11,5,25,19,0,0,119
20,21,18,11,5,14,0,0,0,89
20,21,18,11,9,19,0,0,0,98
20,21,18,11,12,5,0,0,0,87
20,21,18,11,15,9,19,0,0,113
20,21,18,11,15,9,19,5,19,137
20,21,18,11,19,0,0,0,0,89
20,21,18,12,15,21,7,8,0,122
20,21,18,13,0,0,0,0,0,72
20,21,18,13,1,0,0,0,0,73
20,21,18,13,1,12,9,14,5,113
20,21,18,13,5,14,20,0,0,111
20,21,18,13,5,18,9,3,0,107
20,21,18,13,5,18,9,3,19,126
20,21,18,13,5,18,15,12,0,122
20,21,18,13,5,20,0,0,0,97
20,21,18,13,9,20,0,0,0,101
20,21,18,13,15,9,12,0,0,108
20,21,18,13,15,9,12,5,4,117
20,21,18,13,15,9,12,5,18,131
20,21,18,13,15,9,12,19,0,127
20,21,18,13,21,20,0,0,0,113
20,21,18,14,0,0,0,0,0,73
20,21,18,14,1,2,12,5,0,93
20,21,18,14,1,2,15,21,20,132
20,21,18,14,1,7,1,9,14,105
20,21,18,14,1,23,1,25,0,123
20,21,18,14,2,1,3,11,0,90
20,21,18,14,2,15,21,20,0,131
20,21,18,14,3,1,16,0,0,93
20,21,18,14,3,15,1,20,0,112
20,21,18,14,3,15,1,20,19,131
20,21,18,14,3,15,3,11,0,105
20,21,18,14,4,15,23,14,0,129
20,21,18,14,4,15,23,14,19,148
20,21,18,14,4,21,14,0,0,112
20,21,18,14,5,4,0,0,0,82
20,21,18,14,5,12,0,0,0,90
20,21,18,14,5,18,25,0,0,121
20,21,18,14,5,18,9,5,19,129
20,21,18,14,5,18,9,20,5,130
20,21,18,14,7,1,20,5,0,106
20,21,18,14,8,1,12,12,0,106
20,21,18,14,8,1,12,12,19,125
20,21,18,14,9,3,9,14,5,113
20,21,18,14,9,14,7,0,0,103
20,21,18,14,9,14,7,19,0,122
20,21,18,14,9,16,0,0,0,98
20,21,18,14,9,16,25,0,0,123
20,21,18,14,9,16,19,0,0,117
20,21,18,14,11,5,25,0,0,114
20,21,18,14,11,5,25,19,0,133
20,21,18,14,13,5,20,5,18,134
20,21,18,14,15,6,6,0,0,100
20,21,18,14,15,6,6,19,0,119
20,21,18,14,15,18,0,0,0,106
20,21,18,14,15,21,20,0,0,129
20,21,18,14,15,21,20,19,0,148
20,21,18,14,15,22,5,18,0,133
20,21,18,14,15,22,5,18,19,152
20,21,18,14,16,9,11,5,0,114
20,21,18,14,16,9,11,5,18,132
20,21,18,14,16,9,11,5,19,133
20,21,18,14,16,9,14,0,0,112
20,21,18,14,16,12,1,20,5,127
20,21,18,14,16,12,15,23,0,139
20,21,18,14,16,15,11,5,0,120
20,21,18,14,18,15,23,0,0,129
20,21,18,14,19,0,0,0,0,92
20,21,18,14,19,3,18,5,23,141
20,21,18,14,19,8,5,5,20,130
20,21,18,14,19,11,9,14,0,126
20,21,18,14,19,15,12,5,0,124
20,21,18,14,19,15,12,5,19,143
20,21,18,14,19,16,9,20,0,137
20,21,18,14,19,16,9,20,19,156
20,21,18,14,19,20,9,12,5,138
20,21,18,14,19,20,15,14,5,146
20,21,18,14,20,1,2,12,5,113
20,21,18,14,20,1,9,12,0,115
20,21,18,14,20,1,12,5,0,111
20,21,18,14,21,16,0,0,0,110
20,21,18,14,21,16,19,0,0,129
20,21,18,14,23,1,25,0,0,122
20,21,18,14,23,18,5,19,20,158
20,21,18,14,23,18,9,19,20,162
20,21,18,15,16,8,9,12,5,124
20,21,18,16,0,0,0,0,0,75
20,21,18,16,5,20,8,0,0,108
20,21,18,16,5,20,8,9,14,131
20,21,18,16,5,20,8,19,0,127
20,21,18,16,9,4,0,0,0,88
20,21,18,16,9,4,12,25,0,125
20,21,18,16,9,6,25,0,0,115
20,21,18,16,9,14,9,20,5,132
20,21,18,16,9,19,0,0,0,103
20,21,18,16,9,20,21,4,5,134
20,21,18,16,19,0,0,0,0,94
20,21,18,17,21,5,20,0,0,122
20,21,18,17,21,15,9,19,0,140
20,21,18,17,21,15,9,19,5,145
20,21,18,18,0,0,0,0,0,77
20,21,18,18,5,12,0,0,0,94
20,21,18,18,5,20,0,0,0,102
20,21,18,18,5,20,5,4,0,111
20,21,18,18,5,20,9,14,7,132
20,21,18,18,5,20,19,0,0,121
20,21,18,18,9,3,1,12,0,102
20,21,18,18,9,3,12,5,0,106
20,21,18,18,9,3,21,12,1,123
20,21,18,18,9,6,15,18,13,138
20,21,18,18,9,12,9,20,5,132
20,21,18,18,9,15,14,0,0,115
20,21,18,18,9,20,5,4,0,115
20,21,18,18,21,13,0,0,0,111
20,21,18,19,5,0,0,0,0,83
20,21,18,19,9,15,0,0,0,102
20,21,18,20,12,5,4,0,0,100
20,21,18,20,12,5,4,15,13,128
20,21,18,20,12,5,9,26,5,136
20,21,18,20,12,5,16,5,7,124
20,21,18,20,12,5,18,0,0,114
20,21,18,20,12,5,18,19,0,133
20,21,18,20,12,5,19,0,0,115
20,21,18,20,12,5,20,0,0,116
20,21,18,20,12,9,14,7,0,121
20,21,18,20,12,9,14,7,19,140
20,21,18,20,15,19,1,0,0,114
20,21,18,20,21,18,0,0,0,118
20,21,18,21,18,9,0,0,0,107
20,21,18,21,19,0,0,0,0,99
20,21,18,22,5,19,0,0,0,105
20,21,18,22,25,0,0,0,0,106
20,21,18,23,1,18,0,0,0,101
20,21,19,3,8,5,0,0,0,76
20,21,19,3,8,5,19,0,0,95
20,21,19,8,5,4,0,0,0,77
20,21,19,8,5,18,0,0,0,91
20,21,19,8,5,18,25,0,0,116
20,21,19,8,5,19,0,0,0,92
20,21,19,8,25,0,0,0,0,93
20,21,19,8,9,5,0,0,0,82
20,21,19,8,9,5,19,0,0,101
20,21,19,8,9,14,7,0,0,98
20,21,19,8,19,0,0,0,0,87
20,21,19,11,0,0,0,0,0,71
20,21,19,11,1,18,0,0,0,90
20,21,19,11,5,4,0,0,0,80
20,21,19,11,5,18,0,0,0,94
20,21,19,11,5,18,19,0,0,113
20,21,19,11,25,0,0,0,0,96
20,21,19,11,9,5,18,0,0,103
20,21,19,11,9,5,19,20,0,124
20,21,19,11,9,14,7,0,0,101
20,21,19,11,9,19,8,0,0,107
20,21,19,11,12,5,19,19,0,126
20,21,19,11,12,9,11,5,0,108
20,21,19,11,19,0,0,0,0,90
20,21,19,11,23,9,19,5,0,127
20,21,19,19,1,8,0,0,0,88
20,21,19,19,1,8,19,0,0,107
20,21,19,19,1,12,0,0,0,92
20,21,19,19,1,18,0,0,0,98
20,21,19,19,1,18,19,0,0,117
20,21,19,19,5,8,0,0,0,92
20,21,19,19,5,8,19,0,0,111
20,21,19,19,5,18,0,0,0,102
20,21,19,19,5,18,19,0,0,121
20,21,19,19,9,19,0,0,0,107
20,21,19,19,9,19,5,19,0,131
20,21,19,19,9,22,5,0,0,115
20,21,19,19,12,5,0,0,0,96
20,21,19,19,12,5,4,0,0,100
20,21,19,19,12,5,18,0,0,114
20,21,19,19,12,5,19,0,0,115
20,21,19,19,12,9,14,7,0,121
20,21,19,19,15,3,11,0,0,108
20,21,19,19,15,3,11,5,4,117
20,21,19,19,15,3,11,5,18,131
20,21,19,19,15,3,11,25,0,133
20,21,19,19,15,3,11,19,0,127
20,21,19,19,15,18,0,0,0,112
20,21,19,19,15,18,5,0,0,117
20,21,19,19,15,18,5,19,0,136
20,21,19,19,15,18,19,0,0,131
20,21,19,19,21,3,11,0,0,114
20,21,19,19,21,3,11,19,0,133
20,21,19,19,21,18,0,0,0,118
20,21,19,19,21,18,19,0,0,137
20,21,20,1,13,5,14,20,0,114
20,21,20,1,14,9,1,0,0,86
20,21,20,2,1,12,12,0,0,88
20,21,20,5,0,0,0,0,0,66
20,21,20,5,5,0,0,0,0,71
20,21,20,5,5,19,0,0,0,90
20,21,20,5,12,1,0,0,0,79
20,21,20,5,12,1,5,0,0,84
20,21,20,5,12,1,7,5,0,91
20,21,20,5,12,1,7,5,19,110
20,21,20,5,12,1,18,0,0,97
20,21,20,5,12,1,18,25,0,122
20,21,20,5,12,1,18,19,0,116
20,21,20,5,12,5,0,0,0,83
20,21,20,5,14,1,7,0,0,88
20,21,20,5,14,1,7,21,5,114
20,21,20,8,0,0,0,0,0,69
20,21,20,9,14,0,0,0,0,84
20,21,20,9,15,18,9,19,13,144
20,21,20,9,15,18,9,19,20,151
20,21,20,12,5,18,0,0,0,96
20,21,20,12,25,0,0,0,0,98
20,21,20,13,1,14,0,0,0,89
20,21,20,13,5,14,0,0,0,93
20,21,20,15,25,5,4,0,0,110
20,21,20,15,25,5,18,0,0,124
20,21,20,15,25,5,18,5,4,133
20,21,20,15,25,5,18,19,0,143
20,21,20,15,18,0,0,0,0,94
20,21,20,15,18,1,7,5,0,107
20,21,20,15,18,1,7,5,19,126
20,21,20,15,18,5,4,0,0,103
20,21,20,15,18,5,18,0,0,117
20,21,20,15,18,5,19,19,0,137
20,21,20,15,18,8,15,15,4,136
20,21,20,15,18,25,0,0,0,119
20,21,20,15,18,9,1,12,0,116
20,21,20,15,18,9,1,12,19,135
20,21,20,15,18,9,1,20,5,129
20,21,20,15,18,9,14,7,0,124
20,21,20,15,18,9,19,13,0,135
20,21,20,15,18,9,26,5,0,134
20,21,20,15,18,12,5,19,19,149
20,21,20,15,18,12,25,0,0,131
20,21,20,15,18,19,0,0,0,113
20,21,20,15,18,19,8,9,16,146
20,21,20,18,5,19,19,0,0,122
20,21,20,18,9,3,5,0,0,96
20,21,20,18,9,24,0,0,0,112
20,21,20,19,0,0,0,0,0,80
20,21,20,19,1,14,0,0,0,95
20,21,20,19,20,5,18,0,0,123
20,21,20,20,5,4,0,0,0,90
20,21,20,20,9,0,0,0,0,90
20,21,20,20,25,0,0,0,0,106
20,21,20,20,9,5,19,0,0,114
20,21,20,20,9,13,1,14,0,118
20,21,20,20,25,13,1,14,0,134
20,21,20,20,9,14,7,0,0,111
20,21,20,20,9,19,0,0,0,109
20,21,20,21,0,0,0,0,0,82
20,21,20,21,12,21,19,0,0,134
20,21,20,21,19,0,0,0,0,101
20,21,20,23,15,18,11,0,0,128
20,21,20,23,15,18,11,5,18,151
20,21,21,13,0,0,0,0,0,75
20,21,23,9,0,0,0,0,0,73
20,21,24,0,0,0,0,0,0,65
20,21,24,5,4,15,5,4,0,98
20,21,24,5,4,15,5,19,0,113
20,21,24,5,4,15,19,0,0,108
20,21,24,5,19,0,0,0,0,89
20,21,26,1,0,0,0,0,0,68
20,21,26,26,12,5,0,0,0,110
20,23,5,1,7,0,0,0,0,56
20,23,5,1,11,0,0,0,0,60
20,23,5,1,11,5,4,0,0,69
20,23,5,1,11,5,18,0,0,83
20,23,5,1,11,25,0,0,0,85
20,23,5,1,11,9,5,18,0,92
20,23,5,1,11,9,5,19,20,113
20,23,5,1,11,9,14,7,0,90
20,23,5,1,11,19,0,0,0,79
20,23,5,5,0,0,0,0,0,53
20,23,5,5,4,5,4,0,0,66
20,23,5,5,4,25,0,0,0,82
20,23,5,5,4,9,5,18,0,89
20,23,5,5,4,9,5,19,20,110
20,23,5,5,4,12,5,0,0,74
20,23,5,5,4,12,5,4,0,78
20,23,5,5,4,12,5,19,0,93
20,23,5,5,4,12,9,14,7,99
20,23,5,5,4,19,0,0,0,76
20,23,5,5,7,0,0,0,0,60
20,23,5,5,12,0,0,0,0,65
20,23,5,5,14,0,0,0,0,67
20,23,5,5,14,25,0,0,0,92
20,23,5,5,14,9,5,19,0,100
20,23,5,5,19,5,0,0,0,77
20,23,5,5,19,8,0,0,0,80
20,23,5,5,19,8,20,0,0,100
20,23,5,5,19,20,0,0,0,92
20,23,5,5,20,0,0,0,0,73
20,23,5,5,20,5,4,0,0,82
20,23,5,5,20,5,18,0,0,96
20,23,5,5,20,5,18,19,0,115
20,23,5,5,20,9,14,7,0,103
20,23,5,5,20,19,0,0,0,92
20,23,5,5,26,5,0,0,0,84
20,23,5,5,26,5,4,0,0,88
20,23,5,5,26,5,18,0,0,102
20,23,5,5,26,5,18,5,4,111
20,23,5,5,26,5,18,19,0,121
20,23,5,5,26,5,19,0,0,103
20,23,5,5,26,9,14,7,0,109
20,23,5,25,6,15,12,4,0,110
20,23,5,9,12,0,0,0,0,69
20,23,5,12,6,20,8,0,0,94
20,23,5,12,6,20,8,12,25,131
20,23,5,12,6,20,8,19,0,113
20,23,5,12,22,5,13,15,0,115
20,23,5,12,22,5,13,15,19,134
20,23,5,12,22,5,19,0,0,106
20,23,5,14,20,25,0,0,0,107
20,23,5,14,20,9,5,19,0,115
20,23,5,14,20,9,5,20,8,124
20,23,5,14,20,25,13,15,0,135
20,23,5,18,5,0,0,0,0,71
20,23,5,18,16,0,0,0,0,82
20,23,5,18,16,19,0,0,0,101
20,23,9,2,9,12,0,0,0,75
20,23,9,2,9,12,12,0,0,87
20,23,9,2,9,12,12,5,4,96
20,23,9,2,9,12,12,19,0,106
20,23,9,2,9,12,19,0,0,94
20,23,25,2,12,1,4,5,0,92
20,23,9,3,5,0,0,0,0,60
20,23,9,3,5,18,0,0,0,78
20,23,9,3,5,20,0,0,0,80
20,23,9,3,8,9,12,4,0,88
20,23,9,3,11,0,0,0,0,66
20,23,9,4,4,12,5,0,0,77
20,23,9,4,4,12,5,4,0,81
20,23,9,4,4,12,5,18,0,95
20,23,9,4,4,12,5,18,19,114
20,23,9,4,4,12,5,19,0,96
20,23,9,4,4,12,25,0,0,97
20,23,9,4,4,12,9,14,7,102
20,23,9,5,0,0,0,0,0,57
20,23,9,5,18,0,0,0,0,75
20,23,25,5,18,0,0,0,0,91
20,23,9,5,18,19,0,0,0,94
20,23,25,5,18,19,0,0,0,110
20,23,9,6,1,12,12,15,23,121
20,23,9,6,15,9,12,0,0,94
20,23,9,6,15,12,4,0,0,89
20,23,9,6,15,12,4,12,25,126
20,23,9,7,0,0,0,0,0,59
20,23,9,7,6,21,12,0,0,98
20,23,9,7,7,5,4,0,0,75
20,23,9,7,7,5,14,0,0,85
20,23,9,7,7,5,18,0,0,89
20,23,9,7,7,25,0,0,0,91
20,23,9,7,7,9,5,18,0,98
20,23,9,7,7,9,5,19,20,119
20,23,9,7,7,9,14,7,0,96
20,23,9,7,12,5,19,19,0,114
20,23,9,7,12,5,20,0,0,96
20,23,9,7,12,9,11,5,0,96
20,23,9,7,19,0,0,0,0,78
20,23,9,7,19,15,13,5,0,111
20,23,9,7,23,9,20,8,25,144
20,23,25,8,25,14,4,5,0,124
20,23,9,12,9,7,8,20,0,108
20,23,9,12,9,7,8,20,25,133
20,23,9,12,9,7,8,20,19,127
20,23,9,12,9,20,0,0,0,93
20,23,9,12,12,0,0,0,0,76
20,23,9,12,12,5,4,0,0,85
20,23,9,12,12,5,18,0,0,99
20,23,9,12,12,25,0,0,0,101
20,23,9,12,12,9,14,7,0,106
20,23,9,12,12,9,14,7,19,125
20,23,9,12,12,19,0,0,0,95
20,23,9,12,20,0,0,0,0,84
20,23,9,14,0,0,0,0,0,66
20,23,9,14,1,2,12,5,0,86
20,23,9,14,2,5,18,18,25,134
20,23,9,14,2,15,18,14,0,115
20,23,9,14,4,12,5,0,0,87
20,23,9,14,5,0,0,0,0,71
20,23,9,14,5,1,2,12,5,91
20,23,9,14,5,2,21,19,8,121
20,23,9,14,5,4,0,0,0,75
20,23,9,14,5,12,5,19,19,126
20,23,9,14,5,12,9,11,5,108
20,23,9,14,5,18,0,0,0,89
20,23,9,14,5,18,19,0,0,108
20,23,9,14,5,19,0,0,0,90
20,23,9,14,6,15,12,4,0,103
20,23,9,14,7,5,0,0,0,78
20,23,9,14,7,5,4,0,0,82
20,23,9,14,7,5,9,14,7,108
20,23,9,14,7,5,19,0,0,97
20,23,9,14,7,9,14,7,0,103
20,23,9,14,7,12,5,0,0,90
20,23,9,14,8,15,15,4,0,108
20,23,9,14,25,0,0,0,0,91
20,23,9,14,9,5,18,0,0,98
20,23,9,14,9,5,19,20,0,119
20,23,9,14,9,7,8,20,0,110
20,23,9,14,9,14,7,12,25,133
20,23,9,14,9,19,13,0,0,107
20,23,9,14,10,5,20,0,0,101
20,23,9,14,10,5,20,19,0,120
20,23,9,14,11,0,0,0,0,77
20,23,9,14,11,12,5,0,0,94
20,23,9,14,11,12,5,4,0,98
20,23,9,14,11,12,5,18,0,112
20,23,9,14,11,12,5,18,19,131
20,23,9,14,11,12,5,19,0,113
20,23,9,14,11,12,5,19,19,132
20,23,9,14,11,12,25,0,0,114
20,23,9,14,11,12,9,14,7,119
20,23,9,14,12,5,1,6,0,90
20,23,9,14,12,25,0,0,0,103
20,23,9,14,12,9,11,5,0,103
20,23,9,14,12,9,14,7,0,108
20,23,9,14,14,5,4,0,0,89
20,23,9,14,14,5,18,0,0,103
20,23,9,14,14,5,19,19,0,123
20,23,9,14,14,9,14,7,0,110
20,23,9,14,14,9,14,7,19,129
20,23,9,14,19,5,20,0,0,110
20,23,9,14,19,5,20,19,0,129
20,23,9,14,19,8,9,16,0,118
20,23,9,14,19,8,9,16,19,137
20,23,9,14,20,0,0,0,0,86
20,23,9,14,20,5,18,0,0,109
20,23,9,18,5,0,0,0,0,75
20,23,9,18,11,0,0,0,0,81
20,23,9,18,12,0,0,0,0,82
20,23,9,18,12,5,4,0,0,91
20,23,9,18,12,5,18,0,0,105
20,23,9,18,12,5,18,19,0,124
20,23,9,18,12,25,0,0,0,107
20,23,9,18,12,9,5,18,0,114
20,23,9,18,12,9,5,19,20,135
20,23,9,18,12,9,7,9,7,114
20,23,9,18,12,9,14,7,0,112
20,23,9,18,12,19,0,0,0,101
20,23,9,18,16,0,0,0,0,86
20,23,9,18,16,19,0,0,0,105
20,23,9,19,3,1,18,0,0,93
20,23,9,19,5,12,0,0,0,88
20,23,9,19,20,0,0,0,0,91
20,23,9,19,20,1,2,12,5,111
20,23,9,19,20,5,4,0,0,100
20,23,9,19,20,5,4,12,25,137
20,23,9,19,20,5,14,5,4,119
20,23,9,19,20,5,18,0,0,114
20,23,9,19,20,5,18,5,18,137
20,23,9,19,20,5,18,19,0,133
20,23,9,19,20,8,1,14,4,118
20,23,9,19,20,25,0,0,0,116
20,23,9,19,20,9,3,1,12,116
20,23,9,19,20,9,5,18,0,123
20,23,9,19,20,9,12,25,0,137
20,23,9,19,20,9,14,7,0,121
20,23,9,19,20,9,14,7,19,140
20,23,9,19,20,12,5,0,0,108
20,23,9,19,20,12,5,19,19,146
20,23,9,19,20,19,0,0,0,110
20,23,9,20,0,0,0,0,0,72
20,23,9,20,3,8,0,0,0,83
20,23,9,20,3,8,5,4,0,92
20,23,9,20,3,8,5,12,0,100
20,23,9,20,3,8,5,18,0,106
20,23,9,20,3,8,5,18,19,125
20,23,9,20,3,8,5,19,0,107
20,23,9,20,3,8,5,20,0,108
20,23,9,20,3,8,5,20,25,133
20,23,9,20,3,8,25,0,0,108
20,23,9,20,3,8,9,5,18,115
20,23,9,20,3,8,9,12,25,129
20,23,9,20,3,8,9,14,7,113
20,23,9,20,5,0,0,0,0,77
20,23,9,20,12,1,18,11,0,114
20,23,9,20,19,0,0,0,0,91
20,23,9,20,20,5,4,0,0,101
20,23,9,20,20,5,14,0,0,111
20,23,9,20,20,5,18,0,0,115
20,23,9,20,20,5,18,5,4,124
20,23,9,20,20,5,18,5,18,138
20,23,9,20,20,5,18,25,0,140
20,23,9,20,20,5,18,12,25,152
20,23,9,20,20,5,18,19,0,134
20,23,9,20,20,25,0,0,0,117
20,23,9,20,20,9,14,7,0,122
20,23,9,20,20,12,5,0,0,109
20,23,25,22,5,18,0,0,0,113
20,23,9,24,20,0,0,0,0,96
20,23,9,26,26,5,14,5,4,132
20,23,9,26,26,12,5,0,0,121
20,23,15,0,0,0,0,0,0,58
20,23,15,4,5,3,11,5,18,104
20,23,15,5,19,0,0,0,0,82
20,23,15,6,5,18,0,0,0,87
20,23,15,6,5,18,19,0,0,106
20,23,15,6,15,12,4,0,0,95
20,23,15,6,15,12,4,12,25,132
20,23,15,6,15,12,4,19,0,114
20,23,15,12,5,7,7,5,4,98
20,23,15,12,9,14,7,0,0,100
20,23,15,14,5,19,19,0,0,115
20,23,15,16,5,14,3,5,0,101
20,23,15,16,5,14,3,5,19,120
20,23,15,16,5,14,14,25,0,132
20,23,15,19,0,0,0,0,0,77
20,23,15,19,3,15,18,5,0,118
20,23,15,19,15,13,5,0,0,110
20,23,15,19,15,13,5,19,0,129
20,23,16,0,0,0,0,0,0,59
20,24,20,0,0,0,0,0,0,64
20,26,5,4,1,11,1,8,0,76
20,26,5,20,19,5,0,0,0,95
20,26,5,20,26,5,0,0,0,102
20,26,5,20,26,5,19,0,0,121
20,26,9,7,1,14,5,19,0,101
20,26,9,13,13,5,19,0,0,105
20,26,9,20,26,9,19,0,0,129
20,26,9,20,26,9,20,0,0,130
20,26,9,20,26,9,20,8,0,138
20,26,15,12,11,9,14,0,0,107
20,26,15,14,20,12,5,0,0,112
20,26,21,18,9,19,0,0,0,113
21,2,5,18,1,14,20,0,0,81
21,2,5,18,15,21,19,0,0,101
21,2,5,18,15,21,19,12,25,138
21,2,5,18,18,9,13,1,0,87
21,2,5,18,20,25,0,0,0,91
21,2,5,18,20,9,5,19,0,99
21,2,9,0,0,0,0,0,0,32
21,2,9,3,1,20,9,15,14,94
21,2,9,5,20,25,0,0,0,82
21,2,9,5,20,9,5,19,0,90
21,2,9,17,21,5,0,0,0,75
21,2,9,17,21,9,15,21,19,134
21,2,9,17,21,9,20,0,0,99
21,2,9,17,21,9,20,25,0,124
21,2,15,21,14,4,0,0,0,77
21,2,21,19,19,21,0,0,0,103
21,3,11,5,18,19,0,0,0,77
21,3,11,9,1,0,0,0,0,45
21,3,21,21,2,1,0,0,0,69
21,4,4,5,18,0,0,0,0,52
21,4,4,5,18,5,4,0,0,61
21,4,4,5,18,6,21,12,0,91
21,4,4,5,18,12,5,19,19,107
21,4,4,5,18,12,9,11,5,89
21,4,4,5,18,19,0,0,0,71
21,4,15,0,0,0,0,0,0,40
21,4,15,13,0,0,0,0,0,53
21,4,15,13,5,20,5,18,0,101
21,4,15,13,5,20,5,18,19,120
21,4,15,13,5,20,18,25,0,121
21,4,15,13,5,20,18,9,3,108
21,4,15,19,0,0,0,0,0,59
21,6,5,18,0,0,0,0,0,50
21,6,15,12,15,7,25,0,0,101
21,6,15,12,15,7,9,5,19,109
21,6,15,12,15,7,9,19,20,124
21,6,15,19,0,0,0,0,0,61
21,7,7,12,5,19,15,13,5,104
21,7,8,0,0,0,0,0,0,36
21,7,8,19,0,0,0,0,0,55
21,7,8,20,5,14,0,0,0,75
21,7,12,9,0,0,0,0,0,49
21,7,12,25,0,0,0,0,0,65
21,7,12,9,5,18,0,0,0,72
21,7,12,9,5,19,0,0,0,73
21,7,12,9,5,19,20,0,0,93
21,7,12,9,6,25,0,0,0,80
21,7,12,9,6,9,5,4,0,73
21,7,12,9,6,9,5,18,0,87
21,7,12,9,6,9,5,18,19,106
21,7,12,9,6,9,5,19,0,88
21,7,12,9,6,25,9,14,7,110
21,7,12,9,12,25,0,0,0,86
21,7,12,9,14,5,19,19,0,106
21,7,12,9,19,0,0,0,0,68
21,7,12,9,19,15,13,5,0,101
21,7,18,9,1,14,9,26,5,110
21,7,19,15,13,5,0,0,0,80
21,7,19,15,13,5,12,25,0,117
21,7,20,0,0,0,0,0,0,48
21,8,12,1,14,0,0,0,0,56
21,8,12,1,14,19,0,0,0,75
21,8,12,12,15,0,0,0,0,68
21,8,19,0,0,0,0,0,0,48
21,8,20,5,14,19,1,14,7,109
21,8,20,19,15,14,7,0,0,104
21,8,21,18,21,0,0,0,0,89
21,9,12,25,0,0,0,0,0,67
21,9,14,1,12,0,0,0,0,57
21,9,14,20,1,8,9,20,5,107
21,9,14,20,1,9,20,5,0,99
21,9,14,20,1,9,20,5,19,118
21,9,14,20,10,9,5,0,0,88
21,9,20,19,16,1,14,0,0,100
21,10,9,0,0,0,0,0,0,40
21,11,5,12,5,12,5,0,0,71
21,11,5,12,5,12,5,19,0,90
21,11,5,19,0,0,0,0,0,56
21,11,9,25,15,5,0,0,0,86
21,11,9,25,15,25,5,0,0,111
21,11,18,1,14,9,1,14,0,89
21,11,21,12,5,12,5,0,0,87
21,11,21,12,5,12,5,19,0,106
21,12,3,5,18,0,0,0,0,59
21,12,3,5,18,1,2,12,5,79
21,12,3,5,18,1,20,5,0,85
21,12,3,5,18,1,20,5,4,89
21,12,3,5,18,1,20,5,19,104
21,12,3,5,18,5,4,0,0,68
21,12,3,5,18,25,0,0,0,84
21,12,3,5,18,9,14,7,0,89
21,12,3,5,18,15,21,19,0,114
21,12,3,5,18,19,0,0,0,78
21,12,3,21,19,0,0,0,0,76
21,12,3,21,19,3,12,5,0,96
21,12,3,21,19,3,21,12,5,117
21,12,5,0,0,0,0,0,0,38
21,12,5,13,1,0,0,0,0,52
21,12,5,13,1,19,0,0,0,71
21,12,5,14,20,0,0,0,0,72
21,12,5,20,9,3,0,0,0,70
21,12,5,24,9,14,5,0,0,90
21,12,5,24,9,20,5,0,0,96
21,12,5,24,9,20,5,19,0,115
21,12,9,3,15,14,0,0,0,74
21,12,9,7,9,14,15,19,5,111
21,12,9,7,9,14,15,21,19,127
21,12,9,20,9,19,0,0,0,90
21,12,12,1,7,5,0,0,0,58
21,12,12,1,7,5,4,0,0,62
21,12,12,1,7,5,19,0,0,77
21,12,12,1,7,15,14,5,0,87
21,12,12,9,14,7,0,0,0,75
21,12,12,21,3,15,0,0,0,84
21,12,12,21,3,21,0,0,0,90
21,12,13,1,3,5,15,21,19,110
21,12,13,1,20,5,0,0,0,72
21,12,13,9,3,0,0,0,0,58
21,12,13,9,14,0,0,0,0,69
21,12,13,9,14,9,3,0,0,81
21,12,13,15,0,0,0,0,0,61
21,12,13,15,21,19,0,0,0,101
21,12,14,1,0,0,0,0,0,48
21,12,14,1,4,0,0,0,0,52
21,12,14,1,5,0,0,0,0,53
21,12,14,1,7,5,0,0,0,60
21,12,14,1,18,0,0,0,0,66
21,12,14,1,18,5,0,0,0,71
21,12,14,1,18,9,1,0,0,76
21,12,14,1,19,0,0,0,0,67
21,12,15,2,15,18,9,4,0,96
21,12,15,9,4,0,0,0,0,61
21,12,15,14,3,21,19,0,0,105
21,12,15,18,18,8,1,7,25,125
21,12,15,18,18,8,5,1,0,98
21,12,15,19,5,0,0,0,0,72
21,12,15,20,18,9,3,8,25,131
21,12,15,21,19,0,0,0,0,88
21,12,16,1,14,0,0,0,0,64
21,12,16,1,14,9,13,0,0,86
21,12,18,9,3,8,9,20,5,105
21,12,19,20,5,18,5,4,0,104
21,12,19,20,5,18,9,14,7,125
21,12,19,20,5,18,19,0,0,114
21,12,20,0,0,0,0,0,0,53
21,12,20,1,0,0,0,0,0,54
21,12,20,5,18,9,15,18,0,118
21,12,20,9,13,1,3,25,0,104
21,12,20,9,13,1,19,0,0,95
21,12,20,9,13,1,20,1,0,97
21,12,20,9,13,1,20,5,0,101
21,12,20,9,13,1,20,5,4,105
21,12,20,9,13,1,20,5,19,120
21,12,20,9,13,1,20,21,13,130
21,12,20,9,13,5,0,0,0,80
21,12,20,9,13,9,20,25,0,129
21,12,20,9,13,15,0,0,0,90
21,12,20,9,13,21,13,0,0,109
21,12,20,9,15,14,0,0,0,91
21,12,20,15,0,0,0,0,0,68
21,12,20,18,1,0,0,0,0,72
21,12,20,18,1,4,18,25,0,119
21,12,20,18,1,6,1,19,20,118
21,12,20,18,1,7,15,15,4,113
21,12,20,18,1,8,9,7,8,104
21,12,20,18,1,8,15,20,0,115
21,12,20,18,1,9,19,13,0,113
21,12,20,18,1,9,19,13,19,132
21,12,20,18,1,9,19,20,0,120
21,12,20,18,1,9,19,20,19,139
21,12,20,18,1,12,15,23,0,122
21,12,20,18,1,14,5,20,0,111
21,12,20,18,1,14,9,3,5,103
21,12,20,18,1,16,21,18,5,132
21,12,20,18,1,18,5,4,0,99
21,12,20,18,1,18,5,4,19,118
21,12,20,18,1,19,0,0,0,91
21,12,20,18,1,21,7,12,25,137
21,12,20,18,1,23,9,19,5,128
21,12,21,8,9,0,0,0,0,71
21,12,21,12,1,14,20,0,0,101
21,12,21,12,1,20,5,0,0,92
21,12,21,12,1,20,5,4,0,96
21,12,21,12,1,20,5,19,0,111
21,12,21,12,1,20,9,14,7,117
21,12,21,12,1,20,9,15,14,125
21,12,21,12,1,20,9,22,5,123
21,12,21,12,1,20,15,18,25,145
21,12,21,12,21,0,0,0,0,87
21,12,21,19,0,0,0,0,0,73
21,12,22,1,3,5,15,21,19,119
21,12,22,1,19,0,0,0,0,75
21,13,2,5,3,1,19,20,0,84
21,13,2,5,3,12,1,4,0,61
21,13,2,5,12,0,0,0,0,53
21,13,2,5,12,1,16,0,0,70
21,13,2,5,12,5,4,0,0,62
21,13,2,5,12,12,1,0,0,66
21,13,2,5,12,12,1,18,0,84
21,13,2,5,12,12,1,20,5,91
21,13,2,5,12,12,5,4,0,74
21,13,2,5,12,12,5,20,0,90
21,13,2,5,12,12,5,20,19,109
21,13,2,5,12,12,9,3,0,77
21,13,2,5,12,12,15,9,4,93
21,13,2,5,12,12,21,12,5,103
21,13,2,5,12,19,0,0,0,72
21,13,2,5,12,23,15,18,20,129
21,13,2,5,18,0,0,0,0,59
21,13,2,5,18,5,4,0,0,68
21,13,2,5,18,9,13,1,0,82
21,13,2,5,18,9,14,7,0,89
21,13,2,5,18,19,0,0,0,78
21,13,2,5,18,20,25,0,0,104
21,13,2,5,19,5,20,0,0,85
21,13,2,5,20,8,9,14,11,103
21,13,2,9,12,9,3,0,0,69
21,13,2,9,12,9,3,1,12,82
21,13,2,9,12,9,3,1,18,88
21,13,2,9,12,9,3,9,0,78
21,13,2,9,12,9,3,21,19,109
21,13,2,9,12,18,15,15,20,125
21,13,2,12,5,0,0,0,0,53
21,13,2,12,5,19,0,0,0,72
21,13,2,15,0,0,0,0,0,51
21,13,2,15,14,1,12,0,0,78
21,13,2,15,14,1,20,5,0,91
21,13,2,15,14,1,20,5,4,95
21,13,2,15,14,5,0,0,0,70
21,13,2,15,14,5,19,0,0,89
21,13,2,15,14,9,1,12,0,87
21,13,2,15,14,9,3,0,0,77
21,13,2,15,14,21,12,5,0,103
21,13,2,15,19,0,0,0,0,70
21,13,2,18,1,3,12,5,0,75
21,13,2,18,1,5,0,0,0,60
21,13,2,18,1,7,5,0,0,67
21,13,2,18,1,7,5,19,0,86
21,13,2,18,1,9,4,0,0,68
21,13,2,18,1,12,0,0,0,67
21,13,2,18,1,12,12,25,0,104
21,13,2,18,1,14,1,0,0,70
21,13,2,18,1,19,0,0,0,74
21,13,2,18,1,20,5,0,0,80
21,13,2,18,1,20,5,4,0,84
21,13,2,18,1,20,9,3,0,87
21,13,2,18,1,20,9,12,5,101
21,13,2,18,5,0,0,0,0,59
21,13,2,18,5,12,0,0,0,71
21,13,2,18,5,12,12,1,0,84
21,13,2,18,5,12,12,1,19,103
21,13,2,18,5,18,5,0,0,82
21,13,2,18,5,20,0,0,0,79
21,13,2,18,5,20,20,5,0,104
21,13,2,18,5,20,20,5,19,123
21,13,2,18,9,12,0,0,0,75
21,13,2,18,9,14,1,0,0,78
21,13,2,18,9,14,5,0,0,82
21,13,2,18,15,19,5,0,0,93
21,13,2,18,15,19,9,20,25,142
21,13,2,18,15,21,19,0,0,109
21,13,5,19,20,0,0,0,0,78
21,13,6,1,1,14,0,0,0,56
21,13,7,1,14,7,0,0,0,63
21,13,9,1,3,0,0,0,0,47
21,13,9,1,3,11,0,0,0,58
21,13,9,1,3,11,19,0,0,77
21,13,9,1,3,19,0,0,0,66
21,13,9,1,11,0,0,0,0,55
21,13,9,1,11,19,0,0,0,74
21,13,9,1,17,0,0,0,0,61
21,13,9,1,17,19,0,0,0,80
21,13,9,13,16,5,4,5,4,90
21,13,9,18,9,0,0,0,0,70
21,13,9,19,20,0,0,0,0,82
21,13,12,1,14,4,0,0,0,65
21,13,12,1,21,20,0,0,0,88
21,13,12,1,21,20,5,4,0,97
21,13,12,1,21,20,9,14,7,118
21,13,12,1,21,20,19,0,0,107
21,13,12,15,1,4,0,0,0,66
21,13,13,0,0,0,0,0,0,47
21,13,13,16,19,0,0,0,0,82
21,13,15,21,8,9,12,5,0,104
21,13,16,0,0,0,0,0,0,50
21,13,16,5,4,0,0,0,0,59
21,13,16,8,0,0,0,0,0,58
21,13,16,25,0,0,0,0,0,75
21,13,16,9,14,7,0,0,0,80
21,13,16,9,18,1,7,5,0,90
21,13,16,9,18,1,7,5,19,109
21,13,16,9,18,5,0,0,0,82
21,13,16,9,18,5,4,0,0,86
21,13,16,9,18,5,18,0,0,100
21,13,16,9,18,5,19,0,0,101
21,13,16,9,18,5,19,19,0,120
21,13,16,9,18,9,14,7,0,107
21,13,16,9,18,9,19,13,0,118
21,13,16,16,9,18,5,4,0,102
21,13,16,16,9,18,9,14,7,123
21,13,16,19,0,0,0,0,0,69
21,13,16,19,20,5,5,14,0,113
21,13,16,20,5,5,14,0,0,94
21,13,16,20,5,5,14,19,0,113
21,13,16,20,5,5,14,20,8,122
21,13,16,20,5,11,9,20,5,120
21,13,16,20,25,0,0,0,0,95
21,13,16,20,9,5,20,8,0,112
21,13,17,21,8,9,12,5,0,106
21,13,19,5,20,0,0,0,0,78
21,13,19,20,18,15,11,5,0,122
21,13,20,5,5,14,0,0,0,78
21,13,20,5,5,14,20,8,0,106
21,13,21,0,0,0,0,0,0,55
21,14,2,0,0,0,0,0,0,37
21,14,2,1,3,11,5,4,0,61
21,14,2,1,4,7,5,4,0,58
21,14,2,1,6,6,12,5,4,71
21,14,2,1,7,0,0,0,0,45
21,14,2,1,7,7,5,4,0,61
21,14,2,1,25,0,0,0,0,63
21,14,2,1,9,12,5,4,0,68
21,14,2,1,9,14,0,0,0,61
21,14,2,1,9,20,0,0,0,67
21,14,2,1,9,20,5,4,0,76
21,14,2,1,9,26,5,4,0,82
21,14,2,1,11,5,4,0,0,58
21,14,2,1,12,1,14,3,5,73
21,14,2,1,12,5,0,0,0,55
21,14,2,1,12,5,4,0,0,59
21,14,2,1,12,9,14,7,0,80
21,14,2,1,12,11,5,4,0,70
21,14,2,1,12,11,9,14,7,91
21,14,2,1,12,12,1,19,20,102
21,14,2,1,14,4,1,7,5,69
21,14,2,1,14,4,5,4,0,65
21,14,2,1,14,5,0,0,0,57
21,14,2,1,14,7,12,5,4,80
21,14,2,1,14,11,0,0,0,63
21,14,2,1,14,11,5,4,0,72
21,14,2,1,14,14,5,4,0,75
21,14,2,1,16,20,9,26,5,114
21,14,2,1,18,0,0,0,0,56
21,14,2,1,18,2,0,0,0,58
21,14,2,1,18,2,5,4,0,67
21,14,2,1,18,4,5,4,0,69
21,14,2,1,18,5,0,0,0,61
21,14,2,1,18,11,0,0,0,67
21,14,2,1,18,11,9,14,7,97
21,14,2,1,18,15,14,5,20,110
21,14,2,1,18,18,5,4,0,83
21,14,2,1,18,18,5,12,0,91
21,14,2,1,18,18,5,14,0,93
21,14,2,1,18,18,9,14,7,104
21,14,2,1,18,19,0,0,0,75
21,14,2,1,19,5,0,0,0,62
21,14,2,1,19,5,4,0,0,66
21,14,2,1,19,8,6,21,12,104
21,14,2,1,19,11,5,20,0,93
21,14,2,1,19,20,5,0,0,82
21,14,2,1,19,20,5,4,0,86
21,14,2,1,20,5,4,0,0,67
21,14,2,1,20,8,5,4,0,75
21,14,2,1,20,9,14,7,0,88
21,14,2,1,20,20,5,4,0,87
21,14,2,1,20,20,5,14,0,97
21,14,2,5,0,0,0,0,0,42
21,14,2,5,1,3,8,5,4,63
21,14,2,5,1,4,5,4,0,56
21,14,2,5,1,13,5,4,0,65
21,14,2,5,1,13,9,14,7,86
21,14,2,5,1,18,0,0,0,61
21,14,2,5,1,18,4,0,0,65
21,14,2,5,1,18,4,5,4,74
21,14,2,5,1,18,5,4,0,70
21,14,2,5,1,18,9,14,7,91
21,14,2,5,1,18,19,0,0,80
21,14,2,5,1,19,20,0,0,82
21,14,2,5,1,20,5,14,0,82
21,14,2,5,1,21,5,4,0,73
21,14,2,5,3,15,13,5,0,78
21,14,2,5,4,0,0,0,0,46
21,14,2,5,4,4,5,4,0,59
21,14,2,5,4,5,23,5,4,83
21,14,2,5,6,9,20,0,0,77
21,14,2,5,6,15,15,12,0,90
21,14,2,5,7,5,20,0,0,74
21,14,2,5,7,7,1,18,0,75
21,14,2,5,7,7,5,4,0,65
21,14,2,5,7,9,12,20,0,90
21,14,2,5,7,9,18,20,0,96
21,14,2,5,7,15,20,0,0,84
21,14,2,5,7,21,9,12,5,96
21,14,2,5,7,21,14,0,0,84
21,14,2,5,8,5,12,4,0,71
21,14,2,5,9,14,7,0,0,72
21,14,2,5,11,14,15,23,14,119
21,14,2,5,12,9,5,4,0,72
21,14,2,5,12,9,5,6,0,74
21,14,2,5,12,9,5,6,19,93
21,14,2,5,12,9,5,22,5,95
21,14,2,5,12,12,0,0,0,66
21,14,2,5,12,15,22,5,4,100
21,14,2,5,12,20,0,0,0,74
21,14,2,5,12,20,5,4,0,83
21,14,2,5,12,20,9,14,7,104
21,14,2,5,12,20,19,0,0,93
21,14,2,5,14,3,8,0,0,67
21,14,2,5,14,4,0,0,0,60
21,14,2,5,14,4,5,4,0,69
21,14,2,5,14,4,5,18,0,83
21,14,2,5,14,4,9,14,7,90
21,14,2,5,14,4,19,0,0,79
21,14,2,5,14,9,7,8,20,100
21,14,2,5,14,9,7,14,0,86
21,14,2,5,14,20,0,0,0,76
21,14,2,5,14,21,13,2,0,92
21,14,2,5,18,5,6,20,0,91
21,14,2,5,18,20,8,0,0,88
21,14,2,5,18,21,6,5,14,106
21,14,2,5,19,5,5,13,0,84
21,14,2,5,19,5,20,0,0,86
21,14,2,5,19,15,20,0,0,96
21,14,2,5,19,16,5,1,11,94
21,14,2,5,19,16,15,11,5,108
21,14,2,5,20,0,0,0,0,62
21,14,2,5,20,8,9,14,11,104
21,14,2,5,20,9,4,5,0,80
21,14,2,5,20,15,11,5,14,107
21,14,2,5,20,18,1,25,0,106
21,14,2,5,22,5,12,5,4,90
21,14,2,5,23,1,18,5,0,89
21,14,2,5,23,9,20,3,8,105
21,14,2,9,1,19,0,0,0,66
21,14,2,9,1,19,5,4,0,75
21,14,2,9,1,19,9,14,7,96
21,14,2,9,1,19,19,5,4,94
21,14,2,9,4,0,0,0,0,50
21,14,2,9,4,1,2,12,5,70
21,14,2,9,4,4,5,14,0,73
21,14,2,9,7,7,5,4,0,69
21,14,2,9,7,15,20,5,4,97
21,14,2,9,12,9,15,21,19,122
21,14,2,9,12,12,5,4,0,79
21,14,2,9,12,12,5,20,0,95
21,14,2,9,14,4,0,0,0,64
21,14,2,9,14,4,9,14,7,94
21,14,2,9,14,4,19,0,0,83
21,14,2,9,14,14,5,4,0,83
21,14,2,9,18,4,12,25,0,105
21,14,2,9,19,8,15,16,0,104
21,14,2,9,20,0,0,0,0,66
21,14,2,9,20,9,14,7,0,96
21,14,2,9,20,20,0,0,0,86
21,14,2,9,20,20,5,4,0,95
21,14,2,9,20,20,5,14,0,105
21,14,2,9,20,20,5,18,0,109
21,14,2,9,20,20,9,14,7,116
21,14,2,12,1,3,11,5,4,73
21,14,2,12,1,4,5,0,0,59
21,14,2,12,1,4,5,4,0,63
21,14,2,12,1,4,9,14,7,84
21,14,2,12,1,13,5,4,0,72
21,14,2,12,1,13,9,14,7,93
21,14,2,12,1,19,20,5,4,98
21,14,2,12,5,4,0,0,0,58
21,14,2,12,5,14,4,5,4,81
21,14,2,12,5,14,20,0,0,88
21,14,2,12,5,19,19,0,0,92
21,14,2,12,5,19,19,5,4,101
21,14,2,12,5,19,20,0,0,93
21,14,2,12,9,14,4,0,0,76
21,14,2,12,9,14,4,5,4,85
21,14,2,12,9,19,19,0,0,96
21,14,2,12,9,20,8,5,0,91
21,14,2,12,15,3,11,0,0,78
21,14,2,12,15,3,11,5,4,87
21,14,2,12,15,3,11,19,0,97
21,14,2,12,15,15,4,5,4,92
21,14,2,12,15,15,4,25,0,108
21,14,2,12,15,15,13,0,0,92
21,14,2,12,15,15,13,5,4,101
21,14,2,12,15,20,20,5,4,113
21,14,2,12,15,21,19,5,4,113
21,14,2,12,15,23,14,0,0,101
21,14,2,12,21,5,4,0,0,79
21,14,2,12,21,6,6,5,4,91
21,14,2,12,21,14,4,5,18,111
21,14,2,12,21,14,20,5,4,113
21,14,2,12,21,18,18,5,4,115
21,14,2,12,21,19,8,0,0,97
21,14,2,15,1,18,4,5,4,84
21,14,2,15,1,19,20,5,4,101
21,14,2,15,1,20,0,0,0,73
21,14,2,15,2,2,5,4,0,65
21,14,2,15,4,25,0,0,0,81
21,14,2,15,4,9,5,4,0,74
21,14,2,15,4,9,12,25,0,102
21,14,2,15,4,9,14,7,0,86
21,14,2,15,7,0,0,0,0,59
21,14,2,15,7,7,25,0,0,91
21,14,2,15,25,0,0,0,0,77
21,14,2,15,25,9,19,8,0,113
21,14,2,15,9,12,5,4,0,82
21,14,2,15,25,12,9,11,5,114
21,14,2,15,11,5,12,0,0,80
21,14,2,15,12,4,0,0,0,68
21,14,2,15,12,4,5,14,0,87
21,14,2,15,12,4,12,25,0,105
21,14,2,15,12,12,5,4,0,85
21,14,2,15,12,19,20,5,18,126
21,14,2,15,12,20,0,0,0,84
21,14,2,15,12,20,5,4,0,93
21,14,2,15,12,20,9,14,7,114
21,14,2,15,12,20,19,0,0,103
21,14,2,15,13,2,1,19,20,107
21,14,2,15,13,2,5,4,0,76
21,14,2,15,14,4,5,4,0,79
21,14,2,15,14,5,0,0,0,71
21,14,2,15,14,5,4,0,0,75
21,14,2,15,14,14,5,20,0,105
21,14,2,15,14,14,5,20,19,124
21,14,2,15,14,14,25,0,0,105
21,14,2,15,15,11,5,4,0,87
21,14,2,15,15,11,9,19,8,114
21,14,2,15,15,20,0,0,0,87
21,14,2,15,15,20,5,4,0,96
21,14,2,15,18,1,24,5,4,104
21,14,2,15,18,4,5,18,0,97
21,14,2,15,18,5,4,0,0,79
21,14,2,15,18,9,14,7,0,100
21,14,2,15,18,14,0,0,0,84
21,14,2,15,18,14,5,0,0,89
21,14,2,15,18,15,21,7,8,121
21,14,2,15,19,15,13,0,0,99
21,14,2,15,19,15,13,5,4,108
21,14,2,15,19,15,13,5,18,122
21,14,2,15,19,15,13,19,0,118
21,14,2,15,19,19,5,4,0,99
21,14,2,15,20,20,12,5,0,109
21,14,2,15,20,20,12,5,4,113
21,14,2,15,20,20,15,13,0,120
21,14,2,15,21,7,8,20,0,108
21,14,2,15,21,14,3,25,0,115
21,14,2,15,21,14,4,0,0,91
21,14,2,15,21,14,4,5,4,100
21,14,2,15,23,0,0,0,0,75
21,14,2,15,23,1,2,12,5,95
21,14,2,15,23,5,4,0,0,84
21,14,2,15,23,5,12,0,0,92
21,14,2,15,23,5,12,5,4,101
21,14,2,15,23,5,18,5,4,107
21,14,2,15,23,9,14,7,0,105
21,14,2,15,23,12,5,4,0,96
21,14,2,15,23,19,15,13,5,127
21,14,2,15,24,0,0,0,0,76
21,14,2,15,24,5,4,0,0,85
21,14,2,15,24,5,19,0,0,100
21,14,2,15,24,9,14,7,0,106
21,14,2,18,1,3,5,0,0,64
21,14,2,18,1,3,5,4,0,68
21,14,2,18,1,3,5,19,0,83
21,14,2,18,1,3,9,14,7,89
21,14,2,18,1,7,7,5,4,79
21,14,2,18,1,9,4,0,0,69
21,14,2,18,1,9,4,5,4,78
21,14,2,18,1,9,4,19,0,88
21,14,2,18,1,9,12,5,4,86
21,14,2,18,1,9,14,5,4,88
21,14,2,18,1,11,5,0,0,72
21,14,2,18,1,11,5,4,0,76
21,14,2,18,1,11,5,19,0,91
21,14,2,18,1,14,0,0,0,70
21,14,2,18,1,14,4,0,0,74
21,14,2,18,1,14,4,5,4,83
21,14,2,18,1,22,5,0,0,83
21,14,2,18,1,22,5,4,0,87
21,14,2,18,1,22,5,12,25,120
21,14,2,18,1,23,14,25,0,118
21,14,2,18,1,26,5,0,0,87
21,14,2,18,1,26,5,14,0,101
21,14,2,18,5,1,4,5,4,74
21,14,2,18,5,1,19,20,0,100
21,14,2,18,5,1,20,8,0,89
21,14,2,18,5,4,0,0,0,64
21,14,2,18,5,5,3,8,0,76
21,14,2,18,5,5,26,25,0,116
21,14,2,18,5,14,20,0,0,94
21,14,2,18,5,23,5,4,0,92
21,14,2,18,9,2,5,4,0,75
21,14,2,18,9,2,9,14,7,96
21,14,2,18,9,3,11,0,0,78
21,14,2,18,9,3,11,5,4,87
21,14,2,18,9,4,7,5,4,84
21,14,2,18,9,4,12,5,0,85
21,14,2,18,9,4,12,5,4,89
21,14,2,18,9,4,12,5,19,104
21,14,2,18,9,5,6,0,0,75
21,14,2,18,9,5,6,5,4,84
21,14,2,18,9,5,6,12,25,112
21,14,2,18,9,7,8,20,0,99
21,14,2,18,9,14,5,4,0,87
21,14,2,18,9,20,20,12,5,121
21,14,2,18,15,1,4,0,0,75
21,14,2,18,15,9,4,0,0,83
21,14,2,18,15,9,12,5,4,100
21,14,2,18,15,11,5,0,0,86
21,14,2,18,15,11,5,14,0,100
21,14,2,18,15,14,26,5,4,119
21,14,2,18,15,15,3,8,0,96
21,14,2,18,15,15,4,5,4,98
21,14,2,18,15,21,7,8,20,126
21,14,2,18,15,23,14,0,0,107
21,14,2,18,15,23,14,5,4,116
21,14,2,18,21,9,19,5,4,113
21,14,2,18,21,19,8,5,4,112
21,14,2,18,21,20,5,0,0,101
21,14,2,18,21,20,9,6,25,136
21,14,2,18,21,20,9,19,5,129
21,14,2,18,21,20,9,26,5,136
21,14,2,21,3,11,12,5,0,89
21,14,2,21,3,11,12,5,4,93
21,14,2,21,3,11,12,5,19,108
21,14,2,21,4,0,0,0,0,62
21,14,2,21,4,4,5,4,0,75
21,14,2,21,4,4,9,14,7,96
21,14,2,21,4,7,5,4,0,78
21,14,2,21,4,7,9,14,7,99
21,14,2,21,6,6,5,4,0,79
21,14,2,21,25,1,2,12,5,103
21,14,2,21,25,9,14,7,0,113
21,14,2,21,9,12,4,0,0,83
21,14,2,21,9,12,4,5,4,92
21,14,2,21,9,12,4,19,0,102
21,14,2,21,9,12,20,0,0,99
21,14,2,21,12,11,25,0,0,106
21,14,2,21,12,12,5,4,0,91
21,14,2,21,12,12,9,5,4,100
21,14,2,21,13,16,5,4,0,96
21,14,2,21,14,3,8,5,4,92
21,14,2,21,14,4,12,5,0,93
21,14,2,21,14,4,12,5,4,97
21,14,2,21,14,4,12,5,19,112
21,14,2,21,14,7,0,0,0,79
21,14,2,21,15,25,1,14,20,133
21,14,2,21,15,25,5,4,0,107
21,14,2,21,18,4,5,14,0,99
21,14,2,21,18,4,5,14,19,118
21,14,2,21,18,25,0,0,0,101
21,14,2,21,18,9,1,12,0,98
21,14,2,21,18,9,5,4,0,94
21,14,2,21,18,12,25,0,0,113
21,14,2,21,18,14,0,0,0,90
21,14,2,21,18,14,5,4,0,99
21,14,2,21,18,14,9,14,7,120
21,14,2,21,18,14,20,0,0,110
21,14,2,21,18,18,15,23,0,132
21,14,2,21,18,19,20,0,0,115
21,14,2,21,18,20,8,5,14,123
21,14,2,21,19,8,0,0,0,85
21,14,2,21,19,25,0,0,0,102
21,14,2,21,19,9,5,4,0,95
21,14,2,21,19,9,12,25,0,123
21,14,2,21,19,11,0,0,0,88
21,14,2,21,19,11,9,14,0,111
21,14,2,21,19,20,5,4,0,106
21,14,2,21,20,20,15,14,0,127
21,14,2,21,20,20,15,14,19,146
21,14,2,21,24,15,13,0,0,110
21,14,2,21,24,15,13,12,25,147
21,14,3,0,0,0,0,0,0,38
21,14,3,1,0,0,0,0,0,39
21,14,3,1,2,9,14,5,4,73
21,14,3,1,2,12,5,4,0,62
21,14,3,1,7,5,0,0,0,51
21,14,3,1,7,5,4,0,0,55
21,14,3,1,7,5,19,0,0,70
21,14,3,1,7,9,14,7,0,76
21,14,3,1,11,5,0,0,0,55
21,14,3,1,11,5,4,0,0,59
21,14,3,1,11,5,19,0,0,74
21,14,3,1,11,9,14,7,0,80
21,14,3,1,12,11,0,0,0,62
21,14,3,1,12,11,5,4,0,71
21,14,3,1,12,12,0,0,0,63
21,14,3,1,12,12,5,4,0,72
21,14,3,1,12,12,15,21,19,118
21,14,3,1,12,12,15,23,0,101
21,14,3,1,12,13,0,0,0,64
21,14,3,1,12,13,5,4,0,73
21,14,3,1,12,13,12,25,0,101
21,14,3,1,13,16,0,0,0,68
21,14,3,1,13,16,5,4,0,77
21,14,3,1,14,4,9,4,0,70
21,14,3,1,14,4,9,5,4,75
21,14,3,1,14,4,12,5,4,78
21,14,3,1,14,4,15,18,0,90
21,14,3,1,14,4,15,21,18,111
21,14,3,1,14,5,4,0,0,62
21,14,3,1,14,14,5,4,0,76
21,14,3,1,14,14,25,0,0,92
21,14,3,1,14,14,9,5,18,99
21,14,3,1,14,14,9,12,25,113
21,14,3,1,14,15,14,9,3,94
21,14,3,1,16,0,0,0,0,55
21,14,3,1,16,1,2,12,5,75
21,14,3,1,16,1,2,12,25,95
21,14,3,1,16,5,4,0,0,64
21,14,3,1,16,16,5,4,0,80
21,14,3,1,16,16,5,18,0,94
21,14,3,1,16,16,9,14,7,101
21,14,3,1,16,19,0,0,0,74
21,14,3,1,18,4,5,4,0,70
21,14,3,1,18,5,6,21,12,101
21,14,3,1,18,7,15,5,4,88
21,14,3,1,18,9,14,7,0,87
21,14,3,1,18,14,1,20,5,97
21,14,3,1,18,15,12,5,4,93
21,14,3,1,18,18,9,5,4,93
21,14,3,1,18,20,0,0,0,77
21,14,3,1,18,20,5,4,0,86
21,14,3,1,18,22,5,4,0,88
21,14,3,1,19,5,0,0,0,63
21,14,3,1,19,5,4,0,0,67
21,14,3,1,19,5,19,0,0,82
21,14,3,1,19,8,5,4,0,75
21,14,3,1,19,9,14,7,0,88
21,14,3,1,19,11,0,0,0,69
21,14,3,1,19,11,5,4,0,78
21,14,3,1,19,17,21,5,0,101
21,14,3,1,19,19,15,3,11,106
21,14,3,1,19,20,0,0,0,78
21,14,3,1,19,20,5,0,0,83
21,14,3,1,19,20,12,5,0,95
21,14,3,1,19,20,12,5,4,99
21,14,3,1,19,21,1,12,0,92
21,14,3,1,20,3,8,25,0,95
21,14,3,1,20,5,0,0,0,64
21,14,3,1,20,5,18,5,4,91
21,14,3,1,21,7,8,20,0,95
21,14,3,1,21,19,1,12,0,92
21,14,3,1,21,19,5,0,0,84
21,14,3,1,21,19,5,4,0,88
21,14,3,1,21,19,20,9,3,111
21,14,3,1,22,5,0,0,0,66
21,14,3,5,1,19,5,4,0,72
21,14,3,5,1,19,9,14,7,93
21,14,3,5,4,5,4,0,0,56
21,14,3,5,9,12,5,4,0,73
21,14,3,5,12,12,1,18,0,86
21,14,3,5,13,5,14,20,0,95
21,14,3,5,14,20,5,18,0,100
21,14,3,5,14,20,18,1,12,108
21,14,3,5,14,20,18,5,0,100
21,14,3,5,14,20,18,5,4,104
21,14,3,5,14,20,18,9,3,107
21,14,3,5,14,20,21,18,25,141
21,14,3,5,18,1,20,5,4,91
21,14,3,5,18,20,1,9,14,105
21,14,3,5,19,19,1,14,20,116
21,14,3,8,1,6,5,4,0,62
21,14,3,8,1,6,6,5,4,68
21,14,3,8,1,9,14,0,0,70
21,14,3,8,1,9,14,5,4,79
21,14,3,8,1,9,14,19,0,89
21,14,3,8,1,9,18,0,0,74
21,14,3,8,1,9,18,5,4,83
21,14,3,8,1,12,11,5,4,79
21,14,3,8,1,12,11,25,0,95
21,14,3,8,1,14,3,5,0,69
21,14,3,8,1,14,3,5,4,73
21,14,3,8,1,14,3,25,0,89
21,14,3,8,1,14,7,5,0,73
21,14,3,8,1,14,7,5,4,77
21,14,3,8,1,14,20,5,4,90
21,14,3,8,1,15,20,9,3,94
21,14,3,8,1,16,16,5,4,88
21,14,3,8,1,16,20,5,18,106
21,14,3,8,1,18,7,5,0,77
21,14,3,8,1,18,7,5,4,81
21,14,3,8,1,18,7,5,19,96
21,14,3,8,1,18,25,0,0,90
21,14,3,8,1,18,9,12,25,111
21,14,3,8,1,18,9,15,20,109
21,14,3,8,1,18,9,20,25,119
21,14,3,8,1,18,13,0,0,78
21,14,3,8,1,18,13,5,4,87
21,14,3,8,1,18,14,5,12,96
21,14,3,8,1,18,18,5,4,92
21,14,3,8,1,18,20,5,4,94
21,14,3,8,1,19,5,4,0,75
21,14,3,8,1,19,20,5,0,91
21,14,3,8,1,23,5,4,0,79
21,14,3,8,5,1,16,12,25,105
21,14,3,8,5,1,20,0,0,72
21,14,3,8,5,1,20,5,4,81
21,14,3,8,5,3,11,0,0,65
21,14,3,8,5,3,11,5,4,74
21,14,3,8,5,5,18,5,4,83
21,14,3,8,5,5,18,25,0,99
21,14,3,8,5,19,20,5,4,99
21,14,3,8,5,23,5,4,0,83
21,14,3,8,9,3,0,0,0,58
21,14,3,8,9,3,12,25,0,95
21,14,3,8,9,4,0,0,0,59
21,14,3,8,9,4,4,5,14,82
21,14,3,8,9,4,5,4,0,68
21,14,3,8,9,4,9,14,7,89
21,14,3,8,9,12,4,0,0,71
21,14,3,8,9,12,12,5,4,88
21,14,3,8,9,13,9,14,7,98
21,14,3,8,9,14,11,5,4,89
21,14,3,8,9,16,16,5,4,96
21,14,3,8,15,11,5,0,0,77
21,14,3,8,15,11,5,4,0,81
21,14,3,8,15,11,5,19,0,96
21,14,3,8,15,11,9,14,7,102
21,14,3,8,15,16,16,5,4,102
21,14,3,8,15,18,1,12,0,92
21,14,3,8,15,18,4,5,4,92
21,14,3,8,15,19,5,14,0,99
21,14,3,8,18,9,19,15,13,120
21,14,3,8,18,9,19,20,0,112
21,14,3,8,18,15,13,5,4,101
21,14,3,8,18,15,14,9,3,105
21,14,3,8,21,18,3,8,0,96
21,14,3,8,21,18,14,0,0,99
21,14,3,8,21,18,14,5,4,108
21,14,3,9,0,0,0,0,0,47
21,14,3,9,1,0,0,0,0,48
21,14,3,9,1,5,0,0,0,53
21,14,3,9,1,12,0,0,0,60
21,14,3,9,1,12,9,26,5,100
21,14,3,9,1,12,12,25,0,97
21,14,3,9,1,12,19,0,0,79
21,14,3,9,1,20,9,13,0,90
21,14,3,9,6,15,18,13,0,99
21,14,3,9,6,15,18,13,19,118
21,14,3,9,14,1,12,0,0,74
21,14,3,9,14,1,20,5,0,87
21,14,3,9,14,1,20,5,4,91
21,14,3,9,14,1,20,21,13,116
21,14,3,9,14,3,8,0,0,72
21,14,3,9,14,3,20,0,0,84
21,14,3,9,14,9,0,0,0,70
21,14,3,25,14,9,3,1,12,102
21,14,3,9,14,21,19,0,0,101
21,14,3,9,16,8,5,18,0,94
21,14,3,25,16,18,5,19,19,140
21,14,3,9,18,3,12,5,4,89
21,14,3,9,20,1,2,12,5,87
21,14,3,9,20,5,0,0,0,72
21,14,3,9,20,5,4,0,0,76
21,14,3,9,20,25,0,0,0,92
21,14,3,9,20,9,5,4,0,85
21,14,3,9,20,9,26,5,14,121
21,14,3,9,22,9,3,0,0,81
21,14,3,9,22,9,12,0,0,90
21,14,3,9,22,9,12,12,25,127
21,14,3,12,1,4,0,0,0,55
21,14,3,12,1,25,0,0,0,76
21,14,3,12,1,25,5,4,0,85
21,14,3,12,1,9,13,5,4,82
21,14,3,12,1,13,16,0,0,80
21,14,3,12,1,13,16,5,4,89
21,14,3,12,1,13,16,19,0,99
21,14,3,12,1,18,9,20,25,123
21,14,3,12,1,19,16,0,0,86
21,14,3,12,1,19,16,5,4,95
21,14,3,12,1,19,16,19,0,105
21,14,3,12,1,19,19,5,4,98
21,14,3,12,1,23,5,4,0,83
21,14,3,12,5,1,4,0,0,60
21,14,3,12,5,1,14,0,0,70
21,14,3,12,5,1,14,5,4,79
21,14,3,12,5,1,14,5,18,93
21,14,3,12,5,1,14,12,25,107
21,14,3,12,5,1,14,19,5,94
21,14,3,12,5,1,18,0,0,74
21,14,3,12,5,1,18,5,4,83
21,14,3,12,5,1,18,5,18,97
21,14,3,12,5,1,18,12,25,111
21,14,3,12,5,1,22,5,0,83
21,14,3,12,5,4,15,13,0,87
21,14,3,12,5,6,20,0,0,81
21,14,3,12,5,8,15,15,4,97
21,14,3,12,5,13,5,14,20,107
21,14,3,12,5,14,3,8,0,80
21,14,3,12,5,18,7,25,0,105
21,14,3,12,5,18,11,12,25,121
21,14,3,12,5,19,0,0,0,74
21,14,3,12,5,19,8,9,16,107
21,14,3,12,5,22,5,18,0,100
21,14,3,12,5,23,0,0,0,78
21,14,3,12,9,3,11,0,0,73
21,14,3,12,9,6,25,0,0,90
21,14,3,12,9,13,2,0,0,74
21,14,3,12,9,13,2,5,4,83
21,14,3,12,9,14,3,8,0,84
21,14,3,12,9,14,7,0,0,80
21,14,3,12,9,16,0,0,0,75
21,14,3,12,9,16,16,5,4,100
21,14,3,12,9,16,16,5,18,114
21,14,3,12,9,16,19,0,0,94
21,14,3,12,15,1,11,0,0,77
21,14,3,12,15,1,11,5,4,86
21,14,3,12,15,1,11,19,0,96
21,14,3,12,15,7,0,0,0,72
21,14,3,12,15,7,7,5,4,88
21,14,3,12,15,7,19,0,0,91
21,14,3,12,15,25,5,4,0,99
21,14,3,12,15,25,9,14,7,120
21,14,3,12,15,19,5,0,0,89
21,14,3,12,15,19,5,4,0,93
21,14,3,12,15,19,5,19,0,108
21,14,3,12,15,19,9,14,7,114
21,14,3,12,15,20,0,0,0,85
21,14,3,12,15,20,8,5,0,98
21,14,3,12,15,20,8,5,4,102
21,14,3,12,15,20,8,5,19,117
21,14,3,12,15,20,20,5,4,114
21,14,3,12,15,21,4,0,0,90
21,14,3,12,15,21,4,5,4,99
21,14,3,12,15,21,4,25,0,115
21,14,3,12,15,21,4,19,0,109
21,14,3,12,15,21,20,0,0,106
21,14,3,12,15,22,5,14,0,106
21,14,3,12,21,2,0,0,0,73
21,14,3,12,21,2,2,25,0,100
21,14,3,12,21,20,3,8,0,102
21,14,3,12,21,20,20,5,18,134
21,14,3,15,0,0,0,0,0,53
21,14,3,15,1,3,8,0,0,65
21,14,3,15,1,3,8,5,4,74
21,14,3,15,1,3,20,5,4,86
21,14,3,15,1,18,19,5,0,96
21,14,3,15,1,20,0,0,0,74
21,14,3,15,1,20,5,4,0,83
21,14,3,15,1,24,1,12,0,91
21,14,3,15,1,24,5,4,0,87
21,14,3,15,1,24,9,1,12,100
21,14,3,15,1,24,9,14,7,108
21,14,3,15,2,2,12,5,4,78
21,14,3,15,3,11,0,0,0,67
21,14,3,15,3,11,5,4,0,76
21,14,3,15,3,11,9,14,7,97
21,14,3,15,3,11,19,0,0,86
21,14,3,15,3,20,5,4,0,85
21,14,3,15,4,4,5,4,0,70
21,14,3,15,4,4,12,5,4,82
21,14,3,15,4,5,4,0,0,66
21,14,3,15,5,18,3,5,4,88
21,14,3,15,6,6,5,18,0,88
21,14,3,15,6,6,9,14,0,88
21,14,3,15,6,6,9,14,19,107
21,14,3,15,6,6,12,5,0,82
21,14,3,15,6,20,0,0,0,79
21,14,3,15,7,5,14,20,0,99
21,14,3,15,7,7,5,4,0,76
21,14,3,15,25,0,0,0,0,78
21,14,3,15,9,6,0,0,0,68
21,14,3,15,9,6,5,4,0,77
21,14,3,15,9,6,6,5,4,83
21,14,3,15,9,12,0,0,0,74
21,14,3,15,9,12,5,4,0,83
21,14,3,15,25,12,25,0,0,115
21,14,3,15,9,12,9,14,7,104
21,14,3,15,9,12,19,0,0,93
21,14,3,15,9,14,0,0,0,76
21,14,3,15,9,14,5,4,0,85
21,14,3,15,25,14,5,19,19,135
21,14,3,15,11,5,4,0,0,73
21,14,3,15,11,9,14,7,0,94
21,14,3,15,12,25,0,0,0,90
21,14,3,15,12,9,11,5,0,90
21,14,3,15,12,12,1,18,0,96
21,14,3,15,12,15,18,5,4,107
21,14,3,15,12,20,0,0,0,85
21,14,3,15,13,2,5,4,0,77
21,14,3,15,13,2,9,14,5,96
21,14,3,15,13,5,0,0,0,71
21,14,3,15,13,5,12,25,0,108
21,14,3,15,13,6,25,0,0,97
21,14,3,15,13,6,15,18,20,125
21,14,3,15,13,9,3,0,0,78
21,14,3,15,13,9,3,1,12,91
21,14,3,15,13,13,15,14,0,108
21,14,3,15,13,16,1,3,20,106
21,14,3,15,13,16,1,19,19,121
21,14,3,15,13,16,12,5,24,123
21,14,3,15,13,16,20,0,0,102
21,14,3,15,14,3,5,18,14,107
21,14,3,15,14,6,5,19,19,116
21,14,3,15,14,6,9,14,5,101
21,14,3,15,14,6,9,18,13,113
21,14,3,15,14,6,15,18,13,119
21,14,3,15,14,7,5,1,12,92
21,14,3,15,14,9,3,1,12,92
21,14,3,15,14,14,5,4,0,90
21,14,3,15,14,19,5,14,20,125
21,14,3,15,14,19,21,12,20,139
21,14,3,15,14,20,5,14,20,126
21,14,3,15,14,20,18,15,12,132
21,14,3,15,14,22,5,18,20,132
21,14,3,15,15,11,5,4,0,88
21,14,3,15,15,12,0,0,0,80
21,14,3,15,15,12,5,4,0,89
21,14,3,15,15,16,0,0,0,84
21,14,3,15,15,16,5,4,0,93
21,14,3,15,15,16,9,14,7,114
21,14,3,15,16,5,0,0,0,74
21,14,3,15,16,9,5,4,0,87
21,14,3,15,16,9,15,21,19,133
21,14,3,15,18,4,0,0,0,75
21,14,3,15,18,4,5,4,0,84
21,14,3,15,18,4,9,1,12,97
21,14,3,15,18,4,9,14,7,105
21,14,3,15,18,5,0,0,0,76
21,14,3,15,18,5,4,0,0,80
21,14,3,15,18,9,14,7,0,101
21,14,3,15,18,11,0,0,0,82
21,14,3,15,18,11,5,4,0,91
21,14,3,15,18,11,5,18,0,105
21,14,3,15,18,11,9,14,7,112
21,14,3,15,18,11,19,0,0,101
21,14,3,15,18,14,5,4,0,94
21,14,3,15,18,14,5,18,0,108
21,14,3,15,18,18,5,3,20,117
21,14,3,15,18,18,21,16,20,146
21,14,3,15,18,22,5,14,0,112
21,14,3,15,19,0,0,0,0,72
21,14,3,15,19,20,0,0,0,92
21,14,3,15,19,20,12,25,0,129
21,14,3,15,21,3,8,0,0,85
21,14,3,15,21,3,8,5,4,94
21,14,3,15,21,14,20,5,4,117
21,14,3,15,21,16,12,5,0,107
21,14,3,15,21,16,12,5,4,111
21,14,3,15,21,16,12,5,18,125
21,14,3,15,21,16,12,5,19,126
21,14,3,15,21,18,19,5,4,120
21,14,3,15,21,18,20,5,4,121
21,14,3,15,21,18,20,12,25,149
21,14,3,15,21,19,0,0,0,93
21,14,3,15,21,20,8,0,0,102
21,14,3,15,21,20,8,9,5,116
21,14,3,15,21,20,8,12,25,139
21,14,3,15,22,5,18,0,0,98
21,14,3,15,22,5,18,5,4,107
21,14,3,15,22,5,18,19,0,117
21,14,3,15,22,5,20,5,4,109
21,14,3,15,23,0,0,0,0,76
21,14,3,15,23,5,4,0,0,85
21,14,3,15,23,12,0,0,0,88
21,14,3,18,1,3,11,5,4,80
21,14,3,18,1,4,12,5,4,82
21,14,3,18,1,6,20,25,0,108
21,14,3,18,1,7,7,25,0,96
21,14,3,18,1,13,0,0,0,70
21,14,3,18,1,13,16,0,0,86
21,14,3,18,1,13,16,5,4,95
21,14,3,18,1,14,11,5,4,91
21,14,3,18,1,20,5,0,0,82
21,14,3,18,1,20,5,4,0,86
21,14,3,18,1,20,5,19,0,101
21,14,3,18,1,20,9,14,7,107
21,14,3,18,1,22,5,14,0,98
21,14,3,18,1,22,9,14,7,109
21,14,3,18,1,26,5,4,0,92
21,14,3,18,1,26,25,0,0,108
21,14,3,18,5,1,13,0,0,75
21,14,3,18,5,1,19,5,4,90
21,14,3,18,5,1,20,5,0,87
21,14,3,18,5,1,20,5,4,91
21,14,3,18,5,1,20,5,19,106
21,14,3,18,5,4,9,20,0,94
21,14,3,18,5,19,20,0,0,100
21,14,3,18,5,19,20,5,4,109
21,14,3,18,9,2,0,0,0,67
21,14,3,18,9,2,2,5,4,78
21,14,3,18,9,5,4,0,0,74
21,14,3,18,25,9,14,7,0,111
21,14,3,18,9,13,5,0,0,83
21,14,3,18,9,14,11,12,5,107
21,14,3,18,9,19,16,0,0,100
21,14,3,18,15,15,11,0,0,97
21,14,3,18,15,15,11,5,4,106
21,14,3,18,15,16,16,5,4,112
21,14,3,18,15,16,20,0,0,107
21,14,3,18,15,19,19,0,0,109
21,14,3,18,15,19,19,5,4,118
21,14,3,18,15,19,19,5,19,133
21,14,3,18,15,19,19,12,25,146
21,14,3,18,15,23,4,5,4,107
21,14,3,18,15,23,14,0,0,108
21,14,3,18,15,23,14,5,4,117
21,14,3,18,15,23,14,19,0,127
21,14,3,18,21,4,4,5,4,94
21,14,3,18,21,4,5,0,0,86
21,14,3,18,21,4,5,12,25,123
21,14,3,18,21,4,9,20,25,135
21,14,3,18,21,5,12,0,0,94
21,14,3,18,21,5,12,12,25,131
21,14,3,18,21,13,16,12,5,123
21,14,3,18,21,19,8,5,4,113
21,14,3,18,21,19,20,5,4,125
21,14,3,19,0,0,0,0,0,57
21,14,3,20,0,0,0,0,0,58
21,14,3,20,9,15,14,0,0,96
21,14,3,20,9,15,14,1,12,109
21,14,3,20,9,15,14,19,0,115
21,14,3,20,9,15,21,19,0,122
21,14,3,20,15,18,9,1,14,115
21,14,3,20,15,18,9,21,13,134
21,14,3,20,21,15,19,5,0,118
21,14,3,20,21,15,21,19,0,134
21,14,3,21,2,2,5,4,0,72
21,14,3,21,2,9,3,0,0,73
21,14,3,21,2,9,3,1,12,86
21,14,3,21,3,11,15,12,4,104
21,14,3,21,6,6,5,4,0,80
21,14,3,21,12,1,18,0,0,90
21,14,3,21,12,12,5,4,0,92
21,14,3,21,12,20,5,4,0,100
21,14,3,21,12,20,21,18,5,135
21,14,3,21,13,2,5,18,0,97
21,14,3,21,14,14,9,14,7,117
21,14,3,21,16,16,5,4,0,100
21,14,3,21,18,1,2,12,5,97
21,14,3,21,18,1,2,12,25,117
21,14,3,21,18,2,0,0,0,79
21,14,3,21,18,2,5,4,0,88
21,14,3,21,18,2,9,14,7,109
21,14,3,21,18,2,19,0,0,98
21,14,3,21,18,4,0,0,0,81
21,14,3,21,18,4,12,5,4,102
21,14,3,21,18,5,4,0,0,86
21,14,3,21,18,9,15,21,19,141
21,14,3,21,18,12,0,0,0,89
21,14,3,21,18,12,5,4,0,98
21,14,3,21,18,12,9,14,7,119
21,14,3,21,18,12,19,0,0,108
21,14,3,21,18,18,5,14,20,134
21,14,3,21,18,18,9,5,4,113
21,14,3,21,18,19,5,0,0,101
21,14,3,21,18,19,5,4,0,105
21,14,3,21,18,19,9,14,7,126
21,14,3,21,18,19,20,0,0,116
21,14,3,21,18,20,1,9,14,121
21,14,3,21,18,22,5,4,0,108
21,14,3,21,18,22,9,14,7,129
21,14,3,21,19,0,0,0,0,78
21,14,3,21,19,16,5,4,0,103
21,14,3,21,20,0,0,0,0,79
21,14,3,21,20,5,0,0,0,84
21,14,3,21,20,8,0,0,0,87
21,14,4,1,2,2,12,5,4,65
21,14,4,1,7,7,12,5,4,75
21,14,4,1,9,12,25,0,0,86
21,14,4,1,9,14,20,25,0,108
21,14,4,1,13,0,0,0,0,53
21,14,4,1,13,1,7,5,4,70
21,14,4,1,13,13,5,4,0,75
21,14,4,1,13,13,9,14,7,96
21,14,4,1,13,14,0,0,0,67
21,14,4,1,13,16,5,4,0,78
21,14,4,1,14,3,9,14,7,87
21,14,4,1,14,4,12,5,4,79
21,14,4,1,16,16,5,18,0,95
21,14,4,1,16,16,12,5,4,93
21,14,4,1,18,5,4,0,0,67
21,14,4,1,18,9,14,7,0,88
21,14,4,1,18,11,0,0,0,69
21,14,4,1,18,11,5,14,0,88
21,14,4,1,18,14,5,4,0,81
21,14,4,1,19,8,5,4,0,76
21,14,4,1,20,1,2,12,5,80
21,14,4,1,20,5,0,0,0,65
21,14,4,1,20,5,4,0,0,69
21,14,4,1,21,2,0,0,0,63
21,14,4,1,21,2,5,4,0,72
21,14,4,1,21,14,20,5,4,104
21,14,4,1,23,14,5,4,0,86
21,14,4,1,23,14,9,14,7,107
21,14,4,1,26,5,4,0,0,75
21,14,4,1,26,9,14,7,0,96
21,14,4,1,26,26,12,5,0,109
21,14,4,1,26,26,12,5,4,113
21,14,4,5,0,0,0,0,0,44
21,14,4,5,1,4,0,0,0,49
21,14,4,5,1,4,12,25,0,86
21,14,4,5,1,6,0,0,0,51
21,14,4,5,1,12,20,0,0,77
21,14,4,5,1,14,0,0,0,59
21,14,4,5,1,18,0,0,0,63
21,14,4,5,2,1,19,5,4,75
21,14,4,5,2,1,20,5,4,76
21,14,4,5,2,9,20,5,4,84
21,14,4,5,3,1,7,15,14,84
21,14,4,5,3,1,25,5,4,82
21,14,4,5,3,1,14,5,0,67
21,14,4,5,3,5,9,22,5,88
21,14,4,5,3,5,14,3,25,94
21,14,4,5,3,5,14,20,0,86
21,14,4,5,3,9,4,5,0,65
21,14,4,5,3,9,4,5,4,69
21,14,4,5,3,25,12,0,0,84
21,14,4,5,3,25,12,9,3,96
21,14,4,5,3,9,13,1,12,82
21,14,4,5,3,9,13,1,14,84
21,14,4,5,3,11,0,0,0,58
21,14,4,5,3,11,5,4,0,67
21,14,4,5,3,12,1,18,5,83
21,14,4,5,3,15,9,3,0,74
21,14,4,5,3,15,25,5,4,96
21,14,4,5,3,15,12,9,3,86
21,14,4,5,3,18,5,5,0,75
21,14,4,5,3,18,5,5,4,79
21,14,4,5,3,18,9,5,4,83
21,14,4,5,4,21,3,5,4,81
21,14,4,5,5,0,0,0,0,49
21,14,4,5,5,4,5,4,0,62
21,14,4,5,5,13,5,4,0,71
21,14,4,5,5,13,15,21,19,117
21,14,4,5,5,16,0,0,0,65
21,14,4,5,5,16,12,25,0,102
21,14,4,5,6,1,3,5,4,63
21,14,4,5,6,1,13,5,4,73
21,14,4,5,6,5,1,20,0,76
21,14,4,5,6,5,14,19,5,93
21,14,4,5,6,9,1,14,20,94
21,14,4,5,6,9,5,4,0,68
21,14,4,5,6,9,12,5,4,80
21,14,4,5,6,9,14,5,0,78
21,14,4,5,6,9,14,5,4,82
21,14,4,5,6,20,0,0,0,70
21,14,4,5,6,20,12,25,0,107
21,14,4,5,9,6,25,0,0,84
21,14,4,5,9,6,9,5,4,77
21,14,4,5,12,1,25,5,4,91
21,14,4,5,12,1,20,5,4,86
21,14,4,5,12,5,20,5,4,90
21,14,4,5,12,9,2,12,5,84
21,14,4,5,12,9,7,8,20,100
21,14,4,5,12,21,4,5,0,86
21,14,4,5,12,21,4,5,4,90
21,14,4,5,12,21,7,5,4,93
21,14,4,5,12,22,5,0,0,83
21,14,4,5,12,22,5,4,0,87
21,14,4,5,13,9,19,5,4,94
21,14,4,5,13,21,18,5,0,101
21,14,4,5,14,0,0,0,0,58
21,14,4,5,14,9,5,4,0,76
21,14,4,5,14,15,20,5,4,102
21,14,4,5,14,20,5,4,0,87
21,14,4,5,14,21,4,5,4,92
21,14,4,5,16,15,19,5,4,103
21,14,4,5,16,21,20,5,4,110
21,14,4,5,18,0,0,0,0,62
21,14,4,5,18,1,3,20,0,86
21,14,4,5,18,1,3,20,19,105
21,14,4,5,18,1,7,5,0,75
21,14,4,5,18,1,7,5,19,94
21,14,4,5,18,1,9,4,0,76
21,14,4,5,18,1,9,13,0,85
21,14,4,5,18,1,9,18,0,90
21,14,4,5,18,1,18,3,8,92
21,14,4,5,18,1,18,13,0,94
21,14,4,5,18,1,18,13,19,113
21,14,4,5,18,1,20,5,0,88
21,14,4,5,18,2,1,3,11,79
21,14,4,5,18,2,1,11,5,81
21,14,4,5,18,2,1,14,11,90
21,14,4,5,18,2,5,1,11,81
21,14,4,5,18,2,5,1,13,83
21,14,4,5,18,2,5,1,18,88
21,14,4,5,18,2,5,1,20,90
21,14,4,5,18,2,5,4,0,73
21,14,4,5,18,2,9,4,0,77
21,14,4,5,18,2,9,4,19,96
21,14,4,5,18,2,9,12,12,97
21,14,4,5,18,2,9,14,4,91
21,14,4,5,18,2,9,20,0,93
21,14,4,5,18,2,9,20,5,98
21,14,4,5,18,2,15,4,25,108
21,14,4,5,18,2,15,25,0,104
21,14,4,5,18,2,15,9,12,100
21,14,4,5,18,2,15,15,13,107
21,14,4,5,18,2,15,18,14,111
21,14,4,5,18,2,15,24,0,103
21,14,4,5,18,2,18,5,4,91
21,14,4,5,18,2,18,5,23,110
21,14,4,5,18,2,18,9,13,104
21,14,4,5,18,2,21,4,0,89
21,14,4,5,18,2,21,4,19,108
21,14,4,5,18,2,21,25,0,110
21,14,4,5,18,2,21,25,19,129
21,14,4,5,18,2,21,15,25,125
21,14,4,5,18,2,21,18,25,128
21,14,4,5,18,2,21,18,14,117
21,14,4,5,18,2,21,19,8,112
21,14,4,5,18,3,1,16,0,82
21,14,4,5,18,3,1,18,20,104
21,14,4,5,18,3,1,19,5,90
21,14,4,5,18,3,1,19,20,105
21,14,4,5,18,3,8,1,16,90
21,14,4,5,18,3,8,9,14,96
21,14,4,5,18,3,12,1,4,82
21,14,4,5,18,3,12,1,25,103
21,14,4,5,18,3,12,21,2,100
21,14,4,5,18,3,15,1,20,101
21,14,4,5,18,3,15,15,11,106
21,14,4,5,18,3,15,15,12,107
21,14,4,5,18,3,18,25,0,108
21,14,4,5,18,3,18,15,16,114
21,14,4,5,18,3,21,16,0,102
21,14,4,5,18,3,21,18,12,116
21,14,4,5,18,3,21,20,0,106
21,14,4,5,18,3,21,20,19,125
21,14,4,5,18,4,5,1,4,76
21,14,4,5,18,4,5,3,11,85
21,14,4,5,18,4,9,4,0,79
21,14,4,5,18,4,9,7,0,82
21,14,4,5,18,4,9,16,0,91
21,14,4,5,18,4,9,19,8,102
21,14,4,5,18,4,9,22,5,102
21,14,4,5,18,4,15,0,0,81
21,14,4,5,18,4,15,5,18,104
21,14,4,5,18,4,15,5,19,105
21,14,4,5,18,4,15,7,0,88
21,14,4,5,18,4,15,7,19,107
21,14,4,5,18,4,15,14,5,100
21,14,4,5,18,4,15,19,5,105
21,14,4,5,18,4,15,20,0,101
21,14,4,5,18,4,15,23,14,118
21,14,4,5,18,4,18,1,7,92
21,14,4,5,18,4,18,1,23,108
21,14,4,5,18,4,18,5,23,112
21,14,4,5,18,4,18,25,0,109
21,14,4,5,18,4,21,7,0,94
21,14,4,5,18,5,1,20,0,88
21,14,4,5,18,5,1,20,5,93
21,14,4,5,18,5,1,20,19,107
21,14,4,5,18,5,4,7,5,83
21,14,4,5,18,5,25,5,0,97
21,14,4,5,18,5,25,5,4,101
21,14,4,5,18,5,18,0,0,85
21,14,4,5,18,6,1,3,5,77
21,14,4,5,18,6,1,12,12,93
21,14,4,5,18,6,5,4,0,77
21,14,4,5,18,6,5,5,4,82
21,14,4,5,18,6,5,5,12,90
21,14,4,5,18,6,5,5,20,98
21,14,4,5,18,6,5,12,20,105
21,14,4,5,18,6,6,5,4,83
21,14,4,5,18,6,9,12,12,101
21,14,4,5,18,6,9,14,4,95
21,14,4,5,18,6,9,18,5,100
21,14,4,5,18,6,12,15,23,118
21,14,4,5,18,6,15,0,0,83
21,14,4,5,18,6,15,12,4,99
21,14,4,5,18,6,15,14,7,104
21,14,4,5,18,6,15,15,20,118
21,14,4,5,18,6,15,18,13,114
21,14,4,5,18,6,21,18,0,107
21,14,4,5,18,6,21,18,19,126
21,14,4,5,18,7,1,7,5,82
21,14,4,5,18,7,1,18,2,90
21,14,4,5,18,7,5,1,18,93
21,14,4,5,18,7,9,18,4,100
21,14,4,5,18,7,9,18,20,116
21,14,4,5,18,7,12,15,23,119
21,14,4,5,18,7,14,1,23,107
21,14,4,5,18,7,15,0,0,84
21,14,4,5,18,7,15,4,0,88
21,14,4,5,18,7,15,4,19,107
21,14,4,5,18,7,15,5,18,107
21,14,4,5,18,7,15,5,19,108
21,14,4,5,18,7,15,14,5,103
21,14,4,5,18,7,15,18,5,107
21,14,4,5,18,7,15,19,0,103
21,14,4,5,18,7,15,23,14,121
21,14,4,5,18,7,18,1,4,92
21,14,4,5,18,7,18,15,23,125
21,14,4,5,18,7,18,21,2,110
21,14,4,5,18,8,1,14,4,89
21,14,4,5,18,8,1,14,7,92
21,14,4,5,18,8,5,1,4,80
21,14,4,5,18,8,5,1,20,96
21,14,4,5,18,8,5,12,16,103
21,14,4,5,18,8,5,23,0,98
21,14,4,5,18,8,9,4,0,83
21,14,4,5,18,8,9,12,12,103
21,14,4,5,18,8,9,14,20,113
21,14,4,5,18,8,9,22,5,106
21,14,4,5,18,8,15,12,4,101
21,14,4,5,18,8,15,12,5,102
21,14,4,5,18,8,21,13,0,104
21,14,4,5,18,8,21,14,7,112
21,14,4,5,18,9,4,5,4,84
21,14,4,5,18,25,15,11,5,118
21,14,4,5,18,9,22,5,4,102
21,14,4,5,18,10,1,23,0,96
21,14,4,5,18,10,1,23,19,115
21,14,4,5,18,10,15,9,14,110
21,14,4,5,18,11,5,5,12,95
21,14,4,5,18,11,5,5,16,99
21,14,4,5,18,11,9,14,4,100
21,14,4,5,18,11,9,14,7,103
21,14,4,5,18,12,1,25,0,100
21,14,4,5,18,12,1,9,4,88
21,14,4,5,18,12,1,9,14,98
21,14,4,5,18,12,1,25,19,119
21,14,4,5,18,12,1,14,4,93
21,14,4,5,18,12,1,16,0,91
21,14,4,5,18,12,1,16,19,110
21,14,4,5,18,12,1,19,8,102
21,14,4,5,18,12,5,1,6,86
21,14,4,5,18,12,5,20,0,99
21,14,4,5,18,12,5,20,19,118
21,14,4,5,18,12,9,0,0,83
21,14,4,5,18,12,25,0,0,99
21,14,4,5,18,12,9,4,0,87
21,14,4,5,18,12,9,5,0,88
21,14,4,5,18,12,25,5,0,104
21,14,4,5,18,12,9,5,18,106
21,14,4,5,18,12,9,5,19,107
21,14,4,5,18,12,9,6,5,94
21,14,4,5,18,12,9,6,20,109
21,14,4,5,18,12,9,14,5,102
21,14,4,5,18,12,9,14,7,104
21,14,4,5,18,12,9,16,0,99
21,14,4,5,18,12,9,16,19,118
21,14,4,5,18,12,9,20,0,103
21,14,4,5,18,12,9,22,5,110
21,14,4,5,18,12,15,1,4,94
21,14,4,5,18,12,15,3,11,103
21,14,4,5,18,12,15,6,20,115
21,14,4,5,18,12,15,15,11,115
21,14,4,5,18,12,15,21,20,130
21,14,4,5,18,13,1,4,5,85
21,14,4,5,18,13,1,9,4,89
21,14,4,5,18,13,1,14,0,90
21,14,4,5,18,13,1,18,11,105
21,14,4,5,18,13,1,20,5,101
21,14,4,5,18,13,1,20,8,104
21,14,4,5,18,13,5,1,12,93
21,14,4,5,18,13,9,14,5,103
21,14,4,5,18,13,9,19,20,123
21,14,4,5,18,13,15,19,20,129
21,14,4,5,18,14,0,0,0,76
21,14,4,5,18,14,1,13,0,90
21,14,4,5,18,14,1,13,5,95
21,14,4,5,18,14,5,19,19,119
21,14,4,5,18,14,9,13,0,98
21,14,4,5,18,14,15,13,5,109
21,14,4,5,18,14,15,20,5,116
21,14,4,5,18,15,18,2,0,97
21,14,4,5,18,16,1,25,0,104
21,14,4,5,18,16,1,9,4,92
21,14,4,5,18,16,1,9,14,102
21,14,4,5,18,16,1,25,19,123
21,14,4,5,18,16,1,14,0,93
21,14,4,5,18,16,1,18,20,117
21,14,4,5,18,16,1,19,19,117
21,14,4,5,18,16,5,5,16,104
21,14,4,5,18,16,5,5,18,106
21,14,4,5,18,16,5,14,0,97
21,14,4,5,18,16,9,3,11,101
21,14,4,5,18,16,9,5,18,110
21,14,4,5,18,16,9,12,5,104
21,14,4,5,18,16,9,14,0,101
21,14,4,5,18,16,9,14,19,120
21,14,4,5,18,16,12,1,25,116
21,14,4,5,18,16,12,1,14,105
21,14,4,5,18,16,12,25,0,115
21,14,4,5,18,16,12,15,20,125
21,14,4,5,18,16,15,12,5,110
21,14,4,5,18,16,15,19,5,117
21,14,4,5,18,16,15,20,0,113
21,14,4,5,18,16,18,25,0,121
21,14,4,5,18,16,18,15,16,127
21,14,4,5,18,16,21,11,5,115
21,14,4,5,18,16,21,12,12,123
21,14,4,5,18,16,21,20,0,119
21,14,4,5,18,18,1,14,0,95
21,14,4,5,18,18,1,20,5,106
21,14,4,5,18,18,5,1,4,90
21,14,4,5,18,18,5,1,13,99
21,14,4,5,18,18,5,14,20,119
21,14,4,5,18,18,9,14,7,110
21,14,4,5,18,18,9,16,5,110
21,14,4,5,18,18,15,2,5,102
21,14,4,5,18,18,15,12,12,119
21,14,4,5,18,18,15,15,6,116
21,14,4,5,18,18,15,15,13,123
21,14,4,5,18,18,15,15,20,130
21,14,4,5,18,18,21,12,5,118
21,14,4,5,18,18,21,14,0,115
21,14,4,5,18,18,21,14,19,134
21,14,4,5,18,19,1,25,0,107
21,14,4,5,18,19,1,9,12,103
21,14,4,5,18,19,1,16,0,98
21,14,4,5,18,19,1,23,0,105
21,14,4,5,18,19,5,1,0,87
21,14,4,5,18,19,5,1,12,99
21,14,4,5,18,19,5,1,13,100
21,14,4,5,18,19,5,1,19,106
21,14,4,5,18,19,5,3,20,109
21,14,4,5,18,19,5,5,0,91
21,14,4,5,18,19,5,5,14,105
21,14,4,5,18,19,5,12,12,110
21,14,4,5,18,19,5,20,0,106
21,14,4,5,18,19,5,20,19,125
21,14,4,5,18,19,8,15,5,109
21,14,4,5,18,19,8,15,20,124
21,14,4,5,18,19,8,21,20,130
21,14,4,5,18,19,9,4,5,99
21,14,4,5,18,19,9,7,14,111
21,14,4,5,18,19,9,12,12,114
21,14,4,5,18,19,9,26,5,121
21,14,4,5,18,19,11,25,0,117
21,14,4,5,18,19,11,9,14,115
21,14,4,5,18,19,12,9,16,118
21,14,4,5,18,19,15,9,12,117
21,14,4,5,18,19,15,12,4,112
21,14,4,5,18,19,15,12,5,113
21,14,4,5,18,19,15,14,7,117
21,14,4,5,18,19,15,18,20,134
21,14,4,5,18,19,15,21,12,129
21,14,4,5,18,19,15,23,0,119
21,14,4,5,18,19,16,1,14,112
21,14,4,5,18,19,16,1,18,116
21,14,4,5,18,19,16,9,14,120
21,14,4,5,18,19,20,1,25,127
21,14,4,5,18,19,20,5,13,119
21,14,4,5,18,19,20,5,16,122
21,14,4,5,18,19,21,3,11,116
21,14,4,5,18,19,21,9,20,131
21,14,4,5,18,20,1,11,5,99
21,14,4,5,18,20,1,12,11,106
21,14,4,5,18,20,1,24,0,107
21,14,4,5,18,20,5,19,20,126
21,14,4,5,18,20,8,1,23,114
21,14,4,5,18,20,9,4,5,100
21,14,4,5,18,20,9,5,0,96
21,14,4,5,18,20,9,5,4,100
21,14,4,5,18,20,9,13,5,109
21,14,4,5,18,20,9,14,20,125
21,14,4,5,18,20,25,16,5,128
21,14,4,5,18,20,15,14,5,116
21,14,4,5,18,20,15,15,11,123
21,14,4,5,18,20,15,23,0,120
21,14,4,5,18,20,15,23,19,139
21,14,4,5,18,20,21,2,0,105
21,14,4,5,18,20,21,14,5,122
21,14,4,5,18,20,21,18,6,127
21,14,4,5,18,20,21,18,14,135
21,14,4,5,18,20,23,9,7,121
21,14,4,5,18,21,19,5,4,111
21,14,4,5,18,22,5,19,20,128
21,14,4,5,18,23,1,7,5,98
21,14,4,5,18,23,1,25,0,111
21,14,4,5,18,23,1,12,11,109
21,14,4,5,18,23,1,18,4,108
21,14,4,5,18,23,1,18,16,120
21,14,4,5,18,23,1,19,8,113
21,14,4,5,18,23,1,22,5,113
21,14,4,5,18,23,5,1,18,109
21,14,4,5,18,23,5,6,20,116
21,14,4,5,18,23,5,14,20,124
21,14,4,5,18,23,9,14,4,112
21,14,4,5,18,23,9,14,7,115
21,14,4,5,18,23,9,20,0,114
21,14,4,5,18,23,15,15,12,127
21,14,4,5,18,23,15,18,11,129
21,14,4,5,18,23,18,1,16,120
21,14,4,5,18,23,18,9,20,132
21,14,4,5,18,26,5,1,12,106
21,14,4,5,19,5,18,20,0,106
21,14,4,5,19,5,18,22,5,113
21,14,4,5,19,9,7,14,0,93
21,14,4,5,19,9,18,5,0,95
21,14,4,5,19,9,18,5,4,99
21,14,4,5,22,9,12,0,0,87
21,14,4,5,22,9,15,21,19,130
21,14,4,5,22,9,19,5,4,103
21,14,4,5,22,15,20,5,4,110
21,14,4,5,22,15,21,20,0,122
21,14,4,5,23,5,4,0,0,76
21,14,4,5,23,25,0,0,0,92
21,14,4,5,23,9,12,25,0,113
21,14,4,6,12,15,23,0,0,95
21,14,4,25,0,0,0,0,0,64
21,14,4,25,1,2,12,5,0,84
21,14,4,9,1,12,5,4,0,70
21,14,4,9,1,12,12,5,4,82
21,14,4,9,4,0,0,0,0,52
21,14,4,25,5,0,0,0,0,69
21,14,4,25,5,1,2,12,5,89
21,14,4,25,5,4,0,0,0,73
21,14,4,9,5,19,0,0,0,72
21,14,4,9,5,20,5,4,0,82
21,14,4,9,7,0,0,0,0,55
21,14,4,9,7,5,19,20,0,99
21,14,4,9,7,7,5,4,0,71
21,14,4,9,7,8,20,0,0,83
21,14,4,9,7,8,20,5,4,92
21,14,4,9,7,14,5,0,0,74
21,14,4,9,7,14,9,6,25,109
21,14,4,25,9,14,7,0,0,94
21,14,4,25,9,14,7,12,25,131
21,14,4,9,11,5,4,0,0,68
21,14,4,9,12,1,20,5,4,90
21,14,4,9,12,21,20,5,0,106
21,14,4,9,12,21,20,5,4,110
21,14,4,9,13,0,0,0,0,61
21,14,4,9,13,12,25,0,0,98
21,14,4,9,13,13,5,4,0,83
21,14,4,9,13,16,12,5,4,98
21,14,4,25,14,1,13,9,3,104
21,14,4,9,14,5,4,0,0,71
21,14,4,9,14,5,19,0,0,86
21,14,4,9,14,20,5,4,0,91
21,14,4,9,16,16,5,4,0,89
21,14,4,9,18,5,3,20,0,94
21,14,4,9,18,11,0,0,0,77
21,14,4,9,19,8,5,4,0,84
21,14,4,9,19,13,1,25,0,106
21,14,4,9,19,16,12,1,25,121
21,14,4,9,19,16,15,19,5,122
21,14,4,9,19,20,1,14,20,122
21,14,4,9,19,20,5,14,4,110
21,14,4,9,20,3,8,5,4,88
21,14,4,9,20,20,15,5,4,112
21,14,4,9,21,18,14,1,12,114
21,14,4,9,22,1,2,12,5,90
21,14,4,9,22,5,18,19,5,117
21,14,4,9,22,9,4,5,4,92
21,14,4,9,22,9,14,5,4,102
21,14,4,9,26,5,14,5,4,102
21,14,4,9,26,26,9,5,4,118
21,14,4,15,0,0,0,0,0,54
21,14,4,15,1,2,12,5,0,74
21,14,4,15,3,9,2,12,5,85
21,14,4,15,3,9,12,5,0,83
21,14,4,15,3,11,0,0,0,68
21,14,4,15,3,11,5,4,0,77
21,14,4,15,3,11,9,14,7,98
21,14,4,15,3,11,19,0,0,87
21,14,4,15,3,20,15,18,0,110
21,14,4,15,4,7,5,4,0,74
21,14,4,15,5,18,0,0,0,77
21,14,4,15,5,18,19,0,0,96
21,14,4,15,5,19,0,0,0,78
21,14,4,15,6,6,5,4,0,75
21,14,4,15,7,0,0,0,0,61
21,14,4,15,9,14,7,0,0,84
21,14,4,15,9,14,7,19,0,103
21,14,4,15,12,12,5,4,0,87
21,14,4,15,13,5,4,0,0,76
21,14,4,15,14,0,0,0,0,68
21,14,4,15,14,1,20,5,4,98
21,14,4,15,14,5,0,0,0,73
21,14,4,15,14,11,5,25,0,109
21,14,4,15,14,14,9,19,8,118
21,14,4,15,15,13,5,4,0,91
21,14,4,15,16,5,4,0,0,79
21,14,4,15,18,13,1,14,20,120
21,14,4,15,19,5,0,0,0,78
21,14,4,15,19,5,4,0,0,82
21,14,4,15,20,9,14,7,0,104
21,14,4,15,20,20,5,4,0,103
21,14,4,15,21,2,12,5,0,94
21,14,4,15,21,2,12,5,4,98
21,14,4,15,21,2,12,5,19,113
21,14,4,15,21,2,20,5,4,106
21,14,4,15,21,3,8,5,4,95
21,14,4,15,21,7,8,20,25,135
21,14,4,15,23,5,12,5,4,103
21,14,4,15,23,5,18,5,4,109
21,14,4,15,23,14,5,4,0,100
21,14,4,15,23,14,25,0,0,116
21,14,4,18,1,2,0,0,0,60
21,14,4,18,1,6,20,5,4,93
21,14,4,18,1,7,0,0,0,65
21,14,4,18,1,9,14,5,4,90
21,14,4,18,1,16,5,0,0,79
21,14,4,18,1,16,5,4,0,83
21,14,4,18,1,16,5,19,0,98
21,14,4,18,1,16,9,14,7,104
21,14,4,18,1,23,0,0,0,81
21,14,4,18,1,23,9,14,7,111
21,14,4,18,1,23,14,0,0,95
21,14,4,18,1,23,19,0,0,100
21,14,4,18,5,1,4,5,4,76
21,14,4,18,5,1,13,5,4,85
21,14,4,18,5,1,13,25,0,101
21,14,4,18,5,1,13,20,0,96
21,14,4,18,5,4,7,5,4,82
21,14,4,18,5,7,7,25,0,101
21,14,4,18,5,19,19,0,0,100
21,14,4,18,5,19,19,5,4,109
21,14,4,18,5,19,19,5,19,124
21,14,4,18,5,19,20,0,0,101
21,14,4,18,5,23,0,0,0,85
21,14,4,18,25,1,2,12,5,102
21,14,4,18,9,5,4,0,0,75
21,14,4,18,25,9,14,7,0,112
21,14,4,18,9,12,12,5,4,99
21,14,4,18,9,22,5,14,0,107
21,14,4,18,15,16,16,5,4,113
21,14,4,18,15,19,19,25,0,135
21,14,4,18,15,23,14,5,4,118
21,14,4,18,21,2,2,5,4,91
21,14,4,18,21,7,7,5,4,101
21,14,4,18,21,14,11,0,0,103
21,14,4,18,21,14,11,5,14,122
21,14,4,21,1,12,9,26,5,113
21,14,4,21,2,0,0,0,0,62
21,14,4,21,2,2,5,4,0,73
21,14,4,21,2,9,15,21,19,126
21,14,4,21,3,1,12,0,0,76
21,14,4,21,3,8,5,19,19,114
21,14,4,21,3,20,9,12,5,109
21,14,4,21,5,0,0,0,0,65
21,14,4,21,5,14,5,19,19,122
21,14,4,21,7,0,0,0,0,67
21,14,4,21,11,5,0,0,0,76
21,14,4,21,12,1,14,3,5,95
21,14,4,21,12,1,14,3,25,115
21,14,4,21,12,1,14,20,0,107
21,14,4,21,12,1,18,0,0,91
21,14,4,21,12,1,18,12,25,128
21,14,4,21,12,1,20,5,0,98
21,14,4,21,12,1,20,5,4,102
21,14,4,21,12,1,20,5,19,117
21,14,4,21,12,1,20,15,18,126
21,14,4,21,12,1,20,21,19,133
21,14,4,21,12,25,0,0,0,97
21,14,4,21,12,12,0,0,0,84
21,14,4,21,12,12,5,4,0,93
21,14,4,21,12,15,9,4,0,100
21,14,4,21,12,15,19,5,0,111
21,14,4,21,12,15,21,19,0,127
21,14,4,21,13,16,5,4,0,98
21,14,4,21,14,7,5,4,0,90
21,14,4,21,16,1,2,12,5,96
21,14,4,21,16,5,4,0,0,85
21,14,4,21,18,1,2,12,5,98
21,14,4,21,18,1,2,12,25,118
21,14,4,21,18,5,0,0,0,83
21,14,4,21,19,20,0,0,0,99
21,14,4,21,19,20,5,4,0,108
21,14,4,21,19,20,25,0,0,124
21,14,4,21,20,5,15,21,19,140
21,14,4,21,20,25,0,0,0,105
21,14,4,21,20,9,6,21,12,128
21,14,4,23,1,18,6,5,4,96
21,14,4,23,5,12,20,0,0,99
21,14,5,1,7,5,18,0,0,71
21,14,5,1,7,5,18,12,25,108
21,14,5,1,7,12,5,4,0,69
21,14,5,1,18,5,4,0,0,68
21,14,5,1,18,12,25,0,0,96
21,14,5,1,18,14,5,4,0,82
21,14,5,1,18,14,5,19,20,117
21,14,5,1,18,20,8,0,0,87
21,14,5,1,18,20,8,5,4,96
21,14,5,1,18,20,8,12,25,124
21,14,5,1,18,20,8,19,0,106
21,14,5,1,19,5,0,0,0,65
21,14,5,1,19,5,6,21,12,104
21,14,5,1,19,5,19,0,0,84
21,14,5,1,19,25,0,0,0,85
21,14,5,1,19,9,5,18,0,92
21,14,5,1,19,9,5,19,20,113
21,14,5,1,19,9,12,25,0,106
21,14,5,1,19,20,5,18,14,117
21,14,5,1,20,1,2,12,5,81
21,14,5,1,20,5,4,0,0,70
21,14,5,1,20,5,14,0,0,80
21,14,5,1,20,8,0,0,0,69
21,14,5,1,20,8,19,0,0,88
21,14,5,1,20,9,14,7,0,91
21,14,5,1,22,5,4,0,0,72
21,14,5,2,2,5,4,0,0,53
21,14,5,2,2,9,14,7,0,74
21,14,5,2,18,9,1,20,5,95
21,14,5,3,8,15,5,4,0,75
21,14,5,3,8,15,9,3,0,78
21,14,5,3,8,15,9,14,7,96
21,14,5,4,4,9,5,4,0,66
21,14,5,4,4,25,9,14,7,103
21,14,5,4,7,5,0,0,0,56
21,14,5,4,7,5,4,0,0,60
21,14,5,4,7,9,14,7,0,81
21,14,5,4,9,2,12,5,0,72
21,14,5,4,9,2,12,25,0,92
21,14,5,4,9,6,9,5,4,77
21,14,5,4,9,20,5,4,0,82
21,14,5,4,21,3,1,20,5,94
21,14,5,4,21,3,5,4,0,77
21,14,5,6,6,1,2,12,5,72
21,14,5,6,6,1,3,5,4,65
21,14,5,6,6,5,20,5,0,82
21,14,5,6,6,21,19,5,4,101
21,14,5,7,1,12,0,0,0,60
21,14,5,7,1,12,12,25,0,97
21,14,5,7,15,9,19,20,0,110
21,14,5,25,5,0,0,0,0,70
21,14,5,25,5,1,2,12,5,90
21,14,5,25,5,4,0,0,0,74
21,14,5,10,5,3,20,5,4,87
21,14,5,12,1,16,19,5,4,97
21,14,5,12,1,19,20,9,3,104
21,14,5,12,1,20,5,4,0,82
21,14,5,12,1,20,9,14,7,103
21,14,5,12,2,15,23,5,4,101
21,14,5,12,4,5,18,12,25,116
21,14,5,12,5,3,20,0,0,80
21,14,5,12,5,3,20,5,4,89
21,14,5,12,5,7,1,14,20,99
21,14,5,12,9,4,5,4,0,74
21,14,5,12,15,16,5,4,0,92
21,14,5,12,15,16,9,14,7,113
21,14,5,12,21,4,5,4,0,86
21,14,5,12,21,19,9,22,5,128
21,14,5,12,21,19,15,18,25,150
21,14,5,13,2,1,25,5,4,90
21,14,5,13,2,1,19,5,4,84
21,14,5,13,5,14,4,5,4,85
21,14,5,13,5,18,7,5,4,92
21,14,5,13,9,14,5,14,20,115
21,14,5,13,9,20,20,5,4,111
21,14,5,13,15,20,9,22,5,124
21,14,5,13,16,12,15,25,0,121
21,14,5,13,16,20,0,0,0,89
21,14,5,13,16,20,25,0,0,114
21,14,5,13,16,20,9,5,4,107
21,14,5,13,21,12,15,21,19,141
21,14,5,14,1,2,12,5,4,78
21,14,5,14,1,3,20,5,4,87
21,14,5,14,3,8,1,14,20,100
21,14,5,14,3,15,18,5,4,99
21,14,5,14,4,1,2,12,5,78
21,14,5,14,4,5,4,0,0,67
21,14,5,14,4,5,13,9,3,88
21,14,5,14,4,9,14,7,0,88
21,14,5,14,4,12,25,0,0,95
21,14,5,14,4,15,23,5,4,105
21,14,5,14,4,21,5,4,0,88
21,14,5,14,4,21,18,5,4,106
21,14,5,14,7,1,7,5,4,78
21,14,5,14,7,12,9,19,8,109
21,14,5,14,10,15,25,5,4,113
21,14,5,14,18,1,7,5,4,89
21,14,5,14,18,15,2,5,4,98
21,14,5,14,19,12,1,22,5,113
21,14,5,14,19,21,18,5,4,121
21,14,5,14,20,5,18,5,4,106
21,14,5,14,20,9,3,5,4,95
21,14,5,14,20,9,18,5,0,106
21,14,5,14,22,9,5,4,0,94
21,14,5,14,22,25,9,14,7,131
21,14,5,14,22,9,15,21,19,140
21,14,5,14,23,15,22,5,14,133
21,14,5,16,9,3,0,0,0,68
21,14,5,16,15,3,8,1,12,95
21,14,5,17,21,1,2,12,5,98
21,14,5,17,21,1,2,12,25,118
21,14,5,17,21,1,12,0,0,91
21,14,5,17,21,1,12,5,4,100
21,14,5,17,21,1,12,12,25,128
21,14,5,17,21,1,12,19,0,110
21,14,5,17,21,1,20,5,4,108
21,14,5,17,21,9,14,5,0,106
21,14,5,18,1,19,5,4,0,87
21,14,5,18,1,19,9,14,7,108
21,14,5,18,5,3,20,0,0,86
21,14,5,18,5,3,20,5,4,95
21,14,5,18,13,9,14,5,4,103
21,14,5,18,15,4,5,4,0,86
21,14,5,18,15,4,5,14,20,116
21,14,5,18,15,4,9,14,7,107
21,14,5,18,15,19,9,22,5,128
21,14,5,18,15,20,9,3,0,105
21,14,5,18,18,1,2,12,5,96
21,14,5,18,18,1,2,12,25,116
21,14,5,18,18,1,14,3,25,119
21,14,5,18,18,1,14,20,0,111
21,14,5,18,18,1,20,9,3,109
21,14,5,18,18,9,14,7,0,106
21,14,5,18,21,4,9,20,5,117
21,14,5,18,21,16,20,5,4,124
21,14,5,19,3,1,16,5,4,88
21,14,5,19,16,9,5,4,0,93
21,14,5,19,19,1,25,5,4,113
21,14,5,19,19,5,14,3,5,105
21,14,5,20,3,8,5,4,0,80
21,14,5,20,5,18,14,1,12,110
21,14,5,20,8,9,3,0,0,80
21,14,5,20,8,9,3,1,12,93
21,14,5,21,7,5,14,9,3,99
21,14,5,22,1,4,5,4,0,76
21,14,5,22,1,4,9,14,7,97
21,14,5,22,1,19,9,22,5,118
21,14,5,22,5,14,0,0,0,81
21,14,5,22,5,14,5,18,0,104
21,14,5,22,5,14,5,19,20,125
21,14,5,22,5,14,12,25,0,118
21,14,5,22,5,18,20,5,4,114
21,14,5,22,9,3,20,5,4,103
21,14,5,22,9,4,5,14,20,114
21,14,5,22,9,12,0,0,0,83
21,14,5,22,9,12,12,25,0,120
21,14,5,22,9,14,3,5,4,97
21,14,5,22,15,11,5,4,0,97
21,14,5,22,15,12,22,5,4,120
21,14,5,24,1,3,20,0,0,88
21,14,5,24,1,3,20,5,4,97
21,14,5,24,1,3,20,12,25,125
21,14,5,24,1,12,20,5,4,106
21,14,5,24,3,9,19,5,4,104
21,14,5,24,3,9,20,5,4,105
21,14,5,24,3,21,19,5,4,116
21,14,5,24,5,13,16,20,0,118
21,14,5,24,5,18,20,5,4,116
21,14,5,24,8,1,12,5,4,94
21,14,5,24,8,21,13,5,4,115
21,14,5,24,9,7,5,14,20,119
21,14,5,24,9,12,5,4,0,94
21,14,5,24,15,20,9,3,0,111
21,14,5,24,16,5,3,20,0,108
21,14,5,24,16,5,18,20,0,123
21,14,5,24,16,9,18,5,4,116
21,14,5,24,16,15,19,5,4,123
21,14,5,24,16,18,5,19,19,141
21,14,5,24,20,9,14,3,20,130
21,14,5,24,20,18,5,13,5,125
21,14,5,24,21,4,5,4,0,98
21,14,6,1,2,12,5,4,0,65
21,14,6,1,2,12,9,14,7,86
21,14,6,1,3,1,4,5,4,59
21,14,6,1,3,5,0,0,0,50
21,14,6,1,3,5,4,0,0,54
21,14,6,1,3,5,20,5,4,79
21,14,6,1,3,9,12,5,0,71
21,14,6,1,3,20,0,0,0,65
21,14,6,1,3,20,21,1,12,99
21,14,6,1,4,1,2,12,5,66
21,14,6,1,4,5,4,0,0,55
21,14,6,1,4,9,14,7,0,76
21,14,6,1,7,7,5,4,0,65
21,14,6,1,7,15,20,5,4,93
21,14,6,1,9,12,5,4,0,72
21,14,6,1,9,12,9,14,7,93
21,14,6,1,9,14,0,0,0,65
21,14,6,1,9,14,20,0,0,85
21,14,6,1,9,14,20,12,25,122
21,14,6,1,9,18,0,0,0,69
21,14,6,1,9,18,5,18,0,92
21,14,6,1,9,18,5,19,20,113
21,14,6,1,9,18,12,25,0,106
21,14,6,1,9,20,8,0,0,79
21,14,6,1,9,20,8,19,0,98
21,14,6,1,11,1,2,12,5,73
21,14,6,1,11,5,4,0,0,62
21,14,6,1,12,12,5,14,0,85
21,14,6,1,12,12,9,14,7,96
21,14,6,1,12,19,5,0,0,78
21,14,6,1,12,19,9,20,25,127
21,14,6,1,13,5,4,0,0,64
21,14,6,1,13,15,21,19,0,110
21,14,6,1,14,3,25,0,0,84
21,14,6,1,14,3,9,5,4,77
21,14,6,1,14,7,5,4,0,72
21,14,6,1,14,14,5,4,0,79
21,14,6,1,18,0,0,0,0,60
21,14,6,1,18,3,5,4,0,72
21,14,6,1,18,4,12,5,0,81
21,14,6,1,18,13,5,4,0,82
21,14,6,1,18,13,9,14,7,103
21,14,6,1,19,8,9,15,14,107
21,14,6,1,19,20,0,0,0,81
21,14,6,1,19,20,5,14,0,100
21,14,6,1,19,20,5,14,19,119
21,14,6,1,19,20,9,14,7,111
21,14,6,1,20,5,4,0,0,71
21,14,6,1,20,8,5,18,0,93
21,14,6,1,20,9,7,21,5,104
21,14,6,1,20,20,5,4,0,91
21,14,6,1,20,20,5,14,0,101
21,14,6,1,20,20,25,0,0,107
21,14,6,1,21,12,20,25,0,120
21,14,6,1,22,15,18,5,4,106
21,14,6,1,23,14,9,14,7,109
21,14,6,1,26,5,4,0,0,77
21,14,6,5,1,12,20,25,0,104
21,14,6,5,1,18,5,4,0,74
21,14,6,5,1,18,6,21,12,104
21,14,6,5,1,18,25,0,0,90
21,14,6,5,1,18,9,14,7,95
21,14,6,5,1,19,20,5,4,95
21,14,6,5,1,19,20,12,25,123
21,14,6,5,1,20,8,5,18,98
21,14,6,5,1,20,25,0,0,92
21,14,6,5,2,18,9,12,5,92
21,14,6,5,3,21,14,4,0,88
21,14,6,5,4,0,0,0,0,50
21,14,6,5,4,5,18,1,12,86
21,14,6,5,5,2,12,5,0,70
21,14,6,5,5,2,12,25,0,90
21,14,6,5,5,4,0,0,0,55
21,14,6,5,5,4,9,14,7,85
21,14,6,5,5,9,14,7,0,81
21,14,6,5,5,12,0,0,0,63
21,14,6,5,5,12,9,14,7,93
21,14,6,5,9,7,14,5,4,85
21,14,6,5,12,5,0,0,0,63
21,14,6,5,12,9,14,5,0,86
21,14,6,5,12,12,5,4,0,79
21,14,6,5,12,12,9,5,4,88
21,14,6,5,12,12,15,23,0,108
21,14,6,5,12,15,14,0,0,87
21,14,6,5,12,15,14,25,0,112
21,14,6,5,12,20,0,0,0,78
21,14,6,5,12,20,5,4,0,87
21,14,6,5,13,1,12,5,0,77
21,14,6,5,14,3,5,0,0,68
21,14,6,5,14,3,5,4,0,72
21,14,6,5,14,3,5,19,0,87
21,14,6,5,14,3,9,14,7,93
21,14,6,5,14,4,5,4,0,73
21,14,6,5,15,6,6,5,4,82
21,14,6,5,18,18,9,5,4,100
21,14,6,5,18,20,9,12,5,110
21,14,6,5,18,22,5,14,20,125
21,14,6,5,18,22,9,4,0,99
21,14,6,5,19,20,5,18,0,108
21,14,6,5,19,20,9,22,5,121
21,14,6,5,20,3,8,5,4,86
21,14,6,5,20,5,4,0,0,75
21,14,6,5,20,20,5,18,0,109
21,14,6,5,20,20,5,18,19,128
21,14,6,5,20,20,12,5,4,107
21,14,6,5,21,4,1,12,0,84
21,14,6,5,21,5,4,0,0,76
21,14,6,5,22,5,18,5,4,100
21,14,6,5,23,0,0,0,0,69
21,14,6,6,18,15,26,5,0,111
21,14,6,9,2,2,5,4,0,63
21,14,6,9,2,2,9,14,7,84
21,14,6,9,2,5,18,0,0,75
21,14,6,9,2,5,18,5,4,84
21,14,6,9,2,18,5,4,0,79
21,14,6,9,2,18,15,21,19,125
21,14,6,9,3,11,12,5,0,81
21,14,6,9,5,12,4,5,4,80
21,14,6,9,5,14,4,0,0,73
21,14,6,9,5,18,3,5,0,81
21,14,6,9,5,18,25,0,0,98
21,14,6,9,7,8,20,0,0,85
21,14,6,9,7,21,18,5,4,105
21,14,6,9,12,3,8,5,4,82
21,14,6,9,12,5,0,0,0,67
21,14,6,9,12,5,4,0,0,71
21,14,6,9,12,9,1,12,0,84
21,14,6,9,12,9,14,7,0,92
21,14,6,9,12,12,0,0,0,74
21,14,6,9,12,12,5,4,0,83
21,14,6,9,12,12,9,14,7,104
21,14,6,9,12,13,0,0,0,75
21,14,6,9,12,13,5,4,0,84
21,14,6,9,14,1,2,12,5,84
21,14,6,9,14,5,0,0,0,69
21,14,6,9,14,5,4,0,0,73
21,14,6,9,14,9,3,1,12,89
21,14,6,9,14,9,19,8,0,100
21,14,6,9,14,9,20,5,0,98
21,14,6,9,18,5,4,0,0,77
21,14,6,9,18,9,14,7,0,98
21,14,6,9,18,13,0,0,0,81
21,14,6,9,18,13,12,25,0,118
21,14,6,9,19,3,1,12,0,85
21,14,6,9,19,8,5,4,0,86
21,14,6,9,19,8,9,14,7,107
21,14,6,9,19,19,9,12,5,114
21,14,6,9,20,0,0,0,0,70
21,14,6,9,20,12,25,0,0,107
21,14,6,9,20,14,5,19,19,127
21,14,6,9,20,19,0,0,0,89
21,14,6,9,20,20,5,4,0,99
21,14,6,9,20,20,5,14,0,109
21,14,6,9,20,20,25,0,0,115
21,14,6,9,20,20,9,14,7,120
21,14,6,9,24,0,0,0,0,74
21,14,6,9,24,1,2,12,5,94
21,14,6,9,24,1,20,5,4,104
21,14,6,9,24,5,4,0,0,83
21,14,6,9,24,5,19,0,0,98
21,14,6,9,24,9,14,7,0,104
21,14,6,9,24,9,20,25,0,128
21,14,6,9,24,20,0,0,0,94
21,14,6,12,1,7,0,0,0,61
21,14,6,12,1,7,7,5,4,77
21,14,6,12,1,25,5,4,0,88
21,14,6,12,1,11,5,4,0,74
21,14,6,12,1,11,25,0,0,90
21,14,6,12,1,11,9,14,7,95
21,14,6,12,1,13,5,0,0,72
21,14,6,12,1,13,9,14,7,97
21,14,6,12,1,14,7,5,4,84
21,14,6,12,1,14,11,0,0,79
21,14,6,12,1,14,11,5,4,88
21,14,6,12,1,18,5,4,0,81
21,14,6,12,1,18,9,14,7,102
21,14,6,12,1,19,8,25,0,106
21,14,6,12,1,20,0,0,0,74
21,14,6,12,1,20,5,4,0,83
21,14,6,12,1,20,20,5,4,103
21,14,6,12,1,23,5,4,0,86
21,14,6,12,5,1,4,0,0,63
21,14,6,12,5,3,11,5,4,81
21,14,6,12,5,4,7,5,0,74
21,14,6,12,5,4,7,5,4,78
21,14,6,12,5,5,3,5,0,71
21,14,6,12,5,5,3,5,4,75
21,14,6,12,5,5,9,14,7,93
21,14,6,12,5,19,8,0,0,85
21,14,6,12,5,19,8,5,4,94
21,14,6,12,5,19,8,25,0,110
21,14,6,12,5,19,8,12,25,122
21,14,6,12,5,24,5,4,0,91
21,14,6,12,9,7,8,20,25,122
21,14,6,12,25,9,14,7,0,108
21,14,6,12,15,3,11,0,0,82
21,14,6,12,15,7,7,5,4,91
21,14,6,12,15,15,4,5,4,96
21,14,6,12,15,15,18,0,0,101
21,14,6,12,15,15,18,5,4,110
21,14,6,12,15,18,9,4,0,99
21,14,6,12,15,19,19,25,0,131
21,14,6,12,15,21,18,5,4,116
21,14,6,12,15,21,20,5,4,118
21,14,6,12,15,23,5,18,0,114
21,14,6,12,15,23,5,18,25,139
21,14,6,12,15,23,9,14,7,121
21,14,6,12,15,23,14,0,0,105
21,14,6,12,21,5,14,20,0,113
21,14,6,12,21,6,6,5,4,95
21,14,6,12,21,6,6,25,0,111
21,14,6,12,21,9,4,0,0,87
21,14,6,12,21,11,5,4,0,94
21,14,6,12,21,14,11,5,4,108
21,14,6,12,21,19,8,0,0,101
21,14,6,12,21,19,8,5,4,110
21,14,6,12,21,20,5,4,0,103
21,14,6,12,21,22,9,1,12,118
21,14,6,12,21,24,9,12,5,124
21,14,6,15,1,12,5,4,0,78
21,14,6,15,1,13,5,4,0,79
21,14,6,15,1,13,9,14,7,100
21,14,6,15,3,21,19,5,4,108
21,14,6,15,7,7,5,4,0,79
21,14,6,15,7,7,25,0,0,95
21,14,6,15,7,7,9,14,7,100
21,14,6,15,9,12,5,4,0,86
21,14,6,15,9,19,20,5,4,113
21,14,6,15,12,4,0,0,0,72
21,14,6,15,12,4,5,4,0,81
21,14,6,15,12,4,5,14,0,91
21,14,6,15,12,4,5,18,0,95
21,14,6,15,12,4,5,18,19,114
21,14,6,15,12,4,9,14,7,102
21,14,6,15,12,4,19,0,0,91
21,14,6,15,12,4,21,18,5,116
21,14,6,15,14,4,0,0,0,74
21,14,6,15,14,4,12,5,4,95
21,14,6,15,14,4,12,25,0,111
21,14,6,15,15,4,6,21,12,114
21,14,6,15,15,12,0,0,0,83
21,14,6,15,15,12,5,4,0,92
21,14,6,15,15,12,9,14,7,113
21,14,6,15,15,12,9,19,8,119
21,14,6,15,15,20,5,4,0,100
21,14,6,15,16,16,9,19,8,124
21,14,6,15,18,1,7,5,4,91
21,14,6,15,18,2,1,4,5,86
21,14,6,15,18,2,9,4,0,89
21,14,6,15,18,3,5,4,0,86
21,14,6,15,18,3,9,14,7,107
21,14,6,15,18,4,5,4,0,87
21,14,6,15,18,5,9,7,14,109
21,14,6,15,18,5,19,5,5,108
21,14,6,15,18,5,19,20,0,118
21,14,6,15,18,6,5,9,20,114
21,14,6,15,18,7,5,4,0,90
21,14,6,15,18,7,5,20,0,106
21,14,6,15,18,7,15,14,5,115
21,14,6,15,18,7,15,20,0,116
21,14,6,15,18,11,0,0,0,85
21,14,6,15,18,11,5,4,0,94
21,14,6,15,18,12,15,18,14,133
21,14,6,15,18,13,0,0,0,87
21,14,6,15,18,13,1,12,0,100
21,14,6,15,18,13,5,4,0,96
21,14,6,15,18,19,5,5,14,117
21,14,6,15,18,19,15,15,11,134
21,14,6,15,18,20,9,6,25,134
21,14,6,15,18,20,21,14,5,134
21,14,6,15,18,23,1,18,4,120
21,14,6,15,21,7,8,20,0,112
21,14,6,15,21,12,0,0,0,89
21,14,6,15,21,12,5,4,0,98
21,14,6,15,21,12,9,14,7,119
21,14,6,15,21,12,12,25,0,126
21,14,6,15,21,14,4,0,0,95
21,14,6,15,21,14,4,5,4,104
21,14,6,15,24,5,4,0,0,89
21,14,6,15,24,25,0,0,0,105
21,14,6,18,1,7,9,12,5,93
21,14,6,18,1,25,5,4,0,94
21,14,6,18,1,9,12,0,0,81
21,14,6,18,1,13,5,0,0,78
21,14,6,18,1,13,5,4,0,82
21,14,6,18,1,14,11,0,0,85
21,14,6,18,1,14,11,5,4,94
21,14,6,18,1,14,11,12,25,122
21,14,6,18,1,21,7,8,20,116
21,14,6,18,5,5,0,0,0,69
21,14,6,18,5,5,4,0,0,73
21,14,6,18,5,5,4,15,13,101
21,14,6,18,5,5,9,14,7,99
21,14,6,18,5,5,12,25,0,106
21,14,6,18,5,5,13,1,14,97
21,14,6,18,5,5,19,0,0,88
21,14,6,18,5,5,26,5,0,100
21,14,6,18,5,5,26,5,19,119
21,14,6,18,5,9,7,8,20,108
21,14,6,18,5,20,0,0,0,84
21,14,6,18,5,20,6,21,12,123
21,14,6,18,5,20,20,5,4,113
21,14,6,18,5,20,20,25,0,129
21,14,6,18,9,1,2,12,5,88
21,14,6,18,9,5,4,0,0,77
21,14,6,18,9,5,14,4,0,91
21,14,6,18,9,7,9,4,0,88
21,14,6,18,9,12,12,0,0,92
21,14,6,18,9,12,12,5,4,101
21,14,6,18,9,12,12,25,0,117
21,14,6,18,9,14,7,5,0,94
21,14,6,18,9,14,7,5,4,98
21,14,6,18,9,19,11,25,0,123
21,14,6,18,9,26,26,0,0,120
21,14,6,18,9,26,26,25,0,145
21,14,6,18,9,26,26,12,25,157
21,14,6,18,15,3,11,0,0,88
21,14,6,18,15,3,11,5,4,97
21,14,6,18,15,3,11,19,0,107
21,14,6,18,15,14,20,5,4,117
21,14,6,18,15,19,20,0,0,113
21,14,6,18,15,19,20,5,4,122
21,14,6,18,15,19,20,25,0,138
21,14,6,18,15,20,8,5,4,111
21,14,6,18,15,23,1,18,4,120
21,14,6,18,15,26,5,0,0,105
21,14,6,18,15,26,5,14,0,119
21,14,6,18,21,3,20,5,4,112
21,14,6,18,21,7,1,12,0,100
21,14,6,18,21,9,20,25,0,134
21,14,6,21,4,4,12,5,4,91
21,14,6,21,4,7,5,4,0,82
21,14,6,21,5,12,5,4,0,88
21,14,6,21,5,12,12,5,4,100
21,14,6,21,7,1,12,0,0,82
21,14,6,21,7,1,12,12,25,119
21,14,6,21,12,6,9,12,0,101
21,14,6,21,12,6,9,12,12,113
21,14,6,21,12,7,5,14,20,120
21,14,6,21,12,12,0,0,0,86
21,14,6,21,12,12,5,4,0,95
21,14,6,21,12,12,25,0,0,111
21,14,6,21,12,19,15,13,5,126
21,14,6,21,13,2,12,5,4,98
21,14,6,21,13,5,4,0,0,84
21,14,6,21,13,9,14,7,0,105
21,14,6,21,14,4,5,4,0,89
21,14,6,21,14,14,25,0,0,115
21,14,6,21,14,14,9,12,25,136
21,14,6,21,18,0,0,0,0,80
21,14,6,21,18,3,1,20,5,109
21,14,6,21,18,9,15,21,19,144
21,14,6,21,18,12,0,0,0,92
21,14,6,21,18,12,5,4,0,101
21,14,6,21,18,12,9,14,7,122
21,14,6,21,18,12,19,0,0,111
21,14,6,21,18,14,9,19,8,130
21,14,6,21,18,18,5,4,0,107
21,14,6,21,18,18,15,23,0,136
21,14,6,21,19,5,4,0,0,90
21,14,6,21,19,9,2,12,5,109
21,14,6,21,19,9,2,12,25,129
21,14,6,21,19,19,5,4,0,109
21,14,6,21,19,19,25,0,0,125
21,14,6,21,19,19,9,12,25,146
21,14,6,21,19,19,9,14,7,130
21,14,6,21,20,9,12,5,0,108
21,14,7,0,0,0,0,0,0,42
21,14,7,1,2,12,5,4,0,66
21,14,7,1,7,0,0,0,0,50
21,14,7,1,7,5,4,0,0,59
21,14,7,1,7,7,5,4,0,66
21,14,7,1,7,7,9,14,7,87
21,14,7,1,9,14,0,0,0,66
21,14,7,1,9,14,5,4,0,75
21,14,7,1,9,14,6,21,12,105
21,14,7,1,9,14,9,14,7,96
21,14,7,1,9,14,12,25,0,103
21,14,7,1,9,20,5,0,0,77
21,14,7,1,9,20,5,4,0,81
21,14,7,1,12,12,1,14,20,102
21,14,7,1,12,12,5,4,0,76
21,14,7,1,12,12,9,14,7,97
21,14,7,1,13,2,12,5,4,79
21,14,7,1,13,25,0,0,0,81
21,14,7,1,14,7,5,4,0,73
21,14,7,1,16,9,14,7,0,89
21,14,7,1,18,1,7,5,4,78
21,14,7,1,18,2,5,4,0,72
21,14,7,1,18,2,12,5,4,84
21,14,7,1,18,7,12,5,4,89
21,14,7,1,18,12,1,14,4,92
21,14,7,1,18,13,5,14,20,113
21,14,7,1,18,14,9,19,8,111
21,14,7,1,18,15,0,0,0,76
21,14,7,1,18,20,5,18,0,104
21,14,7,1,19,8,5,4,0,79
21,14,7,1,19,19,5,4,0,90
21,14,7,1,19,20,18,9,3,112
21,14,7,1,20,5,4,0,0,72
21,14,7,1,21,4,25,0,0,93
21,14,7,1,21,4,9,12,25,114
21,14,7,1,21,7,5,4,0,80
21,14,7,1,26,9,14,7,0,99
21,14,7,5,1,18,0,0,0,66
21,14,7,5,1,18,5,4,0,75
21,14,7,5,12,4,5,4,0,72
21,14,7,5,12,20,0,0,0,79
21,14,7,5,14,5,18,1,12,97
21,14,7,5,14,5,18,9,3,96
21,14,7,5,14,9,1,12,0,83
21,14,7,5,14,9,21,19,0,110
21,14,7,5,14,20,5,5,12,103
21,14,7,5,14,20,9,12,5,107
21,14,7,5,14,20,12,5,0,98
21,14,7,5,14,20,12,5,4,102
21,14,7,5,14,20,12,25,0,118
21,14,7,5,14,21,9,14,5,110
21,14,7,5,18,13,1,14,5,98
21,14,7,5,19,20,9,14,7,116
21,14,7,5,20,0,0,0,0,67
21,14,7,5,20,1,2,12,5,87
21,14,7,8,15,19,20,12,25,141
21,14,7,9,1,14,20,0,0,86
21,14,7,9,2,2,5,20,0,80
21,14,7,9,4,4,25,0,0,84
21,14,7,9,6,20,0,0,0,77
21,14,7,9,6,20,5,4,0,86
21,14,7,9,12,4,0,0,0,67
21,14,7,9,12,4,5,4,0,76
21,14,7,9,12,12,0,0,0,75
21,14,7,9,12,12,5,4,0,84
21,14,7,9,12,20,0,0,0,83
21,14,7,9,14,7,12,5,4,93
21,14,7,9,14,14,5,4,0,88
21,14,7,9,18,4,0,0,0,73
21,14,7,9,18,4,5,4,0,82
21,14,7,9,18,4,9,14,7,103
21,14,7,9,18,4,12,5,0,90
21,14,7,9,18,4,12,5,4,94
21,14,7,9,18,4,19,0,0,92
21,14,7,9,18,12,9,19,8,117
21,14,7,9,18,20,0,0,0,89
21,14,7,9,18,20,8,0,0,97
21,14,7,9,18,20,8,5,4,106
21,14,7,9,22,1,2,12,5,93
21,14,7,9,22,5,0,0,0,78
21,14,7,25,22,5,0,0,0,94
21,14,7,25,22,5,4,0,0,98
21,14,7,9,22,5,14,0,0,92
21,14,7,9,22,9,14,7,0,103
21,14,7,11,1,0,0,0,0,54
21,14,7,12,1,3,9,1,12,80
21,14,7,12,1,4,0,0,0,59
21,14,7,12,1,4,4,5,14,82
21,14,7,12,1,4,12,25,0,96
21,14,7,12,1,18,9,14,7,103
21,14,7,12,1,19,19,5,4,102
21,14,7,12,1,19,19,25,0,118
21,14,7,12,1,26,5,0,0,86
21,14,7,12,1,26,5,4,0,90
21,14,7,12,5,1,14,5,4,83
21,14,7,12,5,5,0,0,0,64
21,14,7,12,5,5,6,21,12,103
21,14,7,12,9,2,0,0,0,65
21,14,7,12,9,2,12,25,0,102
21,14,7,12,9,4,9,14,7,97
21,14,7,12,15,2,5,0,0,76
21,14,7,12,15,15,13,0,0,97
21,14,7,12,15,15,13,5,4,106
21,14,7,12,15,15,13,25,0,122
21,14,7,12,15,18,25,0,0,112
21,14,7,12,15,18,9,6,25,127
21,14,7,12,15,19,5,4,0,97
21,14,7,12,15,19,19,0,0,107
21,14,7,12,15,19,19,5,4,116
21,14,7,12,15,19,19,25,0,132
21,14,7,12,15,22,5,0,0,96
21,14,7,12,15,22,5,4,0,100
21,14,7,12,15,22,5,19,0,115
21,14,7,12,15,22,9,14,7,121
21,14,7,12,15,23,9,14,7,122
21,14,7,12,15,26,5,4,0,104
21,14,7,12,21,5,0,0,0,80
21,14,7,12,21,5,4,0,0,84
21,14,7,12,21,5,19,0,0,99
21,14,7,12,21,9,14,7,0,105
21,14,7,12,21,20,20,5,4,124
21,14,7,14,1,18,12,5,4,96
21,14,7,14,1,18,18,5,4,102
21,14,7,14,1,23,0,0,0,80
21,14,7,14,1,23,5,4,0,89
21,14,7,14,1,23,14,0,0,94
21,14,7,14,15,19,20,9,3,122
21,14,7,15,1,4,5,4,0,71
21,14,7,15,4,0,0,0,0,61
21,14,7,15,4,4,5,19,19,108
21,14,7,15,4,12,25,0,0,98
21,14,7,15,4,12,9,5,18,105
21,14,7,15,4,12,9,11,5,98
21,14,7,15,4,12,9,12,25,119
21,14,7,15,7,7,12,5,4,92
21,14,7,15,12,4,0,0,0,73
21,14,7,15,12,4,5,14,0,92
21,14,7,15,14,5,0,0,0,76
21,14,7,15,15,4,0,0,0,76
21,14,7,15,15,4,12,25,0,113
21,14,7,15,18,5,4,0,0,84
21,14,7,15,18,7,5,0,0,87
21,14,7,15,18,7,5,4,0,91
21,14,7,15,19,16,5,12,0,109
21,14,7,15,19,19,9,16,25,145
21,14,7,15,20,0,0,0,0,77
21,14,7,15,20,8,9,3,0,97
21,14,7,15,20,20,5,14,0,116
21,14,7,15,21,7,5,4,0,94
21,14,7,15,21,20,25,0,0,123
21,14,7,15,23,14,0,0,0,94
21,14,7,15,23,14,5,4,0,103
21,14,7,18,1,3,5,0,0,69
21,14,7,18,1,3,5,4,0,73
21,14,7,18,1,4,5,4,0,74
21,14,7,18,1,4,21,1,12,99
21,14,7,18,1,6,20,0,0,87
21,14,7,18,1,6,20,5,4,96
21,14,7,18,1,25,5,4,0,95
21,14,7,18,1,9,14,0,0,84
21,14,7,18,1,9,14,5,4,93
21,14,7,18,1,13,13,1,18,106
21,14,7,18,1,14,4,0,0,79
21,14,7,18,1,14,20,5,4,104
21,14,7,18,1,16,8,9,3,97
21,14,7,18,1,16,16,12,5,110
21,14,7,18,1,19,16,0,0,96
21,14,7,18,1,19,16,5,4,105
21,14,7,18,1,19,19,5,4,108
21,14,7,18,1,19,19,25,0,124
21,14,7,18,1,20,5,4,0,90
21,14,7,18,1,20,9,14,7,111
21,14,7,18,1,22,5,0,0,88
21,14,7,18,1,22,5,4,0,92
21,14,7,18,1,22,5,12,25,125
21,14,7,18,1,22,5,14,0,102
21,14,7,18,1,26,5,4,0,96
21,14,7,18,5,1,19,5,4,94
21,14,7,18,5,1,19,25,0,110
21,14,7,18,5,1,20,0,0,86
21,14,7,18,5,1,20,12,25,123
21,14,7,18,5,5,4,25,0,99
21,14,7,18,5,5,14,0,0,84
21,14,7,18,5,5,14,5,4,93
21,14,7,18,5,5,20,5,4,99
21,14,7,18,5,25,5,4,0,99
21,14,7,18,9,4,0,0,0,73
21,14,7,18,9,5,22,5,0,101
21,14,7,18,9,5,22,5,4,105
21,14,7,18,9,12,12,5,4,102
21,14,7,18,9,13,5,4,0,91
21,14,7,18,9,14,14,5,4,106
21,14,7,18,9,16,0,0,0,85
21,14,7,18,9,16,5,0,0,90
21,14,7,18,9,16,16,5,4,110
21,14,7,18,9,20,20,25,0,134
21,14,7,18,15,9,14,5,4,107
21,14,7,18,15,15,13,5,4,112
21,14,7,18,15,15,22,5,4,121
21,14,7,18,15,19,19,0,0,113
21,14,7,18,15,21,14,4,0,114
21,14,7,18,15,21,16,5,4,121
21,14,7,18,15,23,0,0,0,98
21,14,7,18,15,23,9,14,7,128
21,14,7,18,15,23,14,0,0,112
21,14,7,18,21,2,2,5,4,94
21,14,7,18,21,4,7,5,4,101
21,14,7,18,21,6,6,0,0,93
21,14,7,18,21,13,16,25,0,135
21,14,7,20,0,0,0,0,0,62
21,14,7,21,1,12,0,0,0,76
21,14,7,21,1,12,19,0,0,95
21,14,7,21,1,18,4,0,0,86
21,14,7,21,1,18,4,5,4,95
21,14,7,21,1,18,4,19,0,105
21,14,7,21,5,1,12,0,0,81
21,14,7,21,5,14,20,0,0,102
21,14,7,21,5,14,20,1,0,103
21,14,7,21,5,14,20,15,0,117
21,14,7,21,5,14,20,19,0,121
21,14,7,21,5,14,20,21,13,136
21,14,7,21,5,19,0,0,0,87
21,14,7,21,5,19,19,5,4,115
21,14,7,21,9,3,1,12,0,88
21,14,7,21,9,3,15,18,14,122
21,14,7,21,9,3,21,12,5,113
21,14,7,21,9,4,5,4,0,85
21,14,7,21,25,5,4,0,0,97
21,14,7,21,9,6,15,18,13,124
21,14,7,21,9,12,5,4,0,93
21,14,7,21,9,12,20,25,0,129
21,14,7,21,9,14,1,12,0,99
21,14,7,21,9,14,15,21,19,141
21,14,7,21,9,19,0,0,0,91
21,14,7,21,12,1,0,0,0,76
21,14,7,21,12,1,5,0,0,81
21,14,7,21,12,1,18,0,0,94
21,14,7,21,12,1,20,5,0,101
21,14,7,21,12,1,20,5,4,105
21,14,7,21,12,1,20,5,19,120
21,14,7,21,12,5,4,0,0,84
21,14,7,21,12,9,20,5,0,109
21,14,7,21,12,12,0,0,0,87
21,14,7,21,12,15,21,19,0,130
21,14,7,21,12,16,0,0,0,91
21,14,7,21,13,0,0,0,0,76
21,14,7,21,13,13,5,4,0,98
21,14,7,21,19,8,9,14,7,120
21,14,7,21,20,20,5,4,0,112
21,14,7,21,26,26,12,5,4,136
21,14,8,1,2,9,12,5,0,72
21,14,8,1,2,9,20,0,0,75
21,14,8,1,2,9,20,5,4,84
21,14,8,1,3,11,5,4,0,67
21,14,8,1,3,11,12,5,4,79
21,14,8,1,4,0,0,0,0,48
21,14,8,1,6,20,0,0,0,70
21,14,8,1,6,20,5,4,0,79
21,14,8,1,7,7,12,5,4,79
21,14,8,1,25,5,4,0,0,78
21,14,8,1,9,12,5,4,0,74
21,14,8,1,9,18,0,0,0,71
21,14,8,1,9,18,5,4,0,80
21,14,8,1,9,18,5,18,0,94
21,14,8,1,9,18,25,0,0,96
21,14,8,1,9,18,9,12,25,117
21,14,8,1,9,18,9,14,7,101
21,14,8,1,9,18,19,0,0,90
21,14,8,1,12,5,0,0,0,61
21,14,8,1,12,12,15,23,0,106
21,14,8,1,12,12,15,23,19,125
21,14,8,1,12,15,5,4,0,80
21,14,8,1,12,19,5,4,0,84
21,14,8,1,12,20,5,4,0,85
21,14,8,1,12,20,5,18,0,99
21,14,8,1,12,20,9,14,7,106
21,14,8,1,12,22,5,4,0,87
21,14,8,1,13,16,5,18,0,96
21,14,8,1,14,4,0,0,0,62
21,14,8,1,14,4,5,4,0,71
21,14,8,1,14,4,25,0,0,87
21,14,8,1,14,4,9,5,18,94
21,14,8,1,14,4,9,12,25,108
21,14,8,1,14,4,9,14,7,92
21,14,8,1,14,4,12,5,4,83
21,14,8,1,14,4,19,0,0,81
21,14,8,1,14,7,0,0,0,65
21,14,8,1,14,7,5,4,0,74
21,14,8,1,14,7,9,14,7,95
21,14,8,1,14,7,19,0,0,84
21,14,8,1,14,11,5,4,0,78
21,14,8,1,16,0,0,0,0,60
21,14,8,1,16,16,5,14,0,95
21,14,8,1,16,16,9,0,0,85
21,14,8,1,16,16,25,0,0,101
21,14,8,1,16,16,9,5,18,108
21,14,8,1,16,16,9,12,25,122
21,14,8,1,18,2,15,18,0,97
21,14,8,1,18,2,15,21,18,118
21,14,8,1,18,4,0,0,0,66
21,14,8,1,18,4,5,14,0,85
21,14,8,1,18,4,25,0,0,91
21,14,8,1,18,4,9,12,25,112
21,14,8,1,18,11,5,4,0,82
21,14,8,1,18,13,5,4,0,84
21,14,8,1,18,13,6,21,12,114
21,14,8,1,18,13,9,14,7,105
21,14,8,1,18,13,15,14,25,129
21,14,8,1,18,14,5,19,19,119
21,14,8,1,18,16,5,4,0,87
21,14,8,1,18,16,9,14,7,108
21,14,8,1,18,18,9,5,4,98
21,14,8,1,18,19,8,0,0,89
21,14,8,1,18,19,8,12,25,126
21,14,8,1,19,8,5,4,0,80
21,14,8,1,19,16,0,0,0,79
21,14,8,1,19,16,5,4,0,88
21,14,8,1,19,20,5,0,0,88
21,14,8,1,19,20,5,4,0,92
21,14,8,1,19,20,25,0,0,108
21,14,8,1,19,20,9,12,25,129
21,14,8,1,19,20,9,14,7,113
21,14,8,1,20,0,0,0,0,64
21,14,8,1,20,3,8,5,4,84
21,14,8,1,20,5,0,0,0,69
21,14,8,1,20,5,4,0,0,73
21,14,8,1,20,5,6,21,12,108
21,14,8,1,20,9,14,7,0,94
21,14,8,1,20,19,0,0,0,83
21,14,8,1,20,20,5,4,0,93
21,14,8,1,20,20,9,14,7,114
21,14,8,1,21,12,5,4,0,86
21,14,8,1,21,14,20,0,0,99
21,14,8,1,21,14,20,5,4,108
21,14,8,1,22,5,0,0,0,71
21,14,8,1,23,11,5,4,0,87
21,14,8,1,26,5,4,0,0,79
21,14,8,1,26,25,0,0,0,95
21,14,8,1,26,9,12,25,0,116
21,14,8,5,1,4,0,0,0,53
21,14,8,5,1,4,5,4,0,62
21,14,8,5,1,4,5,18,0,76
21,14,8,5,1,4,25,0,0,78
21,14,8,5,1,12,0,0,0,61
21,14,8,5,1,12,5,4,0,70
21,14,8,5,1,12,9,14,7,91
21,14,8,5,1,12,20,8,0,89
21,14,8,5,1,12,20,8,25,114
21,14,8,5,1,16,5,4,0,74
21,14,8,5,1,18,4,0,0,71
21,14,8,5,1,18,9,14,7,97
21,14,8,5,1,18,19,5,0,91
21,14,8,5,1,18,19,5,4,95
21,14,8,5,1,18,20,0,0,87
21,14,8,5,1,18,20,5,14,106
21,14,8,5,1,18,20,25,0,112
21,14,8,5,1,20,5,4,0,78
21,14,8,5,1,20,8,5,14,96
21,14,8,5,1,22,5,4,0,80
21,14,8,5,1,22,5,14,0,90
21,14,8,5,1,22,25,0,0,96
21,14,8,5,1,22,9,12,25,117
21,14,8,5,3,20,9,3,0,83
21,14,8,5,4,7,5,0,0,64
21,14,8,5,4,7,5,4,0,68
21,14,8,5,4,7,9,14,7,89
21,14,8,5,5,4,0,0,0,57
21,14,8,5,5,4,5,4,0,66
21,14,8,5,5,4,6,21,12,96
21,14,8,5,5,4,25,0,0,82
21,14,8,5,5,4,9,14,7,87
21,14,8,5,5,12,5,4,0,74
21,14,8,5,6,20,5,4,0,83
21,14,8,5,9,18,5,4,0,84
21,14,8,5,12,4,0,0,0,64
21,14,8,5,12,5,0,0,0,65
21,14,8,5,12,5,18,0,0,83
21,14,8,5,12,13,0,0,0,73
21,14,8,5,12,13,5,4,0,82
21,14,8,5,12,13,5,20,0,98
21,14,8,5,12,13,9,14,7,103
21,14,8,5,12,13,19,0,0,92
21,14,8,5,12,16,0,0,0,76
21,14,8,5,12,16,5,4,0,85
21,14,8,5,12,16,6,21,12,115
21,14,8,5,12,16,9,14,7,106
21,14,8,5,12,22,5,4,0,91
21,14,8,5,13,13,5,4,0,83
21,14,8,5,14,4,5,0,0,71
21,14,8,5,14,20,0,0,0,82
21,14,8,5,16,16,5,14,0,99
21,14,8,5,18,4,0,0,0,70
21,14,8,5,18,4,5,4,0,79
21,14,8,5,18,15,0,0,0,81
21,14,8,5,18,15,9,3,0,93
21,14,8,5,18,15,9,19,13,122
21,14,8,5,18,15,9,26,5,121
21,14,8,5,23,1,2,12,5,91
21,14,8,5,23,5,4,0,0,80
21,14,8,5,23,14,0,0,0,85
21,14,8,5,24,0,0,0,0,72
21,14,8,9,4,0,0,0,0,56
21,14,8,9,4,1,2,12,5,76
21,14,8,9,4,1,2,12,25,96
21,14,8,9,4,1,20,5,4,86
21,14,8,9,4,4,5,14,0,79
21,14,8,9,4,5,0,0,0,61
21,14,8,9,4,5,15,21,19,116
21,14,8,25,7,5,14,9,3,106
21,14,8,9,7,8,0,0,0,67
21,14,8,9,12,12,25,0,0,101
21,14,8,25,13,14,5,4,0,104
21,14,8,9,14,7,5,0,0,78
21,14,8,9,14,7,5,4,0,82
21,14,8,9,14,7,5,19,0,97
21,14,8,9,14,7,9,14,7,103
21,14,8,9,14,20,5,4,0,95
21,14,8,9,16,0,0,0,0,68
21,14,8,9,16,16,5,4,0,93
21,14,8,9,18,5,4,0,0,79
21,14,8,9,19,19,5,4,0,99
21,14,8,9,19,20,15,18,25,149
21,14,8,9,20,0,0,0,0,72
21,14,8,9,20,3,8,0,0,83
21,14,8,9,20,3,8,5,4,92
21,14,8,9,20,3,8,5,19,107
21,14,8,9,22,5,0,0,0,79
21,14,8,15,1,18,4,0,0,81
21,14,8,15,1,18,4,5,4,90
21,14,8,15,1,18,25,0,0,102
21,14,8,15,1,24,5,4,0,92
21,14,8,15,2,2,12,5,0,79
21,14,8,15,3,11,5,4,0,81
21,14,8,15,5,4,0,0,0,67
21,14,8,15,7,7,5,4,0,81
21,14,8,15,9,19,20,0,0,106
21,14,8,15,9,19,20,5,4,115
21,14,8,15,12,4,0,0,0,74
21,14,8,15,12,25,0,0,0,95
21,14,8,15,12,9,4,1,25,109
21,14,8,15,12,9,5,18,0,102
21,14,8,15,12,9,5,19,20,123
21,14,8,15,12,9,12,25,0,116
21,14,8,15,12,12,15,23,0,120
21,14,8,15,12,16,5,14,0,105
21,14,8,15,13,5,0,0,0,76
21,14,8,15,13,5,12,25,0,113
21,14,8,15,13,9,19,8,0,107
21,14,8,15,14,5,4,0,0,81
21,14,8,15,14,5,25,5,4,111
21,14,8,15,14,5,19,20,0,116
21,14,8,15,14,5,19,20,25,141
21,14,8,15,14,9,5,4,0,90
21,14,8,15,14,15,18,5,4,114
21,14,8,15,15,4,0,0,0,77
21,14,8,15,15,4,5,4,0,86
21,14,8,15,15,4,9,14,7,107
21,14,8,15,15,4,19,0,0,96
21,14,8,15,15,6,5,4,0,88
21,14,8,15,15,11,0,0,0,84
21,14,8,15,15,11,5,4,0,93
21,14,8,15,15,11,9,14,7,114
21,14,8,15,15,11,19,0,0,103
21,14,8,15,15,16,0,0,0,89
21,14,8,15,15,16,5,4,0,98
21,14,8,15,15,16,5,18,0,112
21,14,8,15,15,20,5,4,0,102
21,14,8,15,16,5,0,0,0,79
21,14,8,15,16,5,4,0,0,83
21,14,8,15,16,5,4,12,25,120
21,14,8,15,16,5,6,21,12,118
21,14,8,15,16,9,14,7,0,104
21,14,8,15,16,16,5,4,0,99
21,14,8,15,16,16,12,5,4,111
21,14,8,15,18,14,5,4,0,99
21,14,8,15,18,14,25,0,0,115
21,14,8,15,18,19,5,0,0,100
21,14,8,15,18,19,5,4,0,104
21,14,8,15,18,19,5,19,0,119
21,14,8,15,18,19,9,14,7,125
21,14,8,15,19,5,0,0,0,82
21,14,8,15,19,5,4,0,0,86
21,14,8,15,19,20,9,12,5,123
21,14,8,15,20,0,0,0,0,78
21,14,8,15,21,14,4,5,4,106
21,14,8,15,21,19,5,0,0,103
21,14,8,15,21,19,5,4,0,107
21,14,8,15,21,19,5,19,0,122
21,14,8,15,21,19,9,14,7,128
21,14,8,21,4,4,12,5,0,89
21,14,8,21,4,4,12,5,4,93
21,14,8,21,5,4,0,0,0,73
21,14,8,21,7,7,5,4,0,87
21,14,8,21,12,12,0,0,0,88
21,14,8,21,12,12,5,4,0,97
21,14,8,21,13,1,14,0,0,92
21,14,8,21,13,1,14,5,0,97
21,14,8,21,13,1,14,12,25,129
21,14,8,21,13,2,12,5,0,96
21,14,8,21,13,2,12,5,4,100
21,14,8,21,13,2,12,25,0,116
21,14,8,21,13,9,4,0,0,90
21,14,8,21,13,15,18,5,4,119
21,14,8,21,14,7,0,0,0,85
21,14,8,21,14,20,5,4,0,107
21,14,8,21,18,4,12,5,4,107
21,14,8,21,18,12,5,4,0,103
21,14,8,21,18,18,9,5,4,118
21,14,8,21,18,20,0,0,0,102
21,14,8,21,18,20,5,4,0,111
21,14,8,21,18,20,6,21,12,141
21,14,8,21,18,20,9,14,7,132
21,14,8,21,19,8,5,4,0,100
21,14,8,21,19,8,9,14,7,121
21,14,8,21,19,11,0,0,0,94
21,14,8,21,19,11,5,4,0,103
21,14,8,21,19,11,9,14,7,124
21,14,8,21,19,11,19,0,0,113
21,14,8,21,19,20,12,5,4,124
21,14,8,21,20,3,8,5,4,104
21,14,8,21,26,26,1,5,4,126
21,14,9,1,12,7,1,12,0,77
21,14,9,1,13,2,9,3,0,72
21,14,9,1,24,1,12,0,0,82
21,14,9,1,24,1,12,12,25,119
21,14,9,1,24,9,1,12,0,91
21,14,9,2,1,19,1,12,0,79
21,14,9,2,12,5,0,0,0,63
21,14,9,3,5,0,0,0,0,52
21,14,9,3,5,4,0,0,0,56
21,14,9,3,5,12,12,0,0,76
21,14,9,3,5,12,12,5,4,85
21,14,9,3,8,15,18,4,0,92
21,14,9,3,25,3,12,5,0,92
21,14,9,3,25,3,12,5,19,111
21,14,9,3,9,14,7,0,0,77
21,14,9,3,9,19,13,0,0,88
21,14,9,3,9,19,20,0,0,95
21,14,9,3,9,20,25,0,0,101
21,14,9,3,12,9,14,1,12,95
21,14,9,3,15,12,15,18,0,107
21,14,9,3,15,12,15,21,18,128
21,14,9,3,15,18,14,0,0,94
21,14,9,3,15,18,14,9,3,106
21,14,9,3,15,18,14,19,0,113
21,14,9,3,21,13,0,0,0,81
21,14,9,3,21,18,19,1,12,118
21,14,9,3,21,19,16,9,4,116
21,14,9,4,1,3,20,25,12,109
21,14,9,4,5,1,5,4,0,63
21,14,9,4,5,1,12,0,0,66
21,14,9,4,5,1,20,5,4,83
21,14,9,4,25,12,12,9,3,109
21,14,9,4,9,18,5,3,20,103
21,14,9,4,12,5,0,0,0,65
21,14,9,4,12,25,0,0,0,85
21,14,9,4,12,9,14,7,0,90
21,14,9,5,0,0,0,0,0,49
21,14,25,5,1,14,5,4,0,89
21,14,25,5,1,18,14,5,4,107
21,14,9,6,1,3,5,0,0,59
21,14,9,6,1,3,5,4,0,63
21,14,9,6,1,3,5,19,0,78
21,14,9,6,1,3,9,1,12,76
21,14,9,6,25,0,0,0,0,75
21,14,9,6,9,1,2,12,5,79
21,14,9,6,9,3,0,0,0,62
21,14,9,6,9,5,4,0,0,68
21,14,9,6,9,5,4,12,25,105
21,14,9,6,9,5,18,0,0,82
21,14,9,6,9,5,18,19,0,101
21,14,9,6,9,5,19,0,0,83
21,14,9,6,25,9,14,7,0,105
21,14,9,6,9,12,1,18,0,90
21,14,9,6,12,15,18,1,12,108
21,14,9,6,12,15,23,0,0,100
21,14,9,6,15,3,1,12,0,81
21,14,9,6,15,12,9,1,18,105
21,14,9,6,15,18,13,0,0,96
21,14,9,6,15,18,13,1,12,109
21,14,9,6,15,18,13,5,4,105
21,14,9,6,15,18,13,5,18,119
21,14,9,6,15,18,13,12,25,133
21,14,9,6,15,18,13,19,0,115
21,14,9,7,5,14,9,19,20,118
21,14,9,7,5,14,15,21,19,125
21,14,9,7,14,9,20,5,4,103
21,14,9,7,14,15,18,5,4,107
21,14,25,9,5,12,4,5,4,99
21,14,9,10,21,7,1,20,5,108
21,14,9,10,21,7,15,21,19,137
21,14,9,12,9,14,5,1,18,103
21,14,9,12,12,21,4,5,4,102
21,14,9,12,12,21,13,5,4,111
21,14,9,12,15,2,1,12,0,86
21,14,9,12,15,2,1,18,0,92
21,14,9,12,15,2,1,20,5,99
21,14,9,12,15,2,5,0,0,78
21,14,9,12,15,2,5,4,0,82
21,14,9,13,1,7,5,4,0,74
21,14,9,13,1,7,9,14,5,93
21,14,9,13,1,14,21,1,12,106
21,14,9,13,2,9,2,5,4,79
21,14,9,13,2,15,23,5,4,106
21,14,9,13,2,18,21,5,4,107
21,14,9,13,2,21,5,4,0,89
21,14,9,13,5,4,9,1,12,88
21,14,9,13,13,21,18,5,4,118
21,14,9,13,15,4,1,12,0,89
21,14,9,13,16,1,9,18,0,101
21,14,9,13,16,5,4,0,0,82
21,14,9,13,16,5,4,5,4,91
21,14,9,13,16,12,9,5,4,103
21,14,9,13,16,15,19,5,4,116
21,14,9,13,16,21,20,5,4,123
21,14,9,14,3,9,19,5,4,98
21,14,9,14,3,9,20,5,4,99
21,14,9,14,4,5,24,5,4,100
21,14,9,14,4,21,3,5,4,95
21,14,9,14,5,18,20,0,0,101
21,14,9,14,5,18,20,12,25,138
21,14,9,14,5,18,22,5,4,112
21,14,9,14,6,5,6,20,0,95
21,14,9,14,6,9,24,5,4,106
21,14,9,14,6,21,19,5,4,113
21,14,9,14,8,1,12,5,4,88
21,14,9,14,8,21,13,5,4,109
21,14,9,14,10,21,18,5,4,116
21,14,9,14,11,5,4,0,0,78
21,14,9,14,12,1,9,4,0,84
21,14,9,14,14,0,0,0,0,72
21,14,9,14,14,1,20,5,0,98
21,14,9,14,15,4,1,12,0,90
21,14,9,14,19,1,14,5,0,97
21,14,9,14,19,21,12,1,18,129
21,14,9,14,19,21,18,5,4,125
21,14,9,14,20,5,14,20,0,117
21,14,9,14,20,15,14,5,4,116
21,14,9,14,21,18,5,4,0,106
21,14,9,14,21,18,14,5,4,120
21,14,9,14,22,1,4,5,4,94
21,14,9,14,22,9,20,5,0,114
21,14,9,14,22,9,20,5,4,118
21,14,9,14,22,15,11,5,4,115
21,14,9,14,23,15,22,5,14,137
21,14,9,15,3,21,12,1,18,114
21,14,9,15,9,4,0,0,0,72
21,14,25,15,11,5,0,0,0,91
21,14,25,15,11,5,4,0,0,95
21,14,25,15,11,5,19,0,0,110
21,14,25,15,11,9,14,7,0,116
21,14,25,15,12,4,5,14,0,110
21,14,9,15,14,5,4,0,0,82
21,14,9,15,14,9,3,0,0,85
21,14,9,15,14,9,4,0,0,86
21,14,9,15,14,9,19,5,0,106
21,14,9,15,14,9,19,5,4,110
21,14,9,15,14,9,19,5,19,125
21,14,9,15,14,9,19,13,19,133
21,14,9,15,14,9,19,20,19,140
21,14,9,15,14,9,26,5,0,113
21,14,9,15,14,9,26,5,4,117
21,14,9,15,14,9,26,5,18,131
21,14,9,15,14,9,26,5,19,132
21,14,9,15,14,15,9,4,0,101
21,14,9,15,14,19,0,0,0,92
21,14,25,15,21,14,7,0,0,117
21,14,9,15,22,1,12,0,0,94
21,14,9,15,22,21,12,1,18,133
21,14,9,16,1,18,1,0,0,80
21,14,9,16,1,18,15,21,19,134
21,14,9,16,1,18,20,0,0,99
21,14,9,16,5,4,0,0,0,69
21,14,9,16,8,1,19,5,0,93
21,14,9,16,8,1,19,5,18,111
21,14,9,16,12,1,14,1,18,106
21,14,9,16,12,5,24,0,0,101
21,14,9,16,15,4,0,0,0,79
21,14,9,16,15,4,19,0,0,98
21,14,9,16,15,12,1,18,0,106
21,14,9,16,15,18,15,21,19,148
21,14,9,16,15,20,5,14,20,134
21,14,9,16,21,12,19,5,0,117
21,14,9,17,21,5,0,0,0,87
21,14,9,17,21,5,12,25,0,124
21,14,9,17,21,5,18,0,0,105
21,14,9,17,21,5,19,0,0,106
21,14,9,17,21,5,19,20,0,126
21,14,9,17,21,9,20,25,0,136
21,14,9,18,1,4,9,1,12,89
21,14,9,18,1,13,15,19,5,115
21,14,9,18,1,13,15,21,19,131
21,14,9,18,5,13,5,0,0,85
21,14,9,18,5,14,9,3,0,93
21,14,9,18,8,25,13,5,0,113
21,14,9,18,15,14,5,4,0,100
21,14,9,19,5,18,9,1,12,108
21,14,9,19,5,24,0,0,0,92
21,14,9,19,5,24,5,4,0,101
21,14,9,19,5,24,5,19,0,116
21,14,9,19,5,24,21,1,12,126
21,14,9,19,13,0,0,0,0,76
21,14,9,19,15,9,12,0,0,99
21,14,9,19,15,12,1,20,5,116
21,14,9,19,15,14,0,0,0,92
21,14,9,19,15,14,1,12,0,105
21,14,9,19,15,14,1,14,20,127
21,14,9,19,15,14,15,21,19,147
21,14,9,19,15,14,19,0,0,111
21,14,9,19,16,9,18,1,12,119
21,14,9,19,19,21,1,14,20,138
21,14,9,19,19,21,5,4,0,112
21,14,9,19,20,0,0,0,0,83
21,14,9,20,1,2,12,5,0,84
21,14,9,20,1,7,5,0,0,77
21,14,9,20,1,7,5,19,0,96
21,14,9,20,1,12,0,0,0,77
21,14,9,20,1,18,4,0,0,87
21,14,9,20,1,18,4,19,0,106
21,14,9,20,1,18,25,0,0,108
21,14,9,20,1,18,9,12,25,129
21,14,9,20,1,18,9,19,13,124
21,14,9,20,1,18,9,19,20,131
21,14,9,20,5,0,0,0,0,69
21,14,9,20,5,1,2,12,5,89
21,14,9,20,5,1,2,12,25,109
21,14,9,20,5,4,12,25,0,110
21,14,9,20,5,18,0,0,0,87
21,14,9,20,5,18,19,0,0,106
21,14,9,20,5,19,0,0,0,88
21,14,9,20,9,5,19,0,0,97
21,14,9,20,9,14,7,0,0,94
21,14,9,20,9,14,7,12,25,131
21,14,9,20,9,15,14,0,0,102
21,14,9,20,9,19,13,0,0,105
21,14,9,20,9,19,20,9,3,124
21,14,9,20,9,22,5,0,0,100
21,14,9,20,9,22,5,12,25,137
21,14,9,20,9,26,5,0,0,104
21,14,9,20,9,26,5,4,0,108
21,14,9,20,9,26,5,18,0,122
21,14,9,20,9,26,5,19,0,123
21,14,9,20,9,26,9,14,7,129
21,14,9,20,15,15,20,8,0,122
21,14,9,20,18,15,16,5,0,118
21,14,9,20,18,21,19,20,0,142
21,14,9,20,19,0,0,0,0,83
21,14,9,20,21,4,5,0,0,94
21,14,9,21,19,0,0,0,0,84
21,14,9,22,1,12,5,14,20,118
21,14,9,22,1,12,22,5,0,106
21,14,9,22,1,12,22,5,4,110
21,14,9,22,1,12,22,5,19,125
21,14,9,22,5,18,2,1,12,104
21,14,9,22,5,18,19,1,12,121
21,14,9,22,5,18,19,5,0,113
21,14,9,22,5,18,19,5,19,132
21,14,9,22,9,5,4,0,0,84
21,14,9,22,15,3,1,3,25,113
21,14,9,22,15,3,1,12,0,97
21,14,9,22,15,3,1,12,19,116
21,14,9,22,15,3,9,20,25,138
21,14,9,22,15,18,15,21,19,154
21,14,9,23,5,1,18,0,0,91
21,14,10,1,4,5,4,0,0,59
21,14,10,1,7,7,5,4,0,69
21,14,10,1,9,12,5,4,0,76
21,14,10,1,13,0,0,0,0,59
21,14,10,1,13,13,5,4,0,81
21,14,10,1,13,13,9,14,7,102
21,14,10,1,18,18,5,4,0,91
21,14,10,1,18,18,9,14,7,112
21,14,10,1,21,14,20,25,0,126
21,14,10,5,1,12,15,21,19,118
21,14,10,5,5,18,5,4,0,82
21,14,10,5,5,18,9,14,7,103
21,14,10,5,12,12,5,4,0,83
21,14,10,5,12,12,9,5,4,92
21,14,10,5,19,20,9,14,7,119
21,14,10,5,23,5,12,0,0,90
21,14,10,5,23,5,12,5,4,99
21,14,10,9,12,20,5,4,0,95
21,14,10,15,3,15,19,5,0,102
21,14,10,15,3,21,14,4,0,102
21,14,10,15,7,7,5,4,0,83
21,14,10,15,7,7,9,14,7,104
21,14,10,15,25,5,4,0,0,94
21,14,10,15,25,6,21,12,0,124
21,14,10,15,9,14,0,0,0,83
21,14,10,15,9,14,5,4,0,92
21,14,10,15,9,14,20,0,0,103
21,14,10,15,9,14,20,5,4,112
21,14,10,15,9,14,20,19,0,122
21,14,10,15,25,15,21,19,0,140
21,14,10,15,11,9,14,7,0,101
21,14,10,15,12,12,25,0,0,109
21,14,10,15,12,20,5,4,0,101
21,14,10,15,19,20,12,5,4,120
21,14,10,15,22,9,1,12,0,104
21,14,10,21,4,7,5,0,0,82
21,14,10,21,4,7,5,4,0,86
21,14,10,21,4,7,9,14,7,107
21,14,10,21,7,7,12,5,4,101
21,14,10,21,9,3,5,4,0,87
21,14,10,21,9,3,25,0,0,103
21,14,10,21,9,3,9,12,25,124
21,14,10,21,13,2,12,5,4,102
21,14,10,21,18,9,4,9,3,109
21,14,10,21,19,20,0,0,0,105
21,14,10,21,19,20,9,3,5,122
21,14,10,21,19,20,9,6,25,145
21,14,10,21,19,20,12,5,4,126
21,14,10,21,19,20,12,25,0,142
21,14,11,1,13,5,4,0,0,69
21,14,11,5,4,0,0,0,0,55
21,14,11,5,5,12,5,4,0,77
21,14,11,5,25,0,0,0,0,76
21,14,11,5,25,5,4,0,0,85
21,14,11,5,13,2,5,4,0,75
21,14,11,5,13,16,20,0,0,100
21,14,11,5,13,16,20,12,25,137
21,14,11,5,14,0,0,0,0,65
21,14,11,5,14,4,0,0,0,69
21,14,11,5,14,14,5,4,0,88
21,14,11,5,14,14,5,12,0,96
21,14,11,5,14,14,5,12,19,115
21,14,11,5,14,14,9,14,7,109
21,14,11,5,14,19,15,13,5,117
21,14,11,5,14,20,0,0,0,85
21,14,11,5,16,20,0,0,0,87
21,14,11,5,20,0,0,0,0,71
21,14,11,9,3,11,5,4,0,78
21,14,11,9,4,0,0,0,0,59
21,14,11,9,12,12,0,0,0,79
21,14,11,9,12,12,5,4,0,88
21,14,11,9,12,12,9,14,7,109
21,14,11,9,12,14,5,4,0,90
21,14,11,9,14,0,0,0,0,69
21,14,11,9,14,4,0,0,0,73
21,14,11,9,14,4,5,18,0,96
21,14,11,9,14,4,5,19,20,117
21,14,11,9,14,4,12,5,4,94
21,14,11,9,14,4,12,25,0,110
21,14,11,9,14,4,18,5,4,100
21,14,11,9,14,7,0,0,0,76
21,14,11,9,14,7,4,15,13,108
21,14,11,9,14,7,5,4,0,85
21,14,11,9,14,7,5,18,0,99
21,14,11,9,14,7,12,25,0,113
21,14,11,9,14,11,0,0,0,80
21,14,11,9,14,11,5,4,0,89
21,14,11,9,14,11,19,0,0,99
21,14,11,9,14,12,9,11,5,106
21,14,11,9,18,11,0,0,0,84
21,14,11,9,19,19,0,0,0,93
21,14,11,9,19,19,5,4,0,102
21,14,11,9,19,20,0,0,0,94
21,14,11,14,1,22,5,0,0,88
21,14,11,14,5,1,4,5,4,79
21,14,11,14,5,12,12,5,4,98
21,14,11,14,5,23,0,0,0,88
21,14,11,14,9,7,8,20,0,104
21,14,11,14,9,20,0,0,0,89
21,14,11,14,9,20,19,0,0,108
21,14,11,14,9,20,20,5,4,118
21,14,11,14,15,3,11,5,4,98
21,14,11,14,15,20,0,0,0,95
21,14,11,14,15,20,19,0,0,114
21,14,11,14,15,20,20,5,4,124
21,14,11,14,15,20,20,25,0,140
21,14,11,14,15,23,0,0,0,98
21,14,11,14,15,23,5,14,0,117
21,14,11,14,15,23,9,14,7,128
21,14,11,14,15,23,14,0,0,112
21,14,11,14,15,23,14,12,25,149
21,14,11,14,15,23,14,19,0,131
21,14,11,14,15,23,14,19,20,151
21,14,11,15,4,1,11,5,4,86
21,14,11,15,19,8,5,18,0,111
21,14,12,0,0,0,0,0,0,47
21,14,12,1,2,5,12,5,4,76
21,14,12,1,2,9,1,20,5,85
21,14,12,1,2,15,18,5,4,92
21,14,12,1,3,5,0,0,0,56
21,14,12,1,3,5,4,0,0,60
21,14,12,1,3,5,19,0,0,75
21,14,12,1,3,9,14,7,0,81
21,14,12,1,3,15,14,9,3,92
21,14,12,1,4,5,0,0,0,57
21,14,12,1,4,5,4,0,0,61
21,14,12,1,4,5,14,0,0,71
21,14,12,1,4,5,19,0,0,76
21,14,12,1,4,9,14,7,0,82
21,14,12,1,4,12,5,4,0,73
21,14,12,1,7,7,9,14,7,92
21,14,12,1,25,0,0,0,0,73
21,14,12,1,25,1,2,12,5,93
21,14,12,1,9,4,0,0,0,61
21,14,12,1,25,9,14,7,0,103
21,14,12,1,25,19,0,0,0,92
21,14,12,1,13,5,0,0,0,66
21,14,12,1,13,5,4,0,0,70
21,14,12,1,14,3,5,4,0,74
21,14,12,1,14,4,0,0,0,66
21,14,12,1,14,4,5,4,0,75
21,14,12,1,14,7,21,9,4,103
21,14,12,1,16,0,0,0,0,64
21,14,12,1,16,16,5,4,0,89
21,14,12,1,16,19,5,4,0,92
21,14,12,1,16,19,9,14,7,113
21,14,12,1,18,4,5,4,0,79
21,14,12,1,18,7,5,0,0,78
21,14,12,1,19,8,0,0,0,75
21,14,12,1,19,8,5,4,0,84
21,14,12,1,19,8,5,18,0,98
21,14,12,1,19,8,5,19,0,99
21,14,12,1,19,8,9,14,7,105
21,14,12,1,19,19,15,5,4,110
21,14,12,1,19,20,9,14,7,117
21,14,12,1,20,3,8,0,0,79
21,14,12,1,20,3,8,5,4,88
21,14,12,1,20,3,8,5,19,103
21,14,12,1,20,8,0,0,0,76
21,14,12,1,20,8,5,4,0,85
21,14,12,1,21,4,5,4,0,82
21,14,12,1,21,7,8,0,0,84
21,14,12,1,22,5,4,0,0,79
21,14,12,1,22,9,14,7,0,100
21,14,12,1,22,9,19,8,0,106
21,14,12,1,23,0,0,0,0,71
21,14,12,1,23,5,4,0,0,80
21,14,12,1,23,6,21,12,0,110
21,14,12,1,23,12,25,0,0,108
21,14,12,1,23,12,9,11,5,108
21,14,12,1,24,0,0,0,0,72
21,14,12,5,1,3,8,5,4,73
21,14,12,5,1,4,0,0,0,57
21,14,12,5,1,4,5,4,0,66
21,14,12,5,1,4,9,14,7,87
21,14,12,5,1,4,19,0,0,76
21,14,12,5,1,6,0,0,0,59
21,14,12,5,1,6,5,4,0,68
21,14,12,5,1,7,21,5,4,90
21,14,12,5,1,7,21,5,18,104
21,14,12,5,1,11,25,0,0,89
21,14,12,5,1,12,0,0,0,65
21,14,12,5,1,14,0,0,0,67
21,14,12,5,1,18,5,4,0,80
21,14,12,5,1,18,14,0,0,85
21,14,12,5,1,18,14,5,4,94
21,14,12,5,1,18,14,19,0,104
21,14,12,5,1,18,14,20,0,105
21,14,12,5,1,19,5,4,0,81
21,14,12,5,1,19,8,0,0,80
21,14,12,5,1,19,8,5,4,89
21,14,12,5,1,19,8,5,19,104
21,14,12,5,1,22,5,0,0,80
21,14,12,5,1,22,5,4,0,84
21,14,12,5,4,0,0,0,0,56
21,14,12,5,4,7,5,4,0,72
21,14,12,5,6,20,0,0,0,78
21,14,12,5,7,1,12,0,0,72
21,14,12,5,7,1,12,12,25,109
21,14,12,5,7,1,20,5,0,85
21,14,12,5,7,9,2,12,5,87
21,14,12,5,14,9,5,14,20,114
21,14,12,5,14,19,5,4,0,94
21,14,12,5,14,20,0,0,0,86
21,14,12,5,19,19,0,0,0,90
21,14,12,5,20,0,0,0,0,72
21,14,12,5,20,8,1,12,0,93
21,14,12,5,20,20,5,4,0,101
21,14,12,5,22,5,12,0,0,91
21,14,12,5,22,5,12,5,4,100
21,14,12,5,22,5,12,12,25,128
21,14,12,5,22,5,12,19,0,110
21,14,12,5,22,9,5,4,0,92
21,14,12,9,1,2,12,5,0,76
21,14,12,9,2,5,12,5,4,84
21,14,12,9,2,5,18,1,12,94
21,14,12,9,3,11,5,4,0,79
21,14,12,9,4,0,0,0,0,60
21,14,12,9,4,4,5,4,0,73
21,14,12,9,5,0,0,0,0,61
21,14,12,9,6,20,5,4,0,91
21,14,12,9,6,20,9,14,7,112
21,14,12,9,7,1,2,12,5,83
21,14,12,9,7,8,20,0,0,91
21,14,12,9,7,8,20,5,4,100
21,14,12,25,9,14,7,0,0,102
21,14,12,9,11,1,2,12,5,87
21,14,12,9,11,1,2,12,25,107
21,14,12,9,11,5,0,0,0,72
21,14,12,9,11,5,4,0,0,76
21,14,12,9,11,5,12,25,0,109
21,14,12,9,11,5,14,0,0,86
21,14,12,9,11,5,14,5,4,95
21,14,12,9,11,9,14,7,0,97
21,14,12,9,13,2,0,0,0,71
21,14,12,9,13,2,5,18,0,94
21,14,12,9,13,2,5,18,19,113
21,14,12,9,13,5,0,0,0,74
21,14,12,9,13,5,4,0,0,78
21,14,12,9,13,9,20,5,4,107
21,14,12,9,13,14,5,4,0,92
21,14,12,9,13,16,0,0,0,85
21,14,12,9,14,5,0,0,0,75
21,14,12,9,14,5,1,12,0,88
21,14,12,9,14,5,4,0,0,79
21,14,12,9,14,11,0,0,0,81
21,14,12,9,14,11,5,4,0,90
21,14,12,9,14,11,9,14,7,111
21,14,12,9,14,11,19,0,0,100
21,14,12,9,17,21,9,4,0,107
21,14,12,25,18,9,3,0,0,102
21,14,12,25,18,9,3,1,12,115
21,14,12,9,19,16,9,14,7,121
21,14,12,9,19,20,0,0,0,95
21,14,12,9,19,20,5,4,0,104
21,14,12,9,19,20,25,0,0,120
21,14,12,9,20,0,0,0,0,76
21,14,12,9,20,5,18,1,12,112
21,14,12,9,20,20,5,14,0,115
21,14,12,9,22,1,2,12,5,98
21,14,12,9,22,1,2,12,25,118
21,14,12,9,22,5,0,0,0,83
21,14,12,9,22,5,4,0,0,87
21,14,12,9,22,5,12,25,0,120
21,14,12,9,22,5,18,0,0,101
21,14,12,9,22,5,18,25,0,126
21,14,12,9,22,5,19,0,0,102
21,14,12,9,22,9,14,7,0,108
21,14,12,15,1,4,0,0,0,67
21,14,12,15,1,4,5,4,0,76
21,14,12,15,1,4,5,14,0,86
21,14,12,15,1,4,5,18,0,90
21,14,12,15,1,4,5,18,19,109
21,14,12,15,1,4,9,14,7,97
21,14,12,15,1,4,19,0,0,86
21,14,12,15,1,6,9,14,7,99
21,14,12,15,1,14,5,4,0,86
21,14,12,15,1,14,9,14,7,107
21,14,12,15,1,20,8,0,0,91
21,14,12,15,1,20,8,5,4,100
21,14,12,15,1,20,8,12,25,128
21,14,12,15,2,2,9,5,4,84
21,14,12,15,2,5,4,0,0,73
21,14,12,15,3,1,12,0,0,78
21,14,12,15,3,1,12,12,25,115
21,14,12,15,3,1,20,5,4,95
21,14,12,15,3,11,0,0,0,76
21,14,12,15,3,11,5,4,0,85
21,14,12,15,3,11,5,18,0,99
21,14,12,15,3,11,9,14,7,106
21,14,12,15,3,11,19,0,0,95
21,14,12,15,4,7,5,0,0,78
21,14,12,15,4,7,5,4,0,82
21,14,12,15,6,20,25,0,0,113
21,14,12,15,7,7,5,4,0,85
21,14,12,15,7,9,3,0,0,81
21,14,12,15,7,9,3,1,12,94
21,14,12,15,25,1,12,0,0,100
21,14,12,15,25,1,12,12,25,137
21,14,12,15,25,1,12,20,25,145
21,14,12,15,14,5,12,25,0,118
21,14,12,15,15,11,0,0,0,88
21,14,12,15,15,11,5,4,0,97
21,14,12,15,15,16,0,0,0,93
21,14,12,15,15,16,5,4,0,102
21,14,12,15,15,19,5,0,0,101
21,14,12,15,15,19,5,4,0,105
21,14,12,15,15,19,5,14,0,115
21,14,12,15,15,19,5,14,19,134
21,14,12,15,15,19,5,19,0,120
21,14,12,15,15,19,9,14,7,126
21,14,12,15,15,20,5,4,0,106
21,14,12,15,16,16,5,4,0,103
21,14,12,15,18,4,0,0,0,84
21,14,12,15,18,4,5,4,0,93
21,14,12,15,18,4,12,25,0,121
21,14,12,15,19,1,2,12,5,101
21,14,12,15,19,20,0,0,0,101
21,14,12,15,20,20,5,4,0,111
21,14,12,15,21,4,12,25,0,124
21,14,12,15,21,11,5,14,0,113
21,14,12,15,21,19,25,0,0,127
21,14,12,15,22,1,2,12,5,104
21,14,12,15,22,1,2,12,25,124
21,14,12,15,22,5,0,0,0,89
21,14,12,15,22,5,4,0,0,93
21,14,12,15,22,5,12,25,0,126
21,14,12,15,22,5,18,12,25,144
21,14,12,15,22,9,14,7,0,114
21,14,12,15,23,5,18,5,4,117
21,14,12,15,23,12,25,0,0,122
21,14,12,21,3,5,14,20,0,110
21,14,12,21,3,9,4,0,0,84
21,14,12,21,3,9,4,12,25,121
21,14,12,21,3,11,0,0,0,82
21,14,12,21,3,11,6,21,12,121
21,14,12,21,3,11,25,0,0,107
21,14,12,21,3,11,9,5,18,114
21,14,12,21,3,11,9,12,25,128
21,14,12,21,3,11,12,25,0,119
21,14,12,21,6,6,5,4,0,89
21,14,12,21,7,7,5,4,0,91
21,14,12,21,13,16,5,4,0,106
21,14,12,21,13,16,25,0,0,122
21,14,12,21,14,1,18,0,0,101
21,14,12,21,14,1,20,5,0,108
21,14,12,21,14,1,20,5,4,112
21,14,12,21,18,5,4,0,0,95
21,14,12,21,18,11,9,14,7,127
21,14,12,21,19,8,0,0,0,95
21,14,12,21,19,20,0,0,0,107
21,14,12,21,19,20,6,21,12,146
21,14,12,21,19,20,25,0,0,132
21,14,12,21,19,20,9,5,0,121
21,14,12,21,19,20,9,5,18,139
21,14,12,21,19,20,9,12,25,153
21,14,12,21,19,20,9,14,7,137
21,14,12,21,19,20,18,5,4,134
21,14,12,21,20,5,0,0,0,93
21,14,12,21,20,5,4,0,0,97
21,14,12,21,24,1,20,5,4,122
21,14,13,1,3,8,15,0,0,75
21,14,13,1,3,11,12,25,0,100
21,14,13,1,4,0,0,0,0,53
21,14,13,1,4,4,5,4,0,66
21,14,13,1,4,5,0,0,0,58
21,14,13,1,7,9,3,0,0,68
21,14,13,1,7,9,3,1,12,81
21,14,13,1,7,14,9,6,25,110
21,14,13,1,9,4,0,0,0,62
21,14,13,1,9,4,5,14,0,81
21,14,13,1,9,12,0,0,0,70
21,14,13,1,9,12,5,4,0,79
21,14,13,1,9,13,5,4,0,80
21,14,13,1,11,1,2,12,5,80
21,14,13,1,11,5,0,0,0,65
21,14,13,1,11,5,18,0,0,83
21,14,13,1,11,5,18,19,0,102
21,14,13,1,11,5,19,0,0,84
21,14,13,1,11,9,14,7,0,90
21,14,13,1,12,12,5,4,0,82
21,14,13,1,12,20,5,4,0,90
21,14,13,1,14,0,0,0,0,63
21,14,13,1,14,1,3,12,5,84
21,14,13,1,14,1,7,5,4,80
21,14,13,1,14,5,4,0,0,72
21,14,13,1,14,5,7,5,4,84
21,14,13,1,14,6,21,12,0,102
21,14,13,1,14,7,12,5,4,91
21,14,13,1,14,8,15,15,4,105
21,14,13,1,14,9,1,3,0,76
21,14,13,1,14,12,25,0,0,100
21,14,13,1,14,12,9,5,18,107
21,14,13,1,14,12,9,11,5,100
21,14,13,1,14,12,9,12,25,121
21,14,13,1,14,14,5,4,0,86
21,14,13,1,14,14,5,18,0,100
21,14,13,1,14,14,9,14,7,107
21,14,13,1,14,14,9,19,8,113
21,14,13,1,14,15,18,5,4,105
21,14,13,1,14,19,0,0,0,82
21,14,13,1,14,20,12,5,0,100
21,14,13,1,14,20,12,5,4,104
21,14,13,1,14,21,1,12,0,97
21,14,13,1,14,21,18,5,4,111
21,14,13,1,16,16,5,4,0,90
21,14,13,1,18,2,12,5,4,90
21,14,13,1,18,3,8,0,0,78
21,14,13,1,18,9,14,5,0,95
21,14,13,1,18,11,5,4,0,87
21,14,13,1,18,11,9,14,7,108
21,14,13,1,18,12,5,4,0,88
21,14,13,1,18,18,5,4,0,94
21,14,13,1,18,18,25,0,0,110
21,14,13,1,18,18,9,5,4,103
21,14,13,1,18,18,9,14,7,115
21,14,13,1,18,20,9,1,12,109
21,14,13,1,18,20,25,18,0,130
21,14,13,1,19,8,5,4,0,85
21,14,13,1,19,11,0,0,0,79
21,14,13,1,19,11,5,4,0,88
21,14,13,1,19,11,5,18,0,102
21,14,13,1,19,11,5,18,19,121
21,14,13,1,19,11,9,14,7,109
21,14,13,1,19,11,19,0,0,98
21,14,13,1,19,19,5,4,0,96
21,14,13,1,19,20,0,0,0,88
21,14,13,1,19,20,5,18,0,111
21,14,13,1,20,3,8,5,4,89
21,14,13,1,20,5,0,0,0,74
21,14,13,1,20,5,4,0,0,78
21,14,13,1,20,9,14,7,0,99
21,14,13,1,20,20,5,4,0,98
21,14,13,1,20,21,18,5,0,113
21,14,13,1,20,21,18,5,4,117
21,14,13,1,21,4,12,9,14,109
21,14,13,1,21,12,5,4,0,91
21,14,13,1,26,5,0,0,0,80
21,14,13,5,1,14,9,14,7,98
21,14,13,5,1,14,20,0,0,88
21,14,13,5,1,20,5,4,0,83
21,14,13,5,4,1,12,5,4,79
21,14,13,5,4,4,12,5,0,78
21,14,13,5,4,4,12,5,4,82
21,14,13,5,4,9,3,1,12,82
21,14,13,5,5,4,6,21,12,101
21,14,13,5,5,4,25,0,0,87
21,14,13,5,5,11,0,0,0,69
21,14,13,5,5,11,12,25,0,106
21,14,13,5,5,20,0,0,0,78
21,14,13,5,5,20,12,25,0,115
21,14,13,5,12,12,15,23,0,115
21,14,13,5,12,15,4,9,3,96
21,14,13,5,12,20,0,0,0,85
21,14,13,5,12,20,5,4,0,94
21,14,13,5,12,20,9,14,7,115
21,14,13,5,13,2,5,18,0,91
21,14,13,5,14,1,3,5,4,80
21,14,13,5,14,4,5,4,0,80
21,14,13,5,14,9,1,12,0,89
21,14,13,5,14,20,1,12,0,100
21,14,13,5,18,3,9,5,4,92
21,14,13,5,18,7,5,0,0,83
21,14,13,5,18,7,5,4,0,87
21,14,13,5,18,7,9,14,7,108
21,14,13,5,18,9,20,5,4,109
21,14,13,5,18,18,25,0,0,114
21,14,13,5,18,18,9,12,25,135
21,14,13,5,19,8,0,0,0,80
21,14,13,5,19,8,5,4,0,89
21,14,13,5,19,8,5,19,0,104
21,14,13,5,20,0,0,0,0,73
21,14,13,5,20,1,12,5,4,95
21,14,13,5,20,5,0,0,0,78
21,14,13,5,20,5,4,0,0,82
21,14,13,5,20,5,18,5,4,105
21,14,13,5,20,8,0,0,0,81
21,14,13,5,20,18,5,4,0,100
21,14,13,5,20,18,9,3,0,103
21,14,13,5,20,20,12,5,0,110
21,14,13,5,23,0,0,0,0,76
21,14,13,5,23,5,4,0,0,85
21,14,13,5,23,9,14,7,0,106
21,14,13,5,23,19,0,0,0,95
21,14,13,9,1,19,13,1,12,103
21,14,13,9,1,19,13,9,3,102
21,14,13,9,7,8,20,0,0,92
21,14,13,9,7,8,20,25,0,117
21,14,13,9,7,18,1,14,20,117
21,14,13,9,12,4,0,0,0,73
21,14,13,9,12,11,5,4,0,89
21,14,13,9,12,12,5,4,0,90
21,14,13,9,12,20,5,4,0,98
21,14,13,9,13,5,20,9,3,107
21,14,13,9,14,1,2,12,5,91
21,14,13,9,14,3,5,4,0,83
21,14,13,9,14,3,9,14,7,104
21,14,13,9,14,4,0,0,0,75
21,14,13,9,14,4,5,4,0,84
21,14,13,9,14,4,6,21,12,114
21,14,13,9,14,4,9,14,7,105
21,14,13,9,14,5,4,0,0,80
21,14,13,9,14,7,12,5,0,95
21,14,13,9,14,7,12,5,4,99
21,14,13,9,14,7,12,5,19,114
21,14,13,9,14,20,5,4,0,100
21,14,13,9,14,21,20,5,4,121
21,14,13,25,15,16,9,3,0,116
21,14,13,9,18,5,4,0,0,84
21,14,13,9,18,25,0,0,0,100
21,14,13,9,19,5,18,12,25,136
21,14,13,9,19,12,5,4,0,97
21,14,13,9,19,19,5,4,0,104
21,14,13,9,19,20,0,0,0,96
21,14,13,25,19,20,5,18,25,160
21,14,13,25,19,20,9,3,0,124
21,14,13,9,20,5,18,0,0,100
21,14,13,9,20,5,18,5,4,109
21,14,13,9,20,5,18,19,0,119
21,14,13,9,20,18,5,0,0,100
21,14,13,9,20,18,5,4,0,104
21,14,13,9,20,18,5,19,0,119
21,14,13,9,20,18,9,14,7,125
21,14,13,9,24,0,0,0,0,81
21,14,13,9,24,1,2,12,5,101
21,14,13,9,24,5,4,0,0,90
21,14,13,9,24,5,4,12,25,127
21,14,13,9,24,20,0,0,0,101
21,14,13,15,1,14,5,4,0,87
21,14,13,15,1,14,9,14,7,108
21,14,13,15,1,20,5,4,0,93
21,14,13,15,2,2,5,4,0,76
21,14,13,15,2,9,12,5,0,91
21,14,13,15,2,12,5,0,0,82
21,14,13,15,3,11,5,4,0,86
21,14,13,15,3,11,9,14,7,107
21,14,13,15,4,5,12,0,0,84
21,14,13,15,4,5,12,5,4,93
21,14,13,15,4,5,18,14,0,104
21,14,13,15,4,5,19,20,0,111
21,14,13,15,4,9,19,8,0,103
21,14,13,15,9,12,5,4,0,93
21,14,13,15,9,19,20,0,0,111
21,14,13,15,9,19,20,5,14,130
21,14,13,15,12,4,0,0,0,79
21,14,13,15,12,4,5,4,0,88
21,14,13,15,12,4,25,0,0,104
21,14,13,15,12,4,9,14,7,109
21,14,13,15,12,4,19,0,0,98
21,14,13,15,12,5,19,20,0,119
21,14,13,15,12,20,5,14,0,114
21,14,13,15,14,1,18,3,8,107
21,14,13,15,14,5,25,5,4,116
21,14,13,15,14,11,9,19,8,124
21,14,13,15,14,11,12,25,0,125
21,14,13,15,15,4,25,0,0,107
21,14,13,15,15,18,0,0,0,96
21,14,13,15,15,18,5,4,0,105
21,14,13,15,15,18,9,14,7,126
21,14,13,15,15,18,19,0,0,115
21,14,13,15,15,20,5,4,0,107
21,14,13,15,16,16,5,4,0,104
21,14,13,15,18,1,12,0,0,94
21,14,13,15,18,1,12,12,25,131
21,14,13,15,18,2,9,4,0,96
21,14,13,15,18,4,1,14,20,120
21,14,13,15,18,15,19,5,0,120
21,14,13,15,18,20,1,12,0,114
21,14,13,15,18,20,9,19,5,134
21,14,13,15,19,19,5,4,0,110
21,14,13,15,19,19,25,0,0,126
21,14,13,15,20,9,12,5,0,109
21,14,13,15,20,9,22,5,4,123
21,14,13,15,20,15,18,5,4,125
21,14,13,15,20,20,12,5,4,124
21,14,13,15,21,12,4,0,0,100
21,14,13,15,21,12,4,25,0,125
21,14,13,15,21,14,4,5,4,111
21,14,13,15,21,14,20,0,0,118
21,14,13,15,21,14,20,5,4,127
21,14,13,15,21,18,14,5,4,125
21,14,13,15,21,20,8,5,4,121
21,14,13,15,22,1,2,12,5,105
21,14,13,15,22,1,2,12,25,125
21,14,13,15,22,5,4,0,0,94
21,14,13,15,22,5,4,12,25,131
21,14,13,15,22,9,14,7,0,115
21,14,13,15,23,5,4,0,0,95
21,14,13,15,23,14,0,0,0,100
21,14,13,21,4,4,5,4,0,86
21,14,13,21,4,4,25,0,0,102
21,14,13,21,4,4,9,5,4,95
21,14,13,21,4,4,12,5,0,94
21,14,13,21,4,4,12,5,4,98
21,14,13,21,6,6,12,5,0,98
21,14,13,21,6,6,12,5,4,102
21,14,13,21,6,6,12,5,19,117
21,14,13,21,12,3,20,5,4,113
21,14,13,21,12,9,19,8,0,117
21,14,13,21,12,12,5,4,0,102
21,14,13,21,13,2,12,5,4,105
21,14,13,21,13,13,9,5,4,113
21,14,13,21,13,13,9,6,25,135
21,14,13,21,14,3,8,5,4,103
21,14,13,21,14,4,1,14,5,107
21,14,13,21,19,3,12,5,4,112
21,14,13,21,19,9,3,1,12,113
21,14,13,21,19,9,14,7,0,118
21,14,13,21,19,11,5,4,0,108
21,14,13,21,19,19,5,4,0,116
21,14,13,21,19,20,5,4,0,117
21,14,13,21,20,1,2,12,5,109
21,14,13,21,20,1,14,20,0,124
21,14,13,21,20,1,20,5,4,119
21,14,13,21,20,5,4,0,0,98
21,14,13,21,20,21,1,12,0,123
21,14,13,21,26,26,12,5,0,138
21,14,13,21,26,26,12,5,4,142
21,14,13,21,26,26,12,5,19,157
21,14,14,0,0,0,0,0,0,49
21,14,14,1,2,2,5,4,0,63
21,14,14,1,7,7,5,4,0,73
21,14,14,1,7,7,9,14,7,94
21,14,14,1,9,12,0,0,0,71
21,14,14,1,9,12,5,4,0,80
21,14,14,1,9,12,9,14,7,101
21,14,14,1,9,12,19,0,0,90
21,14,14,1,9,22,5,0,0,86
21,14,14,1,9,22,5,12,25,123
21,14,14,1,11,5,4,0,0,70
21,14,14,1,13,1,2,12,5,83
21,14,14,1,13,1,2,12,25,103
21,14,14,1,13,5,0,0,0,68
21,14,14,1,13,5,4,0,0,72
21,14,14,1,16,16,5,4,0,91
21,14,14,1,16,20,0,0,0,86
21,14,14,1,18,18,15,23,0,124
21,14,14,1,19,1,12,0,0,82
21,14,14,1,19,1,12,12,25,119
21,14,14,1,19,3,5,14,20,111
21,14,14,1,20,9,15,14,0,108
21,14,14,1,20,9,22,5,0,106
21,14,14,1,20,21,18,1,12,122
21,14,14,1,20,21,18,5,0,114
21,14,14,5,1,12,5,4,0,76
21,14,14,5,1,16,5,4,0,80
21,14,14,5,1,18,0,0,0,73
21,14,14,5,1,18,5,4,0,82
21,14,14,5,1,18,12,25,0,110
21,14,14,5,1,20,0,0,0,75
21,14,14,5,1,20,8,0,0,83
21,14,14,5,1,20,12,25,0,112
21,14,14,5,5,4,5,4,0,72
21,14,14,5,5,4,6,21,12,102
21,14,14,5,5,4,25,0,0,88
21,14,14,5,7,1,20,5,4,91
21,14,14,5,7,18,15,0,0,94
21,14,14,5,18,22,5,0,0,99
21,14,14,5,18,22,5,4,0,103
21,14,14,5,18,22,5,19,0,118
21,14,14,5,18,22,9,14,7,124
21,14,14,5,18,22,15,21,19,149
21,14,14,5,19,19,0,0,0,92
21,14,14,5,19,20,0,0,0,93
21,14,14,5,19,20,12,5,0,110
21,14,14,5,19,20,12,5,4,114
21,14,14,5,20,0,0,0,0,74
21,14,14,5,20,8,0,0,0,82
21,14,14,5,20,8,5,0,0,87
21,14,14,5,20,8,5,19,0,106
21,14,14,5,20,8,9,19,0,110
21,14,14,5,20,20,5,4,0,103
21,14,14,5,20,20,12,5,4,115
21,14,14,5,21,18,1,12,0,106
21,14,14,5,21,20,18,1,12,126
21,14,14,5,23,0,0,0,0,77
21,14,14,5,23,12,25,0,0,114
21,14,14,5,23,14,5,19,19,134
21,14,14,5,23,19,5,4,0,105
21,14,14,9,2,2,5,4,0,71
21,14,14,9,2,2,9,5,4,80
21,14,14,9,2,2,12,5,4,83
21,14,14,9,3,5,0,0,0,66
21,14,14,9,3,5,12,25,0,103
21,14,14,9,3,8,5,4,0,78
21,14,14,9,3,11,5,4,0,81
21,14,14,9,7,7,1,18,4,95
21,14,14,9,7,8,0,0,0,73
21,14,14,9,13,2,5,4,0,82
21,14,14,9,13,2,12,5,0,90
21,14,14,9,13,2,12,25,0,110
21,14,14,25,13,16,8,1,12,124
21,14,14,9,16,16,5,4,0,99
21,14,14,15,2,12,5,0,0,83
21,14,14,15,2,12,25,0,0,103
21,14,14,15,4,4,9,14,7,102
21,14,14,15,9,19,5,4,0,101
21,14,14,15,9,19,25,0,0,117
21,14,14,15,9,19,9,12,25,138
21,14,14,15,13,1,4,9,3,94
21,14,14,15,13,9,14,1,12,113
21,14,14,15,15,11,5,4,0,99
21,14,14,15,15,19,5,4,0,107
21,14,14,15,18,13,1,12,0,108
21,14,14,15,19,5,0,0,0,88
21,14,14,15,19,5,4,0,0,92
21,14,14,15,20,1,2,12,5,104
21,14,14,15,20,3,8,5,4,104
21,14,14,15,20,5,4,0,0,93
21,14,14,15,20,9,3,5,4,105
21,14,14,15,20,9,6,25,0,124
21,14,14,15,20,9,14,7,0,114
21,14,14,15,22,5,12,0,0,103
21,14,14,21,13,2,5,4,0,94
21,14,14,21,13,2,5,18,0,108
21,14,14,21,26,26,12,5,4,143
21,14,15,1,18,5,4,0,0,78
21,14,15,2,5,25,5,4,0,91
21,14,15,2,5,25,9,14,7,112
21,14,15,2,5,19,5,0,0,81
21,14,15,2,5,19,5,12,25,118
21,14,15,2,12,9,7,5,4,89
21,14,15,2,19,3,5,14,5,98
21,14,15,2,19,3,21,18,5,118
21,14,15,2,22,9,15,21,19,138
21,14,15,3,5,1,14,9,3,85
21,14,15,3,21,12,1,18,0,105
21,14,15,4,5,0,0,0,0,59
21,14,15,4,9,15,21,19,0,118
21,14,15,4,15,18,5,4,0,96
21,14,15,4,15,18,15,21,19,142
21,14,15,6,6,5,18,5,4,94
21,14,15,6,6,9,3,5,4,83
21,14,15,6,6,19,5,20,0,106
21,14,15,6,20,5,14,0,0,95
21,14,15,7,12,5,4,0,0,78
21,14,15,9,12,0,0,0,0,71
21,14,15,9,12,5,4,0,0,80
21,14,15,9,12,25,0,0,0,96
21,14,15,9,12,9,14,7,0,101
21,14,15,12,4,0,0,0,0,66
21,14,15,13,5,14,5,4,0,91
21,14,15,13,9,14,15,21,19,141
21,14,15,13,9,20,20,5,4,121
21,14,15,14,5,18,15,21,19,142
21,14,15,16,1,17,21,5,0,110
21,14,15,16,5,4,0,0,0,75
21,14,15,16,5,14,0,0,0,85
21,14,15,16,5,14,5,4,0,94
21,14,15,16,5,14,9,14,7,115
21,14,15,16,5,14,12,25,0,122
21,14,15,16,9,1,20,5,4,105
21,14,15,16,9,1,20,9,3,108
21,14,15,16,9,14,5,4,0,98
21,14,15,16,16,15,19,5,4,125
21,14,15,16,20,5,4,0,0,95
21,14,15,16,21,12,5,14,20,138
21,14,15,18,1,12,0,0,0,81
21,14,15,18,1,12,12,25,0,118
21,14,15,18,2,5,4,0,0,79
21,14,15,18,2,9,20,1,12,112
21,14,15,18,4,1,9,14,0,96
21,14,15,18,4,5,18,0,0,95
21,14,15,18,4,5,18,5,4,104
21,14,15,18,4,5,18,12,25,132
21,14,15,18,4,9,14,1,12,108
21,14,15,18,7,1,14,5,4,99
21,14,15,18,7,1,14,9,3,102
21,14,15,18,14,0,0,0,0,82
21,14,15,18,14,1,20,5,0,108
21,14,15,18,14,12,25,0,0,119
21,14,15,19,13,15,20,9,3,129
21,14,15,21,19,20,5,4,0,119
21,14,15,21,20,23,15,18,14,161
21,14,15,22,5,18,20,0,0,115
21,14,15,23,5,4,0,0,0,82
21,14,15,23,9,14,7,0,0,103
21,14,15,23,14,0,0,0,0,87
21,14,15,23,14,5,4,0,0,96
21,14,16,0,0,0,0,0,0,51
21,14,16,1,3,1,2,12,5,75
21,14,16,1,3,5,4,0,0,64
21,14,16,1,3,9,6,9,3,82
21,14,16,1,3,11,0,0,0,66
21,14,16,1,3,11,5,4,0,75
21,14,16,1,3,11,5,18,0,89
21,14,16,1,3,11,5,18,19,108
21,14,16,1,3,11,9,14,7,96
21,14,16,1,3,11,19,0,0,85
21,14,16,1,4,4,5,4,0,69
21,14,16,1,7,1,14,0,0,74
21,14,16,1,7,5,4,0,0,68
21,14,16,1,7,9,14,1,12,95
21,14,16,1,25,0,0,0,0,77
21,14,16,1,25,1,2,12,5,97
21,14,16,1,25,1,2,12,25,117
21,14,16,1,9,4,0,0,0,65
21,14,16,1,25,9,14,7,0,107
21,14,16,1,25,13,5,14,20,129
21,14,16,1,9,14,5,4,0,84
21,14,16,1,9,14,6,21,12,114
21,14,16,1,9,14,9,14,7,105
21,14,16,1,9,14,20,0,0,95
21,14,16,1,9,14,20,5,4,104
21,14,16,1,9,18,5,4,0,88
21,14,16,1,9,19,5,4,0,89
21,14,16,1,12,1,20,1,12,98
21,14,16,1,12,5,0,0,0,69
21,14,16,1,12,5,4,0,0,73
21,14,16,1,12,12,5,4,0,85
21,14,16,1,12,16,5,4,0,89
21,14,16,1,12,19,9,5,4,101
21,14,16,1,12,20,18,25,0,127
21,14,16,1,14,5,12,0,0,83
21,14,16,1,14,5,12,5,4,92
21,14,16,1,14,7,5,4,0,82
21,14,16,1,14,9,3,11,25,114
21,14,16,1,14,14,5,12,0,97
21,14,16,1,14,20,9,14,7,116
21,14,16,1,16,1,12,0,0,81
21,14,16,1,16,5,18,0,0,91
21,14,16,1,16,5,18,5,4,100
21,14,16,1,18,1,4,5,4,84
21,14,16,1,18,1,4,15,24,114
21,14,16,1,18,3,5,12,0,90
21,14,16,1,18,3,8,0,0,81
21,14,16,1,18,3,8,5,4,90
21,14,16,1,18,4,15,14,0,103
21,14,16,1,18,5,4,0,0,79
21,14,16,1,18,5,7,1,12,95
21,14,16,1,18,6,9,20,0,105
21,14,16,1,18,11,0,0,0,81
21,14,16,1,18,11,5,4,0,90
21,14,16,1,18,11,9,14,7,111
21,14,16,1,18,15,12,5,4,106
21,14,16,1,18,18,5,12,0,105
21,14,16,1,18,18,9,5,4,106
21,14,16,1,18,19,5,4,0,98
21,14,16,1,18,19,5,18,0,112
21,14,16,1,18,20,5,4,0,99
21,14,16,1,18,20,25,0,0,115
21,14,16,1,18,20,9,1,12,112
21,14,16,1,18,20,15,15,11,131
21,14,16,1,19,19,0,0,0,90
21,14,16,1,19,19,5,4,0,99
21,14,16,1,19,19,9,14,7,120
21,14,16,1,19,19,9,22,5,126
21,14,16,1,19,20,5,0,0,96
21,14,16,1,19,20,5,4,0,100
21,14,16,1,19,20,9,14,7,121
21,14,16,1,19,20,15,18,0,124
21,14,16,1,20,3,8,5,4,92
21,14,16,1,20,5,14,20,0,111
21,14,16,1,20,8,5,4,0,89
21,14,16,1,20,9,5,14,20,120
21,14,16,1,20,20,5,4,0,101
21,14,16,1,21,14,3,8,0,98
21,14,16,1,21,19,9,14,7,122
21,14,16,1,22,5,0,0,0,79
21,14,16,1,22,5,4,0,0,83
21,14,16,1,22,9,14,7,0,104
21,14,16,1,23,5,4,0,0,84
21,14,16,1,23,14,0,0,0,89
21,14,16,1,23,14,5,4,0,98
21,14,16,5,1,3,5,0,0,65
21,14,16,5,1,11,5,4,0,77
21,14,16,5,1,12,5,4,0,78
21,14,16,5,1,18,12,5,4,96
21,14,16,5,2,2,12,5,4,81
21,14,16,5,3,11,5,4,0,79
21,14,16,5,4,4,12,5,4,85
21,14,16,5,5,12,0,0,0,73
21,14,16,5,5,12,5,4,0,82
21,14,16,5,5,12,9,14,7,103
21,14,16,5,5,18,5,4,0,88
21,14,16,5,5,22,9,19,8,119
21,14,16,5,7,0,0,0,0,63
21,14,16,5,7,7,5,4,0,79
21,14,16,5,7,7,9,14,7,100
21,14,16,5,7,19,0,0,0,82
21,14,16,5,12,1,7,9,3,88
21,14,16,5,12,20,5,4,0,97
21,14,16,5,14,0,0,0,0,70
21,14,16,5,14,1,12,0,0,83
21,14,16,5,14,1,12,12,25,120
21,14,16,5,14,4,1,14,20,109
21,14,16,5,14,4,5,14,20,113
21,14,16,5,14,4,9,14,7,104
21,14,16,5,14,14,5,4,0,93
21,14,16,5,14,14,9,5,4,102
21,14,16,5,14,14,9,14,7,114
21,14,16,5,14,19,0,0,0,89
21,14,16,5,14,20,0,0,0,90
21,14,16,5,15,16,12,5,0,104
21,14,16,5,15,16,12,5,4,108
21,14,16,5,15,16,12,5,19,123
21,14,16,5,16,16,5,18,25,136
21,14,16,5,18,3,8,0,0,85
21,14,16,5,18,3,8,5,4,94
21,14,16,5,18,6,5,3,20,108
21,14,16,5,18,13,9,20,0,116
21,14,16,5,18,13,9,20,19,135
21,14,16,5,18,16,12,5,24,131
21,14,16,5,18,19,15,14,0,122
21,14,16,5,18,19,15,14,19,141
21,14,16,5,18,21,11,5,4,115
21,14,16,5,18,21,19,5,4,123
21,14,16,5,18,22,5,18,20,139
21,14,16,5,20,1,12,0,0,89
21,14,16,5,20,1,12,5,4,98
21,14,16,5,20,18,9,6,25,134
21,14,16,5,20,20,5,4,0,105
21,14,16,8,1,19,5,4,0,88
21,14,16,8,18,1,19,5,4,106
21,14,16,9,3,11,0,0,0,74
21,14,16,9,3,11,5,4,0,83
21,14,16,9,3,11,9,14,7,104
21,14,16,9,3,11,12,5,4,95
21,14,16,9,3,11,19,0,0,93
21,14,16,9,5,3,5,0,0,73
21,14,16,9,5,3,5,4,0,77
21,14,16,9,5,18,3,5,4,95
21,14,16,9,5,20,25,0,0,110
21,14,16,9,12,5,0,0,0,77
21,14,16,9,12,5,4,0,0,81
21,14,16,9,12,5,19,0,0,96
21,14,16,9,12,9,14,7,0,102
21,14,16,9,12,12,5,4,0,93
21,14,16,9,12,15,20,5,4,116
21,14,16,9,13,16,12,5,4,110
21,14,16,9,14,0,0,0,0,74
21,14,16,9,14,3,8,5,4,94
21,14,16,9,14,9,14,7,0,104
21,14,16,9,14,9,15,14,0,112
21,14,16,9,14,11,5,4,0,94
21,14,16,9,14,14,5,4,0,97
21,14,16,9,14,14,9,14,7,118
21,14,16,9,14,19,0,0,0,93
21,14,16,9,15,21,19,0,0,115
21,14,16,9,15,21,19,12,25,152
21,14,16,9,16,5,4,0,0,85
21,14,16,9,17,21,5,4,0,107
21,14,16,9,18,1,20,5,4,108
21,14,16,9,20,3,8,5,4,100
21,14,16,9,20,5,4,0,0,89
21,14,16,9,20,5,15,21,19,140
21,14,16,9,20,25,0,0,0,105
21,14,16,9,20,9,5,4,0,98
21,14,16,9,20,9,6,21,12,128
21,14,16,9,20,25,9,14,7,135
21,14,16,9,20,20,5,4,0,109
21,14,16,12,1,3,5,0,0,72
21,14,16,12,1,3,5,4,0,76
21,14,16,12,1,3,9,4,0,80
21,14,16,12,1,7,21,5,4,101
21,14,16,12,1,9,4,0,0,77
21,14,16,12,1,25,5,4,0,98
21,14,16,12,1,25,6,21,12,128
21,14,16,12,1,25,9,14,7,119
21,14,16,12,1,9,14,0,0,87
21,14,16,12,1,9,14,5,4,96
21,14,16,12,1,9,14,12,25,124
21,14,16,12,1,9,20,0,0,93
21,14,16,12,1,9,20,5,4,102
21,14,16,12,1,9,20,19,0,112
21,14,16,12,1,14,0,0,0,78
21,14,16,12,1,14,5,4,0,87
21,14,16,12,1,14,11,0,0,89
21,14,16,12,1,14,11,5,4,98
21,14,16,12,1,14,14,5,4,101
21,14,16,12,1,14,20,0,0,98
21,14,16,12,1,14,20,5,4,107
21,14,16,12,1,19,8,5,4,100
21,14,16,12,1,19,20,5,18,126
21,14,16,12,1,19,20,9,3,115
21,14,16,12,1,20,0,0,0,84
21,14,16,12,1,20,5,4,0,93
21,14,16,12,1,20,20,5,4,113
21,14,16,12,5,1,4,5,4,82
21,14,16,12,5,1,19,5,4,97
21,14,16,12,5,1,20,0,0,89
21,14,16,12,5,1,20,5,4,98
21,14,16,12,5,4,7,5,4,88
21,14,16,12,9,1,2,12,5,92
21,14,16,12,9,1,2,12,25,112
21,14,16,12,9,1,14,3,25,115
21,14,16,12,9,1,14,20,0,107
21,14,16,12,9,5,4,0,0,81
21,14,16,12,9,7,8,20,0,107
21,14,16,12,15,20,20,5,4,127
21,14,16,12,15,21,7,8,0,114
21,14,16,12,15,23,0,0,0,101
21,14,16,12,15,23,5,4,0,110
21,14,16,12,21,3,11,5,4,107
21,14,16,12,21,7,0,0,0,91
21,14,16,12,21,7,7,5,4,107
21,14,16,12,21,7,19,0,0,110
21,14,16,12,21,13,2,0,0,99
21,14,16,12,21,13,2,5,4,108
21,14,16,12,21,13,5,0,0,102
21,14,16,12,21,13,5,4,0,106
21,14,16,12,21,13,16,0,0,113
21,14,16,12,21,14,7,5,0,110
21,14,16,12,21,14,7,5,4,114
21,14,16,15,1,3,8,5,4,87
21,14,16,15,3,11,5,20,0,105
21,14,16,15,4,4,5,4,0,83
21,14,16,15,5,20,9,3,0,103
21,14,16,15,5,20,9,26,5,131
21,14,16,15,9,14,20,5,4,118
21,14,16,15,9,19,5,0,0,99
21,14,16,15,9,19,5,4,0,103
21,14,16,15,9,19,15,14,0,123
21,14,16,15,12,5,4,0,0,87
21,14,16,15,12,5,13,9,3,108
21,14,16,15,12,9,3,5,4,99
21,14,16,15,12,9,19,8,0,114
21,14,16,15,12,9,20,5,0,112
21,14,16,15,12,9,20,9,3,119
21,14,16,15,12,12,5,4,0,99
21,14,16,15,13,16,15,21,19,150
21,14,16,15,15,12,5,4,0,102
21,14,16,15,16,5,0,0,0,87
21,14,16,15,16,21,12,1,18,134
21,14,16,15,18,14,5,19,19,141
21,14,16,15,18,15,21,19,0,139
21,14,16,15,18,20,12,25,0,141
21,14,16,15,19,5,4,0,0,94
21,14,16,15,19,9,14,7,0,115
21,14,16,15,19,19,5,19,19,147
21,14,16,15,19,20,5,4,0,114
21,14,16,15,20,0,0,0,0,86
21,14,16,15,20,1,2,12,5,106
21,14,16,15,20,5,14,20,0,125
21,14,16,15,20,20,5,4,0,115
21,14,16,15,20,20,9,14,7,136
21,14,16,15,21,3,8,5,4,107
21,14,16,15,21,14,3,5,4,113
21,14,16,15,21,14,4,5,4,114
21,14,16,15,21,18,5,4,0,114
21,14,16,15,21,20,9,14,7,137
21,14,16,15,23,5,18,0,0,112
21,14,16,18,1,25,0,0,0,95
21,14,16,18,1,25,5,4,0,104
21,14,16,18,1,25,9,14,7,125
21,14,16,18,1,9,19,5,0,103
21,14,16,18,1,9,19,5,4,107
21,14,16,18,1,14,11,5,4,104
21,14,16,18,1,20,9,14,7,120
21,14,16,18,5,1,3,8,0,86
21,14,16,18,5,3,9,19,5,110
21,14,16,18,5,4,9,3,20,110
21,14,16,18,5,5,14,5,4,102
21,14,16,18,5,25,9,14,7,129
21,14,16,18,5,16,1,18,5,114
21,14,16,18,5,19,19,5,4,121
21,14,16,18,5,19,19,5,19,136
21,14,16,18,5,19,20,0,0,113
21,14,16,18,5,20,20,25,0,139
21,14,16,18,9,3,5,4,0,90
21,14,16,18,9,3,11,5,4,101
21,14,16,18,9,3,11,12,25,129
21,14,16,18,9,5,19,20,0,122
21,14,16,18,25,9,14,7,0,124
21,14,16,18,9,13,0,0,0,91
21,14,16,18,9,13,5,0,0,96
21,14,16,18,9,13,5,4,0,100
21,14,16,18,9,13,12,25,0,128
21,14,16,18,9,13,13,5,4,113
21,14,16,18,9,14,3,5,0,100
21,14,16,18,9,14,20,0,0,112
21,14,16,18,9,14,20,5,4,121
21,14,16,18,9,19,15,14,0,126
21,14,16,18,9,22,1,20,5,126
21,14,16,18,9,26,5,4,0,113
21,14,16,18,15,2,5,4,0,95
21,14,16,18,15,2,9,20,25,140
21,14,16,18,15,3,21,18,5,131
21,14,16,18,15,4,4,5,4,101
21,14,16,18,15,4,5,4,0,97
21,14,16,18,15,6,1,14,5,110
21,14,16,18,15,6,9,20,0,119
21,14,16,18,15,6,21,19,5,135
21,14,16,18,15,12,9,24,0,129
21,14,16,18,15,13,9,19,5,130
21,14,16,18,15,13,16,20,0,133
21,14,16,18,15,16,0,0,0,100
21,14,16,18,15,16,5,18,0,123
21,14,16,18,15,16,9,3,5,117
21,14,16,18,15,16,16,5,4,125
21,14,16,18,15,19,1,9,3,116
21,14,16,18,15,20,5,3,20,132
21,14,16,18,15,21,4,0,0,109
21,14,16,18,15,21,4,12,25,146
21,14,16,18,15,22,5,4,0,115
21,14,16,18,15,22,5,14,0,125
21,14,16,18,15,22,9,4,5,124
21,14,16,18,15,22,9,14,7,136
21,14,16,18,15,22,15,11,5,137
21,14,16,18,21,4,5,14,20,133
21,14,16,18,21,14,5,4,0,113
21,14,16,19,25,3,8,9,3,118
21,14,16,21,2,12,9,3,0,98
21,14,16,21,3,11,5,18,0,109
21,14,16,21,3,11,5,18,19,128
21,14,16,21,4,4,12,5,4,101
21,14,16,21,6,6,0,0,0,84
21,14,16,21,6,6,5,4,0,93
21,14,16,21,6,6,9,14,7,114
21,14,16,21,12,12,5,4,0,105
21,14,16,21,12,16,5,4,0,109
21,14,16,21,13,16,5,4,0,110
21,14,16,21,14,3,8,5,4,106
21,14,16,21,18,5,0,0,0,95
21,14,16,21,18,5,4,0,0,99
21,14,16,21,18,5,12,25,0,132
21,14,16,21,18,7,5,4,0,106
21,14,16,21,18,9,20,1,14,134
21,14,16,21,18,12,5,4,0,111
21,14,16,21,18,16,12,5,4,127
21,14,16,21,18,19,5,0,0,114
21,14,16,21,18,19,5,4,0,118
21,14,16,21,18,19,21,5,4,139
21,14,16,21,19,8,5,4,0,108
21,14,16,21,20,0,0,0,0,92
21,14,16,21,20,18,9,4,0,123
21,14,16,21,20,20,9,5,4,130
21,14,16,21,26,26,12,5,0,141
21,14,16,21,26,26,12,5,4,145
21,14,16,21,26,26,12,5,19,160
21,14,17,21,1,4,4,5,4,91
21,14,17,21,1,6,6,5,4,95
21,14,17,21,1,25,5,4,0,108
21,14,17,21,1,9,12,5,4,104
21,14,17,21,1,11,9,14,7,115
21,14,17,21,1,12,9,6,25,126
21,14,17,21,1,12,9,20,25,140
21,14,17,21,1,19,8,5,4,110
21,14,17,21,5,5,14,0,0,97
21,14,17,21,5,5,14,5,4,106
21,14,17,21,5,5,14,12,25,134
21,14,17,21,5,12,12,5,4,111
21,14,17,21,5,13,5,0,0,96
21,14,17,21,5,13,5,12,25,133
21,14,17,21,5,18,9,5,4,114
21,14,17,21,5,18,20,0,0,116
21,14,17,21,5,19,20,5,4,126
21,14,17,21,9,3,11,0,0,96
21,14,17,21,9,3,11,12,25,133
21,14,17,21,9,5,20,0,0,107
21,14,17,21,9,5,20,5,4,116
21,14,17,21,9,5,20,5,18,130
21,14,17,21,9,5,20,12,25,144
21,14,17,21,9,5,20,19,0,126
21,14,17,21,9,12,20,5,4,123
21,14,17,21,9,20,0,0,0,102
21,14,17,21,9,20,20,5,4,131
21,14,17,21,9,26,26,5,4,143
21,14,17,21,15,4,0,0,0,92
21,14,17,21,15,20,5,0,0,113
21,14,17,21,15,20,5,4,0,117
21,14,17,21,15,20,5,19,0,132
21,14,17,21,15,20,9,14,7,138
21,14,18,1,3,5,4,0,0,66
21,14,18,1,3,11,0,0,0,68
21,14,18,1,3,11,5,4,0,77
21,14,18,1,3,11,9,14,7,98
21,14,18,1,4,9,1,14,20,102
21,14,18,1,4,9,3,1,12,83
21,14,18,1,6,6,12,5,4,87
21,14,18,1,25,0,0,0,0,79
21,14,18,1,9,4,5,4,0,76
21,14,18,1,25,5,4,0,0,88
21,14,18,1,9,12,5,4,0,84
21,14,18,1,9,14,25,0,0,102
21,14,18,1,9,19,5,4,0,91
21,14,18,1,11,5,0,0,0,70
21,14,18,1,11,5,4,0,0,74
21,14,18,1,11,9,14,7,0,95
21,14,18,1,12,12,9,5,4,96
21,14,18,1,13,0,0,0,0,67
21,14,18,1,13,13,5,4,0,89
21,14,18,1,13,16,5,4,0,92
21,14,18,1,14,3,8,5,4,88
21,14,18,1,14,3,9,4,0,84
21,14,18,1,14,4,15,13,0,100
21,14,18,1,14,7,9,14,7,105
21,14,18,1,14,11,0,0,0,79
21,14,18,1,14,11,5,4,0,88
21,14,18,1,14,11,12,5,4,100
21,14,18,1,14,20,9,14,7,118
21,14,18,1,16,5,4,0,0,79
21,14,18,1,18,5,0,0,0,77
21,14,18,1,19,8,0,0,0,81
21,14,18,1,19,8,12,25,0,118
21,14,18,1,19,16,5,4,0,98
21,14,18,1,19,16,25,0,0,114
21,14,18,1,19,16,9,14,7,119
21,14,18,1,20,1,2,12,5,94
21,14,18,1,20,5,4,0,0,83
21,14,18,1,20,20,12,5,4,115
21,14,18,1,22,1,7,5,4,93
21,14,18,1,22,5,12,0,0,93
21,14,18,1,22,5,12,5,4,102
21,14,18,1,22,5,12,5,18,116
21,14,18,1,22,5,12,19,0,112
21,14,18,1,22,9,14,7,0,106
21,14,18,1,26,5,4,0,0,89
21,14,18,1,26,15,18,5,4,122
21,14,18,5,1,3,8,5,4,79
21,14,18,5,1,4,0,0,0,63
21,14,18,5,1,4,25,0,0,88
21,14,18,5,1,4,9,5,18,95
21,14,18,5,1,4,9,12,25,109
21,14,18,5,1,12,0,0,0,71
21,14,18,5,1,12,9,19,5,104
21,14,18,5,1,12,9,19,13,112
21,14,18,5,1,12,9,19,20,119
21,14,18,5,1,12,9,20,25,125
21,14,18,5,1,12,9,26,5,111
21,14,18,5,1,12,12,25,0,108
21,14,18,5,1,12,13,5,4,93
21,14,18,5,1,16,5,4,0,84
21,14,18,5,1,18,5,4,0,86
21,14,18,5,1,19,15,14,0,107
21,14,18,5,1,19,15,14,19,126
21,14,18,5,1,22,5,0,0,86
21,14,18,5,1,22,9,14,7,111
21,14,18,5,2,1,20,5,4,90
21,14,18,5,2,5,12,0,0,77
21,14,18,5,2,21,9,12,20,122
21,14,18,5,2,21,11,5,4,101
21,14,18,5,3,5,14,20,0,100
21,14,18,5,3,9,20,5,4,99
21,14,18,5,3,11,5,4,0,81
21,14,18,5,3,11,9,14,7,102
21,14,18,5,3,11,15,14,0,101
21,14,18,5,3,12,21,19,5,118
21,14,18,5,3,15,4,5,4,89
21,14,18,5,4,0,0,0,0,62
21,14,18,5,4,21,3,5,4,95
21,14,18,5,4,21,3,20,0,106
21,14,18,5,5,6,5,4,0,78
21,14,18,5,5,12,0,0,0,75
21,14,18,5,5,12,5,4,0,84
21,14,18,5,5,12,5,18,0,98
21,14,18,5,5,12,5,18,19,117
21,14,18,5,5,12,9,14,7,105
21,14,18,5,5,12,19,0,0,94
21,14,18,5,5,22,5,0,0,90
21,14,18,5,5,22,5,4,0,94
21,14,18,5,5,22,5,19,0,109
21,14,18,5,5,22,9,14,7,115
21,14,18,5,6,9,14,5,0,92
21,14,18,5,6,9,14,5,4,96
21,14,18,5,6,21,19,5,4,113
21,14,18,5,6,21,20,5,4,114
21,14,18,5,7,1,12,0,0,78
21,14,18,5,7,1,12,5,4,87
21,14,18,5,7,1,12,12,25,115
21,14,18,5,7,1,18,4,0,88
21,14,18,5,7,21,12,1,18,117
21,14,18,5,9,14,0,0,0,81
21,14,18,5,9,14,5,4,0,90
21,14,18,5,12,1,25,5,4,105
21,14,18,5,12,1,20,5,4,100
21,14,18,5,12,1,24,5,4,104
21,14,18,5,12,9,1,14,20,114
21,14,18,5,13,15,20,5,0,111
21,14,18,5,13,15,22,5,4,117
21,14,18,5,14,5,23,5,4,109
21,14,18,5,14,20,0,0,0,92
21,14,18,5,14,20,5,4,0,101
21,14,18,5,16,1,9,4,0,88
21,14,18,5,16,1,9,18,0,102
21,14,18,5,16,1,9,18,19,121
21,14,18,5,16,5,14,20,0,113
21,14,18,5,16,9,14,5,4,106
21,14,18,5,16,12,5,20,5,116
21,14,18,5,16,12,9,5,4,104
21,14,18,5,16,15,19,5,0,113
21,14,18,5,16,15,19,5,4,117
21,14,18,5,16,21,20,5,4,124
21,14,18,5,17,21,5,19,20,140
21,14,18,5,19,3,21,5,4,110
21,14,18,5,19,5,18,22,5,127
21,14,18,5,19,15,12,22,5,131
21,14,18,5,19,16,5,3,20,121
21,14,18,5,19,20,0,0,0,97
21,14,18,5,19,20,5,4,0,106
21,14,18,5,19,20,6,21,12,136
21,14,18,5,19,20,25,0,0,122
21,14,18,5,19,20,9,14,7,127
21,14,18,5,19,20,19,0,0,116
21,14,18,5,19,21,13,5,4,120
21,14,18,5,20,9,18,5,4,114
21,14,18,5,20,20,5,4,0,107
21,14,18,5,22,5,14,21,5,125
21,14,18,5,22,5,18,5,4,112
21,14,18,5,22,9,12,5,4,110
21,14,18,5,22,9,19,5,4,117
21,14,18,5,22,9,22,5,4,120
21,14,18,5,22,15,11,5,4,115
21,14,18,8,25,13,5,0,0,104
21,14,18,8,25,13,5,4,0,108
21,14,18,8,25,13,9,14,7,129
21,14,18,9,2,2,5,4,0,75
21,14,18,9,3,8,0,0,0,73
21,14,18,9,3,8,5,4,0,82
21,14,18,9,3,8,20,0,0,93
21,14,18,9,3,11,5,4,0,85
21,14,18,9,4,0,0,0,0,66
21,14,18,9,4,1,2,12,5,86
21,14,18,9,4,1,2,12,25,106
21,14,18,9,4,4,5,14,0,89
21,14,18,9,4,4,12,5,0,87
21,14,18,9,4,4,12,5,4,91
21,14,18,9,4,4,12,5,18,105
21,14,18,9,4,4,12,5,19,106
21,14,18,9,4,5,0,0,0,71
21,14,18,9,4,5,12,25,0,108
21,14,18,9,4,5,18,5,4,98
21,14,18,9,4,7,5,4,0,82
21,14,18,9,6,5,0,0,0,73
21,14,18,9,6,6,12,5,4,95
21,14,18,9,6,12,5,4,0,89
21,14,18,9,6,20,5,4,0,97
21,14,18,9,7,0,0,0,0,69
21,14,18,9,7,7,5,4,0,85
21,14,18,9,7,7,9,14,7,106
21,14,18,9,7,8,20,0,0,97
21,14,18,9,7,8,20,5,4,106
21,14,18,9,7,8,20,12,25,134
21,14,18,9,7,9,4,0,0,82
21,14,18,9,7,9,4,12,25,119
21,14,18,9,7,19,0,0,0,88
21,14,18,9,13,5,4,0,0,84
21,14,18,9,13,16,12,5,4,112
21,14,18,9,14,4,0,0,0,80
21,14,18,9,14,7,0,0,0,83
21,14,18,9,14,7,5,4,0,92
21,14,18,9,14,7,9,14,7,113
21,14,18,9,14,19,5,4,0,104
21,14,18,9,15,20,5,4,0,106
21,14,18,9,15,20,9,14,7,127
21,14,18,9,15,20,15,21,19,152
21,14,18,9,16,0,0,0,0,78
21,14,18,9,16,5,0,0,0,83
21,14,18,9,16,5,4,0,0,87
21,14,18,9,16,5,12,25,0,120
21,14,18,9,16,5,14,5,4,106
21,14,18,9,16,5,18,0,0,101
21,14,18,9,16,5,19,20,0,122
21,14,18,9,16,16,5,4,0,103
21,14,18,9,16,16,9,14,7,124
21,14,18,9,16,16,12,5,4,115
21,14,18,9,16,19,0,0,0,97
21,14,18,9,19,5,14,0,0,100
21,14,18,9,19,9,2,12,5,109
21,14,18,9,19,9,14,7,0,111
21,14,18,9,19,11,5,4,0,101
21,14,18,9,19,11,25,0,0,117
21,14,18,9,20,21,1,12,0,116
21,14,18,9,22,1,12,5,4,106
21,14,18,9,22,5,4,0,0,93
21,14,18,9,22,5,14,0,0,103
21,14,18,9,22,5,20,0,0,109
21,14,18,9,22,5,20,5,4,118
21,14,18,15,1,4,5,4,0,82
21,14,18,15,1,13,9,14,7,112
21,14,18,15,1,19,20,0,0,108
21,14,18,15,1,19,20,5,4,117
21,14,18,15,2,2,5,4,0,81
21,14,18,15,2,5,0,0,0,75
21,14,18,15,2,5,4,0,0,79
21,14,18,15,2,5,19,0,0,94
21,14,18,15,2,9,14,7,0,100
21,14,18,15,2,21,19,20,0,130
21,14,18,15,3,11,5,4,0,91
21,14,18,15,3,11,25,0,0,107
21,14,18,15,3,15,3,15,0,104
21,14,18,15,4,4,5,4,0,85
21,14,18,15,25,1,12,0,0,106
21,14,18,15,25,1,12,12,25,143
21,14,18,15,9,12,5,4,0,98
21,14,18,15,12,12,0,0,0,92
21,14,18,15,12,12,5,4,0,101
21,14,18,15,12,12,5,18,0,115
21,14,18,15,12,12,9,14,7,122
21,14,18,15,12,12,19,0,0,111
21,14,18,15,15,6,0,0,0,89
21,14,18,15,15,6,5,4,0,98
21,14,18,15,15,6,9,14,7,119
21,14,18,15,15,6,19,0,0,108
21,14,18,15,15,13,25,0,0,121
21,14,18,15,15,19,20,0,0,122
21,14,18,15,15,19,20,5,4,131
21,14,18,15,15,20,0,0,0,103
21,14,18,15,15,20,5,4,0,112
21,14,18,15,15,20,9,14,7,133
21,14,18,15,15,20,19,0,0,122
21,14,18,15,16,5,0,0,0,89
21,14,18,15,16,5,4,0,0,93
21,14,18,15,19,5,4,0,0,96
21,14,18,15,19,9,14,5,4,119
21,14,18,15,20,1,18,25,0,132
21,14,18,15,20,1,20,5,4,118
21,14,18,15,20,5,4,0,0,97
21,14,18,15,20,20,5,4,0,117
21,14,18,15,20,20,5,14,0,127
21,14,18,15,20,21,14,4,0,127
21,14,18,15,21,7,5,4,0,105
21,14,18,15,21,7,8,0,0,104
21,14,18,15,21,14,4,0,0,107
21,14,18,15,21,14,4,5,4,116
21,14,18,15,21,14,4,19,0,126
21,14,18,15,21,19,5,4,0,117
21,14,18,15,21,19,9,14,7,138
21,14,18,15,21,20,0,0,0,109
21,14,18,15,21,20,5,4,0,118
21,14,18,15,21,20,9,14,5,137
21,14,18,15,22,5,0,0,0,95
21,14,18,15,22,5,4,0,0,99
21,14,18,15,22,5,14,0,0,109
21,14,18,15,22,9,14,7,0,120
21,14,18,15,23,0,0,0,0,91
21,14,18,15,23,4,25,0,0,120
21,14,18,15,23,5,4,0,0,100
21,14,18,15,23,5,12,5,4,117
21,14,18,18,15,22,5,0,0,113
21,14,18,21,2,2,5,4,0,87
21,14,18,21,2,2,9,19,8,114
21,14,18,21,4,4,12,5,4,103
21,14,18,21,4,5,0,0,0,83
21,14,18,21,4,5,12,25,0,120
21,14,18,21,5,4,0,0,0,83
21,14,18,21,5,6,21,12,0,118
21,14,18,21,6,5,0,0,0,85
21,14,18,21,6,6,5,4,0,95
21,14,18,21,6,6,12,5,0,103
21,14,18,21,6,6,12,5,4,107
21,14,18,21,7,7,5,4,0,97
21,14,18,21,9,14,5,4,0,106
21,14,18,21,9,14,15,21,19,152
21,14,18,21,12,1,2,12,5,106
21,14,18,21,12,5,0,0,0,91
21,14,18,21,12,5,4,0,0,95
21,14,18,21,12,5,4,12,25,132
21,14,18,21,12,5,6,21,12,130
21,14,18,21,12,25,0,0,0,111
21,14,18,21,12,9,5,18,0,118
21,14,18,21,12,9,5,19,20,139
21,14,18,21,12,9,12,25,0,132
21,14,18,21,13,15,18,5,4,129
21,14,18,21,13,16,12,5,0,120
21,14,18,21,13,16,12,5,4,124
21,14,18,21,14,0,0,0,0,88
21,14,18,21,14,7,0,0,0,95
21,14,18,21,18,1,12,0,0,105
21,14,18,21,18,1,12,12,25,142
21,14,18,21,19,8,5,4,0,110
21,14,18,21,19,8,9,14,7,131
21,14,18,21,19,20,0,0,0,113
21,14,18,21,19,20,5,4,0,122
21,14,18,21,19,20,9,3,0,125
21,14,18,21,20,8,0,0,0,102
21,14,19,0,0,0,0,0,0,54
21,14,19,1,2,5,18,5,4,89
21,14,19,1,2,12,5,4,0,78
21,14,19,1,2,18,5,4,0,84
21,14,19,1,3,11,0,0,0,69
21,14,19,1,3,11,5,4,0,78
21,14,19,1,3,18,5,4,0,85
21,14,19,1,4,0,0,0,0,59
21,14,19,1,4,4,5,14,0,82
21,14,19,1,4,4,12,5,0,80
21,14,19,1,4,4,12,5,4,84
21,14,19,1,4,4,12,5,19,99
21,14,19,1,4,12,25,0,0,96
21,14,19,1,4,14,5,19,19,116
21,14,19,1,6,5,0,0,0,66
21,14,19,1,6,5,12,25,0,103
21,14,19,1,6,5,18,0,0,84
21,14,19,1,6,5,19,20,0,105
21,14,19,1,6,5,20,25,0,111
21,14,19,1,7,5,0,0,0,67
21,14,19,1,7,5,12,25,0,104
21,14,19,1,7,7,9,14,7,99
21,14,19,1,25,0,0,0,0,80
21,14,19,1,25,1,2,12,5,100
21,14,19,1,9,4,0,0,0,68
21,14,19,1,25,9,14,7,0,110
21,14,19,1,9,12,5,4,0,85
21,14,19,1,9,14,20,0,0,98
21,14,19,1,9,14,20,5,4,107
21,14,19,1,9,14,20,12,25,135
21,14,19,1,25,19,0,0,0,99
21,14,19,1,11,5,4,0,0,75
21,14,19,1,12,1,2,12,5,87
21,14,19,1,12,1,2,12,25,107
21,14,19,1,12,9,5,14,20,115
21,14,19,1,12,9,14,5,0,95
21,14,19,1,12,12,15,23,0,117
21,14,19,1,12,14,5,19,19,124
21,14,19,1,12,20,0,0,0,87
21,14,19,1,12,20,5,4,0,96
21,14,19,1,12,20,25,0,0,112
21,14,19,1,12,21,20,5,4,117
21,14,19,1,12,22,5,4,0,98
21,14,19,1,13,5,0,0,0,73
21,14,19,1,13,16,12,5,4,105
21,14,19,1,14,4,5,4,0,82
21,14,19,1,14,5,0,0,0,74
21,14,19,1,14,9,20,25,0,123
21,14,19,1,16,9,5,14,20,119
21,14,19,1,16,16,5,4,0,96
21,14,19,1,16,16,25,0,0,112
21,14,19,1,19,8,0,0,0,82
21,14,19,1,19,8,5,4,0,91
21,14,19,1,20,1,2,12,5,95
21,14,19,1,20,1,14,9,3,102
21,14,19,1,20,5,4,0,0,84
21,14,19,1,20,5,4,12,25,121
21,14,19,1,20,9,1,20,5,110
21,14,19,1,20,9,14,0,0,98
21,14,19,1,20,9,14,7,0,105
21,14,19,1,20,9,18,5,0,107
21,14,19,1,20,9,18,9,3,114
21,14,19,1,20,9,19,6,25,134
21,14,19,1,21,3,5,4,0,88
21,14,19,1,21,7,8,20,0,111
21,14,19,1,21,18,9,1,14,118
21,14,19,1,22,1,2,12,5,97
21,14,19,1,22,1,7,5,0,90
21,14,19,1,22,5,4,0,0,86
21,14,19,1,22,9,14,7,0,107
21,14,19,1,22,15,18,0,0,110
21,14,19,1,22,15,18,5,4,119
21,14,19,1,22,15,18,25,0,135
21,14,19,1,22,15,18,12,25,147
21,14,19,1,22,15,21,18,25,156
21,14,19,1,23,5,4,0,0,87
21,14,19,1,23,14,0,0,0,92
21,14,19,3,1,2,2,5,4,71
21,14,19,3,1,12,4,5,4,83
21,14,19,3,1,12,5,0,0,75
21,14,19,3,1,12,5,4,0,79
21,14,19,3,1,12,25,0,0,95
21,14,19,3,1,12,9,14,7,100
21,14,19,3,1,13,16,5,4,96
21,14,19,3,1,14,14,5,4,95
21,14,19,3,1,14,20,5,4,101
21,14,19,3,1,14,20,25,0,117
21,14,19,3,1,18,2,0,0,78
21,14,19,3,1,18,3,5,0,84
21,14,19,3,1,18,5,4,0,85
21,14,19,3,1,18,6,5,4,91
21,14,19,3,1,18,18,5,4,103
21,14,19,3,1,18,22,5,4,107
21,14,19,3,1,20,8,5,4,95
21,14,19,3,5,14,9,3,0,88
21,14,19,3,5,14,20,0,0,96
21,14,19,3,5,14,20,5,4,105
21,14,19,3,5,16,20,5,18,121
21,14,19,3,5,16,20,18,5,121
21,14,19,3,8,5,13,5,4,92
21,14,19,3,8,15,12,1,18,111
21,14,19,3,8,15,15,12,0,107
21,14,19,3,9,5,14,3,5,93
21,14,19,3,9,15,14,5,4,104
21,14,19,3,15,6,6,5,4,93
21,14,19,3,15,12,4,5,4,97
21,14,19,3,15,14,3,5,4,98
21,14,19,3,15,15,16,5,4,112
21,14,19,3,15,18,5,4,0,99
21,14,19,3,15,18,9,14,7,120
21,14,19,3,15,18,14,5,4,113
21,14,19,3,15,20,3,8,0,103
21,14,19,3,15,21,18,5,4,120
21,14,19,3,18,1,16,5,4,101
21,14,19,3,18,5,5,14,0,99
21,14,19,3,18,5,23,0,0,103
21,14,19,3,18,5,23,5,4,112
21,14,19,3,18,5,23,19,0,122
21,14,19,3,18,9,2,1,12,99
21,14,19,3,18,9,2,5,4,95
21,14,19,3,21,13,13,5,4,113
21,14,19,5,1,12,0,0,0,72
21,14,19,5,1,12,5,4,0,81
21,14,19,5,1,12,5,18,0,95
21,14,19,5,1,12,9,14,7,102
21,14,19,5,1,12,19,0,0,91
21,14,19,5,1,13,0,0,0,73
21,14,19,5,1,13,5,4,0,82
21,14,19,5,1,13,9,14,7,103
21,14,19,5,1,13,19,0,0,92
21,14,19,5,1,18,5,4,0,87
21,14,19,5,1,19,15,14,0,108
21,14,19,5,1,20,0,0,0,80
21,14,19,5,1,20,5,4,0,89
21,14,19,5,1,20,9,14,7,110
21,14,19,5,1,20,19,0,0,99
21,14,19,5,3,5,4,5,4,80
21,14,19,5,3,18,5,3,25,113
21,14,19,5,3,18,5,20,0,105
21,14,19,5,3,21,12,1,18,114
21,14,19,5,3,21,18,5,0,106
21,14,19,5,3,21,18,5,4,110
21,14,19,5,4,1,20,5,0,89
21,14,19,5,4,21,3,5,0,92
21,14,19,5,4,21,3,5,4,96
21,14,19,5,5,0,0,0,0,64
21,14,19,5,5,1,2,12,5,84
21,14,19,5,5,4,5,4,0,77
21,14,19,5,5,4,9,14,7,98
21,14,19,5,5,9,14,7,0,94
21,14,19,5,5,11,9,14,7,105
21,14,19,5,5,12,0,0,0,76
21,14,19,5,5,12,25,0,0,101
21,14,19,5,5,13,9,14,7,107
21,14,19,5,5,13,12,25,0,114
21,14,19,5,5,14,0,0,0,78
21,14,19,5,5,20,8,5,4,101
21,14,19,5,9,19,13,1,12,113
21,14,19,5,9,19,13,9,3,112
21,14,19,5,9,26,5,0,0,99
21,14,19,5,9,26,5,4,0,103
21,14,19,5,12,4,15,13,0,103
21,14,19,5,12,5,3,20,0,99
21,14,19,5,12,6,0,0,0,77
21,14,19,5,12,6,9,19,8,113
21,14,19,5,12,25,0,0,0,96
21,14,19,5,12,12,0,0,0,83
21,14,19,5,12,12,9,14,7,113
21,14,19,5,12,20,8,0,0,99
21,14,19,5,14,9,12,5,0,99
21,14,19,5,14,19,1,20,5,118
21,14,19,5,14,19,5,0,0,97
21,14,19,5,14,19,5,4,0,101
21,14,19,5,14,19,9,14,7,122
21,14,19,5,14,19,15,18,25,150
21,14,19,5,14,19,21,1,12,126
21,14,19,5,14,20,0,0,0,93
21,14,19,5,16,20,1,20,5,121
21,14,19,5,17,21,5,14,20,136
21,14,19,5,18,5,0,0,0,82
21,14,19,5,18,5,14,5,0,101
21,14,19,5,18,9,15,21,19,141
21,14,19,5,18,18,1,20,5,121
21,14,19,5,18,18,9,5,4,113
21,14,19,5,18,22,5,4,0,108
21,14,19,5,18,22,9,3,5,116
21,14,19,5,18,22,9,12,5,125
21,14,19,5,18,22,9,14,7,129
21,14,19,5,20,0,0,0,0,79
21,14,19,5,20,19,0,0,0,98
21,14,19,5,20,20,9,14,7,129
21,14,19,5,20,20,12,5,0,116
21,14,19,5,20,20,12,5,4,120
21,14,19,5,20,20,12,5,19,135
21,14,19,5,22,5,14,0,0,100
21,14,19,5,22,5,18,5,0,109
21,14,19,5,22,5,18,5,4,113
21,14,19,5,23,0,0,0,0,82
21,14,19,5,23,5,4,0,0,91
21,14,19,5,23,5,18,5,4,114
21,14,19,5,23,9,14,7,0,112
21,14,19,5,23,14,0,0,0,96
21,14,19,5,23,19,0,0,0,101
21,14,19,5,24,0,0,0,0,83
21,14,19,5,24,5,4,0,0,92
21,14,19,5,24,5,19,0,0,107
21,14,19,5,24,25,0,0,0,108
21,14,19,5,24,9,14,7,0,113
21,14,19,5,24,12,9,11,5,120
21,14,19,5,24,21,1,12,0,117
21,14,19,8,1,2,2,25,0,92
21,14,19,8,1,3,11,12,5,94
21,14,19,8,1,4,5,0,0,72
21,14,19,8,1,4,5,4,0,76
21,14,19,8,1,4,25,0,0,92
21,14,19,8,1,4,9,12,25,113
21,14,19,8,1,4,9,14,7,97
21,14,19,8,1,4,15,23,0,105
21,14,19,8,1,6,20,5,4,98
21,14,19,8,1,11,5,4,0,83
21,14,19,8,1,11,5,14,0,93
21,14,19,8,1,11,25,0,0,99
21,14,19,8,1,11,9,14,7,104
21,14,19,8,1,12,5,0,0,80
21,14,19,8,1,12,5,4,0,84
21,14,19,8,1,13,5,4,0,85
21,14,19,8,1,13,13,5,4,98
21,14,19,8,1,14,11,5,4,97
21,14,19,8,1,16,5,0,0,84
21,14,19,8,1,16,5,4,0,88
21,14,19,8,1,16,5,12,25,121
21,14,19,8,1,16,5,14,0,98
21,14,19,8,1,16,9,14,7,109
21,14,19,8,1,18,5,4,0,90
21,14,19,8,1,18,9,14,7,111
21,14,19,8,1,18,16,0,0,97
21,14,19,8,1,18,16,5,4,106
21,14,19,8,1,18,16,5,14,116
21,14,19,8,1,18,16,12,25,134
21,14,19,8,1,22,5,0,0,90
21,14,19,8,1,22,5,4,0,94
21,14,19,8,1,22,5,14,0,104
21,14,19,8,1,23,12,0,0,98
21,14,19,8,5,1,6,0,0,74
21,14,19,8,5,1,18,5,4,95
21,14,19,8,5,1,20,8,5,101
21,14,19,8,5,4,0,0,0,71
21,14,19,8,5,5,18,0,0,90
21,14,19,8,5,5,20,0,0,92
21,14,19,8,5,5,20,5,4,101
21,14,19,8,5,12,12,0,0,91
21,14,19,8,5,12,12,5,4,100
21,14,19,8,5,12,12,19,0,110
21,14,19,8,5,12,22,5,0,106
21,14,19,8,5,12,22,5,4,110
21,14,19,8,5,14,20,0,0,101
21,14,19,8,5,18,9,6,6,106
21,14,19,8,5,23,5,4,0,99
21,14,19,8,25,0,0,0,0,87
21,14,19,8,9,6,20,0,0,97
21,14,19,8,9,6,20,5,4,106
21,14,19,8,9,6,20,25,0,122
21,14,19,8,9,6,20,19,0,116
21,14,19,8,25,12,25,0,0,124
21,14,19,8,9,14,5,4,0,94
21,14,19,8,25,14,5,19,19,144
21,14,19,8,9,14,25,0,0,110
21,14,19,8,9,14,9,14,7,115
21,14,19,8,9,16,0,0,0,87
21,14,19,8,9,16,16,5,4,112
21,14,19,8,9,16,19,0,0,106
21,14,19,8,9,18,11,5,4,109
21,14,19,8,9,18,18,5,4,116
21,14,19,8,9,18,20,5,4,118
21,14,19,8,14,5,19,19,0,119
21,14,19,8,15,3,11,5,4,100
21,14,19,8,15,4,0,0,0,81
21,14,19,8,15,4,4,5,14,104
21,14,19,8,15,5,0,0,0,82
21,14,19,8,15,5,4,0,0,86
21,14,19,8,15,5,9,14,7,112
21,14,19,8,15,15,11,0,0,103
21,14,19,8,15,16,0,0,0,93
21,14,19,8,15,18,5,0,0,100
21,14,19,8,15,18,5,4,0,104
21,14,19,8,15,18,14,0,0,109
21,14,19,8,15,18,20,0,0,115
21,14,19,8,15,18,20,5,14,134
21,14,19,8,15,20,0,0,0,97
21,14,19,8,15,20,20,5,4,126
21,14,19,8,15,21,20,0,0,118
21,14,19,8,15,21,20,5,4,127
21,14,19,8,15,22,5,4,0,108
21,14,19,8,15,23,5,4,0,109
21,14,19,8,15,23,25,0,0,125
21,14,19,8,15,23,9,12,25,146
21,14,19,8,15,23,14,0,0,114
21,14,19,8,18,5,23,0,0,108
21,14,19,8,18,5,23,4,0,112
21,14,19,8,18,9,12,12,0,113
21,14,19,8,18,9,14,5,0,108
21,14,19,8,18,9,14,5,4,112
21,14,19,8,18,9,14,11,0,114
21,14,19,8,18,9,22,5,4,120
21,14,19,8,18,9,22,5,14,130
21,14,19,8,18,15,21,4,0,120
21,14,19,8,18,21,14,11,0,126
21,14,19,8,21,6,6,12,5,112
21,14,19,8,21,14,14,5,4,120
21,14,19,8,21,14,20,5,4,126
21,14,19,8,21,20,0,0,0,103
21,14,19,8,21,20,20,5,18,146
21,14,19,9,3,11,0,0,0,77
21,14,19,9,3,11,5,18,0,100
21,14,19,9,3,11,12,5,4,98
21,14,19,9,3,11,12,25,0,114
21,14,19,9,4,5,4,0,0,76
21,14,19,9,4,9,14,7,0,97
21,14,19,9,4,12,9,14,7,109
21,14,19,9,5,7,5,0,0,80
21,14,19,9,5,7,5,4,0,84
21,14,19,9,5,22,5,4,0,99
21,14,19,9,6,20,5,4,0,98
21,14,19,9,7,8,9,14,7,108
21,14,19,9,7,8,20,0,0,98
21,14,19,9,7,8,20,5,4,107
21,14,19,9,7,8,20,12,25,135
21,14,19,9,7,8,20,19,0,117
21,14,19,9,7,14,5,4,0,93
21,14,19,9,12,5,14,20,0,114
21,14,19,9,12,12,25,0,0,112
21,14,19,9,13,9,12,1,18,116
21,14,19,9,13,16,12,5,0,109
21,14,19,9,13,16,12,25,0,129
21,14,19,9,13,21,12,1,18,128
21,14,19,9,14,0,0,0,0,77
21,14,19,9,14,3,5,18,5,108
21,14,19,9,14,5,23,0,0,105
21,14,19,9,14,5,23,5,4,114
21,14,19,9,14,5,23,25,0,130
21,14,19,9,14,6,21,12,0,116
21,14,19,9,14,7,0,0,0,84
21,14,19,9,14,7,5,4,0,93
21,14,19,9,14,7,12,5,0,101
21,14,19,9,14,7,12,5,4,105
21,14,19,9,14,11,9,14,7,118
21,14,19,9,14,14,9,14,7,121
21,14,19,9,14,21,1,20,5,124
21,14,19,9,14,21,15,21,19,153
21,14,19,9,16,8,15,14,0,116
21,14,19,9,16,16,5,4,0,104
21,14,19,9,19,20,5,18,0,125
21,14,19,9,19,20,9,14,7,132
21,14,19,9,20,20,9,14,7,133
21,14,19,9,26,1,2,12,5,109
21,14,19,9,26,5,4,0,0,98
21,14,19,11,1,9,20,8,4,107
21,14,19,11,5,23,5,4,0,102
21,14,19,11,9,12,6,21,12,125
21,14,19,11,9,12,12,0,0,98
21,14,19,11,9,12,12,5,4,107
21,14,19,11,9,13,13,5,4,109
21,14,19,11,9,14,0,0,0,88
21,14,19,11,9,14,14,5,4,111
21,14,19,11,9,18,20,5,4,121
21,14,19,12,1,3,11,0,0,81
21,14,19,12,1,3,11,5,4,90
21,14,19,12,1,7,7,5,4,90
21,14,19,12,1,9,14,0,0,90
21,14,19,12,1,11,5,4,0,87
21,14,19,12,1,13,13,5,4,102
21,14,19,12,1,14,20,5,4,110
21,14,19,12,1,16,16,5,4,108
21,14,19,12,1,19,8,5,4,103
21,14,19,12,1,20,5,0,0,92
21,14,19,12,1,20,5,4,0,96
21,14,19,12,1,20,9,14,7,117
21,14,19,12,1,20,20,5,4,116
21,14,19,12,1,22,5,0,0,94
21,14,19,12,5,1,22,5,4,103
21,14,19,12,5,5,11,0,0,87
21,14,19,12,5,5,16,25,0,117
21,14,19,12,5,5,22,5,0,103
21,14,19,12,5,5,22,5,4,107
21,14,19,12,5,14,4,5,18,112
21,14,19,12,5,16,20,0,0,107
21,14,19,12,25,0,0,0,0,91
21,14,19,12,9,3,5,4,0,87
21,14,19,12,9,3,11,5,4,98
21,14,19,12,9,4,9,14,7,109
21,14,19,12,25,12,25,0,0,128
21,14,19,12,9,13,0,0,0,88
21,14,19,12,9,13,12,25,0,125
21,14,19,12,9,13,13,5,4,110
21,14,19,12,25,14,5,19,19,148
21,14,19,12,9,14,7,0,0,96
21,14,19,12,9,14,7,19,0,115
21,14,19,12,9,16,0,0,0,91
21,14,19,12,9,16,16,5,4,116
21,14,19,12,9,20,0,0,0,95
21,14,19,12,15,7,8,0,0,96
21,14,19,12,15,16,5,4,0,106
21,14,19,12,15,16,9,14,7,127
21,14,19,12,15,16,16,5,4,122
21,14,19,12,15,20,0,0,0,101
21,14,19,12,15,20,20,5,4,130
21,14,19,12,15,21,3,8,25,138
21,14,19,12,15,23,0,0,0,104
21,14,19,12,15,23,5,4,0,113
21,14,19,12,15,23,12,25,0,141
21,14,19,12,21,9,3,5,0,104
21,14,19,12,21,9,3,5,4,108
21,14,19,12,21,13,16,5,4,125
21,14,19,12,21,14,7,0,0,108
21,14,19,12,21,18,18,5,4,132
21,14,19,13,1,3,11,5,4,91
21,14,19,13,1,18,20,0,0,106
21,14,19,13,1,18,20,12,25,143
21,14,19,13,1,19,8,5,4,104
21,14,19,13,5,1,18,5,4,100
21,14,19,13,5,12,12,5,4,105
21,14,19,13,5,12,20,5,4,113
21,14,19,13,9,12,5,4,0,97
21,14,19,13,9,12,9,14,7,118
21,14,19,13,9,20,20,5,14,135
21,14,19,13,15,3,11,5,4,105
21,14,19,13,15,11,5,4,0,102
21,14,19,13,15,11,25,0,0,118
21,14,19,13,15,11,9,12,25,139
21,14,19,13,15,11,9,14,7,123
21,14,19,13,15,15,20,8,0,125
21,14,19,13,15,20,5,0,0,107
21,14,19,13,21,4,7,5,4,108
21,14,19,13,21,7,0,0,0,95
21,14,19,13,21,7,12,25,0,132
21,14,19,13,21,20,20,5,4,137
21,14,19,13,21,20,20,25,0,153
21,14,19,14,1,7,7,5,4,92
21,14,19,14,1,11,25,0,0,105
21,14,19,14,1,16,0,0,0,85
21,14,19,14,1,16,16,5,4,110
21,14,19,14,1,16,19,0,0,104
21,14,19,14,1,18,5,0,0,92
21,14,19,14,1,18,5,4,0,96
21,14,19,14,1,18,12,0,0,99
21,14,19,14,1,18,12,5,4,108
21,14,19,14,1,18,12,19,0,118
21,14,19,14,1,20,3,8,0,100
21,14,19,14,5,1,11,25,0,110
21,14,19,14,5,3,11,0,0,87
21,14,19,14,9,2,0,0,0,79
21,14,19,14,9,16,16,5,4,118
21,14,19,14,15,18,9,14,7,131
21,14,19,14,15,21,20,5,4,133
21,14,19,14,15,23,0,0,0,106
21,14,19,14,21,2,2,5,4,102
21,14,19,14,21,6,6,5,4,110
21,14,19,14,21,7,0,0,0,96
21,14,19,14,21,7,12,25,0,133
21,14,19,15,1,11,5,4,0,90
21,14,19,15,1,16,5,4,0,95
21,14,19,15,1,18,9,14,7,118
21,14,19,15,2,5,18,0,0,94
21,14,19,15,2,5,18,5,4,103
21,14,19,15,2,5,18,12,25,131
21,14,19,15,3,9,1,12,0,94
21,14,19,15,3,11,5,20,0,108
21,14,19,15,4,4,5,14,0,96
21,14,19,15,6,20,0,0,0,95
21,14,19,15,6,20,12,25,0,132
21,14,19,15,7,7,25,0,0,108
21,14,19,15,9,12,0,0,0,90
21,14,19,15,9,12,5,4,0,99
21,14,19,15,9,12,9,14,7,120
21,14,19,15,12,1,3,5,4,94
21,14,19,15,12,1,18,0,0,100
21,14,19,15,12,4,0,0,0,85
21,14,19,15,12,4,5,18,0,108
21,14,19,15,12,4,5,18,19,127
21,14,19,15,12,4,9,5,18,117
21,14,19,15,12,5,0,0,0,86
21,14,19,15,12,5,4,0,0,90
21,14,19,15,12,5,13,14,0,113
21,14,19,15,12,9,4,0,0,94
21,14,19,15,12,9,4,12,25,131
21,14,19,15,12,9,14,7,0,111
21,14,19,15,12,21,2,12,5,121
21,14,19,15,12,21,2,12,25,141
21,14,19,15,12,22,5,0,0,108
21,14,19,15,12,22,5,4,0,112
21,14,19,15,13,1,20,9,3,115
21,14,19,15,13,2,5,18,0,107
21,14,19,15,13,2,18,5,0,107
21,14,19,15,13,5,0,0,0,87
21,14,19,15,14,0,0,0,0,83
21,14,19,15,14,1,2,12,5,103
21,14,19,15,14,1,14,20,0,118
21,14,19,15,14,3,25,0,0,111
21,14,19,15,14,12,9,11,5,120
21,14,19,15,14,19,25,0,0,127
21,14,19,15,14,19,9,5,0,116
21,14,19,15,15,20,0,0,0,104
21,14,19,15,15,20,8,5,4,121
21,14,19,15,15,20,25,0,0,129
21,14,19,15,18,4,9,4,0,104
21,14,19,15,18,5,0,0,0,92
21,14,19,15,18,5,12,25,0,129
21,14,19,15,18,18,25,0,0,130
21,14,19,15,18,20,0,0,0,107
21,14,19,15,18,20,5,4,0,116
21,14,19,15,18,20,9,14,7,137
21,14,19,15,20,20,5,4,0,118
21,14,19,15,21,7,8,20,0,125
21,14,19,15,21,12,0,0,0,102
21,14,19,15,21,12,6,21,12,141
21,14,19,15,21,12,9,19,8,138
21,14,19,15,21,14,4,0,0,108
21,14,19,15,21,14,4,5,4,117
21,14,19,15,21,14,4,5,18,131
21,14,19,15,21,14,4,12,25,145
21,14,19,15,21,18,0,0,0,108
21,14,19,15,21,18,5,4,0,117
21,14,19,15,21,18,12,25,0,145
21,14,19,15,21,19,5,4,0,118
21,14,19,15,23,5,4,0,0,101
21,14,19,15,23,14,0,0,0,106
21,14,19,16,1,3,5,4,0,83
21,14,19,16,1,4,5,4,0,84
21,14,19,16,1,25,5,4,0,105
21,14,19,16,1,14,0,0,0,85
21,14,19,16,1,14,11,5,4,105
21,14,19,16,1,14,14,5,4,108
21,14,19,16,1,18,0,0,0,89
21,14,19,16,1,18,5,4,0,98
21,14,19,16,1,18,9,14,7,119
21,14,19,16,1,18,11,5,4,109
21,14,19,16,1,18,18,5,4,116
21,14,19,16,1,18,19,5,0,113
21,14,19,16,1,19,13,5,4,112
21,14,19,16,1,20,9,1,12,113
21,14,19,16,1,23,14,5,4,117
21,14,19,16,5,1,11,0,0,87
21,14,19,16,5,1,11,19,0,106
21,14,19,16,5,1,18,5,4,103
21,14,19,16,5,3,11,5,4,98
21,14,19,16,5,4,0,0,0,79
21,14,19,16,5,5,4,0,0,84
21,14,19,16,5,5,4,25,0,109
21,14,19,16,5,5,18,5,4,107
21,14,19,16,5,12,12,0,0,99
21,14,19,16,5,12,12,5,4,108
21,14,19,16,5,12,12,5,18,122
21,14,19,16,5,12,20,0,0,107
21,14,19,16,5,14,20,0,0,109
21,14,19,16,5,23,5,4,0,107
21,14,19,16,8,5,18,5,0,106
21,14,19,16,8,5,18,5,4,110
21,14,19,16,8,5,18,5,19,125
21,14,19,16,9,1,2,12,5,99
21,14,19,16,9,3,5,4,0,91
21,14,19,16,9,3,25,0,0,107
21,14,19,16,9,3,9,12,25,128
21,14,19,16,9,5,4,0,0,88
21,14,19,16,25,9,14,7,0,125
21,14,19,16,9,11,5,0,0,95
21,14,19,16,9,12,12,5,4,112
21,14,19,16,9,12,20,0,0,111
21,14,19,16,9,14,0,0,0,93
21,14,19,16,9,18,1,12,0,110
21,14,19,16,9,18,5,4,0,106
21,14,19,16,9,18,9,14,7,127
21,14,19,16,9,18,9,20,0,126
21,14,19,16,9,20,0,0,0,99
21,14,19,16,9,20,5,4,0,108
21,14,19,16,9,20,20,5,4,128
21,14,19,16,12,1,25,5,4,117
21,14,19,16,12,9,3,5,4,103
21,14,19,16,12,9,20,0,0,111
21,14,19,16,15,9,12,0,0,106
21,14,19,16,15,9,12,5,4,115
21,14,19,16,15,9,12,20,0,126
21,14,19,16,15,11,5,0,0,101
21,14,19,16,15,11,5,14,0,115
21,14,19,16,15,14,7,5,4,115
21,14,19,16,15,14,7,25,0,131
21,14,19,16,15,18,20,5,4,132
21,14,19,16,15,20,0,0,0,105
21,14,19,16,15,20,20,5,4,134
21,14,19,16,15,20,20,5,14,144
21,14,19,16,15,21,19,5,4,134
21,14,19,16,15,21,20,5,4,135
21,14,19,16,18,1,25,5,4,123
21,14,19,16,18,5,1,4,0,98
21,14,19,16,18,9,14,7,0,118
21,14,19,16,18,21,3,5,4,121
21,14,19,16,18,21,14,7,0,130
21,14,19,16,21,14,0,0,0,105
21,14,19,16,21,18,14,5,4,132
21,14,19,16,21,18,18,5,4,136
21,14,19,17,21,1,18,5,0,116
21,14,19,17,21,1,18,5,4,120
21,14,19,17,21,9,18,5,0,124
21,14,19,17,21,9,18,5,4,128
21,14,19,20,1,2,2,5,4,88
21,14,19,20,1,2,12,5,0,94
21,14,19,20,1,2,12,5,4,98
21,14,19,20,1,2,12,5,18,112
21,14,19,20,1,2,12,25,0,114
21,14,19,20,1,3,11,0,0,89
21,14,19,20,1,3,11,5,4,98
21,14,19,20,1,3,11,5,18,112
21,14,19,20,1,3,11,19,0,108
21,14,19,20,1,6,6,5,4,96
21,14,19,20,1,7,5,4,0,91
21,14,19,20,1,7,25,0,0,107
21,14,19,20,1,7,9,12,25,128
21,14,19,20,1,9,4,0,0,88
21,14,19,20,1,9,4,12,25,125
21,14,19,20,1,25,5,4,0,109
21,14,19,20,1,25,9,14,7,130
21,14,19,20,1,9,14,0,0,98
21,14,19,20,1,9,14,5,4,107
21,14,19,20,1,12,5,4,0,96
21,14,19,20,1,12,11,5,4,107
21,14,19,20,1,12,12,5,4,108
21,14,19,20,1,13,16,5,4,113
21,14,19,20,1,14,3,8,0,100
21,14,19,20,1,16,12,5,4,112
21,14,19,20,1,18,0,0,0,93
21,14,19,20,1,18,3,8,0,104
21,14,19,20,1,18,18,5,4,120
21,14,19,20,1,18,20,5,4,122
21,14,19,20,1,18,22,5,4,124
21,14,19,20,1,20,5,0,0,100
21,14,19,20,1,20,5,4,0,104
21,14,19,20,1,20,5,12,25,137
21,14,19,20,1,20,5,19,0,119
21,14,19,20,1,20,9,3,0,107
21,14,19,20,1,20,9,14,7,125
21,14,19,20,1,20,9,15,14,133
21,14,19,20,1,20,21,5,4,125
21,14,19,20,1,21,14,3,8,121
21,14,19,20,1,22,5,4,0,106
21,14,19,20,5,1,4,25,0,109
21,14,19,20,5,1,13,5,4,102
21,14,19,20,5,3,11,0,0,93
21,14,19,20,5,3,11,5,4,102
21,14,19,20,5,5,11,0,0,95
21,14,19,20,5,5,12,0,0,96
21,14,19,20,5,5,12,5,4,105
21,14,19,20,5,5,12,19,0,115
21,14,19,20,5,5,16,0,0,100
21,14,19,20,5,5,16,5,4,109
21,14,19,20,5,5,18,5,4,111
21,14,19,20,5,13,13,5,4,114
21,14,19,20,5,16,0,0,0,95
21,14,19,20,5,16,16,5,4,120
21,14,19,20,5,16,19,0,0,114
21,14,19,20,5,18,9,12,5,123
21,14,19,20,5,18,14,0,0,111
21,14,19,20,5,18,14,12,25,148
21,14,19,20,5,23,5,4,0,111
21,14,19,20,25,0,0,0,0,99
21,14,19,20,9,3,11,0,0,97
21,14,19,20,9,3,11,5,4,106
21,14,19,20,9,3,11,25,0,122
21,14,19,20,9,3,11,19,0,116
21,14,19,20,9,6,6,0,0,95
21,14,19,20,9,6,6,5,14,114
21,14,19,20,9,6,6,12,25,132
21,14,19,20,9,6,12,5,4,110
21,14,19,20,25,12,5,4,0,120
21,14,19,20,25,12,9,19,8,147
21,14,19,20,9,12,12,0,0,107
21,14,19,20,9,12,12,5,4,116
21,14,19,20,9,12,20,5,4,124
21,14,19,20,9,14,7,0,0,104
21,14,19,20,9,14,7,5,4,113
21,14,19,20,9,14,20,5,4,126
21,14,19,20,9,18,18,5,4,128
21,14,19,20,9,20,3,8,0,114
21,14,19,20,15,3,11,0,0,103
21,14,19,20,15,3,11,5,4,112
21,14,19,20,15,9,3,0,0,101
21,14,19,20,15,9,3,1,12,114
21,14,19,20,15,11,5,4,0,109
21,14,19,20,15,11,5,14,0,119
21,14,19,20,15,12,5,14,0,120
21,14,19,20,15,14,5,0,0,108
21,14,19,20,15,14,5,4,0,112
21,14,19,20,15,14,25,0,0,128
21,14,19,20,15,14,9,12,25,149
21,14,19,20,15,15,16,5,4,129
21,14,19,20,15,16,0,0,0,105
21,14,19,20,15,16,16,5,4,130
21,14,19,20,15,16,16,5,18,144
21,14,19,20,15,16,16,12,5,138
21,14,19,20,15,16,19,0,0,124
21,14,19,20,15,18,5,0,0,112
21,14,19,20,15,18,5,4,0,116
21,14,19,20,15,18,9,5,4,125
21,14,19,20,15,18,13,5,4,129
21,14,19,20,15,18,13,25,0,145
21,14,19,20,15,21,20,0,0,130
21,14,19,20,15,21,20,12,25,167
21,14,19,20,15,22,5,4,0,120
21,14,19,20,15,23,0,0,0,112
21,14,19,20,15,23,5,4,0,121
21,14,19,20,18,1,6,5,4,108
21,14,19,20,18,1,9,14,0,116
21,14,19,20,18,1,14,4,0,111
21,14,19,20,18,1,14,7,5,119
21,14,19,20,18,1,16,0,0,109
21,14,19,20,18,1,16,19,0,128
21,14,19,20,18,5,14,7,0,118
21,14,19,20,18,5,19,19,0,135
21,14,19,20,18,5,20,3,8,128
21,14,19,20,18,5,23,5,4,129
21,14,19,20,18,5,23,14,0,134
21,14,19,20,18,9,3,20,0,124
21,14,19,20,18,9,4,5,0,110
21,14,19,20,18,9,11,5,0,117
21,14,19,20,18,9,14,7,0,122
21,14,19,20,18,9,14,7,19,141
21,14,19,20,18,9,16,0,0,117
21,14,19,20,18,9,16,5,4,126
21,14,19,20,18,15,11,5,4,127
21,14,19,20,18,15,14,7,0,128
21,14,19,20,18,21,3,11,0,127
21,14,19,20,18,21,14,7,0,134
21,14,19,20,21,2,2,5,4,108
21,14,19,20,21,3,11,0,0,109
21,14,19,20,21,4,4,5,4,112
21,14,19,20,21,4,9,5,4,117
21,14,19,20,21,6,6,0,0,107
21,14,19,20,21,6,6,5,4,116
21,14,19,20,21,6,6,25,0,132
21,14,19,20,21,14,7,0,0,116
21,14,19,20,21,14,14,5,4,132
21,14,19,20,21,14,20,5,4,138
21,14,19,20,21,16,9,4,0,124
21,14,19,20,21,18,4,25,0,142
21,14,19,21,2,4,21,5,4,111
21,14,19,21,2,10,5,3,20,115
21,14,19,21,2,20,12,5,0,114
21,14,19,21,2,20,12,25,0,134
21,14,19,21,3,3,5,19,19,124
21,14,19,21,3,11,5,4,0,98
21,14,19,21,3,11,12,5,4,110
21,14,19,21,5,4,0,0,0,84
21,14,19,21,7,1,18,5,4,110
21,14,19,21,7,1,18,25,0,126
21,14,19,21,9,20,0,0,0,104
21,14,19,21,9,20,5,4,0,113
21,14,19,21,9,20,9,14,7,134
21,14,19,21,12,11,25,0,0,123
21,14,19,21,12,11,9,12,25,144
21,14,19,21,12,12,5,14,0,118
21,14,19,21,12,12,9,5,4,117
21,14,19,21,12,20,18,25,0,150
21,14,19,21,13,13,5,4,0,110
21,14,19,21,14,0,0,0,0,89
21,14,19,21,14,7,0,0,0,96
21,14,19,21,14,11,0,0,0,100
21,14,19,21,14,11,5,14,0,119
21,14,19,21,14,14,5,4,0,112
21,14,19,21,14,14,25,0,0,128
21,14,19,21,16,9,14,5,0,119
21,14,19,21,16,16,5,4,0,116
21,14,19,21,16,16,12,5,0,124
21,14,19,21,16,16,12,5,4,128
21,14,19,21,16,16,12,25,0,144
21,14,19,21,16,18,5,13,5,132
21,14,19,21,18,5,0,0,0,98
21,14,19,21,18,5,12,25,0,135
21,14,19,21,18,5,20,25,0,143
21,14,19,21,18,7,9,14,7,130
21,14,19,21,18,12,25,0,0,130
21,14,19,21,18,12,9,12,25,151
21,14,19,21,19,16,5,3,20,138
21,14,19,21,20,21,18,5,4,143
21,14,19,23,1,2,2,5,4,91
21,14,19,23,1,4,4,12,5,103
21,14,19,23,1,25,5,4,0,112
21,14,19,23,1,25,9,14,7,133
21,14,19,23,1,13,16,25,0,132
21,14,19,23,1,16,16,5,4,119
21,14,19,23,1,20,8,5,0,111
21,14,19,23,1,20,8,5,4,115
21,14,19,23,1,20,8,5,19,130
21,14,19,23,5,1,18,0,0,101
21,14,19,23,5,1,18,19,0,120
21,14,19,23,5,1,20,0,0,103
21,14,19,23,5,1,20,5,4,112
21,14,19,23,5,5,20,0,0,107
21,14,19,23,5,5,20,5,14,126
21,14,19,23,5,5,20,12,25,144
21,14,19,23,5,12,12,0,0,106
21,14,19,23,5,12,12,5,4,115
21,14,19,23,5,16,20,0,0,118
21,14,19,23,5,18,22,5,4,131
21,14,19,23,9,12,12,5,4,119
21,14,19,23,9,14,7,0,0,107
21,14,19,23,9,22,5,12,0,125
21,14,19,23,15,12,12,5,14,135
21,14,19,23,15,18,5,0,0,115
21,14,19,23,15,18,14,0,0,124
21,14,19,23,21,14,7,0,0,119
21,14,20,1,0,0,0,0,0,56
21,14,20,1,2,12,5,4,0,79
21,14,20,1,3,11,0,0,0,70
21,14,20,1,3,11,5,4,0,79
21,14,20,1,3,11,9,14,7,100
21,14,20,1,3,11,12,5,0,87
21,14,20,1,3,11,12,5,4,91
21,14,20,1,3,11,19,0,0,89
21,14,20,1,3,20,6,21,12,118
21,14,20,1,3,20,9,12,5,105
21,14,20,1,3,20,21,1,12,113
21,14,20,1,7,7,5,4,0,79
21,14,20,1,9,12,5,4,0,86
21,14,20,1,9,14,20,0,0,99
21,14,20,1,9,14,20,5,4,108
21,14,20,1,11,1,2,12,5,87
21,14,20,1,11,5,14,0,0,86
21,14,20,1,11,9,14,7,0,97
21,14,20,1,12,11,5,4,0,88
21,14,20,1,12,11,9,14,7,109
21,14,20,1,12,12,0,0,0,80
21,14,20,1,12,12,9,5,4,98
21,14,20,1,12,15,14,5,4,106
21,14,20,1,13,1,2,12,5,89
21,14,20,1,13,1,2,12,25,109
21,14,20,1,13,5,0,0,0,74
21,14,20,1,13,5,4,0,0,78
21,14,20,1,13,5,4,12,25,115
21,14,20,1,13,5,12,25,0,111
21,14,20,1,14,7,12,5,0,94
21,14,20,1,14,7,12,5,4,98
21,14,20,1,14,7,12,5,19,113
21,14,20,1,14,14,5,4,0,93
21,14,20,1,16,0,0,0,0,72
21,14,20,1,16,5,4,0,0,81
21,14,20,1,16,5,18,5,4,104
21,14,20,1,16,16,5,4,0,97
21,14,20,1,16,16,9,3,5,105
21,14,20,1,18,0,0,0,0,74
21,14,20,1,18,18,5,4,0,101
21,14,20,1,18,18,9,5,4,110
21,14,20,1,19,11,5,4,0,95
21,14,20,1,19,20,5,0,0,100
21,14,20,1,19,20,5,4,0,104
21,14,20,1,19,20,25,0,0,120
21,14,20,1,19,20,9,12,25,141
21,14,20,1,19,20,9,14,7,125
21,14,20,1,21,7,8,20,0,112
21,14,20,1,21,14,20,5,4,120
21,14,20,1,21,20,0,0,0,97
21,14,20,1,21,20,12,25,0,134
21,14,20,1,23,4,18,25,0,126
21,14,20,1,23,5,4,0,0,88
21,14,20,1,24,0,0,0,0,80
21,14,20,1,24,1,2,12,5,100
21,14,20,1,24,5,4,0,0,89
21,14,20,1,24,9,5,4,0,98
21,14,20,1,24,9,14,7,0,110
21,14,20,5,1,3,8,0,0,72
21,14,20,5,1,3,8,5,19,96
21,14,20,5,1,13,0,0,0,74
21,14,20,5,1,13,5,4,0,83
21,14,20,5,1,13,9,14,7,104
21,14,20,5,1,19,5,4,0,89
21,14,20,5,1,19,12,5,4,101
21,14,20,5,4,4,5,4,0,77
21,14,20,5,4,9,15,21,19,128
21,14,20,5,5,13,0,0,0,78
21,14,20,5,5,13,9,14,7,108
21,14,20,5,5,20,8,5,4,102
21,14,20,5,12,9,3,0,0,84
21,14,20,5,12,12,0,0,0,84
21,14,20,5,12,12,9,14,7,114
21,14,20,5,13,16,5,18,0,112
21,14,20,5,13,16,12,5,4,110
21,14,20,5,13,16,20,5,4,118
21,14,20,5,14,1,2,12,5,94
21,14,20,5,14,1,2,12,25,114
21,14,20,5,14,1,14,20,0,109
21,14,20,5,14,4,5,4,0,87
21,14,20,5,14,4,5,18,0,101
21,14,20,5,14,9,2,12,5,102
21,14,20,5,14,9,2,12,25,122
21,14,20,5,14,19,5,0,0,98
21,14,20,5,14,19,5,12,25,135
21,14,20,5,14,19,9,12,5,119
21,14,20,5,14,19,9,14,7,123
21,14,20,5,14,20,0,0,0,94
21,14,20,5,14,20,5,4,0,103
21,14,20,5,14,20,25,0,0,119
21,14,20,5,14,21,15,21,19,150
21,14,20,5,18,13,5,4,0,100
21,14,20,5,18,18,5,4,0,105
21,14,20,5,18,19,5,0,0,102
21,14,20,5,18,19,5,12,25,139
21,14,20,5,19,20,1,20,5,125
21,14,20,5,19,20,5,4,0,108
21,14,20,5,20,8,5,18,0,111
21,14,20,5,20,8,5,18,19,130
21,14,20,5,23,5,4,0,0,92
21,14,20,5,24,20,21,1,12,138
21,14,20,8,1,14,11,0,0,89
21,14,20,8,1,14,11,5,4,98
21,14,20,8,1,20,3,8,0,95
21,14,20,8,1,23,0,0,0,87
21,14,20,8,1,23,5,4,0,96
21,14,20,8,1,23,9,14,7,117
21,14,20,8,5,14,4,5,0,91
21,14,20,8,5,23,5,4,0,100
21,14,20,8,9,3,11,0,0,86
21,14,20,8,9,3,11,5,14,105
21,14,20,8,9,3,11,12,25,123
21,14,20,8,9,14,11,0,0,97
21,14,20,8,9,14,11,5,18,120
21,14,20,8,9,14,11,19,0,116
21,14,20,8,9,14,14,5,4,109
21,14,20,8,9,18,19,20,25,154
21,14,20,8,9,19,20,12,5,128
21,14,20,8,15,18,14,0,0,110
21,14,20,8,15,18,14,25,0,135
21,14,20,8,15,21,7,8,20,134
21,14,20,8,18,1,12,12,0,106
21,14,20,8,18,5,1,4,0,91
21,14,20,8,18,5,1,4,19,110
21,14,20,8,18,9,4,0,0,94
21,14,20,8,18,9,6,20,0,116
21,14,20,8,18,9,6,20,25,141
21,14,20,8,18,9,22,5,0,117
21,14,20,8,18,9,22,5,14,131
21,14,20,8,18,15,1,20,25,142
21,14,20,8,18,15,2,0,0,98
21,14,20,8,18,15,14,5,0,115
21,14,20,8,18,15,14,5,4,119
21,14,20,8,18,15,14,5,19,134
21,14,20,8,18,15,23,14,0,133
21,14,20,8,18,21,19,20,0,141
21,14,20,8,21,13,2,5,4,108
21,14,20,8,21,13,16,5,4,122
21,14,20,9,1,18,1,5,4,93
21,14,20,9,3,11,12,5,4,99
21,14,20,9,4,1,12,0,0,81
21,14,20,9,4,25,0,0,0,93
21,14,20,9,4,9,5,4,0,86
21,14,20,9,4,9,5,18,0,100
21,14,20,9,4,9,5,19,0,101
21,14,20,9,4,9,5,19,20,121
21,14,20,9,4,25,9,14,7,123
21,14,20,9,4,9,12,25,0,114
21,14,20,9,5,0,0,0,0,69
21,14,20,9,5,4,0,0,0,73
21,14,20,9,5,9,14,7,0,99
21,14,20,9,5,18,5,4,0,96
21,14,20,9,5,19,0,0,0,88
21,14,20,9,7,8,20,0,0,99
21,14,20,9,7,8,20,5,14,118
21,14,20,9,9,14,7,0,0,94
21,14,20,25,9,14,7,0,0,110
21,14,20,9,12,0,0,0,0,76
21,14,20,9,12,5,0,0,0,81
21,14,20,9,12,5,4,0,0,85
21,14,20,9,12,12,0,0,0,88
21,14,20,9,12,12,5,4,0,97
21,14,20,9,12,12,9,14,7,118
21,14,20,9,12,20,0,0,0,96
21,14,20,9,12,20,5,4,0,105
21,14,20,9,12,20,9,14,7,126
21,14,20,9,13,5,0,0,0,82
21,14,20,9,13,5,4,0,0,86
21,14,20,9,13,5,12,25,0,119
21,14,20,9,13,5,15,21,19,137
21,14,20,9,13,9,4,0,0,90
21,14,20,9,13,9,4,12,25,127
21,14,20,9,13,15,21,19,0,132
21,14,20,9,14,0,0,0,0,78
21,14,20,9,14,3,20,0,0,101
21,14,20,9,14,5,0,0,0,83
21,14,20,9,14,7,5,4,0,94
21,14,20,9,14,14,5,4,0,101
21,14,20,9,14,20,5,4,0,107
21,14,20,25,16,5,4,0,0,105
21,14,20,25,16,9,3,1,12,121
21,14,20,9,16,16,5,4,0,105
21,14,20,9,16,16,12,5,4,117
21,14,20,9,16,19,25,0,0,124
21,14,20,9,16,20,0,0,0,100
21,14,20,9,18,1,2,12,5,102
21,14,20,9,18,5,0,0,0,87
21,14,20,9,18,5,4,0,0,91
21,14,20,9,18,5,4,12,25,128
21,14,20,9,18,9,14,7,0,112
21,14,20,9,19,19,21,5,4,132
21,14,20,9,20,8,5,4,0,101
21,14,20,9,20,12,5,4,0,105
21,14,20,9,20,21,12,1,18,136
21,14,20,15,0,0,0,0,0,70
21,14,20,15,1,19,20,5,4,119
21,14,20,15,7,1,5,4,0,87
21,14,20,15,7,7,12,5,0,101
21,14,20,15,7,7,12,5,18,119
21,14,20,15,9,12,5,4,0,100
21,14,20,15,9,12,9,14,7,121
21,14,20,15,12,4,0,0,0,86
21,14,20,15,12,12,5,4,0,103
21,14,20,15,13,2,0,0,0,85
21,14,20,15,13,2,5,4,0,94
21,14,20,15,14,5,0,0,0,89
21,14,20,15,14,5,4,0,0,93
21,14,20,15,14,7,21,5,0,117
21,14,20,15,14,7,21,5,4,121
21,14,20,15,15,12,5,4,0,106
21,14,20,15,15,20,8,0,0,113
21,14,20,15,15,20,8,5,4,122
21,14,20,15,16,0,0,0,0,86
21,14,20,15,16,16,5,4,0,111
21,14,20,15,16,16,9,14,7,132
21,14,20,15,16,16,12,5,4,123
21,14,20,15,18,14,0,0,0,102
21,14,20,15,18,16,9,4,0,117
21,14,20,15,18,18,9,4,0,119
21,14,20,15,18,20,21,18,5,152
21,14,20,15,19,19,5,4,0,117
21,14,20,15,20,1,12,5,4,112
21,14,20,15,20,20,5,4,0,119
21,14,20,15,21,3,8,0,0,102
21,14,20,15,21,3,8,5,4,111
21,14,20,15,21,7,8,0,0,106
21,14,20,15,21,7,8,12,25,143
21,14,20,15,21,18,5,4,0,118
21,14,20,15,23,1,18,4,0,116
21,14,20,15,23,5,18,5,4,125
21,14,20,15,23,14,0,0,0,107
21,14,20,15,24,9,3,0,0,106
21,14,20,18,1,3,5,0,0,82
21,14,20,18,1,3,5,4,0,86
21,14,20,18,1,3,11,5,4,97
21,14,20,18,1,3,20,5,4,106
21,14,20,18,1,4,5,4,0,87
21,14,20,18,1,4,9,14,7,108
21,14,20,18,1,7,9,3,0,93
21,14,20,18,1,9,12,5,4,104
21,14,20,18,1,9,14,0,0,97
21,14,20,18,1,9,14,5,4,106
21,14,20,18,1,13,13,5,4,109
21,14,20,18,1,13,16,5,4,112
21,14,20,18,1,14,3,5,0,96
21,14,20,18,1,16,16,5,4,115
21,14,20,18,1,19,8,5,4,110
21,14,20,18,5,1,4,0,0,83
21,14,20,18,5,1,4,19,0,102
21,14,20,18,5,1,20,5,4,108
21,14,20,18,5,5,4,0,0,87
21,14,20,18,5,11,11,5,4,109
21,14,20,18,5,14,4,0,0,96
21,14,20,18,5,14,4,25,0,121
21,14,20,18,5,19,19,0,0,116
21,14,20,18,5,19,19,5,4,125
21,14,20,18,9,1,2,12,5,102
21,14,20,18,9,2,1,12,0,97
21,14,20,18,9,3,5,4,0,94
21,14,20,18,9,3,11,5,4,105
21,14,20,18,9,5,4,0,0,91
21,14,20,18,9,7,0,0,0,89
21,14,20,18,25,9,14,7,0,128
21,14,20,18,9,12,12,0,0,106
21,14,20,18,9,13,0,0,0,95
21,14,20,18,9,13,13,5,4,117
21,14,20,18,9,13,19,0,0,114
21,14,20,18,9,16,5,0,0,103
21,14,20,18,9,16,16,5,4,123
21,14,20,18,9,19,20,0,0,121
21,14,20,18,9,20,5,0,0,107
21,14,20,18,9,20,5,12,25,144
21,14,20,18,9,22,9,1,12,126
21,14,20,18,15,4,0,0,0,92
21,14,20,18,15,4,4,5,14,115
21,14,20,18,15,12,12,5,4,121
21,14,20,18,15,16,9,3,0,116
21,14,20,18,15,20,8,0,0,116
21,14,20,18,15,20,20,5,4,137
21,14,20,18,15,21,2,12,5,128
21,14,20,18,15,23,5,4,0,120
21,14,20,18,21,1,14,20,0,129
21,14,20,18,21,3,5,4,0,106
21,14,20,18,21,3,11,0,0,108
21,14,20,18,21,5,0,0,0,99
21,14,20,18,21,5,18,0,0,117
21,14,20,18,21,5,19,20,0,138
21,14,20,18,21,9,19,13,0,135
21,14,20,18,21,12,25,0,0,131
21,14,20,18,21,13,16,5,4,132
21,14,20,18,21,14,11,5,4,128
21,14,20,18,21,19,19,0,0,132
21,14,20,18,21,19,19,5,4,141
21,14,20,18,21,19,19,5,18,155
21,14,20,18,21,19,19,5,19,156
21,14,20,18,21,19,20,0,0,133
21,14,20,18,21,19,20,5,4,142
21,14,20,18,21,19,20,25,0,158
21,14,20,18,21,20,8,0,0,122
21,14,20,18,21,20,8,5,18,145
21,14,20,18,21,20,8,19,0,141
21,14,20,20,18,15,4,0,0,112
21,14,20,21,2,2,5,4,0,89
21,14,20,21,3,11,0,0,0,90
21,14,20,21,3,11,5,4,0,99
21,14,20,21,3,11,9,14,7,120
21,14,20,21,3,11,19,0,0,109
21,14,20,21,6,20,5,4,0,111
21,14,20,21,7,7,5,4,0,99
21,14,20,21,13,2,12,5,4,112
21,14,20,21,13,9,4,0,0,102
21,14,20,21,13,9,4,12,25,139
21,14,20,21,14,1,2,12,5,110
21,14,20,21,14,1,2,12,25,130
21,14,20,21,14,5,0,0,0,95
21,14,20,21,14,5,4,0,0,99
21,14,20,21,14,5,6,21,12,134
21,14,20,21,14,5,19,0,0,114
21,14,20,21,14,9,14,7,0,120
21,14,20,21,16,16,5,4,0,117
21,14,20,21,18,2,9,4,0,109
21,14,20,21,18,6,0,0,0,100
21,14,20,21,18,6,5,4,0,109
21,14,20,21,18,7,9,4,0,114
21,14,20,21,18,14,0,0,0,108
21,14,20,21,18,14,5,4,0,117
21,14,20,21,18,14,9,14,7,138
21,14,20,21,19,11,5,4,0,115
21,14,20,21,20,5,12,1,18,132
21,14,20,21,20,15,18,5,4,138
21,14,20,23,9,12,12,5,4,120
21,14,20,23,9,14,4,0,0,105
21,14,20,23,9,14,5,0,0,106
21,14,20,23,9,14,5,4,0,110
21,14,20,23,9,14,5,19,0,125
21,14,20,23,9,14,9,14,7,131
21,14,20,23,9,14,14,5,4,124
21,14,20,23,9,18,12,0,0,117
21,14,20,23,9,18,12,5,4,126
21,14,20,23,9,19,20,0,0,126
21,14,20,23,9,19,20,5,4,135
21,14,20,23,9,19,20,5,18,149
21,14,20,23,9,19,20,19,0,145
21,14,20,23,9,20,20,5,14,146
21,14,20,26,0,0,0,0,0,81
21,14,21,7,12,25,0,0,0,100
21,14,21,12,20,18,1,0,0,107
21,14,21,13,0,0,0,0,0,69
21,14,21,13,16,9,18,5,4,121
21,14,21,14,9,6,9,5,4,103
21,14,21,14,9,6,15,18,13,131
21,14,21,14,9,17,21,5,0,122
21,14,21,14,9,20,5,4,0,108
21,14,21,14,9,20,9,14,7,129
21,14,21,16,4,1,20,5,4,106
21,14,21,16,18,9,7,8,20,134
21,14,21,16,19,5,20,0,0,116
21,14,21,18,2,1,14,0,0,91
21,14,21,18,2,1,14,5,0,96
21,14,21,18,5,4,0,0,0,83
21,14,21,18,7,5,4,0,0,90
21,14,21,18,7,5,14,20,0,120
21,14,21,18,7,9,14,7,0,111
21,14,21,18,14,0,0,0,0,88
21,14,21,18,14,5,4,0,0,97
21,14,21,19,1,2,12,5,0,95
21,14,21,19,1,2,12,25,0,115
21,14,21,19,1,7,5,0,0,88
21,14,21,19,5,0,0,0,0,80
21,14,21,19,5,1,2,12,5,100
21,14,21,19,5,1,2,12,25,120
21,14,21,19,5,4,0,0,0,84
21,14,21,19,5,6,21,12,0,119
21,14,21,19,8,5,18,5,4,115
21,14,21,19,21,1,12,0,0,109
21,14,21,19,21,1,12,12,25,146
21,14,21,19,21,18,16,5,4,139
21,14,21,20,20,5,18,5,4,128
21,14,21,24,15,18,9,1,12,135
21,14,22,1,3,1,14,20,0,96
21,14,22,1,3,1,20,5,4,91
21,14,22,1,3,21,15,21,19,137
21,14,22,1,7,18,1,14,20,118
21,14,22,1,7,21,5,0,0,91
21,14,22,1,7,21,5,12,25,128
21,14,22,1,9,14,0,0,0,81
21,14,22,1,9,14,12,25,0,118
21,14,22,1,12,5,20,5,4,104
21,14,22,1,12,9,1,14,20,114
21,14,22,1,12,9,4,0,0,83
21,14,22,1,12,9,4,12,25,120
21,14,22,1,12,21,5,0,0,96
21,14,22,1,12,21,5,4,0,100
21,14,22,1,13,16,5,4,0,96
21,14,22,1,18,9,1,14,20,120
21,14,22,1,18,9,5,4,0,94
21,14,22,1,18,25,9,14,7,131
21,14,22,1,19,19,1,12,0,109
21,14,22,1,20,20,5,4,0,107
21,14,22,1,21,12,20,5,4,120
21,14,22,1,21,14,20,5,4,122
21,14,22,5,5,18,9,14,7,115
21,14,22,5,9,12,0,0,0,83
21,14,22,5,9,12,5,4,0,92
21,14,22,5,9,12,5,18,0,106
21,14,22,5,9,12,9,14,7,113
21,14,22,5,9,12,19,0,0,102
21,14,22,5,9,14,5,4,0,94
21,14,22,5,12,22,5,20,25,146
21,14,22,5,14,1,12,0,0,89
21,14,22,5,14,4,5,4,0,89
21,14,22,5,14,7,5,4,0,92
21,14,22,5,14,9,1,12,0,98
21,14,22,5,14,15,13,0,0,104
21,14,22,5,14,15,13,5,4,113
21,14,22,5,14,20,5,4,0,105
21,14,22,5,14,21,5,4,0,106
21,14,22,5,18,2,1,12,0,95
21,14,22,5,18,2,15,19,5,121
21,14,22,5,18,4,1,14,20,119
21,14,22,5,18,9,4,9,3,105
21,14,22,5,18,9,20,25,0,134
21,14,22,5,18,19,5,4,0,108
21,14,22,5,19,19,5,12,0,117
21,14,22,5,19,20,0,0,0,101
21,14,22,5,19,20,5,4,0,110
21,14,22,5,20,15,5,4,0,106
21,14,22,5,24,5,4,0,0,95
21,14,22,5,24,20,0,0,0,106
21,14,22,9,1,2,12,5,0,86
21,14,22,9,2,18,1,14,20,121
21,14,22,9,3,1,18,0,0,88
21,14,22,9,3,9,15,21,19,133
21,14,22,9,5,23,5,4,0,103
21,14,22,25,9,14,7,0,0,112
21,14,22,9,14,15,21,19,0,135
21,14,22,9,15,12,1,20,5,119
21,14,22,9,15,12,5,14,20,132
21,14,22,9,18,7,9,14,0,114
21,14,22,9,18,9,12,5,0,110
21,14,22,9,18,20,21,5,0,130
21,14,22,9,19,9,2,12,5,113
21,14,22,9,19,9,2,12,25,133
21,14,22,9,19,9,15,14,0,123
21,14,22,9,19,9,20,5,4,123
21,14,22,9,19,15,18,0,0,118
21,14,22,9,19,15,18,5,4,127
21,14,22,9,19,20,1,5,4,115
21,14,22,9,19,21,1,12,0,119
21,14,22,9,20,1,12,0,0,99
21,14,22,9,20,1,12,12,25,136
21,14,22,9,22,9,4,0,0,101
21,14,22,9,22,9,4,12,25,138
21,14,22,9,26,1,18,4,0,115
21,14,22,9,26,15,18,5,4,134
21,14,22,15,3,1,2,12,5,95
21,14,22,15,3,1,12,0,0,88
21,14,22,15,9,3,5,0,0,89
21,14,22,15,9,3,5,4,0,93
21,14,22,15,9,3,5,19,0,108
21,14,22,15,9,3,9,14,7,114
21,14,22,15,9,4,0,0,0,85
21,14,22,15,9,4,5,4,0,94
21,14,22,15,12,21,2,12,5,124
21,14,22,15,12,21,2,12,25,144
21,14,22,15,12,21,13,5,4,127
21,14,22,15,13,9,20,5,4,123
21,14,22,15,20,5,0,0,0,97
21,14,22,15,20,5,4,0,0,101
21,14,22,15,20,9,14,7,0,122
21,14,22,15,21,3,8,5,4,113
21,14,22,15,23,5,4,0,0,104
21,14,22,15,23,5,12,5,4,121
21,14,22,21,12,7,1,18,0,116
21,14,23,1,4,1,2,12,5,83
21,14,23,1,4,4,5,4,0,76
21,14,23,1,4,5,4,0,0,72
21,14,23,1,4,9,14,7,0,93
21,14,23,1,6,20,5,4,0,94
21,14,23,1,7,5,4,0,0,75
21,14,23,1,7,5,18,5,4,98
21,14,23,1,7,7,5,4,0,82
21,14,23,1,25,5,4,0,0,93
21,14,23,1,9,12,5,4,0,89
21,14,23,1,9,12,9,14,7,110
21,14,23,1,9,20,5,4,0,97
21,14,23,1,9,20,9,14,7,118
21,14,23,1,9,22,5,4,0,99
21,14,23,1,25,23,1,18,4,130
21,14,23,1,11,5,4,0,0,79
21,14,23,1,11,5,6,21,12,114
21,14,23,1,11,5,14,5,4,98
21,14,23,1,11,9,14,7,0,100
21,14,23,1,12,11,5,4,0,91
21,14,23,1,12,11,9,14,7,112
21,14,23,1,12,12,0,0,0,83
21,14,23,1,12,12,5,4,0,92
21,14,23,1,12,12,5,20,0,108
21,14,23,1,14,0,0,0,0,73
21,14,23,1,14,5,4,0,0,82
21,14,23,1,14,9,14,7,0,103
21,14,23,1,14,20,5,4,0,102
21,14,23,1,14,20,15,14,0,122
21,14,23,1,18,2,12,5,4,100
21,14,23,1,18,4,5,4,0,90
21,14,23,1,18,5,0,0,0,82
21,14,23,1,18,5,12,25,0,119
21,14,23,1,18,5,19,0,0,101
21,14,23,1,18,25,0,0,0,102
21,14,23,1,18,9,5,18,0,109
21,14,23,1,18,9,5,19,20,130
21,14,23,1,18,9,12,25,0,123
21,14,23,1,18,12,9,11,5,114
21,14,23,1,18,13,0,0,0,90
21,14,23,1,18,13,5,4,0,99
21,14,23,1,18,13,9,14,7,120
21,14,23,1,18,14,0,0,0,91
21,14,23,1,18,14,5,4,0,100
21,14,23,1,18,14,9,14,7,121
21,14,23,1,18,16,0,0,0,93
21,14,23,1,18,16,5,4,0,102
21,14,23,1,18,16,9,14,7,123
21,14,23,1,18,18,1,14,20,130
21,14,23,1,18,18,5,4,0,104
21,14,23,1,18,18,5,14,0,114
21,14,23,1,19,0,0,0,0,78
21,14,23,1,19,8,5,4,0,95
21,14,23,1,19,8,5,4,19,114
21,14,23,1,19,8,5,14,0,105
21,14,23,1,19,20,5,4,0,107
21,14,23,1,19,20,9,14,7,128
21,14,23,1,20,3,8,5,4,99
21,14,23,1,20,5,18,0,0,102
21,14,23,1,20,5,18,5,4,111
21,14,23,1,20,5,18,25,0,127
21,14,23,1,20,20,12,5,4,120
21,14,23,1,22,5,4,0,0,90
21,14,23,1,22,5,18,5,4,113
21,14,23,1,22,9,14,7,0,111
21,14,23,1,24,0,0,0,0,83
21,14,23,1,24,5,4,0,0,92
21,14,23,5,1,11,5,14,0,94
21,14,23,5,1,12,0,0,0,76
21,14,23,5,1,12,20,8,25,129
21,14,23,5,1,14,5,4,0,87
21,14,23,5,1,16,15,14,0,109
21,14,23,5,1,18,25,0,0,107
21,14,23,5,1,18,9,5,4,100
21,14,23,5,1,18,9,12,25,128
21,14,23,5,1,18,9,14,7,112
21,14,23,5,1,22,5,0,0,91
21,14,23,5,1,22,5,19,0,110
21,14,23,5,1,22,9,14,7,116
21,14,23,5,2,0,0,0,0,65
21,14,23,5,2,2,5,4,0,76
21,14,23,5,2,2,9,14,7,97
21,14,23,5,4,0,0,0,0,67
21,14,23,5,4,4,5,4,0,80
21,14,23,5,4,7,5,0,0,79
21,14,23,5,4,7,5,4,0,83
21,14,23,5,4,7,9,14,7,104
21,14,23,5,5,4,5,4,0,81
21,14,23,5,5,12,0,0,0,80
21,14,23,5,5,14,5,4,0,91
21,14,23,5,5,16,9,14,7,114
21,14,23,5,5,20,9,14,7,118
21,14,23,5,6,20,0,0,0,89
21,14,23,5,9,7,8,5,4,96
21,14,23,5,9,7,8,20,0,107
21,14,23,5,9,7,8,20,25,132
21,14,23,5,9,7,8,20,19,126
21,14,23,5,12,3,15,13,5,111
21,14,23,5,12,4,0,0,0,79
21,14,23,5,12,4,5,0,0,84
21,14,23,5,12,4,5,4,0,88
21,14,23,5,12,12,0,0,0,87
21,14,23,5,12,20,5,4,0,104
21,14,23,5,12,20,8,0,0,103
21,14,23,5,13,13,5,4,0,98
21,14,23,5,16,20,0,0,0,99
21,14,23,5,19,20,5,18,14,139
21,14,23,5,20,0,0,0,0,83
21,14,23,5,20,20,5,4,0,112
21,14,23,8,5,5,12,0,0,88
21,14,23,8,5,5,12,5,4,97
21,14,23,8,5,12,13,5,4,105
21,14,23,8,5,12,16,5,4,108
21,14,23,8,5,20,20,5,4,120
21,14,23,8,9,7,0,0,0,82
21,14,23,8,9,14,9,14,7,119
21,14,23,8,9,16,0,0,0,91
21,14,23,8,9,16,16,5,4,116
21,14,23,8,9,16,20,0,0,111
21,14,23,8,9,18,12,5,4,114
21,14,23,8,9,19,11,5,4,114
21,14,23,8,9,20,5,0,0,100
21,14,23,8,9,20,5,4,0,104
21,14,23,8,15,12,5,0,0,98
21,14,23,9,3,11,5,4,0,90
21,14,23,9,4,5,14,5,4,99
21,14,23,9,4,15,23,5,4,118
21,14,23,9,5,12,4,0,0,88
21,14,23,9,5,12,4,25,0,113
21,14,23,9,5,12,4,12,25,125
21,14,23,9,6,5,4,0,0,82
21,14,23,9,6,5,12,25,0,115
21,14,23,9,7,0,0,0,0,74
21,14,23,9,7,7,5,4,0,90
21,14,23,9,7,7,9,14,7,111
21,14,23,9,12,4,0,0,0,83
21,14,23,9,12,4,12,25,0,120
21,14,23,9,12,6,21,12,0,118
21,14,23,9,12,25,0,0,0,104
21,14,23,9,12,9,5,18,0,111
21,14,23,9,12,9,12,25,0,125
21,14,23,9,12,12,0,0,0,91
21,14,23,9,12,12,5,0,0,96
21,14,23,9,12,12,5,4,0,100
21,14,23,9,12,12,6,21,12,130
21,14,23,9,12,12,9,14,7,121
21,14,23,9,12,20,5,4,0,108
21,14,23,9,12,20,9,14,7,129
21,14,23,9,13,16,12,5,0,113
21,14,23,9,14,3,9,14,7,114
21,14,23,9,14,4,0,0,0,85
21,14,23,9,14,4,5,4,0,94
21,14,23,9,14,4,5,18,0,108
21,14,23,9,14,4,5,18,19,127
21,14,23,9,14,4,25,0,0,110
21,14,23,9,14,4,9,14,7,115
21,14,23,9,14,4,19,0,0,104
21,14,23,9,14,7,5,4,0,97
21,14,23,9,14,11,0,0,0,92
21,14,23,9,14,11,9,14,7,122
21,14,23,9,14,12,25,0,0,118
21,14,23,9,14,14,9,14,7,125
21,14,23,9,14,19,15,13,5,133
21,14,23,9,14,20,5,18,0,124
21,14,23,9,14,20,18,25,0,144
21,14,23,9,16,5,4,0,0,92
21,14,23,9,18,1,2,12,5,105
21,14,23,9,18,5,0,0,0,90
21,14,23,9,18,5,4,0,0,94
21,14,23,9,19,4,15,13,0,118
21,14,23,9,19,4,15,13,19,137
21,14,23,9,19,5,0,0,0,91
21,14,23,9,19,5,12,25,0,128
21,14,23,9,19,5,18,0,0,109
21,14,23,9,19,5,19,20,0,130
21,14,23,9,19,8,0,0,0,94
21,14,23,9,19,8,5,4,0,103
21,14,23,9,19,8,5,19,0,118
21,14,23,9,19,8,6,21,12,133
21,14,23,9,19,8,9,14,7,124
21,14,23,9,19,20,0,0,0,106
21,14,23,9,19,20,6,21,12,145
21,14,23,9,20,0,0,0,0,87
21,14,23,9,20,3,8,0,0,98
21,14,23,9,20,3,8,5,4,107
21,14,23,9,20,12,5,19,19,142
21,14,23,9,20,19,0,0,0,106
21,14,23,9,20,20,5,4,0,116
21,14,23,9,20,20,25,0,0,132
21,14,23,9,20,20,9,12,25,153
21,14,23,9,20,20,9,14,7,137
21,14,23,9,22,5,0,0,0,94
21,14,23,9,22,5,4,0,0,98
21,14,23,15,5,6,21,12,0,117
21,14,23,15,6,21,12,0,0,112
21,14,23,15,13,1,14,0,0,101
21,14,23,15,13,1,14,12,25,138
21,14,23,15,13,2,0,0,0,88
21,14,23,15,14,0,0,0,0,87
21,14,23,15,14,4,5,18,0,114
21,14,23,15,14,20,0,0,0,107
21,14,23,15,14,20,5,4,0,116
21,14,23,15,15,4,5,4,0,101
21,14,23,15,15,5,4,0,0,97
21,14,23,15,15,6,0,0,0,94
21,14,23,15,15,12,25,0,0,125
21,14,23,15,18,4,5,4,0,104
21,14,23,15,18,4,25,0,0,120
21,14,23,15,18,4,9,12,25,141
21,14,23,15,18,11,0,0,0,102
21,14,23,15,18,11,5,4,0,111
21,14,23,15,18,11,5,18,0,125
21,14,23,15,18,11,9,14,7,132
21,14,23,15,18,12,4,0,0,107
21,14,23,15,18,12,4,12,25,144
21,14,23,15,18,13,5,4,0,113
21,14,23,15,18,13,25,0,0,129
21,14,23,15,18,14,0,0,0,105
21,14,23,15,18,18,9,5,4,127
21,14,23,15,18,19,8,9,16,143
21,14,23,15,18,20,8,0,0,119
21,14,23,15,18,20,8,25,0,144
21,14,23,15,20,20,9,14,7,143
21,14,23,15,21,14,4,0,0,112
21,14,23,15,21,14,4,5,4,121
21,14,23,15,22,5,0,0,0,100
21,14,23,15,22,5,14,0,0,114
21,14,23,18,1,16,0,0,0,93
21,14,23,18,1,16,16,5,4,118
21,14,23,18,1,16,16,5,18,132
21,14,23,18,1,16,19,0,0,112
21,14,23,18,5,1,11,5,4,102
21,14,23,18,5,1,11,5,14,112
21,14,23,18,5,1,20,8,5,115
21,14,23,18,5,3,11,5,4,104
21,14,23,18,5,14,3,8,0,106
21,14,23,18,5,19,20,0,0,120
21,14,23,18,5,19,20,5,4,129
21,14,23,18,25,0,0,0,0,101
21,14,23,18,9,14,11,12,5,127
21,14,23,18,9,20,0,0,0,105
21,14,23,18,9,20,5,0,0,110
21,14,23,18,9,20,9,14,7,135
21,14,23,18,9,20,20,5,14,144
21,14,23,18,15,11,5,14,0,121
21,14,23,18,15,14,7,5,4,121
21,14,23,18,15,20,5,0,0,116
21,14,23,18,15,21,7,8,20,147
21,14,23,18,21,14,7,0,0,118
21,14,23,23,15,22,5,0,0,123
21,14,23,23,15,22,5,14,0,137
21,14,26,5,0,0,0,0,0,66
21,14,26,5,1,12,15,21,19,134
21,14,26,5,14,0,0,0,0,80
21,14,26,9,16,0,0,0,0,86
21,14,26,9,16,16,5,4,0,111
21,14,26,9,16,16,9,14,7,132
21,14,26,9,16,19,0,0,0,105
21,14,26,15,14,5,0,0,0,95
21,14,26,15,14,5,4,0,0,99
21,14,26,15,14,9,14,7,0,120
21,15,21,19,0,0,0,0,0,76
21,16,2,1,25,0,0,0,0,65
21,16,2,1,14,4,0,0,0,58
21,16,2,1,14,11,0,0,0,65
21,16,2,1,18,0,0,0,0,58
21,16,2,2,15,18,5,0,0,79
21,16,2,2,15,18,14,5,0,93
21,16,2,5,1,18,0,0,0,63
21,16,2,5,1,18,5,18,0,86
21,16,2,5,1,18,5,18,19,105
21,16,2,5,1,18,9,14,7,93
21,16,2,5,1,18,19,0,0,82
21,16,2,5,1,20,0,0,0,65
21,16,2,5,1,20,19,0,0,84
21,16,2,5,12,3,8,0,0,67
21,16,2,5,12,20,0,0,0,76
21,16,2,5,14,4,0,0,0,62
21,16,2,25,0,0,0,0,0,64
21,16,2,9,4,0,0,0,0,52
21,16,2,25,5,0,0,0,0,69
21,16,2,9,14,4,0,0,0,66
21,16,2,9,14,4,9,14,7,96
21,16,2,9,14,4,19,0,0,85
21,16,2,12,1,3,11,5,14,85
21,16,2,12,1,19,20,0,0,91
21,16,2,12,1,26,5,0,0,83
21,16,2,12,15,23,0,0,0,89
21,16,2,15,9,12,0,0,0,75
21,16,2,15,9,12,5,4,0,84
21,16,2,15,9,12,9,14,7,105
21,16,2,15,9,12,19,0,0,94
21,16,2,15,12,19,20,5,18,128
21,16,2,15,12,20,0,0,0,86
21,16,2,15,15,19,20,0,0,108
21,16,2,15,18,5,0,0,0,77
21,16,2,15,18,14,5,0,0,91
21,16,2,15,20,3,8,0,0,85
21,16,2,15,21,14,4,0,0,93
21,16,2,15,23,0,0,0,0,77
21,16,2,15,23,19,0,0,0,96
21,16,2,18,1,3,5,0,0,66
21,16,2,18,1,25,0,0,0,83
21,16,2,18,1,9,4,0,0,71
21,16,2,18,1,9,4,5,4,80
21,16,2,18,1,9,4,5,18,94
21,16,2,18,1,9,4,19,0,90
21,16,2,18,1,19,20,0,0,97
21,16,2,18,5,1,11,0,0,74
21,16,2,18,5,1,20,8,5,96
21,16,2,18,5,4,0,0,0,66
21,16,2,18,5,5,4,0,0,71
21,16,2,18,5,5,26,5,0,98
21,16,2,18,9,13,0,0,0,79
21,16,2,18,9,14,7,0,0,87
21,16,2,18,9,19,20,12,5,122
21,16,2,18,15,11,5,14,0,102
21,16,2,18,15,15,11,0,0,98
21,16,2,18,15,21,7,8,20,128
21,16,2,18,15,23,0,0,0,95
21,16,2,21,2,2,12,5,0,81
21,16,2,21,25,0,0,0,0,85
21,16,2,21,9,12,4,0,0,85
21,16,2,21,9,12,4,5,18,108
21,16,2,21,9,12,4,19,0,104
21,16,2,21,9,12,20,0,0,101
21,16,2,21,12,7,9,14,7,109
21,16,2,21,15,25,0,0,0,100
21,16,2,21,15,25,9,14,7,130
21,16,2,21,18,14,0,0,0,92
21,16,2,21,18,19,20,0,0,117
21,16,3,1,12,12,0,0,0,65
21,16,3,1,14,1,12,0,0,68
21,16,3,1,14,25,15,14,0,109
21,16,3,1,18,4,0,0,0,63
21,16,3,1,18,18,25,0,0,102
21,16,3,1,19,20,0,0,0,80
21,16,3,1,19,20,5,4,0,89
21,16,3,1,19,20,9,14,7,110
21,16,3,1,19,20,19,0,0,99
21,16,3,1,20,3,8,0,0,72
21,16,3,1,21,7,8,20,0,97
21,16,3,8,1,13,2,5,18,87
21,16,3,8,1,14,14,5,12,94
21,16,3,8,1,18,9,15,20,111
21,16,3,8,1,21,14,3,5,92
21,16,3,8,5,5,18,0,0,76
21,16,3,8,9,13,14,5,25,114
21,16,3,8,15,11,5,0,0,79
21,16,3,8,21,3,11,0,0,83
21,16,3,8,21,3,11,5,4,92
21,16,3,8,21,3,11,19,0,102
21,16,3,9,20,25,0,0,0,94
21,16,3,12,9,13,2,0,0,76
21,16,3,12,9,13,2,5,4,85
21,16,3,12,9,13,2,5,18,99
21,16,3,12,9,13,2,19,0,95
21,16,3,12,15,19,5,0,0,91
21,16,3,12,15,19,5,18,0,109
21,16,3,15,1,19,20,0,0,95
21,16,3,15,3,11,0,0,0,69
21,16,3,15,9,12,0,0,0,76
21,16,3,15,9,12,5,4,0,85
21,16,3,15,9,12,9,14,7,106
21,16,3,15,9,12,19,0,0,95
21,16,3,15,12,21,13,14,0,115
21,16,3,15,13,5,0,0,0,73
21,16,3,15,13,9,14,7,0,98
21,16,3,15,14,10,21,18,5,123
21,16,3,15,21,14,20,18,25,153
21,16,3,15,21,18,19,5,0,118
21,16,3,15,22,5,18,0,0,100
21,16,3,18,1,14,5,0,0,78
21,16,3,18,1,23,12,0,0,94
21,16,3,18,5,5,11,0,0,79
21,16,3,18,5,5,16,0,0,84
21,16,3,18,25,0,0,0,0,83
21,16,3,18,15,16,0,0,0,89
21,16,3,18,15,23,4,0,0,100
21,16,3,21,18,12,0,0,0,91
21,16,3,21,18,12,5,4,0,100
21,16,3,21,18,12,9,14,7,121
21,16,3,21,18,12,19,0,0,110
21,16,3,21,18,18,5,14,20,136
21,16,3,21,18,22,5,0,0,106
21,16,3,21,18,22,5,4,0,110
21,16,3,21,18,22,5,19,0,125
21,16,3,21,18,22,9,14,7,131
21,16,3,21,19,8,9,15,14,126
21,16,3,21,20,0,0,0,0,81
21,16,3,21,20,20,9,14,7,131
21,16,4,1,18,20,0,0,0,80
21,16,4,1,18,20,5,4,0,89
21,16,4,1,18,20,9,14,7,110
21,16,4,1,18,20,19,0,0,99
21,16,4,1,20,1,2,12,5,82
21,16,4,1,20,5,0,0,0,67
21,16,4,1,20,5,4,0,0,71
21,16,4,1,20,5,18,0,0,85
21,16,4,1,20,5,18,19,0,104
21,16,4,1,20,5,19,0,0,86
21,16,4,1,20,9,14,7,0,92
21,16,4,5,3,11,0,0,0,60
21,16,4,5,12,22,5,0,0,85
21,16,4,9,22,5,0,0,0,77
21,16,4,9,22,5,4,0,0,81
21,16,4,9,22,5,19,0,0,96
21,16,4,9,22,9,14,7,0,102
21,16,4,15,0,0,0,0,0,56
21,16,4,15,13,5,0,0,0,74
21,16,4,15,19,0,0,0,0,75
21,16,4,15,22,5,0,0,0,83
21,16,4,18,1,6,20,0,0,86
21,16,4,18,1,6,20,19,0,105
21,16,4,18,1,7,0,0,0,67
21,16,4,18,1,21,7,8,20,116
21,16,4,18,1,23,0,0,0,83
21,16,4,18,5,19,19,0,0,102
21,16,4,18,25,0,0,0,0,84
21,16,4,18,9,5,4,0,0,77
21,16,4,18,9,5,19,0,0,92
21,16,4,18,25,9,14,7,0,114
21,16,4,18,9,14,11,0,0,93
21,16,5,1,20,0,0,0,0,63
21,16,5,25,7,1,14,0,0,89
21,16,5,14,4,0,0,0,0,60
21,16,5,14,4,5,4,0,0,69
21,16,5,14,4,9,14,7,0,90
21,16,5,14,4,19,0,0,0,79
21,16,5,18,9,26,5,0,0,100
21,16,6,5,5,4,0,0,0,57
21,16,6,9,5,12,4,0,0,73
21,16,6,9,12,12,0,0,0,76
21,16,6,12,1,13,5,0,0,74
21,16,6,12,1,18,5,0,0,79
21,16,6,12,1,19,8,0,0,83
21,16,6,12,5,5,0,0,0,65
21,16,6,12,25,0,0,0,0,80
21,16,6,12,9,3,11,5,18,101
21,16,6,12,9,14,7,0,0,85
21,16,6,12,9,14,7,19,0,104
21,16,6,12,15,1,20,0,0,91
21,16,6,12,15,15,4,0,0,89
21,16,6,12,15,23,0,0,0,93
21,16,6,12,15,23,5,4,0,102
21,16,6,12,15,23,5,18,0,116
21,16,6,12,15,23,9,14,7,123
21,16,6,12,15,23,19,0,0,112
21,16,6,12,21,14,7,0,0,97
21,16,6,15,12,4,0,0,0,74
21,16,6,15,12,4,5,4,0,83
21,16,6,15,12,4,9,14,7,104
21,16,6,15,12,4,19,0,0,93
21,16,6,15,12,12,15,23,0,120
21,16,6,18,1,13,5,0,0,80
21,16,6,18,15,14,20,0,0,110
21,16,6,21,18,12,0,0,0,94
21,16,7,1,12,5,0,0,0,62
21,16,7,1,14,7,0,0,0,66
21,16,7,1,16,5,0,0,0,66
21,16,7,1,20,8,5,18,0,96
21,16,7,1,20,8,5,18,19,115
21,16,7,1,26,5,0,0,0,76
21,16,7,1,26,5,4,0,0,80
21,16,7,1,26,5,19,0,0,95
21,16,7,1,26,9,14,7,0,101
21,16,7,5,20,0,0,0,0,69
21,16,7,9,18,4,0,0,0,75
21,16,7,9,18,4,5,4,0,84
21,16,7,9,18,4,9,14,7,105
21,16,7,9,18,4,19,0,0,94
21,16,7,9,18,20,0,0,0,91
21,16,7,9,22,5,0,0,0,80
21,16,7,12,5,1,14,0,0,76
21,16,7,12,9,4,5,0,0,74
21,16,7,15,0,0,0,0,0,59
21,16,7,15,9,14,7,0,0,89
21,16,7,15,18,7,5,0,0,89
21,16,7,18,1,4,5,0,0,72
21,16,7,18,1,4,5,4,0,76
21,16,7,18,1,4,5,18,0,90
21,16,7,18,1,4,5,19,0,91
21,16,7,18,1,4,9,14,7,97
21,16,7,18,1,22,5,0,0,90
21,16,7,18,5,23,0,0,0,90
21,16,7,18,15,23,0,0,0,100
21,16,7,18,15,23,9,14,7,130
21,16,7,18,15,23,14,0,0,114
21,16,7,18,15,23,19,0,0,119
21,16,7,18,15,23,20,8,0,128
21,16,7,18,15,23,20,8,19,147
21,16,7,21,12,12,25,0,0,114
21,16,7,21,19,8,0,0,0,92
21,16,8,1,12,5,0,0,0,63
21,16,8,1,14,4,0,0,0,64
21,16,8,1,14,7,0,0,0,67
21,16,8,1,18,2,15,18,0,99
21,16,8,1,18,18,15,23,0,120
21,16,8,1,18,19,9,14,0,106
21,16,8,1,19,16,0,0,0,81
21,16,8,5,1,12,0,0,0,63
21,16,8,5,1,16,0,0,0,67
21,16,8,5,1,16,5,4,0,76
21,16,8,5,1,16,9,14,7,97
21,16,8,5,1,16,19,0,0,86
21,16,8,5,1,18,20,5,4,98
21,16,8,5,1,22,1,12,0,86
21,16,8,5,1,22,1,12,19,105
21,16,8,5,1,22,5,0,0,78
21,16,8,5,1,22,5,4,0,82
21,16,8,5,1,22,5,14,0,92
21,16,8,5,1,22,5,18,0,96
21,16,8,5,1,22,5,18,19,115
21,16,8,5,1,22,5,19,0,97
21,16,8,5,1,22,9,14,7,103
21,16,8,5,12,4,0,0,0,66
21,16,8,5,12,25,1,0,0,88
21,16,8,5,12,13,0,0,0,75
21,16,8,5,18,0,0,0,0,68
21,16,8,8,15,22,5,0,0,95
21,16,8,9,12,12,0,0,0,78
21,16,8,9,12,12,19,0,0,97
21,16,8,15,1,18,4,0,0,83
21,16,8,15,1,18,4,5,4,92
21,16,8,15,1,18,4,19,0,102
21,16,8,15,9,19,20,0,0,108
21,16,8,15,12,4,0,0,0,76
21,16,8,15,12,4,5,14,0,95
21,16,8,15,12,4,5,18,0,99
21,16,8,15,12,4,5,18,19,118
21,16,8,15,12,4,9,14,7,106
21,16,8,15,12,4,19,0,0,95
21,16,8,15,12,19,20,5,18,134
21,16,8,15,22,5,0,0,0,87
21,16,8,18,15,5,0,0,0,83
21,16,8,18,15,5,19,0,0,102
21,16,8,21,14,7,0,0,0,87
21,16,8,21,18,12,0,0,0,96
21,16,25,1,18,4,0,0,0,85
21,16,25,15,11,5,0,0,0,93
21,16,9,19,12,1,14,4,0,96
21,16,10,5,18,11,0,0,0,81
21,16,10,5,20,0,0,0,0,72
21,16,11,5,5,16,0,0,0,74
21,16,11,5,5,16,19,0,0,93
21,16,11,9,14,4,12,5,0,92
21,16,11,14,5,12,12,0,0,91
21,16,11,14,9,20,0,0,0,91
21,16,12,1,0,0,0,0,0,50
21,16,12,1,4,4,5,18,0,81
21,16,12,1,25,0,0,0,0,75
21,16,12,1,9,4,0,0,0,63
21,16,12,1,11,5,0,0,0,66
21,16,12,1,14,4,5,18,0,91
21,16,12,1,14,4,5,18,19,110
21,16,12,1,14,4,9,19,8,104
21,16,12,1,14,4,19,0,0,87
21,16,12,1,14,5,0,0,0,69
21,16,12,5,1,4,0,0,0,59
21,16,12,5,1,14,0,0,0,69
21,16,12,5,1,16,0,0,0,71
21,16,12,5,1,16,5,4,0,80
21,16,12,5,1,16,9,14,7,101
21,16,12,5,1,16,19,0,0,90
21,16,12,5,1,16,20,0,0,91
21,16,12,5,7,0,0,0,0,61
21,16,12,9,3,11,0,0,0,72
21,16,12,9,6,20,0,0,0,84
21,16,12,9,6,20,5,4,0,93
21,16,12,9,6,20,5,18,0,107
21,16,12,9,6,20,5,18,19,126
21,16,12,9,6,20,9,14,7,114
21,16,12,9,6,20,19,0,0,103
21,16,12,9,7,8,20,0,0,93
21,16,12,9,7,8,20,5,4,102
21,16,12,9,7,8,20,19,0,112
21,16,12,25,9,14,7,0,0,104
21,16,12,9,13,2,0,0,0,73
21,16,12,9,13,2,5,18,0,96
21,16,12,9,14,5,0,0,0,77
21,16,12,9,14,11,0,0,0,83
21,16,12,9,14,11,5,4,0,92
21,16,12,9,14,11,9,14,7,113
21,16,12,9,14,11,19,0,0,102
21,16,12,9,20,0,0,0,0,78
21,16,12,15,1,4,0,0,0,69
21,16,12,15,1,4,5,4,0,78
21,16,12,15,1,4,9,14,7,99
21,16,12,15,1,4,19,0,0,88
21,16,12,15,3,11,0,0,0,78
21,16,12,15,14,7,0,0,0,85
21,16,12,15,15,11,0,0,0,90
21,16,12,15,15,11,5,18,0,113
21,16,12,15,15,13,0,0,0,92
21,16,12,15,15,16,0,0,0,95
21,16,13,1,11,9,14,7,0,92
21,16,13,1,14,19,8,9,16,117
21,16,13,1,18,11,5,20,0,105
21,16,13,1,19,20,0,0,0,90
21,16,13,9,24,0,0,0,0,83
21,16,13,15,19,20,0,0,0,104
21,16,13,15,21,14,20,0,0,120
21,16,13,15,22,5,0,0,0,92
21,16,14,5,19,19,0,0,0,94
21,16,15,0,0,0,0,0,0,52
21,16,15,14,0,0,0,0,0,66
21,16,16,1,18,4,0,0,0,76
21,16,16,2,1,4,0,0,0,60
21,16,16,5,4,0,0,0,0,62
21,16,16,5,14,20,0,0,0,92
21,16,16,5,18,0,0,0,0,76
21,16,16,5,18,3,1,19,5,104
21,16,16,5,18,3,8,0,0,87
21,16,16,5,18,3,21,20,0,120
21,16,16,5,18,3,21,20,19,139
21,16,16,5,18,5,18,0,0,99
21,16,16,5,18,5,19,20,0,120
21,16,16,5,18,13,15,18,5,127
21,16,16,5,18,13,15,19,20,143
21,16,16,5,18,16,1,18,20,131
21,16,16,5,18,19,0,0,0,95
21,16,16,9,12,5,0,0,0,79
21,16,16,9,12,5,4,0,0,83
21,16,16,9,12,5,19,0,0,98
21,16,16,9,12,9,14,7,0,104
21,16,16,9,14,7,0,0,0,83
21,16,16,9,14,7,19,0,0,102
21,16,16,9,19,8,0,0,0,89
21,16,16,9,19,8,12,25,0,126
21,16,16,9,20,25,0,0,0,107
21,16,16,12,15,21,7,8,0,116
21,16,16,12,15,23,0,0,0,103
21,16,16,12,21,3,11,0,0,100
21,16,16,15,9,14,20,0,0,111
21,16,16,15,9,19,5,0,0,101
21,16,16,15,16,0,0,0,0,84
21,16,16,15,21,18,0,0,0,107
21,16,16,15,23,15,3,0,0,109
21,16,16,18,9,3,11,0,0,94
21,16,16,18,15,16,0,0,0,102
21,16,16,18,15,16,16,5,4,127
21,16,16,18,15,16,19,0,0,121
21,16,16,21,6,6,0,0,0,86
21,16,16,21,12,12,0,0,0,98
21,16,16,21,19,8,0,0,0,101
21,16,17,21,9,22,5,18,0,129
21,16,18,1,9,19,1,12,0,97
21,16,18,1,9,19,5,0,0,89
21,16,18,1,9,19,5,4,0,93
21,16,18,1,9,19,5,18,0,107
21,16,18,1,9,19,5,18,19,126
21,16,18,1,9,19,5,19,0,108
21,16,18,1,9,19,9,14,7,114
21,16,18,1,21,7,8,20,0,112
21,16,18,5,1,3,8,0,0,72
21,16,18,5,1,3,8,5,4,81
21,16,18,5,1,3,8,5,19,96
21,16,18,5,1,18,0,0,0,79
21,16,18,5,1,18,5,4,0,88
21,16,18,5,1,18,9,14,7,109
21,16,18,5,1,18,19,0,0,98
21,16,18,5,9,14,0,0,0,83
21,16,18,5,14,4,0,0,0,78
21,16,18,5,14,4,5,18,0,101
21,16,18,5,19,20,0,0,0,99
21,16,18,5,19,20,15,18,5,137
21,16,18,9,4,0,0,0,0,68
21,16,18,9,4,7,5,0,0,80
21,16,18,9,7,8,20,0,0,99
21,16,18,9,7,8,20,5,4,108
21,16,18,9,7,8,20,12,25,136
21,16,18,9,7,8,20,19,0,118
21,16,18,9,16,0,0,0,0,80
21,16,18,9,19,1,12,0,0,96
21,16,18,9,19,5,0,0,0,88
21,16,18,9,19,5,14,0,0,102
21,16,18,9,19,5,18,0,0,106
21,16,18,9,19,5,18,19,0,125
21,16,18,9,19,5,19,0,0,107
21,16,18,9,19,9,14,7,0,113
21,16,18,9,19,9,14,7,19,132
21,16,18,9,19,20,0,0,0,103
21,16,18,9,22,5,0,0,0,91
21,16,18,9,22,5,18,0,0,109
21,16,18,9,22,5,18,19,0,128
21,16,18,15,1,4,0,0,0,75
21,16,18,15,1,18,0,0,0,89
21,16,18,15,1,18,5,18,0,112
21,16,18,15,1,18,19,0,0,108
21,16,18,15,15,13,0,0,0,98
21,16,18,15,15,20,0,0,0,105
21,16,18,15,15,20,1,12,0,118
21,16,18,15,15,20,1,12,19,137
21,16,18,15,15,20,5,4,0,114
21,16,18,15,15,20,5,18,0,128
21,16,18,15,15,20,5,18,19,147
21,16,18,15,15,20,9,14,7,135
21,16,18,15,15,20,19,0,0,124
21,16,18,15,19,5,0,0,0,94
21,16,18,15,21,19,5,0,0,115
21,16,18,15,21,19,5,4,0,119
21,16,18,15,21,19,5,19,0,134
21,16,18,15,21,19,9,14,7,140
21,16,18,15,21,20,5,0,0,116
21,16,18,21,14,0,0,0,0,90
21,16,18,21,19,8,0,0,0,103
21,16,18,21,19,8,5,4,0,112
21,16,18,21,19,8,5,19,0,127
21,16,18,21,19,8,9,14,7,133
21,16,19,1,4,1,9,19,25,115
21,16,19,1,4,4,12,5,0,82
21,16,19,3,1,12,5,0,0,77
21,16,19,3,18,5,23,0,0,105
21,16,19,3,21,4,4,12,5,105
21,16,19,5,1,12,0,0,0,74
21,16,19,5,4,15,21,14,0,115
21,16,19,5,5,11,0,0,0,77
21,16,19,5,25,0,0,0,0,86
21,16,19,5,9,26,5,0,0,101
21,16,19,5,14,4,0,0,0,79
21,16,19,5,14,4,9,14,7,109
21,16,19,5,14,4,19,0,0,98
21,16,19,5,14,20,0,0,0,95
21,16,19,5,20,0,0,0,0,81
21,16,19,5,20,13,5,14,20,133
21,16,19,5,20,19,0,0,0,100
21,16,19,5,20,20,1,12,0,114
21,16,19,5,20,20,5,4,0,110
21,16,19,5,20,20,5,18,0,124
21,16,19,5,20,20,5,18,19,143
21,16,19,5,20,20,9,14,7,131
21,16,19,8,1,6,20,0,0,91
21,16,19,8,5,1,18,0,0,88
21,16,19,8,5,1,20,8,0,98
21,16,19,8,9,6,20,0,0,99
21,16,19,8,9,6,20,5,4,108
21,16,19,8,9,6,20,19,0,118
21,16,19,8,15,15,20,0,0,114
21,16,19,8,15,15,20,19,0,133
21,16,19,8,15,18,5,0,0,102
21,16,19,8,15,20,0,0,0,99
21,16,19,8,15,20,19,0,0,118
21,16,19,8,15,22,5,0,0,106
21,16,19,8,21,20,0,0,0,105
21,16,19,25,0,0,0,0,0,81
21,16,19,9,4,1,9,19,25,123
21,16,19,9,4,5,0,0,0,74
21,16,19,9,4,5,19,0,0,93
21,16,19,9,7,8,20,5,4,109
21,16,19,9,12,15,9,4,0,105
21,16,19,9,12,15,14,0,0,106
21,16,19,9,12,15,14,19,0,125
21,16,19,9,20,0,0,0,0,85
21,16,19,9,20,20,5,14,0,124
21,16,19,9,20,20,9,14,7,135
21,16,19,11,9,16,0,0,0,92
21,16,19,12,1,14,20,0,0,103
21,16,19,12,9,16,0,0,0,93
21,16,19,12,15,16,5,0,0,104
21,16,19,12,15,16,9,14,7,129
21,16,19,13,9,20,5,0,0,103
21,16,19,14,1,20,3,8,0,102
21,16,19,15,1,11,0,0,0,83
21,16,19,15,1,18,0,0,0,90
21,16,19,15,1,18,5,4,0,99
21,16,19,15,1,18,9,14,7,120
21,16,19,15,1,18,19,0,0,109
21,16,19,15,12,22,5,0,0,110
21,16,19,16,5,1,11,0,0,89
21,16,19,16,5,1,18,0,0,96
21,16,19,16,5,5,4,0,0,86
21,16,19,16,5,23,0,0,0,100
21,16,19,16,9,14,0,0,0,95
21,16,19,16,9,18,5,0,0,104
21,16,19,16,12,1,19,8,0,112
21,16,19,16,15,21,20,0,0,128
21,16,19,16,18,1,14,7,0,112
21,16,19,16,18,5,1,4,0,100
21,16,19,16,18,9,14,7,0,120
21,16,19,16,18,9,14,7,19,139
21,16,19,16,18,15,21,20,0,146
21,16,19,16,18,21,14,7,0,132
21,16,19,16,21,18,20,0,0,131
21,16,19,18,9,14,7,0,0,104
21,16,19,20,1,6,6,0,0,89
21,16,19,20,1,7,5,0,0,89
21,16,19,20,1,7,5,4,0,93
21,16,19,20,1,7,5,19,0,108
21,16,19,20,1,7,9,14,7,114
21,16,19,20,1,25,0,0,0,102
21,16,19,20,1,9,18,0,0,104
21,16,19,20,1,9,18,19,0,123
21,16,19,20,1,13,16,0,0,106
21,16,19,20,1,14,4,0,0,95
21,16,19,20,1,14,4,5,18,118
21,16,19,20,1,14,4,19,0,114
21,16,19,20,1,18,5,0,0,100
21,16,19,20,1,18,5,4,0,104
21,16,19,20,1,18,5,19,0,119
21,16,19,20,1,18,9,14,7,125
21,16,19,20,1,18,20,0,0,115
21,16,19,20,1,18,20,5,4,124
21,16,19,20,1,18,20,12,5,132
21,16,19,20,1,18,20,19,0,134
21,16,19,20,1,20,5,0,0,102
21,16,19,20,1,20,5,18,0,120
21,16,19,20,1,20,5,18,19,139
21,16,19,20,1,20,5,19,0,121
21,16,19,20,1,21,14,3,8,123
21,16,19,20,5,1,12,0,0,94
21,16,19,20,5,1,13,0,0,95
21,16,19,20,5,13,0,0,0,94
21,16,19,20,5,16,0,0,0,97
21,16,19,20,5,16,16,5,4,122
21,16,19,20,5,16,19,0,0,116
21,16,19,20,9,3,11,0,0,99
21,16,19,20,9,18,0,0,0,103
21,16,19,20,9,18,18,5,4,130
21,16,19,20,9,18,19,0,0,122
21,16,19,20,15,15,4,0,0,110
21,16,19,20,18,5,1,13,0,113
21,16,19,20,18,5,5,20,0,124
21,16,19,20,18,5,20,3,8,130
21,16,19,20,18,9,11,5,0,119
21,16,19,20,18,9,22,5,0,130
21,16,19,20,18,15,11,5,0,125
21,16,19,20,18,15,11,5,19,144
21,16,19,21,3,11,0,0,0,91
21,16,19,21,14,0,0,0,0,91
21,16,19,21,16,0,0,0,0,93
21,16,19,21,18,7,5,0,0,107
21,16,19,21,18,7,5,4,0,111
21,16,19,21,18,7,5,19,0,126
21,16,19,21,18,7,9,14,7,132
21,16,19,23,1,25,0,0,0,105
21,16,19,23,1,12,12,15,23,142
21,16,19,23,1,18,13,0,0,111
21,16,19,23,5,5,16,0,0,105
21,16,19,23,5,5,16,19,0,124
21,16,19,23,5,12,12,0,0,108
21,16,19,23,5,12,12,5,4,117
21,16,19,23,5,12,12,19,0,127
21,16,19,23,5,16,20,0,0,120
21,16,19,23,9,14,7,0,0,109
21,16,19,23,9,14,7,19,0,128
21,16,19,23,15,12,12,5,14,137
21,16,19,23,21,14,7,0,0,121
21,16,20,1,2,12,5,0,0,77
21,16,20,1,11,5,0,0,0,74
21,16,20,1,11,5,18,0,0,92
21,16,20,1,11,5,19,0,0,93
21,16,20,5,1,18,0,0,0,81
21,16,20,5,1,18,9,14,7,111
21,16,20,5,1,18,19,0,0,100
21,16,20,5,13,16,5,18,0,114
21,16,20,5,14,4,0,0,0,80
21,16,20,8,18,5,23,0,0,111
21,16,20,8,18,15,23,0,0,121
21,16,20,8,18,15,23,14,0,135
21,16,20,8,18,15,23,19,0,140
21,16,20,8,18,21,19,20,0,143
21,16,20,8,18,21,19,20,19,162
21,16,20,8,21,14,4,5,18,127
21,16,20,9,3,11,0,0,0,80
21,16,20,9,3,11,19,0,0,99
21,16,20,9,4,5,0,0,0,75
21,16,20,9,5,0,0,0,0,71
21,16,20,9,7,8,20,0,0,101
21,16,20,9,12,12,0,0,0,90
21,16,20,9,12,20,0,0,0,98
21,16,20,9,12,20,5,4,0,107
21,16,20,9,12,20,9,14,7,128
21,16,20,9,12,20,19,0,0,117
21,16,20,9,13,5,0,0,0,84
21,16,20,9,13,5,19,0,0,103
21,16,20,15,18,5,0,0,0,95
21,16,20,15,18,14,0,0,0,104
21,16,20,15,19,19,0,0,0,110
21,16,20,15,19,19,5,4,0,119
21,16,20,15,19,19,5,19,0,134
21,16,20,15,19,19,9,14,7,140
21,16,20,15,23,5,18,0,0,118
21,16,20,15,23,14,0,0,0,109
21,16,20,15,23,14,5,18,0,132
21,16,20,15,23,14,5,18,19,151
21,16,20,15,23,14,19,0,0,128
21,16,20,18,1,3,5,0,0,84
21,16,20,18,1,3,11,0,0,90
21,16,20,18,1,9,12,0,0,97
21,16,20,18,1,9,14,0,0,99
21,16,20,18,5,5,0,0,0,85
21,16,20,18,5,14,4,0,0,98
21,16,20,18,5,14,4,19,0,117
21,16,20,18,9,12,12,0,0,108
21,16,20,18,21,14,11,0,0,121
21,16,20,18,21,19,19,0,0,134
21,16,20,20,15,18,5,0,0,115
21,16,20,20,15,18,14,0,0,124
21,16,20,21,2,5,0,0,0,85
21,16,20,21,3,11,0,0,0,92
21,16,20,21,18,14,0,0,0,110
21,16,20,21,18,14,5,4,0,119
21,16,20,21,18,14,9,14,7,140
21,16,20,21,18,14,19,0,0,129
21,16,20,23,9,14,5,4,0,112
21,16,20,23,9,19,20,0,0,128
21,16,21,16,15,9,4,0,0,102
21,16,22,1,12,12,5,25,0,114
21,16,22,15,13,9,20,0,0,116
21,16,23,1,6,20,0,0,0,87
21,16,23,1,6,20,5,4,0,96
21,16,23,1,6,20,9,14,7,117
21,16,23,1,6,20,19,0,0,106
21,16,23,1,25,0,0,0,0,86
21,16,23,1,25,19,0,0,0,105
21,16,23,1,12,12,0,0,0,85
21,16,23,1,18,4,0,0,0,83
21,16,23,1,18,4,12,25,0,120
21,16,23,1,18,4,19,0,0,102
21,16,23,1,18,16,0,0,0,95
21,16,23,1,24,0,0,0,0,85
21,16,23,5,12,12,0,0,0,89
21,16,23,5,12,12,5,4,0,98
21,16,23,5,12,12,9,14,7,119
21,16,23,5,12,12,19,0,0,108
21,16,23,5,14,20,0,0,0,99
21,16,23,8,5,5,12,0,0,90
21,16,23,8,5,12,13,0,0,98
21,16,23,8,9,18,0,0,0,95
21,16,23,8,9,18,12,0,0,107
21,16,23,9,14,4,0,0,0,87
21,16,23,9,14,4,19,0,0,106
21,16,23,9,20,8,0,0,0,97
21,16,23,15,18,11,0,0,0,104
21,16,23,15,21,14,4,0,0,114
21,16,23,18,1,16,0,0,0,95
21,16,23,18,5,1,20,8,5,117
21,16,23,18,5,14,3,8,0,108
21,16,23,18,9,14,7,0,0,108
21,16,23,18,15,21,7,8,20,149
21,18,2,0,0,0,0,0,0,41
21,18,2,1,3,9,20,25,0,99
21,18,2,1,9,14,9,20,5,99
21,18,2,1,14,5,0,0,0,61
21,18,2,1,14,5,12,25,0,98
21,18,2,1,14,5,18,0,0,79
21,18,2,1,14,5,19,20,0,100
21,18,2,1,14,9,19,5,0,89
21,18,2,1,14,9,19,5,4,93
21,18,2,1,14,9,19,5,19,108
21,18,2,1,14,9,19,13,0,97
21,18,2,1,14,9,19,13,19,116
21,18,2,1,14,9,19,20,19,123
21,18,2,1,14,9,20,5,0,90
21,18,2,1,14,9,20,5,19,109
21,18,2,1,14,9,20,25,0,110
21,18,2,1,14,9,26,5,0,96
21,18,2,1,14,9,26,5,4,100
21,18,2,1,14,9,26,5,19,115
21,18,2,1,18,9,1,12,0,82
21,18,2,9,1,0,0,0,0,51
21,18,2,9,1,14,0,0,0,65
21,18,2,9,1,19,0,0,0,70
21,18,2,9,3,0,0,0,0,53
21,18,2,9,6,25,0,0,0,81
21,18,2,9,14,1,20,5,0,90
21,18,2,19,0,0,0,0,0,60
21,18,3,5,9,6,15,18,13,108
21,18,3,5,15,12,1,18,0,93
21,18,3,5,15,12,1,20,5,100
21,18,3,5,15,12,5,0,0,79
21,18,3,5,15,12,9,0,0,83
21,18,3,5,15,12,21,19,0,114
21,18,3,5,21,19,0,0,0,87
21,18,3,8,9,14,0,0,0,73
21,18,3,8,9,14,5,19,19,116
21,18,3,8,9,14,12,25,0,110
21,18,3,8,9,14,19,0,0,92
21,18,4,5,0,0,0,0,0,48
21,18,4,5,5,0,0,0,0,53
21,18,4,25,0,0,0,0,0,68
21,18,4,19,0,0,0,0,0,62
21,18,5,0,0,0,0,0,0,44
21,18,5,1,0,0,0,0,0,45
21,18,5,1,12,0,0,0,0,57
21,18,5,1,13,5,20,5,18,106
21,18,5,1,13,5,20,18,25,126
21,18,5,1,19,0,0,0,0,64
21,18,5,1,19,5,0,0,0,69
21,18,5,1,19,5,19,0,0,88
21,18,5,3,8,9,20,9,14,107
21,18,5,4,5,13,1,0,0,67
21,18,5,4,9,1,0,0,0,58
21,18,5,4,9,1,12,0,0,70
21,18,5,4,9,4,9,1,0,71
21,18,5,4,9,14,5,0,0,76
21,18,5,4,9,14,5,1,12,89
21,18,5,4,9,14,5,19,0,95
21,18,5,4,9,14,9,1,0,81
21,18,5,4,9,14,9,1,12,93
21,18,5,4,9,14,9,21,13,114
21,18,5,4,9,14,15,9,4,99
21,18,5,4,9,14,15,21,19,126
21,18,5,4,9,21,13,0,0,91
21,18,5,4,15,19,0,0,0,82
21,18,5,9,3,0,0,0,0,56
21,18,5,9,4,0,0,0,0,57
21,18,5,9,4,5,0,0,0,62
21,18,5,9,4,5,19,0,0,81
21,18,5,9,4,15,0,0,0,72
21,18,5,25,12,5,14,5,0,105
21,18,5,13,9,1,0,0,0,67
21,18,5,13,9,1,19,0,0,86
21,18,5,13,9,3,0,0,0,69
21,18,5,14,20,0,0,0,0,78
21,18,5,15,13,5,20,5,18,120
21,18,5,15,13,5,20,18,25,140
21,18,5,15,20,5,12,9,3,108
21,18,5,19,9,19,0,0,0,91
21,18,5,20,0,0,0,0,0,64
21,18,5,20,1,12,0,0,0,77
21,18,5,20,5,18,0,0,0,87
21,18,5,20,5,18,1,12,0,100
21,18,5,20,5,18,9,3,0,99
21,18,5,20,5,18,19,0,0,106
21,18,5,20,8,1,14,0,0,87
21,18,5,20,8,1,14,5,0,92
21,18,5,20,8,1,14,5,19,111
21,18,5,20,8,1,14,19,0,106
21,18,5,20,8,25,12,1,14,124
21,18,5,20,8,18,1,0,0,91
21,18,5,20,8,18,1,5,0,96
21,18,5,20,8,18,1,12,0,103
21,18,5,20,8,18,1,19,0,110
21,18,5,20,8,18,9,19,13,131
21,18,5,20,9,3,0,0,0,76
21,18,6,0,0,0,0,0,0,45
21,18,6,9,18,14,9,19,0,114
21,18,7,5,0,0,0,0,0,51
21,18,7,5,4,0,0,0,0,55
21,18,7,5,6,21,12,0,0,90
21,18,7,5,14,3,5,0,0,73
21,18,7,5,14,3,25,0,0,93
21,18,7,5,14,3,9,5,19,101
21,18,7,5,14,20,0,0,0,85
21,18,7,5,14,20,12,25,0,122
21,18,7,5,18,0,0,0,0,69
21,18,7,5,18,19,0,0,0,88
21,18,7,5,19,0,0,0,0,70
21,18,7,25,0,0,0,0,0,71
21,18,7,9,14,7,0,0,0,76
21,18,7,9,14,7,12,25,0,113
21,18,7,9,14,7,19,0,0,95
21,18,8,5,5,14,0,0,0,71
21,18,9,1,0,0,0,0,0,49
21,18,9,1,12,19,0,0,0,80
21,18,9,3,0,0,0,0,0,51
21,18,9,3,1,5,13,9,1,80
21,18,9,3,1,5,13,9,3,82
21,18,9,3,5,13,9,1,0,79
21,18,9,3,5,13,9,3,0,81
21,18,9,3,15,14,9,1,14,104
21,18,9,4,9,14,5,0,0,80
21,18,9,4,9,14,5,19,0,99
21,18,9,4,18,15,19,9,19,132
21,18,9,5,14,20,0,0,0,87
21,18,9,13,0,0,0,0,0,61
21,18,9,14,1,5,13,9,1,91
21,18,9,14,1,5,13,9,3,93
21,18,9,14,1,12,0,0,0,75
21,18,9,14,1,12,9,19,20,123
21,18,9,14,1,12,19,0,0,94
21,18,9,14,1,14,20,0,0,97
21,18,9,14,1,18,25,0,0,106
21,18,9,14,1,18,9,5,19,114
21,18,9,14,1,18,9,21,13,124
21,18,9,14,1,20,5,0,0,88
21,18,9,14,1,20,5,4,0,92
21,18,9,14,1,20,5,19,0,107
21,18,9,14,1,20,9,14,7,113
21,18,9,14,1,20,9,15,14,121
21,18,9,14,1,20,9,22,5,119
21,18,9,14,1,20,15,18,0,116
21,18,9,14,5,0,0,0,0,67
21,18,9,14,5,13,9,1,0,90
21,18,9,14,5,13,9,1,19,109
21,18,9,14,5,13,9,3,0,92
21,18,9,14,5,19,0,0,0,86
21,18,9,14,15,12,15,7,25,136
21,18,9,14,15,19,5,0,0,101
21,18,9,14,15,21,19,0,0,117
21,18,9,20,5,0,0,0,0,73
21,18,12,1,18,0,0,0,0,70
21,18,12,5,4,0,0,0,0,60
21,18,12,9,14,7,0,0,0,81
21,18,12,21,3,8,0,0,0,83
21,18,13,1,14,0,0,0,0,67
21,18,14,0,0,0,0,0,0,53
21,18,14,1,0,0,0,0,0,54
21,18,14,1,5,0,0,0,0,59
21,18,14,1,12,0,0,0,0,66
21,18,14,6,9,5,12,4,0,89
21,18,14,6,12,15,23,5,18,132
21,18,14,6,21,12,0,0,0,92
21,18,14,6,21,12,19,0,0,111
21,18,14,9,14,7,0,0,0,83
21,18,14,9,14,7,9,19,13,124
21,18,14,9,19,13,0,0,0,94
21,18,14,12,9,11,5,0,0,90
21,18,14,13,1,11,5,18,0,101
21,18,14,19,0,0,0,0,0,72
21,18,15,2,9,12,9,14,0,100
21,18,15,3,1,14,9,3,0,84
21,18,15,3,5,12,5,0,0,79
21,18,15,3,5,18,9,4,0,93
21,18,15,3,8,15,18,4,0,102
21,18,15,3,8,15,18,4,19,121
21,18,15,3,8,18,15,13,5,116
21,18,15,3,8,19,0,0,0,84
21,18,15,3,25,19,20,0,0,121
21,18,15,3,25,19,20,9,3,133
21,18,15,4,1,5,21,13,0,98
21,18,15,4,5,12,1,14,0,90
21,18,15,4,5,12,5,0,0,80
21,18,15,4,5,12,5,19,0,99
21,18,15,4,5,12,15,21,19,130
21,18,15,4,25,14,9,1,0,107
21,18,15,5,4,5,13,1,0,82
21,18,15,7,1,19,20,5,18,124
21,18,15,7,5,14,9,3,0,92
21,18,15,7,5,14,15,21,19,135
21,18,15,7,15,13,16,8,9,122
21,18,15,7,18,1,13,0,0,93
21,18,15,7,18,1,16,8,25,129
21,18,15,8,25,1,12,0,0,100
21,18,15,11,9,14,1,19,5,113
21,18,15,12,0,0,0,0,0,66
21,18,15,12,1,7,14,9,1,98
21,18,15,12,5,21,3,9,3,107
21,18,15,12,9,20,8,0,0,103
21,18,15,12,9,20,8,9,3,115
21,18,15,12,9,20,8,19,0,122
21,18,15,12,25,20,9,3,0,123
21,18,15,12,15,7,25,0,0,113
21,18,15,12,15,7,9,3,0,100
21,18,15,12,15,7,9,5,19,121
21,18,15,12,15,7,9,19,20,136
21,18,15,12,21,20,5,9,14,135
21,18,15,13,1,14,3,25,0,110
21,18,15,13,1,14,20,9,1,112
21,18,15,13,5,12,21,19,0,124
21,18,15,13,5,18,5,0,0,95
21,18,15,13,5,18,9,3,0,102
21,18,15,13,5,20,5,18,0,115
21,18,15,14,9,3,0,0,0,80
21,18,15,14,15,12,15,7,25,142
21,18,15,15,0,0,0,0,0,69
21,18,15,15,4,1,12,0,0,86
21,18,15,16,8,1,5,9,14,107
21,18,15,16,8,1,14,9,3,105
21,18,15,16,8,5,9,14,0,106
21,18,15,16,8,9,0,0,0,87
21,18,15,16,8,15,2,9,1,105
21,18,15,16,25,7,9,1,0,112
21,18,15,16,25,7,9,1,12,124
21,18,15,16,25,7,9,21,13,145
21,18,15,16,12,1,14,9,1,107
21,18,15,16,15,4,0,0,0,89
21,18,15,16,15,4,1,12,0,102
21,18,15,16,15,4,15,21,19,144
21,18,15,16,15,4,19,0,0,108
21,18,15,16,15,5,20,9,3,122
21,18,15,16,19,9,12,5,0,115
21,18,15,16,20,25,19,9,19,162
21,18,15,18,15,19,5,9,14,134
21,18,15,18,18,8,5,1,0,104
21,18,15,18,21,2,9,14,0,118
21,18,15,19,1,3,18,1,12,108
21,18,15,19,3,15,16,25,0,132
21,18,15,19,3,15,16,9,3,119
21,18,15,19,5,16,19,9,19,141
21,18,15,19,5,16,20,9,3,126
21,18,15,19,9,19,0,0,0,101
21,18,15,19,15,13,5,0,0,106
21,18,15,19,15,13,9,20,5,135
21,18,15,19,20,5,1,0,0,99
21,18,15,19,20,5,7,1,12,118
21,18,15,19,20,5,7,5,0,110
21,18,15,19,20,5,15,14,0,127
21,18,15,19,20,8,5,14,5,125
21,18,15,19,20,25,12,1,18,149
21,18,15,19,20,25,12,5,0,135
21,18,15,19,20,25,12,5,19,154
21,18,15,20,15,24,25,0,0,138
21,18,15,20,15,24,9,1,0,123
21,18,15,20,15,24,9,3,0,125
21,18,15,20,15,24,9,5,19,146
21,18,15,20,15,24,9,14,0,136
21,18,15,21,19,0,0,0,0,94
21,18,15,24,1,14,1,20,5,119
21,18,15,24,1,14,9,3,0,105
21,18,15,24,9,14,0,0,0,101
21,18,16,18,9,19,5,18,0,124
21,18,18,1,4,8,21,19,0,110
21,18,18,8,15,4,9,14,0,107
21,18,19,0,0,0,0,0,0,58
21,18,19,1,5,0,0,0,0,64
21,18,19,9,3,9,4,1,12,96
21,18,19,9,3,9,4,5,0,88
21,18,19,9,6,15,18,13,0,119
21,18,19,9,7,18,1,13,0,106
21,18,19,9,14,5,0,0,0,86
21,18,19,15,9,4,0,0,0,86
21,18,19,15,12,9,3,0,0,97
21,18,19,15,14,5,0,0,0,92
21,18,19,21,11,0,0,0,0,90
21,18,20,5,24,20,19,0,0,127
21,18,20,9,3,1,12,0,0,84
21,18,20,9,3,1,14,20,0,106
21,18,20,9,3,1,14,20,19,125
21,18,20,9,3,1,18,9,1,100
21,18,20,9,3,1,20,5,0,97
21,18,20,9,3,1,20,5,4,101
21,18,20,9,3,1,20,5,19,116
21,18,20,9,3,15,19,5,0,110
21,18,20,9,20,5,0,0,0,93
21,18,21,2,21,0,0,0,0,83
21,18,21,3,21,0,0,0,0,84
21,18,21,3,21,13,0,0,0,97
21,18,21,3,21,18,9,0,0,111
21,18,21,3,21,18,25,0,0,127
21,18,21,9,19,7,0,0,0,95
21,18,21,14,4,1,25,0,0,104
21,18,21,19,0,0,0,0,0,79
21,18,21,19,5,19,0,0,0,103
21,18,21,19,8,9,0,0,0,96
21,18,21,19,8,9,3,0,0,99
21,18,21,19,8,9,25,5,0,126
21,18,21,19,8,9,14,9,3,122
21,18,21,19,8,9,15,12,0,123
21,18,21,19,8,9,15,12,19,142
21,18,21,20,21,0,0,0,0,101
21,18,22,1,0,0,0,0,0,62
21,19,5,1,2,12,5,0,0,65
21,19,5,1,2,12,25,0,0,85
21,19,5,4,0,0,0,0,0,49
21,19,5,4,12,25,0,0,0,86
21,19,5,4,14,5,19,19,0,106
21,19,5,4,14,20,0,0,0,83
21,19,5,5,0,0,0,0,0,50
21,19,5,6,21,12,0,0,0,84
21,19,5,6,21,12,12,25,0,121
21,19,5,8,15,12,4,0,0,84
21,19,5,12,5,19,19,0,0,100
21,19,5,12,5,19,19,12,25,137
21,19,5,14,5,20,0,0,0,84
21,19,5,14,20,0,0,0,0,79
21,19,5,18,0,0,0,0,0,63
21,19,5,18,19,0,0,0,0,82
21,19,8,0,0,0,0,0,0,48
21,19,8,1,2,20,9,0,0,80
21,19,8,1,2,20,9,19,0,99
21,19,8,1,2,20,9,21,0,101
21,19,8,5,18,1,14,3,5,94
21,19,8,5,18,4,15,13,0,103
21,19,8,5,18,5,4,0,0,80
21,19,8,5,18,5,18,0,0,94
21,19,8,5,18,5,19,19,0,114
21,19,8,5,18,5,20,20,5,121
21,19,8,5,18,9,14,7,0,101
21,19,8,5,18,9,19,13,0,112
21,19,8,5,18,12,5,19,19,126
21,19,8,5,18,19,0,0,0,90
21,19,8,5,18,19,8,9,16,123
21,19,9,14,5,0,0,0,0,68
21,19,9,14,7,0,0,0,0,70
21,19,9,14,7,19,0,0,0,89
21,19,9,20,1,20,5,0,0,95
21,19,9,20,1,20,9,22,5,126
21,19,14,5,1,19,0,0,0,79
21,19,14,5,15,9,4,0,0,87
21,19,14,9,3,0,0,0,0,66
21,19,14,9,14,0,0,0,0,77
21,19,14,9,14,9,3,0,0,89
21,19,16,5,1,11,9,14,7,103
21,19,16,15,11,5,0,0,0,87
21,19,16,15,11,5,14,0,0,101
21,19,17,21,1,2,1,5,0,87
21,19,17,21,1,2,1,5,19,106
21,19,17,21,5,0,0,0,0,83
21,19,17,21,5,2,1,5,0,91
21,19,17,21,5,2,1,5,19,110
21,19,17,21,5,19,0,0,0,102
21,19,19,5,12,6,0,0,0,82
21,19,19,5,12,19,0,0,0,95
21,19,19,5,12,22,5,14,0,117
21,19,19,9,14,7,9,20,5,123
21,19,20,0,0,0,0,0,0,60
21,19,20,5,18,0,0,0,0,83
21,19,20,9,15,14,0,0,0,98
21,19,20,15,18,9,15,21,19,157
21,19,20,21,12,1,20,5,0,119
21,19,21,0,0,0,0,0,0,61
21,19,21,1,12,0,0,0,0,74
21,19,21,1,12,9,19,13,0,115
21,19,21,1,12,12,25,0,0,111
21,19,21,1,12,14,5,19,19,131
21,19,21,1,12,19,0,0,0,93
21,19,21,1,18,25,0,0,0,105
21,19,21,3,1,16,9,15,14,119
21,19,21,3,1,16,20,0,0,101
21,19,21,3,1,16,20,15,18,134
21,19,21,6,18,21,3,20,0,129
21,19,21,6,18,21,3,20,19,148
21,19,21,6,18,21,9,20,0,135
21,19,21,18,5,0,0,0,0,84
21,19,21,18,5,18,0,0,0,102
21,19,21,18,5,18,19,0,0,121
21,19,21,18,5,19,19,0,0,122
21,19,21,18,25,0,0,0,0,104
21,19,21,18,9,5,19,0,0,112
21,19,21,18,9,15,21,19,0,143
21,19,21,18,16,0,0,0,0,95
21,19,21,18,16,5,4,0,0,104
21,19,21,18,16,5,4,12,25,141
21,19,21,18,16,5,18,0,0,118
21,19,21,18,16,5,18,19,0,137
21,19,21,18,16,9,14,7,0,125
21,19,21,18,16,13,5,14,20,147
21,19,21,18,16,15,18,0,0,128
21,19,21,18,16,18,5,19,19,156
21,19,21,18,16,19,0,0,0,114
21,19,21,18,16,20,9,15,14,153
21,19,23,1,18,4,0,0,0,86
21,19,23,1,18,4,19,0,0,105
21,20,3,8,0,0,0,0,0,52
21,20,3,8,25,0,0,0,0,77
21,20,5,5,19,0,0,0,0,70
21,20,5,14,4,0,0,0,0,64
21,20,5,14,19,9,12,0,0,100
21,20,5,14,19,9,12,5,0,105
21,20,5,14,19,9,12,19,0,119
21,20,5,18,1,12,7,9,1,94
21,20,5,18,9,0,0,0,0,73
21,20,5,18,9,14,5,0,0,92
21,20,5,18,9,20,9,19,0,121
21,20,5,18,15,0,0,0,0,79
21,20,5,18,15,3,5,12,5,104
21,20,5,18,15,7,18,1,13,118
21,20,5,18,15,12,9,20,8,128
21,20,5,18,15,12,15,7,25,138
21,20,5,18,15,16,5,24,25,149
21,20,5,18,15,20,15,13,25,152
21,20,5,18,21,19,0,0,0,104
21,20,5,18,21,19,5,19,0,128
21,20,9,0,0,0,0,0,0,50
21,20,9,2,12,5,0,0,0,69
21,20,9,3,11,0,0,0,0,64
21,20,9,12,0,0,0,0,0,62
21,20,9,12,5,0,0,0,0,67
21,20,9,12,9,4,15,18,0,108
21,20,9,12,9,4,15,18,19,127
21,20,9,12,9,19,5,0,0,95
21,20,9,12,9,19,5,4,0,99
21,20,9,12,9,19,5,18,0,113
21,20,9,12,9,19,5,18,19,132
21,20,9,12,9,19,5,19,0,114
21,20,9,12,9,19,9,14,7,120
21,20,9,12,9,20,25,0,0,116
21,20,9,12,9,20,9,5,19,124
21,20,9,12,9,26,5,0,0,102
21,20,9,12,9,26,5,4,0,106
21,20,9,12,9,26,5,18,0,120
21,20,9,12,9,26,5,18,19,139
21,20,9,12,9,26,5,19,0,121
21,20,9,12,9,26,9,14,7,127
21,20,9,14,1,13,0,0,0,78
21,20,12,1,7,1,18,25,0,105
21,20,12,9,12,9,26,5,4,118
21,20,13,15,19,20,0,0,0,108
21,20,13,15,19,20,19,0,0,127
21,20,15,16,9,1,14,19,0,115
21,20,15,16,9,1,19,0,0,101
21,20,15,16,9,1,19,20,0,121
21,20,15,16,9,19,13,0,0,113
21,20,15,16,9,19,13,19,0,132
21,20,15,16,9,19,20,0,0,120
21,20,15,16,9,19,20,9,3,132
21,20,15,16,9,19,20,19,0,139
21,20,18,9,3,12,5,0,0,88
21,20,18,9,3,12,5,19,0,107
21,20,18,9,3,21,12,0,0,104
21,20,18,9,3,21,12,1,18,123
21,20,18,9,3,21,12,9,0,113
21,20,18,9,3,21,12,21,19,144
21,20,18,9,6,15,18,13,0,120
21,20,18,21,2,9,0,0,0,91
21,20,18,21,13,0,0,0,0,93
21,20,19,0,0,0,0,0,0,60
21,20,19,21,11,0,0,0,0,92
21,20,20,5,18,1,2,12,5,104
21,20,20,5,18,1,14,3,5,107
21,20,20,5,18,1,14,3,25,127
21,20,20,5,18,5,4,0,0,93
21,20,20,5,18,5,18,0,0,107
21,20,20,5,18,5,18,19,0,126
21,20,20,5,18,5,19,20,0,128
21,20,20,5,18,9,14,7,0,114
21,20,20,5,18,12,5,19,19,139
21,20,20,5,18,12,25,0,0,121
21,20,20,5,18,13,15,19,20,151
21,20,20,5,18,14,5,19,19,141
21,20,20,5,18,19,0,0,0,103
21,20,21,13,0,0,0,0,0,75
21,20,21,18,21,14,3,21,0,139
21,21,3,16,14,5,20,0,0,100
21,22,5,1,0,0,0,0,0,49
21,22,5,1,12,0,0,0,0,61
21,22,5,1,19,0,0,0,0,68
21,22,5,9,20,9,3,0,0,89
21,22,5,9,20,9,19,0,0,105
21,22,5,9,20,9,19,5,19,129
21,22,5,15,21,19,0,0,0,103
21,22,9,3,0,0,0,0,0,55
21,22,9,4,0,0,0,0,0,56
21,22,9,15,12,0,0,0,0,79
21,22,9,20,9,3,0,0,0,84
21,22,9,20,9,14,9,3,0,107
21,22,9,20,15,0,0,0,0,87
21,22,9,20,15,14,9,3,0,113
21,22,18,5,0,0,0,0,0,66
21,22,18,5,19,0,0,0,0,85
21,22,18,15,21,0,0,0,0,97
21,22,21,12,1,0,0,0,0,77
21,22,21,12,1,5,0,0,0,82
21,22,21,12,1,18,0,0,0,95
21,22,21,12,1,18,12,25,0,132
21,22,21,12,1,18,19,0,0,114
21,22,21,12,1,19,0,0,0,96
21,22,21,12,1,20,15,13,25,150
21,22,21,12,9,20,9,19,0,133
21,22,21,12,15,20,15,13,5,144
21,22,21,12,15,20,15,13,25,164
21,22,22,5,18,0,0,0,0,88
21,24,15,18,9,1,12,0,0,100
21,24,15,18,9,1,12,12,25,137
21,24,15,18,9,3,9,4,5,108
21,24,15,18,9,15,21,19,0,142
21,24,15,18,9,19,0,0,0,106
22,5,3,20,9,7,1,12,0,79
22,5,3,20,9,15,14,0,0,88
22,5,3,20,9,19,0,0,0,78
22,5,3,20,15,18,0,0,0,83
22,5,3,20,15,18,5,4,0,92
22,5,3,20,15,18,9,1,12,105
22,5,3,20,15,18,9,14,7,113
22,5,3,20,15,18,19,0,0,102
22,5,3,20,21,18,5,0,0,94
22,5,4,1,12,9,1,19,0,73
22,5,4,1,14,1,0,0,0,47
22,5,4,5,20,0,0,0,0,56
22,5,4,5,20,20,5,19,0,100
22,5,4,9,11,1,0,0,0,52
22,5,4,18,15,0,0,0,0,64
22,5,5,10,1,25,0,0,0,68
22,5,5,10,1,25,19,0,0,87
22,5,5,14,0,0,0,0,0,46
22,5,5,14,1,0,0,0,0,47
22,5,5,14,1,19,0,0,0,66
22,5,5,16,0,0,0,0,0,48
22,5,5,16,5,5,0,0,0,58
22,5,5,16,5,5,19,0,0,77
22,5,5,16,19,0,0,0,0,67
22,5,5,18,0,0,0,0,0,50
22,5,5,18,1,2,12,5,0,70
22,5,5,18,5,4,0,0,0,59
22,5,5,18,25,0,0,0,0,75
22,5,5,18,9,5,19,0,0,83
22,5,5,18,9,14,7,0,0,80
22,5,5,18,9,14,7,12,25,117
22,5,5,18,19,0,0,0,0,69
22,5,5,19,0,0,0,0,0,51
22,5,6,18,25,0,0,0,0,76
22,5,7,0,0,0,0,0,0,34
22,5,7,1,14,0,0,0,0,49
22,5,7,1,14,9,19,13,0,90
22,5,7,1,14,9,19,13,19,109
22,5,7,1,14,19,0,0,0,68
22,5,7,1,19,0,0,0,0,54
22,5,7,1,19,9,20,5,0,88
22,5,7,5,20,1,2,12,5,79
22,5,7,5,20,1,2,12,25,99
22,5,7,5,20,1,12,0,0,72
22,5,7,5,20,1,14,20,0,94
22,5,7,5,20,1,20,5,0,85
22,5,7,5,20,1,20,5,4,89
22,5,7,5,20,1,20,5,19,104
22,5,7,5,20,5,0,0,0,64
22,5,7,5,20,9,19,13,0,100
22,5,7,5,20,9,19,20,0,107
22,5,7,5,20,9,19,20,19,126
22,5,7,5,20,9,22,5,0,95
22,5,7,5,20,15,21,19,0,114
22,5,7,7,9,5,0,0,0,55
22,5,7,7,9,5,19,0,0,74
22,5,7,9,5,0,0,0,0,48
22,5,7,9,5,19,0,0,0,67
22,5,8,5,13,5,14,3,5,80
22,5,8,5,13,5,14,3,25,100
22,5,8,5,13,5,14,20,0,92
22,5,8,9,3,12,5,0,0,64
22,5,8,9,3,12,5,19,0,83
22,5,8,9,3,21,12,1,0,81
22,5,8,9,3,21,12,1,18,99
22,5,8,9,3,21,12,21,13,114
22,5,8,13,5,0,0,0,0,53
22,5,9,0,0,0,0,0,0,36
22,5,9,7,12,5,0,0,0,60
22,5,9,12,0,0,0,0,0,48
22,5,9,12,5,4,0,0,0,57
22,5,9,12,5,4,12,25,0,94
22,5,9,12,5,18,0,0,0,71
22,5,9,12,5,18,19,0,0,90
22,5,9,12,25,0,0,0,0,73
22,5,9,12,9,14,7,0,0,78
22,5,9,12,9,14,7,19,0,97
22,5,9,12,12,5,19,19,0,103
22,5,9,12,12,5,21,19,5,110
22,5,9,12,12,9,11,5,0,85
22,5,9,12,13,1,11,5,18,96
22,5,9,12,19,0,0,0,0,67
22,5,9,14,0,0,0,0,0,50
22,5,9,14,1,7,5,0,0,63
22,5,9,14,1,12,0,0,0,63
22,5,9,14,5,4,0,0,0,59
22,5,9,14,5,18,0,0,0,73
22,5,9,14,5,18,25,0,0,98
22,5,9,14,5,18,19,0,0,92
22,5,9,14,25,0,0,0,0,75
22,5,9,14,9,5,18,0,0,82
22,5,9,14,9,5,19,20,0,103
22,5,9,14,9,14,5,19,19,116
22,5,9,14,9,14,7,0,0,80
22,5,9,14,9,14,7,19,0,99
22,5,9,14,12,5,19,19,0,105
22,5,9,14,12,5,20,0,0,87
22,5,9,14,12,5,20,19,0,106
22,5,9,14,12,9,11,5,0,87
22,5,9,14,15,21,19,0,0,105
22,5,9,14,19,0,0,0,0,69
22,5,9,14,19,20,15,14,5,123
22,5,9,14,19,20,21,6,6,122
22,5,9,14,21,12,5,0,0,88
22,5,9,14,21,12,5,19,0,107
22,5,9,14,21,12,5,20,0,108
22,5,9,14,21,12,5,20,19,127
22,5,9,14,23,9,19,5,0,106
22,5,9,14,23,15,18,11,0,117
22,5,12,0,0,0,0,0,0,39
22,5,12,1,12,0,0,0,0,52
22,5,12,1,13,5,14,0,0,72
22,5,12,1,13,9,14,1,0,77
22,5,12,1,18,0,0,0,0,58
22,5,12,1,18,25,0,0,0,83
22,5,12,1,18,9,1,0,0,68
22,5,12,1,18,9,3,0,0,70
22,5,12,1,18,9,21,13,0,101
22,5,12,1,18,9,26,5,0,98
22,5,12,1,18,9,26,5,4,102
22,5,12,1,18,9,26,5,19,117
22,5,12,1,18,19,0,0,0,77
22,5,12,1,20,5,0,0,0,65
22,5,12,1,20,5,4,0,0,69
22,5,12,1,20,9,14,7,0,90
22,5,12,1,20,9,15,14,0,98
22,5,12,1,20,21,18,1,0,100
22,5,12,4,0,0,0,0,0,43
22,5,12,4,3,18,1,6,20,91
22,5,12,4,13,1,14,0,0,71
22,5,12,4,19,0,0,0,0,62
22,5,12,4,19,11,15,5,14,107
22,5,12,4,20,0,0,0,0,63
22,5,12,4,20,19,0,0,0,82
22,5,12,4,20,19,13,1,14,110
22,5,12,5,20,1,0,0,0,65
22,5,12,25,1,18,4,5,0,92
22,5,12,9,3,0,0,0,0,51
22,5,12,9,3,1,20,5,0,77
22,5,12,9,6,15,18,13,0,100
22,5,12,9,7,5,18,0,0,78
22,5,12,9,7,5,18,19,0,97
22,5,12,9,20,5,19,0,0,92
22,5,12,12,0,0,0,0,0,51
22,5,12,12,1,12,1,0,0,65
22,5,12,12,5,4,1,0,0,61
22,5,12,12,5,9,20,25,0,110
22,5,12,12,9,3,1,20,5,89
22,5,12,12,9,14,3,8,0,85
22,5,12,12,15,14,0,0,0,80
22,5,12,12,15,19,9,14,0,108
22,5,12,12,15,19,9,14,5,113
22,5,12,12,21,13,0,0,0,85
22,5,12,12,21,13,25,0,0,110
22,5,12,12,21,13,19,0,0,104
22,5,12,12,21,20,5,0,0,97
22,5,12,15,0,0,0,0,0,54
22,5,12,15,3,5,0,0,0,62
22,5,12,15,3,9,13,1,14,94
22,5,12,15,3,9,15,21,19,121
22,5,12,15,3,9,20,25,0,111
22,5,12,15,4,18,15,13,5,109
22,5,12,15,13,5,20,5,18,115
22,5,12,15,21,18,0,0,0,93
22,5,12,15,21,18,19,0,0,112
22,5,12,15,21,20,0,0,0,95
22,5,12,15,21,20,5,0,0,100
22,5,12,15,21,20,5,19,0,119
22,5,12,15,21,20,9,14,5,123
22,5,12,20,5,0,0,0,0,64
22,5,12,20,6,1,18,5,0,89
22,5,12,21,13,0,0,0,0,73
22,5,12,21,13,5,14,0,0,92
22,5,12,21,13,9,14,1,0,97
22,5,12,21,14,7,5,0,0,86
22,5,12,21,18,5,0,0,0,83
22,5,12,21,18,5,4,0,0,87
22,5,12,21,18,5,19,0,0,102
22,5,12,21,18,9,14,7,0,108
22,5,12,22,5,18,5,20,0,109
22,5,12,22,5,18,5,20,19,128
22,5,12,22,5,20,5,4,0,95
22,5,12,22,5,20,5,5,14,110
22,5,12,22,5,20,25,0,0,111
22,5,12,22,5,20,9,14,7,116
22,5,12,22,5,20,18,25,0,129
22,5,12,22,5,20,19,0,0,105
22,5,14,1,4,1,0,0,0,47
22,5,14,1,5,0,0,0,0,47
22,5,14,1,12,0,0,0,0,54
22,5,14,1,12,9,20,25,0,108
22,5,14,1,12,9,26,5,0,94
22,5,14,1,12,12,25,0,0,91
22,5,14,1,12,14,5,19,19,111
22,5,14,1,14,26,9,20,5,116
22,5,14,1,20,9,3,0,0,74
22,5,14,1,20,9,3,1,12,87
22,5,14,1,20,9,15,14,0,100
22,5,14,1,20,9,15,14,19,119
22,5,14,1,20,15,18,25,0,120
22,5,14,3,15,12,1,0,0,72
22,5,14,4,1,2,12,5,0,65
22,5,14,4,1,3,5,0,0,54
22,5,14,4,1,3,5,19,0,73
22,5,14,4,1,7,5,0,0,58
22,5,14,4,1,22,1,12,0,81
22,5,14,4,5,4,0,0,0,54
22,5,14,4,5,5,19,0,0,74
22,5,14,4,5,18,0,0,0,68
22,5,14,4,5,18,19,0,0,87
22,5,14,4,5,20,20,1,0,91
22,5,14,4,5,20,20,1,19,110
22,5,14,4,5,21,19,5,0,95
22,5,14,4,9,2,12,5,0,73
22,5,14,4,9,2,12,5,19,92
22,5,14,4,9,2,12,25,0,93
22,5,14,4,9,3,1,20,5,83
22,5,14,4,9,14,7,0,0,75
22,5,14,4,9,19,0,0,0,73
22,5,14,4,9,20,1,20,5,100
22,5,14,4,9,20,9,15,14,112
22,5,14,4,9,20,15,18,0,107
22,5,14,4,15,18,0,0,0,78
22,5,14,4,15,18,19,0,0,97
22,5,14,4,19,0,0,0,0,64
22,5,14,4,21,5,0,0,0,71
22,5,14,4,21,5,19,0,0,90
22,5,14,5,3,20,15,13,25,122
22,5,14,5,5,18,0,0,0,69
22,5,14,5,5,18,5,4,0,78
22,5,14,5,5,18,5,18,0,92
22,5,14,5,5,18,5,18,19,111
22,5,14,5,5,18,9,14,7,99
22,5,14,5,5,18,19,0,0,88
22,5,14,5,6,9,3,0,0,64
22,5,14,5,6,9,3,1,12,77
22,5,14,5,6,9,3,5,0,69
22,5,14,5,13,15,21,19,0,114
22,5,14,5,14,1,20,5,0,86
22,5,14,5,14,1,20,5,4,90
22,5,14,5,14,1,20,5,19,105
22,5,14,5,14,5,0,0,0,65
22,5,14,5,14,9,6,9,3,87
22,5,14,5,14,15,19,5,0,99
22,5,14,5,14,15,19,9,0,103
22,5,14,5,14,15,19,21,19,134
22,5,14,5,14,15,21,19,0,115
22,5,14,5,18,1,2,12,5,84
22,5,14,5,18,1,2,12,25,104
22,5,14,5,18,1,12,0,0,77
22,5,14,5,18,1,14,3,5,87
22,5,14,5,18,1,14,20,0,99
22,5,14,5,18,1,20,5,0,90
22,5,14,5,18,1,20,5,4,94
22,5,14,5,18,1,20,5,19,109
22,5,14,5,18,1,20,15,18,118
22,5,14,5,18,5,0,0,0,69
22,5,14,5,18,5,1,12,0,82
22,5,14,5,18,5,1,14,0,84
22,5,14,5,18,5,15,21,19,124
22,5,14,5,18,5,18,0,0,87
22,5,14,5,18,25,0,0,0,89
22,5,14,5,18,9,1,12,0,86
22,5,14,5,18,9,1,14,0,88
22,5,14,5,18,9,5,19,0,97
22,5,14,5,18,9,19,0,0,92
22,5,14,5,18,15,0,0,0,79
22,5,14,5,18,15,19,0,0,98
22,5,14,5,18,15,21,19,0,119
22,5,14,5,19,5,3,20,0,93
22,5,14,5,19,9,1,0,0,75
22,5,14,5,20,9,1,14,19,109
22,5,14,5,21,18,0,0,0,85
22,5,14,7,5,0,0,0,0,53
22,5,14,7,5,1,2,12,5,73
22,5,14,7,5,1,14,3,5,76
22,5,14,7,5,1,14,20,0,88
22,5,14,7,5,4,0,0,0,57
22,5,14,7,5,6,21,12,0,92
22,5,14,7,5,18,0,0,0,71
22,5,14,7,5,19,0,0,0,72
22,5,14,7,9,14,7,0,0,78
22,5,14,25,0,0,0,0,0,66
22,5,14,9,1,2,12,5,0,70
22,5,14,9,1,12,0,0,0,63
22,5,14,9,1,12,9,20,25,117
22,5,14,9,1,12,12,25,0,100
22,5,14,9,1,13,0,0,0,64
22,5,14,9,5,0,0,0,0,55
22,5,14,9,14,0,0,0,0,64
22,5,14,9,14,5,0,0,0,69
22,5,14,9,14,5,19,0,0,88
22,5,14,9,14,19,0,0,0,83
22,5,14,9,16,12,5,24,0,107
22,5,14,9,18,5,0,0,0,73
22,5,14,9,18,5,13,1,14,101
22,5,14,9,18,5,13,5,14,105
22,5,14,9,18,5,19,0,0,92
22,5,14,9,19,5,0,0,0,74
22,5,14,9,19,15,14,0,0,98
22,5,14,9,19,15,14,19,0,117
22,5,14,11,1,20,1,0,0,74
22,5,14,11,9,19,5,14,0,99
22,5,14,12,9,14,0,0,0,76
22,5,14,14,5,12,0,0,0,72
22,5,14,14,5,18,0,0,0,78
22,5,14,15,7,18,1,13,0,95
22,5,14,15,13,0,0,0,0,69
22,5,14,15,13,5,4,0,0,78
22,5,14,15,13,5,18,0,0,92
22,5,14,15,13,5,18,19,0,111
22,5,14,15,13,25,0,0,0,94
22,5,14,15,13,9,14,7,0,99
22,5,14,15,13,9,26,5,0,109
22,5,14,15,13,12,5,19,19,124
22,5,14,15,13,12,25,0,0,106
22,5,14,15,13,14,5,19,19,126
22,5,14,15,13,15,21,19,0,124
22,5,14,15,13,19,0,0,0,88
22,5,14,15,13,19,15,13,5,121
22,5,14,15,19,1,12,0,0,88
22,5,14,15,19,5,0,0,0,80
22,5,14,15,19,9,14,1,12,111
22,5,14,15,19,9,20,25,0,129
22,5,14,15,21,19,0,0,0,96
22,5,14,15,21,19,12,25,0,133
22,5,14,20,1,0,0,0,0,62
22,5,14,20,1,7,5,0,0,74
22,5,14,20,1,7,5,19,0,93
22,5,14,20,1,9,12,0,0,83
22,5,14,20,1,9,12,19,0,102
22,5,14,20,1,14,1,0,0,77
22,5,14,20,5,4,0,0,0,70
22,5,14,20,5,18,0,0,0,84
22,5,14,20,5,18,19,0,0,103
22,5,14,20,8,15,12,5,0,101
22,5,14,20,9,4,21,3,20,118
22,5,14,20,9,6,1,3,20,100
22,5,14,20,9,12,0,0,0,82
22,5,14,20,9,12,1,20,5,108
22,5,14,20,9,14,0,0,0,84
22,5,14,20,9,14,7,0,0,91
22,5,14,20,12,5,19,19,0,116
22,5,14,20,15,25,0,0,0,101
22,5,14,20,15,19,9,20,25,149
22,5,14,20,16,9,5,3,5,99
22,5,14,20,18,1,4,0,0,84
22,5,14,20,18,1,12,0,0,92
22,5,14,20,18,1,12,12,25,129
22,5,14,20,18,1,12,19,0,111
22,5,14,20,18,9,3,0,0,91
22,5,14,20,18,9,3,12,5,108
22,5,14,20,18,9,14,5,0,107
22,5,14,20,18,15,19,5,0,118
22,5,14,20,19,0,0,0,0,80
22,5,14,20,21,18,5,0,0,105
22,5,14,20,21,18,5,4,0,109
22,5,14,20,21,18,5,18,0,123
22,5,14,20,21,18,5,18,19,142
22,5,14,20,21,18,5,19,0,124
22,5,14,20,21,18,9,0,0,109
22,5,14,20,21,18,9,14,5,128
22,5,14,20,21,18,9,14,7,130
22,5,14,20,21,18,9,19,0,128
22,5,14,20,21,18,15,21,19,155
22,5,14,21,5,0,0,0,0,67
22,5,14,21,5,19,0,0,0,86
22,5,14,21,12,1,0,0,0,75
22,5,14,21,12,1,5,0,0,80
22,5,14,21,12,1,18,0,0,93
22,5,14,21,12,5,0,0,0,79
22,5,14,21,12,5,19,0,0,98
22,5,14,21,12,15,19,5,0,113
22,5,14,21,12,15,21,19,0,129
22,5,14,21,19,8,1,9,18,117
22,5,14,21,19,9,1,14,19,124
22,5,14,21,19,20,0,0,0,101
22,5,14,21,19,20,25,0,0,126
22,5,14,22,9,12,12,5,0,101
22,5,18,1,3,9,15,21,19,113
22,5,18,1,3,9,20,25,0,103
22,5,18,1,25,0,0,0,0,71
22,5,18,1,13,5,14,20,0,98
22,5,18,1,14,4,1,0,0,65
22,5,18,1,14,4,1,5,4,74
22,5,18,1,14,4,1,8,0,73
22,5,18,1,14,4,1,8,19,92
22,5,18,1,14,4,1,19,0,84
22,5,18,1,19,3,15,16,5,104
22,5,18,1,20,18,1,12,0,97
22,5,18,1,20,18,1,20,5,110
22,5,18,1,20,18,9,1,0,94
22,5,18,1,20,18,9,1,19,113
22,5,18,1,20,18,9,3,0,96
22,5,18,1,20,18,25,12,0,121
22,5,18,1,20,18,9,14,0,107
22,5,18,1,20,18,9,14,1,108
22,5,18,1,20,18,9,14,5,112
22,5,18,1,20,18,9,14,19,126
22,5,18,1,20,18,9,26,5,124
22,5,18,1,20,18,15,25,12,136
22,5,18,1,20,18,15,12,0,111
22,5,18,1,20,18,15,12,5,116
22,5,18,1,20,18,21,13,19,137
22,5,18,2,0,0,0,0,0,47
22,5,18,2,1,12,0,0,0,60
22,5,18,2,1,12,9,19,5,93
22,5,18,2,1,12,9,19,13,101
22,5,18,2,1,12,9,19,20,108
22,5,18,2,1,12,9,20,25,114
22,5,18,2,1,12,9,26,5,100
22,5,18,2,1,12,12,25,0,97
22,5,18,2,1,12,19,0,0,79
22,5,18,2,1,18,9,1,14,90
22,5,18,2,1,18,9,21,13,109
22,5,18,2,1,19,3,15,0,85
22,5,18,2,1,20,5,0,0,73
22,5,18,2,1,20,9,13,0,90
22,5,18,2,5,14,1,19,0,86
22,5,18,2,5,14,1,20,5,92
22,5,18,2,5,14,5,0,0,71
22,5,18,2,5,14,15,12,0,93
22,5,18,2,5,14,15,14,5,100
22,5,18,2,5,18,1,20,5,96
22,5,18,2,25,0,0,0,0,72
22,5,18,2,9,1,7,5,0,69
22,5,18,2,9,1,7,5,19,88
22,5,18,2,9,3,9,4,5,77
22,5,18,2,9,4,0,0,0,60
22,5,18,2,9,4,19,0,0,79
22,5,18,2,9,6,25,0,0,87
22,5,18,2,9,6,9,5,4,80
22,5,18,2,9,6,9,5,19,95
22,5,18,2,9,12,5,0,0,73
22,5,18,2,9,12,5,19,0,92
22,5,18,2,12,5,19,19,0,102
22,5,18,2,15,19,5,0,0,86
22,5,18,2,15,19,5,12,25,123
22,5,18,2,15,19,9,20,25,135
22,5,18,2,15,20,5,14,0,101
22,5,18,2,15,21,19,0,0,102
22,5,18,2,19,0,0,0,0,66
22,5,18,2,21,13,0,0,0,81
22,5,18,3,8,15,11,0,0,82
22,5,18,4,0,0,0,0,0,49
22,5,18,4,1,14,3,25,0,92
22,5,18,4,1,14,20,0,0,84
22,5,18,4,1,14,20,12,25,121
22,5,18,4,5,1,0,0,0,55
22,5,18,4,5,12,8,15,0,89
22,5,18,4,5,18,5,18,0,95
22,5,18,4,5,18,5,18,19,114
22,5,18,4,5,18,15,18,0,105
22,5,18,4,5,18,15,18,19,124
22,5,18,4,5,20,0,0,0,74
22,5,18,4,5,20,20,15,0,109
22,5,18,4,9,3,20,0,0,81
22,5,18,4,9,3,20,19,0,100
22,5,18,4,9,7,18,9,19,111
22,5,18,4,9,14,0,0,0,72
22,5,18,4,9,14,19,0,0,91
22,5,18,4,9,20,5,0,0,83
22,5,18,4,9,20,5,18,0,101
22,5,18,4,9,20,5,18,19,120
22,5,18,4,15,25,0,0,0,89
22,5,18,4,15,21,18,0,0,103
22,5,18,4,21,7,15,0,0,92
22,5,18,4,21,18,5,0,0,93
22,5,18,4,21,18,5,4,0,97
22,5,18,4,21,18,5,18,0,111
22,5,18,4,21,18,5,19,0,112
22,5,18,4,21,18,15,21,19,143
22,5,18,5,3,21,14,4,0,92
22,5,18,5,4,9,3,20,0,86
22,5,18,5,4,9,3,20,15,101
22,5,18,5,25,0,0,0,0,75
22,5,18,5,11,0,0,0,0,61
22,5,18,5,14,4,1,0,0,69
22,5,18,7,1,12,15,15,0,95
22,5,18,7,5,4,0,0,0,61
22,5,18,7,5,14,3,5,0,79
22,5,18,7,5,14,3,5,19,98
22,5,18,7,5,14,3,25,0,99
22,5,18,7,5,14,20,0,0,91
22,5,18,7,5,18,5,19,19,118
22,5,18,7,5,18,25,0,0,100
22,5,18,7,5,18,9,19,13,116
22,5,18,7,5,18,19,0,0,94
22,5,18,7,5,19,0,0,0,76
22,5,18,7,9,0,0,0,0,61
22,5,18,7,9,6,15,18,13,113
22,5,18,7,9,14,7,0,0,82
22,5,18,7,12,1,19,0,0,84
22,5,18,7,12,1,19,5,19,108
22,5,18,7,15,2,18,5,20,112
22,5,18,7,15,25,14,5,0,111
22,5,18,9,0,0,0,0,0,54
22,5,18,25,0,0,0,0,0,70
22,5,18,9,4,9,3,0,0,70
22,5,18,9,4,9,3,1,12,83
22,5,18,9,4,9,20,25,0,112
22,5,18,9,5,18,0,0,0,77
22,5,18,9,5,19,20,0,0,98
22,5,18,9,6,25,0,0,0,85
22,5,18,9,6,9,5,4,0,78
22,5,18,9,6,9,5,18,0,92
22,5,18,9,6,9,5,18,19,111
22,5,18,9,6,9,5,19,0,93
22,5,18,9,6,25,9,14,7,115
22,5,18,9,12,25,0,0,0,91
22,5,18,9,13,5,14,20,0,106
22,5,18,9,19,3,15,16,5,112
22,5,18,9,19,13,0,0,0,86
22,5,18,9,19,13,15,0,0,101
22,5,18,9,19,13,15,19,0,120
22,5,18,9,19,13,19,0,0,105
22,5,18,9,19,20,0,0,0,93
22,5,18,9,19,20,9,3,0,105
22,5,18,9,19,20,19,0,0,112
22,5,18,9,20,1,2,12,5,94
22,5,18,9,20,1,2,12,25,114
22,5,18,9,20,1,19,0,0,94
22,5,18,9,20,1,20,5,19,119
22,5,18,9,20,5,0,0,0,79
22,5,18,9,20,5,19,0,0,98
22,5,18,9,20,9,5,19,0,107
22,5,18,9,20,9,19,13,0,115
22,5,18,9,20,9,19,20,0,122
22,5,18,10,21,9,3,5,0,93
22,5,18,10,21,9,3,5,4,97
22,5,18,10,21,9,3,5,19,112
22,5,18,12,9,7,20,5,0,98
22,5,18,13,5,9,12,0,0,84
22,5,18,13,5,9,12,19,0,103
22,5,18,13,5,20,9,4,0,96
22,5,18,13,5,20,9,15,0,107
22,5,18,13,9,1,14,0,0,82
22,5,18,13,9,3,9,4,5,88
22,5,18,13,9,3,12,5,0,87
22,5,18,13,9,3,21,12,5,108
22,5,18,13,9,6,15,18,13,119
22,5,18,13,9,6,21,7,5,106
22,5,18,13,9,12,0,0,0,79
22,5,18,13,9,12,25,0,0,104
22,5,18,13,9,12,9,15,14,117
22,5,18,13,9,14,0,0,0,81
22,5,18,13,9,14,1,12,0,94
22,5,18,13,9,14,1,20,5,107
22,5,18,13,9,14,5,18,0,104
22,5,18,13,9,14,25,0,0,106
22,5,18,13,9,14,12,25,0,118
22,5,18,13,9,14,15,21,19,136
22,5,18,13,9,19,0,0,0,86
22,5,18,13,9,24,0,0,0,91
22,5,18,13,15,18,5,12,0,108
22,5,18,13,15,21,12,21,0,127
22,5,18,13,15,21,12,21,5,132
22,5,18,13,15,21,20,8,0,122
22,5,18,13,15,21,20,8,19,141
22,5,18,13,21,20,8,0,0,107
22,5,18,13,21,20,8,19,0,126
22,5,18,14,1,3,12,5,0,80
22,5,18,14,1,3,12,5,19,99
22,5,18,14,1,7,5,0,0,72
22,5,18,14,1,12,9,19,5,105
22,5,18,14,1,12,9,20,25,126
22,5,18,14,1,12,9,26,5,112
22,5,18,14,1,12,12,25,0,109
22,5,18,14,1,14,20,0,0,94
22,5,18,14,1,20,9,15,14,118
22,5,18,14,5,21,11,0,0,96
22,5,18,14,5,21,11,5,18,119
22,5,18,14,9,3,12,5,0,88
22,5,18,14,9,3,12,5,19,107
22,5,18,14,9,3,15,19,5,110
22,5,18,14,9,5,18,19,0,110
22,5,18,14,9,12,5,0,0,85
22,5,18,14,9,12,9,20,25,134
22,5,18,14,9,14,0,0,0,82
22,5,18,14,9,14,5,0,0,87
22,5,18,14,9,20,9,15,14,126
22,5,18,14,9,24,0,0,0,92
22,5,18,14,9,24,5,19,0,116
22,5,18,14,15,14,9,14,0,111
22,5,18,15,14,9,3,1,19,106
22,5,18,17,21,5,18,5,0,111
22,5,18,18,1,25,0,0,0,89
22,5,18,18,5,0,0,0,0,68
22,5,18,18,5,12,0,0,0,80
22,5,18,18,5,12,12,0,0,92
22,5,18,18,25,0,0,0,0,88
22,5,18,18,9,3,21,12,5,113
22,5,18,18,9,5,18,5,0,100
22,5,18,18,21,3,1,0,0,88
22,5,18,18,21,3,1,5,0,93
22,5,18,18,21,3,1,14,15,117
22,5,18,18,21,3,15,19,5,126
22,5,18,18,21,3,15,21,19,142
22,5,18,18,21,7,1,0,0,92
22,5,18,18,21,7,1,19,0,111
22,5,18,19,0,0,0,0,0,64
22,5,18,19,1,0,0,0,0,65
22,5,18,19,1,2,12,5,0,84
22,5,18,19,1,12,0,0,0,77
22,5,18,19,1,14,20,0,0,99
22,5,18,19,1,14,20,19,0,118
22,5,18,19,1,20,5,0,0,90
22,5,18,19,1,20,5,3,0,93
22,5,18,19,1,20,9,12,5,111
22,5,18,19,1,20,9,15,14,123
22,5,18,19,1,20,9,22,5,121
22,5,18,19,5,0,0,0,0,69
22,5,18,19,5,4,0,0,0,73
22,5,18,19,5,12,5,19,19,124
22,5,18,19,5,12,5,20,0,106
22,5,18,19,5,13,1,14,0,97
22,5,18,19,5,13,5,14,0,101
22,5,18,19,5,18,0,0,0,87
22,5,18,19,5,18,19,0,0,106
22,5,18,19,5,19,0,0,0,88
22,5,18,19,5,20,0,0,0,89
22,5,18,19,5,20,19,0,0,108
22,5,18,19,5,20,20,5,0,114
22,5,18,19,5,23,1,18,4,115
22,5,18,19,9,3,12,5,0,93
22,5,18,19,9,3,12,5,18,111
22,5,18,19,9,3,12,5,19,112
22,5,18,19,9,3,21,12,5,114
22,5,18,19,9,3,21,12,9,118
22,5,18,19,9,5,18,1,0,97
22,5,18,19,9,6,25,0,0,104
22,5,18,19,9,6,9,5,4,97
22,5,18,19,9,6,9,5,18,111
22,5,18,19,9,6,9,5,19,112
22,5,18,19,9,6,15,18,13,125
22,5,18,19,9,14,0,0,0,87
22,5,18,19,9,14,5,0,0,92
22,5,18,19,9,14,5,19,0,111
22,5,18,19,9,14,7,0,0,94
22,5,18,19,9,15,14,0,0,102
22,5,18,19,9,15,14,1,12,115
22,5,18,19,9,15,14,5,18,125
22,5,18,19,9,15,14,19,0,121
22,5,18,19,9,16,5,12,0,106
22,5,18,19,15,0,0,0,0,79
22,5,18,19,15,18,0,0,0,97
22,5,18,19,15,19,0,0,0,98
22,5,18,19,20,0,0,0,0,84
22,5,18,19,20,1,0,0,0,85
22,5,18,19,20,5,0,0,0,89
22,5,18,19,20,5,19,0,0,108
22,5,18,19,20,19,0,0,0,103
22,5,18,19,21,1,12,0,0,98
22,5,18,19,21,19,0,0,0,104
22,5,18,19,21,20,5,0,0,110
22,5,18,20,0,0,0,0,0,65
22,5,18,20,5,2,18,1,0,91
22,5,18,20,5,2,18,1,5,96
22,5,18,20,5,2,18,1,12,103
22,5,18,20,5,2,18,1,19,110
22,5,18,20,5,2,18,5,0,95
22,5,18,20,5,16,0,0,0,86
22,5,18,20,5,24,0,0,0,94
22,5,18,20,5,24,5,19,0,118
22,5,18,20,25,0,0,0,0,90
22,5,18,20,9,2,12,5,0,93
22,5,18,20,9,3,1,12,0,90
22,5,18,20,9,3,1,12,19,109
22,5,18,20,9,3,5,19,0,101
22,5,18,20,9,3,9,12,0,98
22,5,18,20,9,3,9,12,19,117
22,5,18,20,9,3,9,20,25,131
22,5,18,20,9,7,15,0,0,96
22,5,18,20,9,7,15,5,19,120
22,5,18,20,9,7,15,19,0,115
22,5,18,20,19,0,0,0,0,84
22,5,18,20,21,0,0,0,0,86
22,5,18,20,21,7,1,12,0,106
22,5,18,20,21,19,0,0,0,105
22,5,18,21,12,5,4,0,0,87
22,5,18,21,19,0,0,0,0,85
22,5,18,21,20,1,0,0,0,87
22,5,18,21,20,21,13,0,0,120
22,5,18,22,1,9,14,0,0,91
22,5,18,22,1,9,14,19,0,110
22,5,18,22,5,0,0,0,0,72
22,5,18,22,5,3,5,1,14,95
22,5,18,22,5,3,9,14,5,103
22,5,18,22,5,12,0,0,0,84
22,5,18,22,5,12,5,4,0,93
22,5,18,22,5,12,12,5,0,101
22,5,18,22,5,12,12,5,4,105
22,5,18,22,5,14,9,1,0,96
22,5,18,22,5,18,0,0,0,90
22,5,18,22,5,19,0,0,0,91
22,5,18,22,5,20,0,0,0,92
22,5,18,22,5,20,19,0,0,111
22,5,18,22,9,14,5,0,0,95
22,5,18,26,9,14,9,0,0,103
22,5,18,26,9,14,15,0,0,109
22,5,19,1,14,9,1,0,0,71
22,5,19,1,14,9,3,0,0,73
22,5,19,2,9,20,5,0,0,82
22,5,19,5,0,0,0,0,0,51
22,5,19,9,3,1,0,0,0,59
22,5,19,9,3,1,5,0,0,64
22,5,19,9,3,1,12,0,0,71
22,5,19,9,3,1,14,20,0,93
22,5,19,9,3,1,14,20,19,112
22,5,19,9,3,1,20,5,0,84
22,5,19,9,3,1,20,5,4,88
22,5,19,9,3,1,20,5,19,103
22,5,19,9,3,12,5,0,0,75
22,5,19,9,3,12,5,19,0,94
22,5,19,9,3,21,12,1,0,92
22,5,19,9,3,21,12,1,5,97
22,5,19,9,3,21,12,1,18,110
22,5,19,9,3,21,12,5,0,96
22,5,19,9,3,21,12,21,19,131
22,5,19,9,7,9,1,0,0,72
22,5,19,11,9,20,0,0,0,86
22,5,19,16,0,0,0,0,0,62
22,5,19,16,1,3,9,4,5,84
22,5,19,16,1,12,0,0,0,75
22,5,19,16,5,18,1,12,0,98
22,5,19,16,5,18,1,12,19,117
22,5,19,16,5,18,25,0,0,110
22,5,19,16,5,18,9,1,14,109
22,5,19,16,5,18,9,14,7,115
22,5,19,16,5,18,19,0,0,104
22,5,19,16,5,20,18,15,0,120
22,5,19,16,9,1,18,25,0,115
22,5,19,16,9,4,0,0,0,75
22,5,19,16,9,4,19,0,0,94
22,5,19,16,9,6,15,18,13,123
22,5,19,16,9,14,5,0,0,90
22,5,19,16,15,9,4,0,0,90
22,5,19,19,5,12,0,0,0,82
22,5,19,19,5,12,5,4,0,91
22,5,19,19,5,12,6,21,12,121
22,5,19,19,5,12,12,5,4,103
22,5,19,19,5,12,19,0,0,101
22,5,19,19,5,19,0,0,0,89
22,5,19,19,5,20,19,0,0,109
22,5,19,19,9,3,14,15,14,120
22,5,19,19,9,7,14,15,14,124
22,5,19,20,0,0,0,0,0,66
22,5,19,20,1,12,0,0,0,79
22,5,19,20,1,12,12,25,0,116
22,5,19,20,1,12,19,0,0,98
22,5,19,20,5,4,0,0,0,75
22,5,19,20,5,5,0,0,0,76
22,5,19,20,5,5,19,0,0,95
22,5,19,20,5,18,0,0,0,89
22,5,19,20,9,1,18,25,0,119
22,5,19,20,9,2,12,5,0,94
22,5,19,20,9,2,21,12,1,111
22,5,19,20,9,2,21,12,5,115
22,5,19,20,9,7,1,12,0,95
22,5,19,20,9,7,5,0,0,87
22,5,19,20,9,7,5,19,0,106
22,5,19,20,9,7,9,1,0,92
22,5,19,20,9,7,9,1,12,104
22,5,19,20,9,7,9,21,13,125
22,5,19,20,9,13,5,14,20,127
22,5,19,20,9,14,7,0,0,96
22,5,19,20,9,14,7,19,0,115
22,5,19,20,9,20,21,18,5,139
22,5,19,20,12,5,19,19,0,121
22,5,19,20,12,5,20,0,0,103
22,5,19,20,12,9,11,5,0,103
22,5,19,20,13,5,14,20,0,118
22,5,19,20,13,5,14,20,19,137
22,5,19,20,18,1,12,0,0,97
22,5,19,20,18,25,0,0,0,109
22,5,19,20,18,9,3,1,12,109
22,5,19,20,18,25,4,15,13,141
22,5,19,20,18,9,5,19,0,117
22,5,19,20,18,9,6,25,0,124
22,5,19,20,18,25,9,19,8,145
22,5,19,20,18,25,9,19,13,150
22,5,19,20,18,25,9,26,5,149
22,5,19,20,18,25,13,1,14,137
22,5,19,20,18,25,13,5,14,141
22,5,19,20,19,0,0,0,0,85
22,5,19,20,21,1,18,25,0,131
22,5,19,20,21,18,1,12,0,118
22,5,19,20,21,18,5,0,0,110
22,5,19,20,21,18,5,4,0,114
22,5,19,20,21,18,5,18,0,128
22,5,19,20,21,18,5,19,0,129
22,5,19,20,21,18,9,14,7,135
22,5,19,21,22,9,1,14,19,132
22,5,19,21,22,9,1,20,5,124
22,5,19,21,22,9,14,0,0,112
22,5,19,21,22,9,20,5,0,123
22,5,20,0,0,0,0,0,0,47
22,5,20,1,14,4,1,0,0,67
22,5,20,3,8,0,0,0,0,58
22,5,20,3,8,5,19,0,0,82
22,5,20,3,8,25,0,0,0,83
22,5,20,3,8,9,5,18,0,90
22,5,20,3,8,9,5,19,20,111
22,5,20,3,8,12,9,11,5,95
22,5,20,3,8,12,9,14,7,100
22,5,20,5,18,0,0,0,0,70
22,5,20,5,18,1,14,0,0,85
22,5,20,5,18,1,14,3,25,113
22,5,20,5,18,1,14,19,0,104
22,5,20,9,20,9,22,5,0,112
22,5,20,9,22,5,14,5,0,102
22,5,20,9,22,5,14,15,12,124
22,5,20,9,22,5,18,0,0,101
22,5,20,9,22,5,18,19,0,120
22,5,20,9,22,5,18,20,0,121
22,5,20,11,15,21,19,9,5,127
22,5,20,15,0,0,0,0,0,62
22,5,20,15,5,4,0,0,0,71
22,5,20,15,5,18,0,0,0,85
22,5,20,15,5,18,19,0,0,104
22,5,20,15,5,19,0,0,0,86
22,5,20,15,9,14,7,0,0,92
22,5,20,15,9,19,13,0,0,103
22,5,20,15,9,19,20,0,0,110
22,5,20,15,9,19,20,9,3,122
22,5,20,19,0,0,0,0,0,66
22,5,20,20,5,4,0,0,0,76
22,5,20,20,9,14,7,0,0,97
22,5,20,20,21,18,1,0,0,107
22,5,20,20,21,18,5,0,0,111
22,5,20,20,21,18,9,14,15,144
22,5,20,21,19,0,0,0,0,87
22,5,20,21,19,20,0,0,0,107
22,5,20,21,19,20,25,0,0,132
22,5,21,7,12,1,9,18,5,100
22,5,21,22,5,0,0,0,0,75
22,5,24,1,2,12,5,0,0,71
22,5,24,1,20,9,15,14,0,110
22,5,24,1,20,9,15,14,19,129
22,5,24,1,20,9,15,21,19,136
22,5,24,1,20,15,18,25,0,130
22,5,24,5,4,0,0,0,0,60
22,5,24,5,4,12,25,0,0,97
22,5,24,5,4,14,5,19,19,117
22,5,24,5,18,0,0,0,0,74
22,5,24,5,18,19,0,0,0,93
22,5,24,5,19,0,0,0,0,75
22,5,24,6,21,12,0,0,0,90
22,5,24,9,12,0,0,0,0,72
22,5,24,9,12,12,1,0,0,85
22,5,24,9,12,12,1,18,0,103
22,5,24,9,12,12,1,18,25,128
22,5,24,9,12,12,1,20,5,110
22,5,24,9,12,12,21,13,0,118
22,5,24,9,12,19,0,0,0,91
22,5,24,9,14,7,0,0,0,81
22,5,24,9,14,7,12,25,0,118
22,5,24,20,0,0,0,0,0,71
22,9,2,5,0,0,0,0,0,38
22,9,2,5,19,0,0,0,0,57
22,9,2,5,20,15,9,20,5,107
22,9,2,5,24,0,0,0,0,62
22,9,2,7,25,15,18,0,0,98
22,9,2,9,3,5,19,0,0,69
22,9,2,9,15,9,4,0,0,70
22,9,2,9,19,20,0,0,0,81
22,9,2,9,19,20,19,0,0,100
22,9,2,9,24,0,0,0,0,66
22,9,2,18,1,3,21,12,1,89
22,9,2,18,1,8,1,18,16,95
22,9,2,18,1,14,3,5,0,74
22,9,2,18,1,14,3,5,19,93
22,9,2,18,1,14,3,25,0,94
22,9,2,18,1,14,20,0,0,86
22,9,2,18,1,14,20,12,25,123
22,9,2,18,1,14,20,19,0,105
22,9,2,18,1,20,5,0,0,77
22,9,2,18,1,20,5,4,0,81
22,9,2,18,1,20,5,19,0,96
22,9,2,18,1,20,9,12,5,98
22,9,2,18,1,20,9,14,7,102
22,9,2,18,1,20,9,15,14,110
22,9,2,18,1,20,9,22,5,108
22,9,2,18,1,20,15,0,0,87
22,9,2,18,1,20,15,18,0,105
22,9,2,18,1,20,15,18,25,130
22,9,2,18,1,20,15,18,19,124
22,9,2,18,1,20,15,19,0,106
22,9,2,18,9,15,9,4,0,88
22,9,2,18,9,15,14,0,0,89
22,9,2,18,9,15,14,9,3,101
22,9,2,18,9,15,14,19,0,108
22,9,2,18,9,15,19,0,0,94
22,9,2,18,9,15,19,9,19,122
22,9,2,18,9,19,19,1,0,99
22,9,2,18,9,19,19,1,5,104
22,9,2,18,9,19,19,1,12,111
22,9,2,18,15,14,9,3,0,92
22,9,2,21,18,14,9,3,0,98
22,9,2,21,18,14,9,14,0,109
22,9,2,21,18,14,21,13,19,139
22,9,3,1,0,0,0,0,0,35
22,9,3,1,9,18,5,0,0,67
22,9,3,1,18,0,0,0,0,53
22,9,3,1,18,1,7,5,0,66
22,9,3,1,18,1,7,5,19,85
22,9,3,1,18,1,20,5,0,79
22,9,3,1,18,1,20,5,19,98
22,9,3,1,18,5,19,19,0,96
22,9,3,1,18,25,0,0,0,78
22,9,3,1,18,9,1,12,0,75
22,9,3,1,18,9,1,14,0,77
22,9,3,1,18,9,1,20,5,88
22,9,3,1,18,9,9,0,0,71
22,9,3,1,18,9,9,19,13,103
22,9,3,1,18,9,15,21,19,117
22,9,3,1,18,9,21,19,0,102
22,9,3,1,18,12,25,0,0,90
22,9,3,1,18,19,0,0,0,72
22,9,3,1,18,19,8,9,16,105
22,9,3,5,3,15,13,5,19,94
22,9,3,5,4,0,0,0,0,43
22,9,3,5,7,5,18,1,12,82
22,9,3,5,12,5,19,19,0,94
22,9,3,5,12,9,11,5,0,76
22,9,3,5,14,1,18,25,0,97
22,9,3,5,14,14,9,1,12,89
22,9,3,5,18,5,7,1,12,82
22,9,3,5,18,5,9,14,5,90
22,9,3,5,18,15,25,0,0,97
22,9,3,5,18,15,25,1,12,110
22,9,3,5,18,15,9,5,19,105
22,9,3,5,18,15,25,19,0,116
22,9,3,5,19,0,0,0,0,58
22,9,3,5,19,9,13,1,12,93
22,9,3,5,20,25,0,0,0,84
22,9,3,8,9,5,19,0,0,75
22,9,3,9,1,14,9,14,0,81
22,9,3,9,1,14,15,19,5,97
22,9,3,9,12,9,14,0,0,78
22,9,3,9,14,1,7,5,0,70
22,9,3,9,14,1,7,5,19,89
22,9,3,9,14,1,12,0,0,70
22,9,3,9,14,5,0,0,0,62
22,9,3,9,14,7,0,0,0,64
22,9,3,9,14,9,20,25,0,111
22,9,3,9,15,19,9,20,25,131
22,9,3,9,15,21,19,0,0,98
22,9,3,9,15,21,19,12,25,135
22,9,3,15,9,20,5,0,0,83
22,9,3,15,13,20,5,0,0,87
22,9,3,15,13,20,5,19,0,106
22,9,3,15,14,20,9,5,12,109
22,9,3,20,1,12,0,0,0,67
22,9,3,20,9,13,0,0,0,76
22,9,3,20,9,13,9,19,5,109
22,9,3,20,9,13,9,26,5,116
22,9,3,20,9,13,19,0,0,95
22,9,3,20,12,5,19,19,0,109
22,9,3,20,15,18,4,15,13,119
22,9,3,20,15,18,5,19,19,130
22,9,3,20,15,18,9,1,19,116
22,9,3,20,15,18,9,5,19,120
22,9,3,20,15,18,9,21,13,130
22,9,3,20,15,18,19,0,0,106
22,9,3,20,18,5,19,19,0,115
22,9,3,20,18,9,3,5,19,108
22,9,3,20,18,9,24,0,0,105
22,9,3,20,21,1,12,0,0,88
22,9,3,20,21,1,12,5,4,97
22,9,3,20,21,1,12,5,18,111
22,9,3,20,21,1,12,18,25,131
22,9,3,20,21,1,12,19,0,107
22,9,3,20,21,19,0,0,0,94
22,9,3,21,1,0,0,0,0,56
22,9,3,21,4,1,0,0,0,60
22,9,3,21,7,14,1,0,0,77
22,9,3,21,7,14,1,19,0,96
22,9,3,21,14,1,0,0,0,70
22,9,3,21,14,1,19,0,0,89
22,9,3,21,19,0,0,0,0,74
22,9,4,1,13,5,0,0,0,54
22,9,4,4,21,9,0,0,0,69
22,9,4,4,21,25,0,0,0,85
22,9,4,5,0,0,0,0,0,40
22,9,4,5,12,9,3,5,20,89
22,9,4,5,14,4,1,0,0,59
22,9,4,5,14,4,21,13,0,92
22,9,4,5,15,0,0,0,0,55
22,9,4,5,15,3,1,19,20,98
22,9,4,5,15,4,9,19,3,90
22,9,4,5,15,4,9,19,11,98
22,9,4,5,15,19,0,0,0,74
22,9,4,5,15,20,1,16,5,97
22,9,4,5,15,20,5,24,0,104
22,9,4,5,15,20,5,24,20,124
22,9,4,5,18,21,6,6,0,91
22,9,4,5,20,20,5,0,0,85
22,9,4,5,20,20,5,19,0,104
22,9,4,5,20,21,18,0,0,99
22,9,4,25,1,0,0,0,0,61
22,9,4,9,3,15,14,0,0,76
22,9,4,9,3,15,14,19,0,95
22,9,4,9,13,21,19,0,0,97
22,9,4,11,9,4,0,0,0,59
22,9,4,11,9,4,19,0,0,78
22,9,4,15,14,9,1,0,0,74
22,9,4,18,25,0,0,0,0,78
22,9,4,21,1,7,5,0,0,69
22,9,4,21,1,12,0,0,0,69
22,9,4,21,1,12,12,25,0,106
22,9,4,21,1,20,5,0,0,82
22,9,4,21,1,20,5,4,0,86
22,9,4,21,1,20,9,15,14,115
22,9,4,21,9,14,5,0,0,84
22,9,4,21,9,20,25,0,0,110
22,9,4,21,9,20,9,5,19,118
22,9,4,21,15,21,19,0,0,111
22,9,5,0,0,0,0,0,0,36
22,9,5,4,0,0,0,0,0,40
22,9,5,12,12,5,0,0,0,65
22,9,5,18,0,0,0,0,0,54
22,9,5,18,11,12,5,21,18,121
22,9,5,18,12,9,14,7,0,96
22,9,5,18,19,0,0,0,0,73
22,9,5,18,20,5,12,0,0,91
22,9,5,19,0,0,0,0,0,55
22,9,5,23,0,0,0,0,0,59
22,9,5,23,1,2,12,5,0,79
22,9,5,23,1,2,12,25,0,99
22,9,5,23,4,1,20,1,0,85
22,9,5,23,5,4,0,0,0,68
22,9,5,23,5,18,0,0,0,82
22,9,5,23,5,18,19,0,0,101
22,9,5,23,25,0,0,0,0,84
22,9,5,23,9,5,18,0,0,91
22,9,5,23,9,5,19,20,0,112
22,9,5,23,9,14,5,19,19,125
22,9,5,23,9,14,7,0,0,89
22,9,5,23,9,14,7,19,0,108
22,9,5,23,12,5,19,19,0,114
22,9,5,23,12,25,0,0,0,96
22,9,5,23,16,15,9,14,20,133
22,9,5,23,16,15,18,20,0,128
22,9,5,23,19,0,0,0,0,78
22,9,5,23,19,15,13,5,0,111
22,9,5,23,19,20,5,18,0,121
22,9,6,4,1,0,0,0,0,42
22,9,7,1,0,0,0,0,0,39
22,9,7,1,19,0,0,0,0,58
22,9,7,5,19,9,13,1,12,97
22,9,7,5,19,9,13,15,0,99
22,9,7,5,19,9,13,15,19,118
22,9,7,7,12,5,0,0,0,62
22,9,7,9,1,0,0,0,0,48
22,9,7,9,1,19,0,0,0,67
22,9,7,9,12,0,0,0,0,59
22,9,7,9,12,1,14,3,5,82
22,9,7,9,12,1,14,3,25,102
22,9,7,9,12,1,14,20,0,94
22,9,7,9,12,1,14,20,5,99
22,9,7,9,12,1,20,5,0,85
22,9,7,9,12,19,0,0,0,78
22,9,7,14,5,18,15,14,0,104
22,9,7,14,5,18,15,14,19,123
22,9,7,14,5,20,20,5,0,102
22,9,7,14,5,20,20,5,4,106
22,9,7,14,5,20,20,5,18,120
22,9,7,14,5,20,20,5,19,121
22,9,7,14,9,14,0,0,0,75
22,9,7,15,7,14,5,0,0,79
22,9,7,15,14,5,0,0,0,72
22,9,7,15,14,9,1,0,0,77
22,9,7,15,18,9,19,8,0,107
22,9,7,15,18,9,19,20,0,119
22,9,7,15,18,12,5,19,19,126
22,9,7,15,18,15,19,15,0,120
22,9,7,15,18,15,21,19,0,126
22,9,7,15,18,19,0,0,0,90
22,9,7,15,21,18,0,0,0,92
22,9,7,15,21,18,19,0,0,111
22,9,7,19,0,0,0,0,0,57
22,9,8,1,18,1,0,0,0,59
22,9,8,21,5,12,1,0,0,78
22,9,9,0,0,0,0,0,0,40
22,9,9,9,0,0,0,0,0,49
22,25,9,14,7,0,0,0,0,77
22,25,9,14,7,12,25,0,0,114
22,9,10,1,25,0,0,0,0,67
22,9,10,1,15,0,0,0,0,57
22,9,11,9,14,7,9,19,13,113
22,9,11,9,14,7,19,0,0,91
22,9,12,0,0,0,0,0,0,43
22,9,12,1,0,0,0,0,0,44
22,9,12,1,25,5,20,0,0,94
22,9,12,1,25,5,20,19,0,113
22,9,12,4,0,0,0,0,0,47
22,9,12,4,12,25,0,0,0,84
22,9,12,4,14,5,19,19,0,104
22,9,12,5,25,14,19,0,0,106
22,9,12,5,12,25,0,0,0,85
22,9,12,5,14,5,19,19,0,105
22,9,12,5,18,0,0,0,0,66
22,9,12,5,19,20,0,0,0,87
22,9,12,8,5,12,13,0,0,81
22,9,12,9,1,3,15,0,0,71
22,9,12,9,3,1,20,5,0,81
22,9,12,9,6,25,0,0,0,83
22,9,12,9,6,9,5,4,0,76
22,9,12,9,6,9,5,18,0,90
22,9,12,9,6,9,5,18,19,109
22,9,12,9,6,9,5,19,0,91
22,9,12,9,6,25,9,14,7,113
22,9,12,9,16,5,14,4,0,91
22,9,12,9,16,5,14,4,19,110
22,9,12,9,20,25,0,0,0,97
22,9,12,9,20,9,5,19,0,105
22,9,12,12,0,0,0,0,0,55
22,9,12,12,1,3,8,5,0,72
22,9,12,12,1,4,15,13,0,88
22,9,12,12,1,4,15,13,19,107
22,9,12,12,1,5,0,0,0,61
22,9,12,12,1,5,20,20,5,106
22,9,12,12,1,7,5,0,0,68
22,9,12,12,1,7,5,25,0,93
22,9,12,12,1,7,5,18,0,86
22,9,12,12,1,7,5,18,25,111
22,9,12,12,1,7,5,18,19,105
22,9,12,12,1,7,5,19,0,87
22,9,12,12,1,7,5,20,0,88
22,9,12,12,1,7,25,0,0,88
22,9,12,12,1,7,9,19,13,104
22,9,12,12,1,25,5,20,0,106
22,9,12,12,1,9,14,0,0,79
22,9,12,12,1,9,14,25,0,104
22,9,12,12,1,9,14,19,0,98
22,9,12,12,1,11,9,14,0,90
22,9,12,12,1,12,5,19,19,111
22,9,12,12,1,12,9,11,5,93
22,9,12,12,1,14,0,0,0,70
22,9,12,12,1,14,1,7,5,83
22,9,12,12,1,14,15,21,19,125
22,9,12,12,1,18,0,0,0,74
22,9,12,12,1,20,5,0,0,81
22,9,12,12,1,20,9,3,0,88
22,9,12,12,5,0,0,0,0,60
22,9,12,12,5,9,14,0,0,83
22,9,12,12,5,9,14,19,0,102
22,9,12,12,5,9,20,25,0,114
22,9,12,12,5,14,1,7,5,87
22,9,12,12,9,0,0,0,0,64
22,9,12,12,9,3,21,19,0,107
22,9,12,12,9,6,15,18,13,116
22,9,12,12,9,20,9,19,0,112
22,9,12,12,15,9,4,0,0,83
22,9,12,12,15,19,5,0,0,94
22,9,12,12,15,19,9,20,25,143
22,9,12,12,15,20,1,0,0,91
22,9,12,12,15,20,5,0,0,95
22,9,12,12,15,21,19,0,0,110
22,9,12,12,15,21,19,12,25,147
22,9,12,12,19,0,0,0,0,74
22,9,12,12,21,19,0,0,0,95
22,9,13,0,0,0,0,0,0,44
22,9,13,1,14,1,0,0,0,60
22,9,13,5,14,0,0,0,0,63
22,9,13,6,21,12,0,0,0,83
22,9,13,9,14,1,0,0,0,68
22,9,13,9,14,5,15,21,19,127
22,9,13,16,1,0,0,0,0,61
22,9,13,19,0,0,0,0,0,63
22,9,14,1,3,5,15,21,19,109
22,9,14,1,3,15,14,9,3,90
22,9,14,1,7,5,0,0,0,58
22,9,14,1,7,18,15,14,0,100
22,9,14,1,9,7,18,5,0,85
22,9,14,1,12,0,0,0,0,58
22,9,14,1,12,19,0,0,0,77
22,9,14,1,19,0,0,0,0,65
22,9,14,1,19,19,5,0,0,89
22,9,14,1,19,19,5,19,0,108
22,9,14,1,20,1,0,0,0,67
22,9,14,3,1,19,0,0,0,68
22,9,14,3,8,21,3,1,0,81
22,9,14,3,9,2,12,5,0,76
22,9,14,3,9,2,12,25,0,96
22,9,14,3,21,12,1,0,0,82
22,9,14,3,21,12,1,18,0,100
22,9,14,3,21,12,1,20,5,107
22,9,14,3,21,12,15,0,0,96
22,9,14,3,21,12,21,12,1,115
22,9,14,3,21,12,21,13,0,115
22,9,14,3,21,12,21,13,19,134
22,9,14,4,1,12,15,15,0,92
22,9,14,4,5,13,9,1,12,89
22,9,14,4,5,19,9,14,5,101
22,9,14,4,5,24,0,0,0,78
22,9,14,4,8,25,1,14,0,97
22,9,14,4,9,3,1,20,5,87
22,9,14,4,9,3,5,19,0,85
22,9,14,4,9,3,20,0,0,81
22,9,14,4,9,3,20,1,0,82
22,9,14,5,1,0,0,0,0,51
22,9,14,5,1,5,0,0,0,56
22,9,14,5,1,12,0,0,0,63
22,9,14,5,1,20,9,3,0,83
22,9,14,5,4,0,0,0,0,54
22,9,14,5,7,1,18,0,0,76
22,9,14,5,7,1,18,5,18,99
22,9,14,5,7,1,18,25,0,101
22,9,14,5,7,1,18,19,0,95
22,9,14,5,25,1,18,4,0,98
22,9,14,5,25,1,18,4,19,117
22,9,14,5,9,20,25,0,0,104
22,9,14,5,12,5,19,19,0,105
22,9,14,5,12,5,20,0,0,87
22,9,14,5,12,9,11,5,0,87
22,9,14,5,18,0,0,0,0,68
22,9,14,5,18,25,0,0,0,93
22,9,14,5,18,9,5,19,0,101
22,9,14,5,19,20,1,12,11,113
22,9,14,5,20,0,0,0,0,70
22,9,14,5,20,20,1,0,0,91
22,9,14,5,23,0,0,0,0,73
22,9,14,5,23,9,19,5,0,106
22,9,14,7,20,0,0,0,0,72
22,9,14,7,20,9,5,13,5,104
22,9,14,7,20,21,14,0,0,107
22,9,14,8,1,20,9,3,15,101
22,9,14,9,3,0,0,0,0,57
22,9,14,9,5,18,0,0,0,77
22,9,14,9,5,19,20,0,0,98
22,9,14,9,6,5,18,1,0,84
22,9,14,9,6,5,18,1,19,103
22,9,14,9,6,25,0,0,0,85
22,9,14,9,6,9,5,4,0,78
22,9,14,9,6,9,5,19,0,93
22,9,14,25,12,0,0,0,0,82
22,9,14,25,12,1,20,5,0,108
22,9,14,25,12,1,20,5,4,112
22,9,14,25,12,5,14,5,0,106
22,9,14,25,12,9,3,0,0,94
22,9,14,25,12,19,0,0,0,101
22,9,14,9,20,15,18,0,0,107
22,9,14,15,0,0,0,0,0,60
22,9,14,15,4,0,0,0,0,64
22,9,14,15,12,5,14,3,5,99
22,9,14,15,12,5,14,20,0,111
22,9,14,15,12,15,7,25,0,119
22,9,14,15,13,5,20,5,18,121
22,9,14,15,19,0,0,0,0,79
22,9,14,15,19,5,0,0,0,84
22,9,14,15,19,9,20,25,0,133
22,9,14,15,21,19,0,0,0,100
22,9,14,15,21,19,12,25,0,137
22,9,14,17,21,9,19,8,0,119
22,9,14,20,0,0,0,0,0,65
22,9,14,20,1,0,0,0,0,66
22,9,14,20,1,7,5,0,0,78
22,9,14,20,1,7,5,4,0,82
22,9,14,20,1,7,5,18,0,96
22,9,14,20,1,7,5,18,19,115
22,9,14,20,1,7,5,19,0,97
22,9,14,20,1,7,9,14,7,103
22,9,14,20,5,13,0,0,0,83
22,9,14,20,5,14,5,18,0,107
22,9,14,20,5,18,0,0,0,88
22,9,14,20,12,9,20,5,0,111
22,9,14,20,14,5,18,0,0,102
22,9,14,20,14,5,18,25,0,127
22,9,14,20,14,5,18,19,0,121
22,9,14,20,18,5,19,19,0,126
22,9,14,20,18,25,0,0,0,108
22,9,14,21,13,0,0,0,0,79
22,9,15,12,0,0,0,0,0,58
22,9,15,12,1,2,12,5,0,78
22,9,15,12,1,2,12,25,0,98
22,9,15,12,1,3,5,1,14,82
22,9,15,12,1,12,0,0,0,71
22,9,15,12,1,14,0,0,0,73
22,9,15,12,1,14,4,0,0,77
22,9,15,12,1,14,9,14,0,96
22,9,15,12,1,19,0,0,0,78
22,9,15,12,1,20,5,0,0,84
22,9,15,12,1,20,5,4,0,88
22,9,15,12,1,20,5,18,0,102
22,9,15,12,1,20,5,18,19,121
22,9,15,12,1,20,5,19,0,103
22,9,15,12,1,20,9,14,7,109
22,9,15,12,1,20,9,15,14,117
22,9,15,12,1,20,9,22,5,115
22,9,15,12,1,20,15,18,0,112
22,9,15,12,1,20,15,18,25,137
22,9,15,12,1,20,15,18,19,131
22,9,15,12,1,20,21,18,5,123
22,9,15,12,5,14,3,5,0,85
22,9,15,12,5,14,3,5,19,104
22,9,15,12,5,14,3,25,0,105
22,9,15,12,5,14,20,0,0,97
22,9,15,12,5,14,20,12,25,134
22,9,15,12,5,18,0,0,0,81
22,9,15,12,5,20,25,0,0,108
22,9,15,12,5,20,9,19,8,119
22,9,15,12,5,20,19,0,0,102
22,9,15,12,9,14,0,0,0,81
22,9,15,12,9,14,1,0,0,82
22,9,15,12,9,14,5,0,0,86
22,9,15,12,9,14,5,4,0,90
22,9,15,12,9,14,9,14,7,111
22,9,15,12,9,14,9,19,20,129
22,9,15,12,9,14,15,0,0,96
22,9,15,12,9,14,19,0,0,100
22,9,15,12,9,19,20,0,0,106
22,9,15,12,9,19,20,19,0,125
22,9,15,12,13,1,11,5,18,106
22,9,15,12,15,14,0,0,0,87
22,9,15,12,15,14,5,0,0,92
22,9,15,12,15,14,5,19,0,111
22,9,15,12,15,20,20,1,0,114
22,9,15,12,15,21,19,0,0,113
22,9,15,12,19,0,0,0,0,77
22,9,15,12,21,18,9,3,0,109
22,9,15,13,25,3,9,14,0,110
22,9,15,13,25,3,9,14,19,129
22,9,15,19,20,5,18,15,12,135
22,9,16,5,18,1,14,0,0,85
22,9,16,5,18,5,19,19,0,113
22,9,16,5,18,6,9,19,8,112
22,9,16,5,18,25,0,0,0,95
22,9,16,5,18,9,1,14,0,94
22,9,16,5,18,9,4,0,0,83
22,9,16,5,18,9,14,5,0,98
22,9,16,5,18,9,19,8,0,106
22,9,16,5,18,12,9,11,5,107
22,9,16,5,18,12,9,14,7,112
22,9,16,5,18,15,9,4,0,98
22,9,16,5,18,15,21,19,0,125
22,9,16,5,18,19,0,0,0,89
22,9,16,15,12,9,20,9,3,115
22,9,16,19,0,0,0,0,0,66
22,9,17,21,5,5,14,0,0,93
22,9,18,1,7,9,14,0,0,80
22,9,18,1,7,15,0,0,0,72
22,9,18,1,7,15,5,19,0,96
22,9,18,1,7,15,9,19,8,108
22,9,18,1,7,15,19,0,0,91
22,9,18,1,12,0,0,0,0,62
22,9,18,1,12,12,25,0,0,99
22,9,18,1,19,15,14,0,0,98
22,9,18,5,0,0,0,0,0,54
22,9,18,5,12,1,9,0,0,76
22,9,18,5,12,1,25,0,0,92
22,9,18,5,12,1,9,19,0,95
22,9,18,5,12,1,25,19,0,111
22,9,18,5,13,5,14,20,0,106
22,9,18,5,13,9,1,0,0,77
22,9,18,5,13,9,1,19,0,96
22,9,18,5,13,9,3,0,0,79
22,9,18,5,14,20,0,0,0,88
22,9,18,5,15,0,0,0,0,69
22,9,18,5,15,14,9,14,5,111
22,9,18,5,15,19,0,0,0,88
22,9,18,5,19,0,0,0,0,73
22,9,18,5,19,3,5,14,20,115
22,9,18,7,1,0,0,0,0,57
22,9,18,7,1,12,0,0,0,69
22,9,18,7,1,19,0,0,0,76
22,9,18,7,1,20,5,0,0,82
22,9,18,7,1,20,5,4,0,86
22,9,18,7,1,20,5,18,0,100
22,9,18,7,1,20,5,19,0,101
22,9,18,7,1,20,9,15,14,115
22,9,18,7,5,18,0,0,0,79
22,9,18,7,9,14,1,12,19,111
22,9,18,7,9,14,9,20,25,133
22,9,18,7,9,14,9,21,13,122
22,9,18,7,9,14,12,25,0,116
22,9,18,7,9,14,19,0,0,98
22,9,18,7,15,19,0,0,0,90
22,9,18,7,21,12,1,0,0,90
22,9,18,7,21,12,1,18,0,108
22,9,18,7,21,12,1,20,5,115
22,9,18,7,21,12,5,0,0,94
22,9,18,7,21,12,5,19,0,113
22,9,18,7,21,12,20,21,13,143
22,9,18,9,1,12,0,0,0,71
22,9,18,9,3,9,4,1,12,87
22,9,18,9,3,9,4,5,0,79
22,9,18,9,3,9,4,5,19,98
22,9,18,9,4,0,0,0,0,62
22,9,18,9,4,1,18,9,1,91
22,9,18,9,4,5,14,5,0,86
22,9,18,9,4,9,1,14,0,86
22,9,18,9,4,9,1,14,19,105
22,9,18,9,4,9,14,0,0,85
22,9,18,9,4,9,14,5,0,90
22,9,18,9,4,9,20,5,0,96
22,9,18,9,4,9,20,25,0,116
22,9,18,9,6,25,0,0,0,89
22,9,18,9,6,9,3,0,0,76
22,9,18,9,12,5,0,0,0,75
22,9,18,9,12,5,12,25,0,112
22,9,18,9,12,9,1,0,0,80
22,9,18,9,12,9,6,25,0,110
22,9,18,9,12,9,19,13,0,111
22,9,18,9,12,9,19,13,19,130
22,9,18,9,12,9,19,20,0,118
22,9,18,9,12,9,20,25,0,124
22,9,18,9,12,9,26,5,0,110
22,9,18,9,12,15,3,1,12,101
22,9,18,9,15,14,0,0,0,87
22,9,18,9,15,14,19,0,0,106
22,9,18,9,20,15,15,20,0,128
22,9,18,9,20,18,1,20,5,122
22,9,18,12,0,0,0,0,0,61
22,9,18,12,5,4,0,0,0,70
22,9,18,12,19,0,0,0,0,80
22,25,18,14,23,25,0,0,0,127
22,9,18,15,9,4,0,0,0,77
22,9,18,15,9,4,19,0,0,96
22,9,18,15,12,5,0,0,0,81
22,9,18,15,12,5,4,0,0,85
22,9,18,15,12,15,7,25,0,123
22,9,18,15,12,15,7,9,3,110
22,9,18,15,14,0,0,0,0,78
22,9,18,15,19,5,0,0,0,88
22,9,18,15,19,5,19,0,0,107
22,9,18,15,19,9,19,0,0,111
22,9,18,15,21,19,0,0,0,104
22,9,18,20,21,0,0,0,0,90
22,9,18,20,21,1,12,0,0,103
22,9,18,20,21,1,12,12,25,140
22,9,18,20,21,5,0,0,0,95
22,9,18,20,21,5,4,0,0,99
22,9,18,20,21,5,6,25,0,126
22,9,18,20,21,5,19,0,0,114
22,9,18,20,21,12,5,19,19,145
22,9,18,20,21,15,19,1,0,125
22,9,18,20,21,15,19,1,19,144
22,9,18,20,21,15,19,5,0,129
22,9,18,20,21,15,19,9,0,133
22,9,18,20,21,15,19,9,3,136
22,9,18,20,21,15,19,15,0,139
22,9,18,20,21,15,19,15,19,158
22,9,18,20,21,15,21,19,0,145
22,9,18,20,21,20,9,0,0,119
22,9,18,20,21,20,9,19,0,138
22,9,18,21,3,9,4,1,12,99
22,9,18,21,3,9,4,5,0,91
22,9,18,21,3,9,4,5,19,110
22,9,18,21,5,12,1,0,0,88
22,9,18,21,12,5,14,3,5,109
22,9,18,21,12,5,14,3,25,129
22,9,18,21,12,5,14,20,0,121
22,9,18,21,19,0,0,0,0,89
22,9,18,21,19,3,9,4,5,110
22,9,18,21,19,5,13,9,3,119
22,9,18,21,19,5,19,0,0,113
22,9,18,21,19,12,9,11,5,126
22,9,19,0,0,0,0,0,0,50
22,9,19,1,0,0,0,0,0,51
22,9,19,1,5,4,0,0,0,60
22,9,19,1,7,5,0,0,0,63
22,9,19,1,7,5,4,0,0,67
22,9,19,1,7,5,19,0,0,82
22,9,19,1,7,18,1,16,8,101
22,9,19,1,9,14,7,0,0,81
22,9,19,1,13,13,9,14,0,100
22,9,19,1,18,4,0,0,0,73
22,9,19,1,18,4,19,0,0,92
22,9,19,1,18,7,1,0,0,77
22,9,19,1,19,0,0,0,0,70
22,9,19,3,1,3,8,1,0,66
22,9,19,3,1,3,8,1,19,85
22,9,19,3,5,18,1,0,0,77
22,9,19,3,5,18,1,12,0,89
22,9,19,3,5,18,1,20,5,102
22,9,19,3,5,18,15,21,19,131
22,9,19,3,9,4,0,0,0,66
22,9,19,3,9,4,9,20,25,120
22,9,19,3,9,4,9,26,5,106
22,9,19,3,9,4,12,25,0,103
22,9,19,3,9,14,0,0,0,76
22,9,19,3,15,9,4,0,0,81
22,9,19,3,15,9,4,1,12,94
22,9,19,3,15,12,9,26,5,120
22,9,19,3,15,14,20,1,12,115
22,9,19,3,15,19,5,0,0,92
22,9,19,3,15,19,5,19,0,111
22,9,19,3,15,19,9,20,25,141
22,9,19,3,15,21,14,20,25,148
22,9,19,3,15,21,14,20,19,142
22,9,19,3,15,21,19,0,0,108
22,9,19,3,15,21,19,12,25,145
22,9,19,3,21,13,0,0,0,87
22,9,19,3,21,19,0,0,0,93
22,9,19,5,0,0,0,0,0,55
22,9,19,5,4,0,0,0,0,59
22,9,19,5,5,4,0,0,0,64
22,9,19,5,9,14,7,0,0,85
22,9,19,5,12,9,11,5,0,92
22,9,19,5,13,1,14,0,0,83
22,9,19,5,13,5,14,20,0,107
22,9,19,5,14,15,13,25,0,122
22,9,19,5,19,0,0,0,0,74
22,9,19,8,1,12,0,0,0,71
22,9,19,9,2,12,5,0,0,78
22,9,19,9,2,12,25,0,0,98
22,9,19,9,5,0,0,0,0,64
22,9,19,9,5,18,0,0,0,82
22,9,19,9,12,5,0,0,0,76
22,9,19,9,14,7,0,0,0,80
22,9,19,9,15,14,0,0,0,88
22,9,19,9,15,14,1,12,0,101
22,9,19,9,15,14,1,18,25,132
22,9,19,9,15,14,5,4,0,97
22,9,19,9,15,14,5,18,0,111
22,9,19,9,15,14,9,3,0,100
22,9,19,9,15,14,9,14,7,118
22,9,19,9,15,14,9,19,20,136
22,9,19,9,15,14,9,26,5,128
22,9,19,9,15,14,19,0,0,107
22,9,19,9,20,0,0,0,0,79
22,9,19,9,20,1,0,0,0,80
22,9,19,9,20,1,2,12,5,99
22,9,19,9,20,1,4,15,18,117
22,9,19,9,20,1,14,20,0,114
22,9,19,9,20,1,14,20,19,133
22,9,19,9,20,1,20,5,0,105
22,9,19,9,20,1,20,15,18,133
22,9,19,9,20,5,0,0,0,84
22,9,19,9,20,5,4,0,0,88
22,9,19,9,20,5,5,0,0,89
22,9,19,9,20,5,18,0,0,102
22,9,19,9,20,5,18,19,0,121
22,9,19,9,20,9,14,7,0,109
22,9,19,9,20,13,5,14,20,131
22,9,19,9,20,15,18,0,0,112
22,9,19,9,20,15,18,19,0,131
22,9,19,9,20,18,5,19,19,140
22,9,19,9,20,18,9,24,0,130
22,9,19,9,20,19,0,0,0,98
22,9,19,9,22,5,0,0,0,86
22,9,19,14,5,0,0,0,0,69
22,9,19,14,5,25,0,0,0,94
22,9,19,14,15,13,25,0,0,117
22,9,19,15,14,0,0,0,0,79
22,9,19,15,18,0,0,0,0,83
22,9,19,15,18,5,4,0,0,92
22,9,19,15,18,25,0,0,0,108
22,9,19,15,18,9,14,7,0,113
22,9,19,15,18,12,5,19,19,138
22,9,19,15,18,12,9,11,5,120
22,9,19,15,18,19,0,0,0,102
22,9,19,19,0,0,0,0,0,69
22,9,19,20,1,5,4,0,0,80
22,9,19,20,1,12,0,0,0,83
22,9,19,20,1,12,5,19,19,126
22,9,19,20,1,19,0,0,0,90
22,9,19,20,12,9,11,0,0,102
22,9,19,20,15,0,0,0,0,85
22,9,19,21,1,12,0,0,0,84
22,9,19,21,1,12,9,19,20,132
22,9,19,21,1,12,9,20,25,138
22,9,19,21,1,12,9,26,5,124
22,9,19,21,1,12,12,25,0,121
22,9,19,21,1,12,19,0,0,103
22,9,20,1,3,5,15,21,19,115
22,9,20,1,5,0,0,0,0,57
22,9,20,1,7,18,1,16,8,102
22,9,20,1,12,0,0,0,0,64
22,9,20,1,12,9,3,0,0,76
22,9,20,1,12,9,19,5,0,97
22,9,20,1,12,9,19,5,4,101
22,9,20,1,12,9,19,5,18,115
22,9,20,1,12,9,19,5,19,116
22,9,20,1,12,9,19,13,0,105
22,9,20,1,12,9,19,13,19,124
22,9,20,1,12,9,19,20,0,112
22,9,20,1,12,9,19,20,19,131
22,9,20,1,12,9,20,25,0,118
22,9,20,1,12,9,26,5,0,104
22,9,20,1,12,9,26,5,4,108
22,9,20,1,12,9,26,5,18,122
22,9,20,1,12,9,26,5,19,123
22,9,20,1,12,12,25,0,0,101
22,9,20,1,12,14,5,19,19,121
22,9,20,1,12,19,0,0,0,83
22,9,20,1,13,5,18,0,0,88
22,9,20,1,13,5,18,9,3,100
22,9,20,1,13,5,18,19,0,107
22,9,20,1,13,9,14,0,0,88
22,9,20,1,13,9,14,5,0,93
22,9,20,1,13,9,14,5,19,112
22,9,20,1,13,9,14,9,3,100
22,9,20,1,13,9,14,19,0,107
22,9,20,1,16,1,20,8,0,97
22,9,20,1,16,1,20,8,25,122
22,9,20,1,19,3,15,16,5,110
22,9,20,1,19,20,9,0,0,100
22,9,20,5,12,12,1,18,25,124
22,9,20,5,12,12,9,14,0,103
22,9,20,5,12,12,9,14,5,108
22,9,20,5,12,12,9,14,19,122
22,9,20,5,12,12,15,19,5,119
22,9,20,5,12,12,21,19,0,120
22,9,20,5,18,2,9,20,5,110
22,9,20,5,19,19,5,0,0,99
22,9,20,5,19,19,5,19,0,118
22,9,20,9,1,2,12,5,0,80
22,9,20,9,1,12,0,0,0,73
22,9,20,9,1,20,5,0,0,86
22,9,20,9,1,20,5,4,0,90
22,9,20,9,1,20,5,19,0,105
22,9,20,9,1,20,9,14,7,111
22,9,20,9,1,20,9,15,14,119
22,9,20,9,1,20,15,18,0,114
22,9,20,9,1,20,15,18,19,133
22,9,20,9,3,5,20,1,0,89
22,9,20,9,3,5,20,21,13,122
22,9,20,9,12,1,7,15,0,95
22,9,20,9,12,9,7,15,0,103
22,9,20,9,12,9,7,15,19,122
22,9,20,9,15,19,9,20,25,148
22,9,20,9,20,1,0,0,0,81
22,9,20,9,21,13,0,0,0,94
22,9,20,18,1,0,0,0,0,70
22,9,20,18,1,7,5,0,0,82
22,9,20,18,1,9,12,0,0,91
22,9,20,18,1,9,12,5,4,100
22,9,20,18,1,9,14,0,0,93
22,9,20,18,1,9,14,19,0,112
22,9,20,18,1,21,24,0,0,115
22,9,20,18,5,1,12,0,0,87
22,9,20,18,5,1,14,0,0,89
22,9,20,18,5,12,12,1,0,99
22,9,20,18,5,13,25,20,5,137
22,9,20,18,5,15,21,19,0,129
22,9,20,18,5,21,13,0,0,108
22,9,20,18,9,1,12,0,0,91
22,9,20,18,9,3,0,0,0,81
22,9,20,18,9,3,19,0,0,100
22,9,20,18,9,6,25,0,0,109
22,9,20,18,9,6,9,5,4,102
22,9,20,18,9,6,9,5,19,117
22,9,20,18,9,6,15,18,13,130
22,9,20,18,9,14,5,0,0,97
22,9,20,18,9,14,5,19,0,116
22,9,20,18,9,14,15,9,4,120
22,9,20,18,9,15,12,0,0,105
22,9,20,18,9,15,12,5,4,114
22,9,20,18,9,15,12,9,3,117
22,9,20,18,9,15,12,19,0,124
22,9,20,18,9,20,5,0,0,103
22,9,20,18,15,0,0,0,0,84
22,9,20,18,15,20,25,16,5,150
22,9,20,18,15,21,19,0,0,124
22,9,20,18,21,13,0,0,0,103
22,9,20,20,1,0,0,0,0,72
22,9,20,20,1,5,0,0,0,77
22,9,20,20,1,20,5,0,0,97
22,9,20,20,12,5,0,0,0,88
22,9,20,20,12,5,4,0,0,92
22,9,20,20,12,5,19,0,0,107
22,9,20,20,12,9,14,7,0,113
22,9,20,21,12,1,18,0,0,103
22,9,20,21,12,1,18,25,0,128
22,9,20,21,12,9,14,5,0,112
22,9,20,21,16,5,18,0,0,111
22,9,20,21,16,5,18,25,0,136
22,9,21,22,1,0,0,0,0,75
22,9,22,1,3,5,0,0,0,62
22,9,22,1,3,5,19,0,0,81
22,9,22,1,3,9,15,21,19,121
22,9,22,1,3,9,20,25,0,111
22,9,22,1,13,5,14,20,5,111
22,9,22,1,14,4,9,0,0,81
22,9,22,1,14,4,9,5,18,104
22,9,22,1,14,4,9,18,5,104
22,9,22,1,14,20,0,0,0,88
22,9,22,1,14,20,19,0,0,107
22,9,22,1,18,25,0,0,0,97
22,9,22,1,18,9,1,0,0,82
22,9,22,1,18,9,5,19,0,105
22,9,22,1,18,9,9,1,0,91
22,9,22,1,18,9,21,13,0,115
22,9,22,1,18,9,21,13,19,134
22,9,22,1,19,0,0,0,0,73
22,9,22,1,20,0,0,0,0,74
22,9,22,1,24,0,0,0,0,78
22,9,22,4,1,0,0,0,0,58
22,9,22,5,0,0,0,0,0,58
22,9,22,5,11,0,0,0,0,69
22,9,22,5,12,25,0,0,0,95
22,9,22,5,14,3,25,0,0,100
22,9,22,5,14,4,9,0,0,85
22,9,22,5,18,0,0,0,0,76
22,9,22,5,18,18,1,0,0,95
22,9,22,5,18,18,9,4,0,107
22,9,22,5,18,18,9,4,19,126
22,9,22,5,18,18,9,14,5,122
22,9,22,5,18,19,0,0,0,95
22,9,22,5,19,0,0,0,0,77
22,9,22,5,21,18,0,0,0,97
22,9,22,9,1,14,9,20,5,111
22,9,22,9,4,0,0,0,0,66
22,9,22,9,4,5,18,0,0,89
22,9,22,9,4,5,19,20,0,110
22,9,22,9,4,9,20,25,0,120
22,9,22,9,4,12,25,0,0,103
22,9,22,9,4,14,5,19,19,123
22,9,22,9,6,25,0,0,0,93
22,9,22,9,6,9,3,0,0,80
22,9,22,9,6,9,3,1,12,93
22,9,22,9,6,9,5,4,0,86
22,9,22,9,6,9,5,18,0,100
22,9,22,9,6,9,5,18,19,119
22,9,22,9,6,9,5,19,0,101
22,9,22,9,6,25,9,14,7,123
22,9,22,9,16,1,18,1,0,98
22,9,22,9,16,1,18,25,0,122
22,9,22,9,19,5,3,20,0,109
22,9,22,9,19,5,3,20,19,128
22,9,22,15,0,0,0,0,0,68
22,9,22,15,19,0,0,0,0,87
22,9,22,18,5,0,0,0,0,76
22,9,22,18,5,19,0,0,0,95
22,9,24,5,14,0,0,0,0,74
22,9,24,5,14,9,19,8,0,110
22,9,24,5,14,12,25,0,0,111
22,9,24,5,14,12,9,11,5,111
22,9,24,5,14,19,0,0,0,93
22,9,26,0,0,0,0,0,0,57
22,9,26,1,13,5,14,20,0,110
22,9,26,1,18,4,0,0,0,80
22,9,26,1,18,4,5,4,0,89
22,9,26,1,18,4,9,14,7,110
22,9,26,1,18,4,19,0,0,99
22,9,26,3,1,3,8,1,0,73
22,9,26,3,1,3,8,1,19,92
22,9,26,9,5,18,0,0,0,89
22,9,26,9,5,18,1,20,5,115
22,9,26,9,5,18,9,1,12,111
22,9,26,9,5,18,19,0,0,108
22,9,26,9,18,0,0,0,0,84
22,9,26,9,18,1,20,5,0,110
22,9,26,9,18,1,20,5,19,129
22,9,26,9,18,9,1,12,0,106
22,9,26,9,18,19,0,0,0,103
22,9,26,9,18,19,8,9,16,136
22,9,26,14,15,13,25,0,0,124
22,9,26,15,18,0,0,0,0,90
22,9,26,15,18,5,4,0,0,99
22,9,26,15,18,9,14,7,0,120
22,9,26,15,18,12,5,19,19,145
22,9,26,15,18,19,0,0,0,109
22,9,26,19,12,1,19,0,0,108
22,9,26,26,25,0,0,0,0,108
22,12,5,9,0,0,0,0,0,48
22,13,19,9,26,5,0,0,0,94
22,15,2,9,19,0,0,0,0,67
22,15,3,0,0,0,0,0,0,40
22,15,3,1,2,0,0,0,0,43
22,15,3,1,2,12,5,0,0,60
22,15,3,1,2,12,5,19,0,79
22,15,3,1,2,12,25,0,0,80
22,15,3,1,2,21,12,1,18,95
22,15,3,1,12,0,0,0,0,53
22,15,3,1,12,9,3,0,0,65
22,15,3,1,12,9,3,19,0,84
22,15,3,1,12,9,15,14,0,91
22,15,3,1,12,9,19,5,0,86
22,15,3,1,12,9,19,5,4,90
22,15,3,1,12,9,19,5,19,105
22,15,3,1,12,9,19,13,0,94
22,15,3,1,12,9,19,13,19,113
22,15,3,1,12,9,19,20,0,101
22,15,3,1,12,9,19,20,19,120
22,15,3,1,12,9,20,25,0,107
22,15,3,1,12,9,26,5,0,93
22,15,3,1,12,9,26,5,4,97
22,15,3,1,12,9,26,5,18,111
22,15,3,1,12,9,26,5,19,112
22,15,3,1,12,12,5,18,0,88
22,15,3,1,12,12,25,0,0,90
22,15,3,1,12,14,5,19,19,110
22,15,3,1,12,19,0,0,0,72
22,15,3,1,20,0,0,0,0,61
22,15,3,1,20,5,0,0,0,66
22,15,3,1,20,9,15,14,0,99
22,15,3,1,20,9,15,14,19,118
22,15,3,1,20,9,22,5,0,97
22,15,3,1,20,9,22,5,19,116
22,15,3,5,0,0,0,0,0,45
22,15,3,5,19,0,0,0,0,64
22,15,3,9,13,15,20,15,18,130
22,15,3,15,4,5,18,0,0,82
22,15,3,15,4,5,18,19,0,101
22,15,3,15,9,4,0,0,0,68
22,15,3,21,12,1,18,0,0,92
22,15,3,21,12,5,0,0,0,78
22,15,4,5,18,0,0,0,0,64
22,15,4,11,1,0,0,0,0,53
22,15,4,11,1,19,0,0,0,72
22,15,4,15,21,14,0,0,0,91
22,15,4,15,21,14,19,0,0,110
22,15,4,21,13,0,0,0,0,75
22,15,4,21,13,19,0,0,0,94
22,15,4,21,14,0,0,0,0,76
22,15,5,19,0,0,0,0,0,61
22,15,5,20,0,0,0,0,0,62
22,15,5,20,5,14,0,0,0,81
22,15,5,20,19,1,11,0,0,93
22,15,5,20,19,5,11,0,0,97
22,15,7,0,0,0,0,0,0,44
22,15,7,5,19,9,20,5,0,102
22,15,7,9,5,0,0,0,0,58
22,15,7,12,9,20,5,0,0,90
22,15,7,20,0,0,0,0,0,64
22,15,7,21,5,0,0,0,0,70
22,15,7,21,5,25,0,0,0,95
22,15,7,21,5,19,0,0,0,89
22,15,7,21,9,19,8,0,0,101
22,15,25,1,7,5,0,0,0,75
22,15,25,1,7,5,4,0,0,79
22,15,25,1,7,5,18,0,0,93
22,15,25,1,7,5,18,19,0,112
22,15,25,1,7,5,19,0,0,94
22,15,25,1,7,5,21,18,0,114
22,15,25,1,7,5,21,18,19,133
22,15,25,1,7,9,14,7,0,100
22,15,25,1,7,9,14,7,19,119
22,15,25,1,14,3,5,0,0,85
22,15,9,3,5,0,0,0,0,54
22,15,9,3,5,2,1,14,4,75
22,15,9,3,5,4,0,0,0,58
22,15,9,3,5,6,21,12,0,93
22,15,9,3,5,12,5,19,19,109
22,15,9,3,5,12,5,20,0,91
22,15,9,3,5,12,9,11,5,91
22,15,9,3,5,18,0,0,0,72
22,15,9,3,5,18,19,0,0,91
22,15,9,3,5,19,0,0,0,73
22,15,9,3,9,14,7,0,0,79
22,15,9,4,0,0,0,0,0,50
22,15,9,4,1,2,12,5,0,70
22,15,9,4,1,14,3,5,0,73
22,15,9,4,1,14,3,5,19,92
22,15,9,4,5,4,0,0,0,59
22,15,9,4,5,5,0,0,0,60
22,15,9,4,5,18,0,0,0,73
22,15,9,4,5,18,19,0,0,92
22,15,9,4,9,14,7,0,0,80
22,15,9,4,12,5,19,19,0,105
22,15,9,4,12,25,0,0,0,87
22,15,9,4,14,5,19,19,0,107
22,15,9,4,19,0,0,0,0,69
22,15,25,5,21,18,0,0,0,106
22,15,25,5,21,18,9,19,13,147
22,15,25,5,21,18,19,0,0,125
22,15,25,5,21,19,5,0,0,112
22,15,25,5,21,19,5,19,0,131
22,15,9,12,1,0,0,0,0,59
22,15,9,12,5,0,0,0,0,63
22,15,9,12,5,19,0,0,0,82
22,15,9,12,9,5,18,0,0,90
22,15,9,19,9,14,1,7,5,101
22,15,9,20,21,18,5,0,0,110
22,15,9,20,21,18,5,19,0,129
22,15,9,20,21,18,9,5,18,137
22,15,9,20,21,18,9,14,0,128
22,15,9,22,15,4,0,0,0,87
22,15,9,22,15,4,5,0,0,92
22,15,12,0,0,0,0,0,0,49
22,15,12,1,2,12,5,0,0,69
22,15,12,1,3,9,15,21,19,117
22,15,12,1,4,15,18,0,0,87
22,15,12,1,7,5,0,0,0,62
22,15,12,1,9,12,12,5,0,88
22,15,12,1,14,20,5,0,0,89
22,15,12,1,14,20,12,25,0,121
22,15,12,1,16,9,5,0,0,80
22,15,12,1,18,0,0,0,0,68
22,15,12,1,18,25,0,0,0,93
22,15,12,1,20,1,0,0,0,71
22,15,12,1,20,9,3,0,0,82
22,15,12,1,20,9,12,5,0,96
22,15,12,1,20,9,12,5,19,115
22,15,12,1,20,9,15,14,0,108
22,15,12,1,20,9,26,5,0,110
22,15,12,3,1,14,0,0,0,67
22,15,12,3,1,14,9,1,14,91
22,15,12,3,1,14,9,3,0,79
22,15,12,3,1,14,9,3,19,98
22,15,12,3,1,14,9,19,13,108
22,15,12,3,1,14,9,19,20,115
22,15,12,3,1,14,9,20,5,101
22,15,12,3,1,14,9,20,25,121
22,15,12,3,1,14,9,26,5,107
22,15,12,3,1,14,15,0,0,82
22,15,12,3,1,14,15,5,19,106
22,15,12,3,1,14,15,19,0,101
22,15,12,5,0,0,0,0,0,54
22,15,12,5,4,0,0,0,0,58
22,15,12,5,13,9,20,5,0,101
22,15,12,5,13,9,20,15,12,123
22,15,12,5,14,3,25,0,0,96
22,15,12,5,14,19,0,0,0,87
22,15,12,5,14,20,0,0,0,88
22,15,12,5,14,20,5,0,0,93
22,15,12,5,14,20,9,0,0,97
22,15,12,5,14,20,12,25,0,125
22,15,12,5,18,25,0,0,0,97
22,15,12,5,18,9,5,19,0,105
22,15,12,5,19,0,0,0,0,73
22,15,12,5,20,0,0,0,0,74
22,15,12,8,25,14,9,20,5,130
22,15,12,25,5,18,0,0,0,97
22,15,12,9,14,7,0,0,0,79
22,15,12,9,20,1,14,20,0,113
22,15,12,9,20,1,20,5,0,104
22,15,12,9,20,9,5,14,20,126
22,15,12,9,20,9,15,14,0,116
22,15,12,9,20,9,15,14,19,135
22,15,12,9,20,9,22,5,0,114
22,15,12,11,19,18,1,1,4,103
22,15,12,12,5,25,0,0,0,91
22,15,12,12,5,25,5,4,0,100
22,15,12,12,5,25,5,18,0,114
22,15,12,12,5,25,5,18,19,133
22,15,12,12,5,25,9,14,7,121
22,15,12,12,5,25,19,0,0,110
22,15,12,12,5,14,7,5,0,92
22,15,12,15,19,20,0,0,0,103
22,15,12,15,19,20,19,0,0,122
22,15,12,15,23,0,0,0,0,87
22,15,12,16,1,14,5,0,0,85
22,15,12,16,12,1,14,5,0,97
22,15,12,16,12,1,14,5,4,101
22,15,12,16,12,1,14,5,19,116
22,15,12,19,0,0,0,0,0,68
22,15,12,19,5,12,12,1,0,98
22,15,12,19,5,12,12,21,13,131
22,15,12,20,0,0,0,0,0,69
22,15,12,20,1,7,5,0,0,82
22,15,12,20,1,7,5,19,0,101
22,15,12,20,1,9,19,13,0,111
22,15,12,20,1,9,19,13,19,130
22,15,12,20,1,9,20,5,0,104
22,15,12,20,1,20,25,16,5,136
22,15,12,20,5,0,0,0,0,74
22,15,12,20,5,1,4,15,18,112
22,15,12,20,5,19,0,0,0,93
22,15,12,20,9,0,0,0,0,78
22,15,12,20,9,7,5,21,18,129
22,15,12,20,9,14,9,19,13,133
22,15,12,20,9,22,9,20,25,154
22,15,12,20,9,26,5,0,0,109
22,15,12,20,13,5,20,5,18,130
22,15,12,20,15,0,0,0,0,84
22,15,12,20,19,0,0,0,0,88
22,15,12,20,26,9,14,5,0,123
22,15,12,20,26,9,20,5,0,129
22,15,12,21,2,12,5,0,0,89
22,15,12,21,2,12,25,0,0,109
22,15,12,21,3,18,9,14,5,119
22,15,12,21,13,5,0,0,0,88
22,15,12,21,13,5,4,0,0,92
22,15,12,21,13,5,14,0,0,102
22,15,12,21,13,5,19,0,0,107
22,15,12,21,13,5,20,5,18,131
22,15,12,21,13,5,20,18,25,151
22,15,12,21,13,5,20,20,5,133
22,15,12,21,13,9,14,1,0,107
22,15,12,21,13,9,14,1,12,119
22,15,12,21,13,9,14,7,0,113
22,15,12,21,13,9,19,20,0,131
22,15,12,21,14,20,1,18,25,148
22,15,12,21,14,20,5,5,18,132
22,15,12,21,14,20,25,0,0,129
22,15,12,21,16,5,18,0,0,109
22,15,12,21,16,20,0,0,0,106
22,15,12,21,16,20,1,18,25,150
22,15,12,21,16,20,5,0,0,111
22,15,12,21,16,20,25,0,0,131
22,15,12,21,20,1,0,0,0,91
22,15,12,21,20,1,5,0,0,96
22,15,12,21,20,1,20,5,0,116
22,15,12,21,20,5,0,0,0,95
22,15,12,21,20,5,4,0,0,99
22,15,12,21,20,5,19,0,0,114
22,15,12,21,20,9,14,0,0,113
22,15,12,21,20,9,14,19,0,132
22,15,12,21,20,9,15,14,0,128
22,15,12,21,20,9,15,14,19,147
22,15,12,21,20,15,9,4,0,118
22,15,12,22,1,0,0,0,0,72
22,15,12,22,1,19,0,0,0,91
22,15,12,22,1,20,5,0,0,97
22,15,12,22,5,12,12,0,0,100
22,15,12,22,5,12,12,5,0,105
22,15,12,22,5,14,20,0,0,110
22,15,12,22,15,24,0,0,0,110
22,15,12,22,15,24,5,19,0,134
22,15,12,22,21,12,9,0,0,113
22,15,12,22,21,12,12,21,19,156
22,15,12,22,21,12,21,19,0,144
22,15,13,2,1,20,9,4,0,86
22,15,13,5,18,0,0,0,0,73
22,15,13,5,18,9,14,5,0,101
22,15,13,5,18,19,0,0,0,92
22,15,13,9,3,1,0,0,0,63
22,15,13,9,3,1,5,0,0,68
22,15,13,9,3,9,14,0,0,85
22,15,13,9,3,9,14,5,0,90
22,15,13,9,20,0,0,0,0,79
22,15,13,9,20,1,2,12,5,99
22,15,13,9,20,5,4,0,0,88
22,15,13,9,20,5,18,0,0,102
22,15,13,9,20,5,18,19,0,121
22,15,13,9,20,25,0,0,0,104
22,15,13,9,20,9,14,7,0,109
22,15,13,9,20,9,15,14,0,117
22,15,13,9,20,9,22,5,0,115
22,15,13,9,20,9,22,5,19,134
22,15,13,9,20,15,0,0,0,94
22,15,13,9,20,15,18,25,0,137
22,15,13,9,20,15,18,9,1,122
22,15,13,9,20,15,19,0,0,113
22,15,13,9,20,15,21,19,0,134
22,15,13,9,20,19,0,0,0,98
22,15,13,9,20,21,18,5,0,123
22,15,13,9,20,21,19,0,0,119
22,15,13,9,20,21,19,5,19,143
22,15,13,9,20,23,15,18,20,155
22,15,13,20,15,18,9,1,0,113
22,15,14,4,19,9,18,1,0,102
22,15,14,19,5,14,9,20,5,123
22,15,15,4,15,15,0,0,0,86
22,15,15,4,15,15,5,4,0,95
22,15,15,4,15,15,9,14,7,116
22,15,15,4,15,15,9,19,13,127
22,15,15,4,15,15,9,19,20,134
22,15,15,4,15,15,19,0,0,105
22,15,15,18,8,21,9,19,0,127
22,15,18,1,3,9,15,21,19,123
22,15,18,1,3,9,20,25,0,113
22,15,18,1,7,5,0,0,0,68
22,15,18,1,7,15,0,0,0,78
22,15,18,1,14,20,0,0,0,90
22,15,18,1,26,0,0,0,0,82
22,15,18,8,1,14,4,0,0,82
22,15,18,12,1,7,5,19,0,99
22,15,18,12,15,15,16,5,18,136
22,15,18,15,14,4,18,5,15,126
22,15,18,15,21,19,0,0,0,110
22,15,18,16,1,12,0,0,0,84
22,15,18,20,5,24,0,0,0,104
22,15,18,20,5,24,5,19,0,128
22,15,18,20,9,3,1,12,0,100
22,15,18,20,9,3,5,12,0,104
22,15,18,20,9,3,5,19,0,111
22,15,18,20,9,3,9,1,12,109
22,15,18,20,9,3,9,19,13,128
22,15,18,20,9,3,9,19,20,135
22,15,18,20,9,3,9,20,25,141
22,15,18,20,9,3,15,19,5,126
22,15,20,1,0,0,0,0,0,58
22,15,20,1,2,12,5,0,0,77
22,15,20,1,12,0,0,0,0,70
22,15,20,1,12,12,25,0,0,107
22,15,20,1,18,5,19,19,0,119
22,15,20,1,18,25,0,0,0,101
22,15,20,1,18,9,5,19,0,109
22,15,20,1,18,9,19,20,0,124
22,15,20,1,18,9,19,20,19,143
22,15,20,1,20,9,15,14,0,116
22,15,20,5,1,2,12,5,0,82
22,15,20,5,4,0,0,0,0,66
22,15,20,5,5,14,0,0,0,81
22,15,20,5,12,5,19,19,0,117
22,15,20,5,18,0,0,0,0,80
22,15,20,5,18,19,0,0,0,99
22,15,20,5,19,0,0,0,0,81
22,15,20,9,14,7,0,0,0,87
22,15,20,9,19,20,0,0,0,105
22,15,20,9,22,5,0,0,0,93
22,15,20,9,22,5,12,25,0,130
22,15,20,15,7,18,1,16,8,122
22,15,20,15,13,5,20,5,18,133
22,15,20,18,5,19,19,0,0,118
22,15,20,18,5,19,19,5,19,142
22,15,21,3,8,0,0,0,0,69
22,15,21,3,8,1,2,12,5,89
22,15,21,3,8,5,4,0,0,78
22,15,21,3,8,5,5,0,0,79
22,15,21,3,8,5,5,19,0,98
22,15,21,3,8,5,18,0,0,92
22,15,21,3,8,5,18,5,4,101
22,15,21,3,8,5,18,19,0,111
22,15,21,3,8,5,19,0,0,93
22,15,21,3,8,9,14,7,0,99
22,15,21,3,8,13,5,14,20,121
22,15,21,3,8,15,18,0,0,102
22,15,21,3,8,19,1,6,5,100
22,15,21,7,5,0,0,0,0,70
22,15,21,12,7,5,0,0,0,82
22,15,21,19,19,15,9,18,0,138
22,15,21,19,19,15,9,18,19,157
22,15,21,19,20,0,0,0,0,97
22,15,21,19,20,5,18,0,0,120
22,15,21,19,20,25,0,0,0,122
22,15,21,22,1,18,25,0,0,124
22,15,21,22,18,1,25,19,0,143
22,15,23,0,0,0,0,0,0,60
22,15,23,5,4,0,0,0,0,69
22,15,23,5,12,25,0,0,0,102
22,15,23,5,12,9,19,8,0,113
22,15,23,5,12,9,19,13,0,118
22,15,23,5,12,9,19,20,0,125
22,15,23,5,12,9,26,5,0,117
22,15,23,5,12,9,26,5,4,121
22,15,23,5,12,9,26,5,19,136
22,15,23,5,12,12,5,4,0,98
22,15,23,5,12,12,5,19,19,132
22,15,23,5,12,12,25,0,0,114
22,15,23,5,12,12,9,11,5,114
22,15,23,5,12,19,0,0,0,96
22,15,23,5,18,0,0,0,0,83
22,15,23,5,18,19,0,0,0,102
22,15,23,5,19,19,0,0,0,103
22,15,23,9,14,7,0,0,0,90
22,15,23,12,5,19,19,0,0,115
22,15,23,13,1,11,5,18,0,108
22,15,23,13,1,11,9,14,7,115
22,15,23,19,0,0,0,0,0,79
22,15,23,19,15,14,0,0,0,108
22,15,24,0,0,0,0,0,0,61
22,18,2,1,9,20,5,0,0,77
22,18,9,4,4,8,9,0,0,74
22,18,9,12,0,0,0,0,0,61
22,18,9,12,12,5,0,0,0,78
22,18,9,12,12,5,4,0,0,82
22,18,9,12,12,9,14,7,0,103
22,18,15,3,8,20,0,0,0,86
22,18,15,15,13,0,0,0,0,83
22,18,15,15,13,5,4,0,0,92
22,18,15,15,13,9,14,7,0,113
22,18,15,15,13,19,0,0,0,102
22,18,15,20,8,5,18,0,0,106
22,18,15,21,23,0,0,0,0,99
22,18,15,21,23,19,0,0,0,118
22,18,15,23,0,0,0,0,0,78
22,18,15,23,19,0,0,0,0,97
22,21,3,15,13,0,0,0,0,74
22,21,3,15,13,19,0,0,0,93
22,21,7,0,0,0,0,0,0,50
22,21,7,7,0,0,0,0,0,57
22,21,7,7,25,0,0,0,0,82
22,21,7,7,9,5,18,0,0,89
22,21,7,7,9,5,19,20,0,110
22,21,7,7,19,0,0,0,0,76
22,21,7,8,0,0,0,0,0,58
22,21,7,8,19,0,0,0,0,77
22,21,7,19,0,0,0,0,0,69
22,21,12,3,1,14,9,19,5,106
22,21,12,3,1,14,9,19,13,114
22,21,12,3,1,14,9,19,20,121
22,21,12,3,1,14,9,20,5,107
22,21,12,3,1,14,9,26,5,113
22,21,12,3,1,14,15,0,0,88
22,21,12,7,1,18,0,0,0,81
22,21,12,7,1,18,5,0,0,86
22,21,12,7,1,18,5,18,0,104
22,21,12,7,1,18,5,19,20,125
22,21,12,7,1,18,9,1,14,105
22,21,12,7,1,18,9,19,5,114
22,21,12,7,1,18,9,19,8,117
22,21,12,7,1,18,9,19,13,122
22,21,12,7,1,18,9,19,20,129
22,21,12,7,1,18,9,20,25,135
22,21,12,7,1,18,9,26,5,121
22,21,12,7,1,18,12,25,0,118
22,21,12,7,1,18,19,0,0,100
22,21,12,7,1,20,5,19,0,107
22,21,12,7,15,0,0,0,0,77
22,21,12,7,21,19,0,0,0,102
22,21,12,7,21,19,5,19,0,126
22,21,12,14,0,0,0,0,0,69
22,21,12,14,5,4,0,0,0,78
22,21,12,14,5,18,1,12,0,105
22,21,12,14,5,18,1,18,25,136
22,21,12,14,5,18,1,20,5,118
22,21,12,14,5,18,15,19,5,131
22,21,12,14,9,6,9,3,0,96
22,21,12,14,15,19,5,0,0,108
22,21,12,16,1,14,19,5,18,128
22,21,12,16,5,3,9,4,5,97
22,21,12,16,9,3,0,0,0,83
22,21,12,16,9,3,9,4,5,101
22,21,12,16,9,14,5,0,0,99
22,21,12,16,9,14,9,3,0,106
22,21,12,16,9,14,9,19,13,135
22,21,12,16,9,14,9,20,5,128
22,21,12,19,5,12,12,1,0,104
22,21,12,19,5,12,12,21,13,137
22,21,12,19,9,14,9,20,5,131
22,21,12,20,21,18,5,0,0,119
22,21,12,20,21,18,5,19,0,138
22,21,12,20,21,18,9,14,5,142
22,21,12,20,21,18,9,19,8,150
22,21,12,20,21,18,9,19,13,155
22,21,12,20,21,18,14,0,0,128
22,21,12,20,21,18,15,21,19,169
22,21,12,22,1,0,0,0,0,78
22,21,12,22,1,5,0,0,0,83
22,21,12,22,1,12,0,0,0,90
22,21,12,22,1,18,0,0,0,96
22,21,12,22,1,19,0,0,0,97
22,21,12,22,1,20,5,0,0,103
22,21,12,22,9,6,15,18,13,138
22,21,12,22,9,20,9,19,0,134
22,21,13,0,0,0,0,0,0,56
22,22,12,12,0,0,0,0,0,68
23,5,2,2,5,4,0,0,0,41
23,5,2,2,25,0,0,0,0,57
23,5,2,2,9,5,18,0,0,64
23,5,2,2,9,5,19,20,0,85
23,5,2,2,9,14,7,0,0,62
23,5,2,2,9,14,7,19,0,81
23,5,2,5,25,5,0,0,0,65
23,5,2,5,12,15,19,0,0,81
23,5,2,5,18,19,0,0,0,72
23,5,2,6,5,4,0,0,0,45
23,5,2,6,5,5,20,0,0,66
23,5,2,6,15,15,20,0,0,86
23,5,2,6,15,15,20,5,4,95
23,5,2,6,15,15,20,5,18,109
23,5,2,12,5,19,19,0,0,85
23,5,2,12,9,11,5,0,0,67
23,5,2,13,1,11,5,18,0,78
23,5,2,13,1,11,9,14,7,85
23,5,2,19,0,0,0,0,0,49
23,5,2,19,20,5,18,19,0,111
23,5,2,23,8,5,5,12,0,83
23,5,2,23,15,18,11,0,0,97
23,5,2,23,15,18,13,0,0,99
23,5,2,23,15,18,13,19,0,118
23,5,2,23,15,18,14,0,0,100
23,5,3,3,8,5,0,0,0,47
23,5,3,8,20,0,0,0,0,59
23,5,3,8,20,19,0,0,0,78
23,5,4,1,14,1,0,0,0,48
23,5,4,2,5,4,0,0,0,43
23,5,4,2,5,4,18,9,16,86
23,5,4,4,5,4,0,0,0,45
23,5,4,4,5,4,12,25,0,82
23,5,4,4,5,5,4,0,0,50
23,5,4,4,5,18,0,0,0,59
23,5,4,4,5,18,19,0,0,78
23,5,4,4,9,14,7,0,0,66
23,5,4,4,9,14,7,5,18,89
23,5,4,4,9,14,7,19,0,85
23,5,4,5,0,0,0,0,0,37
23,5,4,5,12,0,0,0,0,49
23,5,4,5,12,5,4,0,0,58
23,5,4,5,12,9,14,7,0,79
23,5,4,5,12,14,0,0,0,63
23,5,4,5,12,14,19,0,0,82
23,5,4,5,12,19,0,0,0,68
23,5,4,6,5,5,0,0,0,48
23,5,4,7,5,0,0,0,0,44
23,5,4,7,5,1,2,12,5,64
23,5,4,7,5,2,9,12,12,79
23,5,4,7,5,4,0,0,0,48
23,5,4,7,5,12,9,11,5,81
23,5,4,7,5,18,0,0,0,62
23,5,4,7,5,19,0,0,0,63
23,5,4,7,5,23,9,19,5,100
23,5,4,7,25,0,0,0,0,64
23,5,4,7,9,5,18,0,0,71
23,5,4,7,9,5,19,20,0,92
23,5,4,7,9,14,7,0,0,69
23,5,4,12,15,3,11,0,0,73
23,5,4,12,15,3,11,19,0,92
23,5,4,19,0,0,0,0,0,51
23,5,4,19,5,20,0,0,0,76
23,5,5,0,0,0,0,0,0,33
23,5,5,2,12,5,0,0,0,52
23,5,5,4,1,2,12,5,0,57
23,5,5,4,1,7,5,0,0,50
23,5,5,4,5,4,0,0,0,46
23,5,5,4,5,18,0,0,0,60
23,5,5,4,5,18,25,0,0,85
23,5,5,4,5,18,19,0,0,79
23,5,5,4,6,21,12,0,0,76
23,5,5,4,8,15,15,11,0,86
23,5,5,4,25,0,0,0,0,62
23,5,5,4,9,3,9,4,5,67
23,5,5,4,9,5,18,0,0,69
23,5,5,4,9,5,19,20,0,90
23,5,5,4,9,12,25,0,0,83
23,5,5,4,9,14,5,19,19,103
23,5,5,4,9,14,7,0,0,67
23,5,5,4,9,19,8,0,0,73
23,5,5,4,12,5,19,19,0,92
23,5,5,4,12,9,11,5,0,74
23,5,5,4,12,9,14,7,0,79
23,5,5,4,15,23,0,0,0,75
23,5,5,4,16,18,15,15,6,107
23,5,5,4,19,0,0,0,0,56
23,5,5,11,0,0,0,0,0,44
23,5,5,11,4,1,25,0,0,74
23,5,5,11,4,1,25,19,0,93
23,5,5,11,5,14,4,0,0,67
23,5,5,11,5,14,4,5,4,76
23,5,5,11,5,14,4,5,18,90
23,5,5,11,5,14,4,19,0,86
23,5,5,11,12,25,0,0,0,81
23,5,5,11,12,9,5,19,0,89
23,5,5,11,12,9,14,7,0,86
23,5,5,11,12,15,14,7,0,92
23,5,5,11,14,9,7,8,20,102
23,5,5,11,23,1,13,0,0,81
23,5,5,12,0,0,0,0,0,45
23,5,5,12,6,1,18,4,0,74
23,5,5,13,0,0,0,0,0,46
23,5,5,13,5,14,0,0,0,65
23,5,5,14,0,0,0,0,0,47
23,5,5,14,4,9,7,15,0,82
23,5,5,14,5,4,0,0,0,56
23,5,5,14,5,19,19,0,0,90
23,5,5,14,25,0,0,0,0,72
23,5,5,14,9,5,0,0,0,61
23,5,5,14,9,5,18,0,0,79
23,5,5,14,9,5,19,0,0,80
23,5,5,14,9,5,19,20,0,100
23,5,5,14,9,14,7,0,0,77
23,5,5,14,15,14,7,0,0,83
23,5,5,14,19,0,0,0,0,66
23,5,5,14,19,25,0,0,0,91
23,5,5,14,19,9,5,18,0,98
23,5,5,14,19,9,5,19,20,119
23,5,5,14,20,0,0,0,0,67
23,5,5,14,20,25,0,0,0,92
23,5,5,16,0,0,0,0,0,49
23,5,5,16,1,2,12,5,0,69
23,5,5,16,5,4,0,0,0,58
23,5,5,16,5,18,0,0,0,72
23,5,5,16,5,18,5,4,0,81
23,5,5,16,5,18,19,0,0,91
23,5,5,16,6,21,12,0,0,88
23,5,5,16,25,0,0,0,0,74
23,5,5,16,9,5,0,0,0,63
23,5,5,16,9,5,18,0,0,81
23,5,5,16,9,5,19,0,0,82
23,5,5,16,9,5,19,20,0,102
23,5,5,16,9,14,5,19,19,115
23,5,5,16,9,14,7,0,0,79
23,5,5,16,9,14,7,12,25,116
23,5,5,16,9,14,7,19,0,98
23,5,5,16,12,25,0,0,0,86
23,5,5,16,19,0,0,0,0,68
23,5,5,18,0,0,0,0,0,51
23,5,5,18,9,19,8,0,0,87
23,5,5,19,0,0,0,0,0,52
23,5,5,19,8,0,0,0,0,60
23,5,5,19,8,5,5,0,0,70
23,5,5,19,8,25,0,0,0,85
23,5,5,19,20,0,0,0,0,72
23,5,5,20,0,0,0,0,0,53
23,5,5,20,2,9,18,4,0,86
23,5,5,20,5,4,0,0,0,62
23,5,5,20,25,0,0,0,0,78
23,5,5,20,9,14,7,0,0,83
23,5,5,20,12,5,19,19,0,108
23,5,5,20,19,0,0,0,0,72
23,5,5,22,5,18,0,0,0,78
23,5,5,22,5,18,19,0,0,97
23,5,5,22,9,12,0,0,0,76
23,5,5,22,9,12,5,4,0,85
23,5,5,22,9,12,25,0,0,101
23,5,5,22,9,12,12,5,4,97
23,5,5,22,9,12,12,25,0,113
23,5,5,22,9,12,19,0,0,95
23,5,5,23,1,23,0,0,0,80
23,5,5,23,5,5,0,0,0,66
23,5,5,23,5,5,4,0,0,70
23,5,5,23,5,5,9,14,7,96
23,5,5,23,5,5,19,0,0,85
23,5,5,23,15,23,0,0,0,94
23,5,5,26,5,0,0,0,0,64
23,5,5,26,12,5,0,0,0,76
23,5,6,0,0,0,0,0,0,34
23,5,6,20,0,0,0,0,0,54
23,5,6,20,1,7,5,0,0,67
23,5,6,20,5,4,0,0,0,63
23,5,6,20,25,0,0,0,0,79
23,5,6,20,19,0,0,0,0,73
23,5,6,20,23,9,19,5,0,110
23,5,6,20,23,9,26,5,0,117
23,5,7,15,20,9,19,13,0,111
23,5,8,5,5,0,0,0,0,46
23,5,8,18,12,9,20,5,0,100
23,5,9,2,25,5,9,20,5,103
23,5,9,7,5,12,1,19,0,81
23,5,9,7,5,12,9,1,0,71
23,5,9,7,5,12,9,1,19,90
23,5,9,7,5,12,9,20,5,95
23,5,9,7,8,0,0,0,0,52
23,5,9,7,8,1,2,12,5,72
23,5,9,7,8,1,7,5,0,65
23,5,9,7,8,2,1,18,0,73
23,5,9,7,8,2,1,21,11,87
23,5,9,7,8,2,5,1,13,73
23,5,9,7,8,5,4,0,0,61
23,5,9,7,8,5,18,0,0,75
23,5,9,7,8,5,18,19,0,94
23,5,9,7,8,9,14,0,0,75
23,5,9,7,8,9,14,7,0,82
23,5,9,7,8,9,14,7,19,101
23,5,9,7,8,12,15,3,11,93
23,5,9,7,8,13,1,14,0,80
23,5,9,7,8,13,5,14,0,84
23,5,9,7,8,13,5,14,20,104
23,5,9,7,8,19,0,0,0,71
23,5,9,7,8,20,5,4,0,81
23,5,9,7,8,20,5,18,0,95
23,5,9,7,8,20,5,18,19,114
23,5,9,7,8,20,25,0,0,97
23,5,9,7,8,20,9,5,18,104
23,5,9,7,8,20,9,12,25,118
23,5,9,7,8,20,9,14,7,102
23,5,9,7,8,20,19,0,0,91
23,5,9,12,1,14,7,0,0,71
23,5,9,14,5,18,19,0,0,93
23,5,9,18,1,14,7,12,5,94
23,5,9,18,4,0,0,0,0,59
23,5,9,18,4,5,18,0,0,82
23,5,9,18,4,5,19,20,0,103
23,5,9,18,4,6,21,12,0,98
23,5,9,18,4,25,0,0,0,84
23,5,9,18,4,9,5,0,0,73
23,5,9,18,4,9,5,19,0,92
23,5,9,18,4,9,19,8,0,95
23,5,9,18,4,12,5,19,19,114
23,5,9,18,4,12,25,0,0,96
23,5,9,18,4,12,9,11,5,96
23,5,9,18,4,14,5,19,19,116
23,5,9,18,4,15,0,0,0,74
23,5,9,18,4,15,5,19,0,98
23,5,9,18,4,15,19,0,0,93
23,5,9,18,4,19,15,13,5,111
23,5,9,18,4,23,1,18,4,105
23,5,9,18,9,14,7,0,0,85
23,5,9,18,12,5,19,19,0,110
23,5,9,18,19,0,0,0,0,74
23,5,25,19,0,0,0,0,0,72
23,5,9,19,13,0,0,0,0,69
23,5,9,19,19,9,20,5,0,109
23,5,10,1,3,11,0,0,0,53
23,5,11,1,0,0,0,0,0,40
23,5,11,1,19,0,0,0,0,59
23,5,11,1,21,0,0,0,0,61
23,5,11,5,5,14,0,0,0,63
23,5,11,9,0,0,0,0,0,48
23,5,12,3,8,5,4,0,0,60
23,5,12,3,8,5,18,19,0,93
23,5,12,3,8,9,14,7,0,81
23,5,12,3,15,13,5,12,25,113
23,5,12,3,15,13,5,18,0,94
23,5,12,3,15,13,5,18,19,113
23,5,12,3,15,13,5,19,0,95
23,5,12,4,1,2,12,5,0,64
23,5,12,4,5,4,0,0,0,53
23,5,12,4,5,18,0,0,0,67
23,5,12,4,5,18,19,0,0,86
23,5,12,4,9,14,7,0,0,74
23,5,12,4,12,5,19,19,0,99
23,5,12,4,13,5,14,20,0,96
23,5,12,4,13,5,14,20,19,115
23,5,12,4,15,18,0,0,0,77
23,5,12,4,15,18,19,0,0,96
23,5,12,4,19,0,0,0,0,63
23,5,12,6,1,18,5,0,0,70
23,5,12,6,1,18,5,19,0,89
23,5,12,6,1,18,9,14,7,95
23,5,12,6,1,18,9,19,13,106
23,5,12,6,1,18,9,19,20,113
23,5,12,9,0,0,0,0,0,49
23,5,12,11,0,0,0,0,0,51
23,5,12,11,9,14,0,0,0,74
23,5,12,11,9,14,19,0,0,93
23,5,12,12,1,4,1,25,0,83
23,5,12,12,1,4,1,25,19,102
23,5,12,12,1,20,0,0,0,73
23,5,12,12,1,23,1,25,0,102
23,5,12,12,1,23,1,25,19,121
23,5,12,12,2,5,9,14,7,89
23,5,12,12,2,18,5,4,0,81
23,5,12,12,3,21,18,2,0,96
23,5,12,12,3,21,18,2,19,115
23,5,12,12,4,15,5,18,0,94
23,5,12,12,4,15,5,18,19,113
23,5,12,12,4,15,9,14,7,101
23,5,12,12,4,15,14,5,0,90
23,5,12,12,5,4,0,0,0,61
23,5,12,12,6,15,21,14,4,112
23,5,12,12,8,5,1,4,0,70
23,5,12,12,8,5,1,4,19,89
23,5,12,12,8,15,12,5,0,92
23,5,12,12,8,15,12,5,19,111
23,5,12,12,8,15,21,19,5,120
23,5,12,12,25,0,0,0,0,77
23,5,12,12,25,1,18,4,0,100
23,5,12,12,9,5,0,0,0,66
23,5,12,12,9,5,19,0,0,85
23,5,12,12,9,19,8,0,0,88
23,5,12,12,11,14,15,23,14,129
23,5,12,12,13,1,11,5,18,100
23,5,12,12,13,5,14,0,0,84
23,5,12,12,13,15,19,20,0,119
23,5,12,12,14,5,1,18,0,90
23,5,12,12,14,5,19,19,0,109
23,5,12,12,14,9,7,8,0,90
23,5,12,12,16,15,9,14,20,126
23,5,12,12,17,21,5,13,5,113
23,5,12,12,18,5,1,4,0,80
23,5,12,12,18,9,14,7,0,100
23,5,12,12,19,5,5,14,0,95
23,5,12,12,19,5,20,0,0,96
23,5,12,12,19,9,4,5,0,89
23,5,12,12,19,9,20,5,0,105
23,5,12,12,19,9,20,5,19,124
23,5,12,12,19,20,5,1,4,101
23,5,12,19,2,1,3,8,0,73
23,5,12,19,8,5,4,0,0,76
23,5,12,19,8,5,18,0,0,90
23,5,12,19,8,5,18,19,0,109
23,5,12,19,8,5,19,0,0,91
23,5,12,19,8,9,14,7,0,97
23,5,12,19,9,21,13,0,0,102
23,5,12,19,15,13,0,0,0,87
23,5,12,20,0,0,0,0,0,60
23,5,12,20,5,4,0,0,0,69
23,5,12,20,5,18,0,0,0,83
23,5,12,20,5,18,5,4,0,92
23,5,12,20,5,18,9,14,7,113
23,5,12,20,5,18,19,0,0,102
23,5,12,20,9,14,7,0,0,90
23,5,12,20,9,14,7,19,0,109
23,5,12,20,19,0,0,0,0,79
23,5,13,0,0,0,0,0,0,41
23,5,13,12,5,19,19,0,0,96
23,5,13,13,25,0,0,0,0,79
23,5,13,15,4,14,5,19,19,117
23,5,14,0,0,0,0,0,0,42
23,5,14,3,8,0,0,0,0,53
23,5,14,3,8,5,4,0,0,62
23,5,14,3,8,5,12,0,0,70
23,5,14,3,8,5,18,0,0,76
23,5,14,3,8,5,18,19,0,95
23,5,14,3,8,5,19,0,0,77
23,5,14,3,8,9,14,7,0,83
23,5,14,3,8,12,5,19,19,108
23,5,14,3,8,12,9,11,5,90
23,5,14,3,8,13,1,14,0,81
23,5,14,3,8,13,5,14,0,85
23,5,14,4,5,4,0,0,0,55
23,5,14,4,9,7,15,0,0,77
23,5,14,4,9,7,15,19,0,96
23,5,14,4,9,14,7,0,0,76
23,5,14,4,19,0,0,0,0,65
23,5,14,5,0,0,0,0,0,47
23,5,14,5,20,8,0,0,0,75
23,5,14,12,9,3,8,5,0,79
23,5,14,14,25,0,0,0,0,81
23,5,14,14,9,5,18,0,0,88
23,5,14,14,9,5,19,20,0,109
23,5,14,14,9,19,8,0,0,92
23,5,14,19,0,0,0,0,0,61
23,5,14,20,0,0,0,0,0,62
23,5,14,20,12,5,0,0,0,79
23,5,16,13,1,14,0,0,0,72
23,5,16,13,1,14,11,9,14,106
23,5,16,20,0,0,0,0,0,64
23,5,18,0,0,0,0,0,0,46
23,5,18,5,0,0,0,0,0,51
23,5,18,5,1,19,19,0,0,90
23,5,18,5,2,5,1,18,0,77
23,5,18,5,2,15,1,18,0,87
23,5,18,5,3,1,12,6,0,73
23,5,18,5,3,1,20,0,0,75
23,5,18,5,6,15,12,11,0,95
23,5,18,5,6,15,24,0,0,96
23,5,18,5,7,9,12,4,0,83
23,5,18,5,7,9,12,4,19,102
23,5,18,5,8,1,18,5,0,83
23,5,18,5,8,25,5,14,1,104
23,5,18,5,12,9,15,14,0,101
23,5,18,5,14,0,0,0,0,65
23,5,18,5,14,20,0,0,0,85
23,5,18,5,20,9,7,5,18,110
23,5,18,5,23,1,12,12,0,99
23,5,18,5,23,15,12,6,0,107
23,5,18,6,0,0,0,0,0,52
23,5,18,7,5,12,4,0,0,74
23,5,18,7,5,12,4,19,0,93
23,5,18,7,5,12,20,0,0,90
23,5,18,7,5,12,20,19,0,109
23,5,18,7,9,12,0,0,0,74
23,5,18,7,9,12,4,0,0,78
23,5,18,7,9,12,4,19,0,97
23,5,18,9,0,0,0,0,0,55
23,5,18,9,14,7,0,0,0,76
23,5,18,13,5,20,8,5,0,97
23,5,18,14,1,18,4,0,0,83
23,5,18,14,5,18,9,20,5,117
23,5,18,15,15,12,5,0,0,93
23,5,18,15,23,1,14,3,5,107
23,5,18,19,8,0,0,0,0,73
23,5,18,19,12,5,20,5,0,107
23,5,18,19,20,5,0,0,0,90
23,5,18,20,0,0,0,0,0,66
23,5,18,22,5,12,0,0,0,85
23,5,18,23,15,12,6,0,0,102
23,5,18,23,15,12,22,5,19,142
23,5,19,5,0,0,0,0,0,52
23,5,19,11,9,20,0,0,0,87
23,5,19,11,9,20,19,0,0,106
23,5,19,12,5,25,1,14,19,123
23,5,19,19,1,14,4,0,0,85
23,5,19,19,1,14,4,19,0,104
23,5,19,19,5,12,0,0,0,83
23,5,19,19,5,12,20,15,14,132
23,5,19,20,1,2,15,21,20,126
23,5,19,20,1,23,1,25,0,117
23,5,19,20,2,15,21,14,4,123
23,5,19,20,5,0,0,0,0,72
23,5,19,20,5,18,5,4,0,99
23,5,19,20,5,18,9,14,7,120
23,5,19,20,5,18,14,12,25,141
23,5,19,20,5,18,14,19,0,123
23,5,19,20,5,18,19,0,0,109
23,5,19,20,8,1,13,0,0,89
23,5,19,20,25,0,0,0,0,92
23,5,19,20,9,14,7,0,0,97
23,5,19,20,9,14,7,19,0,116
23,5,19,20,12,1,14,0,0,94
23,5,19,20,12,1,23,0,0,103
23,5,19,20,12,9,14,0,0,102
23,5,19,20,12,9,14,7,0,109
23,5,19,20,12,9,14,7,19,128
23,5,19,20,12,9,14,19,0,121
23,5,19,20,13,5,0,0,0,85
23,5,19,20,13,15,19,20,0,134
23,5,19,20,14,5,19,19,0,124
23,5,19,20,19,0,0,0,0,86
23,5,19,20,23,1,18,4,0,113
23,5,19,20,23,1,18,4,19,132
23,5,19,20,23,15,18,11,0,134
23,5,20,0,0,0,0,0,0,48
23,5,20,1,0,0,0,0,0,49
23,5,20,2,1,3,11,0,0,65
23,5,20,2,1,3,11,19,0,84
23,5,20,2,9,18,4,0,0,81
23,5,20,3,8,5,4,0,0,68
23,5,20,3,8,5,20,0,0,84
23,5,20,8,5,18,0,0,0,79
23,5,20,8,5,18,8,15,7,109
23,5,20,8,5,18,19,0,0,98
23,5,20,8,5,18,20,5,7,111
23,5,20,12,1,14,4,0,0,79
23,5,20,12,1,14,4,19,0,98
23,5,20,12,25,0,0,0,0,85
23,5,20,14,5,19,19,0,0,105
23,5,20,14,5,19,19,5,19,129
23,5,20,16,18,15,15,6,0,118
23,5,20,19,0,0,0,0,0,67
23,5,20,19,21,9,20,0,0,117
23,5,20,20,1,2,12,5,0,88
23,5,20,20,5,4,0,0,0,77
23,5,20,20,5,18,0,0,0,91
23,5,20,20,5,18,19,0,0,110
23,5,20,20,5,19,20,0,0,112
23,5,20,20,9,14,7,0,0,98
23,5,20,20,9,14,7,19,0,117
23,5,20,20,9,19,8,0,0,104
23,5,22,5,0,0,0,0,0,55
23,5,22,5,20,0,0,0,0,75
23,8,5,1,12,0,0,0,0,49
23,8,5,1,12,5,4,0,0,58
23,8,5,1,12,25,0,0,0,74
23,8,5,1,12,9,14,7,0,79
23,8,5,1,12,19,0,0,0,68
23,8,5,1,12,23,15,18,13,118
23,8,5,1,13,0,0,0,0,50
23,8,5,1,20,0,0,0,0,57
23,8,5,1,20,2,9,18,4,90
23,8,5,1,20,5,1,18,0,81
23,8,5,1,20,5,1,18,19,100
23,8,5,1,20,5,14,0,0,76
23,8,5,1,20,5,14,19,0,95
23,8,5,1,20,25,0,0,0,82
23,8,5,1,20,9,5,19,0,90
23,8,5,1,20,12,5,19,19,112
23,8,5,1,20,12,9,11,5,94
23,8,5,1,20,13,5,1,12,88
23,8,5,1,20,19,0,0,0,76
23,8,5,1,20,23,15,18,13,126
23,8,5,4,4,5,18,0,0,67
23,8,5,5,0,0,0,0,0,41
23,8,5,5,4,12,5,0,0,62
23,8,5,5,4,12,5,4,0,66
23,8,5,5,4,12,5,18,0,80
23,8,5,5,4,12,5,18,19,99
23,8,5,5,4,12,5,19,0,81
23,8,5,5,4,12,9,14,7,87
23,8,5,5,12,0,0,0,0,53
23,8,5,5,12,1,7,5,0,66
23,8,5,5,12,2,1,14,4,74
23,8,5,5,12,2,1,19,5,80
23,8,5,5,12,2,9,18,4,86
23,8,5,5,12,2,15,24,0,94
23,8,5,5,12,4,15,13,0,85
23,8,5,5,12,5,4,0,0,62
23,8,5,5,12,5,18,25,0,101
23,8,5,5,12,5,18,19,0,95
23,8,5,5,12,25,0,0,0,78
23,8,5,5,12,9,5,0,0,67
23,8,5,5,12,9,5,19,0,86
23,8,5,5,12,9,14,7,19,102
23,8,5,5,12,12,5,19,19,108
23,8,5,5,12,12,9,11,5,90
23,8,5,5,12,13,1,14,0,81
23,8,5,5,12,13,5,14,0,85
23,8,5,5,12,18,1,3,5,80
23,8,5,5,12,18,15,1,4,91
23,8,5,5,12,19,0,0,0,72
23,8,5,5,12,19,13,1,14,100
23,8,5,5,12,19,13,5,14,104
23,8,5,5,12,19,16,9,14,111
23,8,5,5,12,23,1,25,0,102
23,8,5,5,12,23,9,19,5,109
23,8,5,5,12,23,15,18,11,120
23,8,5,5,13,0,0,0,0,54
23,8,5,5,14,0,0,0,0,55
23,8,5,5,14,3,1,20,0,79
23,8,5,5,14,7,5,0,0,67
23,8,5,5,14,19,0,0,0,74
23,8,5,5,16,0,0,0,0,57
23,8,5,5,16,5,4,0,0,66
23,8,5,5,16,9,14,7,0,87
23,8,5,5,16,12,5,0,0,74
23,8,5,5,16,12,5,4,0,78
23,8,5,5,16,12,5,19,0,93
23,8,5,5,16,12,9,14,7,99
23,8,5,5,16,19,0,0,0,76
23,8,5,5,18,0,0,0,0,59
23,8,5,5,19,0,0,0,0,60
23,8,5,5,19,8,20,0,0,88
23,8,5,5,20,12,5,0,0,78
23,8,5,5,26,5,0,0,0,72
23,8,5,5,26,5,4,0,0,76
23,8,5,5,26,5,18,0,0,90
23,8,5,5,26,5,18,19,0,109
23,8,5,5,26,5,19,0,0,91
23,8,5,5,26,25,0,0,0,92
23,8,5,5,26,9,5,18,0,99
23,8,5,5,26,9,5,19,20,120
23,8,5,5,26,9,12,25,0,113
23,8,5,5,26,9,14,7,0,97
23,8,5,5,26,12,5,0,0,84
23,8,5,6,20,0,0,0,0,62
23,8,5,25,0,0,0,0,0,61
23,8,5,25,2,5,1,18,4,91
23,8,5,25,2,9,18,4,0,94
23,8,5,25,5,25,0,0,0,91
23,8,5,25,6,1,3,5,0,76
23,8,5,25,6,1,3,5,4,80
23,8,5,25,6,1,3,5,19,95
23,8,5,25,9,19,8,0,0,97
23,8,5,25,12,9,11,5,0,98
23,8,5,9,14,0,0,0,0,59
23,8,5,25,14,5,19,19,0,118
23,8,5,25,19,0,0,0,0,80
23,8,5,25,23,15,18,13,0,130
23,8,5,11,1,21,0,0,0,69
23,8,5,11,9,0,0,0,0,56
23,8,5,12,11,0,0,0,0,59
23,8,5,12,11,5,4,0,0,68
23,8,5,12,11,5,18,0,0,82
23,8,5,12,11,25,0,0,0,84
23,8,5,12,11,9,5,18,0,91
23,8,5,12,11,9,5,19,20,112
23,8,5,12,11,12,9,11,5,96
23,8,5,12,11,19,0,0,0,78
23,8,5,12,13,0,0,0,0,61
23,8,5,12,13,5,4,0,0,70
23,8,5,12,13,9,14,7,0,91
23,8,5,12,13,19,0,0,0,80
23,8,5,12,16,0,0,0,0,64
23,8,5,12,16,5,4,0,0,73
23,8,5,12,16,8,15,15,4,106
23,8,5,12,16,9,14,7,0,94
23,8,5,12,16,9,19,8,0,100
23,8,5,12,16,12,5,19,19,119
23,8,5,12,16,12,9,14,7,106
23,8,5,12,16,19,0,0,0,83
23,8,5,12,22,5,0,0,0,75
23,8,5,13,13,5,12,0,0,79
23,8,5,13,13,12,5,0,0,79
23,8,5,14,0,0,0,0,0,50
23,8,5,14,1,19,0,0,0,70
23,8,5,14,3,5,0,0,0,58
23,8,5,14,3,5,5,5,18,86
23,8,5,14,3,5,22,5,18,103
23,8,5,14,5,5,18,0,0,78
23,8,5,14,5,22,5,18,0,100
23,8,5,14,14,5,19,19,0,107
23,8,5,14,19,0,0,0,0,69
23,8,5,14,19,15,0,0,0,84
23,8,5,18,5,0,0,0,0,59
23,8,5,18,5,1,19,0,0,79
23,8,5,18,5,1,19,5,19,103
23,8,5,18,5,1,20,0,0,80
23,8,5,18,5,1,23,1,25,109
23,8,5,18,5,2,25,0,0,86
23,8,5,18,5,4,0,0,0,63
23,8,5,18,5,5,18,0,0,82
23,8,5,18,5,6,15,18,0,98
23,8,5,18,5,6,15,18,5,103
23,8,5,18,5,6,18,15,13,111
23,8,5,18,5,9,14,0,0,82
23,8,5,18,5,9,14,20,15,117
23,8,5,18,5,9,19,0,0,87
23,8,5,18,5,14,5,19,19,116
23,8,5,18,5,15,6,0,0,80
23,8,5,18,5,15,14,0,0,88
23,8,5,18,5,15,21,20,0,115
23,8,5,18,5,15,22,5,18,119
23,8,5,18,5,18,5,0,0,82
23,8,5,18,5,19,0,0,0,78
23,8,5,18,5,19,15,0,0,93
23,8,5,18,5,20,9,12,12,112
23,8,5,18,5,20,15,0,0,94
23,8,5,18,5,21,14,20,15,129
23,8,5,18,5,21,16,0,0,96
23,8,5,18,5,21,16,15,14,125
23,8,5,18,5,22,5,18,0,104
23,8,5,18,5,23,9,20,8,119
23,8,5,18,18,5,20,0,0,97
23,8,5,18,18,25,0,0,0,97
23,8,5,18,18,9,5,4,0,90
23,8,5,18,18,9,5,19,0,105
23,8,5,18,18,25,9,14,7,127
23,8,5,18,18,25,13,1,14,125
23,8,5,18,18,9,20,0,0,101
23,8,5,18,22,5,0,0,0,81
23,8,5,18,22,5,19,0,0,100
23,8,5,19,20,5,14,0,0,94
23,8,5,20,0,0,0,0,0,56
23,8,5,20,8,5,18,0,0,87
23,8,5,20,9,12,5,0,0,82
23,8,5,20,18,15,3,11,0,103
23,8,5,20,19,0,0,0,0,75
23,8,5,20,20,5,4,0,0,85
23,8,5,20,20,5,18,0,0,99
23,8,5,20,20,5,18,19,0,118
23,8,5,20,20,9,14,7,0,106
23,8,5,23,0,0,0,0,0,59
23,8,5,23,5,18,0,0,0,82
23,8,5,23,12,0,0,0,0,71
23,8,5,23,19,0,0,0,0,78
23,8,5,23,20,0,0,0,0,79
23,8,6,0,0,0,0,0,0,37
23,8,25,0,0,0,0,0,0,56
23,8,9,2,1,0,0,0,0,43
23,8,9,3,8,0,0,0,0,51
23,8,9,3,8,5,22,5,18,101
23,8,9,3,8,23,1,25,0,100
23,8,9,3,8,23,1,25,19,119
23,8,9,3,11,5,14,0,0,73
23,8,9,3,11,5,18,0,0,77
23,8,9,3,11,5,18,5,4,86
23,8,9,3,11,5,18,19,0,96
23,8,9,4,0,0,0,0,0,44
23,8,9,4,1,8,0,0,0,53
23,8,25,4,1,8,0,0,0,69
23,8,9,4,1,8,19,0,0,72
23,8,25,4,1,8,19,0,0,88
23,8,9,4,4,5,4,0,0,57
23,8,9,4,4,5,18,0,0,71
23,8,9,4,4,9,14,7,0,78
23,8,9,4,19,0,0,0,0,63
23,8,25,5,22,5,18,0,0,106
23,8,9,6,6,0,0,0,0,52
23,8,9,6,6,1,2,12,5,72
23,8,9,6,6,5,4,0,0,61
23,8,9,6,6,5,18,0,0,75
23,8,9,6,6,5,18,19,0,94
23,8,9,6,6,5,20,0,0,77
23,8,9,6,6,5,20,19,0,96
23,8,9,6,6,25,0,0,0,77
23,8,9,6,6,9,14,7,0,82
23,8,9,6,6,12,5,0,0,69
23,8,9,6,6,12,5,4,0,73
23,8,9,6,6,12,5,18,0,87
23,8,9,6,6,12,5,18,25,112
23,8,9,6,6,12,5,18,19,106
23,8,9,6,6,12,5,19,0,88
23,8,9,6,6,12,9,14,7,94
23,8,9,6,6,19,0,0,0,71
23,8,25,6,15,18,0,0,0,95
23,8,9,6,20,0,0,0,0,66
23,8,9,7,7,5,4,0,0,63
23,8,9,7,7,9,14,7,0,84
23,8,9,7,19,0,0,0,0,66
23,8,9,7,19,8,9,16,0,99
23,8,9,11,5,18,2,25,0,101
23,8,9,12,5,0,0,0,0,57
23,8,9,12,5,1,19,0,0,77
23,8,9,12,5,4,0,0,0,61
23,8,9,12,5,5,14,0,0,76
23,8,9,12,5,25,0,0,0,82
23,8,9,12,5,14,4,0,0,75
23,8,9,12,5,18,5,0,0,80
23,8,9,12,5,19,0,0,0,76
23,8,9,12,9,5,0,0,0,66
23,8,9,12,9,14,7,0,0,82
23,8,9,12,11,0,0,0,0,63
23,8,9,12,12,0,0,0,0,64
23,8,9,12,12,1,12,15,15,107
23,8,9,12,12,25,0,0,0,89
23,8,9,12,12,9,12,5,23,113
23,8,9,12,12,25,23,8,1,121
23,8,9,12,15,3,11,0,0,81
23,8,9,12,15,13,0,0,0,80
23,8,9,12,19,0,0,0,0,71
23,8,9,12,19,20,0,0,0,91
23,8,9,12,20,5,18,0,0,95
23,8,9,13,0,0,0,0,0,53
23,8,9,13,2,5,18,18,25,121
23,8,9,13,2,12,5,0,0,72
23,8,9,13,2,18,5,12,0,90
23,8,9,13,2,18,5,12,19,109
23,8,9,13,12,9,14,7,0,95
23,8,9,13,13,5,4,0,0,75
23,8,9,13,13,25,0,0,0,91
23,8,9,13,13,9,5,18,0,98
23,8,9,13,13,9,5,19,20,119
23,8,9,13,13,9,14,7,0,96
23,8,9,13,16,5,18,0,0,92
23,8,9,13,16,5,18,5,4,101
23,8,9,13,16,5,18,5,18,115
23,8,9,13,16,5,18,19,0,111
23,8,9,13,19,0,0,0,0,72
23,8,9,13,19,5,25,0,0,102
23,8,9,13,19,5,25,19,0,121
23,8,9,13,19,25,0,0,0,97
23,8,9,13,19,9,3,0,0,84
23,8,9,13,19,9,3,1,12,97
23,8,9,13,19,9,5,4,0,90
23,8,9,13,19,9,5,19,0,105
23,8,9,13,19,20,15,14,5,126
23,8,9,13,23,8,1,13,0,98
23,8,9,13,23,8,1,13,19,117
23,8,9,14,0,0,0,0,0,54
23,8,9,14,2,5,18,18,25,122
23,8,9,14,3,8,1,20,0,86
23,8,9,14,3,8,1,20,19,105
23,8,9,14,3,8,5,3,11,84
23,8,9,14,3,15,23,0,0,95
23,8,9,14,4,12,5,0,0,75
23,8,9,14,5,0,0,0,0,59
23,8,9,14,5,4,0,0,0,63
23,8,9,14,5,18,0,0,0,77
23,8,9,14,5,18,19,0,0,96
23,8,9,14,5,19,0,0,0,78
23,8,25,14,5,19,19,0,0,113
23,8,9,14,7,0,0,0,0,61
23,8,9,14,7,5,0,0,0,66
23,8,9,14,7,5,4,0,0,70
23,8,9,14,7,5,18,0,0,84
23,8,9,14,7,5,19,0,0,85
23,8,9,14,25,0,0,0,0,79
23,8,9,14,25,1,18,4,0,102
23,8,9,14,9,5,18,0,0,86
23,8,9,14,9,5,19,20,0,107
23,8,9,14,9,14,5,19,19,120
23,8,9,14,9,14,7,0,0,84
23,8,9,14,9,14,7,12,25,121
23,8,9,14,14,5,12,0,0,85
23,8,9,14,14,5,18,0,0,91
23,8,9,14,14,25,0,0,0,93
23,8,9,14,14,9,5,4,0,86
23,8,9,14,14,9,5,18,0,100
23,8,9,14,14,9,5,19,0,101
23,8,9,14,14,9,5,19,20,121
23,8,9,14,14,25,9,14,7,123
23,8,9,14,14,15,3,11,0,97
23,8,9,14,19,0,0,0,0,73
23,8,9,14,19,20,15,14,5,127
23,8,25,15,0,0,0,0,0,71
23,8,9,16,0,0,0,0,0,56
23,8,9,16,2,5,12,12,25,112
23,8,9,16,2,9,18,4,0,89
23,8,9,16,3,1,20,0,0,80
23,8,9,16,3,15,18,4,0,96
23,8,9,16,3,15,18,4,25,121
23,8,9,16,3,15,18,4,19,115
23,8,9,16,3,18,1,3,11,92
23,8,9,16,3,18,1,6,20,104
23,8,9,16,7,18,1,6,20,108
23,8,9,16,10,1,3,11,0,81
23,8,9,16,11,9,14,7,0,97
23,8,9,16,12,1,19,8,0,96
23,8,9,16,12,9,11,5,0,93
23,8,9,16,13,1,11,5,18,104
23,8,9,16,13,1,14,0,0,84
23,8,9,16,16,1,0,0,0,73
23,8,9,16,16,1,2,12,5,92
23,8,9,16,16,1,18,5,5,101
23,8,9,16,16,5,4,0,0,81
23,8,9,16,16,5,18,0,0,95
23,8,9,16,16,5,18,19,0,114
23,8,9,16,16,5,20,0,0,97
23,8,9,16,16,5,20,5,18,120
23,8,9,16,16,5,20,19,0,116
23,8,9,16,16,25,0,0,0,97
23,8,9,16,16,9,5,18,0,104
23,8,9,16,16,9,5,19,20,125
23,8,9,16,16,9,14,7,0,102
23,8,9,16,16,9,14,7,19,121
23,8,9,16,16,15,19,20,0,126
23,8,9,16,18,1,25,0,0,100
23,8,9,16,18,1,25,19,0,119
23,8,9,16,19,0,0,0,0,75
23,8,9,16,19,1,23,0,0,99
23,8,9,16,19,1,23,5,4,108
23,8,9,16,19,1,23,14,0,113
23,8,9,16,19,1,23,19,0,118
23,8,9,16,19,8,9,16,0,108
23,8,9,16,19,20,1,6,6,108
23,8,9,16,19,20,1,12,11,119
23,8,9,16,19,20,1,12,12,120
23,8,9,16,19,20,5,18,0,118
23,8,9,16,19,20,9,3,11,118
23,8,9,16,19,20,15,3,11,124
23,8,9,16,20,0,0,0,0,76
23,8,9,16,20,1,9,12,0,98
23,8,9,16,20,1,9,12,19,117
23,8,9,16,20,18,5,5,0,104
23,8,9,16,23,9,19,5,0,112
23,8,9,16,23,15,18,13,0,125
23,8,9,16,23,15,18,13,19,144
23,8,9,18,0,0,0,0,0,58
23,8,9,18,11,5,14,0,0,88
23,8,9,18,12,0,0,0,0,70
23,8,9,18,12,2,1,20,0,93
23,8,9,18,12,2,15,14,5,106
23,8,9,18,12,5,4,0,0,79
23,8,9,18,12,5,25,0,0,100
23,8,9,18,12,5,18,0,0,93
23,8,9,18,12,5,18,19,0,112
23,8,9,18,12,7,9,7,0,93
23,8,9,18,12,25,0,0,0,95
23,8,9,18,12,9,5,18,0,102
23,8,9,18,12,9,5,19,0,103
23,8,9,18,12,9,5,19,20,123
23,8,9,18,12,9,7,9,7,102
23,8,9,18,12,9,14,7,0,100
23,8,9,18,12,16,9,20,0,115
23,8,9,18,12,16,15,15,12,128
23,8,9,18,12,16,21,6,6,119
23,8,9,18,12,19,0,0,0,89
23,8,9,18,12,23,9,7,0,109
23,8,9,18,12,23,9,14,4,120
23,8,9,18,18,0,0,0,0,76
23,8,9,18,18,5,4,0,0,85
23,8,9,18,18,5,25,0,0,106
23,8,9,18,18,5,20,0,0,101
23,8,9,18,18,25,0,0,0,101
23,8,9,18,18,9,3,11,0,99
23,8,9,18,18,9,5,4,0,94
23,8,9,18,18,9,5,19,0,109
23,8,9,18,18,25,9,14,7,131
23,8,9,18,18,9,14,7,0,106
23,8,9,18,18,15,15,0,0,106
23,8,9,18,18,19,0,0,0,95
23,8,9,18,19,0,0,0,0,77
23,8,9,18,20,12,5,0,0,95
23,8,25,19,0,0,0,0,0,75
23,8,9,19,8,0,0,0,0,67
23,8,9,19,8,5,4,0,0,76
23,8,9,19,8,5,19,0,0,91
23,8,9,19,8,9,14,7,0,97
23,8,9,19,8,20,0,0,0,87
23,8,9,19,8,20,5,4,0,96
23,8,9,19,8,20,9,14,7,117
23,8,9,19,8,20,19,0,0,106
23,8,9,19,11,0,0,0,0,70
23,8,9,19,11,5,4,0,0,79
23,8,9,19,11,5,25,0,0,100
23,8,9,19,11,5,25,19,0,119
23,8,9,19,11,5,18,0,0,93
23,8,9,19,11,5,18,5,4,102
23,8,9,19,11,5,18,5,18,116
23,8,9,19,11,5,18,25,0,118
23,8,9,19,11,5,18,19,0,112
23,8,9,19,11,5,20,0,0,95
23,8,9,19,11,6,21,12,0,109
23,8,9,19,11,25,0,0,0,95
23,8,9,19,11,9,5,4,0,88
23,8,9,19,11,9,5,19,0,103
23,8,9,19,11,9,14,0,0,93
23,8,9,19,11,9,14,7,0,100
23,8,9,19,11,19,0,0,0,89
23,8,9,19,16,0,0,0,0,75
23,8,9,19,16,5,18,0,0,98
23,8,9,19,16,5,18,5,4,107
23,8,9,19,16,5,18,5,18,121
23,8,9,19,16,5,18,25,0,123
23,8,9,19,16,5,18,19,0,117
23,8,9,19,19,0,0,0,0,78
23,8,9,19,19,12,5,0,0,95
23,8,9,19,20,0,0,0,0,79
23,8,9,19,20,5,4,0,0,88
23,8,9,19,20,5,18,0,0,102
23,8,9,19,20,9,14,7,0,109
23,8,9,19,20,12,5,0,0,96
23,8,9,19,20,12,5,4,0,100
23,8,9,19,20,12,5,18,19,133
23,8,9,19,20,12,5,19,0,115
23,8,9,19,20,12,25,0,0,116
23,8,9,19,20,12,9,11,5,116
23,8,9,19,20,12,9,14,7,121
23,8,9,19,20,14,5,19,19,136
23,8,9,19,20,19,0,0,0,98
23,8,9,20,2,12,15,23,0,112
23,8,9,20,5,1,3,18,5,92
23,8,9,20,5,2,1,3,11,82
23,8,9,20,5,2,1,9,20,97
23,8,9,20,5,2,1,18,11,97
23,8,9,20,5,2,5,1,13,86
23,8,9,20,5,2,5,12,20,104
23,8,9,20,5,2,9,12,12,100
23,8,9,20,5,2,12,15,23,117
23,8,9,20,5,3,1,16,0,85
23,8,9,20,5,3,1,16,19,104
23,8,9,20,5,3,15,1,20,104
23,8,9,20,5,3,15,13,2,98
23,8,9,20,5,3,15,18,14,115
23,8,9,20,5,3,21,16,0,105
23,8,9,20,5,4,0,0,0,69
23,8,9,20,5,4,1,13,16,99
23,8,9,20,5,6,1,3,5,80
23,8,9,20,5,6,5,5,20,101
23,8,9,20,5,6,12,25,0,108
23,8,9,20,5,8,1,19,19,112
23,8,9,20,5,25,0,0,0,90
23,8,9,20,5,25,19,0,0,109
23,8,9,20,5,12,25,0,0,102
23,8,9,20,5,12,9,11,5,102
23,8,9,20,5,12,9,14,5,105
23,8,9,20,5,14,0,0,0,79
23,8,9,20,5,14,5,4,0,88
23,8,9,20,5,14,5,18,0,102
23,8,9,20,5,14,5,18,19,121
23,8,9,20,5,14,5,19,19,122
23,8,9,20,5,14,9,14,7,109
23,8,9,20,5,14,15,19,5,118
23,8,9,20,5,14,19,0,0,98
23,8,9,20,5,15,21,20,0,121
23,8,9,20,5,15,21,20,19,140
23,8,9,20,5,16,15,20,0,116
23,8,9,20,5,18,0,0,0,83
23,8,9,20,5,18,15,15,20,133
23,8,9,20,5,18,21,13,16,133
23,8,9,20,5,19,0,0,0,84
23,8,9,20,5,19,1,18,11,114
23,8,9,20,5,19,5,1,13,103
23,8,9,20,5,19,20,0,0,104
23,8,9,20,5,20,1,9,12,107
23,8,9,20,5,20,9,16,0,110
23,8,9,20,5,20,15,16,0,116
23,8,9,20,5,22,5,9,14,115
23,8,9,20,5,23,1,12,12,113
23,8,9,20,5,23,1,18,5,112
23,8,9,20,5,23,1,19,8,116
23,8,9,20,5,23,5,5,4,102
23,8,9,20,5,23,9,14,7,118
23,8,9,20,5,23,15,18,13,134
23,8,9,20,5,23,15,18,20,141
23,8,9,20,6,9,14,3,8,100
23,8,9,20,8,5,18,0,0,91
23,8,9,20,8,5,18,19,15,125
23,8,9,20,8,5,18,20,15,126
23,8,9,20,25,0,0,0,0,85
23,8,9,20,9,5,18,0,0,92
23,8,9,20,9,5,19,0,0,93
23,8,9,20,9,5,19,20,0,113
23,8,9,20,9,14,0,0,0,83
23,8,9,20,9,14,7,19,0,109
23,8,9,20,9,19,8,0,0,96
23,8,9,20,12,9,14,7,0,102
23,8,9,20,12,15,23,0,0,110
23,8,9,20,12,15,23,19,0,129
23,8,9,20,18,1,3,11,0,93
23,8,9,20,18,1,3,11,19,112
23,8,9,20,18,5,20,0,0,103
23,8,9,20,19,0,0,0,0,79
23,8,9,20,19,20,5,18,0,122
23,8,9,20,20,1,23,0,0,104
23,8,9,20,20,1,23,5,18,127
23,8,9,20,20,5,14,5,18,122
23,8,9,20,20,5,18,0,0,103
23,8,9,20,20,5,18,19,0,122
23,8,9,20,20,12,5,4,0,101
23,8,9,20,20,12,5,18,0,115
23,8,9,20,20,12,5,18,19,134
23,8,9,20,20,12,5,19,0,116
23,8,9,20,20,12,9,14,7,122
23,8,9,20,20,18,5,20,0,123
23,8,9,20,20,18,5,20,19,142
23,8,9,20,20,18,9,3,11,121
23,8,9,26,0,0,0,0,0,66
23,8,9,26,2,1,14,7,0,90
23,8,9,26,2,1,14,7,19,109
23,8,9,26,7,9,7,0,0,89
23,8,9,26,26,0,0,0,0,92
23,8,9,26,26,2,1,14,7,116
23,8,9,26,26,5,4,0,0,101
23,8,9,26,26,5,18,0,0,115
23,8,9,26,26,5,18,19,0,134
23,8,9,26,26,5,19,0,0,116
23,8,9,26,26,9,14,7,0,122
23,8,9,26,26,12,5,0,0,109
23,8,15,1,0,0,0,0,0,47
23,8,15,1,19,0,0,0,0,66
23,8,15,4,0,0,0,0,0,50
23,8,15,4,21,14,9,20,0,114
23,8,15,4,21,14,9,20,19,133
23,8,15,4,21,14,14,9,20,128
23,8,15,5,22,5,18,0,0,96
23,8,15,12,5,0,0,0,0,63
23,8,15,12,5,6,15,15,4,103
23,8,15,12,5,12,25,0,0,100
23,8,15,12,5,13,5,1,12,94
23,8,15,12,5,14,5,19,19,120
23,8,15,12,5,19,0,0,0,82
23,8,15,12,5,19,1,12,5,100
23,8,15,12,5,19,15,13,5,115
23,8,15,12,5,20,15,14,5,117
23,8,15,12,5,23,9,19,5,119
23,8,15,12,9,19,13,0,0,99
23,8,15,12,9,19,13,19,0,118
23,8,15,12,9,19,20,9,3,118
23,8,15,12,12,0,0,0,0,70
23,8,15,12,12,25,0,0,0,95
23,8,15,13,0,0,0,0,0,59
23,8,15,13,2,12,5,0,0,78
23,8,15,13,5,22,5,18,0,109
23,8,15,13,16,0,0,0,0,75
23,8,15,13,16,5,4,0,0,84
23,8,15,13,16,9,14,7,0,105
23,8,15,13,16,19,0,0,0,94
23,8,15,13,19,15,0,0,0,93
23,8,15,14,5,0,0,0,0,65
23,8,15,15,0,0,0,0,0,61
23,8,15,15,6,0,0,0,0,67
23,8,15,15,6,5,4,0,0,76
23,8,15,15,6,9,14,7,0,97
23,8,15,15,6,19,0,0,0,86
23,8,15,15,16,0,0,0,0,77
23,8,15,15,16,5,0,0,0,82
23,8,15,15,16,5,4,0,0,86
23,8,15,15,16,5,5,0,0,87
23,8,15,15,16,5,5,19,0,106
23,8,15,15,16,5,18,0,0,100
23,8,15,15,16,5,18,19,0,119
23,8,15,15,16,9,14,7,0,107
23,8,15,15,16,12,1,0,0,90
23,8,15,15,16,12,1,19,0,109
23,8,15,15,16,12,9,11,5,114
23,8,15,15,16,19,0,0,0,96
23,8,15,15,19,5,19,0,0,104
23,8,15,15,19,8,0,0,0,88
23,8,15,15,19,8,5,4,0,97
23,8,15,15,19,8,5,19,0,112
23,8,15,15,19,8,9,14,7,118
23,8,15,15,19,25,0,0,0,105
23,8,15,15,19,9,5,19,0,113
23,8,15,15,19,9,19,0,0,108
23,8,15,15,19,9,19,5,19,132
23,8,15,15,20,0,0,0,0,81
23,8,15,16,0,0,0,0,0,62
23,8,15,16,16,5,4,0,0,87
23,8,15,16,16,5,18,0,0,101
23,8,15,16,16,5,18,19,0,120
23,8,15,16,16,9,14,7,0,108
23,8,15,16,19,0,0,0,0,81
23,8,15,18,1,7,5,0,0,77
23,8,15,18,5,0,0,0,0,69
23,8,15,18,5,4,0,0,0,73
23,8,15,18,5,4,15,13,0,101
23,8,15,18,5,4,15,13,19,120
23,8,15,18,5,12,9,11,5,106
23,8,15,18,5,19,0,0,0,88
23,8,15,18,5,19,8,9,16,121
23,8,15,18,5,19,15,14,0,117
23,8,15,18,5,19,15,14,19,136
23,8,15,18,25,0,0,0,0,89
23,8,15,18,9,14,7,0,0,94
23,8,15,18,9,19,8,0,0,100
23,8,15,18,9,19,8,12,25,137
23,8,15,18,12,0,0,0,0,76
23,8,15,18,12,5,0,0,0,81
23,8,15,18,12,5,4,0,0,85
23,8,15,18,12,25,0,0,0,101
23,8,15,18,12,19,0,0,0,95
23,8,15,18,18,25,0,0,0,107
23,8,15,18,20,0,0,0,0,84
23,8,15,18,20,12,5,0,0,101
23,8,15,18,20,12,5,19,0,120
23,8,15,18,20,19,0,0,0,103
23,8,15,19,5,0,0,0,0,70
23,8,15,19,5,14,0,0,0,84
23,8,15,19,5,22,5,18,0,115
23,8,15,19,9,19,0,0,0,93
23,8,15,19,9,19,5,19,0,117
23,8,15,19,15,0,0,0,0,80
23,8,15,19,15,5,22,5,18,130
23,8,15,19,15,13,5,0,0,98
23,8,18,0,0,0,0,0,0,49
23,8,19,0,0,0,0,0,0,50
23,8,19,12,5,0,0,0,0,67
23,8,21,4,0,0,0,0,0,56
23,8,21,6,6,0,0,0,0,64
23,8,21,6,6,12,5,0,0,81
23,8,21,12,11,0,0,0,0,75
23,8,21,12,20,5,18,0,0,107
23,8,21,13,13,12,5,0,0,95
23,8,21,13,16,0,0,0,0,81
23,8,21,13,16,5,4,0,0,90
23,8,21,13,16,9,14,7,0,111
23,8,21,13,16,19,0,0,0,100
23,8,21,14,0,0,0,0,0,66
23,8,21,14,19,20,1,14,5,125
23,8,21,16,0,0,0,0,0,68
23,8,21,19,8,0,0,0,0,79
23,8,21,19,11,9,5,0,0,96
23,8,21,19,19,12,5,0,0,107
23,8,21,20,5,0,0,0,0,77
23,8,21,20,8,5,18,0,0,103
23,8,21,20,20,5,18,0,0,115
23,8,21,26,0,0,0,0,0,78
23,9,2,2,12,5,0,0,0,53
23,9,3,3,1,0,0,0,0,39
23,9,3,5,0,0,0,0,0,40
23,9,3,8,0,0,0,0,0,43
23,25,3,8,0,0,0,0,0,59
23,9,3,8,5,19,0,0,0,67
23,25,3,8,5,19,0,0,0,83
23,9,3,8,20,0,0,0,0,63
23,9,3,8,20,10,5,0,0,78
23,9,3,11,0,0,0,0,0,46
23,9,3,11,1,16,5,0,0,68
23,9,3,11,1,16,5,19,0,87
23,9,3,11,1,23,5,5,0,80
23,9,3,11,5,4,0,0,0,55
23,9,3,11,5,4,5,18,0,78
23,9,3,11,5,4,5,19,20,99
23,9,3,11,5,4,9,19,8,91
23,9,3,11,5,4,12,25,0,92
23,9,3,11,5,14,0,0,0,65
23,9,3,11,5,18,0,0,0,69
23,9,3,11,5,18,2,25,0,96
23,9,3,11,5,18,19,0,0,88
23,9,3,11,5,20,0,0,0,71
23,9,3,11,5,20,19,0,0,90
23,9,3,11,25,0,0,0,0,71
23,9,3,11,9,14,7,0,0,76
23,9,3,11,9,14,7,19,0,95
23,9,3,11,9,21,16,0,0,92
23,9,3,11,25,21,16,0,0,108
23,9,3,11,9,21,16,19,0,111
23,9,3,11,25,21,16,19,0,127
23,9,3,11,12,5,19,19,0,101
23,9,3,11,20,8,9,14,7,104
23,9,3,11,21,16,0,0,0,83
23,25,3,12,9,6,9,1,14,102
23,9,3,15,16,25,0,0,0,91
23,9,3,15,16,9,5,19,0,99
23,9,4,0,0,0,0,0,0,36
23,9,4,2,9,14,0,0,0,61
23,9,4,4,5,18,0,0,0,63
23,9,4,4,5,18,19,0,0,82
23,9,4,4,25,0,0,0,0,65
23,9,4,4,9,5,0,0,0,54
23,9,4,4,9,5,19,0,0,73
23,9,4,4,9,6,15,23,0,93
23,9,4,4,12,5,0,0,0,57
23,9,4,4,12,5,4,0,0,61
23,9,4,4,12,5,19,0,0,76
23,9,4,4,12,9,14,7,0,82
23,9,4,4,18,9,13,0,0,80
23,9,4,5,0,0,0,0,0,41
23,25,4,5,0,0,0,0,0,57
23,9,4,5,1,23,1,11,5,82
23,9,4,5,2,1,14,4,0,62
23,9,4,5,7,1,2,0,0,51
23,9,4,5,7,1,16,0,0,65
23,9,4,5,12,25,0,0,0,78
23,9,4,5,14,0,0,0,0,55
23,9,4,5,14,5,4,0,0,64
23,9,4,5,14,5,18,19,0,97
23,9,4,5,14,5,19,19,0,98
23,9,4,5,14,9,14,7,0,85
23,9,4,5,14,19,0,0,0,74
23,9,4,5,18,0,0,0,0,59
23,9,4,5,19,0,0,0,0,60
23,9,4,5,19,20,0,0,0,80
23,9,4,5,23,8,5,18,5,100
23,9,4,5,23,15,18,11,0,108
23,9,4,7,5,15,14,0,0,77
23,9,4,7,5,15,14,19,0,96
23,9,4,7,5,20,0,0,0,68
23,9,4,7,5,20,19,0,0,87
23,9,4,7,9,5,0,0,0,57
23,9,4,9,19,8,0,0,0,72
23,9,4,15,18,18,15,18,0,120
23,9,4,15,23,0,0,0,0,74
23,9,4,15,23,5,4,0,0,83
23,9,4,15,23,5,18,0,0,97
23,9,4,15,23,5,18,5,4,106
23,9,4,15,23,5,18,25,0,122
23,9,4,15,23,5,18,19,0,116
23,9,4,15,23,8,15,15,4,116
23,9,4,15,23,25,0,0,0,99
23,9,4,15,23,9,14,7,0,104
23,9,4,15,23,9,19,8,0,110
23,9,4,15,23,12,25,0,0,111
23,9,4,15,23,12,9,11,5,111
23,9,4,15,23,13,1,14,0,102
23,9,4,15,23,13,5,14,0,106
23,9,4,15,23,19,0,0,0,93
23,9,4,20,8,0,0,0,0,64
23,9,4,20,8,12,5,19,19,119
23,9,4,20,8,19,0,0,0,83
23,9,4,20,8,23,1,25,0,113
23,9,4,20,8,23,1,25,19,132
23,9,4,20,8,23,9,19,5,120
23,9,4,21,0,0,0,0,0,57
23,9,5,4,0,0,0,0,0,41
23,9,5,12,1,18,5,0,0,73
23,9,5,12,4,0,0,0,0,53
23,9,5,12,4,1,2,12,5,73
23,9,5,12,4,5,4,0,0,62
23,9,5,12,4,5,18,0,0,76
23,9,5,12,4,5,18,19,0,95
23,9,5,12,4,25,0,0,0,78
23,9,5,12,4,9,5,18,0,85
23,9,5,12,4,9,5,19,20,106
23,9,5,12,4,9,14,7,0,83
23,9,5,12,4,19,0,0,0,72
23,9,5,14,5,18,19,0,0,93
23,9,5,14,9,5,0,0,0,65
23,9,5,14,9,5,19,0,0,84
23,9,5,18,1,14,7,12,5,94
23,9,5,18,4,0,0,0,0,59
23,25,5,19,0,0,0,0,0,72
23,9,6,5,0,0,0,0,0,43
23,9,6,5,3,1,18,12,0,77
23,9,6,5,4,0,0,0,0,47
23,9,6,5,4,15,13,0,0,75
23,9,6,5,4,15,13,19,0,94
23,9,6,5,8,15,15,4,0,85
23,9,6,5,8,15,15,4,19,104
23,9,6,5,9,19,13,0,0,84
23,9,6,5,11,9,14,0,0,77
23,9,6,5,12,5,19,19,0,98
23,9,6,5,12,5,20,0,0,80
23,9,6,5,12,25,0,0,0,80
23,9,6,5,12,9,5,18,0,87
23,9,6,5,12,9,5,19,20,108
23,9,6,5,12,9,11,5,0,80
23,9,6,5,12,9,14,7,0,85
23,9,6,5,12,11,9,14,0,89
23,9,6,5,19,0,0,0,0,62
23,9,6,5,19,8,9,16,0,95
23,9,6,5,20,8,9,14,7,101
23,9,6,5,23,1,18,4,0,89
23,9,6,9,5,0,0,0,0,52
23,9,6,9,5,11,9,5,0,77
23,9,6,9,14,7,0,0,0,68
23,9,6,9,19,8,0,0,0,74
23,9,6,15,3,11,0,0,0,67
23,9,7,1,14,19,0,0,0,73
23,9,7,4,15,13,0,0,0,71
23,9,7,5,12,9,14,7,0,86
23,9,7,5,15,14,0,0,0,73
23,9,7,5,15,14,19,0,0,92
23,9,7,6,21,12,0,0,0,78
23,9,7,7,5,4,0,0,0,55
23,9,7,7,5,14,0,0,0,65
23,9,7,7,5,18,0,0,0,69
23,9,7,7,5,18,25,0,0,94
23,9,7,7,5,18,9,5,19,102
23,9,7,7,25,0,0,0,0,71
23,9,7,7,9,5,18,0,0,78
23,9,7,7,9,5,19,20,0,99
23,9,7,7,9,14,7,0,0,76
23,9,7,7,9,14,7,19,0,95
23,9,7,7,9,19,8,0,0,82
23,9,7,7,9,19,13,0,0,87
23,9,7,7,12,5,0,0,0,63
23,9,7,7,12,5,4,0,0,67
23,9,7,7,12,5,18,0,0,81
23,9,7,7,12,5,18,19,0,100
23,9,7,7,12,5,19,0,0,82
23,9,7,7,12,25,0,0,0,83
23,9,7,7,12,9,5,18,0,90
23,9,7,7,12,9,5,19,20,111
23,9,7,7,12,9,14,7,0,88
23,9,7,8,5,18,0,0,0,70
23,9,7,8,20,12,25,0,0,104
23,9,7,8,20,14,5,19,19,124
23,9,7,8,20,19,0,0,0,86
23,9,7,12,5,19,19,0,0,94
23,9,7,12,5,20,0,0,0,76
23,9,7,12,5,20,19,0,0,95
23,9,7,12,9,11,5,0,0,76
23,9,7,13,1,11,5,0,0,69
23,9,7,13,1,11,5,18,0,87
23,9,7,13,1,11,5,18,19,106
23,9,7,13,1,11,9,14,7,94
23,9,7,19,0,0,0,0,0,58
23,9,7,20,1,9,12,0,0,81
23,9,7,23,1,7,0,0,0,70
23,9,7,23,1,7,7,5,4,86
23,9,7,23,1,7,7,5,18,100
23,9,7,23,1,7,19,0,0,89
23,9,7,23,1,13,0,0,0,76
23,9,7,23,1,13,19,0,0,95
23,9,9,11,9,20,5,0,0,86
23,25,11,5,0,0,0,0,0,64
23,9,11,9,14,7,0,0,0,73
23,9,11,9,21,16,0,0,0,89
23,9,11,9,21,16,19,0,0,108
23,9,11,9,23,9,11,9,0,104
23,9,12,3,15,0,0,0,0,62
23,9,12,3,15,24,15,14,0,115
23,9,12,3,23,5,13,5,0,93
23,9,12,4,0,0,0,0,0,48
23,9,12,4,2,15,18,5,0,88
23,9,12,4,3,1,18,4,0,74
23,9,12,4,3,1,20,0,0,72
23,9,12,4,3,1,20,19,0,91
23,9,12,4,5,4,0,0,0,57
23,9,12,4,5,18,5,4,0,80
23,9,12,4,5,18,9,14,7,101
23,9,12,4,5,18,14,0,0,85
23,9,12,4,5,18,19,0,0,90
23,9,12,4,5,19,20,0,0,92
23,9,12,4,6,9,18,5,0,86
23,9,12,4,6,9,18,5,19,105
23,9,12,4,6,15,23,12,0,104
23,9,12,4,6,15,23,12,19,123
23,9,12,4,7,18,1,22,5,101
23,9,12,4,9,14,7,0,0,78
23,9,12,4,9,14,7,19,0,97
23,9,12,4,9,19,8,0,0,84
23,9,12,4,9,19,8,12,25,121
23,9,12,4,12,1,14,4,0,79
23,9,12,4,12,25,0,0,0,85
23,9,12,4,12,9,6,5,0,80
23,9,12,4,12,9,11,5,0,85
23,9,12,4,12,9,14,7,0,90
23,9,12,4,12,9,14,7,19,109
23,9,12,4,14,5,19,19,0,105
23,9,12,4,19,0,0,0,0,67
23,9,12,4,19,15,13,5,0,100
23,9,12,4,20,25,16,5,0,114
23,9,12,4,23,9,14,4,0,98
23,9,12,4,23,15,15,4,19,124
23,9,12,5,0,0,0,0,0,49
23,25,12,5,0,0,0,0,0,65
23,9,12,5,4,0,0,0,0,53
23,25,12,5,4,0,0,0,0,69
23,9,12,5,6,21,12,0,0,88
23,9,12,5,12,5,19,19,0,104
23,9,12,5,16,18,15,15,6,119
23,25,12,5,19,0,0,0,0,84
23,9,12,6,21,12,0,0,0,83
23,9,12,6,21,12,12,25,0,120
23,9,12,7,1,0,0,0,0,52
23,9,12,7,5,18,19,0,0,93
23,9,12,25,0,0,0,0,0,69
23,9,12,25,3,15,1,20,0,108
23,25,12,9,5,3,15,1,20,113
23,9,12,9,5,18,0,0,0,76
23,9,12,9,5,19,20,0,0,97
23,9,12,9,12,25,0,0,0,90
23,9,12,9,14,5,19,19,0,110
23,9,12,9,14,7,0,0,0,74
23,25,12,9,14,7,0,0,0,90
23,9,12,9,23,9,12,9,0,106
23,9,12,11,0,0,0,0,0,55
23,9,12,11,5,9,20,5,0,94
23,9,12,11,9,14,0,0,0,78
23,9,12,12,1,2,12,5,0,76
23,9,12,12,1,23,1,0,0,81
23,9,12,12,2,12,5,0,0,75
23,9,12,12,5,4,0,0,0,65
23,9,12,12,5,25,5,18,0,109
23,9,12,12,5,13,9,20,5,108
23,9,12,12,5,18,0,0,0,79
23,9,12,12,5,18,19,0,0,98
23,9,12,12,5,19,0,0,0,80
23,9,12,12,5,20,19,0,0,100
23,9,12,12,6,21,12,0,0,95
23,9,12,12,6,21,12,12,25,132
23,9,12,12,25,1,18,4,0,104
23,9,12,12,25,1,18,20,0,120
23,9,12,12,9,3,8,5,0,81
23,9,12,12,9,5,4,0,0,74
23,9,12,12,9,5,18,0,0,88
23,9,12,12,25,5,18,0,0,104
23,9,12,12,9,5,19,0,0,89
23,9,12,12,25,9,14,7,0,111
23,9,12,12,9,14,7,5,18,109
23,9,12,12,9,14,7,12,25,123
23,9,12,12,9,23,1,21,0,110
23,9,12,12,9,23,1,21,19,129
23,9,12,12,9,23,1,23,0,112
23,9,12,12,25,23,1,23,0,128
23,9,12,12,9,23,1,23,19,131
23,9,12,12,25,23,1,23,19,147
23,9,12,12,13,1,11,5,18,104
23,9,12,12,14,5,19,19,0,113
23,9,12,12,15,23,5,4,0,103
23,9,12,12,15,23,5,18,0,117
23,9,12,12,15,23,5,18,19,136
23,9,12,12,15,23,25,0,0,119
23,9,12,12,15,23,9,5,18,126
23,9,12,12,15,23,9,14,7,124
23,9,12,12,15,23,9,19,8,130
23,9,12,12,16,15,23,5,18,133
23,9,12,14,9,14,7,0,0,88
23,9,12,18,15,14,5,0,0,96
23,9,12,18,15,21,14,0,0,112
23,9,12,19,15,13,5,0,0,96
23,9,12,19,15,13,5,12,25,133
23,9,12,20,5,4,0,0,0,73
23,9,12,20,5,18,0,0,0,87
23,9,12,20,9,14,7,0,0,94
23,9,12,20,16,18,15,15,6,134
23,9,13,0,0,0,0,0,0,45
23,9,13,2,5,18,18,25,0,113
23,9,13,2,12,5,0,0,0,64
23,9,13,2,12,5,4,0,0,68
23,9,13,2,12,5,19,0,0,83
23,9,13,2,12,9,14,7,0,89
23,9,13,2,18,5,12,0,0,82
23,9,13,5,0,0,0,0,0,50
23,9,13,9,3,11,0,0,0,68
23,9,13,12,21,14,7,5,0,104
23,25,13,15,20,5,0,0,0,101
23,9,13,16,0,0,0,0,0,61
23,9,13,16,9,19,8,0,0,97
23,9,13,16,12,5,0,0,0,78
23,9,13,16,12,5,4,0,0,82
23,9,13,16,12,5,18,0,0,96
23,9,13,16,12,5,19,0,0,97
23,9,13,16,12,9,14,7,0,103
23,9,13,16,19,0,0,0,0,80
23,9,14,1,18,5,0,0,0,70
23,9,14,2,5,18,18,25,0,114
23,9,14,2,18,15,23,0,0,104
23,9,14,3,5,0,0,0,0,54
23,9,14,3,5,4,0,0,0,58
23,9,14,3,5,25,0,0,0,79
23,9,14,3,5,25,19,0,0,98
23,9,14,3,5,18,19,0,0,91
23,9,14,3,5,19,0,0,0,73
23,9,14,3,8,0,0,0,0,57
23,9,14,3,8,5,4,0,0,66
23,9,14,3,8,5,18,0,0,80
23,9,14,3,8,5,18,19,0,99
23,9,14,3,8,5,19,0,0,81
23,9,14,3,8,9,14,7,0,87
23,9,14,3,8,13,1,14,0,85
23,9,14,3,8,13,5,14,0,89
23,9,14,3,9,14,7,0,0,79
23,9,14,3,9,14,7,12,25,116
23,9,14,3,15,16,9,16,5,110
23,25,14,4,0,0,0,0,0,66
23,9,14,4,1,2,12,5,0,70
23,9,14,4,1,7,5,0,0,63
23,9,14,4,1,7,5,19,0,82
23,9,14,4,1,19,0,0,0,70
23,9,14,4,2,1,7,0,0,60
23,9,14,4,2,1,7,19,0,79
23,9,14,4,2,1,12,12,0,77
23,9,14,4,2,5,18,18,25,118
23,9,14,4,2,12,1,19,20,104
23,9,14,4,2,12,15,23,14,116
23,9,14,4,2,15,1,20,0,88
23,9,14,4,2,15,18,5,0,90
23,9,14,4,2,15,21,14,4,106
23,9,14,4,2,18,5,1,11,87
23,9,14,4,2,21,18,14,0,105
23,9,14,4,2,21,18,14,19,124
23,9,14,4,2,21,18,14,20,125
23,9,14,4,3,8,5,19,20,105
23,9,14,4,3,8,9,12,12,94
23,9,14,4,4,15,7,0,0,76
23,9,14,4,5,4,0,0,0,59
23,9,14,4,5,4,12,25,0,96
23,9,14,4,5,12,0,0,0,67
23,9,14,4,5,18,19,0,0,92
23,9,14,4,6,1,12,12,0,81
23,9,14,4,6,1,12,12,19,100
23,9,14,4,6,9,18,13,0,96
23,9,14,4,6,9,19,8,0,92
23,9,14,4,6,12,1,23,0,92
23,9,14,4,6,12,1,23,19,111
23,9,14,4,7,1,12,12,0,82
23,9,14,4,7,1,12,12,19,101
23,9,14,4,8,15,12,5,0,90
23,9,14,4,8,15,22,5,18,118
23,9,14,4,9,5,18,0,0,82
23,9,14,4,9,5,19,20,0,103
23,9,14,4,9,7,15,0,0,81
23,9,14,4,9,7,15,19,0,100
23,9,14,4,9,12,25,0,0,96
23,9,14,4,9,12,12,0,0,83
23,9,14,4,9,14,5,19,19,116
23,9,14,4,9,14,7,0,0,80
23,9,14,4,9,14,7,12,25,117
23,9,14,4,9,14,7,19,0,99
23,9,14,4,10,1,13,0,0,74
23,9,14,4,12,1,19,19,0,101
23,9,14,4,12,5,0,0,0,67
23,9,14,4,12,5,4,0,0,71
23,9,14,4,12,5,19,0,0,86
23,9,14,4,12,5,19,19,0,105
23,9,14,4,12,9,11,5,0,87
23,9,14,4,12,9,14,0,0,85
23,9,14,4,12,9,14,7,0,92
23,9,14,4,12,9,14,7,19,111
23,9,14,4,13,9,12,12,0,96
23,9,14,4,13,9,12,12,25,121
23,9,14,4,13,9,12,12,19,115
23,9,14,4,15,3,11,0,0,79
23,9,14,4,15,18,5,0,0,88
23,9,14,4,15,23,0,0,0,88
23,9,14,4,15,23,5,4,0,97
23,9,14,4,15,23,6,21,12,127
23,9,14,4,15,23,25,0,0,113
23,9,14,4,15,23,9,14,7,118
23,9,14,4,15,23,12,5,20,125
23,9,14,4,15,23,13,1,14,116
23,9,14,4,15,23,19,0,0,107
23,9,14,4,16,9,16,5,0,96
23,9,14,4,16,9,16,5,19,115
23,9,14,4,16,18,15,15,6,120
23,9,14,4,18,9,14,7,0,98
23,9,14,4,18,15,1,4,0,88
23,9,14,4,18,15,4,5,0,92
23,9,14,4,18,15,15,20,0,118
23,9,14,4,18,15,23,0,0,106
23,9,14,4,18,15,23,5,4,115
23,9,14,4,18,15,23,5,18,129
23,9,14,4,18,15,23,19,0,125
23,9,14,4,19,0,0,0,0,69
23,25,14,4,19,0,0,0,0,85
23,9,14,4,19,1,9,12,0,91
23,9,14,4,19,3,15,15,16,118
23,9,14,4,19,8,1,11,5,94
23,9,14,4,19,8,9,16,0,102
23,9,14,4,19,8,15,3,11,106
23,9,14,4,19,12,1,2,0,84
23,9,14,4,19,15,3,11,0,98
23,9,14,4,19,15,3,11,19,117
23,9,14,4,19,20,15,18,13,135
23,9,14,4,19,21,18,6,0,114
23,9,14,4,19,23,5,16,20,133
23,9,14,4,20,9,7,8,20,114
23,9,14,4,21,16,0,0,0,87
23,9,14,4,21,16,19,0,0,106
23,9,14,4,23,1,25,0,0,99
23,9,14,4,23,1,25,19,0,118
23,9,14,4,23,1,18,4,0,96
23,9,14,4,23,1,18,4,19,115
23,9,14,4,26,0,0,0,0,76
23,9,14,5,0,0,0,0,0,51
23,9,14,5,2,1,12,12,0,78
23,9,14,5,2,5,18,18,25,119
23,9,14,5,4,0,0,0,0,55
23,9,14,5,4,18,1,6,0,80
23,9,14,5,7,12,1,19,19,109
23,9,14,5,8,15,21,19,5,119
23,9,14,5,25,0,0,0,0,76
23,9,14,5,25,1,18,4,0,99
23,9,14,5,9,5,18,0,0,83
23,9,14,5,9,5,19,20,0,104
23,9,14,5,12,5,19,19,0,106
23,9,14,5,12,9,11,5,0,88
23,9,14,5,13,1,25,0,0,90
23,9,14,5,13,1,11,5,0,81
23,9,14,5,13,1,11,5,18,99
23,9,14,5,16,15,20,0,0,102
23,9,14,5,16,18,5,19,19,128
23,9,14,5,18,25,0,0,0,94
23,9,14,5,18,9,5,19,0,102
23,9,14,5,18,19,0,0,0,88
23,9,14,5,19,0,0,0,0,70
23,9,14,5,19,8,15,16,0,109
23,9,14,5,19,8,15,16,19,128
23,9,14,5,19,11,9,14,0,104
23,9,14,5,19,11,9,14,19,123
23,9,14,5,19,15,16,0,0,101
23,9,14,5,19,15,16,19,0,120
23,9,14,5,20,18,5,5,0,99
23,9,14,5,22,1,20,0,0,94
23,9,14,6,18,5,5,0,0,80
23,9,14,6,21,12,0,0,0,85
23,9,14,7,1,2,12,5,0,73
23,9,14,7,1,20,5,0,0,79
23,9,14,7,2,1,3,11,0,70
23,9,14,7,2,1,3,11,19,89
23,9,14,7,2,5,1,20,0,81
23,9,14,7,2,15,23,0,0,93
23,9,14,7,2,15,23,19,0,112
23,9,14,7,3,21,20,0,0,97
23,9,14,7,4,9,14,7,0,87
23,9,14,7,4,9,14,7,19,106
23,9,14,7,5,4,0,0,0,62
23,9,14,7,5,4,12,25,0,99
23,9,14,7,5,18,19,0,0,95
23,9,14,7,6,9,19,8,0,95
23,9,14,7,25,0,0,0,0,78
23,9,14,7,9,5,18,0,0,85
23,9,14,7,9,5,19,20,0,106
23,9,14,7,9,14,7,0,0,83
23,9,14,7,12,5,0,0,0,70
23,9,14,7,12,5,19,19,0,108
23,9,14,7,12,5,20,0,0,90
23,9,14,7,12,5,20,19,0,109
23,9,14,7,12,9,11,5,0,90
23,9,14,7,13,1,14,0,0,81
23,9,14,7,13,5,14,0,0,85
23,9,14,7,15,22,5,18,0,113
23,9,14,7,15,22,5,18,19,132
23,9,14,7,16,9,5,3,5,91
23,9,14,7,16,15,19,20,0,123
23,9,14,7,19,0,0,0,0,72
23,9,14,7,19,5,5,4,0,86
23,9,14,7,19,16,1,14,0,103
23,9,14,7,19,16,1,14,19,122
23,9,14,7,19,20,5,13,0,110
23,9,14,7,20,9,16,0,0,98
23,9,14,7,20,9,16,19,0,117
23,9,14,25,0,0,0,0,0,71
23,9,14,9,5,18,0,0,0,78
23,9,14,9,5,19,20,0,0,99
23,9,14,9,14,7,0,0,0,76
23,9,14,9,19,8,0,0,0,82
23,9,14,11,0,0,0,0,0,57
23,9,14,11,5,4,0,0,0,66
23,9,14,11,5,12,0,0,0,74
23,9,14,11,5,18,0,0,0,80
23,9,14,11,5,18,5,4,0,89
23,25,14,11,5,18,14,5,12,127
23,9,14,11,5,18,19,0,0,99
23,9,14,11,9,14,7,0,0,87
23,9,14,11,9,14,7,12,25,124
23,9,14,11,12,5,0,0,0,74
23,9,14,11,12,5,4,0,0,78
23,9,14,11,12,5,19,0,0,93
23,9,14,11,12,5,20,0,0,94
23,9,14,11,12,9,14,7,0,99
23,9,14,11,12,15,20,0,0,104
23,9,14,11,19,0,0,0,0,76
23,9,14,12,5,19,19,0,0,101
23,9,14,12,25,0,0,0,0,83
23,9,14,14,1,2,12,5,0,80
23,9,14,14,1,18,4,0,0,83
23,9,14,14,5,4,0,0,0,69
23,9,14,14,5,12,0,0,0,77
23,9,14,14,5,18,19,0,0,102
23,9,14,14,9,14,7,0,0,90
23,9,14,14,9,14,7,12,25,127
23,9,14,14,9,14,7,19,0,109
23,9,14,14,9,14,9,19,8,119
23,9,14,14,12,5,0,0,0,77
23,9,14,14,15,3,11,0,0,89
23,9,14,14,15,3,11,19,0,108
23,9,14,14,15,14,9,19,8,125
23,9,14,14,15,23,0,0,0,98
23,9,14,14,15,23,5,4,0,107
23,9,14,14,15,23,5,18,0,121
23,9,14,14,15,23,5,18,19,140
23,9,14,14,15,23,9,14,7,128
23,9,14,14,15,23,19,0,0,117
23,25,14,14,19,0,0,0,0,95
23,9,14,15,0,0,0,0,0,61
23,9,14,15,5,19,0,0,0,85
23,9,14,15,19,0,0,0,0,80
23,9,14,18,1,3,5,0,0,73
23,25,14,18,9,19,0,0,0,108
23,9,14,18,15,23,0,0,0,102
23,25,14,19,0,0,0,0,0,81
23,9,14,19,15,13,5,12,25,135
23,9,14,19,15,13,5,18,0,116
23,9,14,19,15,13,5,19,20,137
23,9,14,19,20,5,18,0,0,108
23,9,14,20,0,0,0,0,0,66
23,9,14,20,5,18,1,7,5,102
23,9,14,20,5,18,5,4,0,98
23,9,14,20,5,18,5,18,0,112
23,9,14,20,5,18,5,18,19,131
23,9,14,20,5,18,6,5,4,104
23,9,14,20,5,18,25,0,0,114
23,9,14,20,5,18,9,5,18,121
23,9,14,20,5,18,9,14,7,119
23,9,14,20,5,18,9,19,8,125
23,9,14,20,5,18,9,26,5,129
23,9,14,20,5,18,12,25,0,126
23,9,14,20,12,5,0,0,0,83
23,9,14,20,12,5,4,0,0,87
23,9,14,20,12,5,19,0,0,102
23,9,14,20,12,9,14,7,0,108
23,9,14,20,18,25,0,0,0,109
23,9,14,20,18,9,5,18,0,116
23,9,14,20,18,9,5,19,20,137
23,9,14,20,18,9,6,25,0,124
23,9,14,20,18,9,12,25,0,130
23,9,14,20,18,9,19,8,0,120
23,9,14,20,18,15,21,19,0,139
23,9,14,26,5,0,0,0,0,77
23,9,14,26,5,13,1,14,0,105
23,9,14,26,5,13,5,14,0,109
23,9,14,26,5,19,0,0,0,96
23,9,16,5,0,0,0,0,0,53
23,25,16,5,0,0,0,0,0,69
23,9,16,5,4,0,0,0,0,57
23,9,16,5,15,21,20,0,0,109
23,9,16,5,15,21,20,19,0,128
23,9,16,5,18,0,0,0,0,71
23,9,16,5,18,19,0,0,0,90
23,9,16,5,19,0,0,0,0,72
23,9,16,9,14,7,0,0,0,78
23,9,16,16,5,14,0,0,0,83
23,9,16,19,0,0,0,0,0,67
23,9,16,19,20,15,3,11,0,116
23,9,18,0,0,0,0,0,0,50
23,9,18,1,2,12,5,0,0,70
23,9,18,2,12,5,0,0,0,69
23,9,18,4,0,0,0,0,0,54
23,9,18,5,0,0,0,0,0,55
23,9,18,5,2,1,18,0,0,76
23,9,18,5,2,9,18,4,0,88
23,9,18,5,4,0,0,0,0,59
23,9,18,5,4,18,1,23,0,101
23,9,18,5,4,18,1,23,14,115
23,9,18,5,4,18,1,23,19,120
23,9,18,5,4,18,5,23,0,105
23,9,18,5,7,18,1,19,19,119
23,9,18,5,8,1,9,18,0,91
23,9,18,5,8,1,9,18,19,110
23,9,18,5,12,5,19,19,0,110
23,9,18,5,12,9,11,5,0,92
23,9,18,5,13,1,11,5,18,103
23,9,18,5,13,1,14,0,0,83
23,9,18,5,13,5,14,0,0,87
23,9,18,5,16,21,12,12,0,116
23,9,18,5,18,0,0,0,0,73
23,9,18,5,18,19,0,0,0,92
23,9,18,5,19,0,0,0,0,74
23,9,18,5,19,13,9,20,8,124
23,9,18,5,19,15,14,4,5,112
23,9,18,5,19,16,21,14,0,125
23,9,18,5,20,1,9,12,0,97
23,9,18,5,20,1,16,0,0,92
23,9,18,5,20,1,16,19,0,111
23,9,18,5,23,1,25,0,0,104
23,9,18,5,23,1,25,19,0,123
23,9,18,5,23,5,5,4,0,92
23,9,18,5,23,15,18,11,0,122
23,9,18,5,23,15,18,11,19,141
23,9,18,5,23,15,18,13,0,124
23,9,18,5,23,15,18,13,19,143
23,9,18,25,0,0,0,0,0,75
23,9,18,9,5,18,0,0,0,82
23,9,18,9,5,19,20,0,0,103
23,9,18,9,12,25,0,0,0,96
23,9,18,9,14,5,19,19,0,116
23,9,18,9,14,7,0,0,0,80
23,9,18,9,14,7,19,0,0,99
23,9,18,12,0,0,0,0,0,62
23,9,18,12,9,14,7,0,0,92
23,25,18,15,3,11,0,0,0,95
23,9,18,18,0,0,0,0,0,68
23,9,18,18,1,0,0,0,0,69
23,9,18,18,1,8,0,0,0,77
23,9,19,4,15,13,0,0,0,83
23,9,19,4,15,13,6,21,12,122
23,9,19,4,15,13,19,0,0,102
23,9,19,5,0,0,0,0,0,56
23,9,19,5,1,3,18,5,0,83
23,9,19,5,1,3,18,5,4,87
23,9,19,5,1,3,18,5,19,102
23,9,19,5,1,19,19,0,0,95
23,9,19,5,3,18,1,3,11,92
23,9,19,5,4,0,0,0,0,60
23,9,19,5,7,21,25,0,0,109
23,9,19,5,8,5,1,4,0,74
23,9,19,5,12,25,0,0,0,93
23,9,19,5,12,9,5,18,0,100
23,9,19,5,12,9,5,19,20,121
23,9,19,5,12,9,11,5,0,93
23,9,19,5,12,9,14,7,0,98
23,9,19,5,14,0,0,0,0,70
23,9,19,5,14,5,19,19,0,113
23,9,19,5,14,20,0,0,0,90
23,9,19,5,14,20,19,0,0,109
23,9,19,5,18,0,0,0,0,74
23,9,19,5,19,0,0,0,0,75
23,9,19,5,19,20,0,0,0,95
23,9,19,5,23,5,5,4,0,93
23,9,19,5,23,15,13,1,14,122
23,9,19,5,23,15,13,5,14,126
23,9,19,8,0,0,0,0,0,59
23,9,19,8,1,0,0,0,0,60
23,9,19,8,1,2,12,5,0,79
23,9,19,8,2,15,14,5,0,95
23,9,19,8,2,15,14,5,19,114
23,9,19,8,5,4,0,0,0,68
23,9,19,8,5,4,12,25,0,105
23,9,19,8,5,18,0,0,0,82
23,9,19,8,5,18,19,0,0,101
23,9,19,8,5,19,0,0,0,83
23,9,19,8,6,21,12,0,0,98
23,9,19,8,6,21,12,12,25,135
23,9,19,8,25,0,0,0,0,84
23,9,19,8,9,14,7,0,0,89
23,9,19,8,9,14,7,12,25,126
23,9,19,8,12,5,19,19,0,114
23,9,19,8,12,25,0,0,0,96
23,9,19,8,13,1,25,0,0,98
23,9,19,8,14,5,19,19,0,116
23,9,19,8,20,0,0,0,0,79
23,9,19,9,14,7,0,0,0,81
23,9,19,11,5,20,0,0,0,87
23,9,19,11,9,14,7,0,0,92
23,9,19,11,9,14,11,25,0,121
23,9,19,11,9,14,11,9,5,110
23,9,19,13,21,20,8,0,0,113
23,25,19,15,14,0,0,0,0,96
23,9,19,16,0,0,0,0,0,67
23,9,19,16,5,4,0,0,0,76
23,9,19,16,25,0,0,0,0,92
23,9,19,16,9,5,18,0,0,99
23,9,19,16,9,5,19,20,0,120
23,9,19,16,9,12,25,0,0,113
23,9,19,16,9,14,5,19,19,133
23,9,19,16,9,14,7,0,0,97
23,9,19,16,9,19,8,0,0,103
23,9,19,16,12,9,11,5,0,104
23,9,19,16,19,0,0,0,0,86
23,9,19,19,0,0,0,0,0,70
23,25,19,19,0,0,0,0,0,86
23,9,19,19,5,0,0,0,0,75
23,9,19,19,5,4,0,0,0,79
23,9,19,19,5,12,0,0,0,87
23,9,19,19,5,19,0,0,0,94
23,9,19,19,8,5,0,0,0,83
23,9,19,19,9,14,7,0,0,100
23,9,19,19,12,5,0,0,0,87
23,9,19,20,0,0,0,0,0,71
23,9,19,20,1,18,9,1,19,119
23,9,19,20,5,0,0,0,0,76
23,9,19,20,5,4,0,0,0,80
23,9,19,20,5,14,5,4,0,99
23,9,19,20,5,18,9,1,19,123
23,9,19,20,6,21,12,0,0,110
23,9,19,20,6,21,12,12,25,147
23,25,19,20,25,0,0,0,0,112
23,9,19,20,9,14,7,0,0,101
23,9,19,20,9,20,0,0,0,100
23,9,19,20,9,20,9,0,0,109
23,9,19,20,12,5,19,19,0,126
23,9,19,20,12,25,0,0,0,108
23,9,19,20,19,0,0,0,0,90
23,9,19,21,18,5,0,0,0,95
23,9,20,1,14,0,0,0,0,67
23,9,20,3,8,0,0,0,0,63
23,9,20,3,8,5,4,0,0,72
23,9,20,3,8,5,4,12,25,109
23,9,20,3,8,5,14,0,0,82
23,9,20,3,8,5,18,25,0,111
23,9,20,3,8,5,19,0,0,87
23,9,20,3,8,5,20,0,0,88
23,9,20,3,8,5,20,20,25,133
23,9,20,3,8,8,15,15,4,105
23,9,20,3,8,25,0,0,0,88
23,9,20,3,8,9,5,18,0,95
23,9,20,3,8,9,5,19,20,116
23,9,20,3,8,9,14,7,0,93
23,9,20,3,8,9,14,7,19,112
23,9,20,3,8,12,5,1,6,87
23,9,20,3,8,12,9,11,5,100
23,9,20,3,8,13,1,14,0,91
23,9,20,3,8,21,3,11,0,98
23,9,20,3,8,23,5,5,4,100
23,9,20,3,8,23,9,6,5,106
23,9,20,3,8,23,15,15,4,120
23,9,20,3,8,23,15,18,11,130
23,9,20,3,18,1,6,20,0,100
23,9,20,5,0,0,0,0,0,57
23,25,20,5,0,0,0,0,0,73
23,9,20,5,4,0,0,0,0,61
23,25,20,5,4,0,0,0,0,77
23,9,20,5,12,5,19,19,0,112
23,9,20,5,14,0,0,0,0,71
23,9,20,5,16,5,14,14,25,131
23,9,20,5,18,5,4,5,14,103
23,9,20,5,19,0,0,0,0,76
23,25,20,5,19,0,0,0,0,92
23,9,20,5,19,19,0,0,0,95
23,9,20,6,21,12,0,0,0,91
23,9,20,8,0,0,0,0,0,60
23,9,20,8,1,12,0,0,0,73
23,9,20,8,1,13,0,0,0,74
23,9,20,8,1,13,9,20,5,108
23,9,20,8,2,5,7,0,0,74
23,9,20,8,3,1,12,12,0,88
23,9,20,8,4,1,23,0,0,88
23,9,20,8,4,18,1,23,0,106
23,9,20,8,4,18,1,23,14,120
23,9,20,8,4,18,1,23,19,125
23,9,20,8,4,18,5,23,0,110
23,9,20,8,5,0,0,0,0,65
23,9,20,8,5,4,0,0,0,69
23,9,20,8,5,14,0,0,0,79
23,9,20,8,5,18,5,4,0,92
23,9,20,8,5,18,5,18,0,106
23,9,20,8,5,18,5,18,19,125
23,9,20,8,5,18,25,0,0,108
23,9,20,8,5,18,9,14,7,113
23,9,20,8,5,18,9,20,5,117
23,9,20,8,5,18,12,25,0,120
23,9,20,8,5,18,14,1,13,111
23,9,20,8,5,18,20,9,16,128
23,9,20,8,5,19,0,0,0,84
23,9,20,8,5,23,15,15,4,122
23,9,20,8,7,1,14,7,0,89
23,9,20,8,7,1,20,5,0,93
23,9,20,8,8,5,12,4,0,89
23,9,20,8,8,5,12,5,0,90
23,9,20,8,8,9,5,0,0,82
23,9,20,8,8,15,12,4,0,99
23,9,20,8,8,15,12,4,19,118
23,9,20,8,25,0,0,0,0,85
23,9,20,8,9,5,18,0,0,92
23,9,20,8,9,5,19,0,0,93
23,9,20,8,9,5,19,20,0,113
23,9,20,8,9,14,0,0,0,83
23,9,20,8,9,14,7,0,0,90
23,9,20,8,9,14,19,0,0,102
23,9,20,8,25,16,15,20,0,136
23,9,20,8,25,23,9,14,4,135
23,9,20,8,14,1,25,0,0,100
23,9,20,8,14,5,19,19,0,117
23,9,20,8,14,9,13,0,0,96
23,9,20,8,15,12,4,5,14,110
23,9,20,8,15,21,20,0,0,116
23,9,20,8,15,21,20,5,14,135
23,9,20,8,15,21,20,19,0,135
23,9,20,8,19,1,25,0,0,105
23,9,20,8,19,1,25,5,18,128
23,9,20,8,19,1,22,5,0,107
23,9,20,8,19,1,23,0,0,103
23,9,20,8,19,5,20,0,0,104
23,9,20,8,19,12,9,16,0,116
23,9,20,8,19,16,1,18,0,114
23,9,20,8,19,20,1,25,0,125
23,9,20,8,19,20,1,14,4,118
23,9,20,8,19,20,15,15,4,133
23,9,20,8,20,1,11,5,0,97
23,9,20,8,20,5,5,0,0,90
23,9,20,8,20,21,18,14,0,133
23,9,20,8,22,9,14,5,0,110
23,9,20,8,23,9,14,4,0,110
23,9,20,9,14,7,0,0,0,82
23,25,20,9,14,7,0,0,0,98
23,9,20,10,1,18,0,0,0,81
23,9,20,12,5,19,19,0,0,107
23,9,20,12,5,19,19,12,25,144
23,9,20,12,5,20,0,0,0,89
23,9,20,12,9,14,7,0,0,94
23,9,20,12,9,14,7,19,0,113
23,9,20,12,15,15,6,0,0,100
23,9,20,12,15,15,6,19,0,119
23,9,20,12,15,19,5,14,0,117
23,9,20,13,15,14,7,5,18,124
23,9,20,14,5,25,0,0,0,96
23,9,20,14,5,25,5,18,0,119
23,9,20,14,5,25,19,0,0,115
23,9,20,14,5,19,19,0,0,109
23,9,20,14,5,19,19,5,4,118
23,9,20,14,5,19,19,5,18,132
23,9,20,14,5,19,19,5,19,133
23,9,20,19,1,6,5,0,0,83
23,9,20,19,8,9,16,0,0,104
23,9,20,20,1,12,0,0,0,85
23,9,20,20,1,12,12,0,0,97
23,9,20,20,1,23,5,18,0,119
23,9,20,20,5,2,15,15,13,122
23,9,20,20,5,4,0,0,0,81
23,9,20,20,5,18,9,14,7,125
23,9,20,20,5,18,12,25,0,132
23,9,20,20,9,3,9,19,13,125
23,9,20,20,9,3,9,26,5,124
23,9,20,20,9,5,18,0,0,104
23,9,20,20,9,5,19,20,0,125
23,9,20,20,9,6,9,5,4,105
23,9,20,20,9,12,25,0,0,118
23,9,20,20,9,14,5,19,19,138
23,9,20,20,9,14,7,0,0,102
23,9,20,20,9,14,7,12,25,139
23,9,20,20,9,14,7,19,0,121
23,9,20,20,15,12,0,0,0,99
23,9,20,20,15,12,12,25,0,136
23,9,20,20,15,12,19,0,0,118
23,9,20,20,15,13,5,0,0,105
23,9,20,23,1,12,12,0,0,100
23,9,20,23,1,14,20,15,14,139
23,9,20,23,15,18,4,0,0,112
23,9,20,23,15,18,13,0,0,121
23,9,22,5,0,0,0,0,0,59
23,25,22,5,0,0,0,0,0,75
23,9,22,5,4,0,0,0,0,63
23,9,22,5,18,0,0,0,0,77
23,25,22,5,18,0,0,0,0,93
23,9,22,5,18,14,0,0,0,91
23,25,22,5,18,14,0,0,0,107
23,9,22,5,18,14,19,0,0,110
23,25,22,5,18,14,19,0,0,126
23,9,22,5,18,19,0,0,0,96
23,9,22,5,19,0,0,0,0,78
23,9,22,9,14,7,0,0,0,84
23,9,23,9,0,0,0,0,0,64
23,9,26,0,0,0,0,0,0,58
23,9,26,1,18,4,0,0,0,81
23,9,26,1,18,4,5,19,19,124
23,9,26,1,18,4,9,19,13,122
23,9,26,1,18,4,12,25,0,118
23,9,26,1,18,4,18,25,0,124
23,9,26,1,18,4,19,0,0,100
23,9,26,5,14,0,0,0,0,77
23,9,26,5,14,5,4,0,0,86
23,9,26,5,14,9,14,7,0,107
23,9,26,5,14,19,0,0,0,96
23,9,26,5,19,0,0,0,0,82
23,9,26,9,5,18,0,0,0,90
23,9,26,26,5,14,0,0,0,103
23,9,26,26,5,14,19,0,0,122
23,10,3,0,0,0,0,0,0,36
23,11,12,25,0,0,0,0,0,71
23,12,5,3,3,8,5,0,0,59
23,12,5,14,3,8,0,0,0,65
23,12,9,20,25,0,0,0,0,89
23,12,15,11,1,0,0,0,0,62
23,12,15,14,11,8,5,4,5,97
23,13,11,0,0,0,0,0,0,47
23,15,2,0,0,0,0,0,0,40
23,15,2,2,5,7,15,14,7,90
23,15,2,2,12,5,0,0,0,59
23,15,2,2,12,5,4,0,0,63
23,15,2,2,12,5,18,0,0,77
23,15,2,2,12,5,18,19,0,96
23,15,2,2,12,5,19,0,0,78
23,15,2,2,12,9,5,18,0,86
23,15,2,2,12,9,5,19,20,107
23,15,2,2,12,9,14,7,0,84
23,15,2,5,7,15,14,5,0,86
23,15,2,19,20,5,18,0,0,102
23,15,3,1,19,0,0,0,0,61
23,15,4,0,0,0,0,0,0,42
23,15,4,4,9,5,0,0,0,60
23,15,4,5,0,0,0,0,0,47
23,15,4,5,12,5,9,5,0,78
23,15,4,7,5,0,0,0,0,54
23,15,4,7,5,19,0,0,0,73
23,15,4,7,25,0,0,0,0,74
23,15,5,0,0,0,0,0,0,43
23,15,5,2,5,7,15,14,5,91
23,15,5,6,1,18,5,0,0,73
23,15,5,6,21,12,0,0,0,82
23,15,5,6,21,12,12,5,18,117
23,15,5,6,21,12,12,25,0,119
23,15,5,14,5,19,19,0,0,100
23,15,5,14,5,19,19,5,19,124
23,15,5,19,0,0,0,0,0,62
23,15,5,19,15,13,5,0,0,95
23,15,5,22,9,14,5,0,0,93
23,15,5,23,15,18,14,0,0,113
23,15,6,6,12,5,18,0,0,85
23,15,6,20,0,0,0,0,0,64
23,15,6,21,12,0,0,0,0,77
23,15,6,21,12,12,25,0,0,114
23,15,6,21,12,14,5,19,19,134
23,15,7,0,0,0,0,0,0,45
23,15,7,7,12,5,0,0,0,69
23,15,7,8,14,5,19,19,0,110
23,15,7,9,5,20,0,0,0,79
23,15,7,19,0,0,0,0,0,64
23,15,7,21,12,0,0,0,0,78
23,15,8,12,1,3,0,0,0,62
23,15,8,12,5,18,9,20,5,115
23,15,25,0,0,0,0,0,0,63
23,15,9,2,5,0,0,0,0,54
23,15,9,4,18,5,0,0,0,74
23,15,9,12,9,5,0,0,0,73
23,15,11,0,0,0,0,0,0,49
23,15,11,1,19,0,0,0,0,69
23,15,11,5,0,0,0,0,0,54
23,15,11,5,14,0,0,0,0,68
23,15,11,15,23,9,0,0,0,96
23,15,11,19,0,0,0,0,0,68
23,15,12,4,0,0,0,0,0,54
23,15,12,4,5,19,0,0,0,78
23,15,12,4,25,0,0,0,0,79
23,15,12,4,12,9,11,5,0,91
23,15,12,4,19,13,1,14,0,101
23,15,12,5,1,9,0,0,0,65
23,15,12,6,2,1,14,5,0,78
23,15,12,6,2,5,18,18,25,124
23,15,12,6,4,15,13,0,0,88
23,15,12,6,5,4,0,0,0,65
23,15,12,6,5,14,0,0,0,75
23,15,12,6,5,18,0,0,0,79
23,15,12,6,5,18,19,0,0,98
23,15,12,6,6,9,19,8,0,98
23,15,12,6,8,15,15,4,0,98
23,15,12,6,8,15,21,14,4,118
23,15,12,6,9,14,7,0,0,86
23,15,12,6,9,19,8,0,0,92
23,15,12,6,9,19,8,12,25,129
23,15,12,6,11,9,14,0,0,90
23,15,12,6,12,5,19,19,0,111
23,15,12,6,12,9,11,5,0,93
23,15,12,6,12,9,14,7,0,98
23,15,12,6,13,1,14,0,0,84
23,15,12,6,13,5,14,0,0,88
23,15,12,6,18,1,13,9,3,100
23,15,12,6,18,1,13,19,0,107
23,15,12,6,19,0,0,0,0,75
23,15,12,6,19,2,1,14,5,97
23,15,12,6,19,11,9,14,0,109
23,15,12,6,23,1,18,4,0,102
23,15,12,6,23,1,18,4,19,121
23,15,12,12,25,0,0,0,0,87
23,15,12,12,15,3,11,0,0,91
23,15,12,12,15,13,1,9,0,100
23,15,12,12,15,16,0,0,0,93
23,15,12,20,5,18,0,0,0,93
23,15,12,22,5,0,0,0,0,77
23,15,12,22,5,2,15,15,14,123
23,15,12,22,5,18,0,0,0,95
23,15,12,22,5,18,5,14,5,119
23,15,12,22,5,18,19,0,0,114
23,15,12,22,5,19,0,0,0,96
23,15,12,22,9,19,8,0,0,108
23,15,13,1,14,0,0,0,0,66
23,15,13,1,14,2,15,4,25,112
23,15,13,1,14,4,15,13,0,98
23,15,13,1,14,5,4,0,0,75
23,15,13,1,14,6,15,12,11,110
23,15,13,1,14,8,5,1,4,84
23,15,13,1,14,8,15,15,4,108
23,15,13,1,14,9,14,7,0,96
23,15,13,1,14,9,19,5,0,99
23,15,13,1,14,9,19,5,4,103
23,15,13,1,14,9,19,5,19,118
23,15,13,1,14,9,19,8,0,102
23,15,13,1,14,9,19,13,0,107
23,15,13,1,14,9,19,20,0,114
23,15,13,1,14,9,20,25,0,120
23,15,13,1,14,9,26,5,0,106
23,15,13,1,14,9,26,5,4,110
23,15,13,1,14,9,26,5,18,124
23,15,13,1,14,9,26,5,19,125
23,15,13,1,14,11,9,14,4,104
23,15,13,1,14,12,5,19,19,121
23,15,13,1,14,12,25,0,0,103
23,15,13,1,14,12,9,5,18,110
23,15,13,1,14,12,9,11,5,103
23,15,13,1,14,14,5,19,19,123
23,15,13,1,14,16,15,19,20,136
23,15,13,1,14,19,0,0,0,85
23,15,13,1,14,19,8,9,16,118
23,15,13,1,14,23,1,25,19,134
23,15,13,1,14,23,9,19,5,122
23,15,13,2,0,0,0,0,0,53
23,15,13,2,1,20,0,0,0,74
23,15,13,2,1,20,19,0,0,93
23,15,13,2,5,4,0,0,0,62
23,15,13,2,25,0,0,0,0,78
23,15,13,2,9,5,18,0,0,85
23,15,13,2,9,5,19,20,0,106
23,15,13,2,12,5,0,0,0,70
23,15,13,2,19,0,0,0,0,72
23,15,13,2,19,9,4,5,0,90
23,15,13,2,19,20,15,14,5,126
23,15,13,5,14,0,0,0,0,70
23,15,13,5,14,6,15,12,11,114
23,15,13,5,14,11,9,14,4,108
23,15,13,5,18,1,0,0,0,75
23,15,13,5,18,1,8,0,0,83
23,15,13,5,18,1,19,0,0,94
23,15,13,13,1,12,1,0,0,78
23,15,13,13,5,18,1,0,0,88
23,15,13,13,5,18,1,8,0,96
23,15,13,13,5,18,1,12,1,101
23,15,13,13,5,18,1,19,0,107
23,15,13,16,0,0,0,0,0,67
23,15,13,16,12,9,20,0,0,108
23,15,13,16,19,0,0,0,0,86
23,15,14,4,5,18,5,4,0,88
23,15,14,4,5,18,5,18,0,102
23,15,14,4,5,18,5,18,19,121
23,15,14,4,5,18,6,21,12,118
23,15,14,4,5,18,9,14,7,109
23,15,14,4,5,18,19,0,0,98
23,15,14,4,9,5,0,0,0,70
23,15,14,4,18,15,21,19,0,129
23,15,14,5,0,0,0,0,0,57
23,15,14,5,7,1,14,0,0,79
23,15,14,7,1,0,0,0,0,60
23,15,14,7,1,8,0,0,0,68
23,15,14,7,5,14,0,0,0,78
23,15,14,7,19,8,25,0,0,111
23,15,14,7,19,11,25,0,0,114
23,15,14,9,14,7,0,0,0,82
23,15,14,11,0,0,0,0,0,63
23,15,14,11,25,0,0,0,0,88
23,15,14,11,9,5,18,0,0,95
23,15,14,11,9,5,19,20,0,116
23,15,14,11,19,0,0,0,0,82
23,15,14,14,1,0,0,0,0,67
23,15,14,14,5,4,0,0,0,75
23,15,14,14,5,18,0,0,0,89
23,15,14,14,5,18,19,0,0,108
23,15,14,14,9,14,7,0,0,96
23,15,14,14,15,20,0,0,0,101
23,15,14,19,0,0,0,0,0,71
23,15,14,20,0,0,0,0,0,72
23,15,14,20,5,4,0,0,0,81
23,15,14,20,5,4,12,25,0,118
23,15,14,20,9,14,7,0,0,102
23,15,14,20,12,5,19,19,0,127
23,15,14,20,15,14,0,0,0,101
23,15,14,20,15,14,19,0,0,120
23,15,14,20,19,0,0,0,0,91
23,15,15,1,2,12,5,0,0,73
23,15,15,4,1,7,1,20,5,91
23,15,15,4,2,1,18,11,0,89
23,15,15,4,2,9,14,0,0,82
23,15,15,4,2,9,14,4,0,86
23,15,15,4,2,9,14,4,19,105
23,15,15,4,2,9,14,5,4,91
23,15,15,4,2,9,14,5,19,106
23,15,15,4,2,9,14,19,0,101
23,15,15,4,2,12,15,3,11,100
23,15,15,4,2,15,18,5,18,115
23,15,15,4,2,15,21,14,4,113
23,15,15,4,2,15,24,0,0,98
23,15,15,4,2,15,24,5,19,122
23,15,15,4,2,21,19,8,0,107
23,15,15,4,3,8,1,20,0,89
23,15,15,4,3,8,1,20,19,108
23,15,15,4,3,8,21,3,11,103
23,15,15,4,3,15,3,0,0,78
23,15,15,4,3,15,3,11,19,108
23,15,15,4,3,18,1,6,0,85
23,15,15,4,3,18,1,6,20,105
23,15,15,4,3,21,20,0,0,101
23,15,15,4,3,21,20,19,0,120
23,15,15,4,5,4,0,0,0,66
23,15,15,4,5,14,5,18,0,99
23,15,15,4,5,14,5,19,20,120
23,15,15,4,5,14,25,0,0,101
23,15,15,4,5,14,12,25,0,113
23,15,15,4,6,1,12,12,0,88
23,15,15,4,6,9,19,8,0,99
23,15,15,4,7,5,12,4,0,85
23,15,15,4,7,18,1,9,14,106
23,15,15,4,7,18,21,2,0,105
23,15,15,4,8,1,3,11,0,80
23,15,15,4,8,5,14,0,0,84
23,15,15,4,8,5,14,19,0,103
23,15,15,4,8,5,23,5,18,116
23,15,15,4,8,15,12,5,0,97
23,15,15,4,8,15,18,19,5,122
23,15,15,4,8,21,14,7,0,107
23,15,15,4,25,1,18,4,0,105
23,15,15,4,9,5,18,0,0,89
23,15,15,4,9,5,19,0,0,90
23,15,15,4,9,5,19,20,0,110
23,15,15,4,9,14,5,0,0,85
23,15,15,4,9,14,5,19,19,123
23,15,15,4,9,14,7,0,0,87
23,15,15,4,9,19,8,0,0,93
23,15,15,4,11,5,18,14,0,105
23,15,15,4,12,1,14,4,0,88
23,15,15,4,12,1,14,4,19,107
23,15,15,4,12,1,18,11,0,99
23,15,15,4,12,1,18,11,19,118
23,15,15,4,12,5,19,19,0,112
23,15,15,4,12,5,20,0,0,94
23,15,15,4,12,25,0,0,0,94
23,15,15,4,12,9,11,5,0,94
23,15,15,4,12,9,14,4,0,96
23,15,15,4,12,15,18,5,0,107
23,15,15,4,12,15,18,5,19,126
23,15,15,4,12,15,20,0,0,104
23,15,15,4,12,15,20,19,0,123
23,15,15,4,12,15,21,19,5,129
23,15,15,4,13,1,9,4,0,84
23,15,15,4,13,5,14,0,0,89
23,15,15,4,13,15,20,5,0,110
23,15,15,4,14,5,19,19,0,114
23,15,15,4,14,15,20,5,0,111
23,15,15,4,14,15,20,5,19,130
23,15,15,4,15,15,0,0,0,87
23,15,15,4,16,5,3,11,0,92
23,15,15,4,16,5,14,14,25,131
23,15,15,4,16,9,12,5,0,99
23,15,15,4,16,9,12,5,19,118
23,15,15,4,16,18,9,14,20,134
23,15,15,4,18,5,5,4,0,89
23,15,15,4,18,5,5,22,5,112
23,15,15,4,18,9,3,11,0,98
23,15,15,4,18,9,13,5,0,102
23,15,15,4,18,9,19,0,0,103
23,15,15,4,18,15,3,11,0,104
23,15,15,4,18,15,15,6,0,111
23,15,15,4,18,15,23,5,12,130
23,15,15,4,18,21,6,6,19,127
23,15,15,4,18,21,19,8,0,123
23,15,15,4,19,3,18,5,23,125
23,15,15,4,19,5,18,5,0,104
23,15,15,4,19,8,5,4,0,93
23,15,15,4,19,8,5,4,19,112
23,15,15,4,19,8,9,16,0,109
23,15,15,4,19,8,15,3,11,113
23,15,15,4,19,8,15,16,0,115
23,15,15,4,19,25,0,0,0,101
23,15,15,4,19,9,1,19,0,105
23,15,15,4,19,9,4,5,0,94
23,15,15,4,19,9,5,18,0,108
23,15,15,4,19,9,5,19,20,129
23,15,15,4,19,11,9,14,0,110
23,15,15,4,19,13,1,14,0,104
23,15,15,4,19,13,5,14,0,108
23,15,15,4,19,16,9,20,5,126
23,15,15,4,19,20,15,14,5,130
23,15,15,4,23,1,12,5,0,98
23,15,15,4,23,1,12,12,0,105
23,15,15,4,23,1,18,5,0,104
23,15,15,4,23,1,24,0,0,105
23,15,15,4,23,1,24,5,14,124
23,15,15,4,23,1,24,5,19,129
23,15,15,4,23,9,14,4,0,107
23,15,15,4,23,9,14,4,19,126
23,15,15,4,23,9,19,5,0,113
23,15,15,4,23,15,18,11,0,124
23,15,15,4,23,15,18,11,19,143
23,15,15,4,23,15,18,13,0,126
23,15,15,4,23,15,18,13,19,145
23,15,15,4,23,15,19,5,0,119
23,15,15,5,4,0,0,0,0,62
23,15,15,5,18,0,0,0,0,76
23,15,15,5,18,19,0,0,0,95
23,15,15,6,0,0,0,0,0,59
23,15,15,6,5,4,0,0,0,68
23,15,15,6,5,12,12,0,0,88
23,15,15,6,5,18,0,0,0,82
23,15,15,6,5,18,19,0,0,101
23,15,15,6,25,0,0,0,0,84
23,15,15,6,9,14,7,0,0,89
23,15,15,6,19,0,0,0,0,78
23,15,15,8,15,15,0,0,0,91
23,15,15,9,14,7,0,0,0,83
23,15,15,9,14,7,12,25,0,120
23,15,15,12,0,0,0,0,0,65
23,15,15,12,4,0,0,0,0,69
23,15,15,12,4,5,4,0,0,78
23,15,15,12,4,5,18,0,0,92
23,15,15,12,4,9,14,7,0,99
23,15,15,12,5,4,0,0,0,74
23,15,15,12,5,14,0,0,0,84
23,15,15,12,5,14,5,20,0,109
23,15,15,12,5,14,9,26,5,124
23,15,15,12,5,14,19,0,0,103
23,15,15,12,5,18,0,0,0,88
23,15,15,12,5,18,19,0,0,107
23,15,15,12,5,18,20,0,0,108
23,15,15,12,6,5,12,12,0,100
23,15,15,12,6,5,12,12,19,119
23,15,15,12,8,1,20,0,0,94
23,15,15,12,8,1,20,19,0,113
23,15,15,12,8,5,1,4,0,83
23,15,15,12,25,0,0,0,0,90
23,15,15,12,9,5,0,0,0,79
23,15,15,12,9,5,18,0,0,97
23,15,15,12,9,5,19,0,0,98
23,15,15,12,9,5,19,20,0,118
23,15,15,12,9,14,5,19,19,131
23,15,15,12,12,5,4,0,0,86
23,15,15,12,12,5,14,0,0,96
23,15,15,12,12,5,14,19,0,115
23,15,15,12,12,25,0,0,0,102
23,15,15,12,12,9,5,18,0,109
23,15,15,12,12,9,5,19,0,110
23,15,15,12,12,9,5,19,20,130
23,15,15,12,12,25,9,19,8,138
23,15,15,12,12,9,11,5,0,102
23,15,15,12,13,1,14,0,0,93
23,15,15,12,13,5,14,0,0,97
23,15,15,12,16,1,3,11,0,96
23,15,15,12,16,1,3,11,19,115
23,15,15,12,16,18,5,19,19,142
23,15,15,12,19,0,0,0,0,84
23,15,15,12,19,1,3,11,0,99
23,15,15,12,19,1,3,11,19,118
23,15,15,12,19,1,23,0,0,108
23,15,15,12,19,5,25,0,0,114
23,15,15,12,19,8,5,4,0,101
23,15,15,12,19,8,5,4,19,120
23,15,15,12,19,11,9,14,0,118
23,15,15,12,19,11,9,14,19,137
23,15,15,12,19,15,23,5,18,145
23,15,15,12,21,12,15,19,5,137
23,15,15,12,23,1,18,4,0,111
23,15,15,12,23,5,5,4,0,102
23,15,15,12,23,8,5,5,12,118
23,15,15,12,23,15,18,11,0,132
23,15,15,13,0,0,0,0,0,66
23,15,15,13,5,18,0,0,0,89
23,15,15,13,5,18,1,8,0,98
23,15,15,13,5,18,1,14,7,111
23,15,15,13,5,18,1,19,0,109
23,15,15,13,16,0,0,0,0,82
23,15,15,13,16,9,14,7,0,112
23,15,15,14,0,0,0,0,0,67
23,15,15,14,19,0,0,0,0,86
23,15,15,16,19,0,0,0,0,88
23,15,15,16,19,5,4,0,0,97
23,15,15,16,19,5,19,0,0,112
23,15,15,16,19,9,14,7,0,118
23,15,15,18,1,12,9,0,0,93
23,15,15,18,1,12,9,19,0,112
23,15,15,18,1,18,9,0,0,99
23,15,15,18,1,18,9,19,0,118
23,15,15,18,4,2,15,15,11,118
23,15,15,19,0,0,0,0,0,72
23,15,15,19,8,0,0,0,0,80
23,15,15,19,8,5,4,0,0,89
23,15,15,19,8,5,19,0,0,104
23,15,15,19,8,9,14,7,0,110
23,15,15,20,26,0,0,0,0,99
23,15,15,26,25,0,0,0,0,104
23,15,15,26,9,5,18,0,0,111
23,15,15,26,9,5,19,20,0,132
23,15,15,26,9,12,25,0,0,125
23,15,15,26,9,14,5,19,19,145
23,15,15,26,12,5,0,0,0,96
23,15,16,0,0,0,0,0,0,54
23,15,16,16,9,19,8,0,0,106
23,15,16,19,0,0,0,0,0,73
23,15,16,19,25,0,0,0,0,98
23,15,18,2,12,5,0,0,0,75
23,15,18,4,1,2,12,5,0,80
23,15,18,4,1,2,12,25,0,100
23,15,18,4,1,7,5,0,0,73
23,15,18,4,1,7,5,19,0,92
23,15,18,4,2,15,15,11,0,103
23,15,18,4,2,15,15,11,19,122
23,15,18,4,2,18,5,1,11,97
23,15,18,4,3,18,1,6,20,108
23,15,18,4,5,4,0,0,0,69
23,15,18,4,5,18,0,0,0,83
23,15,18,4,8,15,1,18,4,106
23,15,18,4,25,0,0,0,0,85
23,15,18,4,9,5,18,0,0,92
23,15,18,4,9,5,18,19,0,111
23,15,18,4,9,5,19,20,0,113
23,15,18,4,9,12,25,0,0,106
23,15,18,4,9,14,5,19,19,126
23,15,18,4,9,14,7,0,0,90
23,15,18,4,9,14,7,19,0,109
23,15,18,4,9,19,8,0,0,96
23,15,18,4,9,19,8,12,25,133
23,15,18,4,12,5,0,0,0,77
23,15,18,4,12,5,19,19,0,115
23,15,18,4,12,9,5,18,0,104
23,15,18,4,12,9,11,5,0,97
23,15,18,4,12,15,18,5,0,110
23,15,18,4,13,1,11,5,18,108
23,15,18,4,13,1,14,0,0,88
23,15,18,4,13,5,14,0,0,92
23,15,18,4,14,5,19,19,0,117
23,15,18,4,16,12,1,25,0,114
23,15,18,4,16,12,1,25,19,133
23,15,18,4,19,0,0,0,0,79
23,15,18,4,19,13,1,14,0,107
23,15,18,4,19,13,5,14,0,111
23,15,18,4,19,13,9,20,8,129
23,15,18,4,19,16,9,20,5,129
23,15,18,4,19,20,1,18,0,118
23,15,18,4,19,20,5,18,0,122
23,15,18,5,0,0,0,0,0,61
23,15,18,11,1,2,12,5,0,87
23,15,18,11,1,2,12,25,0,107
23,15,18,11,1,4,1,25,0,98
23,15,18,11,1,23,1,25,0,117
23,15,18,11,2,1,7,0,0,77
23,15,18,11,2,1,7,19,0,96
23,15,18,11,2,1,14,11,0,95
23,15,18,11,2,5,14,3,8,99
23,15,18,11,2,15,1,20,0,105
23,15,18,11,2,15,1,20,19,124
23,15,18,11,2,15,15,11,0,110
23,15,18,11,2,15,15,11,19,129
23,15,18,11,2,15,24,0,0,108
23,15,18,11,2,15,24,5,19,132
23,15,18,11,4,1,25,0,0,97
23,15,18,11,4,1,25,19,0,116
23,15,18,11,5,4,0,0,0,76
23,15,18,11,5,18,0,0,0,90
23,15,18,11,5,18,19,0,0,109
23,15,18,11,6,1,18,5,0,97
23,15,18,11,6,9,12,5,0,99
23,15,18,11,6,15,12,11,0,111
23,15,18,11,6,15,12,11,19,130
23,15,18,11,6,15,18,3,5,114
23,15,18,11,6,21,12,0,0,106
23,15,18,11,7,9,18,12,0,113
23,15,18,11,8,1,14,4,0,94
23,15,18,11,8,15,18,19,5,132
23,15,18,11,8,15,21,19,5,135
23,15,18,11,25,0,0,0,0,92
23,15,18,11,25,1,18,4,0,115
23,15,18,11,9,14,7,0,0,97
23,15,18,11,9,14,7,12,25,134
23,15,18,11,9,14,7,19,0,116
23,15,18,11,12,5,19,19,0,122
23,15,18,11,12,15,1,4,0,99
23,15,18,11,12,15,1,4,19,118
23,15,18,11,12,15,15,13,0,122
23,15,18,11,13,1,14,0,0,95
23,15,18,11,13,1,14,12,25,132
23,15,18,11,13,1,20,5,0,106
23,15,18,11,13,5,14,0,0,99
23,15,18,11,15,21,20,0,0,123
23,15,18,11,15,21,20,19,0,142
23,15,18,11,16,1,14,0,0,98
23,15,18,11,16,9,5,3,5,105
23,15,18,11,16,12,1,3,5,104
23,15,18,11,18,15,15,13,0,128
23,15,18,11,18,15,15,13,19,147
23,15,18,11,19,0,0,0,0,86
23,15,18,11,19,8,5,5,20,124
23,15,18,11,19,8,25,0,0,119
23,15,18,11,19,8,9,16,0,119
23,15,18,11,19,8,15,16,0,125
23,15,18,11,19,8,15,16,19,144
23,15,18,11,19,15,13,5,0,119
23,15,18,11,19,16,1,3,5,111
23,15,18,11,19,20,1,14,4,125
23,15,18,11,20,1,2,12,5,107
23,15,18,11,20,9,13,5,0,114
23,15,18,11,21,16,0,0,0,104
23,15,18,11,21,16,19,0,0,123
23,15,18,11,23,1,25,19,0,135
23,15,18,11,23,5,5,11,0,111
23,15,18,11,23,5,5,11,19,130
23,15,18,11,23,9,19,5,0,123
23,15,18,11,23,15,13,1,14,133
23,15,18,11,23,15,13,5,14,137
23,15,18,12,4,0,0,0,0,72
23,15,18,12,4,5,4,0,0,81
23,15,18,12,4,6,21,12,0,111
23,15,18,12,4,25,0,0,0,97
23,15,18,12,4,9,19,8,0,108
23,15,18,12,4,12,5,19,19,127
23,15,18,12,4,12,5,20,0,109
23,15,18,12,4,12,25,0,0,109
23,15,18,12,4,12,9,5,18,116
23,15,18,12,4,12,9,11,5,109
23,15,18,12,4,12,9,12,25,130
23,15,18,12,4,12,9,14,7,114
23,15,18,12,4,13,1,14,0,100
23,15,18,12,4,19,0,0,0,91
23,15,18,12,4,23,1,25,0,121
23,15,18,12,4,23,1,18,4,118
23,15,18,12,4,23,9,4,5,113
23,15,18,13,3,1,19,20,0,112
23,15,18,13,5,4,0,0,0,78
23,15,18,13,5,18,0,0,0,92
23,15,18,13,5,18,19,0,0,111
23,15,18,13,6,9,19,8,0,111
23,15,18,13,7,5,1,18,0,100
23,15,18,13,8,15,12,5,0,109
23,15,18,13,8,15,12,5,4,113
23,15,18,13,8,15,12,5,19,128
23,15,18,13,8,15,15,4,0,111
23,15,18,13,25,0,0,0,0,94
23,15,18,13,9,5,18,0,0,101
23,15,18,13,9,5,19,20,0,122
23,15,18,13,9,12,0,0,0,90
23,15,18,13,9,12,19,0,0,109
23,15,18,13,9,14,5,19,19,135
23,15,18,13,9,14,7,0,0,99
23,15,18,13,9,19,8,0,0,105
23,15,18,13,12,5,19,19,0,124
23,15,18,13,12,9,11,5,0,106
23,15,18,13,12,9,14,7,0,111
23,15,18,13,16,18,15,15,6,139
23,15,18,13,18,15,15,20,0,137
23,15,18,13,18,15,15,20,19,156
23,15,18,13,19,5,5,4,0,102
23,15,18,13,19,5,5,4,19,121
23,15,18,13,19,8,9,16,0,121
23,15,18,13,23,5,5,4,0,106
23,15,18,13,23,15,15,4,0,126
23,15,18,13,23,15,15,4,19,145
23,15,18,14,0,0,0,0,0,70
23,15,18,14,9,12,0,0,0,91
23,15,18,14,14,5,19,19,0,127
23,15,18,14,15,21,20,0,0,126
23,15,18,18,1,12,0,0,0,87
23,15,18,18,5,12,0,0,0,91
23,15,18,18,25,0,0,0,0,99
23,15,18,18,9,1,2,12,5,103
23,15,18,18,9,3,15,23,0,124
23,15,18,18,9,5,3,15,23,129
23,15,18,18,9,5,4,0,0,92
23,15,18,18,9,5,4,12,25,129
23,15,18,18,9,5,18,0,0,106
23,15,18,18,9,5,18,19,0,125
23,15,18,18,9,5,19,0,0,107
23,15,18,18,25,9,14,7,0,129
23,15,18,18,9,12,5,19,19,138
23,15,18,18,9,13,5,14,20,135
23,15,18,18,9,19,15,13,5,135
23,15,18,18,9,20,0,0,0,103
23,15,18,18,9,20,5,4,0,112
23,15,18,18,9,20,5,18,0,126
23,15,18,18,9,20,9,14,7,133
23,15,18,18,9,20,19,0,0,122
23,15,18,18,25,23,1,18,20,161
23,15,18,18,25,23,15,18,20,175
23,15,18,19,5,0,0,0,0,80
23,15,18,19,5,13,5,14,20,132
23,15,18,19,5,14,0,0,0,94
23,15,18,19,5,14,5,4,0,103
23,15,18,19,5,14,5,19,19,137
23,15,18,19,5,14,9,14,7,124
23,15,18,19,5,14,19,0,0,113
23,15,18,19,5,18,0,0,0,98
23,15,18,19,5,19,0,0,0,99
23,15,18,19,5,20,0,0,0,100
23,15,18,19,5,20,19,0,0,119
23,15,18,19,8,9,16,5,4,117
23,15,18,19,8,9,16,5,18,131
23,15,18,19,8,9,16,19,0,127
23,15,18,19,12,5,0,0,0,92
23,15,18,19,19,5,20,20,0,139
23,15,18,19,20,0,0,0,0,95
23,15,18,19,20,5,4,0,0,104
23,15,18,19,20,5,4,19,0,123
23,15,18,19,20,9,14,7,0,125
23,15,18,19,20,19,0,0,0,114
23,15,18,19,21,13,0,0,0,109
23,15,18,20,0,0,0,0,0,76
23,15,18,20,8,5,4,0,0,93
23,15,18,20,8,6,21,12,0,123
23,15,18,20,8,25,0,0,0,109
23,15,18,20,8,9,5,18,0,116
23,15,18,20,8,9,5,19,0,117
23,15,18,20,8,9,5,19,20,137
23,15,18,20,8,9,12,25,0,130
23,15,18,20,8,12,5,19,19,139
23,15,18,20,8,19,0,0,0,103
23,15,18,20,8,19,8,9,16,136
23,15,18,20,8,23,1,18,4,130
23,15,18,20,12,5,0,0,0,93
23,15,18,20,19,0,0,0,0,95
23,15,18,20,23,15,18,13,0,145
23,15,19,0,0,0,0,0,0,57
23,15,19,2,9,18,4,0,0,90
23,15,19,9,20,8,0,0,0,94
23,15,19,15,13,5,0,0,0,90
23,15,19,20,0,0,0,0,0,77
23,15,19,20,20,5,20,8,0,130
23,15,20,0,0,0,0,0,0,58
23,15,20,5,0,0,0,0,0,63
23,15,20,12,9,14,11,0,0,104
23,15,20,19,0,0,0,0,0,77
23,15,20,20,5,4,0,0,0,87
23,15,20,20,5,19,20,0,0,122
23,15,20,20,5,20,8,0,0,111
23,15,20,20,9,14,7,0,0,108
23,15,21,2,9,20,0,0,0,90
23,15,21,3,8,0,0,0,0,70
23,15,21,6,0,0,0,0,0,65
23,15,21,7,8,0,0,0,0,74
23,15,21,8,12,5,3,8,5,100
23,15,21,12,4,0,0,0,0,75
23,15,21,12,4,5,19,20,0,119
23,15,21,12,4,9,14,7,0,105
23,15,21,12,4,14,0,0,0,89
23,15,21,12,4,14,20,0,0,109
23,15,21,12,4,19,20,0,0,114
23,15,21,12,6,5,0,0,0,82
23,15,21,14,4,0,0,0,0,77
23,15,21,14,4,1,2,12,5,97
23,15,21,14,4,5,4,0,0,86
23,15,21,14,4,5,4,12,25,123
23,15,21,14,4,5,18,0,0,100
23,15,21,14,4,25,0,0,0,102
23,15,21,14,4,9,12,25,0,123
23,15,21,14,4,9,14,7,0,107
23,15,21,14,4,12,5,19,19,132
23,15,21,14,4,12,25,0,0,114
23,15,21,14,4,19,0,0,0,96
23,15,21,14,4,23,15,18,20,153
23,15,21,18,1,12,9,0,0,99
23,15,21,18,1,18,9,0,0,105
23,15,21,18,14,9,12,0,0,112
23,15,21,19,20,15,21,18,0,152
23,15,22,5,0,0,0,0,0,65
23,15,22,5,14,0,0,0,0,79
23,15,22,5,14,19,0,0,0,98
23,15,23,5,4,0,0,0,0,70
23,15,23,5,14,9,14,7,0,110
23,15,23,9,14,7,0,0,0,91
23,15,23,19,0,0,0,0,0,80
23,15,23,19,5,18,0,0,0,103
23,15,23,19,5,18,4,15,13,135
23,15,23,19,5,18,25,0,0,128
23,15,23,19,5,18,9,1,14,127
23,15,23,19,5,18,9,19,8,139
23,15,23,19,5,18,9,19,13,144
23,15,23,19,5,18,19,0,0,122
23,15,23,20,0,0,0,0,0,81
23,15,23,23,15,23,19,0,0,141
23,16,13,0,0,0,0,0,0,52
23,18,5,1,11,0,0,0,0,58
23,18,5,1,11,5,4,0,0,67
23,18,5,1,11,5,18,0,0,81
23,18,5,1,11,5,18,19,0,100
23,18,5,1,11,6,21,12,0,97
23,18,5,1,11,9,14,7,0,88
23,18,5,1,11,12,5,19,19,113
23,18,5,1,11,19,0,0,0,77
23,18,5,1,20,0,0,0,0,67
23,18,5,1,20,8,0,0,0,75
23,18,5,1,20,8,1,7,5,88
23,18,5,1,20,8,5,0,0,80
23,18,5,1,20,8,5,4,0,84
23,18,5,1,20,8,5,14,0,94
23,18,5,1,20,8,5,18,0,98
23,18,5,1,20,8,5,19,0,99
23,18,5,1,20,8,25,0,0,100
23,18,5,1,20,8,9,14,7,105
23,18,5,1,20,8,12,5,20,112
23,18,5,1,20,8,19,0,0,94
23,18,5,3,11,0,0,0,0,60
23,18,5,3,11,1,7,5,0,73
23,18,5,3,11,1,7,5,19,92
23,18,5,3,11,5,4,0,0,69
23,18,5,3,11,5,18,0,0,83
23,18,5,3,11,5,18,19,0,102
23,18,5,3,11,6,9,19,8,102
23,18,5,3,11,6,21,12,0,99
23,18,5,3,11,25,0,0,0,85
23,18,5,3,11,9,14,7,0,90
23,18,5,3,11,9,14,7,19,109
23,18,5,3,11,19,0,0,0,79
23,18,5,14,3,8,5,4,0,80
23,18,5,14,3,8,5,18,0,94
23,18,5,14,3,8,5,19,0,95
23,18,5,14,3,8,9,14,7,101
23,18,5,14,12,5,20,0,0,97
23,18,5,14,12,9,11,5,0,97
23,18,5,14,20,1,9,12,0,102
23,18,5,19,20,0,0,0,0,85
23,18,5,19,20,1,2,12,5,105
23,18,5,19,20,5,4,0,0,94
23,18,5,19,20,5,18,0,0,108
23,18,5,19,20,5,18,19,0,127
23,18,5,19,20,9,14,7,0,115
23,18,5,19,20,12,5,0,0,102
23,18,5,19,20,12,5,4,0,106
23,18,5,19,20,12,5,18,0,120
23,18,5,19,20,12,5,18,19,139
23,18,5,19,20,12,5,19,0,121
23,18,5,19,20,12,9,14,7,127
23,18,5,19,20,19,0,0,0,104
23,18,5,20,3,8,0,0,0,77
23,18,5,20,3,8,5,4,0,86
23,18,5,20,3,8,5,19,0,101
23,18,5,20,3,8,15,3,11,106
23,18,25,0,0,0,0,0,0,66
23,18,25,2,9,12,12,0,0,101
23,18,9,2,12,5,0,0,0,69
23,18,9,3,8,20,0,0,0,81
23,18,9,3,11,0,0,0,0,64
23,18,9,3,11,5,4,0,0,73
23,18,9,3,11,9,14,7,0,94
23,18,9,3,11,19,0,0,0,83
23,18,9,4,5,0,0,0,0,59
23,18,9,5,4,0,0,0,0,59
23,18,9,5,18,0,0,0,0,73
23,18,25,5,18,0,0,0,0,89
23,18,9,5,19,0,0,0,0,74
23,18,9,5,19,20,0,0,0,94
23,18,25,5,19,20,0,0,0,110
23,18,9,7,0,0,0,0,0,57
23,18,9,7,7,12,5,0,0,81
23,18,9,7,7,12,5,4,0,85
23,18,9,7,7,12,5,18,0,99
23,18,9,7,7,12,5,18,19,118
23,18,9,7,7,12,5,19,0,100
23,18,9,7,7,12,25,0,0,101
23,18,9,7,7,12,9,5,18,108
23,18,9,7,7,12,9,14,7,106
23,18,9,7,8,20,9,14,5,113
23,18,9,7,8,20,18,25,0,128
23,18,9,8,20,5,0,0,0,83
23,18,25,9,14,7,0,0,0,96
23,18,25,12,25,0,0,0,0,103
23,18,25,13,15,21,20,8,0,143
23,18,25,13,15,21,20,8,19,162
23,18,9,13,16,12,5,0,0,96
23,18,25,14,5,3,11,0,0,99
23,18,25,14,5,3,11,5,4,108
23,18,25,14,5,3,11,19,0,118
23,18,25,14,5,19,19,0,0,123
23,18,25,14,5,19,19,5,19,147
23,18,9,14,7,0,0,0,0,71
23,18,9,14,7,2,15,12,20,120
23,18,9,14,7,5,4,0,0,80
23,18,9,14,7,5,18,0,0,94
23,18,9,14,7,5,18,19,0,113
23,18,9,14,7,9,14,7,0,101
23,18,9,14,7,12,5,0,0,88
23,18,9,14,7,13,1,14,0,99
23,18,9,14,7,19,0,0,0,90
23,18,9,14,11,12,5,0,0,92
23,18,9,14,11,12,5,4,0,96
23,18,9,14,11,12,5,4,25,121
23,18,9,14,11,12,5,19,0,111
23,18,9,14,11,12,5,20,0,112
23,18,9,14,11,12,25,0,0,112
23,18,9,14,11,12,9,5,18,119
23,18,9,14,11,12,9,14,7,117
23,18,9,19,20,0,0,0,0,89
23,18,9,19,20,2,1,14,4,110
23,18,9,19,20,2,15,14,5,125
23,18,9,19,20,4,18,15,16,142
23,18,9,19,20,5,4,0,0,98
23,18,9,19,20,5,18,0,0,112
23,18,9,19,20,6,1,12,12,120
23,18,9,19,20,25,0,0,0,114
23,18,9,19,20,9,5,18,0,121
23,18,9,19,20,9,5,19,20,142
23,18,9,19,20,9,11,9,14,132
23,18,9,19,20,12,5,20,0,126
23,18,9,19,20,12,5,20,19,145
23,18,9,19,20,12,15,3,11,130
23,18,9,19,20,19,0,0,0,108
23,18,9,19,20,23,15,18,11,156
23,18,9,20,0,0,0,0,0,70
23,18,9,20,1,2,12,5,0,90
23,18,25,20,1,9,12,0,0,108
23,18,9,20,1,20,9,15,14,129
23,18,9,20,1,20,9,22,5,127
23,18,9,20,5,0,0,0,0,75
23,18,9,20,5,1,2,12,5,95
23,18,9,20,5,5,0,0,0,80
23,18,9,20,5,15,6,6,0,102
23,18,9,20,5,15,6,6,19,121
23,18,9,20,5,18,0,0,0,93
23,18,9,20,5,18,5,19,19,136
23,18,9,20,5,18,12,25,0,130
23,18,9,20,5,18,19,0,0,112
23,18,9,20,5,19,0,0,0,94
23,18,9,20,5,21,16,0,0,112
23,18,9,20,5,21,16,19,0,131
23,18,9,20,8,0,0,0,0,78
23,18,9,20,8,5,0,0,0,83
23,18,9,20,8,5,4,0,0,87
23,18,9,20,8,5,4,12,25,124
23,18,9,20,8,5,14,0,0,97
23,18,9,20,8,5,18,0,0,101
23,18,9,20,8,5,18,19,0,120
23,18,9,20,8,5,19,0,0,102
23,18,9,20,8,25,0,0,0,103
23,18,9,20,8,9,14,7,0,108
23,18,9,20,8,12,5,4,0,99
23,18,9,20,9,14,7,0,0,100
23,18,9,20,9,14,7,5,18,123
23,18,9,20,13,1,11,5,18,118
23,18,9,20,16,18,15,15,6,140
23,18,9,20,19,0,0,0,0,89
23,18,9,20,20,5,14,0,0,109
23,18,9,20,20,5,18,0,0,113
23,18,9,22,5,0,0,0,0,77
23,18,9,24,12,5,0,0,0,91
23,18,9,26,26,12,5,4,0,123
23,18,14,20,0,0,0,0,0,75
23,18,15,0,0,0,0,0,0,56
23,18,15,3,8,20,0,0,0,87
23,18,15,11,5,0,0,0,0,72
23,18,15,11,5,14,0,0,0,86
23,18,15,14,7,0,0,0,0,77
23,18,15,14,7,4,15,0,0,96
23,18,15,14,7,4,15,5,18,119
23,18,15,14,7,5,4,0,0,86
23,18,15,14,7,5,18,0,0,100
23,18,15,14,7,5,18,19,0,119
23,18,15,14,7,5,19,20,0,121
23,18,15,14,7,6,9,12,5,109
23,18,15,14,7,6,21,12,0,116
23,18,15,14,7,6,21,12,25,141
23,18,15,14,7,8,5,1,4,95
23,18,15,14,7,9,14,7,0,107
23,18,15,14,7,9,19,8,0,113
23,18,15,14,7,12,5,19,19,132
23,18,15,14,7,12,25,0,0,114
23,18,15,14,7,14,5,19,19,134
23,18,15,14,7,15,21,19,0,132
23,18,15,14,7,18,5,12,0,112
23,18,15,14,7,19,0,0,0,96
23,18,15,14,7,23,9,19,5,133
23,18,15,15,20,0,0,0,0,91
23,18,15,19,19,12,5,0,0,111
23,18,15,20,5,0,0,0,0,81
23,18,15,20,8,0,0,0,0,84
23,18,15,20,8,5,0,0,0,89
23,18,15,20,8,6,21,12,0,123
23,18,15,20,8,25,0,0,0,109
23,18,15,20,8,9,12,25,0,130
23,18,15,20,8,12,25,0,0,121
23,18,15,20,8,19,15,13,5,136
23,18,15,21,7,8,20,0,0,112
23,18,15,24,0,0,0,0,0,80
23,18,21,14,7,0,0,0,0,83
23,18,21,14,7,14,5,19,19,140
23,21,4,0,0,0,0,0,0,48
23,21,4,4,9,5,0,0,0,66
23,21,4,7,5,0,0,0,0,60
23,21,4,21,0,0,0,0,0,69
23,21,6,6,0,0,0,0,0,56
23,21,7,7,0,0,0,0,0,58
23,21,12,4,5,18,0,0,0,83
23,21,12,6,5,14,9,20,5,115
23,21,12,11,0,0,0,0,0,67
23,21,12,12,0,0,0,0,0,68
23,21,12,12,1,23,9,14,19,134
23,21,12,12,3,1,20,0,0,92
23,21,12,12,9,23,1,0,0,101
23,21,13,2,12,5,0,0,0,76
23,21,13,13,1,14,0,0,0,85
23,21,13,13,5,12,0,0,0,87
23,21,14,4,5,18,2,1,18,106
23,21,14,7,5,5,0,0,0,75
23,21,14,14,1,0,0,0,0,73
23,21,14,14,5,18,0,0,0,95
23,21,14,19,15,13,5,0,0,110
23,21,14,20,5,5,0,0,0,88
23,21,16,0,0,0,0,0,0,60
23,21,18,0,0,0,0,0,0,62
23,21,18,12,5,25,0,0,0,104
23,21,18,12,5,25,19,0,0,123
23,21,18,12,25,0,0,0,0,99
23,21,18,12,9,5,19,0,0,107
23,21,18,13,1,12,0,0,0,88
23,21,18,18,1,12,21,8,0,122
23,21,18,18,21,14,7,0,0,122
23,21,18,18,21,16,0,0,0,117
23,21,18,18,21,19,0,0,0,120
23,21,18,19,5,20,0,0,0,106
23,21,18,19,20,19,0,0,0,120
23,21,18,20,26,9,20,5,0,142
23,21,18,20,26,9,20,9,3,149
23,21,18,26,5,12,0,0,0,105
23,21,18,26,5,12,19,0,0,124
23,21,19,0,0,0,0,0,0,63
23,21,19,8,0,0,0,0,0,71
23,21,19,16,0,0,0,0,0,79
23,21,19,19,0,0,0,0,0,82
23,21,19,19,5,18,0,0,0,105
23,21,19,20,0,0,0,0,0,83
23,21,20,0,0,0,0,0,0,64
23,21,20,8,5,18,0,0,0,95
23,21,20,8,5,18,9,14,7,125
23,21,26,21,0,0,0,0,0,91
23,21,26,26,5,18,0,0,0,119
23,21,26,26,25,0,0,0,0,121
23,21,26,26,12,5,0,0,0,113
23,21,26,26,12,5,4,0,0,117
23,21,26,26,12,9,14,7,0,138
24,3,12,0,0,0,0,0,0,39
24,3,20,12,0,0,0,0,0,59
24,4,9,22,0,0,0,0,0,59
24,5,2,5,3,0,0,0,0,39
24,5,2,5,3,19,0,0,0,58
24,5,4,0,0,0,0,0,0,33
24,5,13,5,0,0,0,0,0,47
24,5,14,1,7,15,7,25,0,98
24,5,14,1,7,15,7,21,5,99
24,5,14,5,12,1,19,25,0,105
24,5,14,5,12,1,19,9,1,90
24,5,14,9,1,12,0,0,0,65
24,5,14,9,1,14,0,0,0,67
24,5,14,9,1,19,0,0,0,72
24,5,14,9,3,0,0,0,0,55
24,5,14,9,3,1,12,12,25,105
24,5,14,25,12,0,0,0,0,80
24,5,14,9,21,13,0,0,0,86
24,5,14,15,2,12,1,19,20,112
24,5,14,15,3,8,9,1,0,79
24,5,14,15,3,25,19,20,0,125
24,5,14,15,3,18,25,19,20,143
24,5,14,15,4,5,18,13,0,98
24,5,14,15,4,15,3,8,25,113
24,5,14,15,7,1,13,25,0,104
24,5,14,15,7,5,14,25,0,109
24,5,14,15,7,5,14,9,3,96
24,5,14,15,7,18,1,6,20,110
24,5,14,15,12,9,20,5,0,104
24,5,14,15,12,9,20,8,0,107
24,5,14,15,12,9,20,8,19,126
24,5,14,15,13,1,14,9,1,96
24,5,14,15,14,0,0,0,0,72
24,5,14,15,14,19,0,0,0,91
24,5,14,15,16,8,25,1,0,108
24,5,14,15,16,8,9,12,5,108
24,5,14,15,16,8,15,2,5,104
24,5,14,15,16,8,15,2,25,124
24,5,14,15,16,15,4,9,4,106
24,5,14,15,20,9,13,5,0,105
24,5,18,1,6,9,14,0,0,77
24,5,18,1,14,19,9,19,0,109
24,5,18,1,14,20,9,3,0,94
24,5,18,1,16,8,9,14,0,95
24,5,18,1,18,3,8,0,0,77
24,5,18,1,19,9,1,0,0,77
24,5,18,9,3,0,0,0,0,59
24,5,18,9,3,1,12,12,25,109
24,5,18,9,6,6,0,0,0,68
24,5,18,15,3,12,9,14,5,105
24,5,18,15,4,5,18,13,1,103
24,5,18,15,7,5,12,0,0,86
24,5,18,15,13,1,0,0,0,76
24,5,18,15,13,1,20,1,0,97
24,5,18,15,13,5,14,9,1,104
24,5,18,15,13,25,18,15,14,147
24,5,18,15,13,25,18,21,13,152
24,5,18,15,13,15,18,16,8,132
24,5,18,15,14,1,20,5,0,102
24,5,18,15,14,9,3,0,0,88
24,5,18,15,16,8,1,7,25,119
24,5,18,15,16,8,9,12,0,107
24,5,18,15,16,8,9,12,5,112
24,5,18,15,16,8,9,12,25,132
24,5,18,15,16,8,25,20,5,136
24,5,18,15,19,5,18,5,0,109
24,5,18,15,19,5,18,5,19,128
24,5,18,15,19,5,19,0,0,105
24,5,18,15,19,9,19,0,0,109
24,5,18,15,19,20,15,13,1,130
24,5,18,15,20,5,19,0,0,106
24,5,18,15,20,8,5,18,13,126
24,5,18,15,20,9,3,0,0,94
24,5,18,15,20,15,3,9,1,110
24,5,18,15,24,5,4,0,0,95
24,5,18,15,24,5,19,0,0,110
24,5,18,15,24,9,14,7,0,116
24,5,18,21,19,5,19,0,0,111
24,9,9,0,0,0,0,0,0,42
24,9,9,9,0,0,0,0,0,51
24,25,12,1,0,0,0,0,0,62
24,25,12,1,14,0,0,0,0,76
24,25,12,1,14,19,0,0,0,95
24,25,12,1,20,5,0,0,0,87
24,25,12,5,13,0,0,0,0,79
24,25,12,5,13,19,0,0,0,98
24,25,12,5,14,5,0,0,0,85
24,25,12,5,14,5,19,0,0,104
24,25,12,5,14,25,12,0,0,117
24,25,12,5,14,15,12,0,0,107
24,25,12,5,20,9,3,0,0,98
24,25,12,9,3,0,0,0,0,73
24,25,12,9,4,9,3,0,0,86
24,25,12,9,4,9,14,0,0,97
24,25,12,9,4,9,14,5,0,102
24,25,12,9,4,9,14,5,19,121
24,25,12,9,4,9,14,19,0,116
24,25,12,25,12,0,0,0,0,98
24,25,12,25,12,5,14,5,0,122
24,25,12,25,12,9,3,0,0,110
24,25,12,25,12,19,0,0,0,117
24,25,12,9,14,4,5,9,14,116
24,25,12,9,14,9,4,0,0,97
24,25,12,9,20,5,0,0,0,95
24,25,12,9,20,15,12,0,0,117
24,25,12,9,20,15,12,19,0,136
24,25,12,9,20,15,14,5,0,124
24,25,12,15,0,0,0,0,0,76
24,25,12,15,3,1,18,16,0,114
24,25,12,15,3,1,18,16,19,133
24,25,12,15,3,15,16,9,4,123
24,25,12,15,7,5,14,0,0,102
24,25,12,15,7,18,1,16,8,126
24,25,12,15,9,4,0,0,0,89
24,25,12,15,9,4,9,14,0,112
24,25,12,15,9,4,9,14,5,117
24,25,12,15,25,12,0,0,0,113
24,25,12,15,12,0,0,0,0,88
24,25,12,15,12,15,7,25,0,135
24,25,12,15,12,19,0,0,0,107
24,25,12,15,13,1,0,0,0,90
24,25,12,15,13,1,14,3,25,132
24,25,12,15,13,1,19,0,0,109
24,25,12,15,13,1,20,1,0,111
24,25,12,15,13,5,20,5,18,137
24,25,12,15,14,9,3,0,0,102
24,25,12,15,16,8,1,7,5,113
24,25,12,15,16,8,15,14,5,134
24,25,12,15,18,3,9,14,0,120
24,25,12,15,19,5,0,0,0,100
24,25,12,15,19,5,19,0,0,119
24,25,12,15,19,9,4,0,0,108
24,25,12,15,19,9,4,5,0,113
24,25,12,15,20,9,12,5,0,122
24,25,12,15,20,15,13,25,0,149
24,25,12,15,20,15,13,9,3,136
24,9,14,20,0,0,0,0,0,67
24,9,16,8,9,9,4,0,0,79
24,9,16,8,9,15,9,4,0,94
24,9,16,8,9,19,20,14,1,120
24,9,16,8,15,9,4,0,0,85
24,25,16,8,15,9,4,0,0,101
24,9,16,8,15,9,4,1,12,98
24,9,16,8,15,9,4,19,0,104
24,9,16,8,15,19,21,18,5,135
24,9,16,8,21,15,21,19,0,133
24,25,18,9,4,0,0,0,0,80
24,9,19,0,0,0,0,0,0,52
24,25,19,20,0,0,0,0,0,88
24,25,19,20,5,18,0,0,0,111
24,25,19,20,5,18,19,0,0,130
24,25,19,20,9,0,0,0,0,97
24,25,19,20,15,9,0,0,0,112
24,25,19,20,15,19,0,0,0,122
24,25,19,20,19,0,0,0,0,107
24,25,19,20,21,13,0,0,0,122
24,25,19,20,21,19,0,0,0,128
24,9,22,0,0,0,0,0,0,55
24,9,24,0,0,0,0,0,0,57
24,25,26,0,0,0,0,0,0,75
24,15,14,15,20,12,9,20,5,134
24,18,5,6,0,0,0,0,0,53
24,21,18,5,12,0,0,0,0,80
24,22,9,0,0,0,0,0,0,55
24,22,9,9,0,0,0,0,0,64
24,22,9,9,9,0,0,0,0,73
24,24,9,0,0,0,0,0,0,57
24,24,9,9,0,0,0,0,0,66
24,24,9,9,9,0,0,0,0,75
24,24,9,22,0,0,0,0,0,79
24,24,22,0,0,0,0,0,0,70
24,24,24,0,0,0,0,0,0,72
26,5,2,5,3,0,0,0,0,41
26,5,2,5,3,11,0,0,0,52
26,5,2,5,3,11,19,0,0,71
26,5,2,5,3,19,0,0,0,60
26,5,2,18,1,0,0,0,0,52
26,5,2,18,1,6,9,19,8,94
26,5,2,18,1,9,3,0,0,64
26,5,2,18,1,12,9,11,5,89
26,5,2,18,1,19,0,0,0,71
26,5,2,18,1,19,19,0,0,90
26,5,2,18,1,19,19,5,19,114
26,5,2,18,1,23,15,15,4,109
26,5,2,18,9,14,5,0,0,79
26,5,2,18,9,14,14,25,0,113
26,5,2,18,15,9,4,0,0,79
26,5,2,18,21,12,1,0,0,85
26,5,2,18,21,12,5,0,0,89
26,5,2,21,0,0,0,0,0,54
26,5,2,21,2,0,0,0,0,56
26,5,2,21,18,18,15,0,0,105
26,5,2,21,19,0,0,0,0,73
26,5,3,3,8,9,14,0,0,68
26,5,3,3,8,9,14,9,0,77
26,5,3,3,8,9,14,15,0,83
26,5,3,3,8,9,14,15,19,102
26,5,3,3,8,9,14,19,0,87
26,5,3,8,9,14,0,0,0,65
26,5,3,8,9,14,19,0,0,84
26,5,4,15,1,18,25,0,0,94
26,5,4,15,1,18,9,5,19,102
26,5,4,19,0,0,0,0,0,54
26,5,5,0,0,0,0,0,0,36
26,5,5,4,0,0,0,0,0,40
26,5,5,11,15,5,0,0,0,67
26,5,5,19,0,0,0,0,0,55
26,5,8,14,5,18,0,0,0,76
26,5,9,12,1,14,9,20,5,101
26,5,9,14,0,0,0,0,0,54
26,5,9,14,19,0,0,0,0,73
26,5,9,19,13,0,0,0,0,72
26,5,11,0,0,0,0,0,0,42
26,5,11,19,0,0,0,0,0,61
26,5,12,1,14,20,0,0,0,78
26,5,12,1,20,15,18,0,0,97
26,5,12,1,20,18,9,3,5,99
26,5,12,1,20,18,9,24,0,115
26,5,12,11,15,22,1,19,0,111
26,5,12,15,20,9,3,0,0,90
26,5,12,15,20,25,16,9,1,129
26,5,12,15,20,25,16,9,5,133
26,5,13,5,0,0,0,0,0,49
26,5,13,5,9,19,13,0,0,90
26,5,13,9,0,0,0,0,0,53
26,5,13,9,9,19,13,0,0,94
26,5,13,9,13,4,1,18,9,98
26,5,13,9,14,4,1,18,0,90
26,5,13,9,14,4,1,18,9,99
26,5,13,9,14,4,1,18,25,115
26,5,13,9,14,4,1,18,19,109
26,5,13,13,9,0,0,0,0,66
26,5,13,14,9,0,0,0,0,67
26,5,13,19,20,22,1,0,0,106
26,5,13,19,20,22,15,0,0,120
26,5,13,19,20,22,15,19,0,139
26,5,14,1,9,4,1,19,0,79
26,5,14,1,14,1,0,0,0,61
26,5,14,1,14,1,19,0,0,80
26,5,14,4,9,3,9,1,14,85
26,5,14,4,9,11,0,0,0,69
26,5,14,4,9,11,9,20,5,103
26,5,14,4,15,0,0,0,0,64
26,5,14,4,15,19,0,0,0,83
26,5,14,9,3,11,0,0,0,68
26,5,14,9,20,8,0,0,0,82
26,5,14,9,20,8,1,12,0,95
26,5,14,9,20,8,19,0,0,101
26,5,14,20,14,5,18,0,0,102
26,5,14,21,0,0,0,0,0,66
26,5,14,26,21,9,3,0,0,104
26,5,15,12,9,20,5,0,0,92
26,5,15,12,9,20,5,19,0,111
26,5,15,12,9,20,9,3,0,99
26,5,15,12,9,20,9,26,5,127
26,5,15,19,3,15,16,5,0,104
26,5,16,8,9,18,1,14,0,97
26,5,16,8,25,18,5,1,14,118
26,5,16,8,25,18,25,0,0,123
26,5,16,8,25,18,9,1,14,122
26,5,16,8,25,18,15,21,19,153
26,5,16,8,25,18,19,0,0,117
26,5,16,16,5,12,9,14,19,122
26,5,17,21,9,14,0,0,0,92
26,5,18,0,0,0,0,0,0,49
26,5,18,4,1,0,0,0,0,54
26,5,18,5,2,1,0,0,0,57
26,5,18,13,1,8,2,21,2,96
26,5,18,15,0,0,0,0,0,64
26,5,18,15,1,24,9,1,12,111
26,5,18,15,5,4,0,0,0,73
26,5,18,15,5,19,0,0,0,88
26,5,18,15,5,20,8,0,0,97
26,5,18,15,9,14,7,0,0,94
26,5,18,15,9,26,5,0,0,104
26,5,18,15,19,0,0,0,0,83
26,5,18,15,20,8,0,0,0,92
26,5,18,21,13,2,5,20,0,110
26,5,19,20,0,0,0,0,0,70
26,5,19,20,5,4,0,0,0,79
26,5,19,20,6,21,12,0,0,109
26,5,19,20,6,21,12,12,25,146
26,5,19,20,25,0,0,0,0,95
26,5,19,20,9,5,18,0,0,102
26,5,19,20,9,5,19,20,0,123
26,5,19,20,9,14,5,19,19,136
26,5,19,20,9,14,7,0,0,100
26,5,19,20,12,5,19,19,0,125
26,5,19,20,19,0,0,0,0,89
26,5,20,1,3,9,19,13,0,96
26,5,20,1,19,0,0,0,0,71
26,5,20,5,20,9,3,0,0,88
26,5,21,7,9,20,5,0,0,93
26,5,21,7,13,1,0,0,0,73
26,5,21,7,13,1,19,0,0,92
26,5,21,7,13,1,20,9,3,105
26,5,21,14,5,18,9,20,5,123
26,5,21,24,9,20,5,0,0,110
26,5,21,26,5,18,9,1,14,125
26,8,15,0,0,0,0,0,0,49
26,9,2,5,12,9,14,5,0,82
26,9,2,5,12,9,14,5,19,101
26,9,2,5,12,12,9,14,5,94
26,9,2,5,20,0,0,0,0,62
26,9,2,5,20,8,0,0,0,70
26,9,2,5,20,8,15,14,5,104
26,9,2,5,20,8,19,0,0,89
26,9,2,5,20,15,14,5,0,96
26,9,2,5,20,19,0,0,0,81
26,9,2,5,20,21,13,0,0,96
26,9,3,26,1,3,0,0,0,68
26,25,4,5,3,15,0,0,0,78
26,25,4,5,3,15,19,0,0,97
26,9,5,7,1,0,0,0,0,48
26,9,5,7,5,18,0,0,0,70
26,9,6,6,0,0,0,0,0,47
26,9,6,6,19,0,0,0,0,66
26,9,7,0,0,0,0,0,0,42
26,25,7,1,0,0,0,0,0,59
26,25,7,1,4,5,14,9,14,105
26,25,7,1,4,9,20,5,0,97
26,25,7,1,5,14,9,4,0,91
26,25,7,1,12,0,0,0,0,71
26,9,7,1,13,15,18,16,8,113
26,9,7,1,14,0,0,0,0,57
26,9,7,1,14,11,1,0,0,69
26,25,7,1,14,20,18,1,0,112
26,25,7,1,14,20,18,21,13,145
26,25,7,5,14,9,4,0,0,90
26,9,7,7,5,4,0,0,0,58
26,9,7,7,5,18,0,0,0,72
26,9,7,7,9,14,7,0,0,79
26,9,7,7,21,18,1,20,0,109
26,9,7,7,21,18,1,20,19,128
26,25,7,9,15,14,0,0,0,96
26,25,7,9,20,5,0,0,0,92
26,25,7,15,4,15,14,20,0,126
26,25,7,15,9,4,0,0,0,86
26,25,7,15,13,1,0,0,0,87
26,25,7,15,13,1,19,0,0,106
26,25,7,15,13,1,20,1,0,108
26,25,7,15,13,1,20,9,3,119
26,25,7,15,14,0,0,0,0,87
26,25,7,15,14,5,21,18,5,136
26,25,7,15,16,8,25,20,5,147
26,25,7,15,16,8,15,18,5,135
26,25,7,15,19,5,0,0,0,97
26,25,7,15,19,5,19,0,0,116
26,25,7,15,19,9,19,0,0,120
26,25,7,15,19,9,20,25,0,146
26,25,7,15,19,16,5,18,13,144
26,25,7,15,19,16,15,18,5,146
26,25,7,15,19,20,25,12,5,154
26,25,7,15,20,1,24,9,19,146
26,25,7,15,20,5,0,0,0,98
26,25,7,15,20,5,14,5,0,117
26,25,7,15,20,5,14,5,19,136
26,25,7,15,20,5,19,0,0,117
26,25,7,15,20,9,3,0,0,105
26,25,7,15,20,15,9,4,0,121
26,25,7,15,21,19,0,0,0,113
26,9,7,19,0,0,0,0,0,61
26,9,7,26,1,7,0,0,0,76
26,9,7,26,1,7,7,5,4,92
26,9,7,26,1,7,7,5,18,106
26,9,7,26,1,7,7,25,0,108
26,9,7,26,1,7,19,0,0,95
26,9,8,1,18,0,0,0,0,62
26,9,11,11,21,18,1,20,0,117
26,9,11,11,21,18,1,20,19,136
26,9,11,21,18,1,20,0,0,106
26,9,11,21,18,1,20,19,0,125
26,9,12,1,0,0,0,0,0,48
26,9,12,3,8,0,0,0,0,58
26,9,12,3,8,5,19,0,0,82
26,9,12,12,0,0,0,0,0,59
26,9,12,12,1,8,19,0,0,87
26,9,12,12,9,15,14,0,0,97
26,9,12,12,9,15,14,19,0,116
26,9,12,12,9,15,14,20,8,125
26,9,12,12,19,0,0,0,0,78
26,9,13,1,18,18,1,0,0,86
26,25,13,1,19,5,0,0,0,89
26,25,13,1,19,5,19,0,0,108
26,9,13,2,0,0,0,0,0,50
26,9,13,2,1,12,15,14,0,92
26,9,13,2,1,12,15,15,14,107
26,9,13,2,9,0,0,0,0,59
26,25,13,5,0,0,0,0,0,69
26,25,13,5,19,0,0,0,0,88
26,25,13,9,3,0,0,0,0,76
26,25,13,9,14,0,0,0,0,87
26,25,13,9,20,5,0,0,0,98
26,9,13,13,5,0,0,0,0,66
26,9,13,13,9,0,0,0,0,70
26,9,13,13,25,0,0,0,0,86
26,9,13,13,9,19,0,0,0,89
26,9,13,15,3,3,1,0,0,70
26,25,13,15,7,5,14,0,0,105
26,25,13,15,7,5,14,5,0,110
26,25,13,15,7,5,14,5,19,129
26,25,13,15,7,5,14,9,3,117
26,25,13,15,7,5,14,19,0,124
26,25,13,15,7,18,1,13,0,118
26,25,13,15,7,18,1,13,19,137
26,25,13,15,9,4,0,0,0,92
26,25,13,15,12,25,9,19,0,144
26,25,13,15,12,25,19,9,19,163
26,25,13,15,12,25,20,9,3,148
26,25,13,15,12,15,7,25,0,138
26,25,13,15,12,15,7,9,3,125
26,25,13,15,13,5,0,0,0,97
26,25,13,15,13,5,20,5,18,140
26,25,13,15,13,9,14,0,0,115
26,25,13,15,16,8,25,20,5,153
26,25,13,15,16,8,15,18,5,141
26,25,13,15,19,1,14,0,0,113
26,25,13,15,19,1,14,19,0,132
26,25,13,15,19,3,15,16,5,137
26,25,13,15,19,5,19,0,0,122
26,25,13,15,19,9,19,0,0,126
26,25,13,15,20,9,3,0,0,111
26,25,13,15,20,9,26,5,0,139
26,25,13,15,20,15,24,9,3,150
26,25,13,21,18,7,25,0,0,135
26,25,13,21,18,7,9,5,19,143
26,9,14,3,0,0,0,0,0,52
26,9,14,3,1,20,5,0,0,78
26,9,14,3,1,20,5,19,0,97
26,9,14,3,5,4,0,0,0,61
26,9,14,3,5,14,9,20,5,105
26,9,14,3,25,0,0,0,0,77
26,9,14,3,9,3,0,0,0,64
26,9,14,3,9,4,0,0,0,65
26,9,14,3,9,4,5,0,0,70
26,9,14,3,9,6,25,0,0,92
26,9,14,3,9,6,9,5,4,85
26,9,14,3,9,6,9,5,19,100
26,9,14,3,9,14,7,0,0,82
26,9,14,3,9,20,5,0,0,86
26,9,14,3,9,20,5,19,0,105
26,9,14,3,9,26,5,0,0,92
26,9,14,3,11,5,0,0,0,68
26,9,14,3,11,5,4,0,0,72
26,9,14,3,11,25,0,0,0,88
26,9,14,3,11,9,14,7,0,93
26,9,14,3,15,0,0,0,0,67
26,9,14,3,15,4,5,0,0,76
26,9,14,3,15,9,4,0,0,80
26,9,14,3,15,20,25,16,5,133
26,9,14,3,15,21,19,0,0,107
26,9,14,3,19,0,0,0,0,71
26,9,14,3,21,13,0,0,0,86
26,9,14,3,21,18,5,20,0,116
26,9,14,4,1,2,1,4,0,61
26,9,14,4,9,17,0,0,0,79
26,9,14,5,2,0,0,0,0,56
26,9,14,5,2,19,0,0,0,75
26,9,14,7,0,0,0,0,0,56
26,9,14,7,1,14,1,0,0,72
26,9,14,7,1,14,9,0,0,80
26,9,14,7,1,14,15,0,0,86
26,9,14,7,1,18,1,0,0,76
26,9,14,7,1,18,5,0,0,80
26,9,14,7,1,18,9,0,0,84
26,9,14,7,1,18,15,0,0,90
26,9,14,7,5,4,0,0,0,65
26,9,14,7,5,12,0,0,0,73
26,9,14,7,5,18,0,0,0,79
26,9,14,7,5,18,15,14,5,113
26,9,14,7,5,18,19,0,0,98
26,9,14,7,25,0,0,0,0,81
26,9,14,7,9,5,18,0,0,88
26,9,14,7,9,5,19,20,0,109
26,9,14,7,9,14,7,0,0,86
26,9,14,7,19,0,0,0,0,75
26,9,14,11,5,0,0,0,0,65
26,9,14,11,5,4,0,0,0,69
26,9,14,11,5,14,9,20,5,113
26,9,14,11,25,0,0,0,0,85
26,9,14,11,9,6,25,0,0,100
26,9,14,11,9,6,9,5,4,93
26,9,14,11,9,6,9,5,19,108
26,9,14,14,9,1,19,0,0,92
26,9,14,15,2,5,18,0,0,89
26,9,14,19,1,14,7,0,0,90
26,9,15,14,9,19,20,19,0,131
26,9,16,8,9,1,14,0,0,83
26,9,16,8,9,15,9,4,0,96
26,9,16,12,5,19,19,0,0,106
26,9,16,16,5,4,0,0,0,76
26,9,16,16,5,9,20,5,0,106
26,9,16,16,5,18,5,4,0,99
26,9,16,16,5,18,9,14,7,120
26,9,16,16,5,18,19,0,0,109
26,9,16,16,25,0,0,0,0,92
26,9,16,16,9,5,18,0,0,99
26,9,16,16,9,5,19,20,0,120
26,9,16,16,9,14,7,0,0,97
26,9,16,16,9,14,7,12,25,134
26,9,16,16,16,9,5,18,0,115
26,9,16,16,16,9,5,19,20,136
26,9,18,1,0,0,0,0,0,54
26,9,18,1,9,0,0,0,0,63
26,9,18,1,13,0,0,0,0,67
26,9,18,1,13,19,0,0,0,86
26,9,18,3,1,12,12,15,25,121
26,9,18,3,1,12,15,25,0,109
26,9,18,3,9,20,5,0,0,90
26,9,18,3,15,14,0,0,0,85
26,9,18,3,15,14,1,20,5,111
26,9,18,3,15,14,9,1,14,109
26,9,18,3,15,14,9,1,19,114
26,9,18,3,15,14,9,3,0,97
26,9,18,3,15,14,25,12,0,122
26,9,18,3,15,14,9,21,13,128
26,9,18,3,15,14,15,9,4,113
26,9,18,3,15,14,19,0,0,104
26,9,18,11,5,12,9,20,5,115
26,9,18,11,9,20,5,0,0,98
26,9,20,0,0,0,0,0,0,55
26,25,20,8,5,13,0,0,0,97
26,9,20,8,5,18,0,0,0,86
26,9,20,8,5,18,9,19,20,134
26,9,20,8,5,18,14,0,0,100
26,9,20,8,5,18,14,19,0,119
26,9,20,8,5,18,19,0,0,105
26,25,20,8,21,13,0,0,0,113
26,9,20,9,0,0,0,0,0,64
26,9,20,9,19,0,0,0,0,83
26,9,20,19,0,0,0,0,0,74
26,9,20,20,5,18,0,0,0,98
26,9,20,20,5,18,14,0,0,112
26,9,20,26,9,20,0,0,0,110
26,9,20,26,9,20,8,0,0,118
26,9,26,1,14,25,0,0,0,101
26,9,26,5,12,0,0,0,0,78
26,9,26,9,20,0,0,0,0,90
26,9,26,9,20,8,0,0,0,98
26,9,26,26,0,0,0,0,0,87
26,25,26,26,25,22,1,0,0,151
26,25,26,26,25,22,1,19,0,170
26,9,26,26,12,5,0,0,0,104
26,9,26,26,12,5,4,0,0,108
26,9,26,26,12,5,19,0,0,123
26,9,26,26,12,9,14,7,0,129
26,12,15,20,5,0,0,0,0,78
26,12,15,20,25,0,0,0,0,98
26,12,15,20,25,3,8,0,0,109
26,12,15,20,9,5,19,0,0,106
26,12,15,20,25,19,0,0,0,117
26,15,2,15,0,0,0,0,0,58
26,15,2,20,5,14,9,20,5,116
26,15,3,1,12,15,0,0,0,72
26,15,3,3,15,0,0,0,0,62
26,15,3,3,15,12,15,0,0,89
26,15,4,0,0,0,0,0,0,45
26,15,4,9,1,3,0,0,0,58
26,15,4,9,1,3,1,12,0,71
26,15,4,9,1,3,19,0,0,77
26,15,5,1,0,0,0,0,0,47
26,15,5,1,5,0,0,0,0,52
26,15,5,1,6,15,18,13,0,99
26,15,5,1,12,0,0,0,0,59
26,15,5,1,19,0,0,0,0,66
26,15,5,6,15,18,13,0,0,98
26,15,5,8,5,13,5,18,1,96
26,15,5,20,9,3,0,0,0,78
26,15,5,20,18,15,16,5,0,120
26,15,5,20,18,15,16,9,3,127
26,15,6,20,9,7,0,0,0,83
26,15,7,1,14,0,0,0,0,63
26,15,7,15,0,0,0,0,0,63
26,15,9,1,20,18,9,1,0,99
26,15,9,1,20,18,9,3,19,120
26,15,9,3,0,0,0,0,0,53
26,15,9,4,0,0,0,0,0,54
26,15,25,19,9,1,19,0,0,114
26,15,9,19,9,20,5,0,0,103
26,15,9,19,9,20,5,19,0,122
26,15,9,19,13,0,0,0,0,82
26,15,9,19,20,0,0,0,0,89
26,15,9,19,20,9,3,0,0,101
26,15,11,15,18,0,0,0,0,85
26,15,12,12,0,0,0,0,0,65
26,15,12,12,5,0,0,0,0,70
26,15,12,12,16,6,21,14,4,126
26,15,12,15,20,9,14,11,0,122
26,15,12,15,20,14,9,11,0,122
26,15,13,2,9,0,0,0,0,65
26,15,13,2,9,5,0,0,0,70
26,15,13,2,9,5,19,0,0,89
26,15,13,2,9,9,19,13,0,106
26,15,13,2,9,9,19,13,19,125
26,15,13,2,9,19,0,0,0,84
26,15,14,1,12,0,0,0,0,68
26,15,14,1,12,9,20,25,0,122
26,15,14,1,12,12,25,0,0,105
26,15,14,1,18,0,0,0,0,74
26,15,14,1,18,25,0,0,0,99
26,15,14,1,20,5,0,0,0,81
26,15,14,1,20,5,4,0,0,85
26,15,14,1,20,9,15,14,0,114
26,15,14,1,20,9,15,14,19,133
26,15,14,5,0,0,0,0,0,60
26,15,14,5,4,0,0,0,0,64
26,15,14,5,12,5,19,19,0,115
26,15,14,5,12,5,20,0,0,97
26,15,14,5,12,9,11,5,0,97
26,15,14,5,18,0,0,0,0,78
26,15,14,5,18,19,0,0,0,97
26,15,14,5,19,0,0,0,0,79
26,15,14,5,20,9,13,5,0,107
26,15,14,5,20,9,13,5,19,126
26,15,14,9,3,0,0,0,0,67
26,15,14,9,14,7,0,0,0,85
26,15,14,9,20,5,0,0,0,89
26,15,14,9,20,9,4,0,0,97
26,15,14,11,0,0,0,0,0,66
26,15,14,11,5,4,0,0,0,75
26,15,14,11,9,14,7,0,0,96
26,15,14,11,19,0,0,0,0,85
26,15,14,14,1,18,0,0,0,88
26,15,14,15,9,4,0,0,0,83
26,15,14,21,12,1,0,0,0,89
26,15,14,21,12,1,5,0,0,94
26,15,14,21,12,1,18,0,0,107
26,15,14,21,12,1,19,0,0,108
26,15,14,21,12,5,0,0,0,93
26,15,14,21,12,5,19,0,0,112
26,15,14,21,12,5,20,0,0,113
26,15,14,21,18,5,0,0,0,99
26,15,14,21,18,9,4,0,0,107
26,15,14,21,18,15,9,4,0,122
26,15,15,0,0,0,0,0,0,56
26,15,15,2,12,1,19,20,0,110
26,15,15,3,1,18,16,0,0,94
26,15,15,3,8,5,13,0,0,85
26,15,15,3,8,5,13,25,0,110
26,15,15,3,8,15,18,5,0,105
26,15,15,3,8,15,18,5,19,124
26,15,15,3,25,19,20,0,0,123
26,15,15,3,25,19,20,9,3,135
26,15,15,3,25,20,9,1,12,126
26,15,15,3,25,20,9,21,13,147
26,15,15,5,3,9,1,0,0,74
26,15,15,5,3,9,1,12,0,86
26,15,15,5,3,9,21,13,0,107
26,15,15,6,21,12,22,9,14,140
26,15,15,7,1,13,5,20,5,107
26,15,15,7,1,13,25,0,0,102
26,15,15,7,1,13,15,21,19,132
26,15,15,7,5,14,5,0,0,87
26,15,15,7,5,14,25,0,0,107
26,15,15,7,5,14,9,3,0,94
26,15,15,7,5,14,15,21,19,137
26,15,15,7,5,15,7,0,0,90
26,15,15,7,12,5,1,0,0,81
26,15,15,7,12,5,1,5,0,86
26,15,15,7,12,5,1,12,0,93
26,15,15,7,12,5,1,19,0,100
26,15,15,7,12,5,18,0,0,98
26,15,15,7,12,15,5,1,0,96
26,15,15,7,12,15,5,1,5,101
26,15,15,7,12,15,5,1,12,108
26,15,15,7,12,15,5,1,19,115
26,15,15,7,12,15,5,9,3,107
26,15,15,7,15,14,25,0,0,117
26,15,15,7,15,14,9,3,0,104
26,15,15,7,15,14,15,21,19,147
26,15,15,7,18,1,6,20,0,108
26,15,15,7,18,1,16,8,25,131
26,15,15,7,18,16,1,8,25,131
26,15,15,9,4,0,0,0,0,69
26,15,15,9,4,1,12,0,0,82
26,15,15,9,4,19,0,0,0,88
26,15,15,11,5,18,19,0,0,109
26,15,15,11,19,0,0,0,0,86
26,15,15,12,0,0,0,0,0,68
26,15,15,12,1,20,5,18,0,112
26,15,15,12,1,20,5,18,19,131
26,15,15,12,1,20,18,25,0,132
26,15,15,12,1,20,18,9,1,117
26,15,15,12,9,20,5,0,0,102
26,15,15,12,9,20,8,0,0,105
26,15,15,12,9,20,8,9,3,117
26,15,15,12,9,20,9,3,0,109
26,15,15,12,15,7,5,18,0,113
26,15,15,12,15,7,25,0,0,115
26,15,15,12,15,7,9,3,0,102
26,15,15,12,15,7,9,5,19,123
26,15,15,12,15,7,9,19,20,138
26,15,15,12,15,7,9,26,5,130
26,15,15,13,0,0,0,0,0,69
26,15,15,13,1,14,3,25,0,112
26,15,15,13,1,14,9,1,0,94
26,15,15,13,1,14,9,1,19,113
26,15,15,13,1,14,20,9,3,116
26,15,15,13,5,4,0,0,0,78
26,15,15,13,5,20,18,25,0,137
26,15,15,13,5,20,18,9,3,124
26,15,15,13,9,13,9,3,0,103
26,15,15,13,9,14,7,0,0,99
26,15,15,13,15,18,16,8,0,126
26,15,15,13,15,18,16,8,25,151
26,15,15,13,15,18,16,8,19,145
26,15,15,13,19,0,0,0,0,88
26,15,15,14,0,0,0,0,0,70
26,15,15,14,1,0,0,0,0,71
26,15,15,14,1,12,0,0,0,83
26,15,15,14,9,3,0,0,0,82
26,15,15,14,9,19,20,0,0,118
26,15,15,14,9,20,5,0,0,104
26,15,15,14,9,20,9,3,0,111
26,15,15,14,15,13,25,0,0,123
26,15,15,14,15,13,9,1,0,108
26,15,15,14,15,13,9,3,0,110
26,15,15,14,15,13,9,19,20,146
26,15,15,14,15,19,5,19,0,128
26,15,15,14,15,19,9,19,0,132
26,15,15,14,15,20,9,3,0,117
26,15,15,14,19,0,0,0,0,89
26,15,15,14,21,12,5,0,0,108
26,15,15,16,1,20,8,25,0,126
26,15,15,16,5,18,1,12,0,108
26,15,15,16,5,18,25,0,0,120
26,15,15,16,5,18,9,19,20,143
26,15,15,16,8,1,7,1,14,103
26,15,15,16,8,1,7,21,19,128
26,15,15,16,8,9,12,5,0,106
26,15,15,16,8,9,12,5,19,125
26,15,15,16,8,9,12,25,0,126
26,15,15,16,8,9,12,9,1,111
26,15,15,16,8,9,12,9,3,113
26,15,15,16,8,9,19,13,0,121
26,15,15,16,8,25,20,1,12,138
26,15,15,16,8,25,20,5,0,130
26,15,15,16,8,25,20,5,19,149
26,15,15,16,8,25,20,9,3,137
26,15,15,16,8,15,2,5,0,102
26,15,15,16,8,15,2,5,19,121
26,15,15,16,8,15,2,9,1,107
26,15,15,16,8,15,18,9,0,122
26,15,15,16,8,15,18,9,3,125
26,15,15,16,8,15,18,21,19,153
26,15,15,16,12,1,19,20,25,149
26,15,15,16,19,9,1,0,0,101
26,15,15,19,0,0,0,0,0,75
26,15,15,19,3,15,16,25,0,134
26,15,15,19,3,15,16,9,3,121
26,15,15,19,9,19,0,0,0,103
26,15,15,19,13,15,19,9,19,150
26,15,15,19,16,5,18,13,0,127
26,15,15,19,16,5,18,13,19,146
26,15,15,19,16,7,9,1,0,108
26,15,15,19,16,8,5,18,5,127
26,15,15,19,16,15,18,5,0,129
26,15,15,19,16,15,18,5,19,148
26,15,15,19,16,15,18,9,3,136
26,15,15,19,20,5,18,15,12,145
26,15,15,20,1,24,25,0,0,126
26,15,15,20,5,3,8,14,25,131
26,15,15,20,5,18,0,0,0,99
26,15,15,20,8,5,3,9,1,102
26,15,15,20,8,5,9,19,13,130
26,15,15,20,8,5,9,19,20,137
26,15,15,20,8,15,13,5,0,117
26,15,15,20,25,0,0,0,0,101
26,15,15,20,9,3,0,0,0,88
26,15,15,20,25,16,5,0,0,122
26,15,15,20,25,16,9,3,0,129
26,15,15,20,15,13,25,0,0,129
26,15,15,20,15,13,9,3,0,116
26,15,15,20,15,13,9,5,19,137
26,15,15,20,15,13,9,19,20,152
26,15,15,20,15,24,9,14,0,138
26,15,15,20,18,15,16,8,25,158
26,15,15,26,15,15,0,0,0,112
26,15,16,8,15,18,9,0,0,107
26,15,16,8,15,18,21,19,0,138
26,15,16,9,12,15,20,5,0,118
26,15,18,7,9,20,5,0,0,100
26,15,18,9,0,0,0,0,0,68
26,15,18,9,12,0,0,0,0,80
26,15,18,9,12,12,1,0,0,93
26,15,18,9,12,12,1,19,0,112
26,15,18,9,12,12,5,0,0,97
26,15,18,9,12,12,5,19,0,116
26,15,18,9,12,12,15,0,0,107
26,15,18,9,12,12,15,19,0,126
26,15,18,9,12,19,0,0,0,99
26,15,18,9,19,0,0,0,0,87
26,15,18,15,1,19,20,18,1,133
26,15,18,18,9,12,12,15,0,125
26,15,18,18,15,0,0,0,0,92
26,15,18,20,26,9,3,15,0,132
26,15,19,20,5,18,0,0,0,103
26,15,19,20,5,18,19,0,0,122
26,15,21,1,22,5,19,0,0,109
26,15,21,14,4,19,0,0,0,99
26,15,23,9,5,0,0,0,0,78
26,21,2,18,0,0,0,0,0,67
26,21,3,3,1,18,9,14,15,110
26,21,3,3,8,5,20,20,9,115
26,21,3,3,8,5,20,20,15,121
26,21,3,3,8,9,14,9,0,93
26,21,3,3,8,9,14,9,19,112
26,21,3,3,15,0,0,0,0,68
26,21,3,8,5,20,20,15,0,118
26,21,4,4,1,0,0,0,0,56
26,21,6,6,15,12,15,0,0,101
26,21,6,15,12,15,0,0,0,95
26,21,7,26,23,1,14,7,0,125
26,21,9,19,9,14,0,0,0,98
26,21,13,1,20,9,3,0,0,93
26,21,13,2,15,15,18,21,11,142
26,21,14,25,9,20,5,0,0,120
26,21,14,9,19,0,0,0,0,89
26,21,16,1,14,1,20,5,0,104
26,21,18,12,9,20,5,0,0,111
26,21,21,18,22,5,12,4,20,149
26,21,26,1,0,0,0,0,0,74
26,23,9,5,2,1,3,11,19,99
26,23,9,20,20,5,18,0,0,121
0,0,0,0,0,0,0,0,0,0
